Link,Name,From-Team,From-Franchise,# Transactions,# Players Traded Away,# Players Traded For,# Players Total,First Year,Last Year,Year Span,Ongoing,Comp Picks,total_WAR_out,total_WAR_in,WAR_total,total_G_out,total_G_in,G_total,total_PA_out,total_PA_in,PA_total,total_IP_out,total_IP_in,IP_total,total_salary_out,total_salary_in,salary_total
<a href=/player/aardd001>aardd001</a>,David Aardsma,San Francisco Giants,GIANTS,2,3,3,6,2005,2008,3,No,0,2.36,1.11,-1.25,196,369,173,41,1,-40,695.0,405.0,-290.0,336000.0,0.0,-336000.0
<a href=/player/aardd001>aardd001</a>,David Aardsma,Chicago Cubs,CUBS,1,2,1,3,2006,2009,3,No,0,-0.4,0.17,0.57,27,164,137,0,1,1,97.0,190.0,93.0,0.0,0.0,0.0
<a href=/player/aardd001>aardd001</a>,David Aardsma,Chicago White Sox,WSOX,1,1,2,3,2008,2011,3,No,0,-0.33,0.0,0.33,52,0,-52,1,0,-1,146.0,0.0,-146.0,0.0,0.0,0.0
<a href=/player/aardd001>aardd001</a>,David Aardsma,Boston Red Sox,RSOX,10,28,17,45,2009,2019,10,Yes,0,37.8,29.55,-8.25,3009,1766,-1243,5076,5901,825,5204.0,1908.0,-3296.0,4708000.0,0.0,-4708000.0
<a href=/player/aaroh101>aaroh101</a>,Hank Aaron,Atlanta Braves,BRAVES,4,9,5,14,1974,1983,9,No,0,4.19,7.49,3.3,717,753,36,1866,2551,685,923.0,87.0,-836.0,253500.0,0.0,-253500.0
<a href=/player/aased001>aased001</a>,Don Aase,Boston Red Sox,RSOX,1,2,1,3,1977,1985,8,No,0,10.47,6.5,-3.97,192,710,518,0,3118,3118,2086.0,0.0,-2086.0,0.0,0.0,0.0
<a href=/player/abadf001>abadf001</a>,Fernando Abad,Washington Nationals,NATEX,1,1,1,2,2013,2013,0,Yes,0,1.97,0.0,-1.97,142,0,-142,0,0,0,315.0,0.0,-315.0,0.0,0.0,0.0
<a href=/player/abadf001>abadf001</a>,Fernando Abad,Minnesota Twins,TWINS,2,2,2,4,2016,2017,1,No,0,0.22,-0.48,-0.7,72,16,-56,0,0,0,169.0,42.0,-127.0,0.0,0.0,0.0
<a href=/player/abbae101>abbae101</a>,Ed Abbaticchio,Boston Braves,BRAVES,2,2,5,7,1906,1910,4,No,0,6.87,14.92,8.05,408,829,421,1496,3044,1548,0.0,1374.0,1374.0,0.0,0.0,0.0
<a href=/player/abbeb101>abbeb101</a>,Bert Abbey,Pittsburgh Pirates,PIRATS,2,2,2,4,1893,1898,5,No,0,2.42,1.37,-1.05,115,147,32,191,295,104,1263.0,1301.0,38.0,0.0,0.0,0.0
<a href=/player/abbof101>abbof101</a>,Fred Abbott,Columbus,Columbus,1,1,1,2,1905,1907,2,No,0,-0.18,0.0,0.18,42,0,-42,142,0,-142,0.0,0.0,0.0,0.0,0.0,0.0
<a href=/player/abboj001>abboj001</a>,Jim Abbott,California Angels,ANGELS,3,4,6,10,1992,1998,6,No,0,15.27,-0.9,-16.17,1393,613,-780,4599,2002,-2597,1493.0,1346.0,-147.0,2825000.0,0.0,-2825000.0
<a href=/player/abboj001>abboj001</a>,Jim Abbott,Chicago White Sox,WSOX,6,9,10,19,1995,2008,13,No,0,-3.17,23.46,26.63,359,1502,1143,866,3855,2989,1206.0,2082.0,876.0,3255000.0,0.0,-3255000.0
<a href=/player/abboj002>abboj002</a>,Jeff Abbott,Chicago White Sox,WSOX,1,1,1,2,2000,2002,2,No,0,0.03,-0.49,-0.52,28,22,-6,46,39,-7,0.0,0.0,0.0,255000.0,0.0,-255000.0
<a href=/player/abbok001>abbok001</a>,Kyle Abbott,California Angels,ANGELS,1,2,1,3,1991,1992,1,No,0,-0.16,-0.8,-0.64,519,94,-425,970,350,-620,485.0,0.0,-485.0,0.0,0.0,0.0
<a href=/player/abbok002>abbok002</a>,Kurt Abbott,Oakland Athletics,ATLTCS,1,1,1,2,1993,1996,3,No,0,1.96,-0.07,-2.03,424,22,-402,1461,18,-1443,0.0,0.0,0.0,109000.0,0.0,-109000.0
<a href=/player/abbok002>abbok002</a>,Kurt Abbott,Florida Marlins,MARLNS,1,1,1,2,1997,1998,1,No,0,-0.55,-1.15,-0.6,35,26,-9,136,7,-129,0.0,98.0,98.0,650000.0,0.0,-650000.0
<a href=/player/abbok002>abbok002</a>,Kurt Abbott,Oakland Athletics,ATLTCS,1,1,2,3,1998,1998,0,No,0,-0.8,0.0,0.8,138,0,-138,381,0,-381,0.0,0.0,0.0,1000000.0,0.0,-1000000.0
<a href=/player/abbop001>abbop001</a>,Paul Abbott,Arizona Diamondbacks,DBACKS,1,1,1,2,2003,2003,0,No,0,0.4,0.0,-0.4,10,0,-10,0,0,0,143.0,0.0,-143.0,0.0,0.0,0.0
<a href=/player/abera101>abera101</a>,Al Aber,Cleveland Indians,INDINS,4,8,7,15,1953,1960,7,No,0,29.6,3.08,-26.52,1527,466,-1061,3515,525,-2990,4632.0,1595.0,-3037.0,15900.0,0.0,-15900.0
<a href=/player/aberb001>aberb001</a>,Brent Abernathy,Toronto Blue Jays,BJAYS,1,1,2,3,2000,2000,0,No,0,0.98,1.0,0.02,198,34,-164,846,0,-846,0.0,251.0,251.0,0.0,0.0,0.0
<a href=/player/aberb101>aberb101</a>,Bill Abernathie,Cleveland Indians,INDINS,1,2,1,3,1953,1954,1,No,0,0.0,-0.16,-0.16,0,4,4,0,4,4,0.0,0.0,0.0,0.0,0.0,0.0
<a href=/player/abert101>abert101</a>,Ted Abernathy,Chicago Cubs,CUBS,2,2,3,5,1966,1968,2,No,0,-1.96,-1.51,0.45,166,152,-14,230,379,149,196.0,0.0,-196.0,0.0,0.0,0.0
<a href=/player/abert101>abert101</a>,Ted Abernathy,Cincinnati Reds,REDS,1,1,3,4,1969,1978,9,No,0,1.7,-3.64,-5.34,134,324,190,8,899,891,283.0,0.0,-283.0,0.0,0.0,0.0
<a href=/player/abert101>abert101</a>,Ted Abernathy,Chicago Cubs,CUBS,2,2,2,4,1970,1974,4,No,0,1.49,-0.89,-2.38,121,253,132,178,707,529,55.0,0.0,-55.0,0.0,0.0,0.0
<a href=/player/abert101>abert101</a>,Ted Abernathy,St. Louis Cardinals,CARDS,2,2,2,4,1970,1971,1,No,0,5.43,-1.11,-6.54,338,47,-291,40,33,-7,700.0,269.0,-431.0,0.0,0.0,0.0
<a href=/player/abnes001>abnes001</a>,Shawn Abner,New York Mets,METS,14,32,26,58,1986,2019,33,No,2,34.33,97.35,63.02,3020,5459,2439,6919,13501,6582,4717.0,5432.0,715.0,28384257.0,0.0,-28384257.0
<a href=/player/abnes001>abnes001</a>,Shawn Abner,San Diego Padres,PADRS,1,1,1,2,1991,1991,0,No,0,-0.68,0.71,1.39,41,58,17,105,179,74,0.0,0.0,0.0,180000.0,0.0,-180000.0
<a href=/player/abrac101>abrac101</a>,Cal Abrams,Brooklyn Dodgers,DOGRS,1,1,2,3,1952,1952,0,No,0,0.81,0.0,-0.81,71,0,-71,177,0,-177,0.0,0.0,0.0,9500.0,0.0,-9500.0
<a href=/player/abrac101>abrac101</a>,Cal Abrams,Cincinnati Reds,REDS,1,3,1,4,1952,1961,9,No,0,1.64,13.15,11.51,150,1235,1085,601,5109,4508,0.0,0.0,0.0,0.0,0.0,0.0
<a href=/player/abrac101>abrac101</a>,Cal Abrams,Pittsburgh Pirates,PIRATS,2,3,2,5,1954,1965,11,No,0,5.86,19.95,14.09,341,1537,1196,1230,5949,4719,29.0,893.0,864.0,11000.0,0.0,-11000.0
<a href=/player/abrac101>abrac101</a>,Cal Abrams,Baltimore Orioles,ORLS,1,1,1,2,1955,1956,1,No,0,0.13,0.22,0.09,4,41,37,5,143,138,0.0,0.0,0.0,16000.0,0.0,-16000.0
<a href=/player/abrea001>abrea001</a>,Albert Abreu,Houston Astros,ASTROS,1,2,2,4,2016,2018,2,No,0,-0.24,1.81,2.05,33,160,127,0,615,615,114.0,0.0,-114.0,0.0,0.0,0.0
<a href=/player/abreb001>abreb001</a>,Bobby Abreu,Tampa Bay Devil Rays,RAYS,1,1,1,2,1997,2000,3,No,0,47.18,2.72,-44.46,1353,231,-1122,5885,804,-5081,0.0,0.0,0.0,0.0,0.0,0.0
<a href=/player/abreb001>abreb001</a>,Bobby Abreu,Philadelphia Phillies,PHILS,1,2,4,6,2006,2009,3,No,0,7.5,0.06,-7.44,382,46,-336,1631,0,-1631,136.0,38.0,-98.0,16900000.0,0.0,-16900000.0
<a href=/player/abrej002>abrej002</a>,Juan Abreu,Atlanta Braves,BRAVES,2,5,3,8,2011,2019,8,No,1,1.07,6.63,5.56,249,230,-19,481,952,471,1075.0,36.0,-1039.0,0.0,0.0,0.0
<a href=/player/abrej101>abrej101</a>,Joe Abreu,Cincinnati Reds,REDS,1,3,1,4,1942,1942,0,No,0,-0.7,0.0,0.7,176,38,-138,37,128,91,438.0,0.0,-438.0,0.0,0.0,0.0
<a href=/player/abret001>abret001</a>,Tony Abreu,Los Angeles Dodgers,DOGRS,1,1,1,2,2009,2009,0,No,0,-1.3,0.17,1.47,81,12,-69,201,13,-188,0.0,109.0,109.0,400000.0,0.0,-400000.0
<a href=/player/abrew001>abrew001</a>,Winston Abreu,Atlanta Braves,BRAVES,1,1,1,2,2001,2001,0,No,0,0.0,0.2,0.2,0,24,24,0,0,0,0.0,36.0,36.0,0.0,0.0,0.0
<a href=/player/abrew001>abrew001</a>,Winston Abreu,San Diego Padres,PADRS,1,1,1,2,2002,2002,0,No,0,0.0,0.0,0.0,0,0,0,0,0,0,0.0,0.0,0.0,0.0,0.0,0.0
<a href=/player/abrew001>abrew001</a>,Winston Abreu,Tampa Bay Devil Rays,RAYS,1,1,1,2,2009,2009,0,No,0,-0.25,0.0,0.25,3,0,-3,0,0,0,7.0,0.0,-7.0,0.0,0.0,0.0
<a href=/player/accaj001>accaj001</a>,Jeremy Accardo,San Francisco Giants,GIANTS,1,1,2,3,2006,2008,2,No,0,1.81,0.24,-1.57,144,281,137,0,251,251,419.0,321.0,-98.0,330000.0,0.0,-330000.0
<a href=/player/acevj001>acevj001</a>,Juan Acevedo,Colorado Rockies,ROCKS,1,2,2,4,1995,1996,1,No,0,-0.04,0.08,0.12,47,18,-29,7,15,8,143.0,129.0,-14.0,109000.0,0.0,-109000.0
<a href=/player/acevj001>acevj001</a>,Juan Acevedo,New York Mets,METS,4,6,5,11,1998,2005,7,No,0,2.27,1.88,-0.39,307,737,430,71,1631,1560,972.0,157.0,-815.0,3750000.0,0.0,-3750000.0
<a href=/player/acevj001>acevj001</a>,Juan Acevedo,St. Louis Cardinals,CARDS,1,3,1,4,1999,2003,4,No,0,0.9,5.69,4.79,122,488,366,2,2221,2219,248.0,0.0,-248.0,475000.0,0.0,-475000.0
<a href=/player/acevj001>acevj001</a>,Juan Acevedo,Milwaukee Brewers,BREWRS,2,4,5,9,2001,2004,3,No,0,0.49,3.61,3.12,225,470,245,5,59,54,355.0,808.0,453.0,1700000.0,0.0,-1700000.0
<a href=/player/acevj001>acevj001</a>,Juan Acevedo,Colorado Rockies,ROCKS,1,1,1,2,2001,2001,0,No,0,0.5,0.0,-0.5,40,0,-40,4,0,-4,85.0,0.0,-85.0,0.0,0.0,0.0
<a href=/player/acevj002>acevj002</a>,Jose Acevedo,Cincinnati Reds,REDS,1,1,1,2,2005,2006,1,No,0,-0.77,-0.07,0.7,72,18,-54,11,0,-11,192.0,20.0,-172.0,0.0,0.0,0.0
<a href=/player/ackej001>ackej001</a>,Jim Acker,Toronto Blue Jays,BJAYS,1,1,1,2,1986,1987,1,No,0,3.97,1.22,-2.75,338,30,-308,56,0,-56,1048.0,464.0,-584.0,0.0,0.0,0.0
<a href=/player/ackej001>ackej001</a>,Jim Acker,Atlanta Braves,BRAVES,2,3,3,6,1989,1993,4,No,0,1.07,1.23,0.16,147,447,300,6,375,369,696.0,468.0,-228.0,853000.0,0.0,-853000.0
<a href=/player/acket101>acket101</a>,Tom Acker,Buffalo,Buffalo,1,2,1,3,1951,1952,1,No,0,4.75,0.0,-4.75,338,0,-338,99,0,-99,1213.0,0.0,-1213.0,0.0,0.0,0.0
<a href=/player/acket101>acket101</a>,Tom Acker,Cincinnati Reds,REDS,1,1,1,2,1959,1961,2,No,0,0.0,-0.26,-0.26,0,23,23,0,28,28,0.0,0.0,0.0,10000.0,0.0,-10000.0
<a href=/player/ackld001>ackld001</a>,Dustin Ackley,Seattle Mariners,MARNRS,4,4,5,9,2015,2017,2,No,0,-1.26,-0.89,0.37,431,38,-393,589,77,-512,306.0,17.0,-289.0,3112000.0,0.0,-3112000.0
<a href=/player/acose101>acose101</a>,Ed Acosta,Pittsburgh Pirates,PIRATS,1,2,1,3,1971,1973,2,No,0,1.19,1.07,-0.12,236,104,-132,456,7,-449,405.0,247.0,-158.0,0.0,0.0,0.0
<a href=/player/acosj101>acosj101</a>,Jose Acosta,Washington Senators,TWINS,3,6,4,10,1922,1933,11,No,0,25.21,14.57,-10.64,1580,710,-870,6114,2665,-3449,0.0,616.0,616.0,0.0,0.0,0.0
<a href=/player/adaij101>adaij101</a>,Jerry Adair,Baltimore Orioles,ORLS,6,13,9,22,1966,1973,7,No,0,1.41,-0.48,-1.89,684,433,-251,1106,498,-608,1557.0,550.0,-1007.0,66000.0,0.0,-66000.0
<a href=/player/adaij101>adaij101</a>,Jerry Adair,Chicago White Sox,WSOX,2,2,3,5,1967,1968,1,No,0,2.07,2.58,0.51,271,188,-83,571,21,-550,218.0,507.0,289.0,31250.0,0.0,-31250.0
<a href=/player/adama001>adama001</a>,Austin Adams,Cleveland Indians,INDINS,1,1,1,2,2017,2017,0,No,0,0.0,0.0,0.0,0,0,0,0,0,0,0.0,0.0,0.0,0.0,0.0,0.0
<a href=/player/adama002>adama002</a>,Austin Adams,Anaheim Angels,ANGELS,1,2,1,3,2016,2017,1,No,0,-0.03,-0.47,-0.44,104,77,-27,6,254,248,215.0,0.0,-215.0,0.0,0.0,0.0
<a href=/player/adama002>adama002</a>,Austin Adams,Washington Nationals,NATEX,1,1,2,3,2019,2019,0,Yes,0,0.65,0.0,-0.65,32,0,-32,1,0,-1,93.0,0.0,-93.0,0.0,0.0,0.0
<a href=/player/adama002>adama002</a>,Austin Adams,Seattle Mariners,MARNRS,1,3,4,7,2020,2020,0,Yes,0,1.48,0.43,-1.05,218,41,-177,269,159,-110,200.0,0.0,-200.0,0.0,0.0,0.0
<a href=/player/adamb101>adamb101</a>,Buster Adams,St. Louis Cardinals,CARDS,1,3,2,5,1943,1946,3,No,0,7.07,3.43,-3.64,654,226,-428,2414,842,-1572,0.0,0.0,0.0,0.0,0.0,0.0
<a href=/player/adamb101>adamb101</a>,Buster Adams,Philadelphia Phillies,PHILS,1,1,2,3,1945,1945,0,No,0,2.98,0.82,-2.16,221,207,-14,855,882,27,0.0,0.0,0.0,0.0,0.0,0.0
<a href=/player/adamb103>adamb103</a>,Bobby Adams,Chicago White Sox,WSOX,1,1,1,2,1955,1955,0,No,0,0.22,0.0,-0.22,41,0,-41,143,0,-143,0.0,0.0,0.0,0.0,0.0,0.0
<a href=/player/adamb106>adamb106</a>,Jack Adams,New York Giants,GIANTS,1,3,1,4,1915,1915,0,No,0,8.83,1.16,-7.67,856,106,-750,2811,431,-2380,1477.0,0.0,-1477.0,0.0,0.0,0.0
<a href=/player/adamc002>adamc002</a>,Chance Adams,New York Yankees,YANKS,1,1,1,2,2019,2019,0,Yes,0,-0.19,0.0,0.19,6,0,-6,0,0,0,26.0,0.0,-26.0,556725.0,0.0,-556725.0
<a href=/player/adamh101>adamh101</a>,Herb Adams,Houston,Houston,1,2,1,3,1959,1959,0,No,0,0.0,0.0,0.0,0,0,0,0,0,0,0.0,0.0,0.0,0.0,0.0,0.0
<a href=/player/adamj001>adamj001</a>,Joel Adamson,Philadelphia Phillies,PHILS,2,3,3,6,1992,2004,12,No,2,-0.36,9.96,10.32,27,711,684,0,2073,2073,41.0,1766.0,1725.0,0.0,0.0,0.0
<a href=/player/adamj001>adamj001</a>,Joel Adamson,Florida Marlins,MARLNS,1,1,1,2,1996,1996,0,No,0,0.84,0.0,-0.84,34,0,-34,3,0,-3,229.0,0.0,-229.0,0.0,0.0,0.0
<a href=/player/adamj002>adamj002</a>,Jason Adam,Kansas City Royals,ROYALS,1,1,1,2,2014,2014,0,No,0,0.0,0.18,0.18,0,24,24,0,86,86,0.0,0.0,0.0,0.0,0.0,0.0
<a href=/player/adamm001>adamm001</a>,Mike Adams,Milwaukee Brewers,BREWRS,1,1,1,2,2006,2006,0,No,0,0.0,-0.65,-0.65,0,40,40,0,5,5,0.0,126.0,126.0,0.0,0.0,0.0
<a href=/player/adamm001>adamm001</a>,Mike Adams,Cleveland Indians,INDINS,1,1,1,2,2006,2007,1,No,0,6.42,0.16,-6.26,406,17,-389,2,0,-2,651.0,59.0,-592.0,0.0,0.0,0.0
<a href=/player/adamm001>adamm001</a>,Mike Adams,San Diego Padres,PADRS,3,6,6,12,2011,2019,8,No,0,10.84,-0.18,-11.02,776,478,-298,2593,1171,-1422,260.0,1056.0,796.0,3828600.0,0.0,-3828600.0
<a href=/player/adamm002>adamm002</a>,Matt Adams,St. Louis Cardinals,CARDS,1,2,1,3,2017,2017,0,Yes,0,-0.02,0.0,0.02,116,0,-116,365,0,-365,0.0,0.0,0.0,0.0,0.0,0.0
<a href=/player/adamm102>adamm102</a>,Mike Adams,Detroit Tigers,TIGRS,1,2,1,3,1971,1971,0,No,0,0.24,-0.53,-0.77,58,32,-26,90,4,-86,0.0,95.0,95.0,0.0,0.0,0.0
<a href=/player/adamm102>adamm102</a>,Mike Adams,Minnesota Twins,TWINS,1,1,1,2,1974,1974,0,No,0,-0.22,0.0,0.22,27,0,-27,40,0,-40,0.0,0.0,0.0,0.0,0.0,0.0
<a href=/player/adamr004>adamr004</a>,Riley Adams,Toronto Blue Jays,BJAYS,1,1,1,2,2021,2021,0,No,0,0.89,-0.62,-1.51,35,12,-23,90,0,-90,0.0,26.0,26.0,0.0,0.0,0.0
<a href=/player/adams101>adams101</a>,Sparky Adams,Chicago Cubs,CUBS,1,2,1,3,1927,1935,8,No,0,1.8,26.3,24.5,269,949,680,1048,4196,3148,0.0,0.0,0.0,15500.0,0.0,-15500.0
<a href=/player/adams101>adams101</a>,Sparky Adams,St. Louis Cardinals,CARDS,2,4,7,11,1933,1941,8,No,0,35.44,3.4,-32.04,1483,791,-692,3153,2855,-298,8479.0,390.0,-8089.0,10000.0,0.0,-10000.0
<a href=/player/adams101>adams101</a>,Sparky Adams,St. Louis Cardinals,CARDS,1,3,1,4,1921,1921,0,No,0,0.0,-0.04,-0.04,0,22,22,0,57,57,0.0,0.0,0.0,0.0,0.0,0.0
<a href=/player/adams101>adams101</a>,Sparky Adams,WichitaFalls,WichitaFalls,1,1,2,3,1922,1922,0,No,0,12.04,0.0,-12.04,672,0,-672,2968,0,-2968,0.0,0.0,0.0,0.0,0.0,0.0
<a href=/player/adams102>adams102</a>,Spencer Adams,St.Louis Browns,ORLS,23,46,52,98,1927,1952,25,No,0,139.77,131.99,-7.78,6854,9855,3001,22708,32907,10199,12609.0,15510.0,2901.0,218500.0,0.0,-218500.0
<a href=/player/adams102>adams102</a>,Spencer Adams,Seattle,Seattle,2,3,5,8,1922,1925,3,No,0,11.84,0.0,-11.84,653,0,-653,687,0,-687,5104.0,0.0,-5104.0,0.0,0.0,0.0
<a href=/player/adamt001>adamt001</a>,Terry Adams,Chicago Cubs,CUBS,2,4,5,9,1999,2002,3,No,0,1.82,4.66,2.84,231,348,117,64,1392,1328,872.0,299.0,-573.0,6473500.0,0.0,-6473500.0
<a href=/player/adamt001>adamt001</a>,Terry Adams,Toronto Blue Jays,BJAYS,1,1,1,2,2004,2007,3,No,0,-0.09,0.29,0.38,19,13,-6,0,29,29,81.0,0.0,-81.0,1700000.0,0.0,-1700000.0
<a href=/player/adamw002>adamw002</a>,Willy Adames,Detroit Tigers,TIGRS,3,5,5,10,2014,2021,7,Yes,0,13.54,10.17,-3.37,428,201,-227,1262,19,-1243,1153.0,2223.0,1070.0,29745000.0,0.0,-29745000.0
<a href=/player/adamw002>adamw002</a>,Willy Adames,Tampa Bay Devil Rays,RAYS,1,2,2,4,2021,2021,0,Yes,0,3.81,2.17,-1.64,129,60,-69,414,3,-411,59.0,287.0,228.0,0.0,0.0,0.0
<a href=/player/adcoj101>adcoj101</a>,Joe Adcock,Cincinnati Reds,REDS,1,1,2,3,1953,1957,4,No,0,26.58,0.53,-26.05,1207,346,-861,4697,754,-3943,0.0,0.0,0.0,0.0,0.0,0.0
<a href=/player/adcoj101>adcoj101</a>,Joe Adcock,Milwaukee Braves,BRAVES,3,5,6,11,1962,1966,4,No,0,-0.69,3.0,3.69,105,383,278,317,708,391,15.0,0.0,-15.0,0.0,0.0,0.0
<a href=/player/adcoj101>adcoj101</a>,Joe Adcock,Cleveland Indians,INDINS,9,16,15,31,1963,1978,15,No,0,26.81,13.21,-13.6,2236,1670,-566,5404,5743,339,2936.0,1183.0,-1753.0,115500.0,0.0,-115500.0
<a href=/player/adcon001>adcon001</a>,Nathan Adcock,Seattle Mariners,MARNRS,2,6,3,9,2009,2011,2,No,0,-0.04,2.82,2.86,447,179,-268,1426,514,-912,0.0,332.0,332.0,5822500.0,0.0,-5822500.0
<a href=/player/addib101>addib101</a>,Bob Addis,Brooklyn Dodgers,DOGRS,1,2,3,5,1949,1949,0,No,0,8.82,0.0,-8.82,541,0,-541,2215,0,-2215,0.0,0.0,0.0,0.0,0.0,0.0
<a href=/player/addib101>addib101</a>,Bob Addis,Boston Braves,BRAVES,1,1,1,2,1951,1951,0,No,0,0.91,0.0,-0.91,103,0,-103,331,0,-331,0.0,0.0,0.0,6600.0,0.0,-6600.0
<a href=/player/addib101>addib101</a>,Bob Addis,Chicago Cubs,CUBS,7,18,16,34,1953,1965,12,No,0,5.64,21.93,16.29,1405,1825,420,3839,2173,-1666,1451.0,4951.0,3500.0,82000.0,0.0,-82000.0
<a href=/player/adduj001>adduj001</a>,Jim Adduci,St. Louis Cardinals,CARDS,1,2,3,5,1984,1984,0,No,0,0.51,0.0,-0.51,168,0,-168,529,0,-529,0.0,0.0,0.0,0.0,0.0,0.0
<a href=/player/aderm101>aderm101</a>,Morrie Aderholt,Washington Senators,TWINS,1,1,1,2,1943,1950,7,No,0,-0.33,-0.38,-0.05,56,165,109,126,573,447,0.0,0.0,0.0,0.0,0.0,0.0
<a href=/player/adkij001>adkij001</a>,Jon Adkins,Oakland Athletics,ATLTCS,3,4,6,10,1989,2007,18,No,2,0.38,3.52,3.14,293,206,-87,619,251,-368,239.0,786.0,547.0,2200000.0,0.0,-2200000.0
<a href=/player/adkij001>adkij001</a>,Jon Adkins,San Diego Padres,PADRS,5,9,10,19,2006,2016,10,No,2,7.6,8.88,1.28,798,1045,247,2623,1095,-1528,111.0,1373.0,1262.0,1621100.0,0.0,-1621100.0
<a href=/player/adkis001>adkis001</a>,Steve Adkins,New York Yankees,YANKS,1,1,1,2,1991,1991,0,No,0,0.0,0.0,0.0,0,0,0,0,0,0,0.0,0.0,0.0,0.0,0.0,0.0
<a href=/player/adled101>adled101</a>,Dave Adlesh,Houston Astros,ASTROS,2,5,3,8,1968,1968,0,No,0,1.27,0.0,-1.27,405,0,-405,1102,0,-1102,299.0,0.0,-299.0,0.0,0.0,0.0
<a href=/player/adled101>adled101</a>,Dave Adlesh,St. Louis Cardinals,CARDS,2,2,2,4,1969,1971,2,No,0,0.47,-0.19,-0.66,81,29,-52,123,38,-85,0.0,0.0,0.0,0.0,0.0,0.0
<a href=/player/adled101>adled101</a>,Dave Adlesh,Atlanta Braves,BRAVES,1,1,1,2,1969,1969,0,No,0,0.0,0.0,0.0,0,0,0,0,0,0,0.0,0.0,0.0,0.0,0.0,0.0
<a href=/player/adled101>adled101</a>,Dave Adlesh,California Angels,ANGELS,4,9,9,18,1971,1976,5,No,0,0.53,5.03,4.5,382,668,286,431,1911,1480,1134.0,244.0,-890.0,35000.0,0.0,-35000.0
<a href=/player/afent001>afent001</a>,Troy Afenir,Houston Astros,ASTROS,1,1,1,2,1989,1989,0,No,0,-0.28,0.0,0.28,19,0,-19,26,0,-26,0.0,0.0,0.0,0.0,0.0,0.0
<a href=/player/affej001>affej001</a>,Jeremy Affeldt,Kansas City Royals,ROYALS,1,2,2,4,2006,2009,3,No,0,-0.8,0.46,1.26,227,144,-83,3,478,475,305.0,71.0,-234.0,1335500.0,0.0,-1335500.0
<a href=/player/agbab001>agbab001</a>,Benny Agbayani,New York Mets,METS,11,24,26,50,2002,2021,19,Yes,0,23.06,23.68,0.62,980,1702,722,2021,4506,2485,5255.0,3554.0,-1701.0,30731467.0,0.0,-30731467.0
<a href=/player/ageet101>ageet101</a>,Tommie Agee,Cleveland Indians,INDINS,3,5,5,10,1965,1968,3,No,0,40.72,5.22,-35.5,1111,420,-691,2880,1615,-1265,4479.0,0.0,-4479.0,0.0,0.0,0.0
<a href=/player/ageet101>ageet101</a>,Tommie Agee,Chicago White Sox,WSOX,12,24,24,48,1967,1985,18,No,1,42.94,39.29,-3.65,3870,2650,-1220,10120,8109,-2011,6724.0,4885.0,-1839.0,267950.0,0.0,-267950.0
<a href=/player/ageet101>ageet101</a>,Tommie Agee,New York Mets,METS,1,1,2,3,1972,1974,2,No,0,0.56,-0.15,-0.71,84,8,-76,221,25,-196,0.0,0.0,0.0,0.0,0.0,0.0
<a href=/player/ageet101>ageet101</a>,Tommie Agee,Houston Astros,ASTROS,1,1,2,3,1973,1973,0,No,0,0.54,0.18,-0.36,26,9,-17,67,15,-52,0.0,0.0,0.0,0.0,0.0,0.0
<a href=/player/ageet101>ageet101</a>,Tommie Agee,St. Louis Cardinals,CARDS,1,1,1,2,1973,1974,1,No,0,0.0,-0.11,-0.11,0,26,26,0,0,0,0.0,34.0,34.0,0.0,0.0,0.0
<a href=/player/agual001>agual001</a>,Luis Aguayo,Philadelphia Phillies,PHILS,1,1,1,2,1988,1991,3,No,0,-0.68,-0.34,0.34,50,6,-44,149,1,-148,0.0,10.0,10.0,375000.0,0.0,-375000.0
<a href=/player/aguih101>aguih101</a>,Hank Aguirre,Cleveland Indians,INDINS,7,13,11,24,1958,1965,7,No,0,29.75,2.89,-26.86,2675,596,-2079,5199,1979,-3220,7620.0,347.0,-7273.0,7500.0,0.0,-7500.0
<a href=/player/aguih101>aguih101</a>,Hank Aguirre,Detroit Tigers,TIGRS,1,1,1,2,1968,1968,0,No,0,0.95,0.0,-0.95,50,0,-50,3,0,-3,117.0,0.0,-117.0,0.0,0.0,0.0
<a href=/player/aguij001>aguij001</a>,Jesus Aguilar,Milwaukee Brewers,BREWRS,1,1,1,2,2019,2020,1,No,0,0.24,-0.56,-0.8,37,18,-19,107,0,-107,0.0,26.0,26.0,637500.0,0.0,-637500.0
<a href=/player/aguir001>aguir001</a>,Rick Aguilera,New York Mets,METS,2,6,3,9,1989,1991,2,No,2,34.39,9.58,-24.81,807,164,-643,0,204,204,6852.0,1699.0,-5153.0,378000.0,0.0,-378000.0
<a href=/player/aguir001>aguir001</a>,Rick Aguilera,Minnesota Twins,TWINS,1,1,2,3,1995,1999,4,No,0,1.05,2.15,1.1,30,120,90,0,1,1,91.0,1528.0,1437.0,4350000.0,0.0,-4350000.0
<a href=/player/aguir001>aguir001</a>,Rick Aguilera,Minnesota Twins,TWINS,2,3,3,6,1999,2006,7,No,0,2.68,7.1,4.42,288,208,-80,99,24,-75,1148.0,2925.0,1777.0,8250000.0,0.0,-8250000.0
<a href=/player/ahmen001>ahmen001</a>,Nick Ahmed,Atlanta Braves,BRAVES,4,10,11,21,2013,2019,6,Yes,0,22.68,8.16,-14.52,2194,1203,-991,6430,4358,-2072,1394.0,147.0,-1247.0,14250000.0,0.0,-14250000.0
<a href=/player/aikew001>aikew001</a>,Willie Aikens,California Angels,ANGELS,4,5,7,12,1979,1983,4,No,0,17.81,3.93,-13.88,1525,241,-1284,5870,846,-5024,0.0,43.0,43.0,0.0,0.0,0.0
<a href=/player/aikew001>aikew001</a>,Willie Aikens,Kansas City Royals,ROYALS,1,1,1,2,1983,1986,3,No,0,-0.87,1.59,2.46,105,338,233,289,1129,840,0.0,0.0,0.0,0.0,0.0,0.0
<a href=/player/ainse101>ainse101</a>,Eddie Ainsmith,Washington Senators,TWINS,3,5,4,9,1919,1933,14,No,0,-0.71,14.2,14.91,37,1313,1276,32,5773,5741,106.0,0.0,-106.0,34200.0,0.0,-34200.0
<a href=/player/ainse101>ainse101</a>,Eddie Ainsmith,Boston Red Sox,RSOX,1,3,1,4,1919,1919,0,No,0,4.45,1.63,-2.82,567,133,-434,1739,583,-1156,282.0,0.0,-282.0,0.0,0.0,0.0
<a href=/player/ainsk001>ainsk001</a>,Kurt Ainsworth,San Francisco Giants,GIANTS,1,3,1,4,2003,2003,0,No,0,-1.54,0.88,2.42,20,20,0,0,25,25,251.0,204.0,-47.0,1852000.0,0.0,-1852000.0
<a href=/player/akerb101>akerb101</a>,Bill Akers,Boston Braves,BRAVES,1,3,1,4,1932,1937,5,No,0,0.0,10.04,10.04,0,601,601,0,2506,2506,0.0,0.0,0.0,0.0,0.0,0.0
<a href=/player/akerd001>akerd001</a>,Darrel Akerfelds,Seattle Mariners,MARNRS,1,2,2,4,1983,1987,4,No,0,2.3,0.84,-1.46,79,391,312,1,1067,1066,329.0,228.0,-101.0,0.0,0.0,0.0
<a href=/player/akerd001>akerd001</a>,Darrel Akerfelds,Oakland Athletics,ATLTCS,1,2,1,3,1987,1987,0,No,0,-0.62,0.31,0.93,21,61,40,12,249,237,224.0,0.0,-224.0,0.0,0.0,0.0
<a href=/player/akerj101>akerj101</a>,Jerry Akers,Washington Senators,TWINS,1,3,1,4,1912,1916,4,No,0,0.0,13.55,13.55,0,546,546,0,2246,2246,0.0,0.0,0.0,0.0,0.0,0.0
<a href=/player/akerj102>akerj102</a>,Jack Aker,Seattle Pilots,BREWRS,6,9,7,16,1969,1976,7,No,0,9.24,16.25,7.01,956,826,-130,2252,2810,558,990.0,497.0,-493.0,176100.0,0.0,-176100.0
<a href=/player/akerj102>akerj102</a>,Jack Aker,New York Yankees,YANKS,1,1,1,2,1972,1973,1,No,0,0.4,-0.69,-1.09,190,137,-53,14,442,428,392.0,0.0,-392.0,0.0,0.0,0.0
<a href=/player/albaj001>albaj001</a>,Jonathan Albaladejo,Washington Nationals,NATEX,3,4,4,8,2007,2019,12,No,0,2.72,11.59,8.87,309,1013,704,948,605,-343,294.0,1476.0,1182.0,5000000.0,0.0,-5000000.0
<a href=/player/albeb101>albeb101</a>,Butch Alberts,California Angels,ANGELS,1,2,1,3,1977,1977,0,No,0,-0.09,0.0,0.09,9,0,-9,25,0,-25,0.0,0.0,0.0,0.0,0.0,0.0
<a href=/player/albem001>albem001</a>,Matt Albers,Houston Astros,ASTROS,1,5,1,6,2007,2009,2,No,0,11.62,3.81,-7.81,860,316,-544,1797,1340,-457,1330.0,0.0,-1330.0,382000.0,0.0,-382000.0
<a href=/player/albem001>albem001</a>,Matt Albers,Boston Red Sox,RSOX,1,2,1,3,2012,2015,3,No,0,0.39,1.0,0.61,46,199,153,0,0,0,63.0,597.0,534.0,1075000.0,0.0,-1075000.0
<a href=/player/albem001>albem001</a>,Matt Albers,Arizona Diamondbacks,DBACKS,3,6,6,12,2012,2021,9,No,0,44.83,10.87,-33.96,1441,607,-834,2691,1018,-1673,5272.0,2512.0,-2760.0,11602833.0,0.0,-11602833.0
<a href=/player/albua001>albua001</a>,Al Alburquerque,Chicago Cubs,CUBS,2,2,3,5,2009,2012,3,No,0,-0.35,1.63,1.98,15,283,268,37,804,767,0.0,0.0,0.0,1375000.0,0.0,-1375000.0
<a href=/player/alcaa001>alcaa001</a>,Arismendy Alcantara,Chicago Cubs,CUBS,1,1,1,2,2016,2016,0,No,0,-0.34,0.6,0.94,16,48,32,19,128,109,0.0,0.0,0.0,0.0,0.0,0.0
<a href=/player/alcaj001>alcaj001</a>,Jorge Alcala,Houston Astros,ASTROS,1,2,1,3,2018,2018,0,Yes,0,0.45,1.4,0.95,104,28,-76,62,0,-62,256.0,70.0,-186.0,0.0,0.0,0.0
<a href=/player/alcal101>alcal101</a>,Luis Alcaraz,Kansas City Royals,ROYALS,1,2,1,3,1971,1972,1,No,0,0.0,-0.92,-0.92,0,116,116,0,287,287,0.0,0.0,0.0,0.0,0.0,0.0
<a href=/player/alcar001>alcar001</a>,Raul Alcantara,Boston Red Sox,RSOX,1,3,2,5,2011,2013,2,No,0,15.82,0.39,-15.43,609,113,-496,2364,219,-2145,139.0,132.0,-7.0,0.0,0.0,0.0
<a href=/player/alcas001>alcas001</a>,Sandy Alcantara,St. Louis Cardinals,CARDS,1,4,1,5,2017,2019,2,No,0,8.96,4.59,-4.37,386,278,-108,632,1177,545,1696.0,0.0,-1696.0,0.0,0.0,0.0
<a href=/player/alcas002>alcas002</a>,Sergio Alcantara,Arizona Diamondbacks,DBACKS,1,3,1,4,2017,2017,0,No,0,-1.37,2.41,3.78,123,62,-61,423,257,-166,0.0,0.0,0.0,0.0,0.0,0.0
<a href=/player/alcas101>alcas101</a>,Santo Alcala,Cincinnati Reds,REDS,3,3,4,7,1977,1981,4,No,1,4.46,6.7,2.24,270,473,203,27,1574,1547,1438.0,25.0,-1413.0,0.0,0.0,0.0
<a href=/player/alcav001>alcav001</a>,Victor Alcantara,Anaheim Angels,ANGELS,1,1,1,2,2016,2017,1,No,0,1.15,1.49,0.34,87,93,6,0,387,387,240.0,0.0,-240.0,0.0,0.0,0.0
<a href=/player/aldrj001>aldrj001</a>,Jay Aldrich,Milwaukee Brewers,BREWRS,1,1,1,2,1989,1989,0,No,0,0.03,-0.38,-0.41,16,15,-1,1,50,49,37.0,0.0,-37.0,0.0,0.0,0.0
<a href=/player/aldrm001>aldrm001</a>,Mike Aldrete,San Francisco Giants,GIANTS,2,2,2,4,1988,1989,1,No,0,0.15,-0.12,-0.27,268,110,-158,666,278,-388,0.0,0.0,0.0,460000.0,0.0,-460000.0
<a href=/player/aldrm001>aldrm001</a>,Mike Aldrete,Oakland Athletics,ATLTCS,1,1,1,2,1995,1995,0,No,0,-0.45,0.0,0.45,49,0,-49,71,0,-71,0.0,0.0,0.0,430000.0,0.0,-430000.0
<a href=/player/aldrm001>aldrm001</a>,Mike Aldrete,California Angels,ANGELS,1,1,1,2,1996,1996,0,No,0,0.02,-0.12,-0.14,33,12,-21,77,0,-77,3.0,46.0,43.0,250000.0,0.0,-250000.0
<a href=/player/aldrs001>aldrs001</a>,Scott Aldred,Tampa Bay Devil Rays,RAYS,1,1,1,2,1999,1999,0,No,0,0.33,0.0,-0.33,104,0,-104,1,0,-1,158.0,0.0,-158.0,545000.0,0.0,-545000.0
<a href=/player/aldrv101>aldrv101</a>,Vic Aldridge,LosAngeles,LosAngeles,1,2,5,7,1922,1922,0,No,0,14.87,0.0,-14.87,633,0,-633,2280,0,-2280,2159.0,0.0,-2159.0,0.0,0.0,0.0
<a href=/player/aldrv101>aldrv101</a>,Vic Aldridge,Chicago Cubs,CUBS,1,3,3,6,1924,1926,2,No,0,29.39,2.01,-27.38,1120,155,-965,4097,410,-3687,1929.0,802.0,-1127.0,13500.0,0.0,-13500.0
<a href=/player/aldrv101>aldrv101</a>,Vic Aldridge,Pittsburgh Pirates,PIRATS,2,2,3,5,1928,1930,2,No,0,-1.29,12.5,13.79,66,180,114,61,239,178,505.0,1746.0,1241.0,0.0,0.0,0.0
<a href=/player/alexa001>alexa001</a>,A.J. Alexy,Los Angeles Dodgers,DOGRS,1,3,1,4,2017,2017,0,No,0,-1.3,0.52,1.82,240,18,-222,874,20,-854,69.0,149.0,80.0,0.0,0.0,0.0
<a href=/player/alexb101>alexb101</a>,Bob Alexander,Portland,Portland,1,1,1,2,1954,1954,0,No,0,-0.58,0.0,0.58,8,0,-8,0,0,0,12.0,0.0,-12.0,0.0,0.0,0.0
<a href=/player/alexb101>alexb101</a>,Bob Alexander,Chicago Cubs,CUBS,1,1,1,2,1957,1957,0,No,0,-0.32,0.0,0.32,10,0,-10,1,0,-1,21.0,0.0,-21.0,0.0,0.0,0.0
<a href=/player/alexd001>alexd001</a>,Doyle Alexander,Los Angeles Dodgers,DOGRS,3,10,5,15,1971,1976,5,No,0,18.58,22.72,4.14,838,611,-227,2013,960,-1053,3623.0,2900.0,-723.0,259900.0,0.0,-259900.0
<a href=/player/alexd001>alexd001</a>,Doyle Alexander,Baltimore Orioles,ORLS,10,21,19,40,1976,1994,18,No,3,48.77,85.06,36.29,2260,4349,2089,4427,10615,6188,10756.0,13691.0,2935.0,713333.0,0.0,-713333.0
<a href=/player/alexd001>alexd001</a>,Doyle Alexander,Texas Rangers,RNGRS,2,4,4,8,1979,1981,2,No,0,4.64,-2.56,-7.2,264,133,-131,467,246,-221,1400.0,101.0,-1299.0,150000.0,0.0,-150000.0
<a href=/player/alexd001>alexd001</a>,Doyle Alexander,Atlanta Braves,BRAVES,1,1,2,3,1980,1981,1,No,0,3.53,0.68,-2.85,48,52,4,58,15,-43,457.0,232.0,-225.0,150000.0,0.0,-150000.0
<a href=/player/alexd001>alexd001</a>,Doyle Alexander,San Francisco Giants,GIANTS,1,1,2,3,1982,1984,2,No,0,-1.33,0.77,2.1,24,94,70,0,34,34,285.0,427.0,142.0,0.0,0.0,0.0
<a href=/player/alexd001>alexd001</a>,Doyle Alexander,Toronto Blue Jays,BJAYS,1,1,1,2,1986,1995,9,No,0,3.76,10.47,6.71,67,453,386,87,0,-87,705.0,1952.0,1247.0,700000.0,0.0,-700000.0
<a href=/player/alexd001>alexd001</a>,Doyle Alexander,Atlanta Braves,BRAVES,1,1,1,2,1987,2008,21,No,0,6.3,69.53,63.23,78,1409,1331,0,1151,1151,1621.0,10185.0,8564.0,650000.0,0.0,-650000.0
<a href=/player/alexd101>alexd101</a>,Dale Alexander,Detroit Tigers,TIGRS,1,2,1,3,1932,1933,1,No,0,12.96,0.98,-11.98,710,94,-616,2975,392,-2583,0.0,0.0,0.0,13000.0,0.0,-13000.0
<a href=/player/alexd101>alexd101</a>,Dale Alexander,Toronto,Toronto,1,2,3,5,1928,1933,5,No,0,9.1,0.0,-9.1,535,0,-535,1990,0,-1990,281.0,0.0,-281.0,0.0,0.0,0.0
<a href=/player/alexg001>alexg001</a>,Gerald Alexander,Texas Rangers,RNGRS,1,2,1,3,1993,1993,0,No,0,0.0,0.0,0.0,0,0,0,0,0,0,0.0,0.0,0.0,0.0,0.0,0.0
<a href=/player/alexg101>alexg101</a>,Gary Alexander,San Francisco Giants,GIANTS,4,14,8,22,1978,1992,14,No,0,8.18,23.62,15.44,767,1277,510,1656,1600,-56,2714.0,7759.0,5045.0,0.0,0.0,0.0
<a href=/player/alexg101>alexg101</a>,Gary Alexander,Oakland Athletics,ATLTCS,1,1,1,2,1978,1980,2,No,0,0.61,-1.7,-2.31,276,108,-168,978,402,-576,0.0,0.0,0.0,0.0,0.0,0.0
<a href=/player/alexg101>alexg101</a>,Gary Alexander,Cleveland Indians,INDINS,6,11,12,23,1980,2011,31,No,2,35.2,55.22,20.02,1530,2690,1160,5654,9199,3545,2682.0,4370.0,1688.0,1767500.0,0.0,-1767500.0
<a href=/player/alexg102>alexg102</a>,Pete Alexander,Philadelphia Phillies,PHILS,5,11,13,24,1917,1929,12,No,0,74.14,17.51,-56.63,2587,762,-1825,7576,2068,-5508,10093.0,3446.0,-6647.0,21000.0,0.0,-21000.0
<a href=/player/alexg102>alexg102</a>,Pete Alexander,St. Louis Cardinals,CARDS,1,2,2,4,1929,1932,3,No,0,0.24,-1.21,-1.45,299,26,-273,578,77,-501,65.0,0.0,-65.0,7500.0,0.0,-7500.0
<a href=/player/alexm001>alexm001</a>,Manny Alexander,Baltimore Orioles,ORLS,1,2,1,3,1997,1998,1,No,0,0.7,0.0,-0.7,54,0,-54,161,0,-161,0.0,0.0,0.0,0.0,0.0,0.0
<a href=/player/alexm001>alexm001</a>,Manny Alexander,New York Mets,METS,7,15,13,28,1997,2005,8,No,0,5.2,5.1,-0.1,1347,1947,600,1609,2988,1379,2422.0,1675.0,-747.0,19588333.0,0.0,-19588333.0
<a href=/player/alexm001>alexm001</a>,Manny Alexander,Chicago Cubs,CUBS,1,1,1,2,1999,2001,2,No,0,-0.72,0.18,0.9,101,185,84,209,645,436,0.0,0.0,0.0,475000.0,0.0,-475000.0
<a href=/player/alexm001>alexm001</a>,Manny Alexander,Texas Rangers,RNGRS,1,1,1,2,2005,2005,0,No,0,-0.38,0.0,0.38,32,0,-32,60,0,-60,0.0,0.0,0.0,0.0,0.0,0.0
<a href=/player/alexm101>alexm101</a>,Matt Alexander,Chicago Cubs,CUBS,1,1,1,2,1975,1975,0,No,0,-1.9,0.0,1.9,214,0,-214,88,0,-88,0.0,0.0,0.0,0.0,0.0,0.0
<a href=/player/alexs001>alexs001</a>,Scott Alexander,Kansas City Royals,ROYALS,1,3,2,5,2018,2021,3,No,0,0.86,-0.68,-1.54,242,21,-221,6,43,37,333.0,41.0,-292.0,0.0,0.0,0.0
<a href=/player/alfaj002>alfaj002</a>,Jorge Alfaro,Texas Rangers,RNGRS,5,14,16,30,2015,2021,6,Yes,0,11.03,13.28,2.25,790,293,-497,1664,16,-1648,2536.0,2164.0,-372.0,3762500.0,0.0,-3762500.0
<a href=/player/alfaj002>alfaj002</a>,Jorge Alfaro,Philadelphia Phillies,PHILS,1,4,1,5,2019,2021,2,Yes,0,1.81,9.39,7.58,260,326,66,876,1325,449,117.0,0.0,-117.0,0.0,0.0,0.0
<a href=/player/alfoa001>alfoa001</a>,Antonio Alfonseca,Florida Marlins,MARLNS,7,9,16,25,2002,2013,11,No,0,71.73,23.4,-48.33,3136,1557,-1579,9615,1244,-8371,3483.0,5887.0,2404.0,18420219.0,0.0,-18420219.0
<a href=/player/alfoe001>alfoe001</a>,Edgardo Alfonzo,San Francisco Giants,GIANTS,1,1,1,2,2005,2006,1,No,0,-0.63,1.13,1.76,18,139,121,52,481,429,0.0,0.0,0.0,7500000.0,0.0,-7500000.0
<a href=/player/alfoe002>alfoe002</a>,Eliezer Alfonzo,St. Louis Cardinals,CARDS,1,3,1,4,2000,2003,3,No,0,0.9,5.69,4.79,122,488,366,2,2221,2219,248.0,0.0,-248.0,0.0,0.0,0.0
<a href=/player/alicl001>alicl001</a>,Luis Alicea,St. Louis Cardinals,CARDS,1,1,2,3,1994,1995,1,No,0,2.28,0.0,-2.28,132,0,-132,511,0,-511,0.0,0.0,0.0,650000.0,0.0,-650000.0
<a href=/player/allaa001>allaa001</a>,Andy Allanson,Kansas City Royals,ROYALS,1,1,1,2,1991,1991,0,No,0,0.24,0.0,-0.24,60,0,-60,160,0,-160,0.0,0.0,0.0,0.0,0.0,0.0
<a href=/player/allab101>allab101</a>,Brian Allard,Texas Rangers,RNGRS,4,10,10,20,1980,1987,7,No,0,9.35,8.94,-0.41,686,425,-261,1581,631,-950,2721.0,2684.0,-37.0,817500.0,0.0,-817500.0
<a href=/player/allak001>allak001</a>,Kolby Allard,Atlanta Braves,BRAVES,1,1,1,2,2019,2021,2,No,0,-0.75,1.69,2.44,54,146,92,4,0,-4,611.0,237.0,-374.0,0.0,0.0,0.0
<a href=/player/allea001>allea001</a>,Austin Allen,San Diego Padres,PADRS,1,2,1,3,2019,2021,2,Yes,0,-0.02,1.34,1.36,18,193,175,40,614,574,0.0,0.0,0.0,0.0,0.0,0.0
<a href=/player/alleb001>alleb001</a>,Brandon Allen,Chicago White Sox,WSOX,1,1,1,2,2009,2011,2,No,0,-0.56,0.39,0.95,65,106,41,209,0,-209,0.0,471.0,471.0,0.0,0.0,0.0
<a href=/player/alleb001>alleb001</a>,Brandon Allen,Arizona Diamondbacks,DBACKS,2,3,3,6,2011,2016,5,Yes,0,1.57,7.2,5.63,125,680,555,165,7,-158,265.0,1007.0,742.0,0.0,0.0,0.0
<a href=/player/alleb105>alleb105</a>,Bernie Allen,Minnesota Twins,TWINS,2,3,2,5,1966,1968,2,No,0,10.51,0.41,-10.1,831,108,-723,1841,6,-1835,1694.0,215.0,-1479.0,90000.0,0.0,-90000.0
<a href=/player/alleb105>alleb105</a>,Bernie Allen,Texas Rangers,RNGRS,17,39,29,68,1971,1988,17,No,0,50.9,56.03,5.13,3324,3490,166,10647,10376,-271,4537.0,8004.0,3467.0,592000.0,0.0,-592000.0
<a href=/player/alled001>alled001</a>,Dusty Allen,San Diego Padres,PADRS,1,1,1,2,2000,2000,0,No,0,0.34,-0.25,-0.59,18,11,-7,18,14,-4,0.0,0.0,0.0,200000.0,0.0,-200000.0
<a href=/player/alled101>alled101</a>,Dick Allen,Philadelphia Phillies,PHILS,5,9,11,20,1969,1977,8,No,0,2.27,5.62,3.35,374,740,366,889,1587,698,321.0,625.0,304.0,70000.0,0.0,-70000.0
<a href=/player/alled101>alled101</a>,Dick Allen,St. Louis Cardinals,CARDS,25,48,46,94,1970,1998,28,No,7,95.99,170.53,74.54,8773,8179,-594,24631,28802,4171,10540.0,4019.0,-6521.0,3173333.0,0.0,-3173333.0
<a href=/player/alled101>alled101</a>,Dick Allen,Los Angeles Dodgers,DOGRS,2,2,3,5,1971,1978,7,No,1,15.35,14.16,-1.19,348,364,16,1422,463,-959,0.0,3594.0,3594.0,125000.0,0.0,-125000.0
<a href=/player/alled101>alled101</a>,Dick Allen,Chicago White Sox,WSOX,2,3,3,6,1974,1979,5,No,0,6.89,4.63,-2.26,401,220,-181,1175,610,-565,453.0,189.0,-264.0,200000.0,0.0,-200000.0
<a href=/player/alled101>alled101</a>,Dick Allen,Atlanta Braves,BRAVES,3,7,6,13,1975,1986,11,No,0,13.14,5.38,-7.76,1203,1387,184,3551,4502,951,1023.0,3.0,-1020.0,0.0,0.0,0.0
<a href=/player/allee101>allee101</a>,Ethan Allen,Cincinnati Reds,REDS,4,9,4,13,1930,1932,2,No,0,-0.65,6.36,7.01,300,397,97,801,1584,783,303.0,0.0,-303.0,27500.0,0.0,-27500.0
<a href=/player/allee101>allee101</a>,Ethan Allen,New York Giants,GIANTS,3,11,6,17,1932,1949,17,No,0,15.21,55.77,40.56,1303,2528,1225,3690,9780,6090,2269.0,40.0,-2229.0,0.0,0.0,0.0
<a href=/player/allee101>allee101</a>,Ethan Allen,Philadelphia Phillies,PHILS,1,2,2,4,1936,1939,3,No,0,4.25,4.0,-0.25,195,450,255,507,1597,1090,830.0,231.0,-599.0,0.0,0.0,0.0
<a href=/player/allef101>allef101</a>,Frank Allen,Detroit Tigers,TIGRS,1,3,1,4,1909,1909,0,No,0,0.0,-0.16,-0.16,0,8,8,0,8,8,0.0,60.0,60.0,0.0,0.0,0.0
<a href=/player/alleg002>alleg002</a>,Greg Allen,Cleveland Indians,INDINS,1,3,6,9,2020,2020,0,Yes,0,0.62,-0.12,-0.74,5,36,31,4,78,74,57.0,44.0,-13.0,4100000.0,0.0,-4100000.0
<a href=/player/alleg002>alleg002</a>,Greg Allen,San Diego Padres,PADRS,1,1,1,2,2021,2021,0,Yes,0,0.42,0.0,-0.42,15,0,-15,48,0,-48,0.0,0.0,0.0,0.0,0.0,0.0
<a href=/player/alleh104>alleh104</a>,Hank Allen,Washington Senators,RNGRS,1,2,1,3,1970,1970,0,No,0,4.46,0.11,-4.35,279,77,-202,994,154,-840,0.0,0.0,0.0,19000.0,0.0,-19000.0
<a href=/player/alleh104>alleh104</a>,Hank Allen,Milwaukee Brewers,BREWRS,1,3,1,4,1970,1971,1,No,0,0.0,0.0,0.0,0,0,0,0,0,0,0.0,0.0,0.0,0.0,0.0,0.0
<a href=/player/allej001>allej001</a>,Jermaine Allensworth,Pittsburgh Pirates,PIRATS,1,1,1,2,1998,1998,0,No,0,0.02,0.0,-0.02,30,0,-30,91,0,-91,0.0,0.0,0.0,260000.0,0.0,-260000.0
<a href=/player/allej001>allej001</a>,Jermaine Allensworth,Kansas City Royals,ROYALS,1,1,1,2,1998,1998,0,No,0,-0.35,0.0,0.35,74,0,-74,143,0,-143,0.0,0.0,0.0,0.0,0.0,0.0
<a href=/player/allej001>allej001</a>,Jermaine Allensworth,New York Mets,METS,1,1,1,2,1999,2000,1,No,0,0.0,-0.02,-0.02,0,48,48,0,92,92,0.0,0.0,0.0,284000.0,0.0,-284000.0
<a href=/player/allej102>allej102</a>,Johnny Allen,New York Yankees,YANKS,2,2,4,6,1935,1942,7,No,0,18.6,14.33,-4.27,322,396,74,390,481,91,2862.0,3424.0,562.0,13500.0,0.0,-13500.0
<a href=/player/allej102>allej102</a>,Johnny Allen,Brooklyn Dodgers,DOGRS,1,2,1,3,1942,1942,0,No,0,0.0,0.0,0.0,0,0,0,0,0,0,0.0,0.0,0.0,0.0,0.0,0.0
<a href=/player/allej102>allej102</a>,Johnny Allen,Brooklyn Dodgers,DOGRS,3,7,5,12,1943,1947,4,No,0,-0.39,6.32,6.71,76,587,511,39,2174,2135,380.0,123.0,-257.0,0.0,0.0,0.0
<a href=/player/allel001>allel001</a>,Luke Allen,Los Angeles Dodgers,DOGRS,3,4,3,7,2003,2017,14,No,0,0.93,22.0,21.07,178,1603,1425,599,5763,5164,0.0,0.0,0.0,2830000.0,0.0,-2830000.0
<a href=/player/allel002>allel002</a>,Logan Allen,Boston Red Sox,RSOX,1,4,1,5,2015,2018,3,No,0,5.44,6.73,1.29,670,203,-467,2136,0,-2136,153.0,553.0,400.0,0.0,0.0,0.0
<a href=/player/allel002>allel002</a>,Logan Allen,San Diego Padres,PADRS,2,7,4,11,2019,2021,2,Yes,0,6.96,0.42,-6.54,597,36,-561,2267,75,-2192,192.0,42.0,-150.0,570500.0,0.0,-570500.0
<a href=/player/allel101>allel101</a>,Lloyd Allen,California Angels,ANGELS,3,4,5,9,1973,1975,2,No,0,-0.57,1.96,2.53,414,169,-245,1273,459,-814,189.0,261.0,72.0,0.0,0.0,0.0
<a href=/player/allen001>allen001</a>,Neil Allen,New York Mets,METS,1,2,1,3,1983,1989,6,No,0,-0.78,26.61,27.39,253,880,627,88,3684,3596,994.0,0.0,-994.0,0.0,0.0,0.0
<a href=/player/allen001>allen001</a>,Neil Allen,New York Yankees,YANKS,4,10,9,19,1986,1992,6,No,0,2.03,5.24,3.21,652,1255,603,1902,3999,2097,488.0,0.0,-488.0,400873.0,0.0,-400873.0
<a href=/player/aller001>aller001</a>,Rod Allen,Chicago White Sox,WSOX,6,11,9,20,1981,1994,13,No,0,14.41,9.4,-5.01,691,899,208,1049,2235,1186,4103.0,4503.0,400.0,1513333.0,0.0,-1513333.0
<a href=/player/aller001>aller001</a>,Rod Allen,Detroit Tigers,TIGRS,1,1,1,2,1985,1985,0,No,0,0.0,0.0,0.0,0,0,0,0,0,0,0.0,0.0,0.0,0.0,0.0,0.0
<a href=/player/aller101>aller101</a>,Ron Allen,Philadelphia Phillies,PHILS,2,2,2,4,1970,1972,2,No,0,0.0,0.23,0.23,0,44,44,0,77,77,0.0,0.0,0.0,0.0,0.0,0.0
<a href=/player/aller101>aller101</a>,Ron Allen,New York Mets,METS,1,1,1,2,1971,1971,0,No,0,-0.16,0.0,0.16,7,0,-7,14,0,-14,0.0,0.0,0.0,0.0,0.0,0.0
<a href=/player/allim102>allim102</a>,Mack Allison,St.Louis Browns,ORLS,1,4,1,5,1913,1916,3,No,0,0.0,8.53,8.53,0,318,318,0,1249,1249,0.0,0.0,0.0,3200.0,0.0,-3200.0
<a href=/player/almaa001>almaa001</a>,Armando Almanza,St. Louis Cardinals,CARDS,7,12,11,23,1998,2019,21,Yes,4,10.35,24.54,14.19,1808,1669,-139,1715,5353,3638,2044.0,547.0,-1497.0,3363000.0,0.0,-3363000.0
<a href=/player/almac001>almac001</a>,Carlos Almanzar,Toronto Blue Jays,BJAYS,1,3,1,4,1998,2001,3,No,0,7.56,0.33,-7.23,451,52,-399,328,5,-323,2800.0,760.0,-2040.0,1787500.0,0.0,-1787500.0
<a href=/player/almac001>almac001</a>,Carlos Almanzar,San Diego Padres,PADRS,1,1,1,2,2001,2001,0,No,0,0.25,0.68,0.43,11,79,68,0,1,1,32.0,146.0,114.0,0.0,0.0,0.0
<a href=/player/almam101>almam101</a>,Mel Almada,Boston Red Sox,RSOX,3,7,5,12,1937,1940,3,No,0,25.02,12.69,-12.33,1633,702,-931,5994,2554,-3440,2353.0,1424.0,-929.0,33500.0,0.0,-33500.0
<a href=/player/almam101>almam101</a>,Mel Almada,Washington Senators,TWINS,1,1,1,2,1938,1942,4,No,0,0.82,4.51,3.69,144,290,146,624,1024,400,0.0,0.0,0.0,7000.0,0.0,-7000.0
<a href=/player/almoa001>almoa001</a>,Abraham Almonte,New York Yankees,YANKS,3,3,3,6,2013,2017,4,Yes,0,1.25,-0.52,-1.77,202,132,-70,196,0,-196,240.0,354.0,114.0,1765000.0,0.0,-1765000.0
<a href=/player/almoa001>almoa001</a>,Abraham Almonte,Seattle Mariners,MARNRS,1,2,1,3,2014,2014,0,No,0,0.26,-0.18,-0.44,70,32,-38,182,90,-92,0.0,0.0,0.0,0.0,0.0,0.0
<a href=/player/almoa001>almoa001</a>,Abraham Almonte,San Diego Padres,PADRS,5,6,9,15,2015,2021,6,No,0,7.93,1.78,-6.15,582,405,-177,1491,448,-1043,1057.0,783.0,-274.0,1650000.0,0.0,-1650000.0
<a href=/player/almob001>almob001</a>,Bill Almon,San Diego Padres,PADRS,1,2,1,3,1979,1981,2,No,0,-0.61,-0.55,0.06,27,130,103,51,437,386,0.0,0.0,0.0,0.0,0.0,0.0
<a href=/player/almob001>almob001</a>,Bill Almon,Pittsburgh Pirates,PIRATS,1,1,2,3,1987,1988,1,No,0,0.12,0.96,0.84,49,138,89,62,411,349,0.0,0.0,0.0,250000.0,0.0,-250000.0
<a href=/player/almob001>almob001</a>,Bill Almon,New York Mets,METS,1,1,2,3,1988,1990,2,No,0,-0.19,0.0,0.19,20,0,-20,31,0,-31,0.0,0.0,0.0,0.0,0.0,0.0
<a href=/player/almoe002>almoe002</a>,Edwin Almonte,Chicago White Sox,WSOX,1,3,2,5,2003,2003,0,No,0,-0.24,0.07,0.31,72,67,-5,1,296,295,104.0,0.0,-104.0,0.0,0.0,0.0
<a href=/player/almom001>almom001</a>,Miguel Almonte,Kansas City Royals,ROYALS,1,1,1,2,2018,2018,0,No,0,-0.24,0.0,0.24,8,0,-8,0,0,0,21.0,0.0,-21.0,0.0,0.0,0.0
<a href=/player/almoy001>almoy001</a>,Yency Almonte,Anaheim Angels,ANGELS,1,1,1,2,2015,2020,5,Yes,0,0.0,0.0,0.0,0,0,0,0,0,0,0.0,0.0,0.0,0.0,0.0,0.0
<a href=/player/almoy001>almoy001</a>,Yency Almonte,Chicago White Sox,WSOX,3,5,6,11,2015,2017,2,Yes,0,4.1,2.11,-1.99,528,83,-445,250,0,-250,1065.0,220.0,-845.0,12535000.0,0.0,-12535000.0
<a href=/player/aloml101>aloml101</a>,Luis Aloma,Detroit Tigers,TIGRS,1,1,1,2,1949,1949,0,No,0,4.52,0.0,-4.52,232,0,-232,51,0,-51,705.0,0.0,-705.0,0.0,0.0,0.0
<a href=/player/alomr001>alomr001</a>,Roberto Alomar,San Diego Padres,PADRS,6,11,15,26,1990,1998,8,No,0,43.43,14.07,-29.36,3426,1340,-2086,13331,3496,-9835,1355.0,1888.0,533.0,8656667.0,0.0,-8656667.0
<a href=/player/alomr001>alomr001</a>,Roberto Alomar,Cleveland Indians,INDINS,3,5,7,12,2001,2008,7,No,0,0.76,6.93,6.17,461,824,363,1426,2856,1430,357.0,576.0,219.0,15000000.0,0.0,-15000000.0
<a href=/player/alomr001>alomr001</a>,Roberto Alomar,New York Mets,METS,2,4,5,9,2003,2008,5,No,0,7.82,-0.41,-8.23,808,83,-725,363,31,-332,1167.0,107.0,-1060.0,8000000.0,0.0,-8000000.0
<a href=/player/alomr001>alomr001</a>,Roberto Alomar,Arizona Diamondbacks,DBACKS,1,1,1,2,2004,2005,1,No,0,-0.8,0.0,0.8,18,0,-18,65,0,-65,0.0,0.0,0.0,1000000.0,0.0,-1000000.0
<a href=/player/aloms001>aloms001</a>,Sandy Alomar,San Diego Padres,PADRS,7,14,16,30,1989,1998,9,No,0,77.02,12.33,-64.69,5607,1502,-4105,22003,4193,-17810,1355.0,1888.0,533.0,8656667.0,0.0,-8656667.0
<a href=/player/aloms001>aloms001</a>,Sandy Alomar,Chicago White Sox,WSOX,1,1,1,2,2002,2002,0,No,0,-0.19,0.0,0.19,38,0,-38,120,0,-120,0.0,0.0,0.0,2500000.0,0.0,-2500000.0
<a href=/player/aloms001>aloms001</a>,Sandy Alomar,Los Angeles Dodgers,DOGRS,1,1,1,2,2006,2006,0,No,0,0.01,0.0,-0.01,19,0,-19,51,0,-51,0.0,0.0,0.0,650000.0,0.0,-650000.0
<a href=/player/aloms101>aloms101</a>,Sandy Alomar,Atlanta Braves,BRAVES,1,3,2,5,1966,1968,2,No,0,0.94,-0.28,-1.22,101,10,-91,383,29,-354,0.0,0.0,0.0,0.0,0.0,0.0
<a href=/player/aloms101>aloms101</a>,Sandy Alomar,Houston Astros,ASTROS,2,3,3,6,1967,1972,5,No,0,-0.13,-3.37,-3.24,209,234,25,39,135,96,428.0,1228.0,800.0,0.0,0.0,0.0
<a href=/player/aloms101>aloms101</a>,Sandy Alomar,New York Mets,METS,2,3,3,6,1967,1970,3,No,0,-1.49,0.67,2.16,346,144,-202,991,467,-524,0.0,0.0,0.0,55000.0,0.0,-55000.0
<a href=/player/aloms101>aloms101</a>,Sandy Alomar,Chicago White Sox,WSOX,2,3,3,6,1969,1971,2,No,0,9.0,0.38,-8.62,941,234,-707,3605,831,-2774,79.0,0.0,-79.0,15500.0,0.0,-15500.0
<a href=/player/aloms101>aloms101</a>,Sandy Alomar,New York Yankees,YANKS,1,1,3,4,1977,1980,3,No,0,-0.56,-0.74,-0.18,93,93,0,128,171,43,0.0,0.0,0.0,0.0,0.0,0.0
<a href=/player/alony001>alony001</a>,Yonder Alonso,Cincinnati Reds,REDS,2,5,3,8,2011,2020,9,No,0,8.75,14.41,5.66,882,376,-506,2596,411,-2185,1389.0,3437.0,2048.0,9475000.0,0.0,-9475000.0
<a href=/player/alony001>alony001</a>,Yonder Alonso,San Diego Padres,PADRS,4,5,8,13,2015,2021,6,No,0,6.15,2.58,-3.57,395,351,-44,906,448,-458,1057.0,739.0,-318.0,1650000.0,0.0,-1650000.0
<a href=/player/alony001>alony001</a>,Yonder Alonso,Oakland Athletics,ATLTCS,1,1,1,2,2017,2018,1,No,0,0.38,0.63,0.25,42,36,-6,150,117,-33,0.0,0.0,0.0,4000000.0,0.0,-4000000.0
<a href=/player/alony001>alony001</a>,Yonder Alonso,Cleveland Indians,INDINS,1,1,1,2,2018,2018,0,Yes,0,-1.03,0.0,1.03,67,0,-67,251,0,-251,0.0,0.0,0.0,7000000.0,0.0,-7000000.0
<a href=/player/alouf101>alouf101</a>,Felipe Alou,San Francisco Giants,GIANTS,8,14,12,26,1963,1972,9,No,0,20.6,12.56,-8.04,1709,1303,-406,5210,1731,-3479,1169.0,4789.0,3620.0,50000.0,0.0,-50000.0
<a href=/player/alouf101>alouf101</a>,Felipe Alou,Atlanta Braves,BRAVES,3,4,4,8,1969,1973,4,No,0,5.9,-0.55,-6.45,463,248,-215,1622,157,-1465,168.0,1238.0,1070.0,60000.0,0.0,-60000.0
<a href=/player/alouf101>alouf101</a>,Felipe Alou,Oakland Athletics,ATLTCS,3,6,4,10,1971,1972,1,No,0,0.83,1.09,0.26,472,138,-334,1300,198,-1102,313.0,159.0,-154.0,33250.0,0.0,-33250.0
<a href=/player/alouj101>alouj101</a>,Jesus Alou,Montreal Expos,NATEX,6,9,10,19,1969,1985,16,No,0,41.28,49.25,7.97,3185,3689,504,11568,12567,999,812.0,1543.0,731.0,243500.0,0.0,-243500.0
<a href=/player/aloum001>aloum001</a>,Moises Alou,Pittsburgh Pirates,PIRATS,1,3,1,4,1990,1994,4,No,0,13.0,10.16,-2.84,782,221,-561,2388,261,-2127,274.0,2055.0,1781.0,200000.0,0.0,-200000.0
<a href=/player/aloum001>aloum001</a>,Moises Alou,Florida Marlins,MARLNS,18,38,43,81,1997,2019,22,Yes,0,128.34,108.22,-20.12,5126,6567,1441,17202,20483,3281,10556.0,10228.0,-328.0,73250667.0,0.0,-73250667.0
<a href=/player/aloum101>aloum101</a>,Matty Alou,San Francisco Giants,GIANTS,2,2,3,5,1965,1969,4,No,0,17.69,1.65,-16.04,895,234,-661,3234,46,-3188,277.0,702.0,425.0,0.0,0.0,0.0
<a href=/player/aloum101>aloum101</a>,Matty Alou,Pittsburgh Pirates,PIRATS,4,6,8,14,1971,1978,7,No,0,4.65,9.98,5.33,393,854,461,1279,1834,555,673.0,1651.0,978.0,94500.0,0.0,-94500.0
<a href=/player/aloum101>aloum101</a>,Matty Alou,St. Louis Cardinals,CARDS,2,2,3,5,1972,1972,0,No,0,0.47,-0.1,-0.57,32,11,-21,136,18,-118,0.0,0.0,0.0,0.0,0.0,0.0
<a href=/player/aloum101>aloum101</a>,Matty Alou,Oakland Athletics,ATLTCS,1,1,2,3,1972,1973,1,No,0,1.39,-0.06,-1.45,123,3,-120,538,0,-538,0.0,22.0,22.0,100000.0,0.0,-100000.0
<a href=/player/alstd101>alstd101</a>,Dell Alston,New York Yankees,YANKS,8,15,13,28,1978,1992,14,No,0,6.29,14.79,8.5,1596,742,-854,3686,2169,-1517,2564.0,669.0,-1895.0,913333.0,0.0,-913333.0
<a href=/player/alstt101>alstt101</a>,Tom Alston,SanDiego,SanDiego,1,1,3,4,1954,1954,0,No,0,-0.23,0.0,0.23,91,0,-91,299,0,-299,0.0,0.0,0.0,0.0,0.0,0.0
<a href=/player/altad001>altad001</a>,Dan Altavilla,Seattle Mariners,MARNRS,1,3,4,7,2020,2020,0,Yes,0,1.48,0.43,-1.05,218,41,-177,269,159,-110,200.0,0.0,-200.0,0.0,0.0,0.0
<a href=/player/altap001>altap001</a>,Porfi Altamirano,Philadelphia Phillies,PHILS,3,6,4,10,1984,1986,2,No,0,8.36,-0.43,-8.79,1292,232,-1060,3847,16,-3831,227.0,557.0,330.0,0.0,0.0,0.0
<a href=/player/altap001>altap001</a>,Porfi Altamirano,Chicago Cubs,CUBS,2,7,4,11,1984,1987,3,No,0,2.88,0.38,-2.5,447,379,-68,818,354,-464,766.0,789.0,23.0,873333.0,0.0,-873333.0
<a href=/player/altmg101>altmg101</a>,George Altman,Chicago Cubs,CUBS,16,27,26,53,1962,1982,20,No,0,54.43,129.03,74.6,2307,6354,4047,4353,15923,11570,10563.0,16087.0,5524.0,552500.0,0.0,-552500.0
<a href=/player/altmg101>altmg101</a>,George Altman,St. Louis Cardinals,CARDS,2,4,2,6,1963,1966,3,No,0,0.61,-0.46,-1.07,354,142,-212,526,97,-429,552.0,871.0,319.0,0.0,0.0,0.0
<a href=/player/altmg101>altmg101</a>,George Altman,New York Mets,METS,4,6,5,11,1965,1968,3,No,0,-2.95,-0.74,2.21,496,87,-409,1178,167,-1011,0.0,0.0,0.0,11000.0,0.0,-11000.0
<a href=/player/altoj101>altoj101</a>,Joe Altobelli,Toronto,Toronto,1,1,1,2,1960,1960,0,No,0,0.0,0.0,0.0,0,0,0,0,0,0,0.0,0.0,0.0,0.0,0.0,0.0
<a href=/player/altoj101>altoj101</a>,Joe Altobelli,Los Angeles Dodgers,DOGRS,1,2,2,4,1961,1961,0,No,0,-0.97,0.0,0.97,59,0,-59,114,0,-114,63.0,0.0,-63.0,0.0,0.0,0.0
<a href=/player/altrn101>altrn101</a>,Nick Altrock,Chicago White Sox,WSOX,1,3,1,4,1909,1910,1,No,0,-0.91,1.19,2.1,140,48,-92,366,63,-303,237.0,502.0,265.0,2400.0,0.0,-2400.0
<a href=/player/alusg101>alusg101</a>,George Alusik,Kansas City Athletics,ATLTCS,1,1,1,2,1965,1965,0,No,0,0.0,0.0,0.0,0,0,0,0,0,0,0.0,0.0,0.0,0.0,0.0,0.0
<a href=/player/alvad001>alvad001</a>,Dario Alvarez,Atlanta Braves,BRAVES,2,4,2,6,2016,2021,5,No,0,-1.23,0.82,2.05,102,117,15,219,0,-219,140.0,208.0,68.0,0.0,0.0,0.0
<a href=/player/alvag001>alvag001</a>,Gabe Alvarez,Arizona Diamondbacks,DBACKS,2,6,2,8,1997,2003,6,No,0,6.66,8.29,1.63,875,595,-280,3219,2462,-757,172.0,0.0,-172.0,0.0,0.0,0.0
<a href=/player/alvag001>alvag001</a>,Gabe Alvarez,Detroit Tigers,TIGRS,1,1,1,2,2000,2000,0,No,0,-0.25,0.34,0.59,11,18,7,14,18,4,0.0,0.0,0.0,0.0,0.0,0.0
<a href=/player/alvah001>alvah001</a>,Henderson Alvarez,Toronto Blue Jays,BJAYS,3,15,11,26,2012,2018,6,No,0,24.75,21.38,-3.37,2099,1087,-1012,5739,3162,-2577,4668.0,4579.0,-89.0,8732900.0,0.0,-8732900.0
<a href=/player/alvaj001>alvaj001</a>,Jose Alvarez,Atlanta Braves,BRAVES,2,2,2,4,1984,1984,0,No,0,0.14,0.0,-0.14,70,0,-70,5,0,-5,155.0,0.0,-155.0,0.0,0.0,0.0
<a href=/player/alvaj003>alvaj003</a>,Jose Alvarez,Boston Red Sox,RSOX,1,2,1,3,2009,2010,1,No,0,0.08,-0.48,-0.56,6,52,46,0,171,171,5.0,0.0,-5.0,400000.0,0.0,-400000.0
<a href=/player/alvaj003>alvaj003</a>,Jose Alvarez,Detroit Tigers,TIGRS,1,1,1,2,2014,2017,3,No,0,2.37,0.81,-1.56,286,439,153,1,1018,1017,710.0,8.0,-702.0,0.0,0.0,0.0
<a href=/player/alvaj003>alvaj003</a>,Jose Alvarez,Anaheim Angels,ANGELS,1,1,1,2,2018,2019,1,No,0,1.13,0.16,-0.97,137,69,-68,0,0,0,196.0,186.0,-10.0,1050000.0,0.0,-1050000.0
<a href=/player/alvaj004>alvaj004</a>,Jose Alvarado,Tampa Bay Devil Rays,RAYS,1,1,2,3,2020,2020,0,Yes,0,0.33,0.0,-0.33,123,0,-123,0,0,0,167.0,0.0,-167.0,0.0,0.0,0.0
<a href=/player/alval101>alval101</a>,Luis Alvarado,Boston Red Sox,RSOX,1,2,1,3,1970,1974,4,No,0,-1.93,4.15,6.08,599,367,-232,1963,1576,-387,0.0,0.0,0.0,69000.0,0.0,-69000.0
<a href=/player/alval101>alval101</a>,Luis Alvarado,Chicago White Sox,WSOX,1,1,1,2,1974,1974,0,No,0,-0.35,0.12,0.47,33,11,-22,85,1,-84,0.0,62.0,62.0,20000.0,0.0,-20000.0
<a href=/player/alval101>alval101</a>,Luis Alvarado,St. Louis Cardinals,CARDS,5,7,6,13,1974,1977,3,No,0,-2.01,-0.59,1.42,565,81,-484,1331,100,-1231,66.0,23.0,-43.0,0.0,0.0,0.0
<a href=/player/alval101>alval101</a>,Luis Alvarado,Cleveland Indians,INDINS,2,3,2,5,1975,1978,3,No,0,1.75,-1.29,-3.04,221,75,-146,802,99,-703,0.0,442.0,442.0,0.0,0.0,0.0
<a href=/player/alvao101>alvao101</a>,Ossie Alvarez,Washington Senators,TWINS,1,1,1,2,1958,1959,1,No,0,0.0,-0.32,-0.32,0,37,37,0,121,121,0.0,0.0,0.0,0.0,0.0,0.0
<a href=/player/alvao101>alvao101</a>,Ossie Alvarez,Cleveland Indians,INDINS,4,8,7,15,1958,1965,7,No,0,18.0,1.46,-16.54,1595,479,-1116,4009,1716,-2293,3556.0,132.0,-3424.0,7500.0,0.0,-7500.0
<a href=/player/alvao102>alvao102</a>,Orlando Alvarez,Los Angeles Dodgers,DOGRS,1,2,1,3,1976,1977,1,No,0,-0.34,0.1,0.44,15,36,21,42,90,48,0.0,0.0,0.0,0.0,0.0,0.0
<a href=/player/alvar001>alvar001</a>,R.J. Alvarez,Anaheim Angels,ANGELS,2,6,4,10,2014,2017,3,No,0,-0.93,3.94,4.87,94,402,308,26,948,922,108.0,488.0,380.0,0.0,0.0,0.0
<a href=/player/alvar001>alvar001</a>,R.J. Alvarez,San Diego Padres,PADRS,2,3,4,7,2014,2019,5,Yes,0,-0.29,3.01,3.3,62,274,212,4,1017,1013,698.0,16.0,-682.0,2925000.0,0.0,-2925000.0
<a href=/player/alvar101>alvar101</a>,Rogelio Alvarez,Cincinnati Reds,REDS,1,1,1,2,1962,1963,1,No,0,0.0,-0.03,-0.03,0,1,1,0,1,1,0.0,0.0,0.0,0.0,0.0,0.0
<a href=/player/alvaw001>alvaw001</a>,Wilson Alvarez,Texas Rangers,RNGRS,3,5,6,11,1989,1992,3,No,0,24.82,3.73,-21.09,1170,237,-933,3620,767,-2853,3192.0,327.0,-2865.0,2411539.0,0.0,-2411539.0
<a href=/player/alvaw001>alvaw001</a>,Wilson Alvarez,Chicago White Sox,WSOX,7,14,18,32,1997,2011,14,No,0,8.23,24.04,15.81,946,1419,473,129,1458,1329,2956.0,3428.0,472.0,22052500.0,0.0,-22052500.0
<a href=/player/alvay001>alvay001</a>,Yordan Alvarez,Los Angeles Dodgers,DOGRS,1,1,1,2,2016,2019,3,No,0,6.87,1.94,-4.93,233,245,12,976,1,-975,0.0,352.0,352.0,0.0,0.0,0.0
<a href=/player/alvim101>alvim101</a>,Max Alvis,Cleveland Indians,INDINS,7,13,13,26,1970,1978,8,No,0,23.54,10.24,-13.3,1728,850,-878,4111,2770,-1341,2427.0,1183.0,-1244.0,83000.0,0.0,-83000.0
<a href=/player/alvob101>alvob101</a>,Billy Alvord,Toledo,Toledo,1,1,1,2,1889,1889,0,No,0,-0.4,0.0,0.4,50,0,-50,196,0,-196,0.0,0.0,0.0,0.0,0.0,0.0
<a href=/player/alyeb101>alyeb101</a>,Brant Alyea,Washington Senators,RNGRS,14,26,26,52,1970,1992,22,No,2,55.11,25.98,-29.13,3093,1946,-1147,6211,4755,-1456,9904.0,4656.0,-5248.0,229000.0,0.0,-229000.0
<a href=/player/alyeb101>alyeb101</a>,Brant Alyea,Oakland Athletics,ATLTCS,3,5,4,9,1972,1975,3,No,0,-3.4,1.69,5.09,461,363,-98,1348,687,-661,48.0,183.0,135.0,66000.0,0.0,-66000.0
<a href=/player/alyeb101>alyeb101</a>,Brant Alyea,Oakland Athletics,ATLTCS,1,2,1,3,1972,1977,5,No,0,0.0,3.91,3.91,0,223,223,0,1,1,0.0,1247.0,1247.0,36400.0,0.0,-36400.0
<a href=/player/amalj101>amalj101</a>,Joey Amalfitano,Houston Astros,ASTROS,5,9,8,17,1962,1965,3,No,0,7.58,1.73,-5.85,944,266,-678,2225,950,-1275,382.0,0.0,-382.0,0.0,0.0,0.0
<a href=/player/amara001>amara001</a>,Alexi Amarista,Anaheim Angels,ANGELS,2,3,2,5,2012,2014,2,No,0,0.27,1.16,0.89,644,214,-430,1673,0,-1673,125.0,563.0,438.0,481000.0,0.0,-481000.0
<a href=/player/amarr002>amarr002</a>,Ruben Amaro,California Angels,ANGELS,1,2,1,3,1991,1992,1,No,0,-0.16,-0.8,-0.64,519,94,-425,970,350,-620,485.0,0.0,-485.0,0.0,0.0,0.0
<a href=/player/amarr002>amarr002</a>,Ruben Amaro,Philadelphia Phillies,PHILS,3,5,5,10,1993,1999,6,No,0,1.62,1.73,0.11,274,527,253,302,176,-126,390.0,857.0,467.0,375000.0,0.0,-375000.0
<a href=/player/amarr101>amarr101</a>,Ruben Amaro,St. Louis Cardinals,CARDS,18,33,27,60,1958,1972,14,No,0,36.26,15.94,-20.32,4243,2613,-1630,10647,7952,-2695,2795.0,1167.0,-1628.0,49500.0,0.0,-49500.0
<a href=/player/amarr101>amarr101</a>,Ruben Amaro,Philadelphia Phillies,PHILS,2,2,2,4,1965,1967,2,No,0,-2.11,-0.67,1.44,293,94,-199,883,137,-746,0.0,0.0,0.0,20000.0,0.0,-20000.0
<a href=/player/amblw101>amblw101</a>,Wayne Ambler,New York Giants,GIANTS,1,1,1,2,1940,1940,0,No,0,0.0,0.0,0.0,0,0,0,0,0,0,0.0,0.0,0.0,0.0,0.0,0.0
<a href=/player/ambrc001>ambrc001</a>,Chip Ambres,Boston Red Sox,RSOX,1,2,1,3,2005,2006,1,No,0,-0.16,1.26,1.42,53,51,-2,167,200,33,0.0,0.0,0.0,0.0,0.0,0.0
<a href=/player/amesr101>amesr101</a>,Red Ames,New York Giants,GIANTS,1,4,1,5,1913,1913,0,No,0,44.86,-0.25,-45.11,1467,52,-1415,5586,39,-5547,1664.0,335.0,-1329.0,8100.0,0.0,-8100.0
<a href=/player/amess001>amess001</a>,Steve Ames,Los Angeles Dodgers,DOGRS,1,3,2,5,2013,2013,0,No,0,0.0,0.91,0.91,8,31,23,0,30,30,12.0,261.0,249.0,0.0,0.0,0.0
<a href=/player/ameza001>ameza001</a>,Alfredo Amezaga,Colorado Rockies,ROCKS,1,1,1,2,2011,2011,0,No,0,-0.56,0.0,0.56,20,0,-20,49,0,-49,0.0,0.0,0.0,0.0,0.0,0.0
<a href=/player/amold101>amold101</a>,Doc Amole,Baltimore Orioles,BLN,2,4,4,8,1897,1899,2,No,0,2.28,18.6,16.32,271,446,175,1095,1688,593,148.0,1122.0,974.0,0.0,0.0,0.0
<a href=/player/amors101>amors101</a>,Sandy Amoros,Los Angeles Dodgers,DOGRS,1,1,1,2,1960,1960,0,No,0,-0.38,0.0,0.38,65,0,-65,81,0,-81,0.0,0.0,0.0,0.0,0.0,0.0
<a href=/player/andea001>andea001</a>,Allan Anderson,Texas Rangers,RNGRS,1,2,1,3,1993,1993,0,No,0,0.0,0.0,0.0,0,0,0,0,0,0,0.0,0.0,0.0,0.0,0.0,0.0
<a href=/player/andea102>andea102</a>,Alf Anderson,Atlanta,Atlanta,1,1,1,2,1940,1940,0,No,0,-0.09,0.0,0.09,126,0,-126,430,0,-430,0.0,0.0,0.0,0.0,0.0,0.0
<a href=/player/andeb001>andeb001</a>,Brady Anderson,Boston Red Sox,RSOX,3,4,4,8,1988,2001,13,No,2,35.17,13.87,-21.3,1803,537,-1266,7464,1508,-5956,208.0,1586.0,1378.0,1112500.0,0.0,-1112500.0
<a href=/player/andeb002>andeb002</a>,Brian Anderson,California Angels,ANGELS,1,1,2,3,1996,1996,0,No,0,1.45,-0.79,-2.24,46,46,0,2,0,-2,742.0,488.0,-254.0,0.0,0.0,0.0
<a href=/player/andeb002>andeb002</a>,Brian Anderson,Cleveland Indians,INDINS,2,3,4,7,2003,2004,1,No,0,0.71,-0.61,-1.32,50,65,15,2,0,-2,739.0,235.0,-504.0,1500000.0,0.0,-1500000.0
<a href=/player/andeb003>andeb003</a>,Brian Anderson,Chicago White Sox,WSOX,1,1,1,2,2009,2010,1,No,0,-0.1,-0.65,-0.55,21,147,126,21,486,465,0.0,0.0,0.0,440000.0,0.0,-440000.0
<a href=/player/andeb004>andeb004</a>,Brett Anderson,Arizona Diamondbacks,DBACKS,6,14,16,30,2007,2018,11,Yes,0,24.99,30.17,5.18,855,1190,335,1319,2038,719,6760.0,6326.0,-434.0,14741000.0,0.0,-14741000.0
<a href=/player/andeb004>andeb004</a>,Brett Anderson,Oakland Athletics,ATLTCS,5,10,7,17,2013,2018,5,Yes,0,6.98,4.69,-2.29,626,433,-193,1007,1020,13,821.0,573.0,-248.0,10267500.0,0.0,-10267500.0
<a href=/player/andeb101>andeb101</a>,Bud Anderson,Seattle Mariners,MARNRS,1,3,1,4,1980,1981,1,No,0,2.1,-0.37,-2.47,64,83,19,0,269,269,447.0,0.0,-447.0,0.0,0.0,0.0
<a href=/player/andeb102>andeb102</a>,Bob Anderson,Chicago Cubs,CUBS,1,1,1,2,1962,1963,1,No,0,0.42,-0.24,-0.66,64,41,-23,9,104,95,180.0,0.0,-180.0,0.0,0.0,0.0
<a href=/player/andeb102>andeb102</a>,Bob Anderson,Detroit Tigers,TIGRS,4,6,6,12,1963,1972,9,No,0,7.82,5.86,-1.96,636,1217,581,727,2715,1988,1071.0,2815.0,1744.0,103000.0,0.0,-103000.0
<a href=/player/andec001>andec001</a>,Chase Anderson,Arizona Diamondbacks,DBACKS,2,7,4,11,2016,2019,3,Yes,0,30.63,10.0,-20.63,1052,220,-832,3757,754,-3003,1784.0,544.0,-1240.0,2600000.0,0.0,-2600000.0
<a href=/player/andec001>andec001</a>,Chase Anderson,Milwaukee Brewers,BREWRS,1,1,1,2,2019,2019,0,Yes,0,-0.44,0.0,0.44,10,0,-10,0,0,0,101.0,0.0,-101.0,6500000.0,0.0,-6500000.0
<a href=/player/anded101>anded101</a>,Dwain Anderson,Oakland Athletics,ATLTCS,2,2,2,4,1972,1974,2,No,0,-0.21,-0.58,-0.37,75,30,-45,165,26,-139,0.0,16.0,16.0,9600.0,0.0,-9600.0
<a href=/player/anded101>anded101</a>,Dwain Anderson,St. Louis Cardinals,CARDS,3,4,3,7,1973,1974,1,No,0,-1.33,-0.2,1.13,97,65,-32,163,91,-72,0.0,34.0,34.0,0.0,0.0,0.0
<a href=/player/anded101>anded101</a>,Dwain Anderson,San Diego Padres,PADRS,1,1,1,2,1973,1973,0,No,0,-0.03,0.0,0.03,2,0,-2,3,0,-3,0.0,0.0,0.0,0.0,0.0,0.0
<a href=/player/anded101>anded101</a>,Dwain Anderson,Cleveland Indians,INDINS,1,1,1,2,1974,1974,0,No,0,0.0,0.0,0.0,0,0,0,0,0,0,0.0,0.0,0.0,0.0,0.0,0.0
<a href=/player/andeh101>andeh101</a>,Harry Anderson,Philadelphia Phillies,PHILS,1,3,2,5,1960,1968,8,No,0,5.52,24.2,18.68,336,1274,938,998,4678,3680,0.0,0.0,0.0,0.0,0.0,0.0
<a href=/player/andeh102>andeh102</a>,Hal Anderson,Chicago White Sox,WSOX,1,1,2,3,1932,1932,0,No,0,0.0,0.0,0.0,0,0,0,0,0,0,0.0,0.0,0.0,4800.0,0.0,-4800.0
<a href=/player/andej001>andej001</a>,Jim Anderson,California Angels,ANGELS,1,1,1,2,1979,1981,2,No,0,0.29,-0.93,-1.22,186,51,-135,536,0,-536,0.0,274.0,274.0,0.0,0.0,0.0
<a href=/player/andej001>andej001</a>,Jim Anderson,Texas Rangers,RNGRS,1,2,1,3,1985,1991,6,No,0,2.79,7.32,4.53,107,694,587,87,2718,2631,806.0,0.0,-806.0,0.0,0.0,0.0
<a href=/player/andej002>andej002</a>,Jimmy Anderson,Chicago Cubs,CUBS,1,1,1,2,2004,2004,0,No,0,0.01,0.0,-0.01,6,0,-6,0,0,0,18.0,0.0,-18.0,0.0,0.0,0.0
<a href=/player/andej003>andej003</a>,Jason Anderson,New York Yankees,YANKS,2,4,2,6,2003,2003,0,No,0,0.35,0.36,0.01,27,33,6,0,0,0,75.0,81.0,6.0,300000.0,0.0,-300000.0
<a href=/player/andej004>andej004</a>,Josh Anderson,Houston Astros,ASTROS,1,1,1,2,2007,2008,1,No,0,1.24,-0.3,-1.54,40,68,28,146,1,-145,0.0,113.0,113.0,0.0,0.0,0.0
<a href=/player/andej004>andej004</a>,Josh Anderson,Atlanta Braves,BRAVES,1,1,1,2,2009,2009,0,No,0,-0.32,0.0,0.32,74,0,-74,175,0,-175,0.0,0.0,0.0,0.0,0.0,0.0
<a href=/player/andej101>andej101</a>,John Anderson,St.Louis Browns,ORLS,1,1,1,2,1903,1903,0,No,0,3.02,0.0,-3.02,175,0,-175,705,0,-705,0.0,0.0,0.0,0.0,0.0,0.0
<a href=/player/andej102>andej102</a>,John Anderson,St. Louis Cardinals,CARDS,2,5,4,9,1962,1965,3,No,0,0.93,8.59,7.66,640,305,-335,1722,489,-1233,727.0,472.0,-255.0,0.0,0.0,0.0
<a href=/player/andel001>andel001</a>,Larry Andersen,Cleveland Indians,INDINS,2,2,3,5,1979,1982,3,No,0,0.0,-1.05,-1.05,0,108,108,0,346,346,0.0,0.0,0.0,0.0,0.0,0.0
<a href=/player/andel001>andel001</a>,Larry Andersen,Pittsburgh Pirates,PIRATS,1,2,1,3,1980,1982,2,No,0,0.54,0.88,0.34,81,26,-55,0,13,13,442.0,163.0,-279.0,0.0,0.0,0.0
<a href=/player/andel001>andel001</a>,Larry Andersen,Houston Astros,ASTROS,1,1,1,2,1990,1990,0,No,0,1.24,0.0,-1.24,15,0,-15,0,0,0,66.0,0.0,-66.0,965000.0,0.0,-965000.0
<a href=/player/andel002>andel002</a>,Lars Anderson,Boston Red Sox,RSOX,1,1,1,2,2012,2019,7,No,0,0.0,3.15,3.15,0,87,87,0,6,6,0.0,1043.0,1043.0,482000.0,0.0,-482000.0
<a href=/player/andel002>andel002</a>,Lars Anderson,Cleveland Indians,INDINS,4,8,11,19,2012,2019,7,Yes,0,4.46,23.51,19.05,328,937,609,554,910,356,512.0,4479.0,3967.0,22963900.0,0.0,-22963900.0
<a href=/player/andel101>andel101</a>,Larry Anderson,Toronto Blue Jays,BJAYS,1,1,1,2,1977,1977,0,No,0,-0.58,-0.11,0.47,6,3,-3,0,5,5,26.0,0.0,-26.0,0.0,0.0,0.0
<a href=/player/andel101>andel101</a>,Larry Anderson,Chicago White Sox,WSOX,2,4,2,6,1977,1979,2,No,0,6.89,0.93,-5.96,401,36,-365,1175,0,-1175,453.0,349.0,-104.0,0.0,0.0,0.0
<a href=/player/andel101>andel101</a>,Larry Anderson,Chicago Cubs,CUBS,1,1,1,2,1978,1978,0,No,0,0.0,0.52,0.52,0,24,24,0,56,56,0.0,0.0,0.0,0.0,0.0,0.0
<a href=/player/andel101>andel101</a>,Larry Anderson,Baltimore Orioles,ORLS,1,3,2,5,1980,1980,0,No,0,0.0,0.0,0.0,0,0,0,0,0,0,0.0,0.0,0.0,0.0,0.0,0.0
<a href=/player/andem001>andem001</a>,Mike Anderson,Cincinnati Reds,REDS,2,4,2,6,1993,1996,3,No,0,1.51,1.69,0.18,53,302,249,0,11,11,157.0,464.0,307.0,817000.0,0.0,-817000.0
<a href=/player/andem003>andem003</a>,Marlon Anderson,Washington Nationals,NATEX,3,3,4,7,2006,2016,10,No,0,0.51,0.37,-0.14,150,256,106,369,568,199,0.0,26.0,26.0,925000.0,0.0,-925000.0
<a href=/player/andem101>andem101</a>,Mike Anderson,Philadelphia Phillies,PHILS,2,2,2,4,1975,1985,10,No,0,2.58,13.14,10.56,233,1026,793,400,231,-169,219.0,3397.0,3178.0,0.0,0.0,0.0
<a href=/player/anden001>anden001</a>,Nick Anderson,Minnesota Twins,TWINS,1,1,1,2,2018,2018,0,Yes,0,0.57,0.0,-0.57,86,0,-86,0,0,0,131.0,0.0,-131.0,0.0,0.0,0.0
<a href=/player/anden001>anden001</a>,Nick Anderson,Miami Marlins,MARLNS,1,2,2,4,2019,2020,1,Yes,0,1.9,-0.48,-2.38,73,53,-20,0,0,0,333.0,94.0,-239.0,1125000.0,0.0,-1125000.0
<a href=/player/ander001>ander001</a>,Rick Anderson,New York Mets,METS,11,23,20,43,1987,2005,18,No,0,11.67,39.4,27.73,1493,3560,2067,1978,7962,5984,3113.0,6312.0,3199.0,27998333.0,0.0,-27998333.0
<a href=/player/ander101>ander101</a>,Rick Anderson,New York Yankees,YANKS,7,17,13,30,1979,1992,13,No,0,39.2,19.95,-19.25,2768,1137,-1631,6569,3883,-2686,8301.0,701.0,-7600.0,913333.0,0.0,-913333.0
<a href=/player/andes001>andes001</a>,Scott Anderson,Texas Rangers,RNGRS,1,1,1,2,1988,1988,0,No,0,0.3,0.0,-0.3,8,0,-8,5,0,-5,54.0,0.0,-54.0,0.0,0.0,0.0
<a href=/player/andes002>andes002</a>,Shaun Anderson,Boston Red Sox,RSOX,1,2,1,3,2017,2019,2,No,0,-0.97,-1.55,-0.58,77,226,149,28,849,821,340.0,3.0,-337.0,0.0,0.0,0.0
<a href=/player/andes002>andes002</a>,Shaun Anderson,San Francisco Giants,GIANTS,1,1,1,2,2021,2021,0,Yes,0,-0.46,1.22,1.68,4,109,105,0,381,381,26.0,0.0,-26.0,0.0,0.0,0.0
<a href=/player/andes101>andes101</a>,Sparky Anderson,Los Angeles Dodgers,DOGRS,2,2,4,6,1958,1961,3,No,0,-1.37,-0.64,0.73,240,115,-125,704,120,-584,0.0,147.0,147.0,17000.0,0.0,-17000.0
<a href=/player/andet002>andet002</a>,Tyler Anderson,Pittsburgh Pirates,PIRATS,1,1,2,3,2021,2021,0,Yes,0,0.27,0.0,-0.27,14,0,-14,3,0,-3,191.0,0.0,-191.0,2500000.0,0.0,-2500000.0
<a href=/player/andet003>andet003</a>,Tanner Anderson,Pittsburgh Pirates,PIRATS,1,1,1,2,2018,2018,0,Yes,0,-0.22,0.0,0.22,6,0,-6,1,0,-1,67.0,0.0,-67.0,0.0,0.0,0.0
<a href=/player/andir001>andir001</a>,Robert Andino,Florida Marlins,MARLNS,1,1,1,2,2009,2010,1,No,0,3.07,-1.06,-4.13,360,32,-328,1223,2,-1221,0.0,66.0,66.0,0.0,0.0,0.0
<a href=/player/andir001>andir001</a>,Robert Andino,Baltimore Orioles,ORLS,1,1,1,2,2012,2013,1,No,0,-0.4,0.0,0.4,29,0,-29,85,0,-85,0.0,0.0,0.0,1300000.0,0.0,-1300000.0
<a href=/player/andir001>andir001</a>,Robert Andino,Seattle Mariners,MARNRS,1,1,1,2,2013,2013,0,No,0,0.0,0.0,0.0,0,0,0,0,0,0,0.0,0.0,0.0,0.0,0.0,0.0
<a href=/player/andrc001>andrc001</a>,Clayton Andrews,Toronto Blue Jays,BJAYS,1,2,1,3,2000,2002,2,No,0,0.0,0.91,0.91,0,36,36,0,6,6,0.0,543.0,543.0,0.0,0.0,0.0
<a href=/player/andre001>andre001</a>,Elvis Andrus,Atlanta Braves,BRAVES,4,8,6,14,2007,2009,2,No,1,51.72,9.48,-42.24,2314,404,-1910,8153,1445,-6708,2789.0,84.0,-2705.0,15385000.0,0.0,-15385000.0
<a href=/player/andre001>andre001</a>,Elvis Andrus,Texas Rangers,RNGRS,1,3,3,6,2021,2021,0,Yes,0,0.18,-0.26,-0.44,178,104,-74,635,346,-289,0.0,0.0,0.0,0.0,0.0,0.0
<a href=/player/andrf101>andrf101</a>,Fred Andrews,Philadelphia Phillies,PHILS,1,2,1,3,1978,1980,2,No,0,0.0,0.97,0.97,0,124,124,0,214,214,0.0,0.0,0.0,0.0,0.0,0.0
<a href=/player/andri101>andri101</a>,Ivy Andrews,New York Yankees,YANKS,1,3,1,4,1932,1934,2,No,0,4.01,-1.32,-5.33,261,128,-133,217,129,-88,1777.0,923.0,-854.0,12000.0,0.0,-12000.0
<a href=/player/andri101>andri101</a>,Ivy Andrews,Boston Red Sox,RSOX,2,5,2,7,1933,1936,3,No,0,13.03,1.41,-11.62,347,273,-74,502,1053,551,1631.0,0.0,-1631.0,28000.0,0.0,-28000.0
<a href=/player/andri101>andri101</a>,Ivy Andrews,St.Louis Browns,ORLS,12,23,32,55,1937,1952,15,No,0,55.87,54.37,-1.5,2736,6464,3728,7991,19515,11524,6789.0,12669.0,5880.0,129000.0,0.0,-129000.0
<a href=/player/andrj001>andrj001</a>,John Andreoli,San Francisco Giants,GIANTS,1,2,1,3,2019,2019,0,No,0,0.0,-0.32,-0.32,0,4,4,0,8,8,0.0,0.0,0.0,0.0,0.0,0.0
<a href=/player/andrj101>andrj101</a>,John Andrews,St. Louis Cardinals,CARDS,1,1,1,2,1973,1974,1,No,0,0.0,0.0,0.0,0,0,0,0,0,0,0.0,0.0,0.0,10000.0,0.0,-10000.0
<a href=/player/andrm001>andrm001</a>,Matt Andriese,San Diego Padres,PADRS,5,10,9,19,2014,2019,5,Yes,0,13.64,2.43,-11.21,896,526,-370,1526,1044,-482,2446.0,524.0,-1922.0,2925000.0,0.0,-2925000.0
<a href=/player/andrm001>andrm001</a>,Matt Andriese,Tampa Bay Devil Rays,RAYS,1,1,2,3,2018,2020,2,Yes,0,-0.97,0.68,1.65,133,84,-49,7,228,221,269.0,0.0,-269.0,0.0,0.0,0.0
<a href=/player/andrm001>andrm001</a>,Matt Andriese,Arizona Diamondbacks,DBACKS,1,1,1,2,2020,2021,1,No,0,0.6,0.01,-0.59,16,1,-15,0,0,0,96.0,1.0,-95.0,0.0,0.0,0.0
<a href=/player/andrm101>andrm101</a>,Mike Andrews,Boston Red Sox,RSOX,1,2,1,3,1970,1974,4,No,0,-1.93,4.15,6.08,599,367,-232,1963,1576,-387,0.0,0.0,0.0,69000.0,0.0,-69000.0
<a href=/player/andrn101>andrn101</a>,Nate Andrews,Cincinnati Reds,REDS,5,8,7,15,1942,1958,16,No,0,10.73,21.22,10.49,1014,1434,420,2886,5138,2252,2587.0,1210.0,-1377.0,0.0,0.0,0.0
<a href=/player/andrr101>andrr101</a>,Rob Andrews,Baltimore Orioles,ORLS,1,2,2,4,1974,1980,6,No,0,10.57,4.54,-6.03,1279,794,-485,5010,3158,-1852,0.0,0.0,0.0,16000.0,0.0,-16000.0
<a href=/player/andrr101>andrr101</a>,Rob Andrews,Houston Astros,ASTROS,3,4,5,9,1977,1989,12,No,0,-2.24,11.47,13.71,506,1255,749,1320,3239,1919,0.0,408.0,408.0,705000.0,0.0,-705000.0
<a href=/player/andrs101>andrs101</a>,Stan Andrews,Philadelphia Phillies,PHILS,1,2,1,3,1945,1946,1,No,0,0.0,-0.34,-0.34,0,6,6,0,20,20,0.0,0.0,0.0,0.0,0.0,0.0
<a href=/player/anduj001>anduj001</a>,Joaquin Andujar,Cincinnati Reds,REDS,1,1,2,3,1975,1976,1,No,0,3.32,0.0,-3.32,405,0,-405,279,0,-279,2580.0,0.0,-2580.0,0.0,0.0,0.0
<a href=/player/anduj001>anduj001</a>,Joaquin Andujar,Houston Astros,ASTROS,1,1,1,2,1981,1984,3,No,0,11.67,1.18,-10.49,325,292,-33,410,954,544,3231.0,0.0,-3231.0,0.0,0.0,0.0
<a href=/player/anduj001>anduj001</a>,Joaquin Andujar,St. Louis Cardinals,CARDS,3,3,5,8,1985,1992,7,No,0,17.92,0.16,-17.76,664,404,-260,1685,909,-776,2317.0,1412.0,-905.0,1718333.0,0.0,-1718333.0
<a href=/player/andul001>andul001</a>,Luis Andujar,Chicago White Sox,WSOX,1,2,2,4,1996,1998,2,No,0,-0.91,-1.48,-0.57,26,123,97,0,23,23,210.0,336.0,126.0,0.0,0.0,0.0
<a href=/player/angen101>angen101</a>,Norm Angelini,Kansas City Royals,ROYALS,1,3,2,5,1975,1976,1,No,0,1.17,0.35,-0.82,138,8,-130,32,0,-32,436.0,23.0,-413.0,0.0,0.0,0.0
<a href=/player/ankir001>ankir001</a>,Rick Ankiel,Kansas City Royals,ROYALS,1,2,3,5,2010,2016,6,No,0,-0.01,2.01,2.02,93,319,226,139,204,65,60.0,734.0,674.0,7250000.0,0.0,-7250000.0
<a href=/player/annad001>annad001</a>,Dean Anna,San Diego Padres,PADRS,1,1,1,2,2013,2013,0,Yes,0,0.12,0.0,-0.12,13,0,-13,25,0,-25,3.0,0.0,-3.0,0.0,0.0,0.0
<a href=/player/anthe001>anthe001</a>,Eric Anthony,Houston Astros,ASTROS,6,11,12,23,1993,2011,18,No,2,7.76,33.1,25.34,563,2499,1936,1619,5074,3455,1469.0,4907.0,3438.0,15790000.0,0.0,-15790000.0
<a href=/player/antoj101>antoj101</a>,John Antonelli,St. Louis Cardinals,CARDS,1,2,1,3,1945,1947,2,No,0,0.82,2.98,2.16,208,221,13,883,855,-28,0.0,0.0,0.0,0.0,0.0,0.0
<a href=/player/antoj103>antoj103</a>,Johnny Antonelli,Milwaukee Braves,BRAVES,2,8,3,11,1954,1960,6,No,0,39.41,8.38,-31.03,1145,621,-524,1887,2335,448,6059.0,0.0,-6059.0,0.0,0.0,0.0
<a href=/player/antoj103>antoj103</a>,Johnny Antonelli,San Francisco Giants,GIANTS,4,7,5,12,1960,1968,8,No,0,1.33,3.3,1.97,705,765,60,1946,2705,759,636.0,0.0,-636.0,33000.0,0.0,-33000.0
<a href=/player/aokin001>aokin001</a>,Nori Aoki,Milwaukee Brewers,BREWRS,3,3,4,7,2013,2021,8,No,0,4.33,0.59,-3.74,419,370,-49,577,31,-546,410.0,459.0,49.0,2000000.0,0.0,-2000000.0
<a href=/player/aokin001>aokin001</a>,Nori Aoki,Houston Astros,ASTROS,1,2,1,3,2017,2017,0,No,0,8.07,-0.16,-8.23,490,21,-469,1918,0,-1918,0.0,43.0,43.0,5500000.0,0.0,-5500000.0
<a href=/player/aparl101>aparl101</a>,Luis Aparicio,Chicago White Sox,WSOX,8,13,17,30,1963,1971,8,No,0,31.42,56.47,25.05,2785,3257,472,9290,8734,-556,740.0,2775.0,2035.0,72500.0,0.0,-72500.0
<a href=/player/aparl101>aparl101</a>,Luis Aparicio,Baltimore Orioles,ORLS,2,4,4,8,1967,1973,6,No,0,9.46,19.82,10.36,579,770,191,2185,2951,766,146.0,306.0,160.0,72000.0,0.0,-72000.0
<a href=/player/aparl101>aparl101</a>,Luis Aparicio,Chicago White Sox,WSOX,2,2,3,5,1970,1974,4,No,0,3.8,-1.81,-5.61,400,610,210,1661,1964,303,0.0,62.0,62.0,58000.0,0.0,-58000.0
<a href=/player/aponl001>aponl001</a>,Luis Aponte,Boston Red Sox,RSOX,1,1,2,3,1984,1984,0,No,0,0.34,0.0,-0.34,25,0,-25,0,0,0,151.0,0.0,-151.0,0.0,0.0,0.0
<a href=/player/aposs001>aposs001</a>,Sherten Apostel,Pittsburgh Pirates,PIRATS,1,2,1,3,2018,2020,2,No,0,-0.62,1.6,2.22,66,95,29,21,0,-21,366.0,141.0,-225.0,0.0,0.0,0.0
<a href=/player/appik001>appik001</a>,Kevin Appier,Kansas City Royals,ROYALS,2,2,4,6,1999,2002,3,No,0,2.45,1.1,-1.35,57,146,89,7,7,0,808.0,1368.0,560.0,5020000.0,0.0,-5020000.0
<a href=/player/appik001>appik001</a>,Kevin Appier,New York Mets,METS,1,1,1,2,2001,2001,0,No,0,1.49,0.0,-1.49,55,0,-55,9,0,-9,843.0,0.0,-843.0,8500000.0,0.0,-8500000.0
<a href=/player/applp101>applp101</a>,Pete Appleton,Cleveland Indians,INDINS,2,3,2,5,1932,1932,0,No,0,3.51,1.94,-1.57,352,36,-316,168,43,-125,1511.0,339.0,-1172.0,4500.0,0.0,-4500.0
<a href=/player/applp101>applp101</a>,Pete Appleton,Washington Senators,TWINS,5,8,6,14,1939,1946,7,No,0,15.27,0.38,-14.89,1887,491,-1396,7336,1848,-5488,270.0,315.0,45.0,42250.0,0.0,-42250.0
<a href=/player/applp101>applp101</a>,Pete Appleton,New York Yankees,YANKS,3,7,3,10,1933,1948,15,No,0,-3.37,1.52,4.89,613,291,-322,2436,971,-1465,0.0,0.0,0.0,9000.0,0.0,-9000.0
<a href=/player/aquig001>aquig001</a>,Greg Aquino,Arizona Diamondbacks,DBACKS,7,17,19,36,2006,2018,12,Yes,0,24.81,35.93,11.12,1150,1382,232,1829,2226,397,7355.0,7967.0,612.0,18358000.0,0.0,-18358000.0
<a href=/player/aquij001>aquij001</a>,Jayson Aquino,Colorado Rockies,ROCKS,1,1,1,2,2015,2015,0,Yes,0,0.0,0.0,0.0,0,0,0,0,0,0,0.0,0.0,0.0,0.0,0.0,0.0
<a href=/player/aquil001>aquil001</a>,Luis Aquino,Toronto Blue Jays,BJAYS,1,1,1,2,1987,1988,1,No,0,8.02,0.16,-7.86,114,66,-48,0,156,156,1390.0,0.0,-1390.0,0.0,0.0,0.0
<a href=/player/aquil001>aquil001</a>,Luis Aquino,Montreal Expos,NATEX,1,1,1,2,1995,1997,2,No,0,-0.63,0.0,0.63,10,0,-10,1,0,-1,15.0,0.0,-15.0,420000.0,0.0,-420000.0
<a href=/player/aranv001>aranv001</a>,Victor Arano,Los Angeles Dodgers,DOGRS,1,2,1,3,2014,2014,0,No,0,1.78,-0.44,-2.22,191,18,-173,89,15,-74,227.0,131.0,-96.0,0.0,0.0,0.0
<a href=/player/arauj001>arauj001</a>,Jonathan Arauz,Philadelphia Phillies,PHILS,2,3,6,9,2015,2021,6,Yes,0,1.74,5.44,3.7,212,305,93,3,183,180,772.0,1899.0,1127.0,519000.0,0.0,-519000.0
<a href=/player/archc001>archc001</a>,Chris Archer,Cleveland Indians,INDINS,2,4,3,7,2008,2013,5,No,0,-0.38,5.27,5.65,140,382,242,264,314,50,120.0,883.0,763.0,5500000.0,0.0,-5500000.0
<a href=/player/archc001>archc001</a>,Chris Archer,Chicago Cubs,CUBS,4,8,9,17,2011,2019,8,Yes,0,18.8,9.35,-9.45,836,1392,556,1720,408,-1312,3536.0,2716.0,-820.0,1500000.0,0.0,-1500000.0
<a href=/player/archc001>archc001</a>,Chris Archer,Tampa Bay Devil Rays,RAYS,1,1,3,4,2018,2018,0,Yes,0,1.43,0.42,-1.01,64,21,-43,58,26,-32,516.0,167.0,-349.0,0.0,0.0,0.0
<a href=/player/archg101>archg101</a>,George Archie,Detroit Tigers,TIGRS,1,5,1,6,1938,1952,14,No,0,0.0,25.69,25.69,0,589,589,0,728,728,0.0,4363.0,4363.0,11000.0,0.0,-11000.0
<a href=/player/archg101>archg101</a>,George Archie,Washington Senators,TWINS,2,4,2,6,1941,1943,2,No,0,8.38,6.04,-2.34,404,250,-154,1593,1022,-571,0.0,0.0,0.0,5000.0,0.0,-5000.0
<a href=/player/archj101>archj101</a>,Jim Archer,Baltimore Orioles,ORLS,4,11,7,18,1961,1973,12,No,0,20.55,30.35,9.8,1602,1797,195,5528,6131,603,845.0,306.0,-539.0,72000.0,0.0,-72000.0
<a href=/player/archm101>archm101</a>,Maurice Archdeacon,Chicago White Sox,WSOX,1,1,2,3,1925,1932,7,No,0,0.0,22.29,22.29,0,491,491,0,595,595,0.0,4665.0,4665.0,4800.0,0.0,-4800.0
<a href=/player/arcij101>arcij101</a>,Jose Arcia,San Diego Padres,PADRS,1,2,1,3,1971,1971,0,No,0,0.0,0.0,0.0,0,0,0,0,0,0,0.0,0.0,0.0,0.0,0.0,0.0
<a href=/player/arcio001>arcio001</a>,Oswaldo Arcia,Minnesota Twins,TWINS,1,1,1,2,2016,2016,0,No,0,-0.05,0.0,0.05,21,0,-21,61,0,-61,0.0,0.0,0.0,535000.0,0.0,-535000.0
<a href=/player/arcio002>arcio002</a>,Orlando Arcia,Milwaukee Brewers,BREWRS,1,1,2,3,2021,2021,0,No,0,-0.18,0.01,0.19,32,6,-26,78,0,-78,0.0,12.0,12.0,2000000.0,0.0,-2000000.0
<a href=/player/ardod001>ardod001</a>,Danny Ardoin,Oakland Athletics,ATLTCS,1,1,1,2,2000,2002,2,No,0,-0.17,-0.21,-0.04,15,37,22,40,79,39,0.0,0.0,0.0,0.0,0.0,0.0
<a href=/player/ardod001>ardod001</a>,Danny Ardoin,Washington Nationals,NATEX,1,1,1,2,2007,2007,0,No,0,0.0,0.0,0.0,0,0,0,0,0,0,0.0,0.0,0.0,0.0,0.0,0.0
<a href=/player/arenn001>arenn001</a>,Nolan Arenado,Colorado Rockies,ROCKS,1,1,5,6,2021,2021,0,Yes,0,4.14,0.69,-3.45,157,45,-112,653,42,-611,0.0,346.0,346.0,0.0,0.0,0.0
<a href=/player/ariaa001>ariaa001</a>,Alex Arias,Chicago Cubs,CUBS,1,2,1,3,1992,1993,1,No,0,1.43,0.32,-1.11,423,63,-360,1012,70,-942,0.0,573.0,573.0,116000.0,0.0,-116000.0
<a href=/player/ariaa001>ariaa001</a>,Alex Arias,San Diego Padres,PADRS,5,11,10,21,2001,2011,10,No,2,32.57,7.85,-24.72,553,890,337,877,2877,2000,4718.0,843.0,-3875.0,3727500.0,0.0,-3727500.0
<a href=/player/ariag001>ariag001</a>,George Arias,Anaheim Angels,ANGELS,1,3,1,4,1997,1997,0,No,0,-0.12,-0.13,-0.01,86,32,-54,233,144,-89,0.0,0.0,0.0,0.0,0.0,0.0
<a href=/player/ariaj001>ariaj001</a>,Joaquin Arias,New York Yankees,YANKS,1,2,2,4,2004,2016,12,No,0,3.52,53.95,50.43,392,1509,1117,1582,6520,4938,0.0,0.0,0.0,0.0,0.0,0.0
<a href=/player/ariaj001>ariaj001</a>,Joaquin Arias,Texas Rangers,RNGRS,1,1,2,3,2010,2010,0,No,0,-0.15,0.25,0.4,22,15,-7,33,56,23,0.0,0.0,0.0,402000.0,0.0,-402000.0
<a href=/player/arlis101>arlis101</a>,Steve Arlin,San Diego Padres,PADRS,1,1,2,3,1974,1978,4,No,0,-1.01,1.74,2.75,11,126,115,0,121,121,131.0,1043.0,912.0,0.0,0.0,0.0
<a href=/player/armat001>armat001</a>,Tony Armas,Pittsburgh Pirates,PIRATS,5,10,11,21,1977,1988,11,No,0,53.71,31.99,-21.72,2929,1675,-1254,9660,6568,-3092,5429.0,149.0,-5280.0,807000.0,0.0,-807000.0
<a href=/player/armat001>armat001</a>,Tony Armas,Oakland Athletics,ATLTCS,2,3,4,7,1982,1991,9,No,0,1.92,23.98,22.06,609,1229,620,2373,4812,2439,0.0,48.0,48.0,0.0,0.0,0.0
<a href=/player/armat002>armat002</a>,Tony Armas,New York Yankees,YANKS,1,2,2,4,1997,1997,0,No,0,0.0,0.17,0.17,0,28,28,0,103,103,0.0,0.0,0.0,0.0,0.0,0.0
<a href=/player/armat002>armat002</a>,Tony Armas,Boston Red Sox,RSOX,3,4,4,8,1997,2016,19,Yes,2,9.5,68.59,59.09,454,428,-26,432,36,-396,3841.0,7654.0,3813.0,13000000.0,0.0,-13000000.0
<a href=/player/armbe101>armbe101</a>,Ed Armbrister,Houston Astros,ASTROS,8,15,14,29,1971,1989,18,No,0,76.39,55.08,-21.31,4763,4769,6,15346,14810,-536,3810.0,5622.0,1812.0,705000.0,0.0,-705000.0
<a href=/player/armsj001>armsj001</a>,Jack Armstrong,Cincinnati Reds,REDS,3,5,4,9,1991,1999,8,No,2,-2.2,4.83,7.03,60,162,102,0,279,279,839.0,641.0,-198.0,215000.0,0.0,-215000.0
<a href=/player/armsm001>armsm001</a>,Mike Armstrong,Cincinnati Reds,REDS,1,1,1,2,1979,1979,0,No,0,-0.76,0.0,0.76,42,0,-42,3,0,-3,79.0,0.0,-79.0,0.0,0.0,0.0
<a href=/player/armsm001>armsm001</a>,Mike Armstrong,Kansas City Royals,ROYALS,1,2,2,4,1983,1986,3,No,0,0.96,2.85,1.89,53,424,371,0,1712,1712,233.0,0.0,-233.0,0.0,0.0,0.0
<a href=/player/armss001>armss001</a>,Shawn Armstrong,Cleveland Indians,INDINS,1,1,1,2,2017,2017,0,No,0,0.35,0.0,-0.35,19,0,-19,0,0,0,55.0,0.0,-55.0,535700.0,0.0,-535700.0
<a href=/player/arndh101>arndh101</a>,Harry Arndt,Louisville,Louisville,2,2,4,6,1905,1910,5,No,0,-0.59,0.0,0.59,21,0,-21,69,0,-69,0.0,0.0,0.0,0.0,0.0,0.0
<a href=/player/arndl001>arndl001</a>,Larry Arndt,Oakland Athletics,ATLTCS,1,1,1,2,1991,1991,0,No,0,0.0,0.0,0.0,0,0,0,0,0,0,0.0,0.0,0.0,0.0,0.0,0.0
<a href=/player/arnoj001>arnoj001</a>,Jamie Arnold,Los Angeles Dodgers,DOGRS,1,3,1,4,2000,2000,0,No,0,-0.56,-0.49,0.07,24,18,-6,10,13,3,98.0,120.0,22.0,0.0,0.0,0.0
<a href=/player/arnom101>arnom101</a>,Morrie Arnovich,Philadelphia Phillies,PHILS,1,1,1,2,1940,1941,1,No,0,0.41,2.66,2.25,62,202,140,226,672,446,0.0,0.0,0.0,0.0,0.0,0.0
<a href=/player/arnsb001>arnsb001</a>,Brad Arnsberg,New York Yankees,YANKS,2,2,3,5,1987,1992,5,No,0,11.66,5.12,-6.54,555,268,-287,1624,750,-874,361.0,266.0,-95.0,718000.0,0.0,-718000.0
<a href=/player/arnto101>arnto101</a>,Orie Arntzen,Cleveland Indians,INDINS,1,1,1,2,1940,1940,0,No,0,0.18,0.0,-0.18,64,0,-64,54,0,-54,493.0,0.0,-493.0,0.0,0.0,0.0
<a href=/player/arnto101>arnto101</a>,Orie Arntzen,Philadelphia Athletics,ATLTCS,40,86,82,168,1943,1976,33,No,0,92.78,72.86,-19.92,10628,9822,-806,25815,30088,4273,12609.0,8822.0,-3787.0,510800.0,0.0,-510800.0
<a href=/player/aro-j001>aro-j001</a>,Jonathan Aro,Boston Red Sox,RSOX,2,3,3,6,2015,2019,4,Yes,0,1.53,0.12,-1.41,94,36,-58,9,0,-9,632.0,95.0,-537.0,3666000.0,0.0,-3666000.0
<a href=/player/arocr001>arocr001</a>,Rene Arocha,St. Louis Cardinals,CARDS,2,2,2,4,1997,2005,8,No,1,-0.71,0.34,1.05,12,227,215,1,521,520,31.0,73.0,42.0,0.0,0.0,0.0
<a href=/player/arozr001>arozr001</a>,Randy Arozarena,St. Louis Cardinals,CARDS,1,3,3,6,2020,2020,0,Yes,0,5.13,0.0,-5.13,188,0,-188,756,0,-756,0.0,0.0,0.0,0.0,0.0,0.0
<a href=/player/arrig101>arrig101</a>,Gerry Arrigo,Minnesota Twins,TWINS,3,3,5,8,1964,1974,10,No,0,2.72,24.52,21.8,336,1245,909,505,4929,4424,1317.0,136.0,-1181.0,63500.0,0.0,-63500.0
<a href=/player/arrig101>arrig101</a>,Gerry Arrigo,Cincinnati Reds,REDS,2,2,2,4,1969,1971,2,No,0,-1.46,0.08,1.54,62,102,40,73,120,47,40.0,0.0,-40.0,21500.0,0.0,-21500.0
<a href=/player/arrig101>arrig101</a>,Gerry Arrigo,Cincinnati Reds,REDS,1,1,2,3,1966,1966,0,No,0,0.78,0.0,-0.78,34,0,-34,12,0,-12,130.0,0.0,-130.0,0.0,0.0,0.0
<a href=/player/arrij001>arrij001</a>,Jake Arrieta,Baltimore Orioles,ORLS,2,4,4,8,2013,2019,6,No,0,26.47,2.52,-23.95,1116,493,-623,389,1879,1490,3793.0,272.0,-3521.0,514000.0,0.0,-514000.0
<a href=/player/arrob001>arrob001</a>,Bronson Arroyo,Boston Red Sox,RSOX,4,7,5,12,2006,2018,12,No,2,17.68,-0.07,-17.75,761,219,-542,1172,592,-580,5284.0,41.0,-5243.0,2275000.0,0.0,-2275000.0
<a href=/player/arrob001>arrob001</a>,Bronson Arroyo,Arizona Diamondbacks,DBACKS,2,3,2,5,2015,2017,2,Yes,0,-1.46,1.06,2.52,118,146,28,80,316,236,435.0,0.0,-435.0,0.0,0.0,0.0
<a href=/player/arrob001>arrob001</a>,Bronson Arroyo,Atlanta Braves,BRAVES,3,7,11,18,2015,2020,5,Yes,0,4.88,-1.29,-6.17,588,465,-123,687,1320,633,1642.0,246.0,-1396.0,24400000.0,0.0,-24400000.0
<a href=/player/arroc001>arroc001</a>,Christian Arroyo,San Francisco Giants,GIANTS,1,4,2,6,2017,2017,0,Yes,0,1.25,0.0,-1.25,79,0,-79,289,0,-289,0.0,0.0,0.0,11000000.0,0.0,-11000000.0
<a href=/player/arroc001>arroc001</a>,Christian Arroyo,Tampa Bay Devil Rays,RAYS,1,2,2,4,2019,2019,0,Yes,0,0.02,0.0,-0.02,21,0,-21,0,0,0,49.0,0.0,-49.0,0.0,0.0,0.0
<a href=/player/arrof001>arrof001</a>,Fernando Arroyo,Detroit Tigers,TIGRS,1,1,1,2,1979,1979,0,No,0,1.41,0.0,-1.41,50,0,-50,0,0,0,703.0,0.0,-703.0,0.0,0.0,0.0
<a href=/player/arrol101>arrol101</a>,Luis Arroyo,St. Louis Cardinals,CARDS,1,1,1,2,1956,1956,0,No,0,-0.66,-0.24,0.42,146,10,-136,40,1,-39,478.0,17.0,-461.0,0.0,0.0,0.0
<a href=/player/arrol101>arrol101</a>,Luis Arroyo,Pittsburgh Pirates,PIRATS,1,1,1,2,1958,1958,0,No,0,-0.2,0.0,0.2,20,0,-20,2,0,-2,41.0,0.0,-41.0,0.0,0.0,0.0
<a href=/player/arrol101>arrol101</a>,Luis Arroyo,Cincinnati Reds,REDS,1,3,2,5,1960,1960,0,No,0,3.11,0.0,-3.11,276,0,-276,63,0,-63,598.0,0.0,-598.0,0.0,0.0,0.0
<a href=/player/arror001>arror001</a>,Rolando Arrojo,Tampa Bay Devil Rays,RAYS,1,2,1,3,1999,2001,2,No,0,-0.33,-0.6,-0.27,69,109,40,75,451,376,304.0,0.0,-304.0,477500.0,0.0,-477500.0
<a href=/player/arror001>arror001</a>,Rolando Arrojo,Colorado Rockies,ROCKS,7,13,12,25,2000,2002,2,No,0,6.04,1.37,-4.67,876,433,-443,660,150,-510,2239.0,928.0,-1311.0,9375000.0,0.0,-9375000.0
<a href=/player/arror101>arror101</a>,Rudy Arroyo,St. Louis Cardinals,CARDS,5,7,6,13,1972,1977,5,No,0,20.99,-1.61,-22.6,875,118,-757,2900,9,-2891,1249.0,251.0,-998.0,47500.0,0.0,-47500.0
<a href=/player/asadr001>asadr001</a>,Randy Asadoor,Texas Rangers,RNGRS,1,1,1,2,1985,1985,0,No,0,0.27,0.0,-0.27,15,0,-15,60,0,-60,0.0,0.0,0.0,0.0,0.0,0.0
<a href=/player/ascaj001>ascaj001</a>,Jose Ascanio,Atlanta Braves,BRAVES,2,3,3,6,2007,2014,7,No,0,6.73,9.57,2.84,1059,962,-97,992,3068,2076,1047.0,176.0,-871.0,2225000.0,0.0,-2225000.0
<a href=/player/ascaj001>ascaj001</a>,Jose Ascanio,Chicago Cubs,CUBS,2,4,5,9,2009,2013,4,No,0,14.85,0.73,-14.12,1031,310,-721,3072,59,-3013,719.0,863.0,144.0,405000.0,0.0,-405000.0
<a href=/player/asenm001>asenm001</a>,Miguel Asencio,Colorado Rockies,ROCKS,1,2,3,5,2006,2010,4,No,0,-0.73,4.59,5.32,38,489,451,30,1012,982,297.0,873.0,576.0,4500000.0,0.0,-4500000.0
<a href=/player/ashba001>ashba001</a>,Alan Ashby,Cleveland Indians,INDINS,1,2,1,3,1976,1978,2,No,0,1.98,-0.52,-2.5,205,36,-169,757,0,-757,0.0,442.0,442.0,0.0,0.0,0.0
<a href=/player/ashba001>ashba001</a>,Alan Ashby,Toronto Blue Jays,BJAYS,1,1,3,4,1978,1982,4,No,0,7.9,-1.25,-9.15,965,29,-936,3318,9,-3309,0.0,249.0,249.0,0.0,0.0,0.0
<a href=/player/ashba002>ashba002</a>,Andy Ashby,Colorado Rockies,ROCKS,1,3,2,5,1993,1994,1,No,0,28.53,-1.48,-30.01,973,90,-883,1500,70,-1430,4150.0,636.0,-3514.0,150000.0,0.0,-150000.0
<a href=/player/ashba002>ashba002</a>,Andy Ashby,San Diego Padres,PADRS,10,22,23,45,1999,2021,22,Yes,0,50.39,35.68,-14.71,2323,2114,-209,7874,5307,-2567,1816.0,6592.0,4776.0,20585200.0,0.0,-20585200.0
<a href=/player/ashba002>ashba002</a>,Andy Ashby,Philadelphia Phillies,PHILS,2,3,4,7,2000,2003,3,No,0,1.01,1.86,0.85,55,250,195,58,64,6,475.0,810.0,335.0,6200000.0,0.0,-6200000.0
<a href=/player/ashbr101>ashbr101</a>,Richie Ashburn,Philadelphia Phillies,PHILS,3,4,5,9,1960,1964,4,No,0,10.16,6.52,-3.64,727,567,-160,1672,1669,-3,2599.0,1208.0,-1391.0,0.0,0.0,0.0
<a href=/player/ashea001>ashea001</a>,Alec Asher,Texas Rangers,RNGRS,5,14,16,30,2015,2021,6,Yes,0,11.03,13.28,2.25,790,293,-497,1664,16,-1648,2536.0,2164.0,-372.0,3762500.0,0.0,-3762500.0
<a href=/player/ashea001>ashea001</a>,Alec Asher,Philadelphia Phillies,PHILS,1,1,1,2,2017,2017,0,No,0,0.0,0.0,0.0,26,0,-26,1,0,-1,180.0,0.0,-180.0,0.0,0.0,0.0
<a href=/player/ashft001>ashft001</a>,Tucker Ashford,San Diego Padres,PADRS,4,8,6,14,1980,1984,4,No,0,16.75,2.24,-14.51,1038,424,-614,3623,1747,-1876,529.0,0.0,-529.0,0.0,0.0,0.0
<a href=/player/ashft001>ashft001</a>,Tucker Ashford,Texas Rangers,RNGRS,1,2,1,3,1980,1980,0,No,0,-0.01,0.0,0.01,3,0,-3,0,0,0,0.0,0.0,0.0,0.0,0.0,0.0
<a href=/player/ashft001>ashft001</a>,Tucker Ashford,New York Yankees,YANKS,1,1,2,3,1983,1983,0,No,0,-0.35,0.0,0.35,35,0,-35,63,0,-63,0.0,0.0,0.0,0.0,0.0,0.0
<a href=/player/ashft001>ashft001</a>,Tucker Ashford,New York Mets,METS,15,23,25,48,1984,1999,15,No,1,42.44,12.02,-30.42,2771,1753,-1018,6235,1747,-4488,4175.0,4754.0,579.0,13614666.0,0.0,-13614666.0
<a href=/player/asprb101>asprb101</a>,Bob Aspromonte,Houston Astros,ASTROS,2,2,2,4,1968,1973,5,No,0,-1.08,-1.54,-0.46,153,213,60,364,475,111,0.0,2.0,2.0,35000.0,0.0,-35000.0
<a href=/player/asprb101>asprb101</a>,Bob Aspromonte,Atlanta Braves,BRAVES,1,1,1,2,1970,1972,2,No,0,-1.27,-0.11,1.16,104,50,-54,377,11,-366,0.0,155.0,155.0,0.0,0.0,0.0
<a href=/player/asprk101>asprk101</a>,Ken Aspromonte,Boston Red Sox,RSOX,3,3,4,7,1958,1960,2,No,0,-0.4,-0.52,-0.12,351,65,-286,1197,201,-996,0.0,26.0,26.0,0.0,0.0,0.0
<a href=/player/asprk101>asprk101</a>,Ken Aspromonte,Washington Senators,TWINS,1,1,1,2,1960,1961,1,No,0,2.45,-0.14,-2.59,159,68,-91,633,140,-493,0.0,0.0,0.0,0.0,0.0,0.0
<a href=/player/asprk101>asprk101</a>,Ken Aspromonte,Washington Senators,RNGRS,1,1,1,2,1960,1961,1,No,0,0.58,-0.75,-1.33,66,69,3,276,252,-24,0.0,0.0,0.0,0.0,0.0,0.0
<a href=/player/asprk101>asprk101</a>,Ken Aspromonte,Milwaukee Braves,BRAVES,1,1,1,2,1962,1962,0,No,0,0.03,0.0,-0.03,20,0,-20,38,0,-38,0.0,0.0,0.0,0.0,0.0,0.0
<a href=/player/assep001>assep001</a>,Paul Assenmacher,Atlanta Braves,BRAVES,4,5,5,10,1989,1999,10,No,0,5.35,0.43,-4.92,606,237,-369,109,498,389,1445.0,0.0,-1445.0,3565833.0,0.0,-3565833.0
<a href=/player/assep001>assep001</a>,Paul Assenmacher,Chicago Cubs,CUBS,1,1,1,2,1993,1995,2,No,0,0.43,0.73,0.3,26,123,97,0,388,388,52.0,0.0,-52.0,2665333.0,0.0,-2665333.0
<a href=/player/assep001>assep001</a>,Paul Assenmacher,New York Yankees,YANKS,1,1,1,2,1994,1997,3,No,0,0.85,0.92,0.07,44,58,14,0,0,0,99.0,336.0,237.0,0.0,0.0,0.0
<a href=/player/astae001>astae001</a>,Ezequiel Astacio,Philadelphia Phillies,PHILS,5,11,7,18,2003,2013,10,No,2,0.36,22.51,22.15,393,644,251,101,485,384,2150.0,4335.0,2185.0,8825000.0,0.0,-8825000.0
<a href=/player/astap001>astap001</a>,Pedro Astacio,Los Angeles Dodgers,DOGRS,7,11,13,24,1997,2013,16,No,2,13.46,20.79,7.33,1015,1937,922,2947,4811,1864,2898.0,2617.0,-281.0,15485000.0,0.0,-15485000.0
<a href=/player/astap001>astap001</a>,Pedro Astacio,Colorado Rockies,ROCKS,1,2,1,3,2001,2004,3,No,0,0.82,-2.27,-3.09,8,45,37,12,39,27,86.0,348.0,262.0,6850000.0,0.0,-6850000.0
<a href=/player/astib001>astib001</a>,Barrett Astin,Milwaukee Brewers,BREWRS,2,4,2,6,2014,2015,1,Yes,0,-0.1,-0.55,-0.45,292,98,-194,5,0,-5,440.0,141.0,-299.0,0.0,0.0,0.0
<a href=/player/asuac001>asuac001</a>,Carlos Asuaje,Boston Red Sox,RSOX,1,4,1,5,2015,2018,3,No,0,5.44,6.73,1.29,670,203,-467,2136,0,-2136,153.0,553.0,400.0,0.0,0.0,0.0
<a href=/player/athek001>athek001</a>,Keith Atherton,Oakland Athletics,ATLTCS,2,2,3,5,1986,1987,1,No,0,2.66,0.0,-2.66,159,0,-159,0,0,0,705.0,0.0,-705.0,183700.0,0.0,-183700.0
<a href=/player/athek001>athek001</a>,Keith Atherton,Minnesota Twins,TWINS,1,1,1,2,1989,1991,2,No,0,-0.06,-2.66,-2.6,32,167,135,0,395,395,117.0,0.0,-117.0,0.0,0.0,0.0
<a href=/player/atill001>atill001</a>,Luis Atilano,Atlanta Braves,BRAVES,1,1,1,2,2006,2006,0,No,0,-0.89,0.15,1.04,29,20,-9,27,27,0,257.0,0.0,-257.0,0.0,0.0,0.0
<a href=/player/atwet101>atwet101</a>,Toby Atwell,Brooklyn Dodgers,DOGRS,2,2,2,4,1951,1953,2,No,0,1.06,-0.26,-1.32,148,8,-140,517,9,-508,0.0,0.0,0.0,0.0,0.0,0.0
<a href=/player/atwet101>atwet101</a>,Toby Atwell,Chicago Cubs,CUBS,7,18,16,34,1953,1965,12,No,0,5.64,21.93,16.29,1405,1825,420,3839,2173,-1666,1451.0,4951.0,3500.0,82000.0,0.0,-82000.0
<a href=/player/atwet101>atwet101</a>,Toby Atwell,Pittsburgh Pirates,PIRATS,4,4,6,10,1956,1962,6,No,0,-0.33,0.42,0.75,123,127,4,369,338,-31,0.0,0.0,0.0,11000.0,0.0,-11000.0
<a href=/player/atwob101>atwob101</a>,Bill Atwood,Baltimore,Baltimore,1,1,1,2,1935,1935,0,No,0,-1.37,0.0,1.37,342,0,-342,1070,0,-1070,0.0,0.0,0.0,0.0,0.0,0.0
<a href=/player/atz-j101>atz-j101</a>,John Atz,Chicago White Sox,WSOX,2,8,2,10,1910,1928,18,No,0,0.0,33.7,33.7,0,1837,1837,0,6519,6519,0.0,0.0,0.0,0.0,0.0,0.0
<a href=/player/atz-j101>atz-j101</a>,John Atz,Cleveland Indians,INDINS,1,6,1,7,1913,1914,1,No,0,0.0,-0.98,-0.98,0,48,48,0,37,37,0.0,303.0,303.0,0.0,0.0,0.0
<a href=/player/auerr101>auerr101</a>,Rick Auerbach,Milwaukee Brewers,BREWRS,2,2,2,4,1973,1978,5,No,0,-0.65,-0.27,0.38,277,407,130,511,1228,717,0.0,0.0,0.0,111500.0,0.0,-111500.0
<a href=/player/auerr101>auerr101</a>,Rick Auerbach,Los Angeles Dodgers,DOGRS,1,1,2,3,1977,1977,0,No,0,0.0,0.2,0.2,0,10,10,0,0,0,0.0,24.0,24.0,0.0,0.0,0.0
<a href=/player/auerr101>auerr101</a>,Rick Auerbach,New York Mets,METS,1,2,1,3,1977,1979,2,No,0,0.0,5.03,5.03,0,268,268,0,1093,1093,0.0,0.0,0.0,0.0,0.0,0.0
<a href=/player/auerr101>auerr101</a>,Rick Auerbach,Texas Rangers,RNGRS,4,10,10,20,1980,1987,7,No,0,9.35,8.94,-0.41,686,425,-261,1581,631,-950,2721.0,2684.0,-37.0,817500.0,0.0,-817500.0
<a href=/player/augud001>augud001</a>,Don August,Houston Astros,ASTROS,2,3,2,5,1986,1990,4,No,1,4.82,13.16,8.34,196,416,220,0,208,208,2588.0,2180.0,-408.0,0.0,0.0,0.0
<a href=/player/augud101>augud101</a>,Dave Augustine,Pittsburgh Pirates,PIRATS,1,1,1,2,1978,1978,0,No,0,0.0,0.0,0.0,0,0,0,0,0,0,0.0,0.0,0.0,0.0,0.0,0.0
<a href=/player/aukee101>aukee101</a>,Elden Auker,Detroit Tigers,TIGRS,1,3,2,5,1938,1946,8,No,0,-0.33,15.76,16.09,102,1005,903,69,3681,3612,596.0,671.0,75.0,19500.0,0.0,-19500.0
<a href=/player/aumop001>aumop001</a>,Phillippe Aumont,Seattle Mariners,MARNRS,6,11,9,20,2009,2014,5,No,0,2.34,8.64,6.3,470,811,341,626,2617,1991,956.0,1416.0,460.0,10564000.0,0.0,-10564000.0
<a href=/player/aurir001>aurir001</a>,Rich Aurilia,Texas Rangers,RNGRS,1,2,1,3,1994,1995,1,No,0,14.18,0.0,-14.18,1333,0,-1333,5009,0,-5009,0.0,0.0,0.0,0.0,0.0,0.0
<a href=/player/ausmb001>ausmb001</a>,Brad Ausmus,Colorado Rockies,ROCKS,1,3,2,5,1993,1994,1,No,0,28.53,-1.48,-30.01,973,90,-883,1500,70,-1430,4150.0,636.0,-3514.0,150000.0,0.0,-150000.0
<a href=/player/ausmb001>ausmb001</a>,Brad Ausmus,San Diego Padres,PADRS,5,8,9,17,1996,2006,10,No,1,4.5,17.6,13.1,1037,1883,846,3956,6307,2351,0.0,1106.0,1106.0,11375000.0,0.0,-11375000.0
<a href=/player/ausmb001>ausmb001</a>,Brad Ausmus,Detroit Tigers,TIGRS,6,13,15,28,1996,2010,14,No,1,13.89,24.32,10.43,4127,1434,-2693,10052,2196,-7856,4562.0,6757.0,2195.0,11529000.0,0.0,-11529000.0
<a href=/player/ausmb001>ausmb001</a>,Brad Ausmus,Houston Astros,ASTROS,1,2,5,7,1999,2001,2,No,0,6.68,0.38,-6.3,481,94,-387,1132,260,-872,710.0,103.0,-607.0,0.0,0.0,0.0
<a href=/player/ausmb001>ausmb001</a>,Brad Ausmus,Detroit Tigers,TIGRS,2,4,4,8,2000,2002,2,No,1,3.02,0.94,-2.08,1389,171,-1218,3537,610,-2927,741.0,454.0,-287.0,5550000.0,0.0,-5550000.0
<a href=/player/austj001>austj001</a>,Jim Austin,San Diego Padres,PADRS,1,2,1,3,1989,1989,0,No,0,2.11,-0.17,-2.28,83,14,-69,0,0,0,300.0,19.0,-281.0,0.0,0.0,0.0
<a href=/player/austj002>austj002</a>,Jeff Austin,Kansas City Royals,ROYALS,1,2,2,4,2003,2003,0,No,0,-0.36,0.0,0.36,139,0,-139,11,0,-11,223.0,0.0,-223.0,0.0,0.0,0.0
<a href=/player/austj101>austj101</a>,Jimmy Austin,New York Yankees,YANKS,1,2,2,4,1911,1911,0,No,0,24.82,2.99,-21.83,1527,144,-1383,6167,615,-5552,0.0,0.0,0.0,0.0,0.0,0.0
<a href=/player/austt001>austt001</a>,Tyler Austin,New York Yankees,YANKS,1,2,2,4,2018,2018,0,No,0,0.29,0.32,0.03,37,12,-25,141,2,-139,0.0,163.0,163.0,0.0,0.0,0.0
<a href=/player/austt001>austt001</a>,Tyler Austin,Minnesota Twins,TWINS,1,1,1,2,2019,2019,0,Yes,0,0.33,0.0,-0.33,70,0,-70,147,0,-147,0.0,0.0,0.0,0.0,0.0,0.0
<a href=/player/autra101>autra101</a>,Al Autry,Kansas City Royals,ROYALS,1,3,2,5,1975,1976,1,No,0,1.17,0.35,-0.82,138,8,-130,32,0,-32,436.0,23.0,-413.0,0.0,0.0,0.0
<a href=/player/autrc101>autrc101</a>,Chick Autry,Lynn,Lynn,1,1,1,2,1909,1909,0,No,0,-0.66,0.0,0.66,65,0,-65,234,0,-234,0.0,0.0,0.0,0.0,0.0,0.0
<a href=/player/autrc102>autrc102</a>,Chick Autry,Cleveland Indians,INDINS,1,1,1,2,1929,1929,0,No,0,-0.79,2.38,3.17,77,125,48,178,489,311,0.0,0.0,0.0,0.0,0.0,0.0
<a href=/player/avela001>avela001</a>,Abiatal Avelino,New York Yankees,YANKS,1,2,2,4,2018,2018,0,No,0,-0.04,0.93,0.97,10,25,15,19,114,95,0.0,0.0,0.0,0.0,0.0,0.0
<a href=/player/avenb001>avenb001</a>,Bruce Aven,Florida Marlins,MARLNS,2,2,2,4,1999,2002,3,No,0,-0.36,2.72,3.08,72,108,36,153,146,-7,0.0,632.0,632.0,515000.0,0.0,-515000.0
<a href=/player/avenb001>avenb001</a>,Bruce Aven,Cleveland Indians,INDINS,1,1,1,2,2002,2002,0,No,0,0.0,0.0,0.0,0,0,0,0,0,0,0.0,0.0,0.0,0.0,0.0,0.0
<a href=/player/avere101>avere101</a>,Earl Averill,Cleveland Indians,INDINS,1,1,2,3,1939,1946,7,No,0,0.45,4.92,4.47,151,206,55,490,69,-421,0.0,771.0,771.0,0.0,0.0,0.0
<a href=/player/avere102>avere102</a>,Earl Averill,Cleveland Indians,INDINS,2,4,3,7,1959,1960,1,No,0,-1.11,0.25,1.36,167,69,-98,374,39,-335,7.0,147.0,140.0,0.0,0.0,0.0
<a href=/player/avere102>avere102</a>,Earl Averill,Chicago Cubs,CUBS,1,2,1,3,1960,1961,1,No,0,0.0,2.07,2.07,0,150,150,0,479,479,0.0,0.0,0.0,0.0,0.0,0.0
<a href=/player/avere102>avere102</a>,Earl Averill,Milwaukee Braves,BRAVES,1,1,2,3,1960,1960,0,No,0,0.03,0.0,-0.03,10,0,-10,18,0,-18,0.0,0.0,0.0,0.0,0.0,0.0
<a href=/player/avere102>avere102</a>,Earl Averill,Los Angeles Angels,ANGELS,2,2,2,4,1962,1963,1,No,0,0.4,0.59,0.19,47,60,13,83,227,144,0.0,0.0,0.0,0.0,0.0,0.0
<a href=/player/averx001>averx001</a>,Xavier Avery,Baltimore Orioles,ORLS,1,1,1,2,2013,2013,0,No,0,0.0,-0.49,-0.49,0,12,12,0,30,30,0.0,0.0,0.0,0.0,0.0,0.0
<a href=/player/avila001>avila001</a>,Alex Avila,Detroit Tigers,TIGRS,1,2,3,5,2017,2017,0,Yes,0,1.19,0.18,-1.01,218,27,-191,113,106,-7,217.0,0.0,-217.0,4700000.0,0.0,-4700000.0
<a href=/player/avilb101>avilb101</a>,Bobby Avila,Cleveland Indians,INDINS,1,1,2,3,1958,1961,3,No,0,-0.65,0.11,0.76,20,12,-8,51,1,-50,0.0,30.0,30.0,20000.0,0.0,-20000.0
<a href=/player/avill001>avill001</a>,Luis Avilan,Atlanta Braves,BRAVES,3,7,11,18,2015,2020,5,Yes,0,4.88,-1.29,-6.17,588,465,-123,687,1320,633,1642.0,246.0,-1396.0,24400000.0,0.0,-24400000.0
<a href=/player/avill001>avill001</a>,Luis Avilan,Los Angeles Dodgers,DOGRS,1,4,2,6,2018,2021,3,Yes,0,0.31,0.86,0.55,61,242,181,1,6,5,119.0,333.0,214.0,0.0,0.0,0.0
<a href=/player/avill001>avill001</a>,Luis Avilan,Chicago White Sox,WSOX,1,1,1,2,2018,2018,0,Yes,0,0.21,0.0,-0.21,23,0,-23,0,0,0,17.0,0.0,-17.0,2450000.0,0.0,-2450000.0
<a href=/player/avilm001>avilm001</a>,Mike Aviles,Kansas City Royals,ROYALS,3,3,5,8,2011,2016,5,Yes,0,2.16,-0.51,-2.67,214,19,-195,709,26,-683,31.0,38.0,7.0,640000.0,0.0,-640000.0
<a href=/player/avilm001>avilm001</a>,Mike Aviles,Boston Red Sox,RSOX,1,1,2,3,2012,2012,0,No,0,0.0,0.0,0.0,0,0,0,0,0,0,0.0,0.0,0.0,1200000.0,0.0,-1200000.0
<a href=/player/avilm001>avilm001</a>,Mike Aviles,Toronto Blue Jays,BJAYS,1,2,1,3,2012,2014,2,No,0,11.57,-0.01,-11.58,944,66,-878,3396,7,-3389,0.0,475.0,475.0,0.0,0.0,0.0
<a href=/player/avilm001>avilm001</a>,Mike Aviles,Detroit Tigers,TIGRS,1,2,1,3,2016,2016,0,No,0,0.0,0.21,0.21,0,29,29,0,91,91,0.0,0.0,0.0,0.0,0.0,0.0
<a href=/player/avilp001>avilp001</a>,Pedro Avila,Washington Nationals,NATEX,1,1,1,2,2016,2017,1,No,0,0.31,0.0,-0.31,4,0,-4,3,0,-3,28.0,0.0,-28.0,0.0,0.0,0.0
<a href=/player/avilr101>avilr101</a>,Ramon Aviles,Philadelphia Phillies,PHILS,1,1,1,2,1981,1982,1,No,0,0.0,0.0,0.0,0,0,0,0,0,0,0.0,0.0,0.0,0.0,0.0,0.0
<a href=/player/axfoj001>axfoj001</a>,John Axford,Milwaukee Brewers,BREWRS,1,1,1,2,2013,2017,4,No,0,0.31,-0.23,-0.54,26,192,166,0,6,6,31.0,338.0,307.0,5000000.0,0.0,-5000000.0
<a href=/player/axfoj001>axfoj001</a>,John Axford,Toronto Blue Jays,BJAYS,1,1,1,2,2018,2018,0,Yes,0,-0.4,0.0,0.4,10,0,-10,0,0,0,11.0,0.0,-11.0,1500000.0,0.0,-1500000.0
<a href=/player/ayalb001>ayalb001</a>,Benny Ayala,New York Mets,METS,1,1,1,2,1977,1977,0,No,0,0.1,0.0,-0.1,1,0,-1,3,0,-3,0.0,0.0,0.0,0.0,0.0,0.0
<a href=/player/ayalb001>ayalb001</a>,Benny Ayala,St. Louis Cardinals,CARDS,1,1,1,2,1979,1979,0,No,0,1.56,0.02,-1.54,333,6,-327,761,3,-758,0.0,0.0,0.0,0.0,0.0,0.0
<a href=/player/ayalb002>ayalb002</a>,Bobby Ayala,Cincinnati Reds,REDS,9,15,18,33,1993,2013,20,No,0,45.48,40.95,-4.53,3672,3082,-590,10149,8976,-1173,3098.0,6878.0,3780.0,12546000.0,0.0,-12546000.0
<a href=/player/ayalb002>ayalb002</a>,Bobby Ayala,Seattle Mariners,MARNRS,1,1,1,2,1999,1999,0,No,0,0.43,0.0,-0.43,101,0,-101,1,0,-1,198.0,0.0,-198.0,0.0,0.0,0.0
<a href=/player/ayall001>ayall001</a>,Luis Ayala,Washington Nationals,NATEX,2,2,2,4,2008,2009,1,No,0,-0.39,0.89,1.28,84,105,21,149,346,197,54.0,0.0,-54.0,2100000.0,0.0,-2100000.0
<a href=/player/ayall001>ayall001</a>,Luis Ayala,Baltimore Orioles,ORLS,1,1,1,2,2013,2013,0,Yes,0,0.43,0.0,-0.43,73,0,-73,0,0,0,93.0,0.0,-93.0,0.0,0.0,0.0
<a href=/player/aybae001>aybae001</a>,Erick Aybar,Anaheim Angels,ANGELS,1,4,2,6,2015,2020,5,No,0,2.92,20.49,17.57,366,607,241,466,2409,1943,1135.0,0.0,-1135.0,8500000.0,0.0,-8500000.0
<a href=/player/aybae001>aybae001</a>,Erick Aybar,Atlanta Braves,BRAVES,1,1,2,3,2016,2016,0,Yes,0,0.21,0.0,-0.21,29,0,-29,91,0,-91,0.0,0.0,0.0,0.0,0.0,0.0
<a href=/player/aybam001>aybam001</a>,Manny Aybar,St. Louis Cardinals,CARDS,2,6,4,10,1999,2003,4,No,0,3.2,2.78,-0.42,870,638,-232,626,106,-520,1171.0,1638.0,467.0,860000.0,0.0,-860000.0
<a href=/player/aybam001>aybam001</a>,Manny Aybar,Colorado Rockies,ROCKS,5,7,8,15,2000,2003,3,No,0,2.36,5.24,2.88,579,451,-128,516,260,-256,1078.0,573.0,-505.0,5086667.0,0.0,-5086667.0
<a href=/player/aybam001>aybam001</a>,Manny Aybar,Cincinnati Reds,REDS,2,4,4,8,2000,2002,2,No,0,0.68,-0.66,-1.34,42,20,-22,0,16,16,82.0,130.0,48.0,0.0,0.0,0.0
<a href=/player/aybam001>aybam001</a>,Manny Aybar,Florida Marlins,MARLNS,1,1,1,2,2001,2003,2,No,0,-0.19,-0.3,-0.11,34,58,24,4,0,-4,68.0,101.0,33.0,0.0,0.0,0.0
<a href=/player/aybam001>aybam001</a>,Manny Aybar,Chicago Cubs,CUBS,1,2,1,3,2001,2002,1,No,0,-0.39,3.26,3.65,27,195,168,73,796,723,0.0,0.0,0.0,665000.0,0.0,-665000.0
<a href=/player/aybaw001>aybaw001</a>,Willy Aybar,Los Angeles Dodgers,DOGRS,2,4,2,6,2006,2008,2,No,0,-0.19,0.14,0.33,182,280,98,417,385,-32,30.0,212.0,182.0,4405000.0,0.0,-4405000.0
<a href=/player/aybaw001>aybaw001</a>,Willy Aybar,Atlanta Braves,BRAVES,1,2,1,3,2008,2009,1,No,0,1.25,0.21,-1.04,300,18,-282,1007,0,-1007,0.0,29.0,29.0,0.0,0.0,0.0
<a href=/player/ayerb101>ayerb101</a>,Bill Ayers,New York Giants,GIANTS,1,5,3,8,1950,1954,4,No,0,0.0,-0.44,-0.44,0,186,186,0,308,308,0.0,172.0,172.0,0.0,0.0,0.0
<a href=/player/ayerd101>ayerd101</a>,Doc Ayers,Washington Senators,TWINS,1,1,1,2,1919,1919,0,No,0,2.43,0.34,-2.09,144,40,-104,90,54,-36,909.0,396.0,-513.0,3000.0,0.0,-3000.0
<a href=/player/ayrab001>ayrab001</a>,Bob Ayrault,Philadelphia Phillies,PHILS,3,3,3,6,1993,1994,1,No,0,3.53,-0.58,-4.11,201,41,-160,193,32,-161,1523.0,273.0,-1250.0,125000.0,0.0,-125000.0
<a href=/player/azcuj101>azcuj101</a>,Joe Azcue,Milwaukee Braves,BRAVES,11,17,20,37,1961,1973,12,No,0,24.16,33.51,9.35,2325,1915,-410,6983,5059,-1924,2257.0,3206.0,949.0,95000.0,0.0,-95000.0
<a href=/player/azcuj101>azcuj101</a>,Joe Azcue,Kansas City Athletics,ATLTCS,12,26,19,45,1963,1976,13,No,0,41.52,16.46,-25.06,5320,2149,-3171,12652,5616,-7036,5181.0,2140.0,-3041.0,368100.0,0.0,-368100.0
<a href=/player/azcuj101>azcuj101</a>,Joe Azcue,Cleveland Indians,INDINS,1,3,3,6,1969,1970,1,No,0,13.72,3.96,-9.76,502,371,-131,436,691,255,3166.0,784.0,-2382.0,34500.0,0.0,-34500.0
<a href=/player/azcuj101>azcuj101</a>,Joe Azcue,Boston Red Sox,RSOX,1,1,1,2,1969,1971,2,No,0,-1.03,-1.04,-0.01,197,106,-91,665,348,-317,0.0,0.0,0.0,26500.0,0.0,-26500.0
<a href=/player/azcuj101>azcuj101</a>,Joe Azcue,California Angels,ANGELS,4,7,6,13,1972,1976,4,No,0,1.77,3.03,1.26,444,170,-274,1491,564,-927,0.0,90.0,90.0,63500.0,0.0,-63500.0
<a href=/player/azoco001>azoco001</a>,Oscar Azocar,New York Yankees,YANKS,1,1,1,2,1990,1991,1,No,0,-1.09,0.0,1.09,137,25,-112,242,50,-192,0.0,0.0,0.0,100000.0,0.0,-100000.0
<a href=/player/babbc101>babbc101</a>,Charlie Babb,New York Giants,GIANTS,5,14,7,21,1903,1921,18,No,0,51.29,48.92,-2.37,2751,2179,-572,9350,7604,-1746,2651.0,2915.0,264.0,6400.0,0.0,-6400.0
<a href=/player/babcb101>babcb101</a>,Bob Babcock,Baltimore Orioles,ORLS,1,1,1,2,1976,1976,0,No,0,0.27,0.0,-0.27,39,0,-39,0,0,0,172.0,0.0,-172.0,0.0,0.0,0.0
<a href=/player/babcb101>babcb101</a>,Bob Babcock,Texas Rangers,RNGRS,1,1,1,2,1983,1983,0,No,0,0.0,0.0,0.0,0,0,0,0,0,0,0.0,0.0,0.0,0.0,0.0,0.0
<a href=/player/babel101>babel101</a>,Loren Babe,Philadelphia Athletics,ATLTCS,46,109,116,225,1953,1976,23,No,0,189.08,109.39,-79.69,16486,13560,-2926,40867,38903,-1964,20759.0,16429.0,-4330.0,546100.0,0.0,-546100.0
<a href=/player/babij101>babij101</a>,Johnny Babich,Mission,Mission,1,1,2,3,1934,1934,0,No,0,-3.62,0.0,3.62,124,0,-124,102,0,-102,835.0,0.0,-835.0,0.0,0.0,0.0
<a href=/player/babij101>babij101</a>,Johnny Babich,Brooklyn Dodgers,DOGRS,2,3,2,5,1936,1939,3,No,0,16.05,5.67,-10.38,637,216,-421,2368,193,-2175,132.0,1522.0,1390.0,0.0,0.0,0.0
<a href=/player/babij101>babij101</a>,Johnny Babich,Boston Braves,BRAVES,6,18,10,28,1938,1952,14,No,0,22.0,33.53,11.53,1506,1625,119,5516,5420,-96,0.0,2449.0,2449.0,12500.0,0.0,-12500.0
<a href=/player/babij101>babij101</a>,Johnny Babich,Philadelphia Athletics,ATLTCS,1,2,1,3,1941,1941,0,No,0,0.0,0.0,0.0,0,0,0,0,0,0,0.0,0.0,0.0,7500.0,0.0,-7500.0
<a href=/player/babij101>babij101</a>,Johnny Babich,New York Yankees,YANKS,1,2,1,3,1944,1950,6,No,0,0.0,-1.41,-1.41,0,90,90,0,41,41,0.0,394.0,394.0,0.0,0.0,0.0
<a href=/player/backb001>backb001</a>,Brandon Backe,Tampa Bay Devil Rays,RAYS,1,1,1,2,2003,2004,1,No,0,2.75,-0.65,-3.4,216,112,-104,158,369,211,1403.0,0.0,-1403.0,0.0,0.0,0.0
<a href=/player/backw001>backw001</a>,Wally Backman,New York Mets,METS,1,2,3,5,1988,1988,0,No,0,-0.66,0.0,0.66,87,0,-87,337,0,-337,0.0,0.0,0.0,650000.0,0.0,-650000.0
<a href=/player/bacsm001>bacsm001</a>,Michael Bacsik,Cleveland Indians,INDINS,3,5,7,12,2001,2008,7,No,0,0.76,6.93,6.17,461,824,363,1426,2856,1430,357.0,576.0,219.0,15000000.0,0.0,-15000000.0
<a href=/player/bacsm101>bacsm101</a>,Mike Bacsik,Texas Rangers,RNGRS,1,1,1,2,1978,1978,0,No,0,0.0,0.0,0.0,41,0,-41,0,0,0,266.0,0.0,-266.0,0.0,0.0,0.0
<a href=/player/bacsm101>bacsm101</a>,Mike Bacsik,Minnesota Twins,TWINS,1,1,1,2,1980,1981,1,No,0,0.0,0.0,0.0,0,0,0,0,0,0,0.0,0.0,0.0,0.0,0.0,0.0
<a href=/player/bacud001>bacud001</a>,Dakota Bacus,Oakland Athletics,ATLTCS,1,1,1,2,2013,2013,0,No,0,-0.13,0.33,0.46,11,15,4,0,35,35,34.0,0.0,-34.0,0.0,0.0,0.0
<a href=/player/baczf101>baczf101</a>,Fred Baczewski,Chicago Cubs,CUBS,4,9,6,15,1953,1961,8,No,0,2.91,2.3,-0.61,226,408,182,136,878,742,1159.0,691.0,-468.0,0.0,0.0,0.0
<a href=/player/badeb001>badeb001</a>,Burke Badenhop,Detroit Tigers,TIGRS,2,8,3,11,2007,2010,3,No,0,-0.1,-1.19,-1.09,705,27,-678,1077,3,-1074,1506.0,303.0,-1203.0,12380000.0,0.0,-12380000.0
<a href=/player/badeb001>badeb001</a>,Burke Badenhop,Florida Marlins,MARLNS,1,1,1,2,2011,2011,0,No,0,0.74,0.0,-0.74,71,0,-71,1,0,-1,187.0,0.0,-187.0,750000.0,0.0,-750000.0
<a href=/player/badeb001>badeb001</a>,Burke Badenhop,Tampa Bay Devil Rays,RAYS,1,1,1,2,2012,2012,0,No,0,-0.36,0.0,0.36,124,0,-124,1,0,-1,187.0,0.0,-187.0,1075000.0,0.0,-1075000.0
<a href=/player/badeb001>badeb001</a>,Burke Badenhop,Milwaukee Brewers,BREWRS,1,1,1,2,2013,2013,0,Yes,0,1.52,0.0,-1.52,76,0,-76,0,0,0,212.0,0.0,-212.0,1550000.0,0.0,-1550000.0
<a href=/player/baece101>baece101</a>,Ed Baecht,Chicago Cubs,CUBS,2,7,2,9,1933,1938,5,No,0,10.27,0.77,-9.5,576,293,-283,361,754,393,2894.0,224.0,-2670.0,0.0,0.0,0.0
<a href=/player/baekc001>baekc001</a>,Cha-Seung Baek,Seattle Mariners,MARNRS,1,1,1,2,2008,2009,1,No,0,0.31,-0.17,-0.48,45,6,-39,38,0,-38,333.0,16.0,-317.0,392500.0,0.0,-392500.0
<a href=/player/baerc001>baerc001</a>,Carlos Baerga,San Diego Padres,PADRS,7,14,16,30,1989,1998,9,No,0,77.02,12.33,-64.69,5607,1502,-4105,22003,4193,-17810,1355.0,1888.0,533.0,8656667.0,0.0,-8656667.0
<a href=/player/baerc001>baerc001</a>,Carlos Baerga,Cleveland Indians,INDINS,5,12,10,22,1996,2001,5,No,0,73.82,8.63,-65.19,4077,457,-3620,13151,1605,-11546,1815.0,172.0,-1643.0,13083332.0,0.0,-13083332.0
<a href=/player/baezd001>baezd001</a>,Danys Baez,Tampa Bay Devil Rays,RAYS,5,6,7,13,2006,2018,12,Yes,0,2.76,13.6,10.84,309,789,480,288,2263,1975,1120.0,1336.0,216.0,7137700.0,0.0,-7137700.0
<a href=/player/baezd001>baezd001</a>,Danys Baez,Los Angeles Dodgers,DOGRS,2,4,2,6,2006,2008,2,No,0,-0.19,0.14,0.33,182,280,98,417,385,-32,30.0,212.0,182.0,4405000.0,0.0,-4405000.0
<a href=/player/baezj001>baezj001</a>,Javier Baez,Chicago Cubs,CUBS,1,3,1,4,2021,2021,0,Yes,0,2.33,0.0,-2.33,66,0,-66,194,0,-194,97.0,0.0,-97.0,14100000.0,0.0,-14100000.0
<a href=/player/baezj101>baezj101</a>,Jose Baez,Seattle Mariners,MARNRS,1,1,1,2,1978,1978,0,No,0,0.0,0.0,0.0,0,0,0,0,0,0,0.0,0.0,0.0,0.0,0.0,0.0
<a href=/player/baezk001>baezk001</a>,Kevin Baez,New York Mets,METS,10,20,16,36,1994,2005,11,No,0,9.72,5.49,-4.23,1692,2201,509,3051,3605,554,2422.0,2911.0,489.0,20343890.0,0.0,-20343890.0
<a href=/player/baezk001>baezk001</a>,Kevin Baez,Detroit Tigers,TIGRS,1,1,1,2,1998,1998,0,No,0,0.0,0.0,0.0,0,0,0,0,0,0,0.0,0.0,0.0,0.0,0.0,0.0
<a href=/player/bagbj102>bagbj102</a>,Jim Bagby,Boston Red Sox,RSOX,4,12,11,23,1940,1956,16,No,0,20.74,30.94,10.2,2288,1730,-558,6966,4243,-2723,4828.0,6235.0,1407.0,124000.0,0.0,-124000.0
<a href=/player/bagbj102>bagbj102</a>,Jim Bagby,Cleveland Indians,INDINS,1,1,2,3,1945,1945,0,No,0,-0.36,0.0,0.36,42,0,-42,44,0,-44,320.0,0.0,-320.0,10200.0,0.0,-10200.0
<a href=/player/bagwb101>bagwb101</a>,Bill Bagwell,Philadelphia Athletics,ATLTCS,1,4,1,5,1925,1925,0,No,0,0.0,0.15,0.15,0,133,133,0,522,522,0.0,0.0,0.0,4850.0,0.0,-4850.0
<a href=/player/bagwb101>bagwb101</a>,Bill Bagwell,Philadelphia Athletics,ATLTCS,1,4,1,5,1925,1925,0,No,0,0.0,0.15,0.15,0,133,133,0,522,522,0.0,0.0,0.0,4850.0,0.0,-4850.0
<a href=/player/bagwj001>bagwj001</a>,Jeff Bagwell,Boston Red Sox,RSOX,3,4,3,7,1990,1995,5,No,1,82.05,2.29,-79.76,2270,45,-2225,9432,0,-9432,1528.0,157.0,-1371.0,109000.0,0.0,-109000.0
<a href=/player/bahns101>bahns101</a>,Stan Bahnsen,New York Yankees,YANKS,2,3,2,5,1971,1973,2,No,0,7.07,0.79,-6.28,331,160,-171,403,666,263,2477.0,0.0,-2477.0,68500.0,0.0,-68500.0
<a href=/player/bahns101>bahns101</a>,Stan Bahnsen,Chicago White Sox,WSOX,5,9,6,15,1975,1989,14,No,1,34.89,33.07,-1.82,1503,1198,-305,4882,4106,-776,2621.0,1459.0,-1162.0,0.0,0.0,0.0
<a href=/player/bahns101>bahns101</a>,Stan Bahnsen,Oakland Athletics,ATLTCS,3,4,3,7,1977,1987,10,No,1,-1.79,1.22,3.01,544,207,-337,370,236,-134,1779.0,1580.0,-199.0,425000.0,0.0,-425000.0
<a href=/player/bahre101>bahre101</a>,Ed Bahr,Pittsburgh Pirates,PIRATS,1,2,1,3,1949,1949,0,No,0,0.0,0.0,0.0,0,0,0,0,0,0,0.0,0.0,0.0,0.0,0.0,0.0
<a href=/player/baila001>baila001</a>,Andrew Bailey,Oakland Athletics,ATLTCS,2,4,6,10,2011,2019,8,Yes,0,6.28,16.11,9.83,292,639,347,512,2366,1854,1216.0,614.0,-602.0,1865000.0,0.0,-1865000.0
<a href=/player/bailb001>bailb001</a>,Bob Bailor,Toronto Blue Jays,BJAYS,1,1,1,2,1980,1985,5,No,0,3.92,4.3,0.38,279,191,-88,867,0,-867,0.0,1011.0,1011.0,130000.0,0.0,-130000.0
<a href=/player/bailb001>bailb001</a>,Bob Bailor,New York Mets,METS,5,9,8,17,1983,2002,19,No,2,9.94,33.47,23.53,1212,944,-268,3663,1895,-1768,473.0,5145.0,4672.0,876667.0,0.0,-876667.0
<a href=/player/bailb002>bailb002</a>,Brandon Bailey,Oakland Athletics,ATLTCS,1,1,1,2,2017,2017,0,Yes,0,0.13,0.0,-0.13,5,0,-5,0,0,0,22.0,0.0,-22.0,0.0,0.0,0.0
<a href=/player/bailb101>bailb101</a>,Bill Bailey,Baltimore Terrapins,BLF,1,1,1,2,1915,1915,0,No,0,0.66,0.0,-0.66,10,0,-10,11,0,-11,100.0,0.0,-100.0,0.0,0.0,0.0
<a href=/player/bailb101>bailb101</a>,Bill Bailey,St.Louis Browns,ORLS,1,1,1,2,1911,1911,0,No,0,0.0,0.0,0.0,0,0,0,0,0,0,0.0,0.0,0.0,0.0,0.0,0.0
<a href=/player/bailb103>bailb103</a>,Bob Bailey,Pittsburgh Pirates,PIRATS,1,2,1,3,1966,1968,2,No,0,-0.49,7.77,8.26,319,302,-17,982,1350,368,0.0,0.0,0.0,0.0,0.0,0.0
<a href=/player/bailb103>bailb103</a>,Bob Bailey,Montreal Expos,NATEX,1,1,1,2,1975,1976,1,No,0,0.41,-1.62,-2.03,118,44,-74,233,25,-208,0.0,236.0,236.0,0.0,0.0,0.0
<a href=/player/bailb103>bailb103</a>,Bob Bailey,Cincinnati Reds,REDS,1,1,2,3,1977,1977,0,No,0,-0.29,0.0,0.29,45,0,-45,118,0,-118,0.0,0.0,0.0,0.0,0.0,0.0
<a href=/player/bailc001>bailc001</a>,Cory Bailey,Boston Red Sox,RSOX,4,7,6,13,1995,1997,2,No,0,2.06,3.71,1.65,881,324,-557,1600,1071,-529,1046.0,345.0,-701.0,1638268.0,0.0,-1638268.0
<a href=/player/bailc001>bailc001</a>,Cory Bailey,St. Louis Cardinals,CARDS,1,1,1,2,1996,1996,0,No,0,0.0,0.0,0.0,0,0,0,0,0,0,0.0,0.0,0.0,125000.0,0.0,-125000.0
<a href=/player/bailc001>bailc001</a>,Cory Bailey,Texas Rangers,RNGRS,1,1,1,2,1997,1997,0,No,0,-0.19,0.0,0.19,23,0,-23,1,0,-1,39.0,0.0,-39.0,0.0,0.0,0.0
<a href=/player/baile101>baile101</a>,Ed Bailey,Cincinnati Reds,REDS,4,6,7,13,1961,1966,5,No,0,12.35,2.83,-9.52,1092,854,-238,3026,2045,-981,1452.0,592.0,-860.0,0.0,0.0,0.0
<a href=/player/baile101>baile101</a>,Ed Bailey,San Francisco Giants,GIANTS,8,14,12,26,1963,1972,9,No,0,20.6,12.56,-8.04,1709,1303,-406,5210,1731,-3479,1169.0,4789.0,3620.0,50000.0,0.0,-50000.0
<a href=/player/baile101>baile101</a>,Ed Bailey,Milwaukee Braves,BRAVES,2,2,2,4,1965,1967,2,No,0,-0.65,3.59,4.24,153,198,45,83,47,-36,474.0,596.0,122.0,0.0,0.0,0.0
<a href=/player/baile101>baile101</a>,Ed Bailey,San Francisco Giants,GIANTS,3,5,4,9,1965,1968,3,No,0,-1.4,-0.01,1.39,272,250,-22,397,696,299,492.0,0.0,-492.0,33000.0,0.0,-33000.0
<a href=/player/bailg101>bailg101</a>,Gene Bailey,Brooklyn Dodgers,DOGRS,3,7,5,12,1924,1927,3,No,0,6.65,3.39,-3.26,787,606,-181,3022,2382,-640,0.0,0.0,0.0,32500.0,0.0,-32500.0
<a href=/player/bailh001>bailh001</a>,Homer Bailey,Cincinnati Reds,REDS,2,6,6,12,2018,2020,2,Yes,0,0.33,2.24,1.91,53,294,241,210,761,551,24.0,499.0,475.0,30700000.0,0.0,-30700000.0
<a href=/player/bailh001>bailh001</a>,Homer Bailey,Kansas City Royals,ROYALS,1,1,1,2,2019,2019,0,Yes,0,0.92,0.0,-0.92,15,0,-15,4,0,-4,220.0,0.0,-220.0,100000.0,0.0,-100000.0
<a href=/player/bailm001>bailm001</a>,Mark Bailey,Houston Astros,ASTROS,1,1,1,2,1988,1993,5,No,0,0.0,3.13,3.13,0,512,512,0,1327,1327,0.0,0.0,0.0,100000.0,0.0,-100000.0
<a href=/player/bailm001>bailm001</a>,Mark Bailey,Montreal Expos,NATEX,1,2,1,3,1989,1992,3,No,0,0.25,-0.1,-0.35,91,204,113,144,4,-140,0.0,350.0,350.0,0.0,0.0,0.0
<a href=/player/bails001>bails001</a>,Scott Bailes,Pittsburgh Pirates,PIRATS,1,1,1,2,1985,1986,1,No,0,1.54,-0.13,-1.67,174,22,-152,0,65,65,1475.0,0.0,-1475.0,0.0,0.0,0.0
<a href=/player/bails001>bails001</a>,Scott Bailes,Cleveland Indians,INDINS,1,1,2,3,1990,1991,1,No,0,-1.98,0.04,2.02,101,77,-24,0,245,245,377.0,0.0,-377.0,0.0,0.0,0.0
<a href=/player/bainh001>bainh001</a>,Harold Baines,Chicago White Sox,WSOX,9,18,22,40,1989,2011,22,No,0,68.5,42.52,-25.98,3028,2464,-564,8796,4720,-4076,3081.0,6620.0,3539.0,22245000.0,0.0,-22245000.0
<a href=/player/bainh001>bainh001</a>,Harold Baines,Texas Rangers,RNGRS,1,1,2,3,1990,1992,2,No,0,3.9,1.62,-2.28,313,30,-283,1227,0,-1227,0.0,327.0,327.0,1143539.0,0.0,-1143539.0
<a href=/player/bainh001>bainh001</a>,Harold Baines,Oakland Athletics,ATLTCS,1,1,2,3,1993,1997,4,No,0,9.51,0.46,-9.05,666,13,-653,2415,0,-2415,0.0,177.0,177.0,0.0,0.0,0.0
<a href=/player/bainh001>bainh001</a>,Harold Baines,Chicago White Sox,WSOX,1,1,1,2,1997,1997,0,No,0,4.23,0.0,-4.23,327,0,-327,1119,0,-1119,0.0,0.0,0.0,1925000.0,0.0,-1925000.0
<a href=/player/bainh001>bainh001</a>,Harold Baines,Baltimore Orioles,ORLS,2,2,3,5,1999,2001,2,No,0,-0.27,0.0,0.27,28,0,-28,96,0,-96,0.0,0.0,0.0,1730000.0,0.0,-1730000.0
<a href=/player/bainh001>bainh001</a>,Harold Baines,Baltimore Orioles,ORLS,1,2,4,6,2000,2003,3,No,0,0.48,0.13,-0.35,100,312,212,320,1036,716,0.0,0.0,0.0,6600000.0,0.0,-6600000.0
<a href=/player/baird001>baird001</a>,Doug Bair,Pittsburgh Pirates,PIRATS,5,10,11,21,1977,1988,11,No,0,53.71,31.99,-21.72,2929,1675,-1254,9660,6568,-3092,5429.0,149.0,-5280.0,807000.0,0.0,-807000.0
<a href=/player/baird001>baird001</a>,Doug Bair,Oakland Athletics,ATLTCS,2,4,4,8,1978,1983,5,No,0,2.08,8.1,6.02,514,624,110,229,1866,1637,956.0,1046.0,90.0,0.0,0.0,0.0
<a href=/player/baird001>baird001</a>,Doug Bair,Cincinnati Reds,REDS,1,1,2,3,1981,1981,0,No,0,2.2,0.51,-1.69,204,12,-192,20,4,-16,417.0,38.0,-379.0,0.0,0.0,0.0
<a href=/player/baird001>baird001</a>,Doug Bair,St. Louis Cardinals,CARDS,4,5,7,12,1983,1996,13,No,1,-2.38,10.77,13.15,294,1154,860,340,3264,2924,908.0,1152.0,244.0,4150000.0,0.0,-4150000.0
<a href=/player/baird101>baird101</a>,Doug Baird,Pittsburgh Pirates,PIRATS,1,1,1,2,1917,1918,1,No,0,5.51,2.15,-3.36,202,80,-122,798,95,-703,0.0,687.0,687.0,1800.0,0.0,-1800.0
<a href=/player/baird101>baird101</a>,Doug Baird,St. Louis Cardinals,CARDS,4,7,6,13,1919,1928,9,No,0,6.49,22.08,15.59,1385,1345,-40,4793,5431,638,403.0,0.0,-403.0,33500.0,0.0,-33500.0
<a href=/player/baird101>baird101</a>,Doug Baird,Philadelphia Phillies,PHILS,3,6,7,13,1919,1925,6,No,0,15.32,16.37,1.05,851,640,-211,1993,1730,-263,4451.0,3043.0,-1408.0,8500.0,0.0,-8500.0
<a href=/player/baird101>baird101</a>,Doug Baird,New York Giants,GIANTS,2,6,2,8,1920,1926,6,No,0,11.79,12.89,1.1,909,766,-143,3326,3233,-93,0.0,0.0,0.0,8100.0,0.0,-8100.0
<a href=/player/bajej001>bajej001</a>,Jeff Bajenaru,Chicago White Sox,WSOX,1,1,1,2,2006,2007,1,No,0,-0.3,-2.54,-2.24,2,159,157,0,500,500,3.0,0.0,-3.0,0.0,0.0,0.0
<a href=/player/bakeb001>bakeb001</a>,Bryan Baker,Colorado Rockies,ROCKS,1,3,1,4,2018,2019,1,No,0,0.04,0.16,0.12,1,90,89,0,0,0,3.0,119.0,116.0,0.0,0.0,0.0
<a href=/player/bakec101>bakec101</a>,Chuck Baker,San Diego Padres,PADRS,1,1,1,2,1980,1982,2,No,0,-0.46,-0.7,-0.24,40,129,89,70,181,111,0.0,0.0,0.0,0.0,0.0,0.0
<a href=/player/baked001>baked001</a>,Doug Baker,Detroit Tigers,TIGRS,1,1,1,2,1988,1988,0,No,0,0.64,0.0,-0.64,57,0,-57,100,0,-100,0.0,0.0,0.0,0.0,0.0,0.0
<a href=/player/baked002>baked002</a>,Dusty Baker,Atlanta Braves,BRAVES,2,4,5,9,1975,1984,9,No,0,23.22,0.43,-22.79,1629,1492,-137,5388,5061,-327,292.0,128.0,-164.0,0.0,0.0,0.0
<a href=/player/baked002>baked002</a>,Dusty Baker,San Francisco Giants,GIANTS,1,1,2,3,1985,1985,0,No,0,2.32,0.0,-2.32,194,0,-194,667,0,-667,0.0,0.0,0.0,0.0,0.0,0.0
<a href=/player/baked101>baked101</a>,Dave Baker,Toronto Blue Jays,BJAYS,2,2,2,4,1982,1984,2,No,0,-0.06,-0.05,0.01,7,4,-3,0,0,0,30.0,16.0,-14.0,0.0,0.0,0.0
<a href=/player/bakef101>bakef101</a>,Frank Baker,New York Yankees,YANKS,1,1,1,2,1973,1973,0,No,0,-0.36,0.0,0.36,68,0,-68,103,0,-103,0.0,0.0,0.0,0.0,0.0,0.0
<a href=/player/bakef102>bakef102</a>,Home Run Baker,Reading,Reading,1,1,1,2,1908,1908,0,No,0,42.2,0.0,-42.2,899,0,-899,3853,0,-3853,0.0,0.0,0.0,0.0,0.0,0.0
<a href=/player/bakef103>bakef103</a>,Floyd Baker,Chicago White Sox,WSOX,3,4,4,8,1951,1954,3,No,0,0.47,0.91,0.44,828,226,-602,2411,504,-1907,0.0,0.0,0.0,32500.0,0.0,-32500.0
<a href=/player/bakef104>bakef104</a>,Frank Baker,Cleveland Indians,INDINS,8,13,14,27,1971,1984,13,No,0,47.87,7.93,-39.94,2666,2447,-219,9920,8254,-1666,38.0,317.0,279.0,169250.0,0.0,-169250.0
<a href=/player/bakeg101>bakeg101</a>,Gene Baker,Chicago Cubs,CUBS,4,7,6,13,1957,1961,4,No,0,9.53,8.89,-0.64,897,921,24,1516,3331,1815,802.0,0.0,-802.0,17500.0,0.0,-17500.0
<a href=/player/bakej001>bakej001</a>,Jeff Baker,Colorado Rockies,ROCKS,1,1,1,2,2009,2010,1,No,0,1.63,0.0,-1.63,283,0,-283,804,0,-804,0.0,0.0,0.0,415000.0,0.0,-415000.0
<a href=/player/bakej001>bakej001</a>,Jeff Baker,Detroit Tigers,TIGRS,1,1,1,2,2012,2012,0,No,0,-0.38,0.0,0.38,14,0,-14,20,0,-20,0.0,0.0,0.0,0.0,0.0,0.0
<a href=/player/bakej001>bakej001</a>,Jeff Baker,Chicago Cubs,CUBS,1,1,2,3,2012,2012,0,No,0,-0.35,0.0,0.35,15,0,-15,37,0,-37,0.0,0.0,0.0,1375000.0,0.0,-1375000.0
<a href=/player/bakej002>bakej002</a>,John Baker,Oakland Athletics,ATLTCS,1,1,1,2,2007,2007,0,No,0,1.7,0.0,-1.7,212,0,-212,760,0,-760,0.0,0.0,0.0,0.0,0.0,0.0
<a href=/player/bakej002>bakej002</a>,John Baker,Florida Marlins,MARLNS,1,1,1,2,2011,2013,2,No,0,0.2,1.02,0.82,79,75,-4,260,29,-231,0.0,352.0,352.0,417000.0,0.0,-417000.0
<a href=/player/bakej103>bakej103</a>,Jack Baker,Boston Red Sox,RSOX,2,4,3,7,1977,1986,9,No,0,26.9,0.41,-26.49,1356,730,-626,5373,2641,-2732,4.0,0.0,-4.0,440000.0,0.0,-440000.0
<a href=/player/bakes001>bakes001</a>,Scott Baker,Florida Marlins,MARLNS,3,4,3,7,1992,2001,9,No,1,-0.58,0.34,0.92,97,427,330,164,711,547,385.0,1278.0,893.0,265000.0,0.0,-265000.0
<a href=/player/bakes101>bakes101</a>,Steve Baker,Oakland Athletics,ATLTCS,1,1,2,3,1983,1983,0,No,0,0.1,0.0,-0.1,16,0,-16,0,0,0,30.0,0.0,-30.0,0.0,0.0,0.0
<a href=/player/bakes101>bakes101</a>,Steve Baker,Montreal Expos,NATEX,1,1,1,2,1985,1987,2,No,0,0.0,-0.2,-0.2,0,1,1,0,4,4,0.0,0.0,0.0,0.0,0.0,0.0
<a href=/player/baket101>baket101</a>,Tracy Baker,Boston Red Sox,RSOX,10,29,25,54,1911,1935,24,No,0,51.77,27.79,-23.98,3792,3076,-716,15081,11324,-3757,0.0,1203.0,1203.0,45050.0,0.0,-45050.0
<a href=/player/baket103>baket103</a>,Tom Baker,Brooklyn Dodgers,DOGRS,1,1,1,2,1937,1942,5,No,0,0.19,12.0,11.81,30,202,172,10,256,246,105.0,1994.0,1889.0,0.0,0.0,0.0
<a href=/player/baket103>baket103</a>,Tom Baker,New York Giants,GIANTS,1,3,1,4,1938,1940,2,No,0,0.0,3.47,3.47,0,123,123,0,517,517,0.0,0.0,0.0,0.0,0.0,0.0
<a href=/player/bakop001>bakop001</a>,Paul Bako,Cincinnati Reds,REDS,1,2,1,3,1997,1998,1,No,0,0.65,-0.13,-0.78,96,83,-13,333,147,-186,0.0,0.0,0.0,0.0,0.0,0.0
<a href=/player/bakop001>bakop001</a>,Paul Bako,Detroit Tigers,TIGRS,4,11,7,18,1999,2002,3,No,1,3.62,7.62,4.0,1493,652,-841,3797,1742,-2055,861.0,1164.0,303.0,6750000.0,0.0,-6750000.0
<a href=/player/bakop001>bakop001</a>,Paul Bako,Atlanta Braves,BRAVES,1,2,1,3,2002,2003,1,No,0,-3.2,-1.6,1.6,184,136,-48,277,415,138,310.0,0.0,-310.0,0.0,0.0,0.0
<a href=/player/bakop001>bakop001</a>,Paul Bako,Milwaukee Brewers,BREWRS,1,1,1,2,2002,2002,0,No,0,0.48,0.0,-0.48,119,0,-119,370,0,-370,0.0,0.0,0.0,750000.0,0.0,-750000.0
<a href=/player/balaj101>balaj101</a>,John Balaz,California Angels,ANGELS,2,4,2,6,1976,1979,3,No,0,0.01,3.49,3.48,36,153,117,0,0,0,119.0,938.0,819.0,0.0,0.0,0.0
<a href=/player/balbs001>balbs001</a>,Steve Balboni,New York Yankees,YANKS,1,2,2,4,1983,1986,3,No,0,1.05,0.96,-0.09,566,53,-513,2201,0,-2201,0.0,233.0,233.0,180000.0,0.0,-180000.0
<a href=/player/balbs001>balbs001</a>,Steve Balboni,Seattle Mariners,MARNRS,1,1,1,2,1989,1989,0,No,0,-0.57,0.0,0.57,226,0,-226,641,0,-641,0.0,0.0,0.0,0.0,0.0,0.0
<a href=/player/baldb101>baldb101</a>,Billy Baldwin,Detroit Tigers,TIGRS,2,3,4,7,1975,1979,4,No,0,1.24,6.09,4.85,109,575,466,196,2407,2211,578.0,284.0,-294.0,95000.0,0.0,-95000.0
<a href=/player/baldd101>baldd101</a>,Dave Baldwin,Washington Senators,RNGRS,17,36,26,62,1969,1988,19,No,0,50.01,50.13,0.12,3095,3348,253,9917,9957,40,4531.0,7211.0,2680.0,573500.0,0.0,-573500.0
<a href=/player/baldj001>baldj001</a>,Jeff Baldwin,Houston Astros,ASTROS,1,1,1,2,1991,1991,0,No,0,0.0,-1.78,-1.78,0,14,14,0,1,1,0.0,24.0,24.0,0.0,0.0,0.0
<a href=/player/baldj002>baldj002</a>,James Baldwin,Chicago White Sox,WSOX,1,2,3,5,2001,2002,1,No,0,0.96,0.0,-0.96,24,0,-24,27,0,-27,238.0,0.0,-238.0,5950000.0,0.0,-5950000.0
<a href=/player/baldj101>baldj101</a>,Jack Baldschun,Philadelphia Phillies,PHILS,3,4,4,8,1965,1969,4,No,0,9.35,1.85,-7.5,553,451,-102,133,871,738,1272.0,301.0,-971.0,34500.0,0.0,-34500.0
<a href=/player/baldj101>baldj101</a>,Jack Baldschun,Baltimore Orioles,ORLS,12,26,24,50,1965,1994,29,No,3,56.78,119.52,62.74,2921,5392,2471,5189,14197,9008,12746.0,15470.0,2724.0,912833.0,0.0,-912833.0
<a href=/player/baldr102>baldr102</a>,Reggie Baldwin,Houston Astros,ASTROS,1,1,1,2,1980,1980,0,No,0,0.0,0.0,0.0,0,0,0,0,0,0,0.0,0.0,0.0,0.0,0.0,0.0
<a href=/player/balec001>balec001</a>,Collin Balester,Washington Nationals,NATEX,1,1,1,2,2011,2014,3,No,0,-0.24,-0.38,-0.14,11,14,3,0,0,0,54.0,24.0,-30.0,0.0,0.0,0.0
<a href=/player/balej001>balej001</a>,John Bale,Toronto Blue Jays,BJAYS,4,8,8,16,2000,2014,14,No,0,3.7,13.0,9.3,601,969,368,810,1750,940,922.0,1398.0,476.0,7829600.0,0.0,-7829600.0
<a href=/player/balej001>balej001</a>,John Bale,Baltimore Orioles,ORLS,1,1,1,2,2002,2003,1,No,0,0.0,1.85,1.85,0,150,150,0,569,569,0.0,0.0,0.0,0.0,0.0,0.0
<a href=/player/balel101>balel101</a>,Lee Bales,Atlanta Braves,BRAVES,1,3,3,6,1966,1970,4,No,0,-2.48,0.0,2.48,260,0,-260,50,0,-50,409.0,0.0,-409.0,0.0,0.0,0.0
<a href=/player/balew001>balew001</a>,Wladimir Balentien,Seattle Mariners,MARNRS,1,1,1,2,2009,2009,0,No,0,0.78,0.0,-0.78,40,0,-40,125,0,-125,0.0,0.0,0.0,405000.0,0.0,-405000.0
<a href=/player/balfg001>balfg001</a>,Grant Balfour,Milwaukee Brewers,BREWRS,1,1,1,2,2007,2009,2,No,0,3.21,1.11,-2.1,295,179,-116,1,29,28,809.0,538.0,-271.0,0.0,0.0,0.0
<a href=/player/ballj001>ballj001</a>,Jay Baller,Philadelphia Phillies,PHILS,5,11,8,19,1982,1999,17,No,0,22.81,28.42,5.61,2142,1948,-194,7615,5685,-1930,390.0,1257.0,867.0,2950000.0,0.0,-2950000.0
<a href=/player/ballj001>ballj001</a>,Jay Baller,Cleveland Indians,INDINS,1,1,1,2,1985,1986,1,No,0,-0.27,-0.05,0.22,158,6,-152,16,11,-5,405.0,0.0,-405.0,0.0,0.0,0.0
<a href=/player/ballj101>ballj101</a>,Jim Ball,Boston Braves,BRAVES,1,1,1,2,1909,1909,0,No,0,0.0,0.0,0.0,0,0,0,0,0,0,0.0,0.0,0.0,0.0,0.0,0.0
<a href=/player/ballw101>ballw101</a>,Win Ballou,Washington Senators,TWINS,1,2,2,4,1926,1926,0,No,0,4.68,-1.0,-5.68,222,56,-166,205,69,-136,1704.0,214.0,-1490.0,0.0,0.0,0.0
<a href=/player/ballw101>ballw101</a>,Win Ballou,Chicago Cubs,CUBS,2,8,3,11,1933,1946,13,No,0,22.35,18.34,-4.01,627,903,276,2568,3781,1213,0.0,0.0,0.0,0.0,0.0,0.0
<a href=/player/bambg101>bambg101</a>,George Bamberger,New York Giants,GIANTS,1,2,1,3,1952,1952,0,No,0,0.0,-0.43,-0.43,0,34,34,0,8,8,0.0,109.0,109.0,7000.0,0.0,-7000.0
<a href=/player/bancd101>bancd101</a>,Dave Bancroft,Philadelphia Phillies,PHILS,1,1,2,3,1920,1920,0,No,0,22.88,3.58,-19.3,534,102,-432,2462,411,-2051,0.0,0.0,0.0,9000.0,0.0,-9000.0
<a href=/player/bancd101>bancd101</a>,Dave Bancroft,New York Giants,GIANTS,2,4,3,7,1923,1927,4,No,0,14.64,1.52,-13.12,912,442,-470,3712,1550,-2162,0.0,87.0,87.0,25500.0,0.0,-25500.0
<a href=/player/banda001>banda001</a>,Anthony Banda,Milwaukee Brewers,BREWRS,3,5,5,10,2014,2019,5,Yes,0,6.43,9.84,3.41,307,369,62,1146,703,-443,285.0,1843.0,1558.0,8837500.0,0.0,-8837500.0
<a href=/player/banda001>banda001</a>,Anthony Banda,Arizona Diamondbacks,DBACKS,1,4,2,6,2018,2019,1,Yes,0,-0.39,-0.4,-0.01,65,72,7,0,272,272,232.0,0.0,-232.0,0.0,0.0,0.0
<a href=/player/banda001>banda001</a>,Anthony Banda,San Francisco Giants,GIANTS,1,1,1,2,2021,2021,0,Yes,0,-0.37,0.0,0.37,10,0,-10,1,0,-1,22.0,0.0,-22.0,0.0,0.0,0.0
<a href=/player/bandj001>bandj001</a>,Jett Bandy,Anaheim Angels,ANGELS,2,2,4,6,2016,2018,2,Yes,0,0.4,1.97,1.57,324,216,-108,1062,761,-301,0.0,0.0,0.0,3900000.0,0.0,-3900000.0
<a href=/player/baned101>baned101</a>,Dick Baney,Milwaukee Brewers,BREWRS,2,4,2,6,1970,1974,4,No,0,1.37,11.49,10.12,187,678,491,473,2707,2234,0.0,0.0,0.0,0.0,0.0,0.0
<a href=/player/banee101>banee101</a>,Eddie Bane,Chicago White Sox,WSOX,1,1,1,2,1980,1980,0,No,0,0.0,0.0,0.0,0,0,0,0,0,0,0.0,0.0,0.0,0.0,0.0,0.0
<a href=/player/bankg101>bankg101</a>,George Banks,Minnesota Twins,TWINS,4,9,8,17,1964,1971,7,No,0,23.37,18.05,-5.32,1251,1468,217,3644,1313,-2331,1591.0,4850.0,3259.0,202500.0,0.0,-202500.0
<a href=/player/bankg101>bankg101</a>,George Banks,Cleveland Indians,INDINS,3,3,3,6,1966,1972,6,No,0,-0.38,1.13,1.51,313,410,97,710,821,111,8.0,15.0,7.0,9500.0,0.0,-9500.0
<a href=/player/banks001>banks001</a>,Scott Bankhead,Kansas City Royals,ROYALS,4,8,7,15,1986,1994,8,No,2,22.08,13.31,-8.77,1163,870,-293,1083,3196,2113,6286.0,300.0,-5986.0,1438000.0,0.0,-1438000.0
<a href=/player/bankw001>bankw001</a>,Willie Banks,Minnesota Twins,TWINS,2,2,3,5,1993,1997,4,No,0,-3.17,-2.12,1.05,199,411,212,435,1008,573,450.0,575.0,125.0,351000.0,0.0,-351000.0
<a href=/player/bankw001>bankw001</a>,Willie Banks,Chicago Cubs,CUBS,1,1,1,2,1995,1995,0,No,0,-0.3,0.0,0.3,12,0,-12,11,0,-11,87.0,0.0,-87.0,240000.0,0.0,-240000.0
<a href=/player/bankw001>bankw001</a>,Willie Banks,New York Yankees,YANKS,1,1,2,3,1998,1998,0,No,0,0.27,0.0,-0.27,64,0,-64,1,0,-1,131.0,0.0,-131.0,342500.0,0.0,-342500.0
<a href=/player/banna001>banna001</a>,Alan Bannister,Philadelphia Phillies,PHILS,1,3,2,5,1975,1979,4,No,0,0.71,0.93,0.22,442,215,-227,1620,199,-1421,0.0,1610.0,1610.0,0.0,0.0,0.0
<a href=/player/banna001>banna001</a>,Alan Bannister,Chicago White Sox,WSOX,1,1,1,2,1980,1981,1,No,0,2.72,0.07,-2.65,367,33,-334,1367,79,-1288,0.0,0.0,0.0,0.0,0.0,0.0
<a href=/player/banna001>banna001</a>,Alan Bannister,Houston Astros,ASTROS,1,1,1,2,1984,1985,1,No,0,0.56,0.0,-0.56,104,16,-88,272,15,-257,0.0,0.0,0.0,0.0,0.0,0.0
<a href=/player/bannb001>bannb001</a>,Brian Bannister,New York Mets,METS,1,1,1,2,2006,2008,2,No,0,4.29,0.23,-4.06,118,34,-84,20,0,-20,1888.0,71.0,-1817.0,327000.0,0.0,-327000.0
<a href=/player/bannf001>bannf001</a>,Floyd Bannister,Houston Astros,ASTROS,1,1,1,2,1978,1988,10,No,0,13.11,10.5,-2.61,118,1070,952,0,3508,3508,2305.0,3.0,-2302.0,26000.0,0.0,-26000.0
<a href=/player/bannf001>bannf001</a>,Floyd Bannister,Chicago White Sox,WSOX,4,7,7,14,1987,1994,7,No,0,14.45,7.51,-6.94,385,504,119,1,759,758,4103.0,4503.0,400.0,930000.0,0.0,-930000.0
<a href=/player/banum001>banum001</a>,Manny Banuelos,New York Yankees,YANKS,7,12,12,24,2015,2020,5,Yes,0,1.96,10.9,8.94,805,450,-355,1019,158,-861,949.0,1850.0,901.0,6061900.0,0.0,-6061900.0
<a href=/player/banum001>banum001</a>,Manny Banuelos,Los Angeles Dodgers,DOGRS,1,1,1,2,2018,2018,0,Yes,0,-0.34,0.0,0.34,17,0,-17,0,0,0,152.0,0.0,-152.0,0.0,0.0,0.0
<a href=/player/barbb001>barbb001</a>,Bret Barberie,Florida Marlins,MARLNS,2,3,2,5,1994,2004,10,No,0,2.98,0.43,-2.55,404,566,162,291,541,250,517.0,587.0,70.0,622500.0,0.0,-622500.0
<a href=/player/barbj001>barbj001</a>,Johnny Barbato,San Diego Padres,PADRS,1,1,1,2,2014,2015,1,No,0,-0.29,0.74,1.03,13,103,90,0,0,0,39.0,154.0,115.0,0.0,0.0,0.0
<a href=/player/barbj001>barbj001</a>,Johnny Barbato,New York Yankees,YANKS,1,1,1,2,2017,2017,0,Yes,0,0.24,0.0,-0.24,47,0,-47,1,0,-1,86.0,0.0,-86.0,0.0,0.0,0.0
<a href=/player/barbj101>barbj101</a>,Jap Barbeau,Pittsburgh Pirates,PIRATS,3,9,6,15,1909,1915,6,No,0,20.39,14.17,-6.22,2165,858,-1307,7822,3752,-4070,942.0,0.0,-942.0,19200.0,0.0,-19200.0
<a href=/player/barbs102>barbs102</a>,Steve Barber,Baltimore Orioles,ORLS,1,1,4,5,1967,1967,0,No,0,-0.05,0.0,0.05,74,0,-74,79,0,-79,678.0,0.0,-678.0,0.0,0.0,0.0
<a href=/player/barbs102>barbs102</a>,Steve Barber,California Angels,ANGELS,3,7,8,15,1973,1976,3,No,0,0.2,6.55,6.35,187,557,370,417,1633,1216,696.0,244.0,-452.0,35000.0,0.0,-35000.0
<a href=/player/barbt101>barbt101</a>,Turner Barber,Washington Senators,TWINS,1,4,1,5,1917,1922,5,No,0,0.0,-0.6,-0.6,0,32,32,0,104,104,0.0,0.0,0.0,0.0,0.0,0.0
<a href=/player/barbt101>barbt101</a>,Turner Barber,Baltimore,Baltimore,1,1,2,3,1917,1926,9,No,0,1.22,0.0,-1.22,443,0,-443,1564,0,-1564,0.0,0.0,0.0,0.0,0.0,0.0
<a href=/player/barbw101>barbw101</a>,Walter Barbare,Pittsburgh Pirates,PIRATS,5,10,8,18,1921,1932,11,No,0,20.59,54.57,33.98,2344,1948,-396,9152,7061,-2091,1307.0,3847.0,2540.0,22300.0,0.0,-22300.0
<a href=/player/barcl001>barcl001</a>,Lorenzo Barcelo,San Francisco Giants,GIANTS,4,11,8,19,1997,2001,4,No,4,22.98,0.1,-22.88,1111,210,-901,1153,268,-885,2846.0,875.0,-1971.0,0.0,0.0,0.0
<a href=/player/bardj001>bardj001</a>,Josh Bard,Colorado Rockies,ROCKS,1,2,1,3,2001,2001,0,No,0,4.57,-0.85,-5.42,461,44,-417,1773,90,-1683,0.0,0.0,0.0,0.0,0.0,0.0
<a href=/player/bardj001>bardj001</a>,Josh Bard,Cleveland Indians,INDINS,2,4,6,10,2006,2011,5,No,0,6.08,6.32,0.24,533,659,126,1913,1893,-20,29.0,785.0,756.0,1950000.0,0.0,-1950000.0
<a href=/player/bardj001>bardj001</a>,Josh Bard,Boston Red Sox,RSOX,1,3,1,4,2006,2008,2,No,0,5.93,-0.85,-6.78,724,107,-617,907,303,-604,712.0,0.0,-712.0,353400.0,0.0,-353400.0
<a href=/player/barfj001>barfj001</a>,Jesse Barfield,Toronto Blue Jays,BJAYS,1,1,1,2,1989,1995,6,No,0,9.91,8.49,-1.42,396,91,-305,1525,0,-1525,0.0,1246.0,1246.0,1300000.0,0.0,-1300000.0
<a href=/player/barfj003>barfj003</a>,Josh Barfield,San Diego Padres,PADRS,5,6,8,14,2006,2013,7,No,0,5.14,8.38,3.24,930,725,-205,2672,2529,-143,264.0,54.0,-210.0,327000.0,0.0,-327000.0
<a href=/player/barkk001>barkk001</a>,Kevin Barker,Milwaukee Brewers,BREWRS,1,1,1,2,2002,2002,0,No,0,-0.11,0.0,0.11,7,0,-7,20,0,-20,0.0,0.0,0.0,0.0,0.0,0.0
<a href=/player/barkl001>barkl001</a>,Len Barker,Texas Rangers,RNGRS,4,7,8,15,1978,1982,4,No,0,19.36,1.68,-17.68,554,422,-132,1098,667,-431,4197.0,810.0,-3387.0,313000.0,0.0,-313000.0
<a href=/player/barkl001>barkl001</a>,Len Barker,Cleveland Indians,INDINS,3,3,8,11,1983,2002,19,No,2,-0.56,56.21,56.77,150,2080,1930,280,7171,6891,699.0,6219.0,5520.0,475000.0,0.0,-475000.0
<a href=/player/barkr102>barkr102</a>,Ray Barker,Baltimore Orioles,ORLS,1,3,1,4,1961,1962,1,No,0,-0.1,0.84,0.94,11,78,67,8,316,308,0.0,0.0,0.0,0.0,0.0,0.0
<a href=/player/barkr102>barkr102</a>,Ray Barker,Cleveland Indians,INDINS,1,1,1,2,1965,1965,0,No,0,0.11,1.21,1.1,176,116,-60,342,432,90,0.0,0.0,0.0,7500.0,0.0,-7500.0
<a href=/player/barkr102>barkr102</a>,Ray Barker,New York Yankees,YANKS,1,4,1,5,1967,1968,1,No,0,0.0,-0.05,-0.05,0,74,74,0,79,79,0.0,678.0,678.0,0.0,0.0,0.0
<a href=/player/barks101>barks101</a>,Sam Barkley,Kansas City Cowboys,KC2,1,1,1,2,1889,1891,2,No,0,0.0,-0.4,-0.4,0,50,50,0,196,196,0.0,0.0,0.0,0.0,0.0,0.0
<a href=/player/barlm101>barlm101</a>,Mike Barlow,Oakland Athletics,ATLTCS,1,2,1,3,1975,1976,1,No,0,-0.15,-0.36,-0.21,18,86,68,0,97,97,23.0,0.0,-23.0,0.0,0.0,0.0
<a href=/player/barlm101>barlm101</a>,Mike Barlow,St. Louis Cardinals,CARDS,2,2,2,4,1975,1976,1,No,0,-0.72,0.0,0.72,53,0,-53,62,0,-62,66.0,0.0,-66.0,0.0,0.0,0.0
<a href=/player/barlm101>barlm101</a>,Mike Barlow,Houston Astros,ASTROS,1,2,1,3,1976,1978,2,No,0,0.55,-0.16,-0.71,312,151,-161,705,515,-190,441.0,0.0,-441.0,0.0,0.0,0.0
<a href=/player/barlm101>barlm101</a>,Mike Barlow,California Angels,ANGELS,1,1,1,2,1980,1980,0,No,0,-0.05,0.0,0.05,53,0,-53,0,0,0,210.0,0.0,-210.0,0.0,0.0,0.0
<a href=/player/barmc001>barmc001</a>,Clint Barmes,Colorado Rockies,ROCKS,1,1,1,2,2010,2011,1,No,0,3.38,-0.44,-3.82,123,36,-87,495,0,-495,0.0,44.0,44.0,3325000.0,0.0,-3325000.0
<a href=/player/barna001>barna001</a>,Austin Barnes,Miami Marlins,MARLNS,3,8,9,17,2014,2020,6,Yes,0,14.59,9.27,-5.32,1600,441,-1159,4137,1747,-2390,525.0,522.0,-3.0,17800000.0,0.0,-17800000.0
<a href=/player/barnb001>barnb001</a>,Brian Barnes,Montreal Expos,NATEX,1,1,1,2,1993,1994,1,No,0,-0.13,0.0,0.13,6,47,41,0,98,98,40.0,0.0,-40.0,182500.0,0.0,-182500.0
<a href=/player/barnb001>barnb001</a>,Brian Barnes,Cleveland Indians,INDINS,1,1,1,2,1994,1994,0,No,0,-0.11,0.0,0.11,10,0,-10,0,0,0,15.0,0.0,-15.0,0.0,0.0,0.0
<a href=/player/barnb002>barnb002</a>,Brandon Barnes,Houston Astros,ASTROS,3,4,5,9,2013,2016,3,No,0,5.67,6.06,0.39,774,357,-417,2028,1370,-658,843.0,53.0,-790.0,491700.0,0.0,-491700.0
<a href=/player/barnb102>barnb102</a>,Babe Barna,New York Giants,GIANTS,1,1,1,2,1943,1943,0,No,0,-0.6,0.15,0.75,30,44,14,127,46,-81,0.0,388.0,388.0,7000.0,0.0,-7000.0
<a href=/player/barnb102>barnb102</a>,Babe Barna,Philadelphia Athletics,ATLTCS,1,4,1,5,1939,1939,0,No,0,0.0,0.0,0.0,0,0,0,0,0,0,0.0,0.0,0.0,3000.0,0.0,-3000.0
<a href=/player/barnd001>barnd001</a>,Darwin Barney,Chicago Cubs,CUBS,1,2,1,3,2014,2014,0,Yes,0,0.76,0.0,-0.76,24,0,-24,49,0,-49,0.0,0.0,0.0,0.0,0.0,0.0
<a href=/player/barnd001>barnd001</a>,Darwin Barney,Los Angeles Dodgers,DOGRS,1,1,1,2,2015,2015,0,Yes,0,1.65,0.0,-1.65,249,0,-249,694,0,-694,3.0,0.0,-3.0,2525000.0,0.0,-2525000.0
<a href=/player/barne104>barne104</a>,Ed Barney,Pittsburgh Pirates,PIRATS,1,1,1,2,1916,1916,0,No,0,0.0,0.16,0.16,0,55,55,0,181,181,0.0,0.0,0.0,2125.0,0.0,-2125.0
<a href=/player/barnf102>barnf102</a>,Frank Barnes,Toronto,Toronto,1,1,3,4,1956,1958,2,No,0,-0.55,0.0,0.55,36,0,-36,11,0,-11,110.0,0.0,-110.0,0.0,0.0,0.0
<a href=/player/barnf102>barnf102</a>,Frank Barnes,Chicago White Sox,WSOX,1,2,2,4,1961,1962,1,No,0,0.0,0.69,0.69,0,79,79,0,145,145,0.0,0.0,0.0,0.0,0.0,0.0
<a href=/player/barnj001>barnj001</a>,John Barnes,Boston Red Sox,RSOX,4,10,6,16,1998,2008,10,No,2,10.55,21.23,10.68,969,325,-644,310,23,-287,3461.0,3027.0,-434.0,859000.0,0.0,-859000.0
<a href=/player/barnj002>barnj002</a>,Jacob Barnes,New York Mets,METS,1,1,1,2,2021,2021,0,Yes,0,-0.07,0.0,0.07,11,0,-11,0,0,0,30.0,0.0,-30.0,750000.0,0.0,-750000.0
<a href=/player/barnj102>barnj102</a>,Jesse Barnes,Boston Braves,BRAVES,2,3,3,6,1918,1921,3,No,0,20.68,4.26,-16.42,840,475,-365,2277,2024,-253,3450.0,0.0,-3450.0,0.0,0.0,0.0
<a href=/player/barnj102>barnj102</a>,Jesse Barnes,New York Giants,GIANTS,1,2,2,4,1923,1923,0,No,0,10.49,3.07,-7.42,305,87,-218,539,194,-345,2035.0,323.0,-1712.0,12500.0,0.0,-12500.0
<a href=/player/barnj102>barnj102</a>,Jesse Barnes,Boston Braves,BRAVES,8,16,14,30,1925,1938,13,No,0,15.59,19.03,3.44,1577,2611,1034,4396,9724,5328,4040.0,1364.0,-2676.0,46800.0,0.0,-46800.0
<a href=/player/barnl101>barnl101</a>,Les Barnhart,Cleveland Indians,INDINS,2,6,4,10,1930,1939,9,No,0,6.18,20.8,14.62,372,942,570,1331,2752,1421,1093.0,2939.0,1846.0,2400.0,0.0,-2400.0
<a href=/player/barnr101>barnr101</a>,Rich Barnes,Chicago White Sox,WSOX,3,4,4,8,1983,1985,2,No,0,0.14,0.07,-0.07,81,9,-72,7,3,-4,156.0,16.0,-140.0,0.0,0.0,0.0
<a href=/player/barnr104>barnr104</a>,Red Barnes,Washington Senators,TWINS,3,5,4,9,1930,1939,9,No,0,0.68,6.27,5.59,134,542,408,466,1630,1164,0.0,0.0,0.0,10500.0,0.0,-10500.0
<a href=/player/barns001>barns001</a>,Skeeter Barnes,Cincinnati Reds,REDS,1,1,1,2,1985,1987,2,No,0,-0.31,0.71,1.02,19,192,173,26,321,295,0.0,0.0,0.0,0.0,0.0,0.0
<a href=/player/barns001>barns001</a>,Skeeter Barnes,Montreal Expos,NATEX,1,2,2,4,1986,1992,6,No,0,0.09,3.06,2.97,102,697,595,18,1867,1849,201.0,144.0,-57.0,415000.0,0.0,-415000.0
<a href=/player/barns002>barns002</a>,Scott Barnes,San Francisco Giants,GIANTS,1,1,1,2,2009,2009,0,No,0,0.05,-0.79,-0.84,24,40,16,0,127,127,83.0,0.0,-83.0,0.0,0.0,0.0
<a href=/player/barnt001>barnt001</a>,Tucker Barnhart,Cincinnati Reds,REDS,1,1,1,2,2021,2021,0,Yes,0,0.0,0.0,0.0,0,0,0,0,0,0,0.0,0.0,0.0,4187500.0,0.0,-4187500.0
<a href=/player/barnv101>barnv101</a>,Virgil Barnes,New York Giants,GIANTS,1,4,1,5,1928,1928,0,No,0,11.88,2.32,-9.56,1432,52,-1380,2925,68,-2857,4700.0,475.0,-4225.0,21900.0,0.0,-21900.0
<a href=/player/barnv102>barnv102</a>,Vic Barnhart,Pittsburgh Pirates,PIRATS,1,2,1,3,1947,1955,8,No,0,0.0,-1.57,-1.57,0,200,200,0,569,569,0.0,0.0,0.0,0.0,0.0,0.0
<a href=/player/baros001>baros001</a>,Salome Barojas,Chicago White Sox,WSOX,2,3,3,6,1984,1989,5,No,0,4.09,3.15,-0.94,327,357,30,0,703,703,1915.0,1149.0,-766.0,440000.0,0.0,-440000.0
<a href=/player/barrb104>barrb104</a>,Bob Barrett,Chicago Cubs,CUBS,1,1,1,2,1925,1925,0,No,0,-0.34,0.17,0.51,100,76,-24,384,262,-122,0.0,0.0,0.0,0.0,0.0,0.0
<a href=/player/barrb104>barrb104</a>,Bob Barrett,Brooklyn Dodgers,DOGRS,1,2,1,3,1927,1927,0,No,0,0.0,0.0,0.0,0,0,0,0,0,0,0.0,0.0,0.0,12000.0,0.0,-12000.0
<a href=/player/barrb105>barrb105</a>,Bill Barrett,Chicago White Sox,WSOX,1,1,1,2,1929,1929,0,No,0,1.29,-1.14,-2.43,117,47,-70,457,136,-321,0.0,0.0,0.0,7000.0,0.0,-7000.0
<a href=/player/barrb105>barrb105</a>,Bill Barrett,Boston Red Sox,RSOX,3,4,4,8,1930,1936,6,No,0,1.11,20.6,19.49,189,1028,839,715,4354,3639,0.0,0.0,0.0,30500.0,0.0,-30500.0
<a href=/player/barrc101>barrc101</a>,Cuno Barragan,Chicago Cubs,CUBS,1,2,1,3,1963,1963,0,No,0,15.76,0.0,-15.76,949,0,-949,117,0,-117,2466.0,0.0,-2466.0,0.0,0.0,0.0
<a href=/player/barrd101>barrd101</a>,Dick Barrett,Boston Braves,BRAVES,2,5,2,7,1934,1940,6,No,0,0.0,6.69,6.69,0,395,395,0,958,958,0.0,2031.0,2031.0,0.0,0.0,0.0
<a href=/player/barrd101>barrd101</a>,Dick Barrett,Philadelphia Athletics,ATLTCS,1,2,1,3,1933,1935,2,No,0,0.0,0.57,0.57,0,102,102,0,81,81,0.0,680.0,680.0,3000.0,0.0,-3000.0
<a href=/player/barrf001>barrf001</a>,Franklin Barreto,Toronto Blue Jays,BJAYS,2,6,2,8,2014,2018,4,Yes,0,6.54,19.48,12.94,350,462,112,887,2066,1179,1411.0,0.0,-1411.0,23516100.0,0.0,-23516100.0
<a href=/player/barrf001>barrf001</a>,Franklin Barreto,Oakland Athletics,ATLTCS,1,1,1,2,2020,2020,0,No,0,-0.23,0.42,0.65,6,27,21,18,111,93,0.0,0.0,0.0,0.0,0.0,0.0
<a href=/player/barrf101>barrf101</a>,Francisco Barrios,Jalisco,Jalisco,1,2,1,3,1973,1973,0,No,0,8.38,0.0,-8.38,129,0,-129,0,0,0,2154.0,0.0,-2154.0,0.0,0.0,0.0
<a href=/player/barrf104>barrf104</a>,Frank Barrett,St. Louis Cardinals,CARDS,1,1,1,2,1944,1946,2,No,0,1.31,-0.16,-1.47,150,16,-134,51,3,-48,529.0,40.0,-489.0,0.0,0.0,0.0
<a href=/player/barrg101>barrg101</a>,German Barranca,Kansas City Royals,ROYALS,1,1,1,2,1981,1983,2,No,0,0.03,0.76,0.73,55,150,95,60,355,295,0.0,0.0,0.0,0.0,0.0,0.0
<a href=/player/barrj001>barrj001</a>,Jeff Barry,Montreal Expos,NATEX,1,1,1,2,1991,1991,0,No,0,-0.13,0.0,0.13,15,0,-15,16,0,-16,0.0,0.0,0.0,0.0,0.0,0.0
<a href=/player/barrj001>barrj001</a>,Jeff Barry,New York Mets,METS,1,1,1,2,1995,1996,1,No,0,0.0,-0.24,-0.24,0,10,10,0,0,0,0.0,21.0,21.0,109000.0,0.0,-109000.0
<a href=/player/barrj001>barrj001</a>,Jeff Barry,Los Angeles Dodgers,DOGRS,1,3,2,5,2001,2001,0,No,0,0.0,0.96,0.96,0,24,24,0,27,27,0.0,238.0,238.0,0.0,0.0,0.0
<a href=/player/barrj104>barrj104</a>,Jack Barry,Boston Red Sox,RSOX,14,27,32,59,1919,1937,18,No,0,90.7,63.54,-27.16,3925,3492,-433,10546,11886,1340,11819.0,5915.0,-5904.0,73300.0,0.0,-73300.0
<a href=/player/barrj106>barrj106</a>,Johnny Barrett,Pittsburgh Pirates,PIRATS,1,1,1,2,1946,1946,0,No,0,-0.14,0.37,0.51,24,58,34,55,162,107,0.0,0.0,0.0,0.0,0.0,0.0
<a href=/player/barrk002>barrk002</a>,Kyle Barraclough,St. Louis Cardinals,CARDS,1,1,1,2,2015,2015,0,No,0,2.64,0.45,-2.19,441,54,-387,2,0,-2,656.0,70.0,-586.0,0.0,0.0,0.0
<a href=/player/barrk002>barrk002</a>,Kyle Barraclough,Miami Marlins,MARLNS,1,1,0,1,2018,2018,0,No,0,-0.72,0.0,0.72,65,0,-65,0,0,0,77.0,0.0,-77.0,1113000.0,0.0,-1113000.0
<a href=/player/barrm002>barrm002</a>,Manuel Barrios,Houston Astros,ASTROS,1,3,1,4,1997,2001,4,No,0,-0.79,11.75,12.54,34,421,387,1,1777,1776,68.0,0.0,-68.0,0.0,0.0,0.0
<a href=/player/barrm002>barrm002</a>,Manuel Barrios,Florida Marlins,MARLNS,15,33,38,71,1998,2019,21,Yes,0,116.45,94.42,-22.03,4698,5470,772,15425,16217,792,10496.0,10160.0,-336.0,68580667.0,0.0,-68580667.0
<a href=/player/barrm002>barrm002</a>,Manuel Barrios,Florida Marlins,MARLNS,1,1,1,2,1998,1999,1,No,0,0.0,-0.03,-0.03,0,4,4,0,4,4,0.0,0.0,0.0,0.0,0.0,0.0
<a href=/player/barrm003>barrm003</a>,Michael Barrett,Montreal Expos,NATEX,1,1,1,2,2003,2003,0,No,0,0.0,0.0,0.0,0,0,0,0,0,0,0.0,0.0,0.0,2600000.0,0.0,-2600000.0
<a href=/player/barrm003>barrm003</a>,Michael Barrett,Oakland Athletics,ATLTCS,4,7,7,14,2003,2016,13,No,2,7.65,9.03,1.38,847,964,117,2220,3425,1205,340.0,0.0,-340.0,410000.0,0.0,-410000.0
<a href=/player/barrm003>barrm003</a>,Michael Barrett,Chicago Cubs,CUBS,3,5,5,10,2007,2011,4,No,1,2.34,-0.92,-3.26,429,67,-362,396,238,-158,801.0,0.0,-801.0,4533333.0,0.0,-4533333.0
<a href=/player/barrr101>barrr101</a>,Red Barrett,Boston Braves,BRAVES,3,4,5,9,1945,1951,6,No,0,3.22,9.25,6.03,172,361,189,151,486,335,1205.0,2522.0,1317.0,0.0,0.0,0.0
<a href=/player/barrs101>barrs101</a>,Shad Barry,Philadelphia Phillies,PHILS,1,1,1,2,1904,1905,1,No,0,0.21,2.0,1.79,100,94,-6,403,118,-285,0.0,908.0,908.0,0.0,0.0,0.0
<a href=/player/barrs101>barrs101</a>,Shad Barry,Cincinnati Reds,REDS,1,1,1,2,1906,1906,0,No,0,-0.34,0.15,0.49,217,60,-157,895,238,-657,0.0,0.0,0.0,0.0,0.0,0.0
<a href=/player/barrs103>barrs103</a>,Steve Barr,Boston Red Sox,RSOX,2,4,3,7,1975,1977,2,No,0,14.8,6.95,-7.85,545,58,-487,1514,0,-1514,2654.0,1206.0,-1448.0,200000.0,0.0,-200000.0
<a href=/player/barrt002>barrt002</a>,Tom Barrett,New York Yankees,YANKS,2,3,3,6,1986,1989,3,No,0,-1.2,3.08,4.28,102,129,27,211,183,-28,200.0,783.0,583.0,658333.0,0.0,-658333.0
<a href=/player/barry001>barry001</a>,Yhonathan Barrios,Pittsburgh Pirates,PIRATS,1,1,2,3,2015,2015,0,No,0,0.3,-0.29,-0.59,10,56,46,0,214,214,20.0,0.0,-20.0,0.0,0.0,0.0
<a href=/player/bartb001>bartb001</a>,Brian Barton,St. Louis Cardinals,CARDS,1,1,1,2,2009,2009,0,No,0,0.0,-0.16,-0.16,1,30,29,0,1,1,0.0,49.0,49.0,0.0,0.0,0.0
<a href=/player/bartb101>bartb101</a>,Bob Barton,San Francisco Giants,GIANTS,1,3,1,4,1969,1969,0,No,0,1.07,0.0,-1.07,369,0,-369,821,0,-821,333.0,0.0,-333.0,0.0,0.0,0.0
<a href=/player/bartb101>bartb101</a>,Bob Barton,San Diego Padres,PADRS,1,1,1,2,1972,1974,2,No,0,0.02,-0.44,-0.46,3,73,70,2,214,212,0.0,0.0,0.0,0.0,0.0,0.0
<a href=/player/bartc001>bartc001</a>,Cliff Bartosh,Cleveland Indians,INDINS,1,1,1,2,2005,2005,0,No,0,-0.01,0.0,0.01,37,0,-37,1,0,-1,59.0,0.0,-59.0,0.0,0.0,0.0
<a href=/player/bartd001>bartd001</a>,Daric Barton,St. Louis Cardinals,CARDS,1,3,1,4,2004,2008,4,No,0,22.03,0.48,-21.55,848,107,-741,2102,105,-1997,2465.0,933.0,-1532.0,305000.0,0.0,-305000.0
<a href=/player/bartd101>bartd101</a>,Dick Bartell,Pittsburgh Pirates,PIRATS,1,1,2,3,1930,1935,5,No,0,9.93,-1.59,-11.52,587,484,-103,2703,1804,-899,0.0,0.0,0.0,6250.0,0.0,-6250.0
<a href=/player/bartd101>bartd101</a>,Dick Bartell,Philadelphia Phillies,PHILS,1,1,5,6,1934,1936,2,No,0,27.34,-1.93,-29.27,835,371,-464,3520,1512,-2008,0.0,0.0,0.0,10500.0,0.0,-10500.0
<a href=/player/bartd101>bartd101</a>,Dick Bartell,New York Giants,GIANTS,2,7,4,11,1938,1949,11,No,0,11.69,46.84,35.15,813,1845,1032,2964,7276,4312,38.0,0.0,-38.0,0.0,0.0,0.0
<a href=/player/bartd101>bartd101</a>,Dick Bartell,Chicago Cubs,CUBS,1,1,1,2,1939,1940,1,No,0,-0.5,-0.57,-0.07,144,33,-111,635,63,-572,0.0,0.0,0.0,20500.0,0.0,-20500.0
<a href=/player/bartj001>bartj001</a>,Jason Bartlett,San Diego Padres,PADRS,1,1,1,2,2002,2004,2,No,0,8.98,0.26,-8.72,324,201,-123,1212,399,-813,0.0,0.0,0.0,0.0,0.0,0.0
<a href=/player/bartj001>bartj001</a>,Jason Bartlett,Minnesota Twins,TWINS,3,6,7,13,2007,2015,8,No,0,34.0,-0.38,-34.38,1580,849,-731,6027,3046,-2981,1777.0,138.0,-1639.0,12330000.0,0.0,-12330000.0
<a href=/player/bartj001>bartj001</a>,Jason Bartlett,Tampa Bay Devil Rays,RAYS,2,2,5,7,2010,2015,5,Yes,0,-0.05,1.36,1.41,239,435,196,716,53,-663,157.0,1270.0,1113.0,4750000.0,0.0,-4750000.0
<a href=/player/bartk001>bartk001</a>,Kimera Bartee,Baltimore Orioles,ORLS,1,2,1,3,1995,2003,8,No,0,-1.6,13.23,14.83,28,211,183,0,27,27,231.0,3863.0,3632.0,109000.0,0.0,-109000.0
<a href=/player/bartk001>bartk001</a>,Kimera Bartee,Anaheim Angels,ANGELS,4,8,7,15,2001,2018,17,No,2,-1.28,25.03,26.31,106,1500,1394,45,5403,5358,108.0,488.0,380.0,0.0,0.0,0.0
<a href=/player/barts001>barts001</a>,Shawn Barton,Philadelphia Phillies,PHILS,1,2,1,3,1988,1988,0,No,0,0.0,-0.19,-0.19,0,20,20,0,31,31,0.0,0.0,0.0,0.0,0.0,0.0
<a href=/player/basal001>basal001</a>,Luis Basabe,Boston Red Sox,RSOX,1,4,1,5,2016,2016,0,Yes,0,14.34,0.0,-14.34,583,0,-583,2288,0,-2288,251.0,0.0,-251.0,0.0,0.0,0.0
<a href=/player/basgm101>basgm101</a>,Monty Basgall,Brooklyn Dodgers,DOGRS,3,3,6,9,1947,1949,2,No,0,-1.55,0.0,1.55,447,0,-447,1458,0,-1458,0.0,0.0,0.0,0.0,0.0,0.0
<a href=/player/basie101>basie101</a>,Eddie Basinski,Brooklyn Dodgers,DOGRS,1,1,1,2,1946,1947,1,No,0,-0.61,0.0,0.61,56,0,-56,182,0,-182,0.0,0.0,0.0,0.0,0.0,0.0
<a href=/player/baskj101>baskj101</a>,Jim Baskette,Cleveland Indians,INDINS,1,1,1,2,1913,1913,0,No,0,0.0,-0.14,-0.14,0,2,2,0,0,0,0.0,3.0,3.0,2400.0,0.0,-2400.0
<a href=/player/bassa001>bassa001</a>,Anthony Bass,San Diego Padres,PADRS,1,2,1,3,2013,2014,1,No,0,-0.87,0.0,0.87,21,0,-21,0,0,0,81.0,0.0,-81.0,503600.0,0.0,-503600.0
<a href=/player/bassa001>bassa001</a>,Anthony Bass,Texas Rangers,RNGRS,2,3,4,7,2015,2020,5,Yes,0,1.97,-1.24,-3.21,224,21,-203,698,0,-698,144.0,64.0,-80.0,5475000.0,0.0,-5475000.0
<a href=/player/bassc001>bassc001</a>,Chris Bassitt,Chicago White Sox,WSOX,1,4,2,6,2014,2018,4,No,0,32.02,0.52,-31.5,1179,80,-1099,4237,2,-4235,1580.0,819.0,-761.0,500000.0,0.0,-500000.0
<a href=/player/bassk001>bassk001</a>,Kevin Bass,Milwaukee Brewers,BREWRS,2,5,4,9,1982,1986,4,No,0,18.77,6.8,-11.97,1695,100,-1595,3977,0,-3977,2039.0,1974.0,-65.0,625000.0,0.0,-625000.0
<a href=/player/bassk001>bassk001</a>,Kevin Bass,San Francisco Giants,GIANTS,1,1,1,2,1992,1992,0,No,0,0.11,0.0,-0.11,46,0,-46,145,0,-145,0.0,0.0,0.0,2000000.0,0.0,-2000000.0
<a href=/player/bassr101>bassr101</a>,Randy Bass,Montreal Expos,NATEX,2,2,3,5,1980,1980,0,No,1,-0.35,0.35,0.7,101,22,-79,292,0,-292,0.0,62.0,62.0,0.0,0.0,0.0
<a href=/player/basta001>basta001</a>,Antonio Bastardo,Philadelphia Phillies,PHILS,2,2,2,4,2014,2017,3,No,0,-0.02,-0.74,-0.72,246,76,-170,3,0,-3,391.0,110.0,-281.0,2535000.0,0.0,-2535000.0
<a href=/player/basta001>basta001</a>,Antonio Bastardo,New York Mets,METS,1,2,1,3,2016,2016,0,No,0,-0.74,-0.56,0.18,73,11,-62,1,1,0,99.0,33.0,-66.0,0.0,0.0,0.0
<a href=/player/batcr001>batcr001</a>,Rich Batchelor,New York Yankees,YANKS,1,1,1,2,1993,1993,0,No,0,-0.38,0.45,0.83,60,8,-52,2,0,-2,123.0,24.0,-99.0,0.0,0.0,0.0
<a href=/player/batcr001>batcr001</a>,Rich Batchelor,St. Louis Cardinals,CARDS,1,3,3,6,1997,1997,0,No,0,-0.21,-1.09,-0.88,425,93,-332,688,180,-508,185.0,68.0,-117.0,4942500.0,0.0,-4942500.0
<a href=/player/bateb001>bateb001</a>,Billy Bates,Milwaukee Brewers,BREWRS,1,2,2,4,1990,1990,0,No,0,3.07,2.88,-0.19,257,33,-224,822,0,-822,0.0,478.0,478.0,675000.0,0.0,-675000.0
<a href=/player/bated101>bated101</a>,Del Bates,California Angels,ANGELS,1,1,1,2,1966,1967,1,No,0,0.0,0.0,0.0,0,0,0,0,0,0,0.0,0.0,0.0,0.0,0.0,0.0
<a href=/player/bated101>bated101</a>,Del Bates,Baltimore Orioles,ORLS,1,2,2,4,1968,1968,0,No,0,0.0,0.0,0.0,0,0,0,0,0,0,0.0,0.0,0.0,0.0,0.0,0.0
<a href=/player/bated101>bated101</a>,Del Bates,Pittsburgh Pirates,PIRATS,1,1,2,3,1970,1970,0,No,0,-0.64,0.0,0.64,22,0,-22,70,0,-70,0.0,0.0,0.0,0.0,0.0,0.0
<a href=/player/batej101>batej101</a>,Johnny Bates,Boston Braves,BRAVES,5,7,8,15,1909,1927,18,No,0,12.27,37.78,25.51,647,1815,1168,1592,4784,3192,2058.0,9235.0,7177.0,6000.0,0.0,-6000.0
<a href=/player/batej101>batej101</a>,Johnny Bates,Philadelphia Phillies,PHILS,12,24,28,52,1910,1931,21,No,0,100.95,91.27,-9.68,4848,5202,354,15981,18765,2784,10753.0,6282.0,-4471.0,25000.0,0.0,-25000.0
<a href=/player/batej102>batej102</a>,John Bateman,Montreal Expos,NATEX,2,2,2,4,1972,1972,0,No,0,-1.18,0.44,1.62,286,77,-209,783,259,-524,0.0,0.0,0.0,0.0,0.0,0.0
<a href=/player/bater101>bater101</a>,Ray Bates,Philadelphia Athletics,ATLTCS,1,3,1,4,1919,1921,2,No,0,0.0,-1.44,-1.44,0,50,50,0,86,86,0.0,133.0,133.0,0.0,0.0,0.0
<a href=/player/bathb001>bathb001</a>,Bill Bathe,Oakland Athletics,ATLTCS,1,1,1,2,1986,1986,0,No,0,0.0,0.0,0.0,0,0,0,0,0,0,0.0,0.0,0.0,0.0,0.0,0.0
<a href=/player/batik001>batik001</a>,Kevin Batiste,Toronto Blue Jays,BJAYS,1,2,1,3,1989,1993,4,No,0,-1.22,-0.11,1.11,67,2,-65,204,0,-204,0.0,5.0,5.0,800000.0,0.0,-800000.0
<a href=/player/batim001>batim001</a>,Miguel Batista,Chicago Cubs,CUBS,7,11,10,21,1997,2011,14,No,1,4.72,8.86,4.14,878,964,86,1047,3569,2522,1883.0,0.0,-1883.0,11986333.0,0.0,-11986333.0
<a href=/player/batim001>batim001</a>,Miguel Batista,Montreal Expos,NATEX,1,1,1,2,2000,2000,0,No,0,-0.99,-0.18,0.81,16,12,-4,3,1,-2,171.0,16.0,-155.0,325000.0,0.0,-325000.0
<a href=/player/batim001>batim001</a>,Miguel Batista,Toronto Blue Jays,BJAYS,5,10,12,22,2005,2014,9,No,0,23.63,23.44,-0.19,1360,1086,-274,3834,4118,284,1461.0,175.0,-1286.0,24569600.0,0.0,-24569600.0
<a href=/player/batit001>batit001</a>,Tony Batista,Arizona Diamondbacks,DBACKS,1,2,1,3,1999,2000,1,No,0,6.98,0.84,-6.14,434,187,-247,1364,1,-1363,379.0,185.0,-194.0,720000.0,0.0,-720000.0
<a href=/player/batta001>batta001</a>,Allen Battle,St. Louis Cardinals,CARDS,7,13,12,25,1996,2004,8,No,1,8.44,23.16,14.72,1305,1318,13,4128,1707,-2421,1089.0,4162.0,3073.0,14483333.0,0.0,-14483333.0
<a href=/player/battc101>battc101</a>,Chris Batton,Oakland Athletics,ATLTCS,5,10,14,24,1977,1991,14,No,0,17.32,67.59,50.27,1802,3570,1768,5305,11715,6410,956.0,6372.0,5416.0,0.0,0.0,0.0
<a href=/player/batte101>batte101</a>,Earl Battey,Chicago White Sox,WSOX,3,5,6,11,1960,1967,7,No,0,32.09,12.95,-19.14,2200,685,-1515,7735,1568,-6167,0.0,2599.0,2599.0,44000.0,0.0,-44000.0
<a href=/player/batth001>batth001</a>,Howard Battle,Toronto Blue Jays,BJAYS,2,4,3,7,1995,2002,7,No,0,7.82,10.52,2.7,990,426,-564,2406,2,-2404,537.0,1768.0,1231.0,1909000.0,0.0,-1909000.0
<a href=/player/battm101>battm101</a>,Matt Batts,Boston Red Sox,RSOX,3,7,4,11,1951,1954,3,No,0,1.03,-2.94,-3.97,539,149,-390,1347,410,-937,675.0,0.0,-675.0,8500.0,0.0,-8500.0
<a href=/player/battm101>battm101</a>,Matt Batts,St.Louis Browns,ORLS,23,51,48,99,1952,1994,42,No,3,84.08,155.33,71.25,5312,9112,3800,11244,26050,14806,18662.0,17928.0,-734.0,984333.0,0.0,-984333.0
<a href=/player/battm101>battm101</a>,Matt Batts,Detroit Tigers,TIGRS,2,3,2,5,1954,1960,6,No,0,-0.4,5.2,5.6,97,511,414,306,1772,1466,0.0,0.0,0.0,12000.0,0.0,-12000.0
<a href=/player/battm101>battm101</a>,Matt Batts,Chicago White Sox,WSOX,29,56,55,111,1954,1971,17,No,0,64.71,122.48,57.77,7633,8254,621,20626,20005,-621,7158.0,13512.0,6354.0,248750.0,0.0,-248750.0
<a href=/player/baueh101>baueh101</a>,Hank Bauer,New York Yankees,YANKS,4,7,6,13,1959,1969,10,No,0,14.99,27.57,12.58,1233,1032,-201,4340,4017,-323,296.0,0.0,-296.0,175000.0,0.0,-175000.0
<a href=/player/bauej001>bauej001</a>,Jake Bauers,San Diego Padres,PADRS,3,7,6,13,2014,2020,6,Yes,0,-1.53,-1.48,0.05,295,146,-149,1021,301,-720,0.0,78.0,78.0,506400.0,0.0,-506400.0
<a href=/player/bauej001>bauej001</a>,Jake Bauers,Tampa Bay Devil Rays,RAYS,1,2,2,4,2018,2019,1,Yes,0,-1.03,0.28,1.31,160,8,-152,536,0,-536,0.0,22.0,22.0,0.0,0.0,0.0
<a href=/player/bauej001>bauej001</a>,Jake Bauers,Cleveland Indians,INDINS,1,1,1,2,2021,2021,0,Yes,0,-0.04,0.0,0.04,72,0,-72,202,0,-202,0.0,0.0,0.0,0.0,0.0,0.0
<a href=/player/bauet001>bauet001</a>,Trevor Bauer,Arizona Diamondbacks,DBACKS,3,6,6,12,2012,2021,9,No,0,44.83,10.87,-33.96,1441,607,-834,2691,1018,-1673,5272.0,2512.0,-2760.0,11602833.0,0.0,-11602833.0
<a href=/player/bauet001>bauet001</a>,Trevor Bauer,Cleveland Indians,INDINS,1,1,5,6,2019,2019,0,Yes,0,2.49,0.68,-1.81,30,101,71,16,401,385,388.0,7.0,-381.0,13000000.0,0.0,-13000000.0
<a href=/player/baumf101>baumf101</a>,Frank Baumholtz,Cincinnati Reds,REDS,3,4,5,9,1949,1951,2,No,0,25.39,2.56,-22.83,1630,361,-1269,6349,1295,-5054,0.0,0.0,0.0,10000.0,0.0,-10000.0
<a href=/player/baumf102>baumf102</a>,Frank Baumann,Boston Red Sox,RSOX,2,2,2,4,1959,1960,1,No,0,4.03,-0.89,-4.92,374,44,-330,184,121,-63,1725.0,0.0,-1725.0,0.0,0.0,0.0
<a href=/player/baumf102>baumf102</a>,Frank Baumann,Chicago White Sox,WSOX,2,2,2,4,1964,1965,1,No,0,-0.71,0.21,0.92,32,45,13,38,37,-1,11.0,80.0,69.0,30500.0,0.0,-30500.0
<a href=/player/baumg101>baumg101</a>,George Baumgardner,St.Louis Browns,ORLS,1,3,1,4,1916,1916,0,No,0,0.0,0.05,0.05,0,27,27,0,42,42,0.0,0.0,0.0,4200.0,0.0,-4200.0
<a href=/player/baumj102>baumj102</a>,Jim Baumer,Chicago White Sox,WSOX,4,10,7,17,1954,1961,7,No,0,23.22,8.09,-15.13,1221,1065,-156,3572,3021,-551,2246.0,488.0,-1758.0,62000.0,0.0,-62000.0
<a href=/player/baumj102>baumj102</a>,Jim Baumer,Cincinnati Reds,REDS,1,1,1,2,1961,1961,0,No,0,0.0,0.25,0.25,0,40,40,0,72,72,0.0,0.0,0.0,0.0,0.0,0.0
<a href=/player/baump101>baump101</a>,Paddy Baumann,NewBedford,NewBedford,1,1,2,3,1911,1911,0,No,0,0.64,0.0,-0.64,95,0,-95,385,0,-385,0.0,0.0,0.0,0.0,0.0,0.0
<a href=/player/baumr101>baumr101</a>,Ross Baumgarten,Chicago White Sox,WSOX,2,3,3,6,1982,1987,5,No,0,4.43,7.04,2.61,422,580,158,1527,1402,-125,154.0,667.0,513.0,0.0,0.0,0.0
<a href=/player/baums101>baums101</a>,Stan Baumgartner,NewHaven,NewHaven,1,1,3,4,1924,1924,0,No,0,8.0,0.0,-8.0,166,0,-166,103,0,-103,950.0,0.0,-950.0,0.0,0.0,0.0
<a href=/player/bautd001>bautd001</a>,Danny Bautista,Detroit Tigers,TIGRS,2,2,2,4,1996,1999,3,No,0,0.37,-0.1,-0.47,163,32,-131,291,0,-291,0.0,78.0,78.0,185000.0,0.0,-185000.0
<a href=/player/bautd001>bautd001</a>,Danny Bautista,Florida Marlins,MARLNS,1,1,1,2,2000,2003,3,No,0,-0.42,-0.72,-0.3,456,326,-130,1595,905,-690,0.0,0.0,0.0,500000.0,0.0,-500000.0
<a href=/player/bautd002>bautd002</a>,Denny Bautista,Florida Marlins,MARLNS,1,2,1,3,2003,2005,2,No,0,-0.35,2.59,2.94,2,296,294,0,1062,1062,6.0,0.0,-6.0,0.0,0.0,0.0
<a href=/player/bautd002>bautd002</a>,Denny Bautista,Baltimore Orioles,ORLS,1,1,1,2,2004,2005,1,No,0,0.22,-0.61,-0.83,20,65,45,0,0,0,295.0,175.0,-120.0,0.0,0.0,0.0
<a href=/player/bautd002>bautd002</a>,Denny Bautista,Kansas City Royals,ROYALS,1,2,2,4,2006,2009,3,No,0,-0.8,0.46,1.26,227,144,-83,3,478,475,305.0,71.0,-234.0,1335500.0,0.0,-1335500.0
<a href=/player/bautd002>bautd002</a>,Denny Bautista,Colorado Rockies,ROCKS,1,1,1,2,2007,2007,0,No,0,0.41,0.0,-0.41,16,0,-16,0,0,0,57.0,0.0,-57.0,0.0,0.0,0.0
<a href=/player/bautd002>bautd002</a>,Denny Bautista,Detroit Tigers,TIGRS,1,1,1,2,2008,2008,0,No,0,-0.59,0.0,0.59,98,0,-98,5,0,-5,165.0,0.0,-165.0,395000.0,0.0,-395000.0
<a href=/player/baute101>baute101</a>,Ed Bauta,Pittsburgh Pirates,PIRATS,2,3,3,6,1960,1962,2,No,0,13.99,2.03,-11.96,1772,159,-1613,6120,213,-5907,474.0,816.0,342.0,0.0,0.0,0.0
<a href=/player/baute101>baute101</a>,Ed Bauta,St. Louis Cardinals,CARDS,14,27,22,49,1963,1972,9,No,0,30.41,1.96,-28.45,3351,779,-2572,8522,1730,-6792,1979.0,729.0,-1250.0,32500.0,0.0,-32500.0
<a href=/player/bautg001>bautg001</a>,Gerson Bautista,Boston Red Sox,RSOX,1,3,1,4,2017,2017,0,No,0,-0.57,0.56,1.13,43,31,-12,1,0,-1,62.0,81.0,19.0,0.0,0.0,0.0
<a href=/player/bautg001>bautg001</a>,Gerson Bautista,New York Mets,METS,1,5,3,8,2018,2018,0,Yes,0,-0.49,0.0,0.49,191,0,-191,565,0,-565,376.0,0.0,-376.0,16500000.0,0.0,-16500000.0
<a href=/player/bautj002>bautj002</a>,Jose Bautista,Kansas City Royals,ROYALS,1,1,1,2,2004,2008,4,No,0,1.21,-1.32,-2.53,83,38,-45,302,106,-196,0.0,0.0,0.0,0.0,0.0,0.0
<a href=/player/bautj002>bautj002</a>,Jose Bautista,New York Mets,METS,4,6,6,12,2004,2010,6,No,0,-0.86,11.14,12.0,655,533,-122,1973,723,-1250,683.0,3210.0,2527.0,2841000.0,0.0,-2841000.0
<a href=/player/bautj002>bautj002</a>,Jose Bautista,Pittsburgh Pirates,PIRATS,1,1,1,2,2008,2009,1,No,0,38.31,0.65,-37.66,1235,43,-1192,5272,144,-5128,0.0,0.0,0.0,1800000.0,0.0,-1800000.0
<a href=/player/bautj002>bautj002</a>,Jose Bautista,New York Mets,METS,1,1,1,2,2018,2018,0,No,0,0.39,0.0,-0.39,27,0,-27,57,0,-57,0.0,0.0,0.0,545000.0,0.0,-545000.0
<a href=/player/baxej101>baxej101</a>,Jim Baxes,Los Angeles Dodgers,DOGRS,2,4,4,8,1959,1959,0,No,0,0.68,0.0,-0.68,77,0,-77,270,0,-270,0.0,0.0,0.0,10000.0,0.0,-10000.0
<a href=/player/baxej101>baxej101</a>,Jim Baxes,Chicago White Sox,WSOX,1,1,1,2,1960,1961,1,No,0,0.0,0.0,0.0,0,0,0,0,0,0,0.0,0.0,0.0,0.0,0.0,0.0
<a href=/player/baxem101>baxem101</a>,Mike Baxes,Kansas City Athletics,ATLTCS,25,53,47,100,1959,1976,17,No,0,93.37,60.18,-33.19,8944,6275,-2669,21756,18191,-3565,9976.0,4965.0,-5011.0,504100.0,0.0,-504100.0
<a href=/player/bay-j001>bay-j001</a>,Jason Bay,Montreal Expos,NATEX,1,2,1,3,2002,2002,0,No,0,1.77,-0.23,-2.0,288,13,-275,1125,14,-1111,0.0,0.0,0.0,0.0,0.0,0.0
<a href=/player/bay-j001>bay-j001</a>,Jason Bay,New York Mets,METS,1,3,2,5,2002,2003,1,No,0,0.08,0.83,0.75,11,64,53,13,7,-6,29.0,147.0,118.0,0.0,0.0,0.0
<a href=/player/bay-j001>bay-j001</a>,Jason Bay,San Diego Padres,PADRS,1,3,1,4,2003,2009,6,No,0,19.18,17.35,-1.83,859,833,-26,3184,3689,505,1194.0,0.0,-1194.0,305000.0,0.0,-305000.0
<a href=/player/bay-j001>bay-j001</a>,Jason Bay,Pittsburgh Pirates,PIRATS,2,2,5,7,2008,2014,6,No,0,9.76,-1.02,-10.78,453,695,242,850,1678,828,364.0,347.0,-17.0,6511500.0,0.0,-6511500.0
<a href=/player/bayld001>bayld001</a>,Don Baylor,Baltimore Orioles,ORLS,11,24,22,46,1976,1994,18,No,3,56.21,91.98,35.77,2586,4496,1910,5425,11173,5748,12108.0,13984.0,1876.0,713333.0,0.0,-713333.0
<a href=/player/bayld001>bayld001</a>,Don Baylor,New York Yankees,YANKS,3,4,4,8,1986,1989,3,No,0,0.87,5.14,4.27,370,275,-95,1307,729,-578,200.0,783.0,583.0,658333.0,0.0,-658333.0
<a href=/player/bayld001>bayld001</a>,Don Baylor,Boston Red Sox,RSOX,1,1,1,2,1987,1987,0,No,0,-0.07,0.0,0.07,20,0,-20,58,0,-58,0.0,0.0,0.0,0.0,0.0,0.0
<a href=/player/baylj001>baylj001</a>,Jonah Bayliss,Kansas City Royals,ROYALS,1,2,1,3,2005,2006,1,No,0,-1.27,0.11,1.38,95,30,-65,0,3,3,157.0,501.0,344.0,0.0,0.0,0.0
<a href=/player/baynb101>baynb101</a>,Bill Bayne,St.Louis Browns,ORLS,29,55,62,117,1924,1952,28,No,0,152.63,143.12,-9.51,7484,11236,3752,22593,31279,8686,18747.0,30694.0,11947.0,281100.0,0.0,-281100.0
<a href=/player/baz-s001>baz-s001</a>,Shane Baz,Pittsburgh Pirates,PIRATS,1,3,1,4,2018,2020,2,No,0,12.58,1.43,-11.15,379,64,-315,1364,58,-1306,825.0,516.0,-309.0,556500.0,0.0,-556500.0
<a href=/player/bazay001>bazay001</a>,Yorman Bazardo,Florida Marlins,MARLNS,2,3,2,5,2005,2005,0,No,0,0.68,-0.67,-1.35,117,54,-63,0,1,1,368.0,71.0,-297.0,0.0,0.0,0.0
<a href=/player/bazay001>bazay001</a>,Yorman Bazardo,Seattle Mariners,MARNRS,1,1,1,2,2007,2008,1,No,0,0.37,0.0,-0.37,15,0,-15,0,0,0,80.0,0.0,-80.0,0.0,0.0,0.0
<a href=/player/bealb101>bealb101</a>,Bob Beall,Philadelphia Phillies,PHILS,1,1,1,2,1973,1973,0,No,0,-0.36,0.0,0.36,145,0,-145,282,0,-282,0.0,0.0,0.0,0.0,0.0,0.0
<a href=/player/bealb101>bealb101</a>,Bob Beall,Atlanta Braves,BRAVES,1,1,1,2,1980,1980,0,No,0,0.0,0.0,0.0,3,0,-3,3,0,-3,0.0,0.0,0.0,0.0,0.0,0.0
<a href=/player/bealj101>bealj101</a>,Johnny Beall,Cleveland Indians,INDINS,1,1,1,2,1913,1915,2,No,0,0.0,2.31,2.31,0,265,265,0,1014,1014,0.0,0.0,0.0,2040.0,0.0,-2040.0
<a href=/player/bealj101>bealj101</a>,Johnny Beall,Chicago White Sox,WSOX,2,6,2,8,1913,1916,3,No,0,11.33,-0.33,-11.66,533,82,-451,1606,278,-1328,1090.0,0.0,-1090.0,0.0,0.0,0.0
<a href=/player/bealj101>bealj101</a>,Johnny Beall,Milwaukee,Milwaukee,1,2,2,4,1918,1918,0,No,0,-0.15,0.0,0.15,31,0,-31,60,0,-60,69.0,0.0,-69.0,0.0,0.0,0.0
<a href=/player/beamt001>beamt001</a>,Trey Beamon,Pittsburgh Pirates,PIRATS,2,3,3,6,1997,1998,1,No,0,-0.39,-0.19,0.2,43,160,117,68,469,401,0.0,0.0,0.0,0.0,0.0,0.0
<a href=/player/beamt001>beamt001</a>,Trey Beamon,San Diego Padres,PADRS,11,16,16,32,1997,2005,8,No,0,0.63,9.5,8.87,874,1331,457,1663,2360,697,1171.0,1867.0,696.0,13510000.0,0.0,-13510000.0
<a href=/player/beanb001>beanb001</a>,Billy Beane,New York Mets,METS,2,4,3,7,1986,1991,5,No,0,0.96,6.32,5.36,405,543,138,1082,1694,612,117.0,0.0,-117.0,637500.0,0.0,-637500.0
<a href=/player/beanb001>beanb001</a>,Billy Beane,Minnesota Twins,TWINS,2,2,2,4,1988,1989,1,No,0,0.01,-0.69,-0.7,6,11,5,6,0,-6,0.0,52.0,52.0,0.0,0.0,0.0
<a href=/player/beanb002>beanb002</a>,Bill Bean,Detroit Tigers,TIGRS,1,1,2,3,1989,1989,0,No,0,-0.42,0.0,0.42,51,0,-51,76,0,-76,0.0,0.0,0.0,70400.0,0.0,-70400.0
<a href=/player/beanb101>beanb101</a>,Belve Bean,Cleveland Indians,INDINS,1,1,1,2,1935,1935,0,No,0,-0.22,-0.66,-0.44,20,48,28,9,33,24,93.0,273.0,180.0,4200.0,0.0,-4200.0
<a href=/player/beard001>beard001</a>,Dave Beard,Oakland Athletics,ATLTCS,5,10,9,19,1983,1994,11,No,0,10.8,21.09,10.29,1624,930,-694,3370,2503,-867,1865.0,4119.0,2254.0,1837653.0,0.0,-1837653.0
<a href=/player/beard001>beard001</a>,Dave Beard,Cleveland Indians,INDINS,1,1,1,2,1985,1985,0,No,0,-0.09,0.0,0.09,18,0,-18,0,0,0,38.0,0.0,-38.0,0.0,0.0,0.0
<a href=/player/bearg101>bearg101</a>,Gary Beare,Milwaukee Brewers,BREWRS,1,1,1,2,1979,1981,2,No,0,0.0,-0.61,-0.61,0,16,16,0,0,0,0.0,71.0,71.0,0.0,0.0,0.0
<a href=/player/bearg102>bearg102</a>,Gene Bearden,New York Yankees,YANKS,3,10,5,15,1946,1954,8,No,0,30.84,1.34,-29.5,1405,374,-1031,2470,260,-2210,6379.0,1746.0,-4633.0,11500.0,0.0,-11500.0
<a href=/player/bearg102>bearg102</a>,Gene Bearden,Detroit Tigers,TIGRS,11,26,24,50,1952,1961,9,No,0,21.38,15.7,-5.68,2119,2215,96,3938,6442,2504,5639.0,2357.0,-3282.0,45200.0,0.0,-45200.0
<a href=/player/bearg102>bearg102</a>,Gene Bearden,Chicago White Sox,WSOX,1,1,2,3,1954,1954,0,No,0,0.0,0.0,0.0,0,0,0,0,0,0,0.0,0.0,0.0,0.0,0.0,0.0
<a href=/player/bearm101>bearm101</a>,Mike Beard,Atlanta Braves,BRAVES,2,2,2,4,1977,1980,3,No,0,2.36,4.13,1.77,123,174,51,99,133,34,822.0,1142.0,320.0,0.0,0.0,0.0
<a href=/player/beasj001>beasj001</a>,Jeremy Beasley,Anaheim Angels,ANGELS,1,1,1,2,2020,2020,0,No,0,0.01,0.6,0.59,1,16,15,0,0,0,1.0,96.0,95.0,0.0,0.0,0.0
<a href=/player/beatb001>beatb001</a>,Blaine Beatty,Baltimore Orioles,ORLS,1,2,1,3,1987,1988,1,No,0,0.54,1.0,0.46,14,52,38,2,0,-2,47.0,283.0,236.0,0.0,0.0,0.0
<a href=/player/beatb001>beatb001</a>,Blaine Beatty,New York Mets,METS,2,2,2,4,1991,1996,5,No,0,0.0,-0.37,-0.37,0,25,25,0,16,16,0.0,21.0,21.0,109000.0,0.0,-109000.0
<a href=/player/beatj001>beatj001</a>,Jim Beattie,New York Yankees,YANKS,7,17,13,30,1979,1992,13,No,0,39.2,19.95,-19.25,2768,1137,-1631,6569,3883,-2686,8301.0,701.0,-7600.0,913333.0,0.0,-913333.0
<a href=/player/beatp001>beatp001</a>,Pedro Beato,New York Mets,METS,1,1,1,2,2012,2012,0,No,0,0.03,0.1,0.07,14,28,14,0,87,87,53.0,0.0,-53.0,487500.0,0.0,-487500.0
<a href=/player/beaug101>beaug101</a>,Ginger Beaumont,Milwaukee,Milwaukee,1,1,2,3,1898,1901,3,No,0,22.3,0.0,-22.3,989,0,-989,4449,0,-4449,0.0,0.0,0.0,0.0,0.0,0.0
<a href=/player/beaug101>beaug101</a>,Ginger Beaumont,Pittsburgh Pirates,PIRATS,1,3,1,4,1906,1910,4,No,0,14.38,6.11,-8.27,866,332,-534,3143,1286,-1857,1417.0,0.0,-1417.0,0.0,0.0,0.0
<a href=/player/beaug101>beaug101</a>,Ginger Beaumont,Boston Braves,BRAVES,1,1,2,3,1910,1910,0,No,0,0.76,0.0,-0.76,76,5,-71,210,4,-206,0.0,0.0,0.0,0.0,0.0,0.0
<a href=/player/beauj101>beauj101</a>,Jim Beauchamp,St. Louis Cardinals,CARDS,1,2,1,3,1964,1965,1,No,0,-0.99,-0.76,0.23,78,138,60,148,253,105,0.0,0.0,0.0,0.0,0.0,0.0
<a href=/player/beauj101>beauj101</a>,Jim Beauchamp,Houston Astros,ASTROS,5,7,7,14,1965,1978,13,No,0,10.97,1.23,-9.74,645,1545,900,1174,5736,4562,2468.0,122.0,-2346.0,0.0,0.0,0.0
<a href=/player/beauj101>beauj101</a>,Jim Beauchamp,Atlanta Braves,BRAVES,1,3,1,4,1967,1968,1,No,0,0.5,-0.77,-1.27,233,127,-106,406,383,-23,170.0,0.0,-170.0,0.0,0.0,0.0
<a href=/player/beauj101>beauj101</a>,Jim Beauchamp,Cincinnati Reds,REDS,1,1,2,3,1969,1970,1,No,0,-0.13,0.0,0.13,31,0,-31,29,0,-29,0.0,0.0,0.0,0.0,0.0,0.0
<a href=/player/beauj101>beauj101</a>,Jim Beauchamp,Houston Astros,ASTROS,1,2,1,3,1970,1973,3,No,0,-0.36,4.11,4.47,121,272,151,243,41,-202,0.0,713.0,713.0,0.0,0.0,0.0
<a href=/player/beauj101>beauj101</a>,Jim Beauchamp,St. Louis Cardinals,CARDS,9,16,14,30,1971,1976,5,No,0,14.55,3.01,-11.54,1564,430,-1134,3017,530,-2487,3834.0,1012.0,-2822.0,0.0,0.0,0.0
<a href=/player/beavb001>beavb001</a>,Blake Beavan,Texas Rangers,RNGRS,2,5,4,9,2010,2012,2,No,2,2.66,1.99,-0.67,576,111,-465,1946,0,-1946,977.0,588.0,-389.0,0.0,0.0,0.0
<a href=/player/beckb101>beckb101</a>,Beals Becker,Boston Braves,BRAVES,13,25,26,51,1910,1938,28,No,0,36.88,50.32,13.44,3190,4555,1365,9582,15721,6139,4682.0,4013.0,-669.0,56400.0,0.0,-56400.0
<a href=/player/beckb101>beckb101</a>,Beals Becker,Cincinnati Reds,REDS,1,1,1,2,1913,1913,0,No,0,6.96,0.1,-6.86,338,94,-244,1275,344,-931,0.0,0.0,0.0,3500.0,0.0,-3500.0
<a href=/player/beckb103>beckb103</a>,Bill Beckmann,Toronto,Toronto,1,2,1,3,1942,1943,1,No,0,0.32,0.0,-0.32,4,0,-4,2,0,-2,21.0,0.0,-21.0,0.0,0.0,0.0
<a href=/player/beckc001>beckc001</a>,Chad Beck,Arizona Diamondbacks,DBACKS,1,1,1,2,2008,2008,0,No,0,-0.21,-0.14,0.07,19,18,-1,0,73,73,54.0,0.0,-54.0,0.0,0.0,0.0
<a href=/player/beckc102>beckc102</a>,Charlie Becker,Washington Senators,TWINS,1,3,1,4,1912,1916,4,No,0,0.0,13.55,13.55,0,546,546,0,2246,2246,0.0,0.0,0.0,0.0,0.0,0.0
<a href=/player/beckf101>beckf101</a>,Fred Beck,Cincinnati Reds,REDS,4,9,7,16,1911,1913,2,No,0,9.68,9.52,-0.16,908,358,-550,2525,783,-1742,1567.0,1169.0,-398.0,11280.0,0.0,-11280.0
<a href=/player/beckg001>beckg001</a>,Gordon Beckham,Chicago White Sox,WSOX,4,6,7,13,2014,2017,3,Yes,0,4.3,2.11,-2.19,554,83,-471,311,0,-311,1065.0,220.0,-845.0,16710000.0,0.0,-16710000.0
<a href=/player/beckg001>beckg001</a>,Gordon Beckham,Atlanta Braves,BRAVES,1,1,1,2,2016,2016,0,Yes,0,-0.23,0.0,0.23,3,0,-3,6,0,-6,0.0,0.0,0.0,1250000.0,0.0,-1250000.0
<a href=/player/beckg101>beckg101</a>,Glenn Beckert,Chicago Cubs,CUBS,13,24,24,48,1973,1990,17,No,0,18.74,18.43,-0.31,3099,2396,-703,8125,5700,-2425,1137.0,4804.0,3667.0,1020000.0,0.0,-1020000.0
<a href=/player/beckh102>beckh102</a>,Heinz Becker,Chicago Cubs,CUBS,1,1,2,3,1946,1946,0,No,0,0.89,0.0,-0.89,52,0,-52,174,0,-174,0.0,0.0,0.0,8500.0,0.0,-8500.0
<a href=/player/beckh102>beckh102</a>,Heinz Becker,Boston Braves,BRAVES,1,3,1,4,1948,1952,4,No,0,0.0,-0.21,-0.21,0,104,104,0,35,35,0.0,376.0,376.0,0.0,0.0,0.0
<a href=/player/beckj001>beckj001</a>,Joe Beckwith,Los Angeles Dodgers,DOGRS,1,1,3,4,1983,1990,7,No,0,2.06,0.0,-2.06,98,0,-98,0,0,0,587.0,0.0,-587.0,0.0,0.0,0.0
<a href=/player/beckj002>beckj002</a>,Josh Beckett,Florida Marlins,MARLNS,7,14,19,33,2005,2019,14,Yes,0,61.63,50.29,-11.34,1841,2297,456,4569,6863,2294,8636.0,5082.0,-3554.0,29867000.0,0.0,-29867000.0
<a href=/player/beckj002>beckj002</a>,Josh Beckett,Boston Red Sox,RSOX,7,22,14,36,2012,2019,7,Yes,0,37.54,19.18,-18.36,2738,1439,-1299,4768,4566,-202,4720.0,1908.0,-2812.0,4708000.0,0.0,-4708000.0
<a href=/player/beckj102>beckj102</a>,Joe Becker,Brooklyn Dodgers,DOGRS,2,9,3,12,1941,1947,6,No,0,3.3,-0.19,-3.49,337,37,-300,419,81,-338,1285.0,0.0,-1285.0,17500.0,0.0,-17500.0
<a href=/player/beckj103>beckj103</a>,Jake Beckley,Pittsburgh Pirates,PIRATS,1,1,2,3,1896,1898,2,No,0,1.45,2.13,0.68,63,213,150,270,903,633,0.0,0.0,0.0,0.0,0.0,0.0
<a href=/player/beckr001>beckr001</a>,Rod Beck,Oakland Athletics,ATLTCS,1,1,1,2,1988,1988,0,No,0,7.12,0.0,-7.12,827,0,-827,18,0,-18,1389.0,0.0,-1389.0,0.0,0.0,0.0
<a href=/player/beckr001>beckr001</a>,Rod Beck,Chicago Cubs,CUBS,3,4,4,8,1999,2000,1,No,0,3.32,-1.65,-4.97,197,144,-53,135,190,55,502.0,93.0,-409.0,7100000.0,0.0,-7100000.0
<a href=/player/beckr002>beckr002</a>,Rich Becker,Minnesota Twins,TWINS,2,2,2,4,1997,1998,1,No,0,3.21,-1.81,-5.02,253,94,-159,702,260,-442,0.0,0.0,0.0,442500.0,0.0,-442500.0
<a href=/player/beckr002>beckr002</a>,Rich Becker,Milwaukee Brewers,BREWRS,1,1,1,2,1999,1999,0,No,0,0.82,-0.37,-1.19,63,8,-55,212,0,-212,0.0,12.0,12.0,475000.0,0.0,-475000.0
<a href=/player/beckt001>beckt001</a>,Tim Beckham,Tampa Bay Devil Rays,RAYS,2,2,2,4,2017,2021,4,Yes,0,2.45,0.0,-2.45,146,0,-146,632,0,-632,0.0,0.0,0.0,885000.0,0.0,-885000.0
<a href=/player/beckz101>beckz101</a>,Zinn Beck,New York Yankees,YANKS,5,14,8,22,1919,1946,27,No,0,28.58,90.66,62.08,995,2697,1702,1312,4980,3668,7730.0,17113.0,9383.0,42500.0,0.0,-42500.0
<a href=/player/bedae001>bedae001</a>,Erik Bedard,Baltimore Orioles,ORLS,4,5,10,15,2008,2018,10,No,0,5.58,43.61,38.03,799,2337,1538,68,8243,8175,1735.0,3798.0,2063.0,3152500.0,0.0,-3152500.0
<a href=/player/bedae001>bedae001</a>,Erik Bedard,Seattle Mariners,MARNRS,3,4,4,8,2011,2013,2,No,0,0.23,-0.5,-0.73,8,119,111,0,404,404,114.0,0.0,-114.0,1000000.0,0.0,-1000000.0
<a href=/player/bedeh101>bedeh101</a>,Howie Bedell,Milwaukee Braves,BRAVES,3,5,5,10,1963,1970,7,No,0,-2.43,1.09,3.52,280,128,-152,53,23,-30,470.0,329.0,-141.0,12000.0,0.0,-12000.0
<a href=/player/bednd001>bednd001</a>,David Bednar,San Diego Padres,PADRS,1,5,1,6,2021,2021,0,Yes,0,2.1,3.49,1.39,119,68,-51,1,57,56,182.0,544.0,362.0,0.0,0.0,0.0
<a href=/player/bedrs001>bedrs001</a>,Steve Bedrosian,Atlanta Braves,BRAVES,2,3,3,6,1985,1994,9,No,0,11.78,9.36,-2.42,1062,684,-378,2024,1673,-351,1256.0,1991.0,735.0,1575000.0,0.0,-1575000.0
<a href=/player/bedrs001>bedrs001</a>,Steve Bedrosian,Philadelphia Phillies,PHILS,5,8,9,17,1989,2002,13,No,0,6.14,8.58,2.44,1265,1614,349,3340,3565,225,859.0,4310.0,3451.0,1570000.0,0.0,-1570000.0
<a href=/player/bedrs001>bedrs001</a>,Steve Bedrosian,San Francisco Giants,GIANTS,1,1,2,3,1990,1995,5,No,0,-0.05,0.0,0.05,56,0,-56,0,0,0,232.0,0.0,-232.0,1450000.0,0.0,-1450000.0
<a href=/player/beebf101>beebf101</a>,Fred Beebe,Chicago Cubs,CUBS,1,3,1,4,1906,1906,0,No,0,1.84,2.12,0.28,366,34,-332,716,57,-659,2561.0,440.0,-2121.0,0.0,0.0,0.0
<a href=/player/beebf101>beebf101</a>,Fred Beebe,St. Louis Cardinals,CARDS,1,2,3,5,1910,1914,4,No,0,0.92,4.47,3.55,70,779,709,75,3039,2964,641.0,470.0,-171.0,0.0,0.0,0.0
<a href=/player/beebf101>beebf101</a>,Fred Beebe,Cincinnati Reds,REDS,2,6,5,11,1910,1914,4,No,0,23.79,7.43,-16.36,1495,715,-780,6220,2571,-3649,283.0,231.0,-52.0,0.0,0.0,0.0
<a href=/player/beebf101>beebf101</a>,Fred Beebe,Philadelphia Phillies,PHILS,6,13,14,27,1911,1929,18,No,0,74.14,24.32,-49.82,2587,1398,-1189,7576,4163,-3413,10093.0,3446.0,-6647.0,21000.0,0.0,-21000.0
<a href=/player/beekj001>beekj001</a>,Jalen Beeks,Boston Red Sox,RSOX,1,1,1,2,2018,2018,0,Yes,0,0.51,0.83,0.32,62,14,-48,5,3,-2,504.0,162.0,-342.0,0.0,0.0,0.0
<a href=/player/beenf101>beenf101</a>,Fred Beene,Baltimore Orioles,ORLS,16,38,31,69,1970,1994,24,No,3,54.62,146.79,92.17,4179,7236,3057,9813,16664,6851,14313.0,25489.0,11176.0,888833.0,0.0,-888833.0
<a href=/player/beenf101>beenf101</a>,Fred Beene,Baltimore Orioles,ORLS,1,1,1,2,1972,1972,0,No,0,3.54,0.0,-3.54,84,0,-84,9,0,-9,476.0,0.0,-476.0,0.0,0.0,0.0
<a href=/player/beenf101>beenf101</a>,Fred Beene,New York Yankees,YANKS,18,35,30,65,1974,2001,27,No,1,68.7,43.61,-25.09,4667,3496,-1171,10476,9633,-843,15153.0,7546.0,-7607.0,4780000.0,0.0,-4780000.0
<a href=/player/beers001>beers001</a>,Seth Beer,Houston Astros,ASTROS,1,4,2,6,2019,2021,2,No,0,-0.93,3.35,4.28,254,54,-200,791,4,-787,100.0,902.0,802.0,0.0,0.0,0.0
<a href=/player/beggj101>beggj101</a>,Joe Beggs,New York Yankees,YANKS,1,1,1,2,1940,1940,0,No,0,9.81,0.32,-9.49,382,10,-372,183,0,-183,1707.0,14.0,-1693.0,0.0,0.0,0.0
<a href=/player/beggj101>beggj101</a>,Joe Beggs,Cincinnati Reds,REDS,2,2,2,4,1947,1948,1,No,0,-0.25,1.45,1.7,107,176,69,142,565,423,199.0,122.0,-77.0,0.0,0.0,0.0
<a href=/player/beher001>beher001</a>,Rick Behenna,Atlanta Braves,BRAVES,1,4,1,5,1983,1986,3,No,0,32.51,0.13,-32.38,1861,94,-1767,7480,76,-7404,166.0,699.0,533.0,110000.0,0.0,-110000.0
<a href=/player/behnm101>behnm101</a>,Mel Behney,Cincinnati Reds,REDS,1,1,2,3,1973,1974,1,No,0,0.0,0.47,0.47,0,189,189,0,309,309,0.0,0.0,0.0,0.0,0.0,0.0
<a href=/player/behrh101>behrh101</a>,Hank Behrman,Brooklyn Dodgers,DOGRS,1,5,2,7,1947,1947,0,No,0,3.3,-0.19,-3.49,337,37,-300,419,81,-338,1285.0,0.0,-1285.0,17500.0,0.0,-17500.0
<a href=/player/behrh101>behrh101</a>,Hank Behrman,New York Giants,GIANTS,1,2,2,4,1950,1957,7,No,0,0.0,-0.62,-0.62,0,132,132,0,152,152,0.0,0.0,0.0,0.0,0.0,0.0
<a href=/player/beimj001>beimj001</a>,Joe Beimel,Washington Nationals,NATEX,1,1,2,3,2009,2014,5,No,0,1.09,1.26,0.17,192,282,90,1,1,0,182.0,427.0,245.0,2000000.0,0.0,-2000000.0
<a href=/player/beirk001>beirk001</a>,Kevin Beirne,Chicago White Sox,WSOX,2,5,3,8,2001,2001,0,No,0,-0.46,1.34,1.8,81,17,-64,117,2,-115,78.0,302.0,224.0,0.0,0.0,0.0
<a href=/player/bejmo101>bejmo101</a>,Ollie Bejma,Chicago White Sox,WSOX,2,3,2,5,1940,1946,6,No,0,-0.96,-2.59,-1.63,232,359,127,719,1342,623,0.0,0.0,0.0,6000.0,0.0,-6000.0
<a href=/player/belaw101>belaw101</a>,Wayne Belardi,Brooklyn Dodgers,DOGRS,1,1,4,5,1954,1954,0,No,0,0.11,-0.25,-0.36,170,13,-157,476,12,-464,0.0,0.0,0.0,8000.0,0.0,-8000.0
<a href=/player/belaw101>belaw101</a>,Wayne Belardi,Detroit Tigers,TIGRS,4,10,9,19,1956,1961,5,No,0,13.15,0.77,-12.38,602,579,-23,394,1616,1222,3228.0,40.0,-3188.0,13200.0,0.0,-13200.0
<a href=/player/belaw101>belaw101</a>,Wayne Belardi,Kansas City Athletics,ATLTCS,38,80,81,161,1957,1976,19,No,0,137.3,59.64,-77.66,12943,8836,-4107,29783,24655,-5128,18720.0,9434.0,-9286.0,506100.0,0.0,-506100.0
<a href=/player/belct001>belct001</a>,Tim Belcher,Oakland Athletics,ATLTCS,1,1,1,2,1987,1993,6,No,0,12.61,2.96,-9.65,276,344,68,282,2,-280,2418.0,1085.0,-1333.0,0.0,0.0,0.0
<a href=/player/belct001>belct001</a>,Tim Belcher,Los Angeles Dodgers,DOGRS,3,4,4,8,1991,1994,3,No,0,3.76,0.59,-3.17,176,242,66,364,733,369,1120.0,132.0,-988.0,2900000.0,0.0,-2900000.0
<a href=/player/belct001>belct001</a>,Tim Belcher,Cincinnati Reds,REDS,1,1,2,3,1993,1996,3,No,0,0.47,1.84,1.37,12,262,250,0,17,17,215.0,550.0,335.0,3825000.0,0.0,-3825000.0
<a href=/player/belct001>belct001</a>,Tim Belcher,Cincinnati Reds,REDS,1,1,1,2,1995,1995,0,No,0,2.23,0.0,-2.23,28,0,-28,0,0,0,538.0,0.0,-538.0,0.0,0.0,0.0
<a href=/player/belfm001>belfm001</a>,Mike Belfiore,Arizona Diamondbacks,DBACKS,1,1,1,2,2012,2012,0,No,0,-0.06,-0.4,-0.34,1,21,20,0,56,56,4.0,0.0,-4.0,0.0,0.0,0.0
<a href=/player/belib101>belib101</a>,Bo Belinsky,California Angels,ANGELS,1,1,2,3,1964,1974,10,No,0,-0.7,5.02,5.72,79,410,331,37,308,271,375.0,3416.0,3041.0,15000.0,0.0,-15000.0
<a href=/player/belib101>belib101</a>,Bo Belinsky,Pittsburgh Pirates,PIRATS,1,1,1,2,1970,1970,0,No,0,0.04,0.0,-0.04,6,0,-6,2,0,-2,24.0,0.0,-24.0,0.0,0.0,0.0
<a href=/player/belim001>belim001</a>,Matt Belisle,Atlanta Braves,BRAVES,1,1,1,2,2003,2003,0,No,0,0.56,0.54,-0.02,262,36,-226,88,1,-87,1025.0,51.0,-974.0,0.0,0.0,0.0
<a href=/player/belis001>belis001</a>,Stan Belinda,Pittsburgh Pirates,PIRATS,4,4,5,9,1993,2000,7,No,0,12.81,4.07,-8.74,462,868,406,382,770,388,3100.0,2733.0,-367.0,3125000.0,0.0,-3125000.0
<a href=/player/belis001>belis001</a>,Stan Belinda,Cincinnati Reds,REDS,3,4,6,10,1999,2006,7,No,0,1.74,1.96,0.22,719,376,-343,1050,622,-428,650.0,1259.0,609.0,10318333.0,0.0,-10318333.0
<a href=/player/belit001>belit001</a>,Todd Belitz,Tampa Bay Devil Rays,RAYS,1,2,1,3,2000,2006,6,No,0,2.82,0.05,-2.77,267,200,-67,0,2,2,762.0,753.0,-9.0,350000.0,0.0,-350000.0
<a href=/player/belit001>belit001</a>,Todd Belitz,Oakland Athletics,ATLTCS,1,3,1,4,2001,2004,3,No,0,0.03,2.82,2.79,154,394,240,507,1663,1156,28.0,0.0,-28.0,201000.0,0.0,-201000.0
<a href=/player/belkt001>belkt001</a>,Tim Belk,Cincinnati Reds,REDS,1,1,1,2,1998,1998,0,No,0,0.0,0.0,0.0,0,0,0,0,0,0,0.0,0.0,0.0,0.0,0.0,0.0
<a href=/player/bellb001>bellb001</a>,Buddy Bell,Cleveland Indians,INDINS,16,27,34,61,1978,2001,23,No,1,146.54,85.55,-60.99,7272,5776,-1496,23009,21264,-1745,7708.0,2374.0,-5334.0,19613332.0,0.0,-19613332.0
<a href=/player/bellb001>bellb001</a>,Buddy Bell,Texas Rangers,RNGRS,3,6,5,11,1985,1996,11,No,0,13.65,11.7,-1.95,1024,786,-238,4041,1776,-2265,1191.0,1995.0,804.0,15083333.0,0.0,-15083333.0
<a href=/player/bellb001>bellb001</a>,Buddy Bell,Cincinnati Reds,REDS,1,1,1,2,1988,1988,0,No,0,0.38,0.0,-0.38,74,0,-74,289,0,-289,0.0,0.0,0.0,790909.0,0.0,-790909.0
<a href=/player/bellb102>bellb102</a>,Beau Bell,St.Louis Browns,ORLS,6,10,14,24,1939,1952,13,No,0,23.39,27.61,4.22,1164,2723,1559,2963,7190,4227,3417.0,6493.0,3076.0,67500.0,0.0,-67500.0
<a href=/player/bellb102>bellb102</a>,Beau Bell,Detroit Tigers,TIGRS,2,3,3,6,1940,1948,8,No,0,-0.05,6.09,6.14,316,1306,990,1084,5263,4179,0.0,0.0,0.0,10000.0,0.0,-10000.0
<a href=/player/bellc003>bellc003</a>,Chad Bell,Texas Rangers,RNGRS,1,1,1,2,2016,2016,0,No,0,-0.76,-0.37,0.39,32,42,10,0,141,141,209.0,0.0,-209.0,0.0,0.0,0.0
<a href=/player/belld001>belld001</a>,Derek Bell,Toronto Blue Jays,BJAYS,2,3,2,5,1993,1993,0,No,0,0.04,2.15,2.11,289,140,-149,1142,579,-563,0.0,0.0,0.0,2100000.0,0.0,-2100000.0
<a href=/player/belld001>belld001</a>,Derek Bell,San Diego Padres,PADRS,16,32,32,64,1994,2010,16,No,6,18.63,52.35,33.72,3699,4432,733,12670,15324,2654,1244.0,1789.0,545.0,25389800.0,0.0,-25389800.0
<a href=/player/belld001>belld001</a>,Derek Bell,Houston Astros,ASTROS,5,10,10,20,1999,2011,12,No,2,8.59,16.0,7.41,484,2055,1571,1331,4586,3255,1469.0,1829.0,360.0,15440000.0,0.0,-15440000.0
<a href=/player/belld002>belld002</a>,David Bell,Cleveland Indians,INDINS,1,3,1,4,1995,1995,0,No,0,-1.28,1.44,2.72,177,12,-165,474,0,-474,13.0,224.0,211.0,0.0,0.0,0.0
<a href=/player/belld002>belld002</a>,David Bell,Cleveland Indians,INDINS,1,1,1,2,1998,1998,0,No,0,5.9,-0.39,-6.29,446,24,-422,1774,97,-1677,0.0,0.0,0.0,0.0,0.0,0.0
<a href=/player/belld002>belld002</a>,David Bell,Seattle Mariners,MARNRS,1,1,2,3,2002,2002,0,No,0,3.15,1.16,-1.99,154,112,-42,628,376,-252,0.0,0.0,0.0,0.0,0.0,0.0
<a href=/player/belld002>belld002</a>,David Bell,Philadelphia Phillies,PHILS,1,1,1,2,2006,2006,0,No,0,1.05,0.0,-1.05,53,0,-53,201,0,-201,0.0,0.0,0.0,4700000.0,0.0,-4700000.0
<a href=/player/bellg001>bellg001</a>,George Bell,Chicago Cubs,CUBS,5,7,9,16,1992,2010,18,No,0,-3.63,62.45,66.08,624,2516,1892,2196,9772,7576,0.0,125.0,125.0,3300000.0,0.0,-3300000.0
<a href=/player/bellg102>bellg102</a>,Gary Bell,Cleveland Indians,INDINS,1,1,2,3,1967,1967,0,No,0,2.77,1.88,-0.89,128,157,29,127,517,390,1094.0,0.0,-1094.0,24000.0,0.0,-24000.0
<a href=/player/bellg102>bellg102</a>,Gary Bell,Seattle Pilots,BREWRS,1,1,1,2,1969,1970,1,No,0,-0.44,1.78,2.22,46,158,112,6,14,8,116.0,331.0,215.0,40000.0,0.0,-40000.0
<a href=/player/bellg103>bellg103</a>,Gus Bell,Pittsburgh Pirates,PIRATS,3,4,5,9,1952,1965,13,No,0,19.01,21.51,2.5,1576,1673,97,6339,6514,175,29.0,893.0,864.0,21500.0,0.0,-21500.0
<a href=/player/bellg103>bellg103</a>,Gus Bell,New York Mets,METS,4,7,8,15,1962,1966,4,No,0,1.85,3.31,1.46,189,508,319,493,1517,1024,71.0,326.0,255.0,0.0,0.0,0.0
<a href=/player/bellh001>bellh001</a>,Heath Bell,New York Mets,METS,1,2,2,4,2006,2008,2,No,0,8.55,-0.17,-8.72,723,11,-712,2,30,28,1167.0,3.0,-1164.0,0.0,0.0,0.0
<a href=/player/bellh001>bellh001</a>,Heath Bell,Miami Marlins,MARLNS,1,2,1,3,2012,2012,0,No,0,-0.16,0.0,0.16,133,0,-133,0,0,0,197.0,0.0,-197.0,6000000.0,0.0,-6000000.0
<a href=/player/bellh001>bellh001</a>,Heath Bell,Arizona Diamondbacks,DBACKS,1,3,2,5,2013,2013,0,Yes,0,-0.62,0.0,0.62,14,0,-14,0,0,0,52.0,0.0,-52.0,9000000.0,0.0,-9000000.0
<a href=/player/bellj001>bellj001</a>,Jay Bell,Minnesota Twins,TWINS,4,9,7,16,1985,1995,10,No,0,10.17,8.8,-1.37,960,260,-700,2169,213,-1956,3138.0,2882.0,-256.0,1000000.0,0.0,-1000000.0
<a href=/player/bellj001>bellj001</a>,Jay Bell,Cleveland Indians,INDINS,3,5,5,10,1989,2011,22,No,2,23.64,35.41,11.77,1343,2308,965,5598,8810,3212,0.0,594.0,594.0,1117500.0,0.0,-1117500.0
<a href=/player/bellj001>bellj001</a>,Jay Bell,Pittsburgh Pirates,PIRATS,1,2,4,6,1996,2000,4,No,0,11.41,4.01,-7.4,460,303,-157,1938,501,-1437,0.0,260.0,260.0,7200000.0,0.0,-7200000.0
<a href=/player/bellj003>bellj003</a>,Juan Bell,Los Angeles Dodgers,DOGRS,3,6,4,10,1988,1997,9,No,2,-1.54,8.26,9.8,185,646,461,229,2698,2469,523.0,0.0,-523.0,305000.0,0.0,-305000.0
<a href=/player/bellj003>bellj003</a>,Juan Bell,Baltimore Orioles,ORLS,2,2,2,4,1992,1993,1,No,0,1.58,-0.36,-1.94,351,21,-330,1051,40,-1011,0.0,0.0,0.0,0.0,0.0,0.0
<a href=/player/bellj004>bellj004</a>,Josh Bell,Los Angeles Dodgers,DOGRS,1,2,1,3,2009,2010,1,No,0,0.18,0.62,0.44,106,187,81,226,1,-225,178.0,192.0,14.0,0.0,0.0,0.0
<a href=/player/bellj004>bellj004</a>,Josh Bell,Baltimore Orioles,ORLS,1,1,1,2,2012,2014,2,No,0,-0.4,-0.06,0.34,21,1,-20,56,0,-56,0.0,4.0,4.0,0.0,0.0,0.0
<a href=/player/bellj005>bellj005</a>,Josh Bell,Pittsburgh Pirates,PIRATS,1,1,2,3,2020,2020,0,Yes,0,3.1,0.0,-3.1,144,0,-144,568,0,-568,0.0,0.0,0.0,4800000.0,0.0,-4800000.0
<a href=/player/bellk101>bellk101</a>,Kevin Bell,San Diego Padres,PADRS,2,4,3,7,1981,1984,3,No,0,15.21,2.85,-12.36,959,296,-663,3500,1221,-2279,64.0,0.0,-64.0,0.0,0.0,0.0
<a href=/player/belll101>belll101</a>,Les Bell,St. Louis Cardinals,CARDS,2,2,4,6,1928,1931,3,No,0,2.14,2.41,0.27,400,392,-8,1478,1482,4,0.0,0.0,0.0,0.0,0.0,0.0
<a href=/player/bellm002>bellm002</a>,Mark Bellhorn,Oakland Athletics,ATLTCS,1,1,1,2,2001,2001,0,No,0,3.5,0.0,-3.5,197,0,-197,702,0,-702,0.0,0.0,0.0,0.0,0.0,0.0
<a href=/player/bellm002>bellm002</a>,Mark Bellhorn,Chicago Cubs,CUBS,3,5,5,10,2003,2017,14,No,1,-0.12,25.52,25.64,358,1205,847,855,5013,4158,0.0,3.0,3.0,465000.0,0.0,-465000.0
<a href=/player/bellm003>bellm003</a>,Mike Bell,Texas Rangers,RNGRS,2,2,3,5,1997,2001,4,No,0,-0.7,-2.09,-1.39,35,48,13,0,4,4,149.0,378.0,229.0,220000.0,0.0,-220000.0
<a href=/player/bellm003>bellm003</a>,Mike Bell,Arizona Diamondbacks,DBACKS,2,3,2,5,1998,1998,0,No,0,0.0,0.27,0.27,0,64,64,0,1,1,0.0,131.0,131.0,225000.0,0.0,-225000.0
<a href=/player/bellr002>bellr002</a>,Ronnie Belliard,Cleveland Indians,INDINS,1,1,1,2,2006,2007,1,No,0,0.14,-0.77,-0.91,54,37,-17,211,134,-77,0.0,0.0,0.0,4000000.0,0.0,-4000000.0
<a href=/player/bellr002>bellr002</a>,Ronnie Belliard,Washington Nationals,NATEX,1,1,2,3,2009,2010,1,No,0,0.65,-0.17,-0.82,106,8,-98,268,0,-268,0.0,6.0,6.0,1900000.0,0.0,-1900000.0
<a href=/player/bellr003>bellr003</a>,Rob Bell,Atlanta Braves,BRAVES,9,20,18,38,1998,2015,17,No,3,84.77,19.25,-65.52,4465,2071,-2394,14759,4939,-9820,5099.0,1624.0,-3475.0,29165000.0,0.0,-29165000.0
<a href=/player/bellr003>bellr003</a>,Rob Bell,Cincinnati Reds,REDS,2,4,3,7,2001,2012,11,No,0,23.96,9.78,-14.18,1069,964,-105,4207,3624,-583,758.0,0.0,-758.0,2675000.0,0.0,-2675000.0
<a href=/player/bellr102>bellr102</a>,Rob Belloir,Cleveland Indians,INDINS,2,3,2,5,1975,1976,1,No,0,-3.18,0.49,3.67,111,22,-89,203,0,-203,168.0,399.0,231.0,0.0,0.0,0.0
<a href=/player/bellt001>bellt001</a>,Terry Bell,Seattle Mariners,MARNRS,2,2,2,4,1986,1987,1,No,0,0.0,1.07,1.07,28,42,14,5,0,-5,106.0,284.0,178.0,0.0,0.0,0.0
<a href=/player/bellt001>bellt001</a>,Terry Bell,Kansas City Royals,ROYALS,1,1,1,2,1987,1988,1,No,0,0.0,0.69,0.69,1,39,38,1,0,-1,0.0,141.0,141.0,0.0,0.0,0.0
<a href=/player/bellz101>bellz101</a>,Zeke Bella,New York Yankees,YANKS,1,2,1,3,1958,1959,1,No,0,-0.62,-0.64,-0.02,47,12,-35,93,7,-86,0.0,61.0,61.0,0.0,0.0,0.0
<a href=/player/belnv001>belnv001</a>,Vince Belnome,San Diego Padres,PADRS,1,1,1,2,2012,2015,3,No,0,-0.13,-0.16,-0.03,4,10,6,14,0,-14,0.0,9.0,9.0,0.0,0.0,0.0
<a href=/player/beltc001>beltc001</a>,Carlos Beltran,Kansas City Royals,ROYALS,2,2,6,8,2004,2013,9,No,0,2.07,8.04,5.97,347,1699,1352,1300,6027,4727,0.0,839.0,839.0,12575000.0,0.0,-12575000.0
<a href=/player/beltc001>beltc001</a>,Carlos Beltran,New York Mets,METS,1,2,1,3,2011,2019,8,No,0,1.17,10.76,9.59,44,246,202,179,250,71,0.0,2248.0,2248.0,19325436.0,0.0,-19325436.0
<a href=/player/beltc001>beltc001</a>,Carlos Beltran,New York Yankees,YANKS,3,7,5,12,2016,2020,4,Yes,0,-1.49,4.55,6.04,291,134,-157,212,8,-204,1269.0,772.0,-497.0,0.0,0.0,0.0
<a href=/player/belte001>belte001</a>,Esteban Beltre,Milwaukee Brewers,BREWRS,1,1,1,2,1991,1991,0,No,0,-1.12,0.0,1.12,57,0,-57,123,0,-123,0.0,0.0,0.0,0.0,0.0,0.0
<a href=/player/belte001>belte001</a>,Esteban Beltre,Chicago White Sox,WSOX,3,5,4,9,1994,2004,10,No,0,0.31,0.69,0.38,194,240,46,252,8,-244,327.0,1874.0,1547.0,580000.0,0.0,-580000.0
<a href=/player/belte001>belte001</a>,Esteban Beltre,Baltimore Orioles,ORLS,1,1,1,2,1999,1999,0,No,0,0.0,0.0,0.0,0,0,0,0,0,0,0.0,0.0,0.0,0.0,0.0,0.0
<a href=/player/belte002>belte002</a>,Engel Beltre,Boston Red Sox,RSOX,4,8,6,14,2007,2017,10,No,3,18.18,4.77,-13.41,1196,220,-976,3031,777,-2254,3507.0,311.0,-3196.0,415500.0,0.0,-415500.0
<a href=/player/beltf001>beltf001</a>,Francis Beltran,Chicago Cubs,CUBS,2,8,4,12,2004,2009,5,No,0,11.71,9.74,-1.97,643,537,-106,2292,1477,-815,256.0,718.0,462.0,5750000.0,0.0,-5750000.0
<a href=/player/beltr001>beltr001</a>,Rigo Beltran,St. Louis Cardinals,CARDS,2,4,2,6,1998,2003,5,No,0,1.21,7.77,6.56,177,685,508,4,2263,2259,365.0,602.0,237.0,475000.0,0.0,-475000.0
<a href=/player/beltr001>beltr001</a>,Rigo Beltran,New York Mets,METS,3,5,4,9,1999,2005,6,No,0,0.19,1.57,1.38,110,682,572,29,1629,1600,370.0,40.0,-330.0,3750000.0,0.0,-3750000.0
<a href=/player/benaf001>benaf001</a>,Freddie Benavides,Colorado Rockies,ROCKS,1,1,2,3,1994,1994,0,No,0,-1.1,0.0,1.1,47,0,-47,90,0,-90,0.0,0.0,0.0,0.0,0.0,0.0
<a href=/player/benea001>benea001</a>,Andy Benes,San Diego Padres,PADRS,7,16,15,31,1995,2006,11,No,1,8.74,38.72,29.98,1384,2329,945,3649,8703,5054,1217.0,136.0,-1081.0,12941680.0,0.0,-12941680.0
<a href=/player/benea002>benea002</a>,Alan Benes,Chicago Cubs,CUBS,1,1,1,2,2003,2003,0,No,0,-0.73,0.0,0.73,4,0,-4,0,0,0,45.0,0.0,-45.0,0.0,0.0,0.0
<a href=/player/benea002>benea002</a>,Alan Benes,Texas Rangers,RNGRS,1,1,1,2,2003,2003,0,No,0,0.34,0.0,-0.34,6,0,-6,1,0,-1,25.0,0.0,-25.0,0.0,0.0,0.0
<a href=/player/bengb101>bengb101</a>,Benny Bengough,Milwaukee,Milwaukee,1,1,1,2,1931,1933,2,No,0,-0.56,0.0,0.56,94,0,-94,295,0,-295,0.0,0.0,0.0,0.0,0.0,0.0
<a href=/player/bengr101>bengr101</a>,Ray Benge,Philadelphia Phillies,PHILS,2,5,4,9,1932,1934,2,No,0,2.5,-0.26,-2.76,192,259,67,226,508,282,1744.0,864.0,-880.0,0.0,0.0,0.0
<a href=/player/bengr101>bengr101</a>,Ray Benge,Brooklyn Dodgers,DOGRS,5,10,8,18,1935,1948,13,No,0,23.18,15.94,-7.24,1423,1121,-302,4586,3821,-765,1769.0,791.0,-978.0,0.0,0.0,0.0
<a href=/player/benia001>benia001</a>,Armando Benitez,Baltimore Orioles,ORLS,2,3,5,8,1998,2003,5,No,0,10.22,6.28,-3.94,749,531,-218,327,1848,1521,1041.0,0.0,-1041.0,7700000.0,0.0,-7700000.0
<a href=/player/benia001>benia001</a>,Armando Benitez,New York Mets,METS,1,1,3,4,2003,2006,3,No,0,0.18,0.03,-0.15,9,12,3,0,0,0,28.0,32.0,4.0,6937500.0,0.0,-6937500.0
<a href=/player/benia001>benia001</a>,Armando Benitez,New York Yankees,YANKS,1,1,1,2,2003,2003,0,No,0,0.32,0.18,-0.14,15,24,9,0,0,0,43.0,53.0,10.0,0.0,0.0,0.0
<a href=/player/benia001>benia001</a>,Armando Benitez,San Francisco Giants,GIANTS,1,2,1,3,2007,2008,1,No,0,-0.9,0.01,0.91,70,73,3,0,0,0,99.0,122.0,23.0,9866219.0,0.0,-9866219.0
<a href=/player/benia002>benia002</a>,Andrew Benintendi,Boston Red Sox,RSOX,1,2,5,7,2021,2021,0,Yes,0,2.43,-0.67,-3.1,134,48,-86,538,136,-402,0.0,0.0,0.0,0.0,0.0,0.0
<a href=/player/benij001>benij001</a>,Juan Beniquez,Boston Red Sox,RSOX,2,4,3,7,1975,1977,2,No,0,14.8,6.95,-7.85,545,58,-487,1514,0,-1514,2654.0,1206.0,-1448.0,200000.0,0.0,-200000.0
<a href=/player/benij001>benij001</a>,Juan Beniquez,Texas Rangers,RNGRS,9,19,16,35,1978,1992,14,No,2,37.88,13.17,-24.71,1966,942,-1024,3128,2227,-901,8593.0,2130.0,-6463.0,0.0,0.0,0.0
<a href=/player/benij001>benij001</a>,Juan Beniquez,New York Yankees,YANKS,7,17,13,30,1979,1992,13,No,0,39.2,19.95,-19.25,2768,1137,-1631,6569,3883,-2686,8301.0,701.0,-7600.0,913333.0,0.0,-913333.0
<a href=/player/benij001>benij001</a>,Juan Beniquez,Baltimore Orioles,ORLS,1,1,2,3,1986,1986,0,No,0,-1.59,0.0,1.59,57,0,-57,190,0,-190,0.0,0.0,0.0,450000.0,0.0,-450000.0
<a href=/player/benij001>benij001</a>,Juan Beniquez,Kansas City Royals,ROYALS,1,1,1,2,1987,1993,6,No,0,0.16,8.02,7.86,66,114,48,156,0,-156,0.0,1390.0,1390.0,0.0,0.0,0.0
<a href=/player/beniy001>beniy001</a>,Yamil Benitez,Montreal Expos,NATEX,1,1,1,2,1997,1998,1,No,0,0.35,0.0,-0.35,53,0,-53,204,0,-204,0.0,0.0,0.0,0.0,0.0,0.0
<a href=/player/benjm001>benjm001</a>,Mike Benjamin,San Francisco Giants,GIANTS,1,1,2,3,1995,1996,1,No,0,0.66,-0.14,-0.8,35,72,37,118,3,-115,0.0,125.0,125.0,320000.0,0.0,-320000.0
<a href=/player/bennd101>bennd101</a>,Dennis Bennett,Philadelphia Phillies,PHILS,2,2,4,6,1964,1968,4,No,0,2.36,-0.09,-2.45,157,159,2,197,605,408,859.0,0.0,-859.0,14000.0,0.0,-14000.0
<a href=/player/bennd101>bennd101</a>,Dennis Bennett,Boston Red Sox,RSOX,2,2,3,5,1967,1974,7,No,0,-0.01,2.98,2.99,40,197,157,60,15,-45,79.0,485.0,406.0,20000.0,0.0,-20000.0
<a href=/player/bennd102>bennd102</a>,Dave Bennett,Philadelphia Phillies,PHILS,1,2,1,3,1970,1970,0,No,0,0.0,-0.64,-0.64,0,22,22,0,70,70,0.0,0.0,0.0,0.0,0.0,0.0
<a href=/player/benng001>benng001</a>,Gary Bennett,Philadelphia Phillies,PHILS,1,1,1,2,2001,2005,4,No,0,0.0,2.88,2.88,1,222,221,1,751,750,0.0,0.0,0.0,237500.0,0.0,-237500.0
<a href=/player/benng001>benng001</a>,Gary Bennett,New York Mets,METS,1,1,1,2,2001,2001,0,No,0,-1.08,0.0,1.08,109,0,-109,375,0,-375,0.0,0.0,0.0,0.0,0.0,0.0
<a href=/player/benns001>benns001</a>,Shayne Bennett,Boston Red Sox,RSOX,2,4,3,7,1996,1997,1,No,0,-1.72,2.82,4.54,535,239,-296,705,937,232,864.0,0.0,-864.0,0.0,0.0,0.0
<a href=/player/benoj001>benoj001</a>,Joaquin Benoit,San Diego Padres,PADRS,2,2,3,5,2015,2018,3,Yes,0,-1.19,1.85,3.04,102,162,60,6,656,650,247.0,0.0,-247.0,8000000.0,0.0,-8000000.0
<a href=/player/benoj001>benoj001</a>,Joaquin Benoit,Seattle Mariners,MARNRS,1,1,2,3,2016,2016,0,No,0,1.44,0.26,-1.18,26,21,-5,0,0,0,71.0,55.0,-16.0,0.0,0.0,0.0
<a href=/player/benoj001>benoj001</a>,Joaquin Benoit,Philadelphia Phillies,PHILS,1,1,1,2,2017,2017,0,Yes,0,-0.57,0.0,0.57,15,0,-15,0,0,0,25.0,0.0,-25.0,7500000.0,0.0,-7500000.0
<a href=/player/bensk001>bensk001</a>,Kris Benson,Pittsburgh Pirates,PIRATS,2,3,4,7,2004,2009,5,No,0,40.94,-2.9,-43.84,1344,558,-786,5481,2041,-3440,727.0,0.0,-727.0,7950000.0,0.0,-7950000.0
<a href=/player/bensk001>bensk001</a>,Kris Benson,New York Mets,METS,2,2,3,5,2006,2010,4,No,0,2.56,8.43,5.87,118,326,208,9,303,294,683.0,2483.0,1800.0,2525000.0,0.0,-2525000.0
<a href=/player/bensv101>bensv101</a>,Vern Benson,Philadelphia Athletics,ATLTCS,1,4,1,5,1946,1954,8,No,0,0.34,26.76,26.42,48,917,869,112,4210,4098,0.0,0.0,0.0,7000.0,0.0,-7000.0
<a href=/player/benta101>benta101</a>,Al Benton,Philadelphia Athletics,ATLTCS,1,4,1,5,1937,1940,3,No,0,0.0,6.28,6.28,0,278,278,0,321,321,0.0,1514.0,1514.0,0.0,0.0,0.0
<a href=/player/benta101>benta101</a>,Al Benton,SanDiego,SanDiego,1,1,1,2,1952,1952,0,No,0,1.46,0.0,-1.46,48,0,-48,11,0,-11,113.0,0.0,-113.0,0.0,0.0,0.0
<a href=/player/bentb001>bentb001</a>,Butch Benton,Chicago Cubs,CUBS,1,1,1,2,1983,1983,0,No,0,0.0,0.0,0.0,0,0,0,0,0,0,0.0,0.0,0.0,0.0,0.0,0.0
<a href=/player/bentj101>bentj101</a>,Jack Bentley,New York Giants,GIANTS,5,8,6,14,1925,1932,7,No,0,44.2,17.47,-26.73,1941,1197,-744,7676,4275,-3401,795.0,550.0,-245.0,27600.0,0.0,-27600.0
<a href=/player/bentj101>bentj101</a>,Jack Bentley,Washington Senators,TWINS,1,4,1,5,1917,1922,5,No,0,0.0,-0.6,-0.6,0,32,32,0,104,104,0.0,0.0,0.0,0.0,0.0,0.0
<a href=/player/bentl101>bentl101</a>,Larry Benton,New York Giants,GIANTS,3,8,5,13,1922,1930,8,No,0,4.92,14.44,9.52,1096,750,-346,1706,1477,-229,6029.0,4662.0,-1367.0,17500.0,0.0,-17500.0
<a href=/player/bentl101>bentl101</a>,Larry Benton,Boston Braves,BRAVES,7,13,11,24,1927,1938,11,No,0,17.24,17.06,-0.18,1140,2433,1293,3084,9081,5997,3328.0,1364.0,-1964.0,42000.0,0.0,-42000.0
<a href=/player/bentl101>bentl101</a>,Larry Benton,New York Giants,GIANTS,1,1,1,2,1930,1930,0,No,0,2.73,-1.03,-3.76,316,124,-192,266,592,326,2226.0,0.0,-2226.0,0.0,0.0,0.0
<a href=/player/bentr101>bentr101</a>,Rabbit Benton,Charleston,Charleston,1,1,2,3,1922,1933,11,No,0,-0.19,0.0,0.19,6,0,-6,21,0,-21,0.0,0.0,0.0,0.0,0.0,0.0
<a href=/player/benzt001>benzt001</a>,Todd Benzinger,Boston Red Sox,RSOX,5,9,6,15,1988,1995,7,No,1,-0.55,4.69,5.24,556,458,-98,1236,872,-364,1786.0,1405.0,-381.0,506000.0,0.0,-506000.0
<a href=/player/benzt001>benzt001</a>,Todd Benzinger,Cincinnati Reds,REDS,1,1,1,2,1991,1991,0,No,0,0.77,0.44,-0.33,78,53,-25,315,156,-159,0.0,0.0,0.0,705000.0,0.0,-705000.0
<a href=/player/benzt001>benzt001</a>,Todd Benzinger,Kansas City Royals,ROYALS,1,1,2,3,1991,1994,3,No,0,-0.93,0.26,1.19,121,137,16,313,406,93,0.0,0.0,0.0,0.0,0.0,0.0
<a href=/player/beraj101>beraj101</a>,Johnny Berardino,St.Louis Browns,ORLS,2,2,3,5,1947,1950,3,No,0,6.81,5.09,-1.72,451,315,-136,1933,1294,-639,0.0,43.0,43.0,14000.0,0.0,-14000.0
<a href=/player/beraj101>beraj101</a>,Johnny Berardino,St.Louis Browns,ORLS,1,1,2,3,1947,1955,8,No,0,-0.31,0.0,0.31,155,0,-155,361,0,-361,0.0,0.0,0.0,14000.0,0.0,-14000.0
<a href=/player/beraj101>beraj101</a>,Johnny Berardino,Cleveland Indians,INDINS,1,3,2,5,1952,1960,8,No,0,-0.35,6.71,7.06,19,748,729,60,2451,2391,0.0,35.0,35.0,10000.0,0.0,-10000.0
<a href=/player/berbj001>berbj001</a>,Jeff Berblinger,Detroit Tigers,TIGRS,1,1,2,3,1996,2001,5,No,0,0.0,5.99,5.99,0,703,703,0,2550,2550,0.0,0.0,0.0,0.0,0.0,0.0
<a href=/player/berbl101>berbl101</a>,Lou Berberet,New York Yankees,YANKS,7,20,15,35,1956,1970,14,No,0,3.04,33.17,30.13,2442,2492,50,6615,5619,-996,2999.0,5239.0,2240.0,115500.0,0.0,-115500.0
<a href=/player/berbl101>berbl101</a>,Lou Berberet,Washington Senators,TWINS,2,2,2,4,1958,1961,3,No,0,2.61,-0.85,-3.46,216,234,18,833,680,-153,0.0,0.0,0.0,0.0,0.0,0.0
<a href=/player/berbl101>berbl101</a>,Lou Berberet,Boston Red Sox,RSOX,2,2,3,5,1958,1960,2,No,0,0.31,-0.68,-0.99,185,8,-177,657,1,-656,0.0,26.0,26.0,0.0,0.0,0.0
<a href=/player/bereb001>bereb001</a>,Bruce Berenyi,Cincinnati Reds,REDS,4,7,7,14,1984,1988,4,No,0,12.33,8.43,-3.9,964,327,-637,681,447,-234,4756.0,2505.0,-2251.0,1777500.0,0.0,-1777500.0
<a href=/player/berej001>berej001</a>,Juan Berenguer,New York Mets,METS,2,3,4,7,1981,1984,3,No,0,-3.49,-1.63,1.86,387,108,-279,1480,288,-1192,193.0,0.0,-193.0,0.0,0.0,0.0
<a href=/player/berej001>berej001</a>,Juan Berenguer,Detroit Tigers,TIGRS,5,7,8,15,1985,1991,6,No,0,13.23,9.61,-3.62,999,888,-111,2374,2066,-308,1829.0,1754.0,-75.0,1440000.0,0.0,-1440000.0
<a href=/player/berej001>berej001</a>,Juan Berenguer,Atlanta Braves,BRAVES,2,2,2,4,1992,1993,1,No,0,-0.92,-0.44,0.48,69,28,-41,3,1,-2,228.0,50.0,-178.0,1200000.0,0.0,-1200000.0
<a href=/player/berej002>berej002</a>,Jason Bere,Milwaukee Brewers,BREWRS,10,20,24,44,2000,2012,12,No,2,44.17,39.37,-4.8,3016,3033,17,9285,7113,-2172,2619.0,7597.0,4978.0,13997000.0,0.0,-13997000.0
<a href=/player/bergb101>bergb101</a>,Boze Berger,Chicago White Sox,WSOX,1,1,1,2,1938,1940,2,No,0,0.03,1.32,1.29,20,195,175,33,793,760,0.0,0.0,0.0,4000.0,0.0,-4000.0
<a href=/player/bergb101>bergb101</a>,Boze Berger,Brooklyn Dodgers,DOGRS,1,1,1,2,1940,1946,6,No,0,0.0,-0.05,-0.05,0,2,2,0,5,5,0.0,0.0,0.0,0.0,0.0,0.0
<a href=/player/bergd001>bergd001</a>,Dave Bergman,New York Yankees,YANKS,2,4,2,6,1977,1979,2,No,0,-0.57,3.2,3.77,493,187,-306,951,449,-502,300.0,202.0,-98.0,0.0,0.0,0.0
<a href=/player/bergd001>bergd001</a>,Dave Bergman,Houston Astros,ASTROS,1,2,1,3,1981,1982,1,No,0,11.7,-0.13,-11.83,1042,26,-1016,3644,52,-3592,0.0,0.0,0.0,0.0,0.0,0.0
<a href=/player/bergd001>bergd001</a>,Dave Bergman,San Francisco Giants,GIANTS,2,2,2,4,1984,1988,4,No,0,-0.31,-0.95,-0.64,71,55,-16,133,84,-49,0.0,347.0,347.0,0.0,0.0,0.0
<a href=/player/bergd001>bergd001</a>,Dave Bergman,Philadelphia Phillies,PHILS,3,6,6,12,1984,1989,5,No,0,21.01,8.65,-12.36,1868,885,-983,3542,3171,-371,2761.0,15.0,-2746.0,1629900.0,0.0,-1629900.0
<a href=/player/bergd003>bergd003</a>,Dusty Bergman,Anaheim Angels,ANGELS,1,2,1,3,2005,2005,0,No,0,0.0,0.15,0.15,0,12,12,0,0,0,0.0,11.0,11.0,0.0,0.0,0.0
<a href=/player/bergj002>bergj002</a>,Justin Berg,New York Yankees,YANKS,1,1,1,2,2005,2005,0,No,0,0.28,-0.42,-0.7,119,21,-98,2,57,55,192.0,0.0,-192.0,0.0,0.0,0.0
<a href=/player/bergp001>bergp001</a>,Peter Bergeron,Los Angeles Dodgers,DOGRS,4,8,8,16,1998,2006,8,No,0,3.75,12.46,8.71,1576,982,-594,3524,3610,86,1585.0,233.0,-1352.0,12365000.0,0.0,-12365000.0
<a href=/player/bergp001>bergp001</a>,Peter Bergeron,Montreal Expos,NATEX,1,2,2,4,2004,2004,0,No,0,0.0,0.0,0.0,0,0,0,0,0,0,0.0,0.0,0.0,300000.0,0.0,-300000.0
<a href=/player/bergs001>bergs001</a>,Sean Bergman,Detroit Tigers,TIGRS,8,20,15,35,1996,2002,6,No,1,8.66,7.11,-1.55,2368,1295,-1073,4185,3631,-554,2521.0,1620.0,-901.0,8560000.0,0.0,-8560000.0
<a href=/player/bergs001>bergs001</a>,Sean Bergman,San Diego Padres,PADRS,1,1,1,2,1998,1998,0,No,0,1.9,-1.01,-2.91,98,55,-43,97,71,-26,813.0,0.0,-813.0,0.0,0.0,0.0
<a href=/player/bergt001>bergt001</a>,Travis Bergen,Toronto Blue Jays,BJAYS,1,1,2,3,2020,2021,1,No,0,0.07,6.89,6.82,7,39,32,0,5,5,20.0,642.0,622.0,0.0,0.0,0.0
<a href=/player/bergw101>bergw101</a>,Wally Berger,LosAngeles,LosAngeles,1,1,3,4,1929,1929,0,No,0,36.6,0.0,-36.6,1057,0,-1057,4551,0,-4551,0.0,0.0,0.0,0.0,0.0,0.0
<a href=/player/bergw101>bergw101</a>,Wally Berger,Boston Braves,BRAVES,1,1,2,3,1937,1938,1,No,0,1.82,-0.86,-2.68,75,40,-35,255,24,-231,0.0,229.0,229.0,12000.0,0.0,-12000.0
<a href=/player/bergw101>bergw101</a>,Wally Berger,New York Giants,GIANTS,4,11,7,18,1938,1954,16,No,0,3.71,9.13,5.42,198,921,723,814,3167,2353,0.0,172.0,172.0,6000.0,0.0,-6000.0
<a href=/player/berkl001>berkl001</a>,Lance Berkman,Houston Astros,ASTROS,4,5,9,14,2010,2020,10,Yes,0,12.52,9.56,-2.96,1152,1169,17,4030,2853,-1177,460.0,1904.0,1444.0,15511100.0,0.0,-15511100.0
<a href=/player/berlj101>berlj101</a>,Jack Berly,New York Giants,GIANTS,1,4,1,5,1931,1931,0,No,0,0.0,0.0,0.0,0,0,0,0,0,0,0.0,0.0,0.0,0.0,0.0,0.0
<a href=/player/berna001>berna001</a>,Adam Bernero,Detroit Tigers,TIGRS,1,1,1,2,2003,2004,1,No,0,0.08,0.19,0.11,94,43,-51,8,129,121,195.0,0.0,-195.0,314000.0,0.0,-314000.0
<a href=/player/bernd101>bernd101</a>,Dwight Bernard,New York Mets,METS,3,5,4,9,1979,1984,5,No,0,-1.09,5.09,6.18,271,220,-51,297,188,-109,1199.0,1734.0,535.0,0.0,0.0,0.0
<a href=/player/bernj101>bernj101</a>,Juan Bernhardt,Seattle Mariners,MARNRS,1,1,1,2,1979,1979,0,No,0,0.0,-0.2,-0.2,0,14,14,0,0,0,0.0,60.0,60.0,0.0,0.0,0.0
<a href=/player/bernt001>bernt001</a>,Tony Bernazard,Montreal Expos,NATEX,1,1,1,2,1980,1982,2,No,0,7.71,0.0,-7.71,302,0,-302,1339,0,-1339,0.0,0.0,0.0,0.0,0.0,0.0
<a href=/player/bernt001>bernt001</a>,Tony Bernazard,Chicago White Sox,WSOX,1,1,1,2,1983,1987,4,No,0,0.85,4.14,3.29,80,414,334,347,1370,1023,0.0,0.0,0.0,252000.0,0.0,-252000.0
<a href=/player/bernt001>bernt001</a>,Tony Bernazard,Seattle Mariners,MARNRS,1,1,2,3,1983,1986,3,No,0,3.77,5.97,2.2,518,507,-11,2036,2147,111,0.0,0.0,0.0,0.0,0.0,0.0
<a href=/player/bernt001>bernt001</a>,Tony Bernazard,Cleveland Indians,INDINS,2,2,3,5,1987,1989,2,No,0,0.17,-0.62,-0.79,68,21,-47,261,12,-249,0.0,224.0,224.0,630000.0,0.0,-630000.0
<a href=/player/beroj101>beroj101</a>,Johnny Bero,St.Louis Browns,ORLS,24,54,49,103,1951,1994,43,No,3,84.08,155.15,71.07,5312,9145,3833,11244,26154,14910,18662.0,17928.0,-734.0,989433.0,0.0,-989433.0
<a href=/player/berra001>berra001</a>,Angel Berroa,Oakland Athletics,ATLTCS,22,40,42,82,2001,2019,18,Yes,2,56.7,95.01,38.31,4719,4541,-178,12582,14854,2272,10255.0,6599.0,-3656.0,20632501.0,0.0,-20632501.0
<a href=/player/berra001>berra001</a>,Angel Berroa,Kansas City Royals,ROYALS,1,1,2,3,2008,2008,0,No,0,-0.21,0.0,0.21,84,0,-84,256,0,-256,0.0,0.0,0.0,0.0,0.0,0.0
<a href=/player/berrc103>berrc103</a>,Charlie Berry,Boston Red Sox,RSOX,4,10,7,17,1932,1937,5,No,0,13.6,8.5,-5.1,544,1121,577,1112,4164,3052,1631.0,0.0,-1631.0,49250.0,0.0,-49250.0
<a href=/player/berrc103>berrc103</a>,Charlie Berry,Chicago White Sox,WSOX,1,2,2,4,1933,1935,2,No,0,0.0,3.6,3.6,175,72,-103,526,95,-431,0.0,735.0,735.0,8000.0,0.0,-8000.0
<a href=/player/berrd001>berrd001</a>,Dale Berra,Pittsburgh Pirates,PIRATS,1,3,3,6,1984,1986,2,No,0,0.69,0.08,-0.61,132,124,-8,338,327,-11,92.0,0.0,-92.0,0.0,0.0,0.0
<a href=/player/berrd002>berrd002</a>,Damon Berryhill,Chicago Cubs,CUBS,3,6,6,12,1991,2001,10,No,0,5.81,3.91,-1.9,1572,1078,-494,2118,2224,106,1917.0,1553.0,-364.0,10348333.0,0.0,-10348333.0
<a href=/player/berrg001>berrg001</a>,Geronimo Berroa,Oakland Athletics,ATLTCS,7,12,13,25,1997,2012,15,No,2,22.77,7.31,-15.46,1712,441,-1271,3519,667,-2852,6649.0,1785.0,-4864.0,6013333.0,0.0,-6013333.0
<a href=/player/berrg001>berrg001</a>,Geronimo Berroa,Cleveland Indians,INDINS,3,3,5,8,1998,2001,3,No,0,5.51,0.14,-5.37,436,78,-358,1334,182,-1152,316.0,16.0,-300.0,2412000.0,0.0,-2412000.0
<a href=/player/berrj001>berrj001</a>,Jose Berrios,Minnesota Twins,TWINS,1,1,2,3,2021,2021,0,Yes,0,1.38,0.0,-1.38,13,0,-13,2,0,-2,211.0,0.0,-211.0,6100000.0,0.0,-6100000.0
<a href=/player/berrk101>berrk101</a>,Ken Berry,Chicago White Sox,WSOX,8,16,13,29,1970,1985,15,No,1,24.79,26.84,2.05,2093,1635,-458,4791,5459,668,4811.0,2182.0,-2629.0,87700.0,0.0,-87700.0
<a href=/player/berrk101>berrk101</a>,Ken Berry,California Angels,ANGELS,3,7,8,15,1973,1976,3,No,0,0.2,6.55,6.35,187,557,370,417,1633,1216,696.0,244.0,-452.0,35000.0,0.0,-35000.0
<a href=/player/berrn101>berrn101</a>,Neil Berry,Detroit Tigers,TIGRS,1,3,1,4,1952,1952,0,No,0,-0.5,0.0,0.5,62,0,-62,121,0,-121,0.0,0.0,0.0,10000.0,0.0,-10000.0
<a href=/player/berrn101>berrn101</a>,Neil Berry,Chicago White Sox,WSOX,22,41,37,78,1954,1969,15,No,0,45.6,54.96,9.36,4683,4529,-154,11508,9881,-1627,7275.0,8147.0,872.0,218750.0,0.0,-218750.0
<a href=/player/berrn101>berrn101</a>,Neil Berry,Baltimore Orioles,ORLS,5,10,10,20,1954,1960,6,No,0,15.05,10.79,-4.26,745,954,209,1673,2729,1056,2291.0,1208.0,-1083.0,10000.0,0.0,-10000.0
<a href=/player/berrq001>berrq001</a>,Quintin Berry,Kansas City Royals,ROYALS,1,1,1,2,2013,2017,4,No,0,0.39,0.0,-0.39,13,0,-13,9,0,-9,0.0,0.0,0.0,0.0,0.0,0.0
<a href=/player/berrr101>berrr101</a>,Ray Berres,Pittsburgh Pirates,PIRATS,3,8,3,11,1940,1947,7,No,0,-0.52,4.7,5.22,266,678,412,694,2222,1528,0.0,0.0,0.0,5000.0,0.0,-5000.0
<a href=/player/berrs001>berrs001</a>,Sean Berry,Kansas City Royals,ROYALS,1,2,2,4,1992,1998,6,No,0,4.48,3.6,-0.88,352,157,-195,1116,0,-1116,0.0,1991.0,1991.0,0.0,0.0,0.0
<a href=/player/berrs001>berrs001</a>,Sean Berry,Montreal Expos,NATEX,3,4,5,9,1995,1999,4,No,0,8.5,1.98,-6.52,598,385,-213,1155,466,-689,460.0,419.0,-41.0,1010000.0,0.0,-1010000.0
<a href=/player/bertd101>bertd101</a>,Dick Bertell,Chicago Cubs,CUBS,3,4,6,10,1965,1968,3,No,0,-0.02,-1.61,-1.59,244,333,89,648,438,-210,220.0,627.0,407.0,0.0,0.0,0.0
<a href=/player/bertd101>bertd101</a>,Dick Bertell,San Francisco Giants,GIANTS,1,1,1,2,1967,1968,1,No,0,0.01,0.0,-0.01,2,0,-2,7,0,-7,0.0,0.0,0.0,0.0,0.0,0.0
<a href=/player/bertf101>bertf101</a>,Frank Bertaina,Baltimore Orioles,ORLS,12,25,24,49,1967,1994,27,No,3,56.83,90.93,34.1,3175,4948,1773,6934,10778,3844,11841.0,16499.0,4658.0,888333.0,0.0,-888333.0
<a href=/player/bertf101>bertf101</a>,Frank Bertaina,Washington Senators,RNGRS,1,1,1,2,1969,1969,0,No,0,0.67,0.0,-0.67,6,0,-6,2,0,-2,18.0,0.0,-18.0,0.0,0.0,0.0
<a href=/player/bertr101>bertr101</a>,Reno Bertoia,Detroit Tigers,TIGRS,2,5,4,9,1958,1960,2,No,0,-1.58,7.47,9.05,379,604,225,1361,2163,802,0.0,0.0,0.0,7000.0,0.0,-7000.0
<a href=/player/bertr101>bertr101</a>,Reno Bertoia,Kansas City Athletics,ATLTCS,1,2,2,4,1961,1963,2,No,0,0.04,2.6,2.56,55,199,144,51,85,34,40.0,733.0,693.0,0.0,0.0,0.0
<a href=/player/bertr101>bertr101</a>,Reno Bertoia,Minnesota Twins,TWINS,1,3,1,4,1961,1963,2,No,0,-0.34,-0.87,-0.53,41,239,198,137,577,440,5.0,0.0,-5.0,0.0,0.0,0.0
<a href=/player/berua001>berua001</a>,Andres Berumen,Florida Marlins,MARLNS,16,36,40,76,1993,2019,26,Yes,0,141.98,107.88,-34.1,6566,6100,-466,15461,18577,3116,13532.0,10298.0,-3234.0,68689667.0,0.0,-68689667.0
<a href=/player/berua001>berua001</a>,Andres Berumen,San Diego Padres,PADRS,1,1,1,2,1997,1997,0,No,0,0.0,0.45,0.45,0,17,17,0,14,14,0.0,132.0,132.0,0.0,0.0,0.0
<a href=/player/bescb101>bescb101</a>,Bob Bescher,Cincinnati Reds,REDS,3,4,7,11,1913,1930,17,No,0,8.71,56.49,47.78,629,2132,1503,2672,8901,6229,0.0,27.0,27.0,5200.0,0.0,-5200.0
<a href=/player/bescb101>bescb101</a>,Bob Bescher,New York Giants,GIANTS,1,2,1,3,1915,1921,6,No,0,2.98,6.22,3.24,323,339,16,1330,336,-994,0.0,2915.0,2915.0,0.0,0.0,0.0
<a href=/player/bescb101>bescb101</a>,Bob Bescher,St. Louis Cardinals,CARDS,1,5,1,6,1917,1917,0,No,0,0.0,0.36,0.36,0,28,28,0,29,29,0.0,256.0,256.0,9800.0,0.0,-9800.0
<a href=/player/bessh101>bessh101</a>,Herman Besse,Memphis,Memphis,1,1,4,5,1939,1945,6,No,0,-2.98,0.0,2.98,136,0,-136,99,0,-99,729.0,0.0,-729.0,0.0,0.0,0.0
<a href=/player/bestk001>bestk001</a>,Karl Best,Seattle Mariners,MARNRS,1,1,1,2,1987,1987,0,No,0,0.0,0.0,0.0,0,0,0,0,0,0,0.0,0.0,0.0,0.0,0.0,0.0
<a href=/player/bestk001>bestk001</a>,Karl Best,Detroit Tigers,TIGRS,1,1,1,2,1988,1988,0,No,0,-0.18,0.0,0.18,11,0,-11,0,0,0,36.0,0.0,-36.0,0.0,0.0,0.0
<a href=/player/bestk001>bestk001</a>,Karl Best,Minnesota Twins,TWINS,2,2,2,4,1988,1990,2,No,0,0.0,0.0,0.0,0,0,0,0,0,0,0.0,0.0,0.0,0.0,0.0,0.0
<a href=/player/betar001>betar001</a>,Rafael Betancourt,Cleveland Indians,INDINS,1,1,1,2,2009,2009,0,No,0,6.3,0.0,-6.3,606,0,-606,0,0,0,827.0,0.0,-827.0,3350000.0,0.0,-3350000.0
<a href=/player/betay001>betay001</a>,Yuniesky Betancourt,Seattle Mariners,MARNRS,1,1,2,3,2009,2011,2,No,0,-3.4,-0.16,3.24,279,14,-265,1079,0,-1079,0.0,48.0,48.0,2300000.0,0.0,-2300000.0
<a href=/player/betay001>betay001</a>,Yuniesky Betancourt,Kansas City Royals,ROYALS,4,9,9,18,2010,2021,11,Yes,0,13.5,49.72,36.22,866,2766,1900,2084,9673,7589,3154.0,2429.0,-725.0,26600000.0,0.0,-26600000.0
<a href=/player/betew001>betew001</a>,Wilson Betemit,Atlanta Braves,BRAVES,8,16,19,35,2006,2014,8,No,1,18.86,9.38,-9.48,2803,1334,-1469,4288,3547,-741,3035.0,1652.0,-1383.0,26425000.0,0.0,-26425000.0
<a href=/player/betew001>betew001</a>,Wilson Betemit,Los Angeles Dodgers,DOGRS,1,1,1,2,2007,2008,1,No,0,-0.36,-0.41,-0.05,124,141,17,290,0,-290,0.0,212.0,212.0,405000.0,0.0,-405000.0
<a href=/player/betew001>betew001</a>,Wilson Betemit,New York Yankees,YANKS,2,4,3,7,2008,2013,5,Yes,1,-0.72,11.97,12.69,28,599,571,50,2501,2451,20.0,3.0,-17.0,1165000.0,0.0,-1165000.0
<a href=/player/betew001>betew001</a>,Wilson Betemit,Kansas City Royals,ROYALS,1,1,2,3,2011,2011,0,No,0,0.46,0.0,-0.46,40,0,-40,133,0,-133,0.0,0.0,0.0,1000000.0,0.0,-1000000.0
<a href=/player/bethc001>bethc001</a>,Christian Bethancourt,Atlanta Braves,BRAVES,1,1,2,3,2015,2016,1,Yes,0,-0.48,-0.36,0.12,87,20,-67,211,3,-208,16.0,65.0,49.0,507500.0,0.0,-507500.0
<a href=/player/bettl101>bettl101</a>,Larry Bettencourt,St.Louis Browns,ORLS,2,4,3,7,1932,1938,6,No,0,5.05,3.68,-1.37,140,456,316,175,291,116,1317.0,2656.0,1339.0,9500.0,0.0,-9500.0
<a href=/player/bettm001>bettm001</a>,Mookie Betts,Boston Red Sox,RSOX,1,3,3,6,2020,2020,0,Yes,0,8.46,2.13,-6.33,253,53,-200,814,221,-593,221.0,0.0,-221.0,0.0,0.0,0.0
<a href=/player/bevah101>bevah101</a>,Hal Bevan,Kansas City Athletics,ATLTCS,1,1,1,2,1955,1955,0,No,0,0.0,0.0,0.0,3,0,-3,3,0,-3,0.0,0.0,0.0,7000.0,0.0,-7000.0
<a href=/player/bevak001>bevak001</a>,Kurt Bevacqua,Cincinnati Reds,REDS,3,4,4,8,1971,1973,2,No,0,0.37,0.09,-0.28,297,115,-182,794,178,-616,24.0,0.0,-24.0,16000.0,0.0,-16000.0
<a href=/player/bevak001>bevak001</a>,Kurt Bevacqua,Cleveland Indians,INDINS,2,2,2,4,1972,1974,2,No,0,-1.25,0.0,1.25,138,0,-138,409,0,-409,0.0,0.0,0.0,10500.0,0.0,-10500.0
<a href=/player/bevak001>bevak001</a>,Kurt Bevacqua,Kansas City Royals,ROYALS,2,4,3,7,1973,1978,5,No,0,2.68,1.78,-0.9,438,157,-281,817,247,-570,955.0,645.0,-310.0,49000.0,0.0,-49000.0
<a href=/player/bevak001>bevak001</a>,Kurt Bevacqua,Pittsburgh Pirates,PIRATS,1,1,2,3,1974,1974,0,No,0,-1.04,0.0,1.04,39,0,-39,100,0,-100,0.0,0.0,0.0,26000.0,0.0,-26000.0
<a href=/player/bevak001>bevak001</a>,Kurt Bevacqua,Texas Rangers,RNGRS,3,8,8,16,1978,1985,7,No,1,13.84,11.07,-2.77,1150,730,-420,2985,2621,-364,918.0,0.0,-918.0,475000.0,0.0,-475000.0
<a href=/player/bevak001>bevak001</a>,Kurt Bevacqua,San Diego Padres,PADRS,3,8,6,14,1980,1989,9,No,0,23.83,6.58,-17.25,2167,688,-1479,6899,2080,-4819,2009.0,1127.0,-882.0,0.0,0.0,0.0
<a href=/player/bevej001>bevej001</a>,Jason Beverlin,Oakland Athletics,ATLTCS,2,3,3,6,1995,1997,2,No,0,-0.97,-0.14,0.83,515,36,-479,1898,98,-1800,0.0,89.0,89.0,6200000.0,0.0,-6200000.0
<a href=/player/biagj001>biagj001</a>,Joe Biagini,Toronto Blue Jays,BJAYS,2,4,3,7,2019,2021,2,Yes,0,-0.75,-0.48,0.27,26,56,30,8,146,138,113.0,0.0,-113.0,4800000.0,0.0,-4800000.0
<a href=/player/bianb001>bianb001</a>,Buddy Biancalana,Kansas City Royals,ROYALS,1,1,1,2,1987,1987,0,No,0,-0.55,0.0,0.55,18,0,-18,25,0,-25,0.0,0.0,0.0,0.0,0.0,0.0
<a href=/player/bibbj001>bibbj001</a>,Jim Bibby,New York Mets,METS,1,4,4,8,1971,1975,4,No,0,1.94,1.36,-0.58,244,340,96,49,280,231,763.0,880.0,117.0,0.0,0.0,0.0
<a href=/player/bibbj001>bibbj001</a>,Jim Bibby,St. Louis Cardinals,CARDS,3,3,4,7,1973,1974,1,No,0,10.5,-0.07,-10.57,783,18,-765,2118,11,-2107,1625.0,122.0,-1503.0,0.0,0.0,0.0
<a href=/player/bibbj001>bibbj001</a>,Jim Bibby,Texas Rangers,RNGRS,2,5,3,8,1975,1978,3,No,0,27.68,13.0,-14.68,537,88,-449,186,0,-186,7504.0,2017.0,-5487.0,60000.0,0.0,-60000.0
<a href=/player/bichd001>bichd001</a>,Dante Bichette,California Angels,ANGELS,1,1,1,2,1991,1991,0,No,0,-0.31,-1.23,-0.92,246,119,-127,886,501,-385,0.0,0.0,0.0,0.0,0.0,0.0
<a href=/player/bichd001>bichd001</a>,Dante Bichette,Milwaukee Brewers,BREWRS,1,1,1,2,1992,1993,1,No,0,4.76,-0.36,-5.12,1018,125,-893,4352,477,-3875,0.0,0.0,0.0,230000.0,0.0,-230000.0
<a href=/player/bichd001>bichd001</a>,Dante Bichette,Colorado Rockies,ROCKS,1,2,2,4,1999,2000,1,No,0,0.45,1.52,1.07,125,214,89,514,512,-2,0.0,107.0,107.0,7250000.0,0.0,-7250000.0
<a href=/player/bichd001>bichd001</a>,Dante Bichette,Cincinnati Reds,REDS,2,2,4,6,2000,2006,6,No,0,0.22,1.51,1.29,505,251,-254,538,108,-430,543.0,1259.0,716.0,7000000.0,0.0,-7000000.0
<a href=/player/bickp001>bickp001</a>,Phil Bickford,San Francisco Giants,GIANTS,1,2,1,3,2016,2019,3,No,0,-0.35,3.53,3.88,20,278,258,31,2,-29,6.0,410.0,404.0,0.0,0.0,0.0
<a href=/player/bickv101>bickv101</a>,Vern Bickford,Milwaukee Braves,BRAVES,1,1,2,3,1954,1956,2,No,0,-0.22,0.12,0.34,2,62,60,1,138,137,12.0,0.0,-12.0,0.0,0.0,0.0
<a href=/player/biddj001>biddj001</a>,Jesse Biddle,Philadelphia Phillies,PHILS,1,1,1,2,2016,2016,0,No,0,0.0,0.0,0.0,0,0,0,0,0,0,0.0,0.0,0.0,0.0,0.0,0.0
<a href=/player/biddj001>biddj001</a>,Jesse Biddle,Atlanta Braves,BRAVES,1,2,2,4,2019,2019,0,No,0,-0.53,0.41,0.94,11,85,74,0,0,0,33.0,119.0,86.0,5375000.0,0.0,-5375000.0
<a href=/player/biddr001>biddr001</a>,Rocky Biddle,Chicago White Sox,WSOX,3,7,5,12,2003,2010,7,No,2,-4.18,5.27,9.45,270,142,-128,107,7,-100,449.0,996.0,547.0,0.0,0.0,0.0
<a href=/player/bielm001>bielm001</a>,Mike Bielecki,Pittsburgh Pirates,PIRATS,1,1,1,2,1988,1988,0,No,0,4.7,0.0,-4.7,254,0,-254,200,0,-200,1802.0,0.0,-1802.0,0.0,0.0,0.0
<a href=/player/bielm001>bielm001</a>,Mike Bielecki,Chicago Cubs,CUBS,3,6,6,12,1991,2001,10,No,0,5.81,3.91,-1.9,1572,1078,-494,2118,2224,106,1917.0,1553.0,-364.0,10348333.0,0.0,-10348333.0
<a href=/player/biern001>biern001</a>,Nick Bierbrodt,Arizona Diamondbacks,DBACKS,1,2,2,4,2001,2001,0,No,0,-0.05,0.9,0.95,103,38,-65,245,52,-193,290.0,243.0,-47.0,200000.0,0.0,-200000.0
<a href=/player/bierr001>bierr001</a>,Randor Bierd,Baltimore Orioles,ORLS,1,1,1,2,2009,2009,0,No,0,0.0,0.0,0.0,0,0,0,0,0,0,0.0,0.0,0.0,0.0,0.0,0.0
<a href=/player/bigbl001>bigbl001</a>,Larry Bigbie,Baltimore Orioles,ORLS,1,1,1,2,2005,2005,0,No,0,-0.58,-0.09,0.49,23,52,29,70,181,111,0.0,0.0,0.0,380000.0,0.0,-380000.0
<a href=/player/bigbl001>bigbl001</a>,Larry Bigbie,Colorado Rockies,ROCKS,1,2,1,3,2005,2006,1,No,0,1.78,0.15,-1.63,503,131,-372,1507,1,-1506,15.0,134.0,119.0,326000.0,0.0,-326000.0
<a href=/player/bigbl101>bigbl101</a>,Lyle Bigbee,Seattle,Seattle,1,1,3,4,1919,1921,2,No,0,-1.44,0.0,1.44,50,0,-50,86,0,-86,133.0,0.0,-133.0,0.0,0.0,0.0
<a href=/player/bigee101>bigee101</a>,Elliot Bigelow,Washington Senators,TWINS,1,5,1,6,1928,1941,13,No,0,14.54,41.49,26.95,801,1492,691,1696,6460,4764,3390.0,0.0,-3390.0,20500.0,0.0,-20500.0
<a href=/player/biitl101>biitl101</a>,Larry Biittner,Texas Rangers,RNGRS,1,1,1,2,1973,1974,1,No,0,0.76,0.0,-0.76,150,0,-150,443,0,-443,0.0,0.0,0.0,0.0,0.0,0.0
<a href=/player/biitl101>biitl101</a>,Larry Biittner,Montreal Expos,NATEX,2,3,2,5,1976,1978,2,No,0,19.9,-0.47,-20.37,1883,153,-1730,6872,280,-6592,648.0,557.0,-91.0,0.0,0.0,0.0
<a href=/player/bilad001>bilad001</a>,Dann Bilardello,Cincinnati Reds,REDS,3,6,4,10,1985,1988,3,No,0,12.45,4.93,-7.52,892,228,-664,620,336,-284,4251.0,1549.0,-2702.0,1777500.0,0.0,-1777500.0
<a href=/player/bilks101>bilks101</a>,Steve Bilko,Cincinnati Reds,REDS,1,4,1,5,1958,1960,2,No,0,0.85,9.64,8.79,265,190,-75,151,233,82,590.0,1314.0,724.0,14000.0,0.0,-14000.0
<a href=/player/billb002>billb002</a>,Bruce Billings,Colorado Rockies,ROCKS,3,5,4,9,2011,2017,6,Yes,1,0.36,-1.09,-1.45,44,141,97,22,335,313,232.0,478.0,246.0,0.0,0.0,0.0
<a href=/player/billj101>billj101</a>,Jack Billingham,Houston Astros,ASTROS,8,15,14,29,1971,1989,18,No,0,76.39,55.08,-21.31,4763,4769,6,15346,14810,-536,3810.0,5622.0,1812.0,705000.0,0.0,-705000.0
<a href=/player/billj101>billj101</a>,Jack Billingham,Cincinnati Reds,REDS,1,1,2,3,1978,1980,2,No,0,4.64,0.0,-4.64,73,0,-73,0,0,0,1101.0,0.0,-1101.0,0.0,0.0,0.0
<a href=/player/billj103>billj103</a>,Josh Billings,Cleveland Indians,INDINS,1,1,1,2,1919,1923,4,No,0,-0.67,0.22,0.89,133,131,-2,324,316,-8,0.0,0.0,0.0,0.0,0.0,0.0
<a href=/player/binkg101>binkg101</a>,George Binks,Milwaukee,Milwaukee,1,1,1,2,1944,1944,0,No,0,1.67,0.0,-1.67,215,0,-215,747,0,-747,0.0,0.0,0.0,0.0,0.0,0.0
<a href=/player/binkg101>binkg101</a>,George Binks,Washington Senators,TWINS,1,1,2,3,1947,1947,0,No,0,-0.75,-0.26,0.49,121,18,-103,407,2,-405,0.0,46.0,46.0,0.0,0.0,0.0
<a href=/player/binkg101>binkg101</a>,George Binks,Philadelphia Athletics,ATLTCS,37,81,79,160,1948,1976,28,No,0,93.04,74.67,-18.37,10610,9528,-1082,25813,29511,3698,12563.0,7417.0,-5146.0,507800.0,0.0,-507800.0
<a href=/player/birdd101>birdd101</a>,Doug Bird,Kansas City Royals,ROYALS,4,6,5,11,1979,1986,7,No,0,14.16,8.78,-5.38,1336,964,-372,3943,3382,-561,183.0,0.0,-183.0,0.0,0.0,0.0
<a href=/player/birdd101>birdd101</a>,Doug Bird,New York Yankees,YANKS,1,3,1,4,1981,1983,2,No,0,0.87,1.55,0.68,126,12,-114,98,0,-98,955.0,212.0,-743.0,0.0,0.0,0.0
<a href=/player/birdd101>birdd101</a>,Doug Bird,Chicago Cubs,CUBS,3,4,3,7,1982,1988,6,No,0,-1.41,4.87,6.28,122,600,478,169,660,491,295.0,1469.0,1174.0,490000.0,0.0,-490000.0
<a href=/player/birdk001>birdk001</a>,Kyle Bird,Tampa Bay Devil Rays,RAYS,2,4,5,9,2018,2020,2,Yes,0,-0.58,3.27,3.85,173,118,-55,2,160,158,374.0,210.0,-164.0,0.0,0.0,0.0
<a href=/player/birkr101>birkr101</a>,Ralph Birkofer,Pittsburgh Pirates,PIRATS,1,2,1,3,1936,1939,3,No,0,12.93,4.3,-8.63,841,114,-727,3255,108,-3147,89.0,818.0,729.0,0.0,0.0,0.0
<a href=/player/birkr101>birkr101</a>,Ralph Birkofer,Brooklyn Dodgers,DOGRS,1,1,2,3,1937,1939,2,No,0,0.0,-0.42,-0.42,0,48,48,0,121,121,0.0,0.0,0.0,0.0,0.0,0.0
<a href=/player/birtt001>birtt001</a>,Tim Birtsas,New York Yankees,YANKS,3,7,8,15,1984,1993,9,No,0,53.43,36.99,-16.44,2484,1135,-1349,8455,3089,-5366,3002.0,2795.0,-207.0,2415000.0,0.0,-2415000.0
<a href=/player/birtt001>birtt001</a>,Tim Birtsas,Oakland Athletics,ATLTCS,2,3,3,6,1987,1996,9,No,2,38.12,0.22,-37.9,775,350,-425,532,1011,479,4990.0,1220.0,-3770.0,0.0,0.0,0.0
<a href=/player/bishm102>bishm102</a>,Max Bishop,Philadelphia Athletics,ATLTCS,1,3,3,6,1933,1936,3,No,0,51.32,1.87,-49.45,848,361,-487,1283,1356,73,5977.0,119.0,-5858.0,31000.0,0.0,-31000.0
<a href=/player/bissd101>bissd101</a>,Del Bissonette,Brooklyn Dodgers,DOGRS,3,7,4,11,1933,1940,7,No,0,2.67,10.0,7.33,454,955,501,1715,3466,1751,0.0,317.0,317.0,0.0,0.0,0.0
<a href=/player/bitkj001>bitkj001</a>,Joe Bitker,Oakland Athletics,ATLTCS,2,3,3,6,1990,1997,7,No,0,11.13,4.36,-6.77,696,326,-370,2415,1227,-1188,327.0,177.0,-150.0,0.0,0.0,0.0
<a href=/player/bittj001>bittj001</a>,Jeff Bittiger,New York Mets,METS,2,4,3,7,1986,1986,0,No,0,-0.05,0.0,0.05,49,0,-49,136,0,-136,44.0,0.0,-44.0,0.0,0.0,0.0
<a href=/player/bittj001>bittj001</a>,Jeff Bittiger,Chicago White Sox,WSOX,1,1,1,2,1989,1990,1,No,0,0.0,0.0,0.0,0,0,0,0,0,0,0.0,0.0,0.0,0.0,0.0,0.0
<a href=/player/bivij101>bivij101</a>,Jim Bivin,Philadelphia Phillies,PHILS,1,1,1,2,1935,1935,0,No,0,0.0,0.0,0.0,0,0,0,0,0,0,0.0,0.0,0.0,0.0,0.0,0.0
<a href=/player/bixlb001>bixlb001</a>,Brian Bixler,Pittsburgh Pirates,PIRATS,1,1,1,2,2010,2010,0,No,0,0.0,0.0,0.0,0,0,0,0,0,0,0.0,0.0,0.0,0.0,0.0,0.0
<a href=/player/bjorg101>bjorg101</a>,George Bjorkman,St. Louis Cardinals,CARDS,1,1,1,2,1983,1983,0,No,0,0.26,0.0,-0.26,29,0,-29,93,0,-93,0.0,0.0,0.0,0.0,0.0,0.0
<a href=/player/bjorg101>bjorg101</a>,George Bjorkman,Houston Astros,ASTROS,1,1,1,2,1984,1984,0,No,0,0.0,-0.34,-0.34,0,6,6,0,12,12,0.0,0.0,0.0,0.0,0.0,0.0
<a href=/player/blacb001>blacb001</a>,Buddy Black,Seattle Mariners,MARNRS,1,1,1,2,1982,1984,2,No,0,12.93,-2.39,-15.32,217,229,12,0,757,757,2933.0,8.0,-2925.0,0.0,0.0,0.0
<a href=/player/blacb001>blacb001</a>,Buddy Black,Kansas City Royals,ROYALS,3,4,4,8,1988,1998,10,No,0,11.52,1.16,-10.36,458,446,-12,1163,984,-179,1559.0,1998.0,439.0,1360000.0,0.0,-1360000.0
<a href=/player/blacb001>blacb001</a>,Buddy Black,Cleveland Indians,INDINS,19,25,32,57,1990,2020,30,Yes,2,34.13,110.71,76.58,3254,3355,101,9795,9199,-596,4030.0,9522.0,5492.0,45429400.0,0.0,-45429400.0
<a href=/player/blacb101>blacb101</a>,Bud Black,St.Louis Browns,ORLS,8,14,16,30,1952,1960,8,No,0,32.49,23.42,-9.07,2082,1835,-247,5453,4904,-549,5614.0,2626.0,-2988.0,41000.0,0.0,-41000.0
<a href=/player/blacb103>blacb103</a>,Bill Black,Beaumont,Beaumont,1,1,4,5,1924,1924,0,No,0,-0.04,0.0,0.04,6,0,-6,5,0,-5,0.0,0.0,0.0,0.0,0.0,0.0
<a href=/player/blacd102>blacd102</a>,Dave Black,Chicago Whales,CHF,1,1,1,2,1915,1916,1,No,0,0.0,0.66,0.66,0,10,10,0,11,11,0.0,100.0,100.0,0.0,0.0,0.0
<a href=/player/blace101>blace101</a>,Earl Blackburn,Boston Braves,BRAVES,1,2,2,4,1917,1919,2,No,0,0.0,-1.02,-1.02,2,181,179,2,722,720,0.0,0.0,0.0,0.0,0.0,0.0
<a href=/player/blace102>blace102</a>,Ewell Blackwell,Cincinnati Reds,REDS,6,11,19,30,1952,1965,13,No,0,65.09,23.38,-41.71,3612,2003,-1609,11350,4683,-6667,2670.0,1071.0,-1599.0,27000.0,0.0,-27000.0
<a href=/player/blace103>blace103</a>,Ethan Blackaby,Atlanta Braves,BRAVES,1,1,1,2,1966,1968,2,No,0,0.0,0.0,0.0,0,0,0,0,0,0,0.0,0.0,0.0,0.0,0.0,0.0
<a href=/player/blace103>blace103</a>,Ethan Blackaby,California Angels,ANGELS,1,1,1,2,1968,1968,0,No,0,0.0,0.0,0.0,0,0,0,0,0,0,0.0,0.0,0.0,0.0,0.0,0.0
<a href=/player/blacj103>blacj103</a>,Joe Black,Brooklyn Dodgers,DOGRS,1,1,2,3,1955,1955,0,No,0,0.74,-0.33,-1.07,130,9,-121,44,20,-24,492.0,0.0,-492.0,0.0,0.0,0.0
<a href=/player/blacl101>blacl101</a>,Lena Blackburne,Providence,Providence,1,1,3,4,1909,1913,4,No,0,2.75,0.0,-2.75,323,0,-323,1203,0,-1203,1.0,0.0,-1.0,0.0,0.0,0.0
<a href=/player/blacl101>blacl101</a>,Lena Blackburne,Chicago White Sox,WSOX,1,5,1,6,1912,1928,16,No,0,0.0,33.22,33.22,0,1757,1757,0,6239,6239,0.0,0.0,0.0,0.0,0.0,0.0
<a href=/player/blacl101>blacl101</a>,Lena Blackburne,Cincinnati Reds,REDS,1,1,1,2,1919,1919,0,No,0,0.14,-0.11,-0.25,31,5,-26,92,14,-78,0.0,0.0,0.0,0.0,0.0,0.0
<a href=/player/blacp001>blacp001</a>,Paul Blackburn,Chicago Cubs,CUBS,4,5,5,10,2016,2020,4,Yes,0,4.67,3.17,-1.5,619,278,-341,1969,187,-1782,208.0,960.0,752.0,2440000.0,0.0,-2440000.0
<a href=/player/blacp001>blacp001</a>,Paul Blackburn,Seattle Mariners,MARNRS,1,1,1,2,2016,2017,1,No,0,-0.33,1.0,1.33,32,130,98,5,500,495,414.0,0.0,-414.0,0.0,0.0,0.0
<a href=/player/blacr001>blacr001</a>,Ray Black,San Francisco Giants,GIANTS,1,2,1,3,2019,2019,0,Yes,0,0.99,0.61,-0.38,83,28,-55,2,109,107,130.0,0.0,-130.0,1500000.0,0.0,-1500000.0
<a href=/player/blact001>blact001</a>,Travis Blackley,Seattle Mariners,MARNRS,1,1,1,2,2007,2007,0,No,0,-0.38,-0.24,0.14,12,63,51,3,48,45,41.0,0.0,-41.0,0.0,0.0,0.0
<a href=/player/blact001>blact001</a>,Travis Blackley,Oakland Athletics,ATLTCS,2,3,2,5,2013,2014,1,No,0,-0.02,0.59,0.61,96,21,-75,115,56,-59,105.0,0.0,-105.0,0.0,0.0,0.0
<a href=/player/blact001>blact001</a>,Travis Blackley,Houston Astros,ASTROS,1,1,1,2,2013,2013,0,No,0,-0.03,0.0,0.03,4,0,-4,0,0,0,46.0,0.0,-46.0,0.0,0.0,0.0
<a href=/player/blact101>blact101</a>,Tim Blackwell,Philadelphia Phillies,PHILS,12,28,21,49,1977,1999,22,No,0,39.49,55.77,16.28,5043,4716,-327,14497,10321,-4176,7936.0,3859.0,-4077.0,2950000.0,0.0,-2950000.0
<a href=/player/blacv001>blacv001</a>,Vic Black,Pittsburgh Pirates,PIRATS,1,2,3,5,2013,2013,0,No,0,0.44,0.95,0.51,159,39,-120,169,139,-30,143.0,0.0,-143.0,0.0,0.0,0.0
<a href=/player/bladr101>bladr101</a>,Rick Bladt,Chicago Cubs,CUBS,1,3,1,4,1970,1970,0,No,0,0.08,-0.37,-0.45,52,28,-24,133,36,-97,0.0,0.0,0.0,0.0,0.0,0.0
<a href=/player/bladr101>bladr101</a>,Rick Bladt,New York Yankees,YANKS,1,2,1,3,1977,1979,2,No,0,0.81,-0.33,-1.14,49,160,111,128,324,196,0.0,0.0,0.0,0.0,0.0,0.0
<a href=/player/blaeg101>blaeg101</a>,George Blaeholder,St.Louis Browns,ORLS,4,5,5,10,1935,1939,4,No,0,3.13,1.95,-1.18,153,471,318,166,1259,1093,1298.0,1025.0,-273.0,16000.0,0.0,-16000.0
<a href=/player/blaer101>blaer101</a>,Rae Blaemire,New York Giants,GIANTS,1,2,1,3,1941,1942,1,No,0,0.0,0.0,0.0,0,0,0,0,0,0,0.0,0.0,0.0,0.0,0.0,0.0
<a href=/player/blaia001>blaia001</a>,Aaron Blair,Arizona Diamondbacks,DBACKS,2,5,3,8,2015,2018,3,No,0,16.27,-1.52,-17.79,1329,142,-1187,5122,368,-4754,281.0,417.0,136.0,513000.0,0.0,-513000.0
<a href=/player/blaib102>blaib102</a>,Buddy Blair,New York Yankees,YANKS,3,4,5,9,1941,1950,9,No,0,8.96,-1.41,-10.37,588,90,-498,2279,41,-2238,0.0,394.0,394.0,0.0,0.0,0.0
<a href=/player/blaid101>blaid101</a>,Dennis Blair,Montreal Expos,NATEX,1,1,1,2,1977,1979,2,No,0,0.0,0.07,0.07,0,40,40,0,10,10,0.0,153.0,153.0,0.0,0.0,0.0
<a href=/player/blaid101>blaid101</a>,Dennis Blair,Baltimore Orioles,ORLS,1,1,1,2,1979,1979,0,No,0,-0.31,0.0,0.31,10,0,-10,5,0,-5,42.0,0.0,-42.0,0.0,0.0,0.0
<a href=/player/blaip101>blaip101</a>,Paul Blair,Baltimore Orioles,ORLS,3,3,4,7,1977,1990,13,No,1,-1.39,3.89,5.28,303,655,352,716,2220,1504,0.0,0.0,0.0,0.0,0.0,0.0
<a href=/player/blaiw001>blaiw001</a>,Willie Blair,Toronto Blue Jays,BJAYS,1,1,1,2,1990,1990,0,No,0,-0.37,0.0,0.37,11,0,-11,0,0,0,108.0,0.0,-108.0,100000.0,0.0,-100000.0
<a href=/player/blaiw001>blaiw001</a>,Willie Blair,Cleveland Indians,INDINS,16,22,27,49,1991,2020,29,Yes,2,33.95,111.42,77.47,3251,3340,89,9795,9199,-596,3983.0,9391.0,5408.0,44654400.0,0.0,-44654400.0
<a href=/player/blaiw001>blaiw001</a>,Willie Blair,San Diego Padres,PADRS,2,3,3,6,1996,1997,1,No,0,2.37,0.0,-2.37,183,0,-183,158,0,-158,1473.0,0.0,-1473.0,920000.0,0.0,-920000.0
<a href=/player/blaiw001>blaiw001</a>,Willie Blair,Arizona Diamondbacks,DBACKS,10,23,21,44,1998,2012,14,No,3,42.86,25.86,-17.0,3128,1205,-1923,7041,1494,-5547,9612.0,4323.0,-5289.0,28375667.0,0.0,-28375667.0
<a href=/player/blaiw001>blaiw001</a>,Willie Blair,New York Mets,METS,2,2,2,4,1998,1998,0,No,0,13.23,0.0,-13.23,981,0,-981,3718,0,-3718,944.0,0.0,-944.0,0.0,0.0,0.0
<a href=/player/blakc001>blakc001</a>,Casey Blake,Cleveland Indians,INDINS,2,3,3,6,2008,2017,9,No,0,9.15,24.02,14.87,406,1121,715,1608,4782,3174,0.0,13.0,13.0,6100000.0,0.0,-6100000.0
<a href=/player/blake101>blake101</a>,Ed Blake,St. Louis Cardinals,CARDS,1,1,1,2,1949,1949,0,No,0,0.01,0.0,-0.01,12,0,-12,0,0,0,21.0,0.0,-21.0,0.0,0.0,0.0
<a href=/player/blaks101>blaks101</a>,Sheriff Blake,Pittsburgh Pirates,PIRATS,1,3,1,4,1922,1927,5,No,0,0.0,-0.21,-0.21,0,25,25,0,62,62,0.0,0.0,0.0,3600.0,0.0,-3600.0
<a href=/player/blaks101>blaks101</a>,Sheriff Blake,Seattle,Seattle,1,2,2,4,1923,1925,2,No,0,12.05,0.0,-12.05,628,0,-628,625,0,-625,5104.0,0.0,-5104.0,0.0,0.0,0.0
<a href=/player/blang001>blang001</a>,Gregor Blanco,Atlanta Braves,BRAVES,1,3,2,5,2010,2010,0,No,0,2.01,-0.01,-2.02,319,93,-226,204,139,-65,734.0,60.0,-674.0,415000.0,0.0,-415000.0
<a href=/player/blang101>blang101</a>,Gil Blanco,New York Yankees,YANKS,3,5,4,9,1966,1973,7,No,0,1.66,4.77,3.11,451,607,156,554,678,124,1018.0,1714.0,696.0,17000.0,0.0,-17000.0
<a href=/player/blanh001>blanh001</a>,Henry Blanco,Colorado Rockies,ROCKS,5,7,10,17,1999,2015,16,Yes,2,2.29,20.39,18.1,742,1883,1141,1686,1378,-308,1715.0,2932.0,1217.0,6840000.0,0.0,-6840000.0
<a href=/player/blanh001>blanh001</a>,Henry Blanco,Milwaukee Brewers,BREWRS,2,2,3,5,2002,2002,0,No,0,-1.12,-3.2,-2.08,255,184,-71,785,277,-508,0.0,310.0,310.0,750000.0,0.0,-750000.0
<a href=/player/blanj001>blanj001</a>,Joe Blanton,Oakland Athletics,ATLTCS,6,10,10,20,2008,2014,6,No,0,5.46,7.89,2.43,637,601,-36,939,1576,637,2311.0,709.0,-1602.0,8180000.0,0.0,-8180000.0
<a href=/player/blanj001>blanj001</a>,Joe Blanton,Philadelphia Phillies,PHILS,1,1,1,2,2012,2012,0,No,0,1.95,0.0,-1.95,166,0,-166,21,0,-21,413.0,0.0,-413.0,8500000.0,0.0,-8500000.0
<a href=/player/blanj101>blanj101</a>,Johnny Blanchard,New York Yankees,YANKS,2,3,2,5,1965,1967,2,No,0,0.45,-0.46,-0.91,144,131,-13,217,298,81,767.0,0.0,-767.0,35500.0,0.0,-35500.0
<a href=/player/blank001>blank001</a>,Kevin Blankenship,Atlanta Braves,BRAVES,1,2,1,3,1988,1990,2,No,0,-1.22,-1.32,-0.1,28,92,64,13,296,283,123.0,0.0,-123.0,65000.0,0.0,-65000.0
<a href=/player/blank002>blank002</a>,Kyle Blanks,San Diego Padres,PADRS,2,2,3,5,2014,2019,5,No,0,0.54,0.73,0.19,23,297,274,56,978,922,9.0,0.0,-9.0,988000.0,0.0,-988000.0
<a href=/player/blanl101>blanl101</a>,Larvell Blanks,Atlanta Braves,BRAVES,6,12,8,20,1975,1987,12,No,0,13.66,24.44,10.78,1298,1964,666,3286,2845,-441,3707.0,4072.0,365.0,999667.0,0.0,-999667.0
<a href=/player/blanl101>blanl101</a>,Larvell Blanks,Chicago White Sox,WSOX,4,5,5,10,1975,1985,10,No,1,3.85,3.26,-0.59,356,183,-173,941,593,-348,121.0,16.0,-105.0,0.0,0.0,0.0
<a href=/player/blanl101>blanl101</a>,Larvell Blanks,Cleveland Indians,INDINS,14,21,31,52,1978,2011,33,No,4,61.95,134.64,72.69,2403,5295,2892,7210,17001,9791,7208.0,16506.0,9298.0,2352500.0,0.0,-2352500.0
<a href=/player/blanl101>blanl101</a>,Larvell Blanks,Texas Rangers,RNGRS,2,4,4,8,1979,1981,2,No,0,4.64,-2.56,-7.2,264,133,-131,467,246,-221,1400.0,101.0,-1299.0,150000.0,0.0,-150000.0
<a href=/player/blanm001>blanm001</a>,Matt Blank,Montreal Expos,NATEX,2,4,5,9,2003,2011,8,No,0,4.63,14.95,10.32,424,496,72,130,594,464,1491.0,3711.0,2220.0,8000000.0,0.0,-8000000.0
<a href=/player/blanm001>blanm001</a>,Matt Blank,Florida Marlins,MARLNS,1,1,1,2,2006,2006,0,No,0,0.0,0.0,0.0,0,0,0,0,0,0,0.0,0.0,0.0,0.0,0.0,0.0
<a href=/player/blano101>blano101</a>,Ossie Blanco,Chicago White Sox,WSOX,4,5,7,12,1970,1975,5,No,0,0.12,0.95,0.83,86,167,81,189,439,250,0.0,6.0,6.0,9500.0,0.0,-9500.0
<a href=/player/blant001>blant001</a>,Tony Blanco,Boston Red Sox,RSOX,1,2,1,3,2002,2003,1,No,0,0.0,1.1,1.1,0,144,144,0,647,647,0.0,0.0,0.0,0.0,0.0,0.0
<a href=/player/blasd101>blasd101</a>,Don Blasingame,St. Louis Cardinals,CARDS,5,11,9,20,1959,1965,6,No,0,3.97,11.52,7.55,923,741,-182,2729,1825,-904,727.0,697.0,-30.0,0.0,0.0,0.0
<a href=/player/blasd101>blasd101</a>,Don Blasingame,San Francisco Giants,GIANTS,9,17,13,30,1961,1972,11,No,0,22.69,19.49,-3.2,2066,1611,-455,6411,2790,-3621,1334.0,4789.0,3455.0,50000.0,0.0,-50000.0
<a href=/player/blasd101>blasd101</a>,Don Blasingame,Cincinnati Reds,REDS,2,3,2,5,1963,1966,3,No,0,2.04,-0.66,-2.7,511,40,-471,1520,5,-1515,336.0,101.0,-235.0,0.0,0.0,0.0
<a href=/player/blasj001>blasj001</a>,Jabari Blash,Oakland Athletics,ATLTCS,4,8,5,13,2015,2018,3,Yes,0,5.93,2.94,-2.99,610,354,-256,992,1020,28,691.0,108.0,-583.0,4517500.0,0.0,-4517500.0
<a href=/player/blasj001>blasj001</a>,Jabari Blash,San Diego Padres,PADRS,1,1,3,4,2017,2019,2,No,0,0.0,-0.98,-0.98,0,57,57,0,79,79,0.0,219.0,219.0,0.0,0.0,0.0
<a href=/player/blasj001>blasj001</a>,Jabari Blash,New York Yankees,YANKS,1,1,1,2,2018,2018,0,No,0,-0.82,0.0,0.82,24,0,-24,45,0,-45,0.0,0.0,0.0,0.0,0.0,0.0
<a href=/player/blasw101>blasw101</a>,Wade Blasingame,Atlanta Braves,BRAVES,1,2,2,4,1967,1969,2,No,0,-3.37,0.31,3.68,234,194,-40,135,17,-118,1228.0,428.0,-800.0,0.0,0.0,0.0
<a href=/player/blatj101>blatj101</a>,Johnny Blatnik,Philadelphia Phillies,PHILS,1,1,1,2,1950,1952,2,No,0,-0.3,0.46,0.76,7,91,84,23,57,34,0.0,500.0,500.0,0.0,0.0,0.0
<a href=/player/blats101>blats101</a>,Steve Blateric,Cincinnati Reds,REDS,1,1,1,2,1973,1975,2,No,0,0.0,0.09,0.09,0,6,6,0,7,7,0.0,0.0,0.0,0.0,0.0,0.0
<a href=/player/blats101>blats101</a>,Steve Blateric,Chicago White Sox,WSOX,1,2,1,3,1974,1976,2,No,0,-0.34,0.75,1.09,2,206,204,0,720,720,13.0,0.0,-13.0,0.0,0.0,0.0
<a href=/player/blats101>blats101</a>,Steve Blateric,Cleveland Indians,INDINS,1,1,1,2,1974,1975,1,No,0,0.0,-0.13,-0.13,0,6,6,0,18,18,0.0,0.0,0.0,0.0,0.0,0.0
<a href=/player/blaym101>blaym101</a>,Marv Blaylock,New York Giants,GIANTS,1,1,1,2,1953,1953,0,No,0,0.0,0.0,0.0,0,0,0,0,0,0,0.0,0.0,0.0,0.0,0.0,0.0
<a href=/player/blazm001>blazm001</a>,Michael Blazek,St. Louis Cardinals,CARDS,1,1,1,2,2013,2013,0,No,0,-0.23,0.31,0.54,192,26,-166,6,0,-6,338.0,31.0,-307.0,0.0,0.0,0.0
<a href=/player/blefc101>blefc101</a>,Curt Blefary,Baltimore Orioles,ORLS,17,40,34,74,1968,1999,31,No,3,56.19,162.01,105.82,4334,7679,3345,10445,17111,6666,14313.0,31574.0,17261.0,914833.0,0.0,-914833.0
<a href=/player/blefc101>blefc101</a>,Curt Blefary,Houston Astros,ASTROS,1,1,1,2,1969,1970,1,No,0,-1.67,0.08,1.75,120,75,-45,357,299,-58,0.0,0.0,0.0,0.0,0.0,0.0
<a href=/player/blefc101>blefc101</a>,Curt Blefary,Oakland Athletics,ATLTCS,1,3,1,4,1972,1972,0,No,0,-0.03,-0.15,-0.12,84,20,-64,122,60,-62,13.0,0.0,-13.0,20500.0,0.0,-20500.0
<a href=/player/blefc101>blefc101</a>,Curt Blefary,New York Yankees,YANKS,2,3,3,6,1971,1973,2,No,0,-0.83,1.22,2.05,208,167,-41,436,571,135,22.0,300.0,278.0,35500.0,0.0,-35500.0
<a href=/player/bleir001>bleir001</a>,Richard Bleier,New York Yankees,YANKS,1,1,1,2,2017,2017,0,No,0,3.56,0.0,-3.56,154,0,-154,0,0,0,463.0,0.0,-463.0,0.0,0.0,0.0
<a href=/player/bleir001>bleir001</a>,Richard Bleier,Baltimore Orioles,ORLS,1,1,1,2,2020,2020,0,Yes,0,1.4,0.0,-1.4,151,0,-151,1,0,-1,215.0,0.0,-215.0,915000.0,0.0,-915000.0
<a href=/player/blevj001>blevj001</a>,Jerry Blevins,Chicago Cubs,CUBS,2,3,3,6,2007,2011,4,No,1,3.55,-0.3,-3.85,355,57,-298,153,202,49,801.0,0.0,-801.0,0.0,0.0,0.0
<a href=/player/blevj001>blevj001</a>,Jerry Blevins,Oakland Athletics,ATLTCS,3,3,3,6,2013,2017,4,Yes,0,-1.42,1.88,3.3,174,255,81,82,976,894,172.0,0.0,-172.0,1100000.0,0.0,-1100000.0
<a href=/player/blevj001>blevj001</a>,Jerry Blevins,Washington Nationals,NATEX,1,1,1,2,2015,2016,1,No,0,2.89,0.77,-2.12,425,74,-351,3,149,146,416.0,0.0,-416.0,0.0,0.0,0.0
<a href=/player/blocb101>blocb101</a>,Bruno Block,Chicago White Sox,WSOX,1,5,1,6,1912,1928,16,No,0,0.0,33.22,33.22,0,1757,1757,0,6239,6239,0.0,0.0,0.0,0.0,0.0,0.0
<a href=/player/bloct001>bloct001</a>,Terry Blocker,New York Mets,METS,3,4,4,8,1987,2008,21,No,1,1.96,2.3,0.34,177,236,59,242,659,417,562.0,6.0,-556.0,200000.0,0.0,-200000.0
<a href=/player/blooj101>blooj101</a>,Jimmy Bloodworth,Washington Senators,TWINS,3,5,4,9,1941,1946,5,No,0,3.39,-0.33,-3.72,1062,197,-865,4332,521,-3811,0.0,315.0,315.0,17000.0,0.0,-17000.0
<a href=/player/blooj101>blooj101</a>,Jimmy Bloodworth,Pittsburgh Pirates,PIRATS,1,2,1,3,1947,1955,8,No,0,0.0,-1.57,-1.57,0,200,200,0,569,569,0.0,0.0,0.0,0.0,0.0,0.0
<a href=/player/blooj101>blooj101</a>,Jimmy Bloodworth,Brooklyn Dodgers,DOGRS,2,2,4,6,1948,1949,1,No,0,0.02,0.0,-0.02,247,0,-247,889,0,-889,0.0,0.0,0.0,0.0,0.0,0.0
<a href=/player/blowm001>blowm001</a>,Mike Blowers,Montreal Expos,NATEX,1,1,1,2,1989,1990,1,No,0,-1.24,-0.03,1.21,76,24,-52,238,0,-238,0.0,49.0,49.0,0.0,0.0,0.0
<a href=/player/blowm001>blowm001</a>,Mike Blowers,New York Yankees,YANKS,1,1,2,3,1991,1991,0,No,0,5.94,0.0,-5.94,464,0,-464,1534,0,-1534,0.0,0.0,0.0,130000.0,0.0,-130000.0
<a href=/player/blowm001>blowm001</a>,Mike Blowers,Seattle Mariners,MARNRS,3,4,5,9,1995,1997,2,No,0,0.63,-0.72,-1.35,191,11,-180,402,0,-402,434.0,126.0,-308.0,829445.0,0.0,-829445.0
<a href=/player/blueb101>blueb101</a>,Bert Blue,St.Louis Browns,ORLS,1,1,1,2,1908,1910,2,No,0,-0.23,-0.11,0.12,6,27,21,19,83,64,0.0,0.0,0.0,0.0,0.0,0.0
<a href=/player/bluel101>bluel101</a>,Lu Blue,Detroit Tigers,TIGRS,2,5,6,11,1927,1932,5,No,0,22.97,3.43,-19.54,913,569,-344,3930,2101,-1829,97.0,731.0,634.0,36000.0,0.0,-36000.0
<a href=/player/blueo101>blueo101</a>,Otto Bluege,Philadelphia Phillies,PHILS,1,3,1,4,1934,1934,0,No,0,0.0,-0.13,-0.13,0,10,10,0,32,32,0.0,0.0,0.0,0.0,0.0,0.0
<a href=/player/blueo101>blueo101</a>,Otto Bluege,Cincinnati Reds,REDS,4,6,6,12,1933,1942,9,No,0,0.93,12.9,11.97,309,1107,798,770,4269,3499,264.0,0.0,-264.0,23000.0,0.0,-23000.0
<a href=/player/bluev001>bluev001</a>,Vida Blue,Oakland Athletics,ATLTCS,6,8,17,25,1978,1987,9,No,0,13.35,12.26,-1.09,965,1823,858,1922,5674,3752,4815.0,2393.0,-2422.0,425000.0,0.0,-425000.0
<a href=/player/bluev001>bluev001</a>,Vida Blue,San Francisco Giants,GIANTS,3,6,7,13,1982,1992,10,No,0,0.93,10.52,9.59,146,1038,892,148,1280,1132,952.0,5228.0,4276.0,0.0,0.0,0.0
<a href=/player/blumg001>blumg001</a>,Geoff Blum,Montreal Expos,NATEX,3,3,3,6,2002,2003,1,No,0,0.51,-0.97,-1.48,879,236,-643,2557,652,-1905,0.0,0.0,0.0,1095000.0,0.0,-1095000.0
<a href=/player/blumg001>blumg001</a>,Geoff Blum,Houston Astros,ASTROS,1,1,1,2,2003,2009,6,No,0,-0.65,2.75,3.4,112,216,104,369,158,-211,0.0,1403.0,1403.0,1500000.0,0.0,-1500000.0
<a href=/player/blumg001>blumg001</a>,Geoff Blum,San Diego Padres,PADRS,1,1,1,2,2005,2005,0,No,0,-0.7,0.0,0.7,31,0,-31,99,0,-99,0.0,0.0,0.0,575000.0,0.0,-575000.0
<a href=/player/blylb001>blylb001</a>,Bert Blyleven,Minnesota Twins,TWINS,10,17,22,39,1976,1995,19,No,3,25.7,52.26,26.56,1493,3238,1745,3699,9266,5567,4606.0,5223.0,617.0,2325000.0,0.0,-2325000.0
<a href=/player/blylb001>blylb001</a>,Bert Blyleven,Texas Rangers,RNGRS,4,9,7,16,1977,1988,11,No,0,14.96,29.07,14.11,537,2027,1490,1603,7192,5589,2093.0,2974.0,881.0,330000.0,0.0,-330000.0
<a href=/player/blylb001>blylb001</a>,Bert Blyleven,Pittsburgh Pirates,PIRATS,4,6,9,15,1980,1984,4,No,0,24.19,-0.04,-24.23,615,106,-509,1402,76,-1326,2781.0,299.0,-2482.0,300000.0,0.0,-300000.0
<a href=/player/blylb001>blylb001</a>,Bert Blyleven,Cleveland Indians,INDINS,5,7,10,17,1985,2011,26,No,2,34.25,35.12,0.87,1463,2586,1123,5598,9199,3601,2580.0,2088.0,-492.0,1767500.0,0.0,-1767500.0
<a href=/player/blylb001>blylb001</a>,Bert Blyleven,Minnesota Twins,TWINS,3,5,6,11,1988,1995,7,No,0,10.18,-1.81,-11.99,698,140,-558,1780,213,-1567,1711.0,302.0,-1409.0,1000000.0,0.0,-1000000.0
<a href=/player/blyzm101>blyzm101</a>,Mike Blyzka,Baltimore Orioles,ORLS,21,46,43,89,1954,1994,40,No,3,83.66,150.67,67.01,4979,8510,3531,10385,24729,14344,18519.0,15968.0,-2551.0,970833.0,0.0,-970833.0
<a href=/player/boakc101>boakc101</a>,Chet Boak,Washington Senators,RNGRS,2,2,2,4,1961,1964,3,No,0,0.0,1.36,1.36,0,237,237,0,754,754,0.0,0.0,0.0,13000.0,0.0,-13000.0
<a href=/player/bobbr101>bobbr101</a>,Randy Bobb,Chicago Cubs,CUBS,1,1,1,2,1970,1973,3,No,0,0.0,-0.66,-0.66,0,112,112,0,299,299,0.0,0.0,0.0,0.0,0.0,0.0
<a href=/player/bocah001>bocah001</a>,Hiram Bocachica,Montreal Expos,NATEX,3,8,7,15,1998,2004,6,No,0,7.97,-4.29,-12.26,909,664,-245,2909,2173,-736,1579.0,285.0,-1294.0,2150000.0,0.0,-2150000.0
<a href=/player/bocah001>bocah001</a>,Hiram Bocachica,Los Angeles Dodgers,DOGRS,2,2,3,5,2002,2006,4,No,0,5.88,4.3,-1.58,579,191,-388,131,721,590,1514.0,0.0,-1514.0,225000.0,0.0,-225000.0
<a href=/player/boccj101>boccj101</a>,John Boccabella,Montreal Expos,NATEX,1,1,1,2,1974,1977,3,No,0,-0.89,2.04,2.93,29,151,122,85,91,6,0.0,904.0,904.0,0.0,0.0,0.0
<a href=/player/bochb001>bochb001</a>,Bruce Bochte,California Angels,ANGELS,1,3,2,5,1977,1982,5,No,0,9.5,4.45,-5.05,371,221,-150,444,0,-444,1221.0,1215.0,-6.0,0.0,0.0,0.0
<a href=/player/bochb002>bochb002</a>,Bruce Bochy,Houston Astros,ASTROS,1,1,2,3,1981,1981,0,No,0,0.72,0.0,-0.72,17,0,-17,53,0,-53,0.0,0.0,0.0,0.0,0.0,0.0
<a href=/player/bochd001>bochd001</a>,Doug Bochtler,Colorado Rockies,ROCKS,1,3,2,5,1993,1994,1,No,0,28.53,-1.48,-30.01,973,90,-883,1500,70,-1430,4150.0,636.0,-3514.0,150000.0,0.0,-150000.0
<a href=/player/bochd001>bochd001</a>,Doug Bochtler,San Diego Padres,PADRS,3,4,4,8,1997,2000,3,No,0,-0.13,-0.75,-0.62,150,123,-27,122,262,140,149.0,49.0,-100.0,693000.0,0.0,-693000.0
<a href=/player/bocke101>bocke101</a>,Eddie Bockman,New York Yankees,YANKS,1,1,2,3,1946,1946,0,No,0,0.17,0.0,-0.17,46,0,-46,71,0,-71,0.0,0.0,0.0,3600.0,0.0,-3600.0
<a href=/player/bocob001>bocob001</a>,Brian Bocock,Washington Nationals,NATEX,1,1,1,2,2013,2013,0,Yes,0,0.0,0.0,0.0,0,0,0,0,0,0,0.0,0.0,0.0,0.0,0.0,0.0
<a href=/player/boddm001>boddm001</a>,Mike Boddicker,Baltimore Orioles,ORLS,2,4,3,7,1988,2001,13,No,0,35.55,35.9,0.35,987,1988,1001,2612,8228,5616,4021.0,208.0,-3813.0,850000.0,0.0,-850000.0
<a href=/player/bodip101>bodip101</a>,Ping Bodie,SanFrancisco,SanFrancisco,1,1,2,3,1916,1921,5,No,0,3.85,0.0,-3.85,148,0,-148,635,0,-635,0.0,0.0,0.0,0.0,0.0,0.0
<a href=/player/bodip101>bodip101</a>,Ping Bodie,Philadelphia Athletics,ATLTCS,1,1,1,2,1918,1920,2,No,0,3.65,8.03,4.38,385,278,-107,1524,1125,-399,0.0,0.0,0.0,0.0,0.0,0.0
<a href=/player/boehb001>boehb001</a>,Brian Boehringer,Chicago White Sox,WSOX,1,1,1,2,1994,1994,0,No,0,1.65,0.85,-0.8,81,44,-37,0,0,0,440.0,99.0,-341.0,0.0,0.0,0.0
<a href=/player/boehb001>boehb001</a>,Brian Boehringer,Tampa Bay Devil Rays,RAYS,1,2,1,3,1997,2002,5,No,0,1.57,0.35,-1.22,275,471,196,252,1802,1550,559.0,0.0,-559.0,0.0,0.0,0.0
<a href=/player/boehb001>boehb001</a>,Brian Boehringer,New York Yankees,YANKS,1,1,2,3,2001,2002,1,No,0,-0.14,-0.01,0.13,54,3,-51,3,6,3,103.0,0.0,-103.0,350000.0,0.0,-350000.0
<a href=/player/boehj101>boehj101</a>,Joe Boehling,Washington Senators,TWINS,1,2,2,4,1916,1917,1,No,0,-0.1,0.72,0.82,82,122,40,78,517,439,360.0,0.0,-360.0,5000.0,0.0,-5000.0
<a href=/player/boehl101>boehl101</a>,Len Boehmer,Cincinnati Reds,REDS,1,1,1,2,1967,1967,0,No,0,-0.89,0.0,0.89,48,0,-48,121,0,-121,0.0,0.0,0.0,0.0,0.0,0.0
<a href=/player/boevj001>boevj001</a>,Joe Boever,St. Louis Cardinals,CARDS,1,1,1,2,1987,1988,1,No,0,0.52,-0.05,-0.57,258,22,-236,3,21,18,490.0,174.0,-316.0,0.0,0.0,0.0
<a href=/player/boevj001>boevj001</a>,Joe Boever,Atlanta Braves,BRAVES,1,1,1,2,1990,1993,3,No,0,1.77,1.35,-0.42,204,244,40,4,13,9,433.0,455.0,22.0,215000.0,0.0,-215000.0
<a href=/player/bogat001>bogat001</a>,Tim Bogar,New York Mets,METS,14,27,29,56,1997,2021,24,Yes,0,25.01,23.23,-1.78,1544,2155,611,3255,5420,2165,6012.0,3574.0,-2438.0,30731467.0,0.0,-30731467.0
<a href=/player/boggt001>boggt001</a>,Tommy Boggs,Texas Rangers,RNGRS,4,9,7,16,1977,1988,11,No,0,9.87,29.07,19.2,738,2027,1289,1844,7192,5348,1774.0,2974.0,1200.0,330000.0,0.0,-330000.0
<a href=/player/bogub001>bogub001</a>,Brian Bogusevic,Chicago Cubs,CUBS,2,2,2,4,2013,2014,1,Yes,0,-0.53,-0.37,0.16,36,81,45,81,250,169,0.0,0.0,0.0,2000000.0,0.0,-2000000.0
<a href=/player/bohab001>bohab001</a>,Brian Bohanon,New York Mets,METS,2,3,3,6,1998,1999,1,No,0,6.73,-0.73,-7.46,202,177,-25,35,1,-34,834.0,257.0,-577.0,2300000.0,0.0,-2300000.0
<a href=/player/bohns101>bohns101</a>,Sam Bohne,Seattle,Seattle,1,1,3,4,1920,1921,1,No,0,8.24,0.0,-8.24,602,0,-602,2409,0,-2409,0.0,0.0,0.0,0.0,0.0,0.0
<a href=/player/bohns101>bohns101</a>,Sam Bohne,St. Louis Cardinals,CARDS,1,5,1,6,1917,1917,0,No,0,0.0,0.36,0.36,0,28,28,0,29,29,0.0,256.0,256.0,9800.0,0.0,-9800.0
<a href=/player/boitd101>boitd101</a>,Dan Boitano,Philadelphia Phillies,PHILS,1,1,1,2,1979,1979,0,No,0,-0.61,0.0,0.61,16,0,-16,0,0,0,71.0,0.0,-71.0,0.0,0.0,0.0
<a href=/player/boitd101>boitd101</a>,Dan Boitano,New York Mets,METS,2,5,2,7,1981,1986,5,No,0,-0.02,4.68,4.7,485,655,170,913,2610,1697,596.0,0.0,-596.0,170000.0,0.0,-170000.0
<a href=/player/bokeb101>bokeb101</a>,Bob Boken,Washington Senators,TWINS,2,4,2,6,1934,1940,6,No,0,-2.0,1.2,3.2,81,376,295,319,1332,1013,0.0,17.0,17.0,4000.0,0.0,-4000.0
<a href=/player/bokeb101>bokeb101</a>,Bob Boken,Nashville,Nashville,1,3,1,4,1940,1954,14,No,0,0.0,0.0,0.0,0,0,0,0,0,0,0.0,0.0,0.0,0.0,0.0,0.0
<a href=/player/bolar001>bolar001</a>,Ronald Bolanos,San Diego Padres,PADRS,1,2,1,3,2020,2020,0,Yes,0,-0.21,-0.04,0.17,21,24,3,42,1,-41,30.0,54.0,24.0,0.0,0.0,0.0
<a href=/player/bolgj101>bolgj101</a>,Jim Bolger,Cincinnati Reds,REDS,2,2,3,5,1951,1961,10,No,0,0.0,4.19,4.19,0,329,329,0,124,124,0.0,1141.0,1141.0,16000.0,0.0,-16000.0
<a href=/player/bolgj101>bolgj101</a>,Jim Bolger,Cincinnati Reds,REDS,2,7,3,10,1954,1960,6,No,0,0.48,13.19,12.71,599,458,-141,824,407,-417,733.0,2898.0,2165.0,18000.0,0.0,-18000.0
<a href=/player/bolgj101>bolgj101</a>,Jim Bolger,Chicago Cubs,CUBS,2,4,3,7,1959,1961,2,No,0,-0.03,1.89,1.92,58,282,224,20,801,781,147.0,7.0,-140.0,0.0,0.0,0.0
<a href=/player/bolgj101>bolgj101</a>,Jim Bolger,Cleveland Indians,INDINS,1,2,1,3,1959,1959,0,No,0,-0.93,0.28,1.21,35,11,-24,52,19,-33,0.0,0.0,0.0,0.0,0.0,0.0
<a href=/player/bolgj101>bolgj101</a>,Jim Bolger,Milwaukee Braves,BRAVES,1,3,1,4,1962,1963,1,No,0,3.88,-0.09,-3.97,176,64,-112,179,177,-2,1524.0,0.0,-1524.0,0.0,0.0,0.0
<a href=/player/bolib101>bolib101</a>,Bobby Bolin,San Francisco Giants,GIANTS,1,1,2,3,1969,1969,0,No,0,-0.08,0.0,0.08,64,0,-64,45,0,-45,396.0,0.0,-396.0,33000.0,0.0,-33000.0
<a href=/player/bolib101>bolib101</a>,Bobby Bolin,Milwaukee Brewers,BREWRS,1,1,1,2,1970,1970,0,No,0,2.98,0.0,-2.98,197,0,-197,15,0,-15,485.0,0.0,-485.0,33000.0,0.0,-33000.0
<a href=/player/bolif001>bolif001</a>,Frank Bolick,Milwaukee Brewers,BREWRS,1,1,1,2,1990,1990,0,No,0,0.0,0.0,0.0,0,0,0,0,0,0,0.0,0.0,0.0,0.0,0.0,0.0
<a href=/player/bolif001>bolif001</a>,Frank Bolick,Seattle Mariners,MARNRS,2,3,3,6,1992,1994,2,No,0,-1.19,-0.25,0.94,99,17,-82,244,0,-244,20.0,66.0,46.0,0.0,0.0,0.0
<a href=/player/bolld101>bolld101</a>,Don Bollweg,St. Louis Cardinals,CARDS,1,2,1,3,1951,1953,2,No,0,1.29,4.57,3.28,70,229,159,178,828,650,0.0,0.0,0.0,0.0,0.0,0.0
<a href=/player/bolld101>bolld101</a>,Don Bollweg,New York Yankees,YANKS,16,45,38,83,1953,1970,17,No,0,48.62,78.17,29.55,7017,4726,-2291,22732,11340,-11392,3607.0,11554.0,7947.0,313000.0,0.0,-313000.0
<a href=/player/bollf101>bollf101</a>,Frank Bolling,Detroit Tigers,TIGRS,5,8,11,19,1960,1970,10,No,0,40.14,34.88,-5.26,2089,1971,-118,6205,4897,-1308,4562.0,4033.0,-529.0,39000.0,0.0,-39000.0
<a href=/player/bollj101>bollj101</a>,Jack Bolling,Atlanta,Atlanta,1,1,2,3,1939,1939,0,No,0,0.32,0.0,-0.32,69,0,-69,222,0,-222,0.0,0.0,0.0,0.0,0.0,0.0
<a href=/player/bollm101>bollm101</a>,Milt Bolling,Boston Red Sox,RSOX,3,5,4,9,1957,1961,4,No,0,-1.86,-2.15,-0.29,679,212,-467,1371,205,-1166,1950.0,366.0,-1584.0,0.0,0.0,0.0
<a href=/player/bollm101>bollm101</a>,Milt Bolling,Washington Senators,TWINS,1,1,1,2,1958,1958,0,No,0,0.0,0.0,0.0,0,0,0,0,0,0,0.0,0.0,0.0,0.0,0.0,0.0
<a href=/player/bollm101>bollm101</a>,Milt Bolling,Cleveland Indians,INDINS,1,2,2,4,1958,1958,0,No,0,0.0,0.0,0.0,54,0,-54,37,0,-37,56.0,0.0,-56.0,0.0,0.0,0.0
<a href=/player/bolsm001>bolsm001</a>,Mike Bolsinger,Los Angeles Dodgers,DOGRS,1,1,1,2,2016,2016,0,No,0,-0.42,-0.09,0.33,11,45,34,0,0,0,124.0,77.0,-47.0,0.0,0.0,0.0
<a href=/player/boltt001>boltt001</a>,Tom Bolton,Boston Red Sox,RSOX,3,4,4,8,1992,1995,3,No,0,-0.51,-2.13,-1.62,177,341,164,231,1333,1102,767.0,0.0,-767.0,1410000.0,0.0,-1410000.0
<a href=/player/bombm101>bombm101</a>,Mark Bomback,Milwaukee Brewers,BREWRS,1,1,1,2,1979,1983,4,No,0,1.87,-0.28,-2.15,72,53,-19,53,0,-53,488.0,252.0,-236.0,0.0,0.0,0.0
<a href=/player/bombm101>bombm101</a>,Mark Bomback,New York Mets,METS,2,4,3,7,1981,1984,3,No,0,-0.81,3.22,4.03,218,148,-70,297,135,-162,947.0,1246.0,299.0,0.0,0.0,0.0
<a href=/player/bondb101>bondb101</a>,Bobby Bonds,San Francisco Giants,GIANTS,16,31,33,64,1974,1998,24,No,2,56.53,76.94,20.41,3759,5633,1874,9443,9718,275,5201.0,15628.0,10427.0,10739278.0,0.0,-10739278.0
<a href=/player/bondb101>bondb101</a>,Bobby Bonds,New York Yankees,YANKS,21,49,40,89,1975,2001,26,No,2,82.22,90.69,8.47,5605,5539,-66,16272,17579,1307,12396.0,7138.0,-5258.0,3694706.0,0.0,-3694706.0
<a href=/player/bondb101>bondb101</a>,Bobby Bonds,California Angels,ANGELS,1,3,3,6,1977,1990,13,No,0,18.22,44.27,26.05,460,1735,1275,586,6912,6326,4818.0,1336.0,-3482.0,175000.0,0.0,-175000.0
<a href=/player/bondb101>bondb101</a>,Bobby Bonds,Chicago White Sox,WSOX,3,3,4,7,1978,1983,5,No,0,4.1,2.64,-1.46,209,355,146,861,1192,331,0.0,0.0,0.0,0.0,0.0,0.0
<a href=/player/bondb101>bondb101</a>,Bobby Bonds,Texas Rangers,RNGRS,4,7,8,15,1978,1982,4,No,0,19.36,1.68,-17.68,554,422,-132,1098,667,-431,4197.0,810.0,-3387.0,313000.0,0.0,-313000.0
<a href=/player/bondb101>bondb101</a>,Bobby Bonds,Cleveland Indians,INDINS,10,16,21,37,1979,2011,32,No,2,56.5,63.71,7.21,2052,2925,873,6792,9199,2407,5800.0,7490.0,1690.0,1767500.0,0.0,-1767500.0
<a href=/player/bondj001>bondj001</a>,Jeremy Bonderman,Oakland Athletics,ATLTCS,6,8,9,17,2002,2009,7,No,0,16.13,13.6,-2.53,956,906,-50,1909,3247,1338,5469.0,605.0,-4864.0,947000.0,0.0,-947000.0
<a href=/player/bondw101>bondw101</a>,Walt Bond,Houston Astros,ASTROS,5,6,7,13,1966,1978,12,No,0,3.03,1.17,-1.86,387,1322,935,908,4912,4004,159.0,122.0,-37.0,0.0,0.0,0.0
<a href=/player/boner001>boner001</a>,Ricky Bones,San Diego Padres,PADRS,3,6,6,12,1992,2008,16,No,0,33.52,31.92,-1.6,1981,2091,110,6462,948,-5514,2787.0,3132.0,345.0,3375000.0,0.0,-3375000.0
<a href=/player/boner001>boner001</a>,Ricky Bones,Milwaukee Brewers,BREWRS,12,24,27,51,1996,2012,16,No,2,48.89,48.53,-0.36,3405,3905,500,10041,7823,-2218,2917.0,8947.0,6030.0,18537000.0,0.0,-18537000.0
<a href=/player/bongj001>bongj001</a>,Jung Bong,Atlanta Braves,BRAVES,1,2,1,3,2004,2006,2,No,0,-0.35,-0.6,-0.25,5,368,363,4,1,-3,46.0,543.0,497.0,0.0,0.0,0.0
<a href=/player/bongn101>bongn101</a>,Nino Bongiovanni,Cincinnati Reds,REDS,3,5,3,8,1940,1940,0,No,0,13.89,1.36,-12.53,908,95,-813,3350,355,-2995,0.0,0.0,0.0,0.0,0.0,0.0
<a href=/player/bonhb101>bonhb101</a>,Bill Bonham,Chicago Cubs,CUBS,7,12,11,23,1977,1990,13,No,0,21.39,14.29,-7.1,2195,1033,-1162,4948,645,-4303,3120.0,4061.0,941.0,890000.0,0.0,-890000.0
<a href=/player/bonht101>bonht101</a>,Tiny Bonham,New York Yankees,YANKS,1,1,1,2,1946,1946,0,No,0,4.66,0.0,-4.66,146,0,-146,135,0,-135,1123.0,0.0,-1123.0,17000.0,0.0,-17000.0
<a href=/player/bonib001>bonib001</a>,Bobby Bonilla,Chicago White Sox,WSOX,5,6,9,15,1986,1995,9,No,0,27.7,25.49,-2.21,1329,1162,-167,3860,3946,86,3561.0,1711.0,-1850.0,1962500.0,0.0,-1962500.0
<a href=/player/bonib001>bonib001</a>,Bobby Bonilla,New York Mets,METS,3,4,4,8,1995,1998,3,No,0,1.06,2.23,1.17,526,299,-227,1782,890,-892,0.0,0.0,0.0,5452000.0,0.0,-5452000.0
<a href=/player/bonib001>bonib001</a>,Bobby Bonilla,Florida Marlins,MARLNS,15,33,38,71,1998,2019,21,Yes,0,116.45,94.42,-22.03,4698,5470,772,15425,16217,792,10496.0,10160.0,-336.0,68580667.0,0.0,-68580667.0
<a href=/player/bonib001>bonib001</a>,Bobby Bonilla,Los Angeles Dodgers,DOGRS,2,3,4,7,1998,1999,1,No,0,-1.38,-0.94,0.44,141,28,-113,150,4,-146,1195.0,62.0,-1133.0,6833334.0,0.0,-6833334.0
<a href=/player/bonie001>bonie001</a>,Emilio Bonifacio,Arizona Diamondbacks,DBACKS,2,2,2,4,2008,2012,4,No,0,2.04,-0.52,-2.56,122,181,59,178,7,-171,220.0,311.0,91.0,2525000.0,0.0,-2525000.0
<a href=/player/bonie001>bonie001</a>,Emilio Bonifacio,Washington Nationals,NATEX,3,5,5,10,2008,2013,5,Yes,0,5.63,4.16,-1.47,562,556,-6,2188,1050,-1138,12.0,770.0,758.0,5101000.0,0.0,-5101000.0
<a href=/player/bonie001>bonie001</a>,Emilio Bonifacio,Miami Marlins,MARLNS,12,33,32,65,2012,2020,8,Yes,0,57.99,24.95,-33.04,3997,2605,-1392,9990,7444,-2546,7539.0,4278.0,-3261.0,66200000.0,0.0,-66200000.0
<a href=/player/bonie001>bonie001</a>,Emilio Bonifacio,Chicago Cubs,CUBS,2,5,6,11,2014,2021,7,Yes,0,0.58,0.03,-0.55,319,313,-6,628,721,93,572.0,456.0,-116.0,26275000.0,0.0,-26275000.0
<a href=/player/bonij001>bonij001</a>,Juan Bonilla,Cleveland Indians,INDINS,1,1,1,2,1981,1981,0,No,0,2.85,-0.56,-3.41,296,14,-282,1221,0,-1221,0.0,64.0,64.0,0.0,0.0,0.0
<a href=/player/bonil001>bonil001</a>,Lisalverto Bonilla,Philadelphia Phillies,PHILS,3,6,4,10,2012,2014,2,No,0,0.71,-1.18,-1.89,80,130,50,137,512,375,193.0,7.0,-186.0,496000.0,0.0,-496000.0
<a href=/player/bonnb001>bonnb001</a>,Barry Bonnell,Philadelphia Phillies,PHILS,9,22,16,38,1975,1999,24,No,0,25.13,40.88,15.75,3277,4153,876,11430,11792,362,522.0,1259.0,737.0,2950000.0,0.0,-2950000.0
<a href=/player/bonnb001>bonnb001</a>,Barry Bonnell,Atlanta Braves,BRAVES,1,3,2,5,1979,1986,7,No,0,6.25,5.96,-0.29,653,1043,390,1647,3360,1713,1023.0,3.0,-1020.0,0.0,0.0,0.0
<a href=/player/bonnb001>bonnb001</a>,Barry Bonnell,Toronto Blue Jays,BJAYS,1,1,1,2,1983,1985,2,No,0,-1.19,-0.79,0.4,175,20,-155,565,0,-565,0.0,137.0,137.0,0.0,0.0,0.0
<a href=/player/bonnf101>bonnf101</a>,Frank Bonner,Baltimore Orioles,BLN,1,2,1,3,1895,1895,0,No,0,-4.82,1.63,6.45,136,40,-96,276,66,-210,924.0,426.0,-498.0,0.0,0.0,0.0
<a href=/player/bonsb001>bonsb001</a>,Boof Bonser,San Francisco Giants,GIANTS,1,3,2,5,2003,2004,1,No,0,27.51,0.25,-27.26,760,131,-629,32,510,478,4915.0,0.0,-4915.0,300000.0,0.0,-300000.0
<a href=/player/bonsb001>bonsb001</a>,Boof Bonser,Minnesota Twins,TWINS,1,1,1,2,2009,2009,0,No,0,-0.12,0.0,0.12,2,0,-2,0,0,0,6.0,0.0,-6.0,0.0,0.0,0.0
<a href=/player/bonuz101>bonuz101</a>,Zeke Bonura,Cleveland Indians,INDINS,2,6,4,10,1930,1939,9,No,0,6.18,20.8,14.62,372,942,570,1331,2752,1421,1093.0,2939.0,1846.0,2400.0,0.0,-2400.0
<a href=/player/bonuz101>bonuz101</a>,Zeke Bonura,Chicago White Sox,WSOX,1,1,1,2,1938,1943,5,No,0,1.97,10.99,9.02,216,832,616,941,3595,2654,0.0,0.0,0.0,0.0,0.0,0.0
<a href=/player/bonuz101>bonuz101</a>,Zeke Bonura,Washington Senators,TWINS,1,1,3,4,1938,1938,0,No,0,3.47,0.0,-3.47,123,0,-123,517,0,-517,0.0,0.0,0.0,0.0,0.0,0.0
<a href=/player/booee101>booee101</a>,Everett Booe,Pittsburgh Pirates,PIRATS,1,1,1,2,1913,1913,0,No,0,0.0,-0.54,-0.54,0,40,40,0,169,169,0.0,0.0,0.0,1200.0,0.0,-1200.0
<a href=/player/bookb101>bookb101</a>,Buddy Booker,New York Mets,METS,2,5,4,9,1967,1974,7,No,0,2.47,11.88,9.41,357,948,591,832,3426,2594,1066.0,0.0,-1066.0,89000.0,0.0,-89000.0
<a href=/player/bookc001>bookc001</a>,Chris Booker,Chicago Cubs,CUBS,2,3,2,5,2001,2002,1,No,0,-0.07,1.18,1.25,254,63,-191,981,235,-746,6.0,0.0,-6.0,0.0,0.0,0.0
<a href=/player/bookg001>bookg001</a>,Greg Booker,San Diego Padres,PADRS,2,3,3,6,1989,1990,1,No,0,-0.28,-0.81,-0.53,20,210,190,0,619,619,275.0,115.0,-160.0,775000.0,0.0,-775000.0
<a href=/player/boola101>boola101</a>,Al Bool,Boston Braves,BRAVES,1,2,1,3,1931,1933,2,No,0,0.0,-0.39,-0.39,0,82,82,0,328,328,0.0,0.0,0.0,0.0,0.0,0.0
<a href=/player/boola101>boola101</a>,Al Bool,Baltimore,Baltimore,1,1,1,2,1929,1929,0,No,0,0.16,0.0,-0.16,78,0,-78,245,0,-245,0.0,0.0,0.0,0.0,0.0,0.0
<a href=/player/boona001>boona001</a>,Aaron Boone,Cincinnati Reds,REDS,2,3,4,7,2003,2006,3,No,0,1.41,-0.53,-1.94,54,193,139,209,110,-99,0.0,1046.0,1046.0,3700000.0,0.0,-3700000.0
<a href=/player/boonb002>boonb002</a>,Bret Boone,Seattle Mariners,MARNRS,2,3,3,6,1993,2005,12,No,0,5.9,13.17,7.27,829,1554,725,2754,4500,1746,566.0,1101.0,535.0,1250000.0,0.0,-1250000.0
<a href=/player/boonb002>boonb002</a>,Bret Boone,Cincinnati Reds,REDS,8,13,16,29,1998,2013,15,No,0,32.31,35.48,3.17,2118,2354,236,5649,6223,574,1997.0,6510.0,4513.0,12325000.0,0.0,-12325000.0
<a href=/player/boonb002>boonb002</a>,Bret Boone,Atlanta Braves,BRAVES,1,3,3,6,1999,2001,2,No,0,15.79,3.54,-12.25,961,377,-584,3858,1296,-2562,4.0,0.0,-4.0,7650000.0,0.0,-7650000.0
<a href=/player/boond101>boond101</a>,Danny Boone,San Diego Padres,PADRS,2,3,2,5,1982,1984,2,No,0,-0.38,0.87,1.25,37,102,65,24,188,164,38.0,0.0,-38.0,0.0,0.0,0.0
<a href=/player/boond102>boond102</a>,Dan Boone,Cleveland Indians,INDINS,1,4,3,7,1924,1928,4,No,0,0.12,9.37,9.25,387,855,468,1555,3344,1789,0.0,0.0,0.0,0.0,0.0,0.0
<a href=/player/booni101>booni101</a>,Ike Boone,Chicago White Sox,WSOX,5,17,8,25,1927,1936,9,No,0,4.13,-0.01,-4.14,711,811,100,2521,3083,562,0.0,39.0,39.0,40200.0,0.0,-40200.0
<a href=/player/booni101>booni101</a>,Ike Boone,New York Giants,GIANTS,1,1,1,2,1922,1923,1,No,0,0.0,0.0,0.0,0,0,0,0,0,0,0.0,0.0,0.0,2700.0,0.0,-2700.0
<a href=/player/booni101>booni101</a>,Ike Boone,SanAntonio,SanAntonio,1,5,1,6,1923,1923,0,No,0,9.54,0.0,-9.54,1176,0,-1176,4721,0,-4721,0.0,0.0,0.0,0.0,0.0,0.0
<a href=/player/boonr101>boonr101</a>,Ray Boone,Cleveland Indians,INDINS,4,8,7,15,1953,1960,7,No,0,29.6,3.08,-26.52,1527,466,-1061,3515,525,-2990,4632.0,1595.0,-3037.0,15900.0,0.0,-15900.0
<a href=/player/boonr101>boonr101</a>,Ray Boone,Detroit Tigers,TIGRS,2,3,3,6,1958,1959,1,No,0,16.44,-3.06,-19.5,1173,107,-1066,3797,151,-3646,1676.0,92.0,-1584.0,32000.0,0.0,-32000.0
<a href=/player/boonr101>boonr101</a>,Ray Boone,Chicago White Sox,WSOX,2,3,2,5,1959,1960,1,No,0,0.78,0.48,-0.3,70,150,80,176,397,221,0.0,0.0,0.0,34500.0,0.0,-34500.0
<a href=/player/boonr101>boonr101</a>,Ray Boone,Milwaukee Braves,BRAVES,1,1,1,2,1960,1960,0,No,0,-0.49,0.0,0.49,34,0,-34,89,0,-89,0.0,0.0,0.0,22000.0,0.0,-22000.0
<a href=/player/borbp001>borbp001</a>,Pedro Borbon,Los Angeles Dodgers,DOGRS,6,14,16,30,1999,2008,9,No,0,11.13,39.67,28.54,2076,1867,-209,6047,4980,-1067,1264.0,3315.0,2051.0,19163667.0,0.0,-19163667.0
<a href=/player/borbp101>borbp101</a>,Pedro Borbon,California Angels,ANGELS,3,6,7,13,1969,1974,5,No,0,8.36,4.59,-3.77,1680,510,-1170,1673,1948,275,4531.0,88.0,-4443.0,15000.0,0.0,-15000.0
<a href=/player/borbp101>borbp101</a>,Pedro Borbon,Cincinnati Reds,REDS,3,3,3,6,1979,1983,4,No,0,-0.67,-1.7,-1.03,148,301,153,178,550,372,138.0,269.0,131.0,0.0,0.0,0.0
<a href=/player/borcj001>borcj001</a>,Joe Borchard,Chicago White Sox,WSOX,5,8,7,15,2006,2020,14,Yes,0,3.49,26.89,23.4,365,985,620,1322,1934,612,399.0,1492.0,1093.0,3255000.0,0.0,-3255000.0
<a href=/player/bordf101>bordf101</a>,Frenchy Bordagaray,Sacramento,Sacramento,1,1,3,4,1934,1947,13,No,0,3.24,0.0,-3.24,625,0,-625,2073,0,-2073,0.0,0.0,0.0,0.0,0.0,0.0
<a href=/player/bordf101>bordf101</a>,Frenchy Bordagaray,Brooklyn Dodgers,DOGRS,1,3,1,4,1936,1938,2,No,0,0.05,-0.59,-0.64,177,153,-24,491,535,44,0.0,3.0,3.0,0.0,0.0,0.0
<a href=/player/bordf101>bordf101</a>,Frenchy Bordagaray,St. Louis Cardinals,CARDS,1,1,1,2,1938,1938,0,No,0,-1.01,0.0,1.01,63,0,-63,136,0,-136,0.0,0.0,0.0,0.0,0.0,0.0
<a href=/player/bordf101>bordf101</a>,Frenchy Bordagaray,Cincinnati Reds,REDS,3,5,3,8,1940,1940,0,No,0,13.89,1.36,-12.53,908,95,-813,3350,355,-2995,0.0,0.0,0.0,0.0,0.0,0.0
<a href=/player/bordm001>bordm001</a>,Mike Bordick,Baltimore Orioles,ORLS,1,1,4,5,2000,2009,9,No,0,0.16,28.33,28.17,56,1330,1274,211,5573,5362,0.0,33.0,33.0,3000000.0,0.0,-3000000.0
<a href=/player/bordp001>bordp001</a>,Pat Borders,Kansas City Royals,ROYALS,1,1,1,2,1995,1995,0,No,0,-0.5,-0.09,0.41,11,7,-4,37,0,-37,0.0,29.0,29.0,310000.0,0.0,-310000.0
<a href=/player/bordp001>bordp001</a>,Pat Borders,St. Louis Cardinals,CARDS,1,1,1,2,1996,1996,0,No,0,-0.18,0.0,0.18,19,0,-19,61,0,-61,0.0,0.0,0.0,375000.0,0.0,-375000.0
<a href=/player/bordp001>bordp001</a>,Pat Borders,California Angels,ANGELS,1,1,1,2,1996,1997,1,No,0,-0.03,0.23,0.26,31,3,-28,102,0,-102,0.0,15.0,15.0,0.0,0.0,0.0
<a href=/player/bordp001>bordp001</a>,Pat Borders,Seattle Mariners,MARNRS,1,1,1,2,2004,2004,0,No,0,0.24,0.0,-0.24,19,0,-19,44,0,-44,0.0,0.0,0.0,0.0,0.0,0.0
<a href=/player/bordr001>bordr001</a>,Rich Bordi,Oakland Athletics,ATLTCS,1,1,1,2,1981,1985,4,No,0,-0.37,-2.36,-1.99,7,223,216,0,635,635,39.0,0.0,-39.0,0.0,0.0,0.0
<a href=/player/bordr001>bordr001</a>,Rich Bordi,Seattle Mariners,MARNRS,2,2,2,4,1982,1985,3,No,1,0.78,1.61,0.83,84,230,146,24,848,824,326.0,0.0,-326.0,0.0,0.0,0.0
<a href=/player/bordr001>bordr001</a>,Rich Bordi,Chicago Cubs,CUBS,2,7,4,11,1984,1987,3,No,0,2.88,0.38,-2.5,447,379,-68,818,354,-464,766.0,789.0,23.0,873333.0,0.0,-873333.0
<a href=/player/bordr001>bordr001</a>,Rich Bordi,New York Yankees,YANKS,1,2,2,4,1985,1986,1,No,0,0.34,-0.33,-0.67,66,76,10,1,188,187,321.0,0.0,-321.0,0.0,0.0,0.0
<a href=/player/borip101>borip101</a>,Paul Boris,New York Yankees,YANKS,12,22,19,41,1982,2001,19,No,1,71.79,28.19,-43.6,3910,1960,-1950,9749,5314,-4435,10685.0,4016.0,-6669.0,4250000.0,0.0,-4250000.0
<a href=/player/borkb101>borkb101</a>,Bob Borkowski,Chicago Cubs,CUBS,1,2,2,4,1951,1955,4,No,0,6.65,0.0,-6.65,713,1,-712,2114,1,-2113,0.0,0.0,0.0,12500.0,0.0,-12500.0
<a href=/player/borkb101>borkb101</a>,Bob Borkowski,Cincinnati Reds,REDS,1,2,1,3,1955,1957,2,No,0,-0.33,0.74,1.07,9,130,121,20,44,24,0.0,492.0,492.0,0.0,0.0,0.0
<a href=/player/borlt001>borlt001</a>,Toby Borland,Philadelphia Phillies,PHILS,1,2,1,3,1996,2000,4,No,0,-0.52,-2.87,-2.35,69,496,427,2,2022,2020,121.0,0.0,-121.0,284000.0,0.0,-284000.0
<a href=/player/borlt001>borlt001</a>,Toby Borland,New York Mets,METS,1,1,1,2,1997,1997,0,No,0,-0.16,-0.32,-0.16,3,18,15,0,0,0,10.0,27.0,17.0,262500.0,0.0,-262500.0
<a href=/player/borlt101>borlt101</a>,Tom Borland,Boston Red Sox,RSOX,1,1,1,2,1962,1962,0,No,0,0.0,-0.33,-0.33,0,38,38,0,48,48,0.0,0.0,0.0,0.0,0.0,0.0
<a href=/player/boroh101>boroh101</a>,Hank Borowy,Chicago Cubs,CUBS,2,3,3,6,1948,1953,5,No,0,8.13,13.76,5.63,675,587,-88,2640,227,-2413,597.0,2431.0,1834.0,16000.0,0.0,-16000.0
<a href=/player/boroj001>boroj001</a>,Joe Borowski,Chicago White Sox,WSOX,1,1,1,2,1991,1991,0,No,0,0.34,0.0,-0.34,6,0,-6,0,0,0,22.0,0.0,-22.0,0.0,0.0,0.0
<a href=/player/boroj001>boroj001</a>,Joe Borowski,Baltimore Orioles,ORLS,2,3,2,5,1995,1996,1,No,0,0.29,-0.9,-1.19,94,78,-16,3,263,260,185.0,174.0,-11.0,2934000.0,0.0,-2934000.0
<a href=/player/boros101>boros101</a>,Steve Boros,Detroit Tigers,TIGRS,5,7,7,14,1962,1972,10,No,0,7.58,6.28,-1.3,677,1281,604,831,2724,1893,1071.0,2995.0,1924.0,103000.0,0.0,-103000.0
<a href=/player/bortb101>bortb101</a>,Babe Borton,Chicago White Sox,WSOX,1,2,1,3,1913,1914,1,No,0,-0.81,2.78,3.59,83,160,77,319,648,329,0.0,0.0,0.0,0.0,0.0,0.0
<a href=/player/bortb101>bortb101</a>,Babe Borton,New York Yankees,YANKS,1,2,1,3,1913,1913,0,No,0,0.0,0.28,0.28,0,70,70,0,282,282,0.0,0.0,0.0,0.0,0.0,0.0
<a href=/player/boscd101>boscd101</a>,Don Bosch,Pittsburgh Pirates,PIRATS,2,3,3,6,1966,1968,2,No,0,2.29,1.17,-1.12,328,107,-221,391,68,-323,1500.0,578.0,-922.0,46000.0,0.0,-46000.0
<a href=/player/boscd101>boscd101</a>,Don Bosch,Montreal Expos,NATEX,5,7,8,15,1970,1986,16,No,1,19.15,22.77,3.62,1432,1987,555,2872,3208,336,1885.0,5701.0,3816.0,110000.0,0.0,-110000.0
<a href=/player/boscw001>boscw001</a>,Wilfredo Boscan,Texas Rangers,RNGRS,1,1,1,2,2012,2014,2,No,0,0.0,0.18,0.18,0,10,10,0,0,0,0.0,34.0,34.0,0.0,0.0,0.0
<a href=/player/boser101>boser101</a>,Rick Bosetti,Philadelphia Phillies,PHILS,3,5,4,9,1977,1983,6,No,0,1.29,13.57,12.28,795,776,-19,1705,2597,892,551.0,251.0,-300.0,300000.0,0.0,-300000.0
<a href=/player/boser101>boser101</a>,Rick Bosetti,St. Louis Cardinals,CARDS,1,1,2,3,1978,1980,2,No,0,1.94,1.48,-0.46,376,90,-286,1522,20,-1502,0.0,264.0,264.0,0.0,0.0,0.0
<a href=/player/bosks001>bosks001</a>,Shawn Boskie,Chicago Cubs,CUBS,1,1,1,2,1994,1998,4,No,0,-0.16,3.26,3.42,37,185,148,30,193,163,253.0,1456.0,1203.0,300000.0,0.0,-300000.0
<a href=/player/bosks001>bosks001</a>,Shawn Boskie,Philadelphia Phillies,PHILS,1,1,1,2,1994,1994,0,No,0,-0.08,0.0,0.08,2,0,-2,0,0,0,8.0,0.0,-8.0,0.0,0.0,0.0
<a href=/player/boslt001>boslt001</a>,Thad Bosley,California Angels,ANGELS,1,3,3,6,1977,1990,13,No,0,18.22,44.27,26.05,460,1735,1275,586,6912,6326,4818.0,1336.0,-3482.0,175000.0,0.0,-175000.0
<a href=/player/boslt001>boslt001</a>,Thad Bosley,Chicago White Sox,WSOX,1,1,1,2,1981,1981,0,No,0,-0.41,0.0,0.41,42,0,-42,112,0,-112,0.0,0.0,0.0,0.0,0.0,0.0
<a href=/player/boslt001>boslt001</a>,Thad Bosley,Milwaukee Brewers,BREWRS,1,1,1,2,1982,1982,0,No,0,-0.91,0.0,0.91,22,0,-22,50,0,-50,0.0,0.0,0.0,0.0,0.0,0.0
<a href=/player/boslt001>boslt001</a>,Thad Bosley,Chicago Cubs,CUBS,1,2,1,3,1987,1988,1,No,0,-0.74,0.52,1.26,103,85,-18,176,227,51,58.0,0.0,-58.0,0.0,0.0,0.0
<a href=/player/bosmd101>bosmd101</a>,Dick Bosman,Texas Rangers,RNGRS,3,5,3,8,1973,1977,4,No,0,-2.28,-0.02,2.26,64,49,-15,44,0,-44,759.0,568.0,-191.0,0.0,0.0,0.0
<a href=/player/bosmd101>bosmd101</a>,Dick Bosman,Cleveland Indians,INDINS,3,5,4,9,1975,1976,1,No,0,-1.95,0.82,2.77,177,25,-152,203,0,-203,1075.0,430.0,-645.0,68000.0,0.0,-68000.0
<a href=/player/bossh101>bossh101</a>,Harley Boss,Washington Senators,TWINS,2,2,3,5,1932,1937,5,No,0,-0.12,4.34,4.46,158,394,236,477,215,-262,120.0,1888.0,1768.0,7000.0,0.0,-7000.0
<a href=/player/bosta001>bosta001</a>,Akeem Bostick,Texas Rangers,RNGRS,1,1,1,2,2015,2015,0,No,0,0.0,-0.51,-0.51,0,33,33,0,121,121,0.0,0.0,0.0,0.0,0.0,0.0
<a href=/player/bostc001>bostc001</a>,Chris Bostick,Oakland Athletics,ATLTCS,1,2,2,4,2013,2015,2,No,0,-2.08,1.42,3.5,87,121,34,281,314,33,0.0,14.0,14.0,0.0,0.0,0.0
<a href=/player/bostc001>bostc001</a>,Chris Bostick,Texas Rangers,RNGRS,1,2,1,3,2014,2015,1,No,0,0.0,-1.13,-1.13,4,18,14,0,0,0,5.0,129.0,124.0,0.0,0.0,0.0
<a href=/player/bostc001>bostc001</a>,Chris Bostick,Washington Nationals,NATEX,1,1,1,2,2016,2020,4,No,0,0.02,0.0,-0.02,22,0,-22,34,0,-34,0.0,0.0,0.0,0.0,0.0,0.0
<a href=/player/boswk101>boswk101</a>,Ken Boswell,New York Mets,METS,3,4,3,7,1974,1976,2,No,0,-0.02,-0.55,-0.53,249,97,-152,457,90,-367,0.0,0.0,0.0,0.0,0.0,0.0
<a href=/player/boted001>boted001</a>,Derek Botelho,Philadelphia Phillies,PHILS,7,17,13,30,1979,1999,20,No,0,25.6,38.01,12.41,2807,3562,755,9986,9588,-398,522.0,1259.0,737.0,2950000.0,0.0,-2950000.0
<a href=/player/boted001>boted001</a>,Derek Botelho,Kansas City Royals,ROYALS,1,2,1,3,1984,1986,2,No,0,-0.02,-0.09,-0.07,22,5,-17,15,0,-15,132.0,39.0,-93.0,0.0,0.0,0.0
<a href=/player/boted001>boted001</a>,Derek Botelho,Cincinnati Reds,REDS,1,1,2,3,1987,1987,0,No,0,0.0,0.0,0.0,0,0,0,0,0,0,0.0,0.0,0.0,0.0,0.0,0.0
<a href=/player/bottj101>bottj101</a>,Jim Bottomley,St. Louis Cardinals,CARDS,2,3,4,7,1932,1942,10,No,0,1.14,2.64,1.5,593,243,-350,1978,361,-1617,902.0,474.0,-428.0,0.0,0.0,0.0
<a href=/player/bottj101>bottj101</a>,Jim Bottomley,Cincinnati Reds,REDS,1,1,1,2,1936,1936,0,No,0,-0.16,0.0,0.16,205,0,-205,722,0,-722,0.0,0.0,0.0,0.0,0.0,0.0
<a href=/player/bottk001>bottk001</a>,Kent Bottenfield,Montreal Expos,NATEX,1,1,1,2,1993,1995,2,No,0,0.25,6.83,6.58,58,110,52,30,89,59,304.0,757.0,453.0,113500.0,0.0,-113500.0
<a href=/player/bottk001>bottk001</a>,Kent Bottenfield,St. Louis Cardinals,CARDS,4,6,6,12,2000,2019,19,No,0,27.34,51.35,24.01,1988,2348,360,6641,8016,1375,960.0,194.0,-766.0,13224540.0,0.0,-13224540.0
<a href=/player/bottk001>bottk001</a>,Kent Bottenfield,Anaheim Angels,ANGELS,1,1,1,2,2000,2000,0,No,0,0.56,0.73,0.17,16,34,18,17,103,86,132.0,0.0,-132.0,4000000.0,0.0,-4000000.0
<a href=/player/bottr001>bottr001</a>,Ricky Bottalico,Philadelphia Phillies,PHILS,3,4,5,9,1998,2002,4,No,0,4.86,4.39,-0.47,468,569,101,282,1029,747,2055.0,750.0,-1305.0,7696667.0,0.0,-7696667.0
<a href=/player/botzb101>botzb101</a>,Bob Botz,Milwaukee Braves,BRAVES,1,1,1,2,1962,1962,0,No,0,0.37,0.0,-0.37,70,0,-70,10,0,-10,189.0,0.0,-189.0,0.0,0.0,0.0
<a href=/player/botzb101>botzb101</a>,Bob Botz,Los Angeles Angels,ANGELS,2,2,2,4,1963,1965,2,No,0,0.53,-0.04,-0.57,78,128,50,8,7,-1,193.0,241.0,48.0,0.0,0.0,0.0
<a href=/player/boucd001>boucd001</a>,Denis Boucher,Toronto Blue Jays,BJAYS,8,18,13,31,1991,2013,22,No,3,16.79,37.75,20.96,2901,2301,-600,8386,7682,-704,1653.0,2653.0,1000.0,7815000.0,0.0,-7815000.0
<a href=/player/boucd001>boucd001</a>,Denis Boucher,Colorado Rockies,ROCKS,1,1,1,2,1993,1993,0,No,0,0.0,-0.42,-0.42,0,23,23,0,45,45,0.0,0.0,0.0,0.0,0.0,0.0
<a href=/player/boucd001>boucd001</a>,Denis Boucher,San Diego Padres,PADRS,1,1,2,3,1993,1993,0,No,0,0.67,0.0,-0.67,30,0,-30,12,0,-12,141.0,0.0,-141.0,0.0,0.0,0.0
<a href=/player/bouce101>bouce101</a>,Ed Bouchee,Philadelphia Phillies,PHILS,2,3,4,7,1960,1971,11,No,0,11.26,16.56,5.3,652,1580,928,1728,6417,4689,1893.0,0.0,-1893.0,60000.0,0.0,-60000.0
<a href=/player/boulc101>boulc101</a>,Carl Bouldin,Washington Senators,RNGRS,2,3,3,6,1964,1975,11,No,0,4.84,-0.04,-4.88,347,541,194,1279,559,-720,0.0,1708.0,1708.0,55000.0,0.0,-55000.0
<a href=/player/bourc101>bourc101</a>,Chris Bourjos,San Francisco Giants,GIANTS,3,5,4,9,1980,1984,4,No,0,13.32,-1.81,-15.13,864,212,-652,1590,613,-977,5214.0,0.0,-5214.0,0.0,0.0,0.0
<a href=/player/bourc101>bourc101</a>,Chris Bourjos,Houston Astros,ASTROS,1,2,1,3,1981,1982,1,No,0,0.0,0.83,0.83,0,82,82,0,230,230,0.0,0.0,0.0,0.0,0.0,0.0
<a href=/player/bourj001>bourj001</a>,Jason Bourgeois,Houston Astros,ASTROS,1,2,2,4,2012,2017,5,No,0,-0.3,0.42,0.72,73,60,-13,210,0,-210,0.0,165.0,165.0,0.0,0.0,0.0
<a href=/player/bourj002>bourj002</a>,Justin Bour,Miami Marlins,MARLNS,1,2,1,3,2018,2018,0,Yes,0,-0.18,0.0,0.18,29,0,-29,54,0,-54,0.0,0.0,0.0,3400000.0,0.0,-3400000.0
<a href=/player/bourm001>bourm001</a>,Michael Bourn,Philadelphia Phillies,PHILS,1,3,2,5,2007,2011,4,No,0,12.75,0.63,-12.12,681,613,-68,2271,356,-1915,252.0,579.0,327.0,1217500.0,0.0,-1217500.0
<a href=/player/bourm001>bourm001</a>,Michael Bourn,Houston Astros,ASTROS,3,10,7,17,2011,2020,9,No,0,14.39,5.69,-8.7,651,525,-126,1291,481,-810,2153.0,1828.0,-325.0,9515800.0,0.0,-9515800.0
<a href=/player/bourm001>bourm001</a>,Michael Bourn,Cleveland Indians,INDINS,1,3,1,4,2015,2015,0,No,0,-0.91,-0.23,0.68,92,27,-65,305,93,-212,0.0,0.0,0.0,0.0,0.0,0.0
<a href=/player/bourm001>bourm001</a>,Michael Bourn,Arizona Diamondbacks,DBACKS,1,1,1,2,2016,2016,0,Yes,0,0.13,0.0,-0.13,24,0,-24,55,0,-55,0.0,0.0,0.0,0.0,0.0,0.0
<a href=/player/bourp001>bourp001</a>,Peter Bourjos,Anaheim Angels,ANGELS,2,3,3,6,2013,2016,3,Yes,0,6.81,4.69,-2.12,768,456,-312,1907,981,-926,187.0,536.0,349.0,0.0,0.0,0.0
<a href=/player/bourp101>bourp101</a>,Pat Bourque,Chicago Cubs,CUBS,1,1,1,2,1973,1973,0,No,0,0.32,-0.37,-0.69,96,19,-77,172,65,-107,0.0,0.0,0.0,0.0,0.0,0.0
<a href=/player/bourp101>bourp101</a>,Pat Bourque,Oakland Athletics,ATLTCS,1,1,1,2,1974,1974,0,No,0,0.09,-0.41,-0.5,23,30,7,71,45,-26,0.0,0.0,0.0,17500.0,0.0,-17500.0
<a href=/player/bourp101>bourp101</a>,Pat Bourque,Minnesota Twins,TWINS,3,3,5,8,1974,1982,8,No,0,4.67,8.03,3.36,408,1108,700,1503,4024,2521,0.0,0.0,0.0,260000.0,0.0,-260000.0
<a href=/player/bourr001>bourr001</a>,Rafael Bournigal,Los Angeles Dodgers,DOGRS,2,3,2,5,1995,2002,7,No,0,1.42,-0.47,-1.89,279,38,-241,871,0,-871,30.0,70.0,40.0,0.0,0.0,0.0
<a href=/player/boutj101>boutj101</a>,Jim Bouton,Seattle Pilots,BREWRS,2,3,3,6,1969,1972,3,No,0,1.65,-1.38,-3.03,168,83,-85,43,19,-24,594.0,246.0,-348.0,22000.0,0.0,-22000.0
<a href=/player/bovem001>bovem001</a>,Mike Bovee,Kansas City Royals,ROYALS,1,2,1,3,1996,1997,1,No,0,-0.59,2.4,2.99,5,140,135,0,567,567,24.0,0.0,-24.0,1600000.0,0.0,-1600000.0
<a href=/player/bowal001>bowal001</a>,Larry Bowa,Philadelphia Phillies,PHILS,2,4,2,6,1982,1986,4,No,0,69.17,2.77,-66.4,2804,581,-2223,11092,1670,-9422,193.0,313.0,120.0,0.0,0.0,0.0
<a href=/player/bowdm001>bowdm001</a>,Michael Bowden,Boston Red Sox,RSOX,1,2,2,4,2012,2012,0,No,0,0.77,-0.16,-0.93,128,34,-94,2,106,104,223.0,0.0,-223.0,484000.0,0.0,-484000.0
<a href=/player/bowef102>bowef102</a>,Frank Bowerman,New York Giants,GIANTS,4,11,6,17,1907,1921,14,No,0,45.64,34.38,-11.26,2445,1600,-845,8369,5323,-3046,1733.0,2915.0,1182.0,6400.0,0.0,-6400.0
<a href=/player/bower002>bower002</a>,Rob Bowen,San Diego Padres,PADRS,1,2,2,4,2007,2008,1,No,0,-0.62,-1.21,-0.59,10,74,64,36,243,207,0.0,0.0,0.0,382300.0,0.0,-382300.0
<a href=/player/bower002>bower002</a>,Rob Bowen,Chicago Cubs,CUBS,2,3,3,6,2007,2011,4,No,1,3.55,-0.3,-3.85,355,57,-298,153,202,49,801.0,0.0,-801.0,0.0,0.0,0.0
<a href=/player/bowim001>bowim001</a>,Micah Bowie,Atlanta Braves,BRAVES,3,6,5,11,1999,2009,10,No,2,-4.19,8.84,13.03,73,1044,971,54,2148,2094,486.0,1194.0,708.0,0.0,0.0,0.0
<a href=/player/bowkj001>bowkj001</a>,John Bowker,San Francisco Giants,GIANTS,1,2,1,3,2010,2016,6,No,0,0.17,5.3,5.13,55,867,812,96,4,-92,26.0,753.0,727.0,410000.0,0.0,-410000.0
<a href=/player/bowmb103>bowmb103</a>,Bob Bowman,New York Giants,GIANTS,1,1,1,2,1941,1941,0,No,0,0.07,0.0,-0.07,2,0,-2,0,0,0,3.0,0.0,-3.0,0.0,0.0,0.0
<a href=/player/bowme101>bowme101</a>,Ernie Bowman,San Francisco Giants,GIANTS,8,14,12,26,1964,1972,8,No,0,20.6,12.56,-8.04,1709,1303,-406,5210,1731,-3479,1169.0,4789.0,3620.0,50000.0,0.0,-50000.0
<a href=/player/bowme101>bowme101</a>,Ernie Bowman,Milwaukee Braves,BRAVES,4,5,8,13,1965,1971,6,No,0,0.93,-0.4,-1.33,225,245,20,724,738,14,0.0,0.0,0.0,0.0,0.0,0.0
<a href=/player/bowme101>bowme101</a>,Ernie Bowman,New York Mets,METS,1,2,1,3,1966,1968,2,No,0,-0.53,0.0,0.53,142,0,-142,357,0,-357,0.0,0.0,0.0,0.0,0.0,0.0
<a href=/player/bowmj101>bowmj101</a>,Joe Bowman,Portland,Portland,1,1,2,3,1933,1943,10,No,0,0.61,0.0,-0.61,61,0,-61,32,0,-32,322.0,0.0,-322.0,0.0,0.0,0.0
<a href=/player/bowmj101>bowmj101</a>,Joe Bowman,New York Giants,GIANTS,1,1,1,2,1934,1937,3,No,0,3.13,-0.11,-3.24,166,150,-16,157,267,110,1053.0,0.0,-1053.0,0.0,0.0,0.0
<a href=/player/bowmj101>bowmj101</a>,Joe Bowman,Philadelphia Phillies,PHILS,1,1,1,2,1937,1938,1,No,0,3.74,0.24,-3.5,336,126,-210,322,440,118,1889.0,0.0,-1889.0,0.0,0.0,0.0
<a href=/player/bowmj101>bowmj101</a>,Joe Bowman,Pittsburgh Pirates,PIRATS,1,1,1,2,1941,1942,1,No,0,0.0,0.0,0.0,0,0,0,0,0,0,0.0,0.0,0.0,0.0,0.0,0.0
<a href=/player/bowmj101>bowmj101</a>,Joe Bowman,Portland,Portland,1,2,2,4,1931,1931,0,No,0,1.71,0.0,-1.71,253,0,-253,858,0,-858,33.0,0.0,-33.0,0.0,0.0,0.0
<a href=/player/bowmj101>bowmj101</a>,Joe Bowman,Philadelphia Athletics,ATLTCS,1,2,1,3,1932,1936,4,No,0,0.0,1.11,1.11,0,224,224,0,182,182,0.0,1445.0,1445.0,2500.0,0.0,-2500.0
<a href=/player/bowmj101>bowmj101</a>,Joe Bowman,St.Paul,St.Paul,1,1,1,2,1943,1943,0,No,0,-1.41,0.0,1.41,97,0,-97,115,0,-115,540.0,0.0,-540.0,0.0,0.0,0.0
<a href=/player/bowst101>bowst101</a>,Ted Bowsfield,Boston Red Sox,RSOX,4,8,6,14,1960,1966,6,No,0,-2.7,-1.76,0.94,273,963,690,690,2516,1826,122.0,336.0,214.0,18500.0,0.0,-18500.0
<a href=/player/bowst101>bowst101</a>,Ted Bowsfield,Los Angeles Angels,ANGELS,3,4,5,9,1962,1965,3,No,0,2.33,1.29,-1.04,351,291,-60,119,108,-11,940.0,979.0,39.0,12500.0,0.0,-12500.0
<a href=/player/bowyt001>bowyt001</a>,Travis Bowyer,Minnesota Twins,TWINS,5,6,6,12,2005,2019,14,No,0,3.77,5.35,1.58,558,693,135,2185,2384,199,5.0,417.0,412.0,5750000.0,0.0,-5750000.0
<a href=/player/boxbb001>boxbb001</a>,Brad Boxberger,Cincinnati Reds,REDS,2,5,3,8,2011,2020,9,No,0,8.75,14.41,5.66,882,376,-506,2596,411,-2185,1389.0,3437.0,2048.0,9475000.0,0.0,-9475000.0
<a href=/player/boxbb001>boxbb001</a>,Brad Boxberger,San Diego Padres,PADRS,5,10,9,19,2014,2019,5,Yes,0,13.64,2.43,-11.21,896,526,-370,1526,1044,-482,2446.0,524.0,-1922.0,2925000.0,0.0,-2925000.0
<a href=/player/boxbb001>boxbb001</a>,Brad Boxberger,Tampa Bay Devil Rays,RAYS,2,3,2,5,2017,2019,2,No,0,-0.93,0.71,1.64,118,37,-81,0,119,119,160.0,0.0,-160.0,1600000.0,0.0,-1600000.0
<a href=/player/boydb102>boydb102</a>,Bob Boyd,Baltimore Orioles,ORLS,4,11,7,18,1961,1973,12,No,0,20.55,30.35,9.8,1602,1797,195,5528,6131,603,845.0,306.0,-539.0,72000.0,0.0,-72000.0
<a href=/player/boydj001>boydj001</a>,Jason Boyd,Arizona Diamondbacks,DBACKS,2,3,2,5,1999,2003,4,No,0,-0.64,1.43,2.07,53,629,576,82,2744,2662,55.0,0.0,-55.0,6000000.0,0.0,-6000000.0
<a href=/player/boydm001>boydm001</a>,Matt Boyd,Toronto Blue Jays,BJAYS,1,3,1,4,2015,2015,0,No,0,13.77,2.5,-11.27,310,12,-298,26,4,-22,3733.0,223.0,-3510.0,508700.0,0.0,-508700.0
<a href=/player/boydo001>boydo001</a>,Oil Can Boyd,Montreal Expos,NATEX,5,6,8,14,1991,2000,9,No,0,1.61,1.53,-0.08,564,553,-11,1710,1303,-407,548.0,901.0,353.0,4125000.0,0.0,-4125000.0
<a href=/player/boyeb001>boyeb001</a>,Blaine Boyer,Atlanta Braves,BRAVES,1,1,1,2,2009,2009,0,No,0,-0.16,0.0,0.16,30,1,-29,1,0,-1,49.0,0.0,-49.0,432500.0,0.0,-432500.0
<a href=/player/boyec102>boyec102</a>,Clete Boyer,Kansas City Athletics,ATLTCS,38,80,81,161,1957,1976,19,No,0,137.3,59.64,-77.66,12943,8836,-4107,29783,24655,-5128,18720.0,9434.0,-9286.0,506100.0,0.0,-506100.0
<a href=/player/boyec102>boyec102</a>,Clete Boyer,New York Yankees,YANKS,2,2,3,5,1966,1970,4,No,0,8.56,-2.04,-10.6,533,310,-223,2105,998,-1107,0.0,0.0,0.0,31500.0,0.0,-31500.0
<a href=/player/boyek101>boyek101</a>,Ken Boyer,St. Louis Cardinals,CARDS,6,8,10,18,1965,1972,7,No,0,3.16,6.17,3.01,837,438,-399,1340,759,-581,1318.0,1226.0,-92.0,102500.0,0.0,-102500.0
<a href=/player/boyek101>boyek101</a>,Ken Boyer,New York Mets,METS,2,3,3,6,1967,1970,3,No,0,-1.49,0.67,2.16,346,144,-202,991,467,-524,0.0,0.0,0.0,55000.0,0.0,-55000.0
<a href=/player/boylb101>boylb101</a>,Buzz Boyle,Baltimore,Baltimore,1,1,2,3,1933,1933,0,No,0,5.7,0.0,-5.7,348,0,-348,1406,0,-1406,0.0,0.0,0.0,0.0,0.0,0.0
<a href=/player/boylb101>boylb101</a>,Buzz Boyle,Brooklyn Dodgers,DOGRS,2,5,3,8,1936,1940,4,No,0,2.67,4.3,1.63,454,607,153,1715,2060,345,0.0,317.0,317.0,0.0,0.0,0.0
<a href=/player/boyld101>boyld101</a>,Doe Boyland,Pittsburgh Pirates,PIRATS,1,1,1,2,1981,1982,1,No,0,0.0,-0.96,-0.96,0,12,12,0,9,9,0.0,67.0,67.0,0.0,0.0,0.0
<a href=/player/boyle101>boyle101</a>,Eddie Boyle,Louisville Colonels,LS3,1,2,1,3,1896,1899,3,No,0,-0.17,5.69,5.86,17,500,483,58,1976,1918,0.0,0.0,0.0,0.0,0.0,0.0
<a href=/player/boylj102>boylj102</a>,Jack Boyle,Cincinnati Reds,REDS,1,2,1,3,1886,1890,4,No,0,1.15,1.51,0.36,379,432,53,1510,1926,416,0.0,0.0,0.0,0.0,0.0,0.0
<a href=/player/boylj102>boylj102</a>,Jack Boyle,New York Giants,GIANTS,1,3,1,4,1893,1894,1,No,0,-1.18,4.81,5.99,549,157,-392,2414,700,-1714,168.0,0.0,-168.0,0.0,0.0,0.0
<a href=/player/brabg101>brabg101</a>,Gene Brabender,Baltimore Orioles,ORLS,1,2,1,3,1969,1972,3,No,0,-0.94,-0.21,0.73,159,174,15,161,395,234,993.0,0.0,-993.0,0.0,0.0,0.0
<a href=/player/brabg101>brabg101</a>,Gene Brabender,Milwaukee Brewers,BREWRS,3,4,4,8,1971,1972,1,No,0,0.08,-0.4,-0.48,40,188,148,109,485,376,0.0,0.0,0.0,37000.0,0.0,-37000.0
<a href=/player/bracb001>bracb001</a>,Brad Brach,San Diego Padres,PADRS,1,1,1,2,2013,2013,0,Yes,0,5.96,0.0,-5.96,314,0,-314,2,0,-2,983.0,0.0,-983.0,498200.0,0.0,-498200.0
<a href=/player/bracb001>bracb001</a>,Brad Brach,Baltimore Orioles,ORLS,1,1,1,2,2018,2018,0,No,0,0.39,0.0,-0.39,54,0,-54,0,0,0,71.0,0.0,-71.0,5165000.0,0.0,-5165000.0
<a href=/player/bracg101>bracg101</a>,Gibby Brack,Brooklyn Dodgers,DOGRS,1,1,1,2,1938,1940,2,No,0,1.49,-0.5,-1.99,163,103,-60,603,318,-285,0.0,0.0,0.0,0.0,0.0,0.0
<a href=/player/brada001>brada001</a>,Archie Bradley,Arizona Diamondbacks,DBACKS,1,2,2,4,2020,2020,0,Yes,0,0.33,0.3,-0.03,6,12,6,0,41,41,23.0,0.0,-23.0,4100000.0,0.0,-4100000.0
<a href=/player/bradb101>bradb101</a>,Bert Bradley,Oakland Athletics,ATLTCS,9,18,16,34,1984,1998,14,No,2,132.59,51.65,-80.94,4207,2470,-1737,7421,6370,-1051,13842.0,8807.0,-5035.0,6670419.0,0.0,-6670419.0
<a href=/player/bradb105>bradb105</a>,Buddy Bradford,Chicago White Sox,WSOX,3,4,4,8,1970,1971,1,No,0,2.16,-0.62,-2.78,446,79,-367,1302,48,-1254,0.0,422.0,422.0,40000.0,0.0,-40000.0
<a href=/player/bradb105>bradb105</a>,Buddy Bradford,Cleveland Indians,INDINS,3,3,3,6,1971,1974,3,No,0,-1.35,-1.83,-0.48,217,74,-143,527,183,-344,0.0,0.0,0.0,30000.0,0.0,-30000.0
<a href=/player/bradb105>bradb105</a>,Buddy Bradford,Chicago White Sox,WSOX,1,1,2,3,1975,1975,0,No,0,0.3,0.0,-0.3,50,0,-50,93,0,-93,0.0,0.0,0.0,0.0,0.0,0.0
<a href=/player/bradb105>bradb105</a>,Buddy Bradford,St. Louis Cardinals,CARDS,1,2,1,3,1975,1976,1,No,0,0.63,-0.55,-1.18,80,66,-14,258,97,-161,0.0,0.0,0.0,0.0,0.0,0.0
<a href=/player/bradb105>bradb105</a>,Buddy Bradford,Cincinnati Reds,REDS,2,3,3,6,1972,1973,1,No,0,2.2,0.19,-2.01,223,36,-187,611,60,-551,24.0,0.0,-24.0,16000.0,0.0,-16000.0
<a href=/player/bradc001>bradc001</a>,Chad Bradford,Chicago White Sox,WSOX,5,10,9,19,2000,2013,13,No,0,31.16,26.72,-4.44,2306,672,-1634,7101,1367,-5734,2636.0,4790.0,2154.0,12920000.0,0.0,-12920000.0
<a href=/player/bradc001>bradc001</a>,Chad Bradford,Oakland Athletics,ATLTCS,1,1,2,3,2005,2006,1,No,0,0.44,3.53,3.09,31,211,180,0,879,879,70.0,0.0,-70.0,0.0,0.0,0.0
<a href=/player/bradf102>bradf102</a>,Fred Bradley,New York Yankees,YANKS,2,4,2,6,1948,1956,8,No,0,8.14,18.41,10.27,334,437,103,647,602,-45,2224.0,4492.0,2268.0,0.0,0.0,0.0
<a href=/player/bradj101>bradj101</a>,Joe Bradshaw,Toledo,Toledo,2,2,4,6,1924,1927,3,No,0,-0.91,0.0,0.91,153,0,-153,464,0,-464,0.0,0.0,0.0,0.0,0.0,0.0
<a href=/player/bradj103>bradj103</a>,Jack Bradley,Cleveland Indians,INDINS,1,1,1,2,1916,1916,0,No,0,0.0,0.21,0.21,0,19,19,0,36,36,0.0,0.0,0.0,0.0,0.0,0.0
<a href=/player/bradm001>bradm001</a>,Milton Bradley,Montreal Expos,NATEX,2,4,2,6,2001,2005,4,No,0,3.6,3.17,-0.43,225,211,-14,838,379,-459,74.0,964.0,890.0,881000.0,0.0,-881000.0
<a href=/player/bradm001>bradm001</a>,Milton Bradley,Cleveland Indians,INDINS,3,4,5,9,2004,2013,9,No,0,22.65,11.89,-10.76,1291,986,-305,5076,2133,-2943,0.0,843.0,843.0,404400.0,0.0,-404400.0
<a href=/player/bradm001>bradm001</a>,Milton Bradley,Los Angeles Dodgers,DOGRS,1,2,1,3,2005,2017,12,No,0,0.96,21.5,20.54,172,1455,1283,589,5425,4836,0.0,0.0,0.0,2830000.0,0.0,-2830000.0
<a href=/player/bradm001>bradm001</a>,Milton Bradley,Oakland Athletics,ATLTCS,1,2,1,3,2007,2009,2,No,0,1.87,0.57,-1.3,42,65,23,169,0,-169,0.0,230.0,230.0,4000000.0,0.0,-4000000.0
<a href=/player/bradm001>bradm001</a>,Milton Bradley,Chicago Cubs,CUBS,1,1,2,3,2009,2011,2,No,0,0.02,1.59,1.57,101,40,-61,393,40,-353,0.0,339.0,339.0,7000000.0,0.0,-7000000.0
<a href=/player/bradm002>bradm002</a>,Michael Brady,Anaheim Angels,ANGELS,1,2,2,4,2015,2017,2,No,0,-0.45,1.55,2.0,66,221,155,0,948,948,84.0,0.0,-84.0,0.0,0.0,0.0
<a href=/player/bradm101>bradm101</a>,Mark Bradley,Los Angeles Dodgers,DOGRS,1,1,3,4,1983,1983,0,No,0,-0.14,0.0,0.14,73,0,-73,115,0,-115,0.0,0.0,0.0,0.0,0.0,0.0
<a href=/player/bradp001>bradp001</a>,Phil Bradley,Seattle Mariners,MARNRS,5,8,8,16,1987,1993,6,No,0,24.41,5.5,-18.91,1467,818,-649,2406,1901,-505,2994.0,1198.0,-1796.0,7690000.0,0.0,-7690000.0
<a href=/player/bradp001>bradp001</a>,Phil Bradley,Philadelphia Phillies,PHILS,1,1,2,3,1988,1989,1,No,0,3.6,-0.08,-3.68,216,10,-206,963,0,-963,0.0,12.0,12.0,905000.0,0.0,-905000.0
<a href=/player/bradp001>bradp001</a>,Phil Bradley,Baltimore Orioles,ORLS,1,1,1,2,1990,1990,0,No,0,-0.07,-0.63,-0.56,45,22,-23,162,64,-98,0.0,0.0,0.0,1150000.0,0.0,-1150000.0
<a href=/player/brads001>brads001</a>,Scott Bradley,New York Yankees,YANKS,4,10,9,19,1986,1992,6,No,0,2.03,5.24,3.21,652,1255,603,1902,3999,2097,488.0,0.0,-488.0,400873.0,0.0,-400873.0
<a href=/player/brads001>brads001</a>,Scott Bradley,Chicago White Sox,WSOX,3,4,5,9,1986,1996,10,No,0,6.56,25.54,18.98,1140,1193,53,3363,5160,1797,266.0,0.0,-266.0,4896500.0,0.0,-4896500.0
<a href=/player/brads001>brads001</a>,Scott Bradley,Cincinnati Reds,REDS,1,1,1,2,1992,1992,0,No,0,0.0,0.0,0.0,0,0,0,0,0,0,0.0,0.0,0.0,0.0,0.0,0.0
<a href=/player/bradt102>bradt102</a>,Tom Bradley,California Angels,ANGELS,8,17,17,34,1970,1976,6,No,0,13.31,15.37,2.06,1179,1226,47,3267,3750,483,2333.0,345.0,-1988.0,137100.0,0.0,-137100.0
<a href=/player/bradt102>bradt102</a>,Tom Bradley,Chicago White Sox,WSOX,7,13,10,23,1972,1985,13,No,1,19.0,15.5,-3.5,1594,1087,-507,3238,4100,862,4800.0,545.0,-4255.0,32700.0,0.0,-32700.0
<a href=/player/bragb101>bragb101</a>,Bobby Bragan,Philadelphia Phillies,PHILS,1,1,2,3,1943,1946,3,No,0,0.07,1.98,1.91,202,107,-95,586,100,-486,0.0,847.0,847.0,0.0,0.0,0.0
<a href=/player/bragd001>bragd001</a>,Darren Bragg,Seattle Mariners,MARNRS,2,2,3,5,1996,2006,10,No,0,10.51,34.44,23.93,579,337,-242,1584,31,-1553,2162.0,6279.0,4117.0,5630000.0,0.0,-5630000.0
<a href=/player/bragg001>bragg001</a>,Glenn Braggs,Milwaukee Brewers,BREWRS,1,2,2,4,1990,1990,0,No,0,3.07,2.88,-0.19,257,33,-224,822,0,-822,0.0,478.0,478.0,675000.0,0.0,-675000.0
<a href=/player/braid101>braid101</a>,Dave Brain,Buffalo,Buffalo,1,1,1,2,1903,1903,0,No,0,3.27,0.0,-3.27,290,0,-290,1181,0,-1181,0.0,0.0,0.0,0.0,0.0,0.0
<a href=/player/braid101>braid101</a>,Dave Brain,St. Louis Cardinals,CARDS,2,3,2,5,1905,1907,2,No,0,1.71,-1.89,-3.6,85,193,108,334,714,380,0.0,0.0,0.0,0.0,0.0,0.0
<a href=/player/braid101>braid101</a>,Dave Brain,Pittsburgh Pirates,PIRATS,1,3,1,4,1905,1910,5,No,0,9.35,21.13,11.78,731,320,-411,2264,464,-1800,2702.0,3628.0,926.0,0.0,0.0,0.0
<a href=/player/braid101>braid101</a>,Dave Brain,Cincinnati Reds,REDS,1,2,2,4,1908,1910,2,No,0,-0.57,0.79,1.36,13,104,91,18,143,125,9.0,1093.0,1084.0,0.0,0.0,0.0
<a href=/player/branb102>branb102</a>,Bucky Brandon,Houston Astros,ASTROS,6,10,11,21,1965,1973,8,No,0,1.14,0.64,-0.5,559,971,412,411,1029,618,1907.0,2057.0,150.0,57500.0,0.0,-57500.0
<a href=/player/branb102>branb102</a>,Bucky Brandon,Chicago White Sox,WSOX,1,1,1,2,1971,1971,0,No,0,-0.5,0.0,0.5,260,0,-260,40,0,-40,731.0,0.0,-731.0,0.0,0.0,0.0
<a href=/player/brand101>brand101</a>,Dud Branom,KansasCity,KansasCity,1,1,2,3,1926,1926,0,No,0,-0.86,0.0,0.86,30,0,-30,102,0,-102,0.0,0.0,0.0,0.0,0.0,0.0
<a href=/player/brane101>brane101</a>,Ed Brandt,Boston Braves,BRAVES,9,22,18,40,1935,1952,17,No,0,30.65,55.97,25.32,2386,3342,956,8192,10691,2499,702.0,5153.0,4451.0,12500.0,0.0,-12500.0
<a href=/player/brane101>brane101</a>,Ed Brandt,Brooklyn Dodgers,DOGRS,2,2,4,6,1936,1948,12,No,0,4.3,12.51,8.21,114,889,775,108,3376,3268,818.0,89.0,-729.0,0.0,0.0,0.0
<a href=/player/branh101>branh101</a>,Harvey Branch,Chicago Cubs,CUBS,3,5,5,10,1962,1966,4,No,0,41.25,2.73,-38.52,2472,341,-2131,10221,655,-9566,24.0,861.0,837.0,12000.0,0.0,-12000.0
<a href=/player/branj001>branj001</a>,Jeff Brantley,Cincinnati Reds,REDS,1,1,1,2,1997,1997,0,No,0,0.03,0.0,-0.03,94,0,-94,1,0,-1,152.0,0.0,-152.0,2800000.0,0.0,-2800000.0
<a href=/player/branj001>branj001</a>,Jeff Brantley,St. Louis Cardinals,CARDS,1,3,2,5,1998,1999,1,No,0,3.97,-0.62,-4.59,475,133,-342,1012,3,-1009,549.0,220.0,-329.0,8470000.0,0.0,-8470000.0
<a href=/player/branj002>branj002</a>,Jeff Branson,Cincinnati Reds,REDS,5,9,11,20,1997,2005,8,No,0,10.23,15.87,5.64,1063,1597,534,3584,2539,-1045,112.0,2236.0,2124.0,7950000.0,0.0,-7950000.0
<a href=/player/branj101>branj101</a>,Jackie Brandt,San Francisco Giants,GIANTS,5,9,7,16,1959,1968,9,No,0,13.15,7.42,-5.73,1312,848,-464,3499,1107,-2392,1130.0,3244.0,2114.0,43000.0,0.0,-43000.0
<a href=/player/branj101>branj101</a>,Jackie Brandt,Baltimore Orioles,ORLS,13,28,25,53,1965,1994,29,No,3,56.99,119.52,62.53,3157,5392,2235,5411,14197,8786,13047.0,15470.0,2423.0,940333.0,0.0,-940333.0
<a href=/player/branj101>branj101</a>,Jackie Brandt,St. Louis Cardinals,CARDS,19,44,38,82,1956,1972,16,No,0,56.42,67.4,10.98,5645,3260,-2385,13530,9157,-4373,6309.0,6165.0,-144.0,120500.0,0.0,-120500.0
<a href=/player/brank101>brank101</a>,Kitty Bransfield,Pittsburgh Pirates,PIRATS,2,6,3,9,1904,1910,6,No,0,14.45,22.9,8.45,1603,573,-1030,5618,1466,-4152,2702.0,3643.0,941.0,0.0,0.0,0.0
<a href=/player/branm001>branm001</a>,Mickey Brantley,Seattle Mariners,MARNRS,3,4,4,8,1990,1994,4,No,0,-1.19,-0.25,0.94,99,17,-82,244,0,-244,20.0,66.0,46.0,0.0,0.0,0.0
<a href=/player/branm002>branm002</a>,Mark Brandenburg,Texas Rangers,RNGRS,3,6,6,12,1996,2002,6,No,2,0.53,0.51,-0.02,205,106,-99,245,209,-36,377.0,194.0,-183.0,1973500.0,0.0,-1973500.0
<a href=/player/branm002>branm002</a>,Mark Brandenburg,Boston Red Sox,RSOX,4,7,7,14,1997,2000,3,No,0,8.97,2.55,-6.42,585,374,-211,1634,946,-688,1253.0,139.0,-1114.0,5063500.0,0.0,-5063500.0
<a href=/player/branm003>branm003</a>,Michael Brantley,Milwaukee Brewers,BREWRS,2,5,3,8,2008,2008,0,No,2,22.37,5.2,-17.17,1354,34,-1320,5551,50,-5501,190.0,392.0,202.0,0.0,0.0,0.0
<a href=/player/branm101>branm101</a>,Marshall Brant,New York Yankees,YANKS,1,3,1,4,1983,1984,1,No,0,-1.24,-0.76,0.48,9,12,3,14,0,-14,28.0,167.0,139.0,0.0,0.0,0.0
<a href=/player/branr001>branr001</a>,Russell Branyan,Cleveland Indians,INDINS,6,11,14,25,2002,2019,17,Yes,0,10.66,51.34,40.68,689,2146,1457,2167,5669,3502,399.0,4479.0,4080.0,25702400.0,0.0,-25702400.0
<a href=/player/branr001>branr001</a>,Russell Branyan,Atlanta Braves,BRAVES,1,1,1,2,2004,2004,0,No,0,1.1,0.0,-1.1,52,0,-52,190,0,-190,0.0,0.0,0.0,0.0,0.0,0.0
<a href=/player/branr001>branr001</a>,Russell Branyan,Tampa Bay Devil Rays,RAYS,1,1,2,3,2006,2010,4,No,0,0.94,-0.26,-1.2,88,13,-75,235,1,-234,0.0,47.0,47.0,0.0,0.0,0.0
<a href=/player/branr001>branr001</a>,Russell Branyan,Cleveland Indians,INDINS,1,1,2,3,2010,2013,3,No,0,0.86,0.34,-0.52,57,123,66,238,406,168,0.0,0.0,0.0,1500000.0,0.0,-1500000.0
<a href=/player/branr002>branr002</a>,Rob Brantly,Detroit Tigers,TIGRS,1,3,2,5,2012,2017,5,No,0,-1.8,11.54,13.34,208,344,136,437,741,304,809.0,2395.0,1586.0,1175000.0,0.0,-1175000.0
<a href=/player/bratj101>bratj101</a>,Joe Bratcher,St. Louis Cardinals,CARDS,1,5,1,6,1924,1925,1,No,0,0.0,0.0,0.0,0,0,0,0,0,0,0.0,0.0,0.0,0.0,0.0,0.0
<a href=/player/braus001>braus001</a>,Steve Braun,Seattle Mariners,MARNRS,1,1,1,2,1978,1979,1,No,0,0.35,-0.62,-0.97,136,20,-116,331,0,-331,0.0,343.0,343.0,0.0,0.0,0.0
<a href=/player/braus002>braus002</a>,Steven Brault,Baltimore Orioles,ORLS,1,2,1,3,2015,2015,0,No,0,1.85,1.0,-0.85,210,69,-141,101,236,135,1030.0,0.0,-1030.0,0.0,0.0,0.0
<a href=/player/brava101>brava101</a>,Angel Bravo,Chicago White Sox,WSOX,1,1,1,2,1969,1969,0,No,0,0.02,0.0,-0.02,70,0,-70,83,0,-83,0.0,0.0,0.0,0.0,0.0,0.0
<a href=/player/brava101>brava101</a>,Angel Bravo,Cincinnati Reds,REDS,1,1,1,2,1971,1971,0,No,0,-0.52,0.06,0.58,52,32,-20,68,37,-31,0.0,0.0,0.0,0.0,0.0,0.0
<a href=/player/braxg101>braxg101</a>,Garland Braxton,New York Yankees,YANKS,1,2,1,3,1926,1926,0,No,0,10.55,0.57,-9.98,311,18,-293,225,24,-201,1748.0,108.0,-1640.0,3000.0,0.0,-3000.0
<a href=/player/braxg101>braxg101</a>,Garland Braxton,Washington Senators,TWINS,1,2,1,3,1930,1930,0,No,0,0.86,0.43,-0.43,237,38,-199,612,91,-521,414.0,0.0,-414.0,13500.0,0.0,-13500.0
<a href=/player/brayb001>brayb001</a>,Bill Bray,Washington Nationals,NATEX,1,5,3,8,2006,2009,3,No,0,-0.61,0.43,1.04,705,795,90,181,2860,2679,809.0,139.0,-670.0,1352000.0,0.0,-1352000.0
<a href=/player/braza101>braza101</a>,Al Brazle,Boston Red Sox,RSOX,1,1,1,2,1940,1946,6,No,0,20.12,5.58,-14.54,888,369,-519,466,211,-255,4131.0,1746.0,-2385.0,0.0,0.0,0.0
<a href=/player/brazd001>brazd001</a>,Dewon Brazelton,Tampa Bay Devil Rays,RAYS,1,1,1,2,2005,2006,1,No,0,-0.89,-0.03,0.86,18,8,-10,4,25,21,54.0,0.0,-54.0,1124000.0,0.0,-1124000.0
<a href=/player/brazf101>brazf101</a>,Frank Brazill,Philadelphia Athletics,ATLTCS,1,3,1,4,1922,1925,3,No,0,0.0,-0.89,-0.89,0,157,157,0,354,354,0.0,0.0,0.0,2500.0,0.0,-2500.0
<a href=/player/brazy001>brazy001</a>,Yhency Brazoban,New York Yankees,YANKS,1,4,1,5,2003,2005,2,No,0,4.25,2.4,-1.85,506,36,-470,179,2,-177,2047.0,616.0,-1431.0,4150000.0,0.0,-4150000.0
<a href=/player/breal001>breal001</a>,Leslie Brea,Seattle Mariners,MARNRS,2,2,2,4,1998,1999,1,No,0,-0.18,0.95,1.13,45,80,35,131,292,161,0.0,55.0,55.0,1500000.0,0.0,-1500000.0
<a href=/player/breal001>breal001</a>,Leslie Brea,New York Mets,METS,1,4,1,5,2000,2000,0,No,0,28.33,0.16,-28.17,1330,56,-1274,5573,211,-5362,33.0,0.0,-33.0,210000.0,0.0,-210000.0
<a href=/player/breas001>breas001</a>,Sid Bream,Los Angeles Dodgers,DOGRS,1,3,1,4,1985,1987,2,No,0,13.58,2.02,-11.56,1414,166,-1248,4553,618,-3935,0.0,0.0,0.0,0.0,0.0,0.0
<a href=/player/breed101>breed101</a>,Danny Breeden,St. Louis Cardinals,CARDS,3,8,6,14,1968,1972,4,No,0,11.85,2.24,-9.61,1182,243,-939,1248,521,-727,1854.0,299.0,-1555.0,17500.0,0.0,-17500.0
<a href=/player/breed101>breed101</a>,Danny Breeden,Cincinnati Reds,REDS,1,1,1,2,1970,1970,0,No,0,-0.52,0.0,0.52,25,0,-25,79,0,-79,0.0,0.0,0.0,0.0,0.0,0.0
<a href=/player/breed101>breed101</a>,Danny Breeden,San Diego Padres,PADRS,2,3,4,7,1974,1977,3,No,0,0.29,1.08,0.79,46,347,301,86,318,232,183.0,1079.0,896.0,0.0,0.0,0.0
<a href=/player/breeh101>breeh101</a>,Hal Breeden,Atlanta Braves,BRAVES,1,1,1,2,1970,1971,1,No,0,-0.34,1.77,2.11,23,106,83,39,13,-26,0.0,242.0,242.0,0.0,0.0,0.0
<a href=/player/breeh101>breeh101</a>,Hal Breeden,Chicago Cubs,CUBS,1,2,2,4,1972,1972,0,No,0,0.36,-1.6,-1.96,335,85,-250,844,8,-836,2.0,188.0,186.0,0.0,0.0,0.0
<a href=/player/breem101>breem101</a>,Marv Breeding,Baltimore Orioles,ORLS,1,3,2,5,1962,1967,5,No,0,0.29,3.01,2.72,74,349,275,211,975,764,63.0,22.0,-41.0,7000.0,0.0,-7000.0
<a href=/player/breem101>breem101</a>,Marv Breeding,Washington Senators,RNGRS,1,1,1,2,1963,1964,1,No,0,-0.38,0.54,0.92,20,56,36,40,13,-27,0.0,175.0,175.0,0.0,0.0,0.0
<a href=/player/breem101>breem101</a>,Marv Breeding,Atlanta Braves,BRAVES,3,4,3,7,1966,1980,14,No,0,0.0,0.4,0.4,3,465,462,3,1209,1206,0.0,0.0,0.0,0.0,0.0,0.0
<a href=/player/breem101>breem101</a>,Marv Breeding,Houston Astros,ASTROS,1,1,1,2,1967,1967,0,No,0,0.0,-0.22,-0.22,0,4,4,0,0,0,0.0,4.0,4.0,0.0,0.0,0.0
<a href=/player/breif001>breif001</a>,Fred Breining,Pittsburgh Pirates,PIRATS,3,5,7,12,1979,1990,11,No,1,17.64,30.66,13.02,910,2106,1196,973,7523,6550,3555.0,123.0,-3432.0,975500.0,0.0,-975500.0
<a href=/player/breif001>breif001</a>,Fred Breining,San Francisco Giants,GIANTS,3,6,4,10,1984,1992,8,No,0,-0.38,4.13,4.51,126,534,408,225,652,427,93.0,2798.0,2705.0,0.0,0.0,0.0
<a href=/player/brena101>brena101</a>,Ad Brennan,Cincinnati Reds,REDS,4,11,9,20,1910,1914,4,No,0,53.01,6.59,-46.42,3186,799,-2387,12273,2663,-9610,3029.0,990.0,-2039.0,0.0,0.0,0.0
<a href=/player/brenb102>brenb102</a>,Bert Brenner,Cleveland Indians,INDINS,1,6,1,7,1913,1914,1,No,0,0.0,-0.98,-0.98,0,48,48,0,37,37,0.0,303.0,303.0,0.0,0.0,0.0
<a href=/player/brenj001>brenj001</a>,Jake Brentz,Toronto Blue Jays,BJAYS,1,3,1,4,2015,2015,0,No,0,-1.1,0.06,1.16,24,25,1,0,0,0,43.0,57.0,14.0,0.0,0.0,0.0
<a href=/player/brenj001>brenj001</a>,Jake Brentz,Seattle Mariners,MARNRS,1,2,1,3,2016,2016,0,No,0,0.0,-0.38,-0.38,0,18,18,0,0,0,0.0,59.0,59.0,0.0,0.0,0.0
<a href=/player/brenl101>brenl101</a>,Lynn Brenton,Seattle,Seattle,1,1,2,3,1920,1920,0,No,0,-0.78,0.0,0.78,44,0,-44,28,0,-28,235.0,0.0,-235.0,0.0,0.0,0.0
<a href=/player/brent001>brent001</a>,Tom Brennan,Cleveland Indians,INDINS,1,1,1,2,1984,1987,3,No,0,-0.06,0.0,0.06,4,0,-4,0,0,0,20.0,0.0,-20.0,0.0,0.0,0.0
<a href=/player/bresc001>bresc001</a>,Craig Breslow,Oakland Athletics,ATLTCS,3,5,5,10,2011,2015,4,No,0,0.11,4.67,4.56,286,252,-34,221,116,-105,1515.0,585.0,-930.0,3722500.0,0.0,-3722500.0
<a href=/player/bresc001>bresc001</a>,Craig Breslow,Arizona Diamondbacks,DBACKS,4,7,8,15,2012,2021,9,No,0,45.83,11.26,-34.57,1640,653,-987,2691,1018,-1673,5869.0,2575.0,-3294.0,13397833.0,0.0,-13397833.0
<a href=/player/brese101>brese101</a>,Eddie Bressoud,Houston Astros,ASTROS,1,1,1,2,1961,1962,1,No,0,11.94,0.02,-11.92,558,40,-518,2188,100,-2088,0.0,0.0,0.0,0.0,0.0,0.0
<a href=/player/brese101>brese101</a>,Eddie Bressoud,Boston Red Sox,RSOX,4,7,6,13,1965,1968,3,No,0,24.8,3.53,-21.27,1088,233,-855,3047,426,-2621,3084.0,1094.0,-1990.0,44500.0,0.0,-44500.0
<a href=/player/brese101>brese101</a>,Eddie Bressoud,New York Mets,METS,2,4,4,8,1967,1969,2,No,0,-0.9,-0.52,0.38,52,197,145,76,651,575,0.0,0.0,0.0,0.0,0.0,0.0
<a href=/player/bresr102>bresr102</a>,Roger Bresnahan,New York Giants,GIANTS,1,1,3,4,1908,1915,7,No,0,10.02,9.62,-0.4,290,859,569,993,3291,2298,10.0,0.0,-10.0,0.0,0.0,0.0
<a href=/player/bretk101>bretk101</a>,Ken Brett,Boston Red Sox,RSOX,5,10,10,20,1971,1977,6,No,0,35.42,11.92,-23.5,1569,736,-833,4628,2092,-2536,3846.0,2344.0,-1502.0,155000.0,0.0,-155000.0
<a href=/player/bretk101>bretk101</a>,Ken Brett,Milwaukee Brewers,BREWRS,3,6,5,11,1972,1984,12,No,0,7.41,27.71,20.3,475,1402,927,547,5127,4580,4062.0,1332.0,-2730.0,59800.0,0.0,-59800.0
<a href=/player/bretk101>bretk101</a>,Ken Brett,Philadelphia Phillies,PHILS,1,1,1,2,1973,1976,3,No,0,4.9,11.68,6.78,119,484,365,149,2238,2089,927.0,0.0,-927.0,0.0,0.0,0.0
<a href=/player/bretk101>bretk101</a>,Ken Brett,Pittsburgh Pirates,PIRATS,6,13,12,25,1975,1988,13,No,0,109.3,32.91,-76.39,4660,1733,-2927,17124,6632,-10492,6130.0,687.0,-5443.0,807000.0,0.0,-807000.0
<a href=/player/bretk101>bretk101</a>,Ken Brett,New York Yankees,YANKS,1,2,1,3,1976,1977,1,No,0,4.11,0.35,-3.76,80,152,72,116,536,420,850.0,0.0,-850.0,0.0,0.0,0.0
<a href=/player/bretk101>bretk101</a>,Ken Brett,Chicago White Sox,WSOX,1,1,3,4,1977,1979,2,No,0,1.23,0.12,-1.11,53,29,-24,0,3,3,726.0,151.0,-575.0,70000.0,0.0,-70000.0
<a href=/player/brewb001>brewb001</a>,Billy Brewer,Kansas City Royals,ROYALS,8,14,15,29,1995,2021,26,Yes,2,13.66,59.53,45.87,983,3573,2590,2084,12349,10265,3468.0,2951.0,-517.0,27250000.0,0.0,-27250000.0
<a href=/player/brewb001>brewb001</a>,Billy Brewer,Los Angeles Dodgers,DOGRS,1,1,1,2,1996,2001,5,No,0,-0.11,-0.91,-0.8,4,32,28,0,13,13,17.0,138.0,121.0,0.0,0.0,0.0
<a href=/player/brewc002>brewc002</a>,Colten Brewer,San Diego Padres,PADRS,2,4,3,7,2018,2021,3,Yes,0,0.86,1.32,0.46,113,186,73,139,686,547,244.0,0.0,-244.0,545000.0,0.0,-545000.0
<a href=/player/brewc101>brewc101</a>,Charlie Brewster,Cincinnati Reds,REDS,1,1,1,2,1943,1943,0,No,0,-0.61,-0.02,0.59,49,49,0,175,106,-69,0.0,0.0,0.0,0.0,0.0,0.0
<a href=/player/brewc101>brewc101</a>,Charlie Brewster,SanDiego,SanDiego,1,1,1,2,1946,1946,0,No,0,-0.01,0.0,0.01,3,0,-3,3,0,-3,0.0,0.0,0.0,0.0,0.0,0.0
<a href=/player/brewj001>brewj001</a>,Jamie Brewington,San Francisco Giants,GIANTS,1,1,1,2,1996,2002,6,No,0,0.0,3.32,3.32,0,368,368,0,1045,1045,0.0,0.0,0.0,0.0,0.0,0.0
<a href=/player/brewj001>brewj001</a>,Jamie Brewington,Kansas City Royals,ROYALS,1,1,1,2,1997,1997,0,No,0,0.0,0.0,0.0,0,0,0,0,0,0,0.0,0.0,0.0,0.0,0.0,0.0
<a href=/player/brewj102>brewj102</a>,Jim Brewer,Chicago Cubs,CUBS,1,2,1,3,1963,1963,0,No,0,15.76,0.0,-15.76,949,0,-949,117,0,-117,2466.0,0.0,-2466.0,0.0,0.0,0.0
<a href=/player/brewj102>brewj102</a>,Jim Brewer,Los Angeles Dodgers,DOGRS,1,1,1,2,1975,1975,0,No,0,1.31,0.0,-1.31,34,10,-24,0,1,1,164.0,21.0,-143.0,0.0,0.0,0.0
<a href=/player/brica001>brica001</a>,Austin Brice,Miami Marlins,MARLNS,1,3,1,4,2017,2019,2,No,0,13.54,1.87,-11.67,336,112,-224,228,107,-121,2332.0,912.0,-1420.0,0.0,0.0,0.0
<a href=/player/brica001>brica001</a>,Austin Brice,Miami Marlins,MARLNS,1,1,1,2,2020,2020,0,Yes,0,-0.06,0.0,0.06,34,0,-34,0,0,0,100.0,0.0,-100.0,0.0,0.0,0.0
<a href=/player/brica101>brica101</a>,Alan Brice,Chicago White Sox,WSOX,1,1,1,2,1962,1962,0,No,0,0.0,0.0,0.0,0,0,0,0,0,0,0.0,0.0,0.0,0.0,0.0,0.0
<a href=/player/bricf101>bricf101</a>,Fred Brickell,Pittsburgh Pirates,PIRATS,1,1,1,2,1930,1930,0,No,0,-2.43,-0.43,2.0,236,17,-219,905,54,-851,0.0,0.0,0.0,0.0,0.0,0.0
<a href=/player/bricf102>bricf102</a>,Fritz Brickell,New York Yankees,YANKS,1,1,1,2,1961,1961,0,No,0,-0.79,-0.14,0.65,21,2,-19,55,0,-55,0.0,1.0,1.0,0.0,0.0,0.0
<a href=/player/bricj001>bricj001</a>,Jose Briceno,Colorado Rockies,ROCKS,1,2,2,4,2015,2016,1,No,0,0.0,-0.37,-0.37,0,36,36,0,27,27,0.0,241.0,241.0,0.0,0.0,0.0
<a href=/player/bricj001>bricj001</a>,Jose Briceno,Atlanta Braves,BRAVES,4,9,8,17,2015,2017,2,Yes,0,22.94,1.32,-21.62,894,130,-764,2564,403,-2161,887.0,339.0,-548.0,16307500.0,0.0,-16307500.0
<a href=/player/brida101>brida101</a>,Al Bridwell,Cincinnati Reds,REDS,1,1,1,2,1906,1906,0,No,0,2.0,2.26,0.26,342,115,-227,1449,451,-998,0.0,0.0,0.0,0.0,0.0,0.0
<a href=/player/brida101>brida101</a>,Al Bridwell,Boston Braves,BRAVES,2,4,6,10,1907,1911,4,No,0,19.52,11.83,-7.69,821,855,34,3252,2714,-538,0.0,1733.0,1733.0,0.0,0.0,0.0
<a href=/player/brida101>brida101</a>,Al Bridwell,New York Giants,GIANTS,3,6,3,9,1911,1921,10,No,0,34.55,14.86,-19.69,1629,779,-850,5823,2071,-3752,0.0,2915.0,2915.0,6400.0,0.0,-6400.0
<a href=/player/bridj101>bridj101</a>,Jim Brideweser,New York Yankees,YANKS,1,1,3,4,1954,1954,0,No,0,0.89,0.0,-0.89,164,0,-164,392,0,-392,0.0,0.0,0.0,0.0,0.0,0.0
<a href=/player/bridj101>bridj101</a>,Jim Brideweser,Baltimore Orioles,ORLS,4,7,9,16,1954,1960,6,No,0,15.05,10.88,-4.17,745,881,136,1673,2506,833,2291.0,1208.0,-1083.0,0.0,0.0,0.0
<a href=/player/bridj101>bridj101</a>,Jim Brideweser,Chicago White Sox,WSOX,10,18,21,39,1956,1971,15,No,0,41.93,77.23,35.3,3299,4500,1201,10984,12532,1548,917.0,5807.0,4890.0,83500.0,0.0,-83500.0
<a href=/player/bridj101>bridj101</a>,Jim Brideweser,Baltimore Orioles,ORLS,1,2,1,3,1958,1958,0,No,0,0.0,0.0,0.0,0,0,0,0,0,0,0.0,0.0,0.0,0.0,0.0,0.0
<a href=/player/bridm101>bridm101</a>,Marshall Bridges,Cincinnati Reds,REDS,3,3,4,7,1961,1964,3,No,0,2.16,-1.12,-3.28,380,87,-293,650,145,-505,314.0,0.0,-314.0,0.0,0.0,0.0
<a href=/player/bridp001>bridp001</a>,Parker Bridwell,Baltimore Orioles,ORLS,1,1,1,2,2017,2017,0,No,0,1.44,0.0,-1.44,26,0,-26,0,0,0,383.0,0.0,-383.0,0.0,0.0,0.0
<a href=/player/bridr101>bridr101</a>,Rocky Bridges,Brooklyn Dodgers,DOGRS,3,6,5,11,1953,1961,8,No,0,18.78,1.43,-17.35,2060,372,-1688,3863,742,-3121,2426.0,1360.0,-1066.0,0.0,0.0,0.0
<a href=/player/bridr101>bridr101</a>,Rocky Bridges,Washington Senators,TWINS,5,10,8,18,1958,1963,5,No,0,7.52,-2.19,-9.71,769,798,29,2600,2634,34,5.0,80.0,75.0,9500.0,0.0,-9500.0
<a href=/player/bridr101>bridr101</a>,Rocky Bridges,Detroit Tigers,TIGRS,1,2,1,3,1960,1960,0,No,0,-0.21,0.09,0.3,42,26,-16,127,61,-66,0.0,0.0,0.0,0.0,0.0,0.0
<a href=/player/brieb101>brieb101</a>,Bunny Brief,St.Louis Browns,ORLS,1,4,1,5,1913,1916,3,No,0,0.0,8.53,8.53,0,318,318,0,1249,1249,0.0,0.0,0.0,3200.0,0.0,-3200.0
<a href=/player/brigb101>brigb101</a>,Buttons Briggs,Chicago Cubs,CUBS,1,2,2,4,1898,1901,3,No,0,0.0,6.83,6.83,0,327,327,0,1338,1338,0.0,0.0,0.0,0.0,0.0,0.0
<a href=/player/brigb101>brigb101</a>,Buttons Briggs,Toronto,Toronto,1,1,4,5,1903,1903,0,No,0,5.06,0.0,-5.06,108,0,-108,173,0,-173,1329.0,0.0,-1329.0,0.0,0.0,0.0
<a href=/player/brigb101>brigb101</a>,Buttons Briggs,Chicago Cubs,CUBS,1,5,1,6,1905,1913,8,No,0,5.14,19.07,13.93,814,1001,187,3290,4393,1103,0.0,0.0,0.0,0.0,0.0,0.0
<a href=/player/brigd101>brigd101</a>,Dan Briggs,Cleveland Indians,INDINS,1,1,1,2,1979,1979,0,No,0,0.14,0.0,-0.14,104,0,-104,254,0,-254,0.0,0.0,0.0,0.0,0.0,0.0
<a href=/player/brigd101>brigd101</a>,Dan Briggs,San Diego Padres,PADRS,1,2,1,3,1979,1981,2,No,0,-0.61,-0.55,0.06,27,130,103,51,437,386,0.0,0.0,0.0,0.0,0.0,0.0
<a href=/player/brigd101>brigd101</a>,Dan Briggs,Montreal Expos,NATEX,3,3,3,6,1982,1983,1,No,0,-0.51,0.0,0.51,62,0,-62,51,0,-51,31.0,0.0,-31.0,0.0,0.0,0.0
<a href=/player/brigh101>brigh101</a>,Harry Bright,Pittsburgh Pirates,PIRATS,1,3,1,4,1960,1961,1,No,0,4.94,2.05,-2.89,573,87,-486,984,20,-964,2463.0,268.0,-2195.0,0.0,0.0,0.0
<a href=/player/brigh101>brigh101</a>,Harry Bright,Washington Senators,RNGRS,1,1,1,2,1962,1963,1,No,0,-0.03,0.0,0.03,1,0,-1,1,0,-1,0.0,0.0,0.0,0.0,0.0,0.0
<a href=/player/brigj001>brigj001</a>,Jake Brigham,Texas Rangers,RNGRS,1,2,1,3,2012,2014,2,No,0,0.0,0.74,0.74,0,111,111,0,386,386,0.0,0.0,0.0,0.0,0.0,0.0
<a href=/player/brigj001>brigj001</a>,Jake Brigham,Chicago Cubs,CUBS,1,1,1,2,2012,2012,0,No,0,0.0,0.0,0.0,0,0,0,0,0,0,0.0,0.0,0.0,0.0,0.0,0.0
<a href=/player/brigj002>brigj002</a>,Jeff Brigham,Los Angeles Dodgers,DOGRS,9,31,24,55,2015,2021,6,Yes,0,13.68,18.97,5.29,1948,1113,-835,5665,1311,-4354,2367.0,3323.0,956.0,37486500.0,0.0,-37486500.0
<a href=/player/brigj101>brigj101</a>,John Briggs,Sacramento,Sacramento,1,2,3,5,1955,1959,4,No,0,0.4,0.0,-0.4,56,0,-56,37,0,-37,317.0,0.0,-317.0,0.0,0.0,0.0
<a href=/player/brigj101>brigj101</a>,John Briggs,Chicago Cubs,CUBS,2,4,3,7,1959,1961,2,No,0,-0.03,1.89,1.92,58,282,224,20,801,781,147.0,7.0,-140.0,0.0,0.0,0.0
<a href=/player/brigj101>brigj101</a>,John Briggs,Kansas City Athletics,ATLTCS,1,2,1,3,1961,1961,0,No,0,1.89,1.04,-0.85,216,93,-123,188,76,-112,1621.0,384.0,-1237.0,0.0,0.0,0.0
<a href=/player/brigj102>brigj102</a>,John Briggs,Philadelphia Phillies,PHILS,2,2,3,5,1971,1973,2,No,0,14.34,-0.93,-15.27,584,53,-531,2237,83,-2154,0.0,0.0,0.0,25000.0,0.0,-25000.0
<a href=/player/brigj102>brigj102</a>,John Briggs,Milwaukee Brewers,BREWRS,3,5,3,8,1975,1976,1,No,0,5.39,0.55,-4.84,629,149,-480,2135,501,-1634,335.0,0.0,-335.0,150000.0,0.0,-150000.0
<a href=/player/briln101>briln101</a>,Nelson Briles,St. Louis Cardinals,CARDS,3,4,5,9,1971,1972,1,No,0,10.59,4.12,-6.47,503,282,-221,1140,1112,-28,1651.0,28.0,-1623.0,0.0,0.0,0.0
<a href=/player/briln101>briln101</a>,Nelson Briles,Pittsburgh Pirates,PIRATS,3,4,6,10,1973,1978,5,No,0,0.57,-0.14,-0.71,111,383,272,173,830,657,645.0,0.0,-645.0,94500.0,0.0,-94500.0
<a href=/player/briln101>briln101</a>,Nelson Briles,Kansas City Royals,ROYALS,1,1,1,2,1975,1978,3,No,0,3.4,-0.07,-3.47,60,105,45,0,226,226,955.0,0.0,-955.0,0.0,0.0,0.0
<a href=/player/brine101>brine101</a>,Ed Brinkman,Washington Senators,RNGRS,6,10,11,21,1970,1976,6,No,0,30.0,-0.41,-30.41,2790,834,-1956,8622,1724,-6898,5481.0,1612.0,-3869.0,75900.0,0.0,-75900.0
<a href=/player/brine101>brine101</a>,Ed Brinkman,Detroit Tigers,TIGRS,1,3,1,4,1974,1975,1,No,0,-0.19,-1.37,-1.18,91,45,-46,191,173,-18,0.0,0.0,0.0,79000.0,0.0,-79000.0
<a href=/player/brine101>brine101</a>,Ed Brinkman,San Diego Padres,PADRS,2,3,4,7,1974,1977,3,No,0,0.29,1.08,0.79,46,347,301,86,318,232,183.0,1079.0,896.0,0.0,0.0,0.0
<a href=/player/brine101>brine101</a>,Ed Brinkman,St. Louis Cardinals,CARDS,3,4,3,7,1975,1976,1,No,0,0.91,1.54,0.63,156,98,-58,524,376,-148,63.0,0.0,-63.0,0.0,0.0,0.0
<a href=/player/brinl001>brinl001</a>,Lewis Brinson,Texas Rangers,RNGRS,3,5,4,9,2016,2018,2,Yes,0,3.83,1.66,-2.17,343,178,-165,233,474,241,460.0,162.0,-298.0,7350000.0,0.0,-7350000.0
<a href=/player/brinl001>brinl001</a>,Lewis Brinson,Milwaukee Brewers,BREWRS,1,4,1,5,2018,2018,0,Yes,0,-6.06,7.26,13.32,541,147,-394,1645,651,-994,270.0,0.0,-270.0,0.0,0.0,0.0
<a href=/player/brinl101>brinl101</a>,Leon Brinkopf,Dallas,Dallas,1,1,1,2,1948,1948,0,No,0,0.04,0.0,-0.04,9,0,-9,26,0,-26,0.0,0.0,0.0,0.0,0.0,0.0
<a href=/player/brisl101>brisl101</a>,Lou Brissie,Philadelphia Athletics,ATLTCS,35,74,76,150,1951,1976,25,No,0,96.76,72.83,-23.93,10509,9253,-1256,24683,28375,3692,13188.0,7417.0,-5771.0,500300.0,0.0,-500300.0
<a href=/player/britc001>britc001</a>,Chris Britton,Baltimore Orioles,ORLS,1,1,2,3,2006,2007,1,No,0,0.34,-0.34,-0.68,28,3,-25,0,0,0,107.0,31.0,-76.0,0.0,0.0,0.0
<a href=/player/britj101>britj101</a>,Jim Britton,Atlanta Braves,BRAVES,1,2,1,3,1969,1969,0,No,0,-1.08,0.0,1.08,32,0,-32,10,0,-10,137.0,0.0,-137.0,0.0,0.0,0.0
<a href=/player/brits001>brits001</a>,Socrates Brito,San Diego Padres,PADRS,1,1,1,2,2019,2019,0,Yes,0,-0.82,0.0,0.82,17,0,-17,43,0,-43,0.0,0.0,0.0,0.0,0.0,0.0
<a href=/player/britz001>britz001</a>,Zack Britton,Baltimore Orioles,ORLS,1,1,3,4,2018,2021,3,Yes,0,2.85,-1.38,-4.23,142,26,-116,0,0,0,371.0,135.0,-236.0,12000000.0,0.0,-12000000.0
<a href=/player/broal001>broal001</a>,Lance Broadway,Chicago White Sox,WSOX,1,1,2,3,2009,2011,2,No,0,-0.14,0.61,0.75,16,91,75,0,287,287,44.0,0.0,-44.0,402500.0,0.0,-402500.0
<a href=/player/brobp101>brobp101</a>,Pete Broberg,Texas Rangers,RNGRS,1,1,1,2,1974,1976,2,No,0,1.7,-0.25,-1.95,58,25,-33,0,0,0,938.0,280.0,-658.0,0.0,0.0,0.0
<a href=/player/brobp101>brobp101</a>,Pete Broberg,Seattle Mariners,MARNRS,1,1,1,2,1977,1979,2,No,0,0.1,0.8,0.7,44,49,5,6,0,-6,108.0,320.0,212.0,0.0,0.0,0.0
<a href=/player/brobp101>brobp101</a>,Pete Broberg,Chicago Cubs,CUBS,2,3,3,6,1978,1979,1,No,0,3.42,0.91,-2.51,833,109,-724,2458,294,-2164,497.0,0.0,-497.0,0.0,0.0,0.0
<a href=/player/brocc001>brocc001</a>,Chris Brock,San Francisco Giants,GIANTS,2,3,2,5,1999,2001,2,No,0,1.19,2.34,1.15,171,189,18,20,469,449,378.0,103.0,-275.0,525000.0,0.0,-525000.0
<a href=/player/brocc001>brocc001</a>,Chris Brock,Philadelphia Phillies,PHILS,1,1,1,2,2001,2001,0,No,0,0.12,0.0,-0.12,24,0,-24,2,0,-2,132.0,0.0,-132.0,700000.0,0.0,-700000.0
<a href=/player/brocd001>brocd001</a>,Doug Brocail,San Diego Padres,PADRS,16,32,32,64,1994,2010,16,No,6,18.63,52.35,33.72,3699,4432,733,12670,15324,2654,1244.0,1789.0,545.0,25389800.0,0.0,-25389800.0
<a href=/player/brocd001>brocd001</a>,Doug Brocail,Houston Astros,ASTROS,6,12,18,30,1996,2004,8,No,0,25.8,6.98,-18.82,2221,1542,-679,3937,2959,-978,4263.0,3434.0,-829.0,7155000.0,0.0,-7155000.0
<a href=/player/brocd001>brocd001</a>,Doug Brocail,Detroit Tigers,TIGRS,2,4,4,8,2000,2002,2,No,1,3.02,0.94,-2.08,1389,171,-1218,3537,610,-2927,741.0,454.0,-287.0,5550000.0,0.0,-5550000.0
<a href=/player/brocg001>brocg001</a>,Greg Brock,Los Angeles Dodgers,DOGRS,3,4,5,9,1986,1993,7,No,0,7.41,17.7,10.29,892,1640,748,3202,3057,-145,269.0,2632.0,2363.0,3695000.0,0.0,-3695000.0
<a href=/player/brocl102>brocl102</a>,Lou Brock,Chicago Cubs,CUBS,2,4,4,8,1964,1966,2,No,0,41.31,1.04,-40.27,2470,267,-2203,10220,596,-9624,9.0,335.0,326.0,12000.0,0.0,-12000.0
<a href=/player/broct001>broct001</a>,Tarrik Brock,Colorado Rockies,ROCKS,1,1,2,3,1999,1999,0,No,0,-0.11,0.0,0.11,13,0,-13,16,0,-16,0.0,0.0,0.0,0.0,0.0,0.0
<a href=/player/brodb001>brodb001</a>,Brian Broderick,Anaheim Angels,ANGELS,1,1,1,2,2014,2016,2,No,0,0.0,1.39,1.39,0,228,228,0,869,869,0.0,0.0,0.0,0.0,0.0,0.0
<a href=/player/brodd101>brodd101</a>,Dick Brodowski,Boston Red Sox,RSOX,2,7,5,12,1955,1963,8,No,0,0.69,2.88,2.19,731,424,-307,812,1170,358,1712.0,707.0,-1005.0,7000.0,0.0,-7000.0
<a href=/player/brodd101>brodd101</a>,Dick Brodowski,Washington Senators,TWINS,1,2,1,3,1957,1957,0,No,0,0.92,-0.4,-1.32,46,96,50,9,331,322,120.0,0.0,-120.0,8000.0,0.0,-8000.0
<a href=/player/brods101>brods101</a>,Steve Brodie,Baltimore Orioles,BLN,2,4,6,10,1896,1903,7,No,0,2.95,7.66,4.71,454,485,31,1885,2090,205,0.0,0.0,0.0,0.0,0.0,0.0
<a href=/player/broge101>broge101</a>,Ernie Broglio,San Francisco Giants,GIANTS,2,4,4,8,1958,1961,3,No,0,20.2,2.2,-18.0,530,255,-275,497,641,144,4103.0,59.0,-4044.0,0.0,0.0,0.0
<a href=/player/broge101>broge101</a>,Ernie Broglio,St. Louis Cardinals,CARDS,1,3,3,6,1964,1965,1,No,0,-0.83,5.23,6.06,340,107,-233,612,464,-148,674.0,9.0,-665.0,0.0,0.0,0.0
<a href=/player/brogr001>brogr001</a>,Rico Brogna,Detroit Tigers,TIGRS,1,1,1,2,1994,1995,1,No,0,3.42,0.0,-3.42,228,0,-228,889,0,-889,0.0,0.0,0.0,0.0,0.0,0.0
<a href=/player/brogr001>brogr001</a>,Rico Brogna,New York Mets,METS,2,2,3,5,1996,1997,1,No,0,-3.03,-0.84,2.19,499,87,-412,2022,2,-2020,10.0,148.0,138.0,587500.0,0.0,-587500.0
<a href=/player/brohj101>brohj101</a>,Jack Brohamer,Cleveland Indians,INDINS,15,22,32,54,1975,2011,36,No,4,65.06,138.16,73.1,2581,5574,2993,7803,17935,10132,7208.0,16506.0,9298.0,2352500.0,0.0,-2352500.0
<a href=/player/broht001>broht001</a>,Troy Brohawn,San Francisco Giants,GIANTS,2,3,3,6,1998,2006,8,No,0,0.78,7.92,7.14,162,796,634,1,75,74,211.0,1209.0,998.0,3050000.0,0.0,-3050000.0
<a href=/player/bronj001>bronj001</a>,Jeff Bronkey,Texas Rangers,RNGRS,1,1,1,2,1994,1994,0,No,0,0.5,0.0,-0.5,24,0,-24,0,0,0,99.0,0.0,-99.0,0.0,0.0,0.0
<a href=/player/brooa001>brooa001</a>,Aaron Brooks,Kansas City Royals,ROYALS,1,2,2,4,2015,2015,0,No,0,11.48,1.17,-10.31,167,59,-108,19,264,245,2493.0,0.0,-2493.0,0.0,0.0,0.0
<a href=/player/brooa001>brooa001</a>,Aaron Brooks,Oakland Athletics,ATLTCS,2,2,2,4,2016,2016,0,No,0,0.6,-1.55,-2.15,48,67,19,128,191,63,0.0,0.0,0.0,0.0,0.0,0.0
<a href=/player/broob101>broob101</a>,Bobby Brooks,Detroit Tigers,TIGRS,1,1,1,2,1973,1979,6,No,0,-0.04,1.22,1.26,4,77,73,7,200,193,0.0,0.0,0.0,0.0,0.0,0.0
<a href=/player/broof001>broof001</a>,Frank Brooks,Philadelphia Phillies,PHILS,1,1,2,3,2003,2003,0,No,0,0.01,-0.52,-0.53,22,56,34,1,0,-1,52.0,77.0,25.0,0.0,0.0,0.0
<a href=/player/brooh001>brooh001</a>,Hubie Brooks,New York Mets,METS,1,4,1,5,1984,1989,5,No,0,17.64,11.38,-6.26,1847,600,-1247,5919,2448,-3471,1489.0,0.0,-1489.0,356000.0,0.0,-356000.0
<a href=/player/brooh001>brooh001</a>,Hubie Brooks,Los Angeles Dodgers,DOGRS,2,5,4,9,1990,1998,8,No,0,-0.32,5.35,5.67,932,589,-343,3120,151,-2969,618.0,1944.0,1326.0,1584667.0,0.0,-1584667.0
<a href=/player/brooh001>brooh001</a>,Hubie Brooks,New York Mets,METS,2,2,2,4,1991,1994,3,No,0,-1.41,0.9,2.31,171,239,68,497,481,-16,0.0,394.0,394.0,2816666.0,0.0,-2816666.0
<a href=/player/brooi101>brooi101</a>,Ike Brookens,Kansas City Royals,ROYALS,2,2,2,4,1970,1972,2,No,0,1.74,0.0,-1.74,121,0,-121,14,0,-14,570.0,0.0,-570.0,0.0,0.0,0.0
<a href=/player/brooi101>brooi101</a>,Ike Brookens,St. Louis Cardinals,CARDS,1,1,1,2,1974,1974,0,No,0,0.03,0.0,-0.03,3,0,-3,0,0,0,31.0,0.0,-31.0,0.0,0.0,0.0
<a href=/player/broom101>broom101</a>,Mandy Brooks,Columbus,Columbus,1,1,2,3,1925,1925,0,No,0,1.18,0.0,-1.18,116,0,-116,435,0,-435,0.0,0.0,0.0,0.0,0.0,0.0
<a href=/player/broom101>broom101</a>,Mandy Brooks,Chicago Cubs,CUBS,1,2,1,3,1926,1929,3,No,0,0.0,3.23,3.23,0,164,164,0,554,554,0.0,0.0,0.0,0.0,0.0,0.0
<a href=/player/broot001>broot001</a>,Tom Brookens,Detroit Tigers,TIGRS,1,1,1,2,1989,1989,0,No,0,-1.23,-0.99,0.24,66,19,-47,183,0,-183,0.0,200.0,200.0,0.0,0.0,0.0
<a href=/player/brosj101>brosj101</a>,Jim Brosnan,Chicago Cubs,CUBS,2,4,2,6,1958,1961,3,No,0,6.95,8.63,1.68,339,510,171,491,2091,1600,1652.0,0.0,-1652.0,0.0,0.0,0.0
<a href=/player/brosj101>brosj101</a>,Jim Brosnan,St. Louis Cardinals,CARDS,1,1,1,2,1959,1959,0,No,0,6.21,-0.5,-6.71,380,23,-357,65,3,-62,995.0,53.0,-942.0,0.0,0.0,0.0
<a href=/player/brosj101>brosj101</a>,Jim Brosnan,Cincinnati Reds,REDS,1,1,1,2,1963,1963,0,No,0,1.23,0.02,-1.21,90,62,-28,13,3,-10,219.0,129.0,-90.0,0.0,0.0,0.0
<a href=/player/brosm001>brosm001</a>,Michael Brosseau,Tampa Bay Devil Rays,RAYS,1,1,1,2,2021,2021,0,Yes,0,0.0,0.0,0.0,0,0,0,0,0,0,0.0,0.0,0.0,0.0,0.0,0.0
<a href=/player/bross001>bross001</a>,Scott Brosius,Oakland Athletics,ATLTCS,4,5,7,12,1997,2012,15,No,0,16.92,23.71,6.79,998,1203,205,3641,4574,933,228.0,1280.0,1052.0,11612500.0,0.0,-11612500.0
<a href=/player/brost001>brost001</a>,Terry Bross,New York Mets,METS,1,1,1,2,1992,1992,0,No,0,0.0,0.0,0.0,0,0,0,0,0,0,0.0,0.0,0.0,0.0,0.0,0.0
<a href=/player/brost001>brost001</a>,Terry Bross,San Diego Padres,PADRS,1,1,1,2,1992,1993,1,No,0,0.0,0.01,0.01,0,55,55,0,5,5,0.0,95.0,95.0,0.0,0.0,0.0
<a href=/player/brotr001>brotr001</a>,Rex Brothers,Colorado Rockies,ROCKS,1,1,1,2,2015,2015,0,Yes,0,-0.32,0.0,0.32,114,0,-114,2,0,-2,169.0,0.0,-169.0,1400000.0,0.0,-1400000.0
<a href=/player/brott101>brott101</a>,Tony Brottem,LittleRock,LittleRock,1,2,2,4,1920,1920,0,No,0,1.39,0.0,-1.39,118,0,-118,471,0,-471,0.0,0.0,0.0,0.0,0.0,0.0
<a href=/player/broub001>broub001</a>,Ben Broussard,Cincinnati Reds,REDS,1,1,1,2,2002,2003,1,No,0,6.04,1.85,-4.19,524,158,-366,1827,460,-1367,0.0,0.0,0.0,0.0,0.0,0.0
<a href=/player/broub001>broub001</a>,Ben Broussard,Cleveland Indians,INDINS,5,10,13,23,2006,2019,13,Yes,0,8.81,45.3,36.49,531,1622,1091,1707,3842,2135,399.0,4479.0,4080.0,25451400.0,0.0,-25451400.0
<a href=/player/broub001>broub001</a>,Ben Broussard,Seattle Mariners,MARNRS,1,1,1,2,2007,2009,2,No,0,-0.96,-0.19,0.77,26,30,4,89,56,-33,0.0,0.0,0.0,3550000.0,0.0,-3550000.0
<a href=/player/broud101>broud101</a>,Dan Brouthers,Brooklyn Dodgers,DOGRS,1,2,2,4,1894,1896,2,No,0,29.72,4.69,-25.03,772,328,-444,3764,1481,-2283,0.0,0.0,0.0,0.0,0.0,0.0
<a href=/player/brovj101>brovj101</a>,Joe Brovia,Oakland,Oakland,1,1,2,3,1955,1955,0,No,0,0.0,0.0,0.0,21,0,-21,20,0,-20,0.0,0.0,0.0,0.0,0.0,0.0
<a href=/player/browa002>browa002</a>,Andrew Brown,Atlanta Braves,BRAVES,1,3,1,4,2002,2003,1,No,0,12.57,11.23,-1.34,452,290,-162,1035,1257,222,2316.0,0.0,-2316.0,0.0,0.0,0.0
<a href=/player/browa002>browa002</a>,Andrew Brown,Los Angeles Dodgers,DOGRS,2,4,2,6,2004,2017,13,No,0,6.58,25.96,19.38,465,1671,1206,1473,6338,4865,30.0,0.0,-30.0,2830000.0,0.0,-2830000.0
<a href=/player/browa002>browa002</a>,Andrew Brown,Cleveland Indians,INDINS,1,2,1,3,2006,2009,3,No,0,5.38,-0.48,-5.86,440,159,-281,1775,497,-1278,0.0,0.0,0.0,0.0,0.0,0.0
<a href=/player/browa002>browa002</a>,Andrew Brown,San Diego Padres,PADRS,1,1,2,3,2007,2007,0,No,0,0.57,1.87,1.3,65,42,-23,0,169,169,230.0,0.0,-230.0,0.0,0.0,0.0
<a href=/player/browb001>browb001</a>,Bobby Brown,Philadelphia Phillies,PHILS,1,2,1,3,1978,1980,2,No,0,1.16,-1.2,-2.36,257,146,-111,709,10,-699,0.0,369.0,369.0,0.0,0.0,0.0
<a href=/player/browb001>browb001</a>,Bobby Brown,New York Yankees,YANKS,3,6,4,10,1982,1987,5,No,0,15.14,5.21,-9.93,593,176,-417,734,188,-546,3682.0,1574.0,-2108.0,62500.0,0.0,-62500.0
<a href=/player/browb002>browb002</a>,Bob Brower,Texas Rangers,RNGRS,1,1,1,2,1988,1988,0,No,0,1.28,0.0,-1.28,26,0,-26,75,0,-75,0.0,0.0,0.0,98000.0,0.0,-98000.0
<a href=/player/browb003>browb003</a>,Brant Brown,Chicago Cubs,CUBS,1,1,1,2,1998,2002,4,No,0,-1.3,12.67,13.97,130,237,107,371,300,-71,0.0,2483.0,2483.0,180000.0,0.0,-180000.0
<a href=/player/browb003>browb003</a>,Brant Brown,Pittsburgh Pirates,PIRATS,1,1,1,2,1999,2000,1,No,0,-0.44,-0.36,0.08,41,72,31,76,153,77,0.0,0.0,0.0,290000.0,0.0,-290000.0
<a href=/player/browb003>browb003</a>,Brant Brown,Florida Marlins,MARLNS,1,1,1,2,2000,2002,2,No,0,0.0,3.16,3.16,0,67,67,0,70,70,0.0,632.0,632.0,315000.0,0.0,-315000.0
<a href=/player/browb003>browb003</a>,Brant Brown,Texas Rangers,RNGRS,2,2,2,4,2000,2001,1,No,0,0.12,0.5,0.38,101,38,-63,308,134,-174,0.0,0.0,0.0,0.0,0.0,0.0
<a href=/player/browb005>browb005</a>,Brooks Brown,Arizona Diamondbacks,DBACKS,1,1,1,2,2009,2009,0,No,0,0.0,0.0,0.0,0,0,0,0,0,0,0.0,0.0,0.0,0.0,0.0,0.0
<a href=/player/browb101>browb101</a>,Byron Browne,Chicago Cubs,CUBS,1,1,1,2,1968,1968,0,No,0,0.08,0.0,-0.08,10,0,-10,17,0,-17,0.0,0.0,0.0,0.0,0.0,0.0
<a href=/player/browb101>browb101</a>,Byron Browne,St. Louis Cardinals,CARDS,30,57,53,110,1969,1998,29,No,7,115.3,176.27,60.97,11163,8552,-2611,30164,29400,-764,12224.0,4453.0,-7771.0,3323333.0,0.0,-3323333.0
<a href=/player/browb101>browb101</a>,Byron Browne,Philadelphia Phillies,PHILS,1,1,1,2,1972,1972,0,No,0,0.0,0.0,0.0,0,0,0,0,0,0,0.0,0.0,0.0,0.0,0.0,0.0
<a href=/player/browb102>browb102</a>,Buster Brown,St. Louis Cardinals,CARDS,1,1,1,2,1907,1907,0,No,0,0.92,1.27,0.35,63,55,-8,67,83,16,484.0,430.0,-54.0,0.0,0.0,0.0
<a href=/player/browb102>browb102</a>,Buster Brown,Philadelphia Phillies,PHILS,13,27,30,57,1909,1931,22,No,0,110.35,96.74,-13.61,5407,5417,10,17248,19665,2417,13600.0,6282.0,-7318.0,25000.0,0.0,-25000.0
<a href=/player/browb102>browb102</a>,Buster Brown,Boston Braves,BRAVES,1,2,1,3,1913,1927,14,No,0,0.0,23.58,23.58,0,555,555,0,778,778,0.0,6096.0,6096.0,2400.0,0.0,-2400.0
<a href=/player/browc001>browc001</a>,Curt Brown,California Angels,ANGELS,1,1,1,2,1983,1983,0,No,0,0.53,0.0,-0.53,13,0,-13,0,0,0,50.0,0.0,-50.0,0.0,0.0,0.0
<a href=/player/browc001>browc001</a>,Curt Brown,Milwaukee Brewers,BREWRS,1,1,1,2,1987,1987,0,No,0,0.0,0.0,0.0,0,0,0,0,0,0,0.0,0.0,0.0,0.0,0.0,0.0
<a href=/player/browc002>browc002</a>,Chris Brown,San Francisco Giants,GIANTS,7,13,17,30,1987,1998,11,No,2,21.03,37.78,16.75,1321,2343,1022,1429,4032,2603,4080.0,4148.0,68.0,9879278.0,0.0,-9879278.0
<a href=/player/browc002>browc002</a>,Chris Brown,San Diego Padres,PADRS,2,4,3,7,1988,1990,2,No,0,-0.11,0.47,0.58,120,230,110,406,663,257,249.0,443.0,194.0,2283333.0,0.0,-2283333.0
<a href=/player/browc003>browc003</a>,Corey Brown,Oakland Athletics,ATLTCS,9,15,12,27,2010,2018,8,Yes,2,7.39,2.24,-5.15,868,456,-412,2078,1439,-639,442.0,312.0,-130.0,8300001.0,0.0,-8300001.0
<a href=/player/browc102>browc102</a>,Curtis Brown,New York Mets,METS,1,4,1,5,1971,1974,3,No,0,-0.13,-1.66,-1.53,1,64,63,4,139,135,0.0,0.0,0.0,0.0,0.0,0.0
<a href=/player/browc103>browc103</a>,Clint Brown,Chicago White Sox,WSOX,1,1,1,2,1941,1945,4,No,0,0.77,8.14,7.37,96,244,148,20,301,281,250.0,2436.0,2186.0,0.0,0.0,0.0
<a href=/player/browc105>browc105</a>,Cal Browning,St. Louis Cardinals,CARDS,1,4,1,5,1960,1961,1,No,0,0.0,0.08,0.08,0,58,58,0,21,21,0.0,225.0,225.0,0.0,0.0,0.0
<a href=/player/browd001>browd001</a>,Darrell Brown,Detroit Tigers,TIGRS,1,3,2,5,1982,1982,0,No,0,-0.02,0.0,0.02,8,0,-8,20,0,-20,0.0,0.0,0.0,0.0,0.0,0.0
<a href=/player/browd102>browd102</a>,Dick Brown,Cleveland Indians,INDINS,6,11,11,22,1959,1968,9,No,0,95.02,18.27,-76.75,3674,1436,-2238,12659,5344,-7315,4502.0,50.0,-4452.0,0.0,0.0,0.0
<a href=/player/browd102>browd102</a>,Dick Brown,Milwaukee Braves,BRAVES,1,4,2,6,1960,1966,6,No,0,17.87,5.81,-12.06,1212,765,-447,3111,2935,-176,1033.0,0.0,-1033.0,0.0,0.0,0.0
<a href=/player/browd102>browd102</a>,Dick Brown,Detroit Tigers,TIGRS,3,5,6,11,1962,1970,8,No,0,33.85,17.8,-16.05,894,735,-159,1860,1781,-79,4562.0,2945.0,-1617.0,39000.0,0.0,-39000.0
<a href=/player/browe001>browe001</a>,Emil Brown,Pittsburgh Pirates,PIRATS,1,1,2,3,2001,2003,2,No,0,-0.2,0.0,0.2,13,0,-13,15,0,-15,0.0,0.0,0.0,265000.0,0.0,-265000.0
<a href=/player/browe101>browe101</a>,Elmer Brown,St.Louis Browns,ORLS,2,6,5,11,1912,1924,12,No,0,0.0,-0.88,-0.88,0,143,143,0,396,396,0.0,10.0,10.0,0.0,0.0,0.0
<a href=/player/browe102>browe102</a>,Eddie Brown,Indianapolis,Indianapolis,1,1,2,3,1924,1924,0,No,0,3.15,0.0,-3.15,267,0,-267,1155,0,-1155,0.0,0.0,0.0,0.0,0.0,0.0
<a href=/player/browe102>browe102</a>,Eddie Brown,Brooklyn Dodgers,DOGRS,2,5,4,9,1925,1927,2,No,0,6.65,0.24,-6.41,787,339,-448,3022,1227,-1795,0.0,0.0,0.0,27500.0,0.0,-27500.0
<a href=/player/browe102>browe102</a>,Eddie Brown,New York Giants,GIANTS,1,5,1,6,1921,1924,3,No,0,0.0,-0.65,-0.65,0,89,89,0,166,166,0.0,0.0,0.0,1500.0,0.0,-1500.0
<a href=/player/browe104>browe104</a>,Earl Browne,Pittsburgh Pirates,PIRATS,2,2,2,4,1937,1942,5,No,0,0.24,3.74,3.5,126,336,210,440,322,-118,0.0,1889.0,1889.0,0.0,0.0,0.0
<a href=/player/browf102>browf102</a>,Frank Brower,Washington Senators,TWINS,1,1,1,2,1923,1924,1,No,0,4.25,-0.16,-4.41,196,106,-90,615,421,-194,26.0,0.0,-26.0,0.0,0.0,0.0
<a href=/player/browf102>browf102</a>,Frank Brower,Reading,Reading,1,1,2,3,1920,1920,0,No,0,3.18,0.0,-3.18,258,0,-258,916,0,-916,0.0,0.0,0.0,0.0,0.0,0.0
<a href=/player/browg102>browg102</a>,George Browne,New York Giants,GIANTS,4,11,6,17,1907,1921,14,No,0,45.64,34.38,-11.26,2445,1600,-845,8369,5323,-3046,1733.0,2915.0,1182.0,6400.0,0.0,-6400.0
<a href=/player/browh101>browh101</a>,Hal Brown,Seattle,Seattle,1,2,4,6,1951,1954,3,No,0,0.74,0.0,-0.74,138,0,-138,86,0,-86,741.0,0.0,-741.0,0.0,0.0,0.0
<a href=/player/browh101>browh101</a>,Hal Brown,Chicago White Sox,WSOX,1,3,1,4,1953,1953,0,No,0,1.18,-0.21,-1.39,202,44,-158,118,143,25,1116.0,0.0,-1116.0,0.0,0.0,0.0
<a href=/player/browh101>browh101</a>,Hal Brown,Boston Red Sox,RSOX,1,2,2,4,1949,1950,1,No,0,0.0,-0.68,-0.68,0,28,28,0,12,12,0.0,68.0,68.0,0.0,0.0,0.0
<a href=/player/browj001>browj001</a>,Jerry Browne,Texas Rangers,RNGRS,1,3,1,4,1988,1993,5,No,0,6.72,20.24,13.52,624,632,8,2545,2680,135,0.0,0.0,0.0,930000.0,0.0,-930000.0
<a href=/player/browj003>browj003</a>,Jim Brower,Cleveland Indians,INDINS,1,2,1,3,2000,2002,2,No,0,2.43,-0.3,-2.73,134,52,-82,33,128,95,506.0,0.0,-506.0,0.0,0.0,0.0
<a href=/player/browj003>browj003</a>,Jim Brower,Cincinnati Reds,REDS,1,1,1,2,2002,2003,1,No,0,-0.01,-0.14,-0.13,60,78,18,5,4,-1,123.0,119.0,-4.0,250000.0,0.0,-250000.0
<a href=/player/browj003>browj003</a>,Jim Brower,Montreal Expos,NATEX,2,4,5,9,2003,2011,8,No,0,4.63,14.95,10.32,424,496,72,130,594,464,1491.0,3711.0,2220.0,8000000.0,0.0,-8000000.0
<a href=/player/browj003>browj003</a>,Jim Brower,San Diego Padres,PADRS,1,1,1,2,2006,2006,0,No,0,0.0,0.0,0.0,0,0,0,0,0,0,0.0,0.0,0.0,0.0,0.0,0.0
<a href=/player/browj004>browj004</a>,Jamie Brown,Cleveland Indians,INDINS,1,1,1,2,2003,2003,0,No,0,-0.08,0.2,0.28,4,32,28,0,80,80,23.0,0.0,-23.0,0.0,0.0,0.0
<a href=/player/browj102>browj102</a>,Joe Brown,OklahomaCity,OklahomaCity,1,2,1,3,1924,1924,0,No,0,0.53,0.0,-0.53,98,0,-98,46,0,-46,457.0,0.0,-457.0,0.0,0.0,0.0
<a href=/player/browj105>browj105</a>,Jake Brown,San Francisco Giants,GIANTS,5,10,8,18,1976,1995,19,No,1,14.15,26.8,12.65,1367,2042,675,3556,6654,3098,4215.0,726.0,-3489.0,1545000.0,0.0,-1545000.0
<a href=/player/browj108>browj108</a>,Jim Brown,Harrisburg,Harrisburg,1,1,1,2,1916,1919,3,No,0,0.1,0.0,-0.1,14,0,-14,49,0,-49,0.0,0.0,0.0,0.0,0.0,0.0
<a href=/player/browj109>browj109</a>,Jackie Brown,Texas Rangers,RNGRS,2,5,3,8,1975,1978,3,No,0,27.68,13.0,-14.68,537,88,-449,186,0,-186,7504.0,2017.0,-5487.0,60000.0,0.0,-60000.0
<a href=/player/browj109>browj109</a>,Jackie Brown,Cleveland Indians,INDINS,1,1,1,2,1976,1987,11,No,0,-0.41,19.05,19.46,84,1225,1141,61,5096,5035,557.0,0.0,-557.0,0.0,0.0,0.0
<a href=/player/browj110>browj110</a>,Jumbo Brown,New York Giants,GIANTS,1,2,1,3,1941,1941,0,No,0,0.0,0.38,0.38,0,4,4,0,6,6,0.0,46.0,46.0,0.0,0.0,0.0
<a href=/player/browk001>browk001</a>,Kevin Brown,Florida Marlins,MARLNS,16,30,39,69,1997,2019,22,Yes,0,140.21,119.59,-20.62,4768,6251,1483,12938,20835,7897,15799.0,8180.0,-7619.0,60053667.0,0.0,-60053667.0
<a href=/player/browk001>browk001</a>,Kevin Brown,Los Angeles Dodgers,DOGRS,3,4,7,11,2003,2010,7,No,2,3.08,10.28,7.2,494,590,96,1052,1051,-1,897.0,1677.0,780.0,16106786.0,0.0,-16106786.0
<a href=/player/browk003>browk003</a>,Kevin Brown,Atlanta Braves,BRAVES,1,1,1,2,1987,1989,2,No,0,0.06,-0.65,-0.71,4,93,89,0,242,242,6.0,3.0,-3.0,0.0,0.0,0.0
<a href=/player/browk003>browk003</a>,Kevin Brown,New York Mets,METS,2,3,3,6,1990,2008,18,No,1,2.61,2.24,-0.37,84,232,148,0,659,659,559.0,0.0,-559.0,200000.0,0.0,-200000.0
<a href=/player/browk004>browk004</a>,Kevin Brown,Texas Rangers,RNGRS,1,1,1,2,1998,2001,3,No,0,0.48,2.76,2.28,54,234,180,137,1,-136,0.0,762.0,762.0,0.0,0.0,0.0
<a href=/player/browk004>browk004</a>,Kevin Brown,Toronto Blue Jays,BJAYS,1,1,1,2,2000,2000,0,No,0,0.07,0.0,-0.07,22,0,-22,64,0,-64,0.0,0.0,0.0,0.0,0.0,0.0
<a href=/player/browl101>browl101</a>,Lloyd Brown,Washington Senators,TWINS,3,6,5,11,1932,1936,4,No,0,25.58,12.35,-13.23,1434,628,-806,5873,2235,-3638,390.0,1249.0,859.0,38000.0,0.0,-38000.0
<a href=/player/browl101>browl101</a>,Lloyd Brown,St.Louis Browns,ORLS,2,3,3,6,1933,1935,2,No,0,12.74,1.35,-11.39,735,162,-573,2638,528,-2110,489.0,0.0,-489.0,13500.0,0.0,-13500.0
<a href=/player/browl101>browl101</a>,Lloyd Brown,Boston Red Sox,RSOX,4,5,5,10,1933,1943,10,No,0,28.33,10.21,-18.12,1088,690,-398,3483,1043,-2440,1883.0,3526.0,1643.0,22500.0,0.0,-22500.0
<a href=/player/browl103>browl103</a>,Leon Brown,San Francisco Giants,GIANTS,1,1,1,2,1976,1976,0,No,0,-0.35,0.0,0.35,64,0,-64,74,0,-74,0.0,0.0,0.0,0.0,0.0,0.0
<a href=/player/browl103>browl103</a>,Leon Brown,New York Mets,METS,1,2,1,3,1976,1976,0,No,0,0.0,0.0,0.0,0,0,0,0,0,0,0.0,0.0,0.0,0.0,0.0,0.0
<a href=/player/browl105>browl105</a>,Lindsay Brown,Detroit Tigers,TIGRS,1,2,1,3,1937,1937,0,No,0,-0.42,0.0,0.42,48,0,-48,121,0,-121,0.0,0.0,0.0,0.0,0.0,0.0
<a href=/player/browm001>browm001</a>,Mark Brown,Baltimore Orioles,ORLS,3,4,3,7,1985,1988,3,No,1,2.81,0.55,-2.26,479,151,-328,1461,0,-1461,182.0,590.0,408.0,300000.0,0.0,-300000.0
<a href=/player/browm002>browm002</a>,Mike Brown,California Angels,ANGELS,3,5,7,12,1985,1988,3,No,2,1.4,3.61,2.21,825,316,-509,630,678,48,1883.0,911.0,-972.0,800000.0,0.0,-800000.0
<a href=/player/browm003>browm003</a>,Mike Brown,Seattle Mariners,MARNRS,1,1,1,2,1987,1987,0,No,0,0.0,0.0,0.0,0,0,0,0,0,0,0.0,0.0,0.0,0.0,0.0,0.0
<a href=/player/browm003>browm003</a>,Mike Brown,Boston Red Sox,RSOX,3,7,5,12,1986,1993,7,No,0,7.37,8.49,1.12,984,1130,146,3351,3154,-197,369.0,1455.0,1086.0,1275000.0,0.0,-1275000.0
<a href=/player/browm102>browm102</a>,Mordecai Brown,St. Louis Cardinals,CARDS,4,6,9,15,1903,1914,11,No,0,50.1,19.67,-30.43,1069,1341,272,1762,4083,2321,8426.0,5469.0,-2957.0,2400.0,0.0,-2400.0
<a href=/player/browm102>browm102</a>,Mordecai Brown,Louisville,Louisville,1,1,1,2,1913,1921,8,No,0,1.62,0.0,-1.62,78,0,-78,58,0,-58,500.0,0.0,-500.0,0.0,0.0,0.0
<a href=/player/browm103>browm103</a>,Mace Brown,Brooklyn Dodgers,DOGRS,2,3,2,5,1941,1948,7,No,0,4.66,22.35,17.69,178,627,449,598,2568,1970,0.0,0.0,0.0,0.0,0.0,0.0
<a href=/player/brown101>brown101</a>,Norm Brown,Boston Red Sox,RSOX,1,2,2,4,1943,1943,0,No,0,-0.43,0.0,0.43,10,0,-10,3,0,-3,43.0,0.0,-43.0,0.0,0.0,0.0
<a href=/player/browo102>browo102</a>,Ollie Brown,San Diego Padres,PADRS,3,3,5,8,1972,1972,0,No,0,2.68,-0.33,-3.01,590,123,-467,1233,221,-1012,180.0,13.0,-167.0,36000.0,0.0,-36000.0
<a href=/player/browo102>browo102</a>,Ollie Brown,Milwaukee Brewers,BREWRS,3,7,7,14,1973,1978,5,No,0,7.23,1.8,-5.43,546,209,-337,1533,327,-1206,524.0,1634.0,1110.0,168301.0,0.0,-168301.0
<a href=/player/browr001>browr001</a>,Roosevelt Brown,Atlanta Braves,BRAVES,1,1,1,2,1996,1996,0,No,0,0.0,-1.29,-1.29,0,42,42,0,177,177,0.0,0.0,0.0,0.0,0.0,0.0
<a href=/player/brows002>brows002</a>,Scott Brow,Arizona Diamondbacks,DBACKS,1,2,1,3,1998,1998,0,No,0,0.0,0.27,0.27,0,64,64,0,1,1,0.0,131.0,131.0,225000.0,0.0,-225000.0
<a href=/player/brows101>brows101</a>,Scott Brown,Cincinnati Reds,REDS,1,1,1,2,1981,1982,1,No,0,0.0,-0.43,-0.43,0,19,19,0,37,37,0.0,0.0,0.0,0.0,0.0,0.0
<a href=/player/brows103>brows103</a>,Sam Brown,Toledo,Toledo,1,1,1,2,1905,1905,0,No,0,0.19,0.0,-0.19,141,0,-141,489,0,-489,0.0,0.0,0.0,0.0,0.0,0.0
<a href=/player/browt102>browt102</a>,Tom Brown,Louisville Colonels,LS3,1,1,1,2,1895,1895,0,No,0,-0.94,-0.52,0.42,84,113,29,407,511,104,0.0,0.0,0.0,0.0,0.0,0.0
<a href=/player/browt103>browt103</a>,Tommy Brown,Brooklyn Dodgers,DOGRS,1,1,2,3,1951,1951,0,No,0,-0.41,0.0,0.41,96,0,-96,243,0,-243,0.0,0.0,0.0,9000.0,0.0,-9000.0
<a href=/player/broxj001>broxj001</a>,Jonathan Broxton,Kansas City Royals,ROYALS,1,1,2,3,2012,2014,2,No,0,1.66,0.16,-1.5,219,7,-212,0,0,0,304.0,19.0,-285.0,4000000.0,0.0,-4000000.0
<a href=/player/broxj001>broxj001</a>,Jonathan Broxton,Cincinnati Reds,REDS,1,1,2,3,2014,2018,4,Yes,0,-0.55,-0.21,0.34,98,61,-37,0,4,4,141.0,116.0,-25.0,0.0,0.0,0.0
<a href=/player/broxj001>broxj001</a>,Jonathan Broxton,Milwaukee Brewers,BREWRS,1,2,1,3,2015,2015,0,Yes,0,0.24,0.0,-0.24,219,0,-219,0,0,0,300.0,0.0,-300.0,0.0,0.0,0.0
<a href=/player/broxk001>broxk001</a>,Keon Broxton,Pittsburgh Pirates,PIRATS,1,2,1,3,2015,2017,2,No,0,4.25,-0.14,-4.39,269,23,-246,796,33,-763,0.0,0.0,0.0,0.0,0.0,0.0
<a href=/player/broxk001>broxk001</a>,Keon Broxton,Milwaukee Brewers,BREWRS,2,3,4,7,2019,2021,2,Yes,0,-0.49,-0.15,0.34,34,3,-31,53,0,-53,0.0,7.0,7.0,0.0,0.0,0.0
<a href=/player/broxk001>broxk001</a>,Keon Broxton,New York Mets,METS,1,1,1,2,2019,2019,0,No,0,0.12,0.0,-0.12,37,0,-37,112,0,-112,0.0,0.0,0.0,571765.0,0.0,-571765.0
<a href=/player/brubb102>brubb102</a>,Bruce Brubaker,Milwaukee Braves,BRAVES,5,10,5,15,1963,1983,20,No,0,3.41,33.61,30.2,551,1293,742,1018,2898,1880,1041.0,6668.0,5627.0,33500.0,0.0,-33500.0
<a href=/player/brubb102>brubb102</a>,Bruce Brubaker,Los Angeles Dodgers,DOGRS,1,1,1,2,1970,1970,0,No,0,-0.04,-0.2,-0.16,2,6,4,0,1,1,6.0,20.0,14.0,0.0,0.0,0.0
<a href=/player/brucb101>brucb101</a>,Bob Bruce,Detroit Tigers,TIGRS,1,2,1,3,1961,1962,1,No,0,12.08,0.99,-11.09,318,60,-258,331,21,-310,2721.0,244.0,-2477.0,0.0,0.0,0.0
<a href=/player/brucb101>brucb101</a>,Bob Bruce,Houston Astros,ASTROS,4,6,8,14,1966,1973,7,No,0,0.01,-1.36,-1.37,310,801,491,266,544,278,544.0,2019.0,1475.0,57500.0,0.0,-57500.0
<a href=/player/brucj001>brucj001</a>,Jay Bruce,Cincinnati Reds,REDS,1,1,2,3,2016,2018,2,Yes,0,1.81,-0.19,-2.0,247,53,-194,996,97,-899,0.0,0.0,0.0,0.0,0.0,0.0
<a href=/player/brucj001>brucj001</a>,Jay Bruce,New York Mets,METS,2,2,2,4,2017,2021,4,Yes,0,0.26,0.14,-0.12,43,15,-28,169,51,-118,0.0,3.0,3.0,13000000.0,0.0,-13000000.0
<a href=/player/brucj001>brucj001</a>,Jay Bruce,New York Mets,METS,1,5,3,8,2018,2018,0,Yes,0,-0.49,0.0,0.49,191,0,-191,565,0,-565,376.0,0.0,-376.0,16500000.0,0.0,-16500000.0
<a href=/player/brucj001>brucj001</a>,Jay Bruce,Seattle Mariners,MARNRS,1,2,1,3,2019,2019,0,Yes,0,0.59,0.0,-0.59,83,0,-83,252,0,-252,0.0,0.0,0.0,14000000.0,0.0,-14000000.0
<a href=/player/brucl101>brucl101</a>,Lou Bruce,Toronto,Toronto,1,1,2,3,1903,1903,0,No,0,-0.22,0.0,0.22,32,0,-32,111,0,-111,33.0,0.0,-33.0,0.0,0.0,0.0
<a href=/player/brugf101>brugf101</a>,Frank Bruggy,Portland,Portland,1,1,3,4,1922,1922,0,No,0,-0.89,0.0,0.89,157,0,-157,354,0,-354,0.0,0.0,0.0,0.0,0.0,0.0
<a href=/player/brugf101>brugf101</a>,Frank Bruggy,Buffalo,Buffalo,1,1,1,2,1921,1921,0,No,0,0.6,0.0,-0.6,96,0,-96,306,0,-306,0.0,0.0,0.0,0.0,0.0,0.0
<a href=/player/brugj001>brugj001</a>,Jaycob Brugman,Oakland Athletics,ATLTCS,1,1,1,2,2017,2017,0,Yes,0,0.0,0.0,0.0,0,0,0,0,0,0,0.0,0.0,0.0,0.0,0.0,0.0
<a href=/player/bruhm101>bruhm101</a>,Mike Bruhert,New York Mets,METS,1,2,1,3,1979,1979,0,No,0,0.0,-1.27,-1.27,0,34,34,0,28,28,0.0,255.0,255.0,0.0,0.0,0.0
<a href=/player/brumd001>brumd001</a>,Duff Brumley,St. Louis Cardinals,CARDS,1,1,1,2,1993,1993,0,No,0,-0.16,-0.68,-0.52,2,48,46,0,4,4,10.0,92.0,82.0,0.0,0.0,0.0
<a href=/player/brumg002>brumg002</a>,Greg Brummett,San Francisco Giants,GIANTS,1,3,1,4,1993,1993,0,No,0,0.3,-0.08,-0.38,64,10,-54,0,6,6,230.0,51.0,-179.0,109000.0,0.0,-109000.0
<a href=/player/brumj001>brumj001</a>,Jacob Brumfield,Cincinnati Reds,REDS,2,3,2,5,1994,1995,1,No,0,-0.31,-0.17,0.14,158,12,-146,560,2,-558,0.0,29.0,29.0,170000.0,0.0,-170000.0
<a href=/player/brumj001>brumj001</a>,Jacob Brumfield,Pittsburgh Pirates,PIRATS,1,1,1,2,1996,1996,0,No,0,0.55,0.0,-0.55,210,0,-210,726,0,-726,0.0,0.0,0.0,350000.0,0.0,-350000.0
<a href=/player/brumm001>brumm001</a>,Mike Brumley,Boston Red Sox,RSOX,1,2,1,3,1984,1987,3,No,0,10.18,-0.52,-10.7,204,504,300,312,2176,1864,1592.0,0.0,-1592.0,0.0,0.0,0.0
<a href=/player/brumm001>brumm001</a>,Mike Brumley,Chicago Cubs,CUBS,2,3,4,7,1988,1989,1,No,0,-1.95,-0.22,1.73,155,94,-61,562,6,-556,188.0,131.0,-57.0,0.0,0.0,0.0
<a href=/player/brumm001>brumm001</a>,Mike Brumley,San Diego Padres,PADRS,19,36,38,74,1989,2010,21,No,6,15.89,63.14,47.25,4291,5417,1126,14484,18238,3754,1244.0,2171.0,927.0,26139800.0,0.0,-26139800.0
<a href=/player/brumm001>brumm001</a>,Mike Brumley,Detroit Tigers,TIGRS,1,1,1,2,1990,1990,0,No,0,0.0,-1.02,-1.02,0,131,131,0,390,390,0.0,0.0,0.0,0.0,0.0,0.0
<a href=/player/brunb001>brunb001</a>,Brian Bruney,New York Yankees,YANKS,1,1,1,2,2009,2010,1,No,0,-0.85,0.0,0.85,38,0,-38,0,0,0,53.0,0.0,-53.0,1250000.0,0.0,-1250000.0
<a href=/player/brune001>brune001</a>,Eric Bruntlett,Houston Astros,ASTROS,5,17,11,28,2007,2020,13,No,0,26.64,22.25,-4.39,2124,1522,-602,3444,4092,648,4062.0,2080.0,-1982.0,15247800.0,0.0,-15247800.0
<a href=/player/brung101>brung101</a>,George Brunet,Kansas City Athletics,ATLTCS,1,1,1,2,1960,1960,0,No,0,-0.66,-0.05,0.61,44,20,-24,11,2,-9,164.0,56.0,-108.0,0.0,0.0,0.0
<a href=/player/brung101>brung101</a>,George Brunet,Milwaukee Braves,BRAVES,1,1,1,2,1962,1962,0,No,0,-0.49,0.0,0.49,44,0,-44,22,0,-22,200.0,0.0,-200.0,0.0,0.0,0.0
<a href=/player/brung101>brung101</a>,George Brunet,Milwaukee Brewers,BREWRS,1,1,1,2,1969,1971,2,No,0,-0.24,1.04,1.28,48,56,8,44,2,-42,354.0,106.0,-248.0,35000.0,0.0,-35000.0
<a href=/player/brung101>brung101</a>,George Brunet,Washington Senators,RNGRS,16,35,25,60,1970,1988,18,No,0,48.97,50.37,1.4,3039,3300,261,9915,9913,-2,4425.0,6857.0,2432.0,559500.0,0.0,-559500.0
<a href=/player/brung101>brung101</a>,George Brunet,Pittsburgh Pirates,PIRATS,4,6,8,14,1971,1978,7,No,0,4.65,9.98,5.33,393,854,461,1279,1834,555,673.0,1651.0,978.0,94500.0,0.0,-94500.0
<a href=/player/brunt001>brunt001</a>,Tom Brunansky,California Angels,ANGELS,1,3,2,5,1982,1987,5,No,0,16.27,3.87,-12.4,962,569,-393,3760,1197,-2563,264.0,852.0,588.0,0.0,0.0,0.0
<a href=/player/brunt001>brunt001</a>,Tom Brunansky,Minnesota Twins,TWINS,2,4,3,7,1988,1989,1,No,0,5.46,1.87,-3.59,624,113,-511,2491,345,-2146,0.0,435.0,435.0,1243500.0,0.0,-1243500.0
<a href=/player/brunt001>brunt001</a>,Tom Brunansky,St. Louis Cardinals,CARDS,3,5,5,10,1990,1997,7,No,0,3.57,2.86,-0.71,890,643,-247,2470,186,-2284,209.0,991.0,782.0,9134167.0,0.0,-9134167.0
<a href=/player/brunt001>brunt001</a>,Tom Brunansky,Milwaukee Brewers,BREWRS,1,1,1,2,1994,1994,0,No,0,0.23,0.5,0.27,48,16,-32,204,46,-158,0.0,0.0,0.0,1100000.0,0.0,-1100000.0
<a href=/player/brunt101>brunt101</a>,Tom Bruno,Toronto Blue Jays,BJAYS,1,2,1,3,1978,1981,3,No,0,1.48,1.94,0.46,90,376,286,20,1522,1502,264.0,0.0,-264.0,0.0,0.0,0.0
<a href=/player/brunw001>brunw001</a>,Will Brunson,Cincinnati Reds,REDS,1,1,1,2,1994,1995,1,No,0,-0.13,0.0,0.13,3,0,-3,0,0,0,7.0,0.0,-7.0,0.0,0.0,0.0
<a href=/player/brusj001>brusj001</a>,Jim Bruske,Los Angeles Dodgers,DOGRS,1,1,1,2,1998,1998,0,No,0,-0.02,0.0,0.02,8,0,-8,0,0,0,21.0,0.0,-21.0,200000.0,0.0,-200000.0
<a href=/player/brusj001>brusj001</a>,Jim Bruske,San Diego Padres,PADRS,1,2,2,4,1998,1998,0,No,0,0.16,0.0,-0.16,3,0,-3,0,0,0,27.0,0.0,-27.0,0.0,0.0,0.0
<a href=/player/brusw001>brusw001</a>,Warren Brusstar,Chicago White Sox,WSOX,4,9,10,19,1983,1991,8,No,0,34.9,10.9,-24.0,2508,1101,-1407,7089,2979,-4110,3712.0,567.0,-3145.0,640000.0,0.0,-640000.0
<a href=/player/brutb101>brutb101</a>,Bill Bruton,Milwaukee Braves,BRAVES,1,4,2,6,1960,1966,6,No,0,17.87,5.81,-12.06,1212,765,-447,3111,2935,-176,1033.0,0.0,-1033.0,0.0,0.0,0.0
<a href=/player/bryab101>bryab101</a>,Billy Bryan,Kansas City Athletics,ATLTCS,2,3,5,8,1966,1967,1,No,0,5.45,-1.25,-6.7,785,201,-584,1910,500,-1410,1121.0,300.0,-821.0,25000.0,0.0,-25000.0
<a href=/player/bryad101>bryad101</a>,Don Bryant,Chicago Cubs,CUBS,1,1,1,2,1967,1967,0,No,0,0.0,0.01,0.01,0,2,2,0,7,7,0.0,0.0,0.0,0.0,0.0,0.0
<a href=/player/bryak001>bryak001</a>,Kris Bryant,Chicago Cubs,CUBS,1,1,2,3,2021,2021,0,Yes,0,1.09,0.0,-1.09,51,0,-51,212,0,-212,0.0,0.0,0.0,19500000.0,0.0,-19500000.0
<a href=/player/bryar101>bryar101</a>,Ron Bryant,San Francisco Giants,GIANTS,2,2,4,6,1975,1983,8,No,0,10.37,1.91,-8.46,863,740,-123,3014,2323,-691,26.0,218.0,192.0,0.0,0.0,0.0
<a href=/player/buchb001>buchb001</a>,Bob Buchanan,Cincinnati Reds,REDS,1,1,1,2,1985,1987,2,No,0,0.0,0.0,0.0,0,0,0,0,0,0,0.0,0.0,0.0,0.0,0.0,0.0
<a href=/player/buchb002>buchb002</a>,Brian Buchanan,New York Yankees,YANKS,1,5,1,6,1998,2001,3,No,0,22.8,7.48,-15.32,1163,539,-624,4014,2478,-1536,2978.0,0.0,-2978.0,0.0,0.0,0.0
<a href=/player/buchb002>buchb002</a>,Brian Buchanan,Minnesota Twins,TWINS,4,7,8,15,2002,2015,13,No,0,34.26,8.74,-25.52,1781,1170,-611,6426,4254,-2172,1777.0,138.0,-1639.0,12555000.0,0.0,-12555000.0
<a href=/player/buchc001>buchc001</a>,Clay Buchholz,Boston Red Sox,RSOX,1,1,1,2,2016,2016,0,Yes,0,-0.41,0.0,0.41,4,0,-4,2,0,-2,22.0,0.0,-22.0,13000000.0,0.0,-13000000.0
<a href=/player/buchj101>buchj101</a>,Jim Bucher,Brooklyn Dodgers,DOGRS,1,4,1,5,1937,1944,7,No,0,1.9,1.11,-0.79,125,343,218,330,1190,860,390.0,0.0,-390.0,10000.0,0.0,-10000.0
<a href=/player/buchj102>buchj102</a>,Jerry Buchek,St. Louis Cardinals,CARDS,1,3,3,6,1967,1967,0,No,0,-0.52,-0.9,-0.38,197,52,-145,651,76,-575,0.0,0.0,0.0,0.0,0.0,0.0
<a href=/player/buchj102>buchj102</a>,Jerry Buchek,New York Mets,METS,1,1,1,2,1968,1969,1,No,0,0.0,0.0,0.0,0,0,0,0,0,0,0.0,0.0,0.0,0.0,0.0,0.0
<a href=/player/buchj102>buchj102</a>,Jerry Buchek,St. Louis Cardinals,CARDS,1,2,1,3,1969,1969,0,No,0,-0.33,0.06,0.39,57,49,-8,101,68,-33,0.0,0.0,0.0,0.0,0.0,0.0
<a href=/player/buchj104>buchj104</a>,Johnny Bucha,Detroit Tigers,TIGRS,5,14,10,24,1954,1961,7,No,0,12.9,0.88,-12.02,615,749,134,406,2092,1686,3228.0,40.0,-3188.0,13200.0,0.0,-13200.0
<a href=/player/buchr001>buchr001</a>,Ryan Buchter,Chicago Cubs,CUBS,1,1,1,2,2011,2012,1,No,0,0.09,-0.51,-0.6,2,59,57,0,33,33,3.0,312.0,309.0,0.0,0.0,0.0
<a href=/player/buchr001>buchr001</a>,Ryan Buchter,Washington Nationals,NATEX,1,1,1,2,2008,2008,0,No,0,0.0,0.0,0.0,0,0,0,0,0,0,0.0,0.0,0.0,0.0,0.0,0.0
<a href=/player/buchr001>buchr001</a>,Ryan Buchter,San Diego Padres,PADRS,1,3,4,7,2017,2017,0,Yes,0,-1.51,-0.81,0.7,107,22,-85,1,17,16,304.0,157.0,-147.0,4194700.0,0.0,-4194700.0
<a href=/player/buchr001>buchr001</a>,Ryan Buchter,Kansas City Royals,ROYALS,1,3,2,5,2018,2021,3,No,0,1.28,0.62,-0.66,124,62,-62,0,5,5,254.0,390.0,136.0,0.0,0.0,0.0
<a href=/player/bucht001>bucht001</a>,Taylor Buchholz,Philadelphia Phillies,PHILS,5,11,7,18,2003,2013,10,No,2,0.36,22.51,22.15,393,644,251,101,485,384,2150.0,4335.0,2185.0,8825000.0,0.0,-8825000.0
<a href=/player/bucht001>bucht001</a>,Taylor Buchholz,Houston Astros,ASTROS,1,3,2,5,2006,2007,1,No,0,4.59,-0.73,-5.32,489,38,-451,1012,30,-982,873.0,297.0,-576.0,727000.0,0.0,-727000.0
<a href=/player/buckb001>buckb001</a>,Bill Buckner,Los Angeles Dodgers,DOGRS,2,4,4,8,1977,1984,7,No,0,15.47,7.3,-8.17,1806,765,-1041,7323,1796,-5527,184.0,243.0,59.0,0.0,0.0,0.0
<a href=/player/buckb001>buckb001</a>,Bill Buckner,Chicago Cubs,CUBS,4,6,9,15,1984,1989,5,No,0,12.74,9.96,-2.78,1223,298,-925,2786,318,-2468,2099.0,1723.0,-376.0,0.0,0.0,0.0
<a href=/player/buckb002>buckb002</a>,Billy Buckner,Kansas City Royals,ROYALS,3,3,4,7,2007,2014,7,No,0,7.4,4.46,-2.94,829,510,-319,1649,1790,141,766.0,756.0,-10.0,460000.0,0.0,-460000.0
<a href=/player/buckb002>buckb002</a>,Billy Buckner,Arizona Diamondbacks,DBACKS,1,1,2,3,2010,2010,0,No,0,0.0,-0.24,-0.24,0,11,11,0,6,6,0.0,67.0,67.0,0.0,0.0,0.0
<a href=/player/buckj001>buckj001</a>,John Buck,Houston Astros,ASTROS,2,4,3,7,2004,2011,7,No,2,2.27,3.09,0.82,611,180,-431,2116,686,-1430,69.0,0.0,-69.0,2800000.0,0.0,-2800000.0
<a href=/player/buckj001>buckj001</a>,John Buck,Miami Marlins,MARLNS,12,33,32,65,2012,2020,8,Yes,0,57.99,24.95,-33.04,3997,2605,-1392,9990,7444,-2546,7539.0,4278.0,-3261.0,66200000.0,0.0,-66200000.0
<a href=/player/buckj001>buckj001</a>,John Buck,Toronto Blue Jays,BJAYS,1,4,3,7,2012,2016,4,No,0,18.37,4.87,-13.5,742,311,-431,2152,493,-1659,2154.0,2473.0,319.0,0.0,0.0,0.0
<a href=/player/buckj001>buckj001</a>,John Buck,New York Mets,METS,4,7,5,12,2013,2021,8,Yes,0,1.02,3.24,2.22,135,327,192,405,855,450,0.0,146.0,146.0,13000000.0,0.0,-13000000.0
<a href=/player/buckk001>buckk001</a>,Kevin Buckley,Texas Rangers,RNGRS,1,1,1,2,1985,1986,1,No,0,0.0,0.0,0.0,0,0,0,0,0,0,0.0,0.0,0.0,0.0,0.0,0.0
<a href=/player/buddd101>buddd101</a>,Don Buddin,Boston Red Sox,RSOX,5,8,7,15,1961,1968,7,No,0,24.82,15.47,-9.35,1128,791,-337,3147,2614,-533,3084.0,1094.0,-1990.0,44500.0,0.0,-44500.0
<a href=/player/budnm101>budnm101</a>,Mike Budnick,New York Giants,GIANTS,1,4,1,5,1947,1953,6,No,0,0.0,-0.83,-0.83,0,19,19,0,46,46,0.0,19.0,19.0,0.0,0.0,0.0
<a href=/player/buecs001>buecs001</a>,Steve Buechele,Texas Rangers,RNGRS,3,4,4,8,1991,1996,5,No,0,4.84,-0.13,-4.97,718,182,-536,478,171,-307,1163.0,627.0,-536.0,884000.0,0.0,-884000.0
<a href=/player/buecs001>buecs001</a>,Steve Buechele,Pittsburgh Pirates,PIRATS,1,1,1,2,1992,1992,0,No,0,3.16,0.25,-2.91,334,30,-304,1290,30,-1260,0.0,265.0,265.0,2600000.0,0.0,-2600000.0
<a href=/player/buehm001>buehm001</a>,Mark Buehrle,Miami Marlins,MARLNS,12,33,32,65,2012,2020,8,Yes,0,57.99,24.95,-33.04,3997,2605,-1392,9990,7444,-2546,7539.0,4278.0,-3261.0,66200000.0,0.0,-66200000.0
<a href=/player/buelf101>buelf101</a>,Fritz Buelow,Cleveland Indians,INDINS,2,3,2,5,1907,1907,0,No,0,0.08,0.51,0.43,65,55,-10,229,206,-23,0.0,0.0,0.0,0.0,0.0,0.0
<a href=/player/buesa101>buesa101</a>,Art Bues,Boston Braves,BRAVES,1,1,1,2,1913,1915,2,No,0,0.0,1.2,1.2,0,246,246,0,860,860,0.0,0.0,0.0,1800.0,0.0,-1800.0
<a href=/player/bufod001>bufod001</a>,Damon Buford,Baltimore Orioles,ORLS,1,2,2,4,1995,1996,1,No,0,2.13,2.23,0.1,250,220,-30,767,956,189,0.0,0.0,0.0,0.0,0.0,0.0
<a href=/player/bufod001>bufod001</a>,Damon Buford,New York Mets,METS,1,1,1,2,1996,1996,0,No,0,0.64,0.0,-0.64,212,0,-212,566,0,-566,0.0,0.0,0.0,0.0,0.0,0.0
<a href=/player/bufod001>bufod001</a>,Damon Buford,Texas Rangers,RNGRS,2,3,5,8,1997,2007,10,No,2,2.88,7.0,4.12,229,110,-119,721,120,-601,0.0,1253.0,1253.0,225000.0,0.0,-225000.0
<a href=/player/bufod001>bufod001</a>,Damon Buford,Boston Red Sox,RSOX,1,1,1,2,1999,2000,1,No,0,0.18,-0.72,-0.9,185,101,-84,645,209,-436,0.0,0.0,0.0,1100000.0,0.0,-1100000.0
<a href=/player/bufod101>bufod101</a>,Don Buford,Chicago White Sox,WSOX,6,9,10,19,1967,1977,10,No,0,29.24,13.29,-15.95,1920,1924,4,6795,7037,242,306.0,62.0,-244.0,134800.0,0.0,-134800.0
<a href=/player/buhlb101>buhlb101</a>,Bob Buhl,Milwaukee Braves,BRAVES,4,6,7,13,1962,1966,4,No,0,5.98,3.18,-2.8,385,443,58,640,729,89,2572.0,227.0,-2345.0,0.0,0.0,0.0
<a href=/player/buhlb101>buhlb101</a>,Bob Buhl,Chicago Cubs,CUBS,10,15,17,32,1966,1982,16,No,0,38.97,72.32,33.35,1515,3517,2002,3549,10033,6484,7048.0,7391.0,343.0,430000.0,0.0,-430000.0
<a href=/player/buhnj001>buhnj001</a>,Jay Buhner,Pittsburgh Pirates,PIRATS,1,3,3,6,1984,1986,2,No,0,0.69,0.08,-0.61,132,124,-8,338,327,-11,92.0,0.0,-92.0,0.0,0.0,0.0
<a href=/player/buhnj001>buhnj001</a>,Jay Buhner,New York Yankees,YANKS,2,4,2,6,1988,1989,1,No,0,22.92,1.01,-21.91,1483,131,-1352,5913,342,-5571,0.0,0.0,0.0,722000.0,0.0,-722000.0
<a href=/player/buicd001>buicd001</a>,DeWayne Buice,California Angels,ANGELS,1,1,1,2,1989,1992,3,No,0,-0.3,0.42,0.72,7,28,21,0,0,0,51.0,130.0,79.0,0.0,0.0,0.0
<a href=/player/bukaj001>bukaj001</a>,J.B. Bukauskas,Houston Astros,ASTROS,1,4,2,6,2019,2021,2,No,0,-0.93,3.35,4.28,254,54,-200,791,4,-787,100.0,902.0,802.0,0.0,0.0,0.0
<a href=/player/bukvr001>bukvr001</a>,Ryan Bukvich,Kansas City Royals,ROYALS,1,2,3,5,2004,2005,1,No,0,-0.35,0.13,0.48,40,137,97,10,489,479,178.0,0.0,-178.0,1750000.0,0.0,-1750000.0
<a href=/player/bulgj001>bulgj001</a>,Jason Bulger,Arizona Diamondbacks,DBACKS,3,3,4,7,2006,2010,4,No,0,5.39,-2.74,-8.13,442,146,-296,1241,238,-1003,369.0,380.0,11.0,380000.0,0.0,-380000.0
<a href=/player/bulle001>bulle001</a>,Eric Bullock,Houston Astros,ASTROS,1,1,1,2,1987,1987,0,No,0,0.12,0.0,-0.12,16,0,-16,20,0,-20,0.0,0.0,0.0,0.0,0.0,0.0
<a href=/player/bulle001>bulle001</a>,Eric Bullock,Minnesota Twins,TWINS,1,3,2,5,1988,1989,1,No,0,2.78,0.41,-2.37,304,27,-277,1185,0,-1185,0.0,435.0,435.0,103500.0,0.0,-103500.0
<a href=/player/bullj001>bullj001</a>,Jim Bullinger,Chicago White Sox,WSOX,1,1,1,2,1998,1998,0,No,0,-0.34,0.0,0.34,2,0,-2,0,0,0,17.0,0.0,-17.0,0.0,0.0,0.0
<a href=/player/bullk001>bullk001</a>,Kirk Bullinger,St. Louis Cardinals,CARDS,2,4,4,8,1995,1998,3,No,0,0.65,-1.89,-2.54,140,207,67,86,512,426,308.0,331.0,23.0,4525000.0,0.0,-4525000.0
<a href=/player/bulls001>bulls001</a>,Scott Bullett,Pittsburgh Pirates,PIRATS,1,1,1,2,1994,1994,0,No,0,0.3,0.0,-0.3,213,0,-213,341,0,-341,0.0,0.0,0.0,0.0,0.0,0.0
<a href=/player/bumpn001>bumpn001</a>,Nate Bump,San Francisco Giants,GIANTS,2,5,3,8,1999,2005,6,No,0,17.71,7.22,-10.49,680,557,-123,659,309,-350,4495.0,2909.0,-1586.0,0.0,0.0,0.0
<a href=/player/buncm001>buncm001</a>,Melvin Bunch,Kansas City Royals,ROYALS,1,1,1,2,1997,1997,0,No,0,0.0,0.35,0.35,0,53,53,0,204,204,0.0,0.0,0.0,0.0,0.0,0.0
<a href=/player/bundd001>bundd001</a>,Dylan Bundy,Baltimore Orioles,ORLS,1,1,4,5,2019,2019,0,Yes,0,1.39,0.0,-1.39,37,0,-37,4,0,-4,469.0,0.0,-469.0,2800000.0,0.0,-2800000.0
<a href=/player/bunnj101>bunnj101</a>,Jim Bunning,Detroit Tigers,TIGRS,2,4,4,8,1963,1970,7,No,0,32.41,16.87,-15.54,651,629,-22,1145,1412,267,4562.0,2945.0,-1617.0,39000.0,0.0,-39000.0
<a href=/player/bunnj101>bunnj101</a>,Jim Bunning,Philadelphia Phillies,PHILS,4,8,10,18,1967,1979,12,No,0,29.8,35.32,5.52,1773,1867,94,5720,5488,-232,3305.0,6584.0,3279.0,74500.0,0.0,-74500.0
<a href=/player/bunnj101>bunnj101</a>,Jim Bunning,Pittsburgh Pirates,PIRATS,1,1,3,4,1969,1973,4,No,0,0.15,0.16,0.01,18,6,-12,21,9,-12,169.0,0.0,-169.0,75000.0,0.0,-75000.0
<a href=/player/burbb101>burbb101</a>,Bill Burbach,New York Yankees,YANKS,1,1,1,2,1971,1972,1,No,0,0.0,-0.56,-0.56,0,24,24,0,4,4,0.0,85.0,85.0,13000.0,0.0,-13000.0
<a href=/player/burbb101>burbb101</a>,Bill Burbach,Baltimore Orioles,ORLS,1,1,1,2,1972,1972,0,No,0,0.0,0.0,0.0,0,0,0,0,0,0,0.0,0.0,0.0,0.0,0.0,0.0
<a href=/player/burbd001>burbd001</a>,Dave Burba,Seattle Mariners,MARNRS,2,4,3,7,1991,1993,2,No,0,19.75,1.34,-18.41,1114,134,-980,1118,402,-716,2994.0,104.0,-2890.0,5400000.0,0.0,-5400000.0
<a href=/player/burbd001>burbd001</a>,Dave Burba,San Francisco Giants,GIANTS,3,5,8,13,1995,1998,3,No,0,9.99,0.74,-9.25,311,256,-55,447,555,108,1958.0,96.0,-1862.0,5827778.0,0.0,-5827778.0
<a href=/player/burbd001>burbd001</a>,Dave Burba,Cincinnati Reds,REDS,4,6,4,10,1998,2010,12,No,0,10.01,17.06,7.05,225,1137,912,273,4616,4343,2499.0,133.0,-2366.0,9600000.0,0.0,-9600000.0
<a href=/player/burbd001>burbd001</a>,Dave Burba,Milwaukee Brewers,BREWRS,1,1,1,2,2004,2004,0,No,0,0.01,0.0,-0.01,12,0,-12,1,0,-1,19.0,0.0,-19.0,440000.0,0.0,-440000.0
<a href=/player/burcf101>burcf101</a>,Fred Burchell,Baltimore,Baltimore,1,1,2,3,1907,1908,1,No,0,0.37,0.0,-0.37,87,0,-87,96,0,-96,725.0,0.0,-725.0,0.0,0.0,0.0
<a href=/player/burdb102>burdb102</a>,Bob Burda,St. Louis Cardinals,CARDS,1,1,1,2,1963,1963,0,No,0,0.0,0.0,0.0,0,0,0,0,0,0,0.0,0.0,0.0,0.0,0.0,0.0
<a href=/player/burdb102>burdb102</a>,Bob Burda,Pittsburgh Pirates,PIRATS,1,2,1,3,1965,1965,0,No,0,0.03,0.41,0.38,287,60,-227,312,157,-155,304.0,0.0,-304.0,0.0,0.0,0.0
<a href=/player/burdb102>burdb102</a>,Bob Burda,Milwaukee Brewers,BREWRS,1,1,1,2,1971,1971,0,No,0,0.23,0.0,-0.23,65,0,-65,83,0,-83,0.0,0.0,0.0,0.0,0.0,0.0
<a href=/player/burdb102>burdb102</a>,Bob Burda,St. Louis Cardinals,CARDS,2,3,2,5,1972,1972,0,No,0,-0.78,-0.15,0.63,52,17,-35,91,13,-78,0.0,0.0,0.0,24000.0,0.0,-24000.0
<a href=/player/burdl101>burdl101</a>,Lew Burdette,New York Yankees,YANKS,2,4,3,7,1951,1955,4,No,0,31.53,5.62,-25.91,1224,273,-951,1581,188,-1393,8049.0,1370.0,-6679.0,20000.0,0.0,-20000.0
<a href=/player/burdl101>burdl101</a>,Lew Burdette,Milwaukee Braves,BRAVES,7,12,11,23,1963,1968,5,No,0,0.46,3.02,2.56,765,1080,315,1175,2207,1032,1041.0,1768.0,727.0,15000.0,0.0,-15000.0
<a href=/player/burdl101>burdl101</a>,Lew Burdette,St. Louis Cardinals,CARDS,2,4,3,7,1964,1965,1,No,0,0.31,0.14,-0.17,71,26,-45,56,14,-42,454.0,133.0,-321.0,0.0,0.0,0.0
<a href=/player/burdn001>burdn001</a>,Nick Burdi,Philadelphia Phillies,PHILS,1,1,1,2,2017,2017,0,No,0,-0.55,0.0,0.55,28,0,-28,0,0,0,37.0,0.0,-37.0,0.0,0.0,0.0
<a href=/player/burga001>burga001</a>,Ambiorix Burgos,Kansas City Royals,ROYALS,1,1,1,2,2006,2010,4,No,0,0.23,4.29,4.06,34,118,84,0,20,20,71.0,1888.0,1817.0,339500.0,0.0,-339500.0
<a href=/player/burgb101>burgb101</a>,Bill Burgo,Philadelphia Athletics,ATLTCS,1,5,1,6,1944,1946,2,No,0,0.0,1.19,1.19,0,162,162,0,669,669,0.0,0.0,0.0,3000.0,0.0,-3000.0
<a href=/player/burge001>burge001</a>,Enrique Burgos,Kansas City Royals,ROYALS,1,1,1,2,1995,1995,0,No,0,-0.29,-0.49,-0.2,10,22,12,0,38,38,25.0,0.0,-25.0,0.0,0.0,0.0
<a href=/player/burgs101>burgs101</a>,Smoky Burgess,Chicago Cubs,CUBS,1,2,2,4,1951,1955,4,No,0,6.65,0.0,-6.65,713,1,-712,2114,1,-2113,0.0,0.0,0.0,12500.0,0.0,-12500.0
<a href=/player/burgs101>burgs101</a>,Smoky Burgess,Cincinnati Reds,REDS,8,16,22,38,1951,1965,14,No,0,82.9,22.04,-60.86,4576,2061,-2515,14654,4760,-9894,2749.0,1025.0,-1724.0,63000.0,0.0,-63000.0
<a href=/player/burgs101>burgs101</a>,Smoky Burgess,Philadelphia Phillies,PHILS,2,4,4,8,1955,1957,2,No,0,8.43,2.22,-6.21,540,413,-127,1547,1258,-289,90.0,0.0,-90.0,15500.0,0.0,-15500.0
<a href=/player/burgs101>burgs101</a>,Smoky Burgess,Cincinnati Reds,REDS,4,7,11,18,1959,1965,6,No,0,63.65,9.6,-54.05,3136,1073,-2063,9911,1717,-8194,2563.0,935.0,-1628.0,0.0,0.0,0.0
<a href=/player/burgt001>burgt001</a>,Tom Burgmeier,Kansas City Royals,ROYALS,1,1,1,2,1973,1973,0,No,0,3.45,0.0,-3.45,221,0,-221,0,0,0,1140.0,0.0,-1140.0,0.0,0.0,0.0
<a href=/player/burgt101>burgt101</a>,Tom Burgess,St. Louis Cardinals,CARDS,1,1,1,2,1959,1959,0,No,0,0.0,0.0,0.0,0,0,0,0,0,0,0.0,0.0,0.0,0.0,0.0,0.0
<a href=/player/burgt101>burgt101</a>,Tom Burgess,Pittsburgh Pirates,PIRATS,2,2,3,5,1960,1962,2,No,0,-0.33,0.65,0.98,123,67,-56,369,216,-153,0.0,0.0,0.0,0.0,0.0,0.0
<a href=/player/burkb001>burkb001</a>,Brock Burke,Tampa Bay Devil Rays,RAYS,2,4,5,9,2018,2020,2,Yes,0,-0.58,3.27,3.85,173,118,-55,2,160,158,374.0,210.0,-164.0,0.0,0.0,0.0
<a href=/player/burkc001>burkc001</a>,Chris Burke,Houston Astros,ASTROS,4,8,6,14,2007,2018,11,Yes,2,3.86,8.15,4.29,1017,824,-193,623,1881,1258,2956.0,649.0,-2307.0,856000.0,0.0,-856000.0
<a href=/player/burke001>burke001</a>,Ellis Burks,Colorado Rockies,ROCKS,3,4,7,11,1998,2000,2,No,0,9.55,0.76,-8.79,495,181,-314,1665,633,-1032,40.0,49.0,9.0,9563333.0,0.0,-9563333.0
<a href=/player/burke101>burke101</a>,Eddie Burke,Philadelphia Phillies,PHILS,1,3,1,4,1890,1890,0,No,0,-0.87,0.47,1.34,43,31,-12,162,139,-23,150.0,0.0,-150.0,0.0,0.0,0.0
<a href=/player/burkg101>burkg101</a>,Glenn Burke,Los Angeles Dodgers,DOGRS,1,1,1,2,1978,1978,0,No,0,-1.4,1.8,3.2,101,110,9,311,377,66,0.0,0.0,0.0,0.0,0.0,0.0
<a href=/player/burkj001>burkj001</a>,John Burkett,San Francisco Giants,GIANTS,1,1,2,3,1994,2003,9,No,0,5.31,16.23,10.92,108,993,885,10,3948,3938,1801.0,0.0,-1801.0,3550000.0,0.0,-3550000.0
<a href=/player/burkj001>burkj001</a>,John Burkett,Florida Marlins,MARLNS,9,15,17,32,1996,2012,16,No,2,13.58,15.34,1.76,714,1417,703,846,2789,1943,5960.0,4798.0,-1162.0,15975000.0,0.0,-15975000.0
<a href=/player/burkj101>burkj101</a>,Jesse Burkett,St.Louis Browns,ORLS,1,1,2,3,1904,1904,0,No,0,2.67,0.0,-2.67,148,0,-148,654,0,-654,0.0,0.0,0.0,4500.0,0.0,-4500.0
<a href=/player/burkj104>burkj104</a>,Jimmy Burke,Pittsburgh Pirates,PIRATS,3,7,4,11,1903,1910,7,No,0,15.96,23.51,7.55,1958,739,-1219,7001,2073,-4928,2702.0,3643.0,941.0,0.0,0.0,0.0
<a href=/player/burkk101>burkk101</a>,Ken Burkhart,St. Louis Cardinals,CARDS,1,1,1,2,1948,1948,0,No,0,0.34,-0.22,-0.56,54,41,-13,18,127,109,207.0,0.0,-207.0,0.0,0.0,0.0
<a href=/player/burkl102>burkl102</a>,Leo Burke,St. Louis Cardinals,CARDS,1,1,1,2,1963,1966,3,No,0,-0.13,2.11,2.24,98,176,78,176,10,-166,0.0,381.0,381.0,0.0,0.0,0.0
<a href=/player/burkt001>burkt001</a>,Tim Burke,Pittsburgh Pirates,PIRATS,1,4,1,5,1982,1986,4,No,0,0.06,2.65,2.59,23,373,350,0,881,881,83.0,0.0,-83.0,0.0,0.0,0.0
<a href=/player/burkt001>burkt001</a>,Tim Burke,New York Yankees,YANKS,1,1,1,2,1983,1983,0,No,0,11.79,0.0,-11.79,850,0,-850,46,0,-46,1801.0,0.0,-1801.0,0.0,0.0,0.0
<a href=/player/burkt001>burkt001</a>,Tim Burke,Montreal Expos,NATEX,2,2,4,6,1991,1991,0,No,0,3.57,-0.52,-4.09,227,6,-221,6,7,1,2384.0,51.0,-2333.0,0.0,0.0,0.0
<a href=/player/burkt001>burkt001</a>,Tim Burke,New York Mets,METS,1,1,1,2,1992,1992,0,No,0,0.06,-0.93,-0.99,23,86,63,0,2,2,83.0,130.0,47.0,2266667.0,0.0,-2266667.0
<a href=/player/burlr001>burlr001</a>,Rick Burleson,Boston Red Sox,RSOX,3,6,6,12,1980,1989,9,No,0,34.32,7.26,-27.06,1836,1801,-35,6677,5369,-1308,547.0,1201.0,654.0,1020000.0,0.0,-1020000.0
<a href=/player/burna001>burna001</a>,A.J. Burnett,New York Mets,METS,4,8,6,14,1998,2004,6,No,0,16.46,25.48,9.02,820,471,-349,1355,484,-871,4079.0,4278.0,199.0,362500.0,0.0,-362500.0
<a href=/player/burna001>burna001</a>,A.J. Burnett,New York Yankees,YANKS,2,4,3,7,2012,2016,4,No,0,6.48,-0.08,-6.56,169,134,-35,190,458,268,1672.0,31.0,-1641.0,0.0,0.0,0.0
<a href=/player/burnb001>burnb001</a>,Britt Burns,Chicago White Sox,WSOX,7,14,13,27,1985,1996,11,No,0,11.29,32.32,21.03,1612,1563,-49,4746,6374,1628,301.0,975.0,674.0,6084000.0,0.0,-6084000.0
<a href=/player/burnb002>burnb002</a>,Billy Burns,Washington Nationals,NATEX,2,2,2,4,2013,2016,3,No,0,5.56,0.37,-5.19,636,200,-436,856,149,-707,416.0,172.0,-244.0,0.0,0.0,0.0
<a href=/player/burnb002>burnb002</a>,Billy Burns,Oakland Athletics,ATLTCS,2,2,2,4,2016,2017,1,Yes,0,-1.02,-0.79,0.23,48,44,-4,82,123,41,0.0,0.0,0.0,0.0,0.0,0.0
<a href=/player/burnb101>burnb101</a>,Bill Burns,Washington Senators,TWINS,1,1,3,4,1909,1909,0,No,0,1.19,-0.8,-1.99,48,109,61,63,350,287,502.0,114.0,-388.0,3500.0,0.0,-3500.0
<a href=/player/burnc001>burnc001</a>,Cory Burns,Cleveland Indians,INDINS,1,1,1,2,2011,2012,1,No,0,-0.16,-0.65,-0.49,34,72,38,1,109,108,54.0,0.0,-54.0,0.0,0.0,0.0
<a href=/player/burnc001>burnc001</a>,Cory Burns,San Diego Padres,PADRS,1,1,1,2,2012,2013,1,No,0,0.18,0.0,-0.18,10,0,-10,0,0,0,34.0,0.0,-34.0,0.0,0.0,0.0
<a href=/player/burnd101>burnd101</a>,Dennis Burns,Philadelphia Athletics,ATLTCS,3,9,5,14,1924,1935,11,No,0,15.67,38.22,22.55,391,1328,937,1453,5363,3910,735.0,0.0,-735.0,39667.0,0.0,-39667.0
<a href=/player/burne101>burne101</a>,Ed Burns,Montreal,Montreal,1,1,2,3,1913,1913,0,No,0,0.59,0.0,-0.59,320,0,-320,902,0,-902,0.0,0.0,0.0,0.0,0.0,0.0
<a href=/player/burng101>burng101</a>,George Burns,New York Giants,GIANTS,1,3,1,4,1921,1926,5,No,0,3.43,7.56,4.13,403,420,17,1818,1780,-38,0.0,0.0,0.0,15208.0,0.0,-15208.0
<a href=/player/burng102>burng102</a>,George Burns,New York Yankees,YANKS,1,1,1,2,1918,1918,0,No,0,8.05,1.23,-6.82,307,91,-216,1176,371,-805,0.0,0.0,0.0,0.0,0.0,0.0
<a href=/player/burng102>burng102</a>,George Burns,Cleveland Indians,INDINS,1,3,1,4,1921,1923,2,No,0,18.85,0.33,-18.52,768,142,-626,3109,582,-2527,0.0,0.0,0.0,10000.0,0.0,-10000.0
<a href=/player/burng102>burng102</a>,George Burns,Boston Red Sox,RSOX,2,5,5,10,1924,1925,1,No,0,9.31,0.12,-9.19,860,387,-473,3360,1555,-1805,0.0,0.0,0.0,3300.0,0.0,-3300.0
<a href=/player/burnj001>burnj001</a>,Jeromy Burnitz,New York Mets,METS,6,10,11,21,1994,1999,5,No,1,9.6,7.76,-1.84,747,954,207,324,289,-35,2209.0,3636.0,1427.0,6823000.0,0.0,-6823000.0
<a href=/player/burnj001>burnj001</a>,Jeromy Burnitz,Cleveland Indians,INDINS,1,1,1,2,1996,1997,1,No,0,15.73,0.69,-15.04,782,86,-696,3269,318,-2951,0.0,0.0,0.0,190000.0,0.0,-190000.0
<a href=/player/burnj001>burnj001</a>,Jeromy Burnitz,Milwaukee Brewers,BREWRS,2,7,6,13,2002,2004,2,No,0,1.18,1.8,0.62,314,393,79,929,661,-268,437.0,1049.0,612.0,2750000.0,0.0,-2750000.0
<a href=/player/burnj001>burnj001</a>,Jeromy Burnitz,New York Mets,METS,8,15,15,30,2003,2021,18,Yes,0,22.85,21.94,-0.91,694,1363,669,1260,3646,2386,4975.0,2970.0,-2005.0,30731467.0,0.0,-30731467.0
<a href=/player/burnj105>burnj105</a>,Jack Burns,St.Louis Browns,ORLS,2,2,2,4,1936,1937,1,No,0,-0.28,1.4,1.68,201,159,-42,673,143,-530,273.0,1178.0,905.0,13500.0,0.0,-13500.0
<a href=/player/burnj108>burnj108</a>,Johnny Burnett,Cleveland Indians,INDINS,2,4,2,6,1934,1940,6,No,0,1.33,10.59,9.26,342,673,331,1172,2639,1467,96.0,0.0,-96.0,5000.0,0.0,-5000.0
<a href=/player/burnj108>burnj108</a>,Johnny Burnett,St.Louis Browns,ORLS,1,1,1,2,1936,1936,0,No,0,0.0,-0.03,-0.03,0,140,140,0,596,596,0.0,0.0,0.0,0.0,0.0,0.0
<a href=/player/burnm001>burnm001</a>,Mike Burns,Cincinnati Reds,REDS,1,1,2,3,2006,2006,0,No,0,0.07,0.0,-0.07,7,0,-7,0,0,0,23.0,0.0,-23.0,332500.0,0.0,-332500.0
<a href=/player/burnp102>burnp102</a>,Pete Burnside,Washington Senators,RNGRS,2,3,4,7,1962,1964,2,No,0,2.63,0.81,-1.82,369,114,-255,1015,218,-797,22.0,175.0,153.0,0.0,0.0,0.0
<a href=/player/burns001>burns001</a>,Sean Burnett,Pittsburgh Pirates,PIRATS,4,7,9,16,2009,2020,11,Yes,0,14.34,15.86,1.52,1433,1357,-76,3037,658,-2379,1099.0,1818.0,719.0,4920000.0,0.0,-4920000.0
<a href=/player/burns101>burns101</a>,Sheldon Burnside,Detroit Tigers,TIGRS,2,2,3,5,1979,1983,4,No,0,0.05,7.42,7.37,113,520,407,178,1791,1613,14.0,0.0,-14.0,0.0,0.0,0.0
<a href=/player/burnt001>burnt001</a>,Todd Burns,Texas Rangers,RNGRS,1,1,1,2,1993,1993,0,No,0,-0.68,0.0,0.68,48,0,-48,4,0,-4,92.0,0.0,-92.0,575000.0,0.0,-575000.0
<a href=/player/burnw101>burnw101</a>,Wally Burnette,New York Yankees,YANKS,1,1,1,2,1956,1957,1,No,0,3.41,0.0,-3.41,136,0,-136,89,0,-89,787.0,0.0,-787.0,0.0,0.0,0.0
<a href=/player/burrj001>burrj001</a>,Jeff Burroughs,Texas Rangers,RNGRS,6,16,16,32,1976,1988,12,No,0,15.83,55.04,39.21,1321,3190,1869,4055,10570,6515,1774.0,6297.0,4523.0,330000.0,0.0,-330000.0
<a href=/player/burrj001>burrj001</a>,Jeff Burroughs,Atlanta Braves,BRAVES,2,2,2,4,1981,1983,2,No,0,1.76,-0.3,-2.06,205,44,-161,367,3,-364,261.0,87.0,-174.0,33500.0,0.0,-33500.0
<a href=/player/burrl101>burrl101</a>,Larry Burright,Los Angeles Dodgers,DOGRS,2,5,3,8,1962,1968,6,No,0,8.72,5.17,-3.55,1130,752,-378,1613,597,-1016,1656.0,2078.0,422.0,122000.0,0.0,-122000.0
<a href=/player/burrr001>burrr001</a>,Ray Burris,Chicago Cubs,CUBS,4,7,7,14,1979,1990,11,No,0,9.02,17.35,8.33,763,1156,393,2292,336,-1956,512.0,4219.0,3707.0,890000.0,0.0,-890000.0
<a href=/player/burrr001>burrr001</a>,Ray Burris,Montreal Expos,NATEX,1,1,2,3,1983,1983,0,No,0,3.69,0.0,-3.69,37,0,-37,0,0,0,635.0,0.0,-635.0,600000.0,0.0,-600000.0
<a href=/player/burrr001>burrr001</a>,Ray Burris,Oakland Athletics,ATLTCS,2,4,3,7,1984,1985,1,No,0,5.99,2.63,-3.36,113,29,-84,0,0,0,1871.0,583.0,-1288.0,600000.0,0.0,-600000.0
<a href=/player/burrr002>burrr002</a>,Ryan Burr,Arizona Diamondbacks,DBACKS,1,1,1,2,2017,2017,0,No,0,0.96,0.0,-0.96,61,0,-61,0,0,0,198.0,0.0,-198.0,0.0,0.0,0.0
<a href=/player/burrs001>burrs001</a>,Sean Burroughs,San Diego Padres,PADRS,1,1,1,2,2005,2006,1,No,0,-0.03,-0.89,-0.86,8,18,10,25,4,-21,0.0,54.0,54.0,1675000.0,0.0,-1675000.0
<a href=/player/burte101>burte101</a>,Ellis Burton,St. Louis Cardinals,CARDS,1,4,1,5,1961,1961,0,No,0,0.0,0.08,0.08,0,58,58,0,21,21,0.0,225.0,225.0,0.0,0.0,0.0
<a href=/player/burtj101>burtj101</a>,Jim Burton,Boston Red Sox,RSOX,1,1,1,2,1978,1978,0,No,0,0.0,0.0,0.0,0,0,0,0,0,0,0.0,0.0,0.0,0.0,0.0,0.0
<a href=/player/burtm101>burtm101</a>,Moe Burtschy,Kansas City Athletics,ATLTCS,42,95,97,192,1956,1976,20,No,0,133.5,78.63,-54.87,13774,10527,-3247,30995,29007,-1988,20345.0,13097.0,-7248.0,522100.0,0.0,-522100.0
<a href=/player/burwb101>burwb101</a>,Bill Burwell,St.Louis Browns,ORLS,1,6,1,7,1921,1921,0,No,0,0.0,0.0,0.0,0,0,0,0,0,0,0.0,0.0,0.0,6600.0,0.0,-6600.0
<a href=/player/busbj101>busbj101</a>,Jim Busby,Chicago White Sox,WSOX,23,43,38,81,1952,1969,17,No,0,54.0,56.53,2.53,5273,4792,-481,13898,10899,-2999,7275.0,8147.0,872.0,226750.0,0.0,-226750.0
<a href=/player/busbj101>busbj101</a>,Jim Busby,Washington Senators,TWINS,5,7,9,16,1955,1962,7,No,0,-2.39,0.04,2.43,319,1553,1234,752,4001,3249,250.0,2448.0,2198.0,39500.0,0.0,-39500.0
<a href=/player/busbj101>busbj101</a>,Jim Busby,Chicago White Sox,WSOX,16,28,29,57,1955,1969,14,No,0,20.76,44.3,23.54,2687,3479,792,5604,6611,1007,4631.0,7668.0,3037.0,148250.0,0.0,-148250.0
<a href=/player/busbj101>busbj101</a>,Jim Busby,Cleveland Indians,INDINS,9,16,15,31,1957,1968,11,No,0,105.59,32.42,-73.17,4771,2513,-2258,16106,9193,-6913,4502.0,562.0,-3940.0,17000.0,0.0,-17000.0
<a href=/player/busbj101>busbj101</a>,Jim Busby,Baltimore Orioles,ORLS,1,1,1,2,1958,1960,2,No,0,-0.22,1.54,1.76,62,150,88,110,430,320,0.0,0.0,0.0,18000.0,0.0,-18000.0
<a href=/player/busea001>busea001</a>,Alan Busenitz,Anaheim Angels,ANGELS,1,2,3,5,2016,2018,2,No,0,-0.15,3.27,3.42,80,67,-13,0,11,11,566.0,1029.0,463.0,0.0,0.0,0.0
<a href=/player/bushc001>bushc001</a>,Chris Bushing,Philadelphia Phillies,PHILS,1,1,1,2,1992,1992,0,No,0,-0.21,0.0,0.21,12,0,-12,0,0,0,13.0,0.0,-13.0,0.0,0.0,0.0
<a href=/player/bushd001>bushd001</a>,David Bush,Toronto Blue Jays,BJAYS,1,3,2,5,2005,2010,5,No,0,4.16,12.24,8.08,549,739,190,828,2857,2029,2736.0,120.0,-2616.0,627000.0,0.0,-627000.0
<a href=/player/bushg101>bushg101</a>,Guy Bush,Chicago Cubs,CUBS,1,3,2,5,1934,1941,7,No,0,3.72,22.26,18.54,346,634,288,358,941,583,2252.0,4458.0,2206.0,0.0,0.0,0.0
<a href=/player/bushh001>bushh001</a>,Homer Bush,San Diego Padres,PADRS,4,12,9,21,1997,2004,7,No,2,13.56,11.74,-1.82,1190,510,-680,3618,1358,-2260,1498.0,814.0,-684.0,0.0,0.0,0.0
<a href=/player/bushh001>bushh001</a>,Homer Bush,New York Yankees,YANKS,1,3,1,4,1999,2003,4,No,0,11.64,19.58,7.94,456,165,-291,1235,16,-1219,1600.0,3012.0,1412.0,0.0,0.0,0.0
<a href=/player/bushj102>bushj102</a>,Bullet Joe Bush,Philadelphia Athletics,ATLTCS,2,6,5,11,1917,1924,7,No,0,21.83,0.26,-21.57,730,281,-449,2197,867,-1330,2329.0,731.0,-1598.0,12000.0,0.0,-12000.0
<a href=/player/bushj102>bushj102</a>,Bullet Joe Bush,Boston Red Sox,RSOX,10,21,30,51,1921,1937,16,No,0,73.06,40.4,-32.66,4195,2010,-2185,13395,5364,-8031,9458.0,7949.0,-1509.0,78550.0,0.0,-78550.0
<a href=/player/bushj102>bushj102</a>,Bullet Joe Bush,St.Louis Browns,ORLS,23,43,52,95,1926,1952,26,No,0,132.07,125.15,-6.92,6541,9540,2999,21287,29892,8605,12928.0,19199.0,6271.0,217500.0,0.0,-217500.0
<a href=/player/bushj102>bushj102</a>,Bullet Joe Bush,New York Yankees,YANKS,1,3,1,4,1924,1924,0,No,0,7.92,0.0,-7.92,312,0,-312,382,0,-382,2741.0,0.0,-2741.0,16500.0,0.0,-16500.0
<a href=/player/buskm101>buskm101</a>,Mike Buskey,Chicago White Sox,WSOX,7,11,11,22,1975,1985,10,No,1,16.3,6.76,-9.54,1220,1148,-72,3180,4231,1051,3148.0,16.0,-3132.0,0.0,0.0,0.0
<a href=/player/buskt101>buskt101</a>,Tom Buskey,New York Yankees,YANKS,18,35,30,65,1974,2001,27,No,1,68.7,43.61,-25.09,4667,3496,-1171,10476,9633,-843,15153.0,7546.0,-7607.0,4780000.0,0.0,-4780000.0
<a href=/player/buskt101>buskt101</a>,Tom Buskey,Cleveland Indians,INDINS,2,4,5,9,1978,1980,2,No,0,-0.65,0.26,0.91,196,116,-80,422,243,-179,0.0,597.0,597.0,0.0,0.0,0.0
<a href=/player/bussr101>bussr101</a>,Ray Busse,Houston Astros,ASTROS,2,3,4,7,1972,1977,5,No,0,-0.92,-3.42,-2.5,71,191,120,200,517,317,0.0,0.0,0.0,0.0,0.0,0.0
<a href=/player/bussr101>bussr101</a>,Ray Busse,St. Louis Cardinals,CARDS,2,2,2,4,1973,1975,2,No,0,-1.05,-0.05,1.0,114,8,-106,266,4,-262,0.0,0.0,0.0,0.0,0.0,0.0
<a href=/player/butcj001>butcj001</a>,John Butcher,Texas Rangers,RNGRS,2,4,3,7,1983,1992,9,No,2,7.12,7.75,0.63,212,425,213,0,1729,1729,3956.0,28.0,-3928.0,0.0,0.0,0.0
<a href=/player/butcj001>butcj001</a>,John Butcher,Minnesota Twins,TWINS,7,13,12,25,1986,2007,21,No,6,8.36,37.47,29.11,1114,1578,464,2383,5077,2694,3115.0,2210.0,-905.0,488500.0,0.0,-488500.0
<a href=/player/butcm001>butcm001</a>,Mike Butcher,Seattle Mariners,MARNRS,1,1,1,2,1996,1996,0,No,0,0.0,0.0,0.0,0,0,0,0,0,0,0.0,0.0,0.0,0.0,0.0,0.0
<a href=/player/butcm101>butcm101</a>,Max Butcher,Brooklyn Dodgers,DOGRS,1,1,1,2,1938,1938,0,No,0,1.85,0.05,-1.8,64,8,-56,77,6,-71,613.0,34.0,-579.0,0.0,0.0,0.0
<a href=/player/butcm101>butcm101</a>,Max Butcher,Philadelphia Phillies,PHILS,1,1,1,2,1939,1940,1,No,0,14.95,1.65,-13.3,406,70,-336,430,265,-165,3506.0,0.0,-3506.0,0.0,0.0,0.0
<a href=/player/buted001>buted001</a>,Drew Butera,New York Mets,METS,1,2,1,3,2007,2011,4,No,0,-1.44,2.94,4.38,187,365,178,534,1469,935,3.0,0.0,-3.0,0.0,0.0,0.0
<a href=/player/buted001>buted001</a>,Drew Butera,Minnesota Twins,TWINS,3,3,3,6,2013,2019,6,No,0,0.83,3.09,2.26,193,279,86,716,814,98,5.0,414.0,409.0,0.0,0.0,0.0
<a href=/player/buted001>buted001</a>,Drew Butera,Los Angeles Dodgers,DOGRS,1,1,1,2,2014,2014,0,Yes,0,-0.54,0.0,0.54,22,0,-22,57,0,-57,0.0,0.0,0.0,700000.0,0.0,-700000.0
<a href=/player/buted001>buted001</a>,Drew Butera,Anaheim Angels,ANGELS,1,1,1,2,2015,2015,0,No,0,-1.21,-0.44,0.77,229,22,-207,575,14,-561,5.0,0.0,-5.0,987500.0,0.0,-987500.0
<a href=/player/buted001>buted001</a>,Drew Butera,Kansas City Royals,ROYALS,1,2,1,3,2018,2018,0,No,0,-0.55,0.0,0.55,55,5,-50,108,0,-108,5.0,11.0,6.0,2300000.0,0.0,-2300000.0
<a href=/player/butes001>butes001</a>,Sal Butera,Minnesota Twins,TWINS,1,1,2,3,1983,1983,0,No,0,-0.13,0.0,0.13,4,0,-4,5,0,-5,0.0,0.0,0.0,0.0,0.0,0.0
<a href=/player/butes001>butes001</a>,Sal Butera,Montreal Expos,NATEX,6,9,12,21,1985,1996,11,No,0,4.45,9.14,4.69,274,1231,957,297,636,339,2341.0,2913.0,572.0,1325000.0,0.0,-1325000.0
<a href=/player/butla101>butla101</a>,Art Butler,FallRiver,FallRiver,1,1,2,3,1911,1911,0,No,0,-0.45,0.0,0.45,27,0,-27,76,0,-76,0.0,0.0,0.0,0.0,0.0,0.0
<a href=/player/butla101>butla101</a>,Art Butler,Boston Braves,BRAVES,1,2,1,3,1911,1911,0,No,0,0.0,-0.19,-0.19,0,19,19,0,71,71,0.0,0.0,0.0,0.0,0.0,0.0
<a href=/player/butla101>butla101</a>,Art Butler,StPaul,StPaul,1,2,1,3,1912,1912,0,No,0,1.26,0.0,-1.26,125,0,-125,428,0,-428,0.0,0.0,0.0,0.0,0.0,0.0
<a href=/player/butla101>butla101</a>,Art Butler,Pittsburgh Pirates,PIRATS,1,5,3,8,1913,1915,2,No,0,18.03,3.31,-14.72,1733,233,-1500,6155,938,-5217,795.0,0.0,-795.0,11400.0,0.0,-11400.0
<a href=/player/butlb001>butlb001</a>,Brett Butler,Atlanta Braves,BRAVES,1,4,1,5,1983,1986,3,No,0,32.51,0.13,-32.38,1861,94,-1767,7480,76,-7404,166.0,699.0,533.0,110000.0,0.0,-110000.0
<a href=/player/butlb001>butlb001</a>,Brett Butler,New York Mets,METS,1,1,2,3,1995,1995,0,No,0,-0.18,0.0,0.18,178,0,-178,724,0,-724,0.0,0.0,0.0,2000000.0,0.0,-2000000.0
<a href=/player/butlb002>butlb002</a>,Brent Butler,St. Louis Cardinals,CARDS,2,6,4,10,1999,2003,4,No,0,3.2,2.78,-0.42,870,638,-232,626,106,-520,1171.0,1638.0,467.0,860000.0,0.0,-860000.0
<a href=/player/butlb101>butlb101</a>,Bill Butler,Cleveland Indians,INDINS,1,2,2,4,1973,1973,0,No,0,-0.78,0.0,0.78,55,0,-55,0,0,0,604.0,0.0,-604.0,0.0,0.0,0.0
<a href=/player/butlb101>butlb101</a>,Bill Butler,Minnesota Twins,TWINS,1,1,1,2,1977,1977,0,No,0,0.0,0.0,0.0,0,0,0,0,0,0,0.0,0.0,0.0,0.0,0.0,0.0
<a href=/player/butlb103>butlb103</a>,Bill Butland,Minneapolis,Minneapolis,1,3,2,5,1939,1940,1,No,0,2.73,0.0,-2.73,141,0,-141,95,0,-95,836.0,0.0,-836.0,0.0,0.0,0.0
<a href=/player/butld001>butld001</a>,Dan Butler,Boston Red Sox,RSOX,1,1,1,2,2015,2015,0,Yes,0,0.0,0.0,0.0,0,0,0,0,0,0,0.0,0.0,0.0,0.0,0.0,0.0
<a href=/player/butle001>butle001</a>,Eddie Butler,Colorado Rockies,ROCKS,1,2,2,4,2017,2017,0,Yes,0,0.65,0.0,-0.65,41,0,-41,22,0,-22,217.0,0.0,-217.0,0.0,0.0,0.0
<a href=/player/butle001>butle001</a>,Eddie Butler,Chicago Cubs,CUBS,1,3,2,5,2018,2019,1,No,0,-0.39,5.6,5.99,25,74,49,0,71,71,96.0,654.0,558.0,570750.0,0.0,-570750.0
<a href=/player/butlj001>butlj001</a>,Josh Butler,Tampa Bay Devil Rays,RAYS,1,1,1,2,2008,2009,1,No,0,-0.11,2.02,2.13,6,242,236,0,671,671,12.0,0.0,-12.0,0.0,0.0,0.0
<a href=/player/butlj101>butlj101</a>,Johnny Butler,Minneapolis,Minneapolis,1,1,5,6,1926,1933,7,No,0,0.6,0.0,-0.6,296,0,-296,1153,0,-1153,0.0,0.0,0.0,0.0,0.0,0.0
<a href=/player/butlj101>butlj101</a>,Johnny Butler,Brooklyn Dodgers,DOGRS,2,4,2,6,1927,1934,7,No,0,0.53,8.07,7.54,100,526,426,99,1883,1784,677.0,0.0,-677.0,30000.0,0.0,-30000.0
<a href=/player/butlj101>butlj101</a>,Johnny Butler,Milwaukee,Milwaukee,1,1,2,3,1927,1927,0,No,0,0.3,0.0,-0.3,62,0,-62,201,0,-201,0.0,0.0,0.0,0.0,0.0,0.0
<a href=/player/buttt001>buttt001</a>,Ty Buttrey,Boston Red Sox,RSOX,1,2,2,4,2018,2018,0,No,0,0.49,-0.14,-0.63,139,37,-102,0,143,143,390.0,0.0,-390.0,0.0,0.0,0.0
<a href=/player/buxtr101>buxtr101</a>,Ralph Buxton,Philadelphia Athletics,ATLTCS,2,6,2,8,1938,1939,1,No,0,0.0,-1.04,-1.04,0,60,60,0,37,37,0.0,323.0,323.0,5100.0,0.0,-5100.0
<a href=/player/buxtr101>buxtr101</a>,Ralph Buxton,Oakland,Oakland,1,1,3,4,1949,1949,0,No,0,0.1,0.0,-0.1,28,0,-28,3,0,-3,80.0,0.0,-80.0,0.0,0.0,0.0
<a href=/player/buzhj101>buzhj101</a>,John Buzhardt,Chicago Cubs,CUBS,1,3,1,4,1960,1961,1,No,0,4.05,4.05,0.0,233,260,27,447,1040,593,1208.0,0.0,-1208.0,0.0,0.0,0.0
<a href=/player/buzhj101>buzhj101</a>,John Buzhardt,Philadelphia Phillies,PHILS,1,2,1,3,1961,1964,3,No,0,5.78,3.33,-2.45,417,331,-86,480,1188,708,2599.0,0.0,-2599.0,0.0,0.0,0.0
<a href=/player/byerb103>byerb103</a>,Bud Byerly,Cincinnati Reds,REDS,1,2,1,3,1952,1957,5,No,0,0.0,2.38,2.38,0,218,218,0,150,150,0.0,1386.0,1386.0,6000.0,0.0,-6000.0
<a href=/player/byerb103>byerb103</a>,Bud Byerly,Brooklyn Dodgers,DOGRS,1,1,1,2,1953,1953,0,No,0,0.32,0.0,-0.32,60,0,-60,2,0,-2,105.0,0.0,-105.0,0.0,0.0,0.0
<a href=/player/byerb103>byerb103</a>,Bud Byerly,Washington Senators,TWINS,1,1,1,2,1958,1965,7,No,0,0.43,-0.47,-0.9,36,6,-30,4,2,-2,91.0,21.0,-70.0,11000.0,0.0,-11000.0
<a href=/player/byerb103>byerb103</a>,Bud Byerly,Boston Red Sox,RSOX,1,1,2,3,1959,1959,0,No,0,0.32,0.0,-0.32,60,0,-60,2,0,-2,105.0,0.0,-105.0,0.0,0.0,0.0
<a href=/player/byerr001>byerr001</a>,Randy Byers,San Diego Padres,PADRS,4,6,6,12,1989,2000,11,No,0,0.96,-0.13,-1.09,77,166,89,3,16,13,299.0,424.0,125.0,448500.0,0.0,-448500.0
<a href=/player/bynuf001>bynuf001</a>,Freddie Bynum,Oakland Athletics,ATLTCS,1,2,1,3,2006,2006,0,No,0,-0.48,0.0,0.48,71,0,-71,148,0,-148,0.0,0.0,0.0,0.0,0.0,0.0
<a href=/player/bynuf001>bynuf001</a>,Freddie Bynum,Chicago Cubs,CUBS,3,5,6,11,2006,2013,7,No,0,14.01,1.49,-12.52,1141,382,-759,3294,73,-3221,719.0,1062.0,343.0,732500.0,0.0,-732500.0
<a href=/player/byrdh101>byrdh101</a>,Harry Byrd,Philadelphia Athletics,ATLTCS,46,109,116,225,1953,1976,23,No,0,189.08,109.39,-79.69,16486,13560,-2926,40867,38903,-1964,20759.0,16429.0,-4330.0,546100.0,0.0,-546100.0
<a href=/player/byrdh101>byrdh101</a>,Harry Byrd,New York Yankees,YANKS,12,33,27,60,1954,1970,16,No,0,40.55,76.98,36.43,5201,4368,-833,16466,10777,-5689,3212.0,10751.0,7539.0,302500.0,0.0,-302500.0
<a href=/player/byrdh101>byrdh101</a>,Harry Byrd,Chicago White Sox,WSOX,10,18,21,39,1956,1971,15,No,0,41.93,77.23,35.3,3299,4500,1201,10984,12532,1548,917.0,5807.0,4890.0,83500.0,0.0,-83500.0
<a href=/player/byrdm001>byrdm001</a>,Marlon Byrd,Philadelphia Phillies,PHILS,1,1,1,2,2005,2005,0,No,0,1.06,-0.42,-1.48,152,91,-61,472,118,-354,0.0,0.0,0.0,0.0,0.0,0.0
<a href=/player/byrdm001>byrdm001</a>,Marlon Byrd,Chicago Cubs,CUBS,1,2,2,4,2012,2015,3,No,0,-0.16,0.77,0.93,34,128,94,106,2,-104,0.0,223.0,223.0,0.0,0.0,0.0
<a href=/player/byrdm001>byrdm001</a>,Marlon Byrd,New York Mets,METS,4,7,5,12,2013,2021,8,Yes,0,1.02,3.24,2.22,135,327,192,405,855,450,0.0,146.0,146.0,13000000.0,0.0,-13000000.0
<a href=/player/byrdm001>byrdm001</a>,Marlon Byrd,Philadelphia Phillies,PHILS,1,2,1,3,2014,2018,4,No,0,0.81,1.36,0.55,96,39,-57,388,33,-355,0.0,337.0,337.0,8000000.0,0.0,-8000000.0
<a href=/player/byrdm001>byrdm001</a>,Marlon Byrd,Cincinnati Reds,REDS,1,2,1,3,2015,2015,0,Yes,0,0.57,0.0,-0.57,39,0,-39,156,0,-156,0.0,0.0,0.0,0.0,0.0,0.0
<a href=/player/byrdp001>byrdp001</a>,Paul Byrd,Cleveland Indians,INDINS,5,11,9,20,1994,2001,7,No,0,59.36,5.4,-53.96,3537,380,-3157,10591,1129,-9462,3110.0,195.0,-2915.0,7871666.0,0.0,-7871666.0
<a href=/player/byrdp001>byrdp001</a>,Paul Byrd,New York Mets,METS,2,4,3,7,1996,1999,3,No,0,1.53,1.68,0.15,165,283,118,98,37,-61,946.0,702.0,-244.0,3273000.0,0.0,-3273000.0
<a href=/player/byrdp001>byrdp001</a>,Paul Byrd,Philadelphia Phillies,PHILS,1,1,1,2,2001,2002,1,No,0,7.23,-0.82,-8.05,52,183,131,7,7,0,965.0,328.0,-637.0,0.0,0.0,0.0
<a href=/player/byrdp001>byrdp001</a>,Paul Byrd,Cleveland Indians,INDINS,1,1,1,2,2008,2009,1,No,0,0.81,0.0,-0.81,15,0,-15,0,0,0,249.0,0.0,-249.0,7500000.0,0.0,-7500000.0
<a href=/player/byrnb101>byrnb101</a>,Bobby Byrne,St. Louis Cardinals,CARDS,2,3,5,8,1909,1914,5,No,0,11.73,6.08,-5.65,660,875,215,2738,3442,704,641.0,470.0,-171.0,0.0,0.0,0.0
<a href=/player/byrnb101>byrnb101</a>,Bobby Byrne,Pittsburgh Pirates,PIRATS,2,7,5,12,1913,1915,2,No,0,18.65,3.36,-15.29,2062,268,-1794,7394,1089,-6305,942.0,0.0,-942.0,19200.0,0.0,-19200.0
<a href=/player/byrne001>byrne001</a>,Eric Byrnes,Oakland Athletics,ATLTCS,1,2,2,4,2005,2007,2,No,0,0.29,2.31,2.02,231,152,-79,619,3,-616,0.0,786.0,786.0,2200000.0,0.0,-2200000.0
<a href=/player/byrne001>byrne001</a>,Eric Byrnes,Colorado Rockies,ROCKS,2,3,2,5,2005,2006,1,No,0,1.69,-0.43,-2.12,555,154,-401,1688,71,-1617,15.0,134.0,119.0,326000.0,0.0,-326000.0
<a href=/player/byrnm101>byrnm101</a>,Milt Byrnes,St.Louis Browns,ORLS,1,2,1,3,1946,1946,0,No,0,0.0,0.02,0.02,0,7,7,0,18,18,0.0,0.0,0.0,0.0,0.0,0.0
<a href=/player/byrnm101>byrnm101</a>,Milt Byrnes,New York Yankees,YANKS,1,2,2,4,1948,1948,0,No,0,0.1,0.0,-0.1,6,0,-6,0,0,0,12.0,0.0,-12.0,0.0,0.0,0.0
<a href=/player/byrnt101>byrnt101</a>,Tommy Byrne,New York Yankees,YANKS,1,2,1,3,1951,1952,1,No,0,3.65,-0.3,-3.95,122,30,-92,152,9,-143,956.0,134.0,-822.0,18000.0,0.0,-18000.0
<a href=/player/byrnt101>byrnt101</a>,Tommy Byrne,St.Louis Browns,ORLS,1,2,2,4,1952,1954,2,No,0,-0.79,-0.8,-0.01,24,89,65,20,141,121,48.0,0.0,-48.0,19250.0,0.0,-19250.0
<a href=/player/byrnt101>byrnt101</a>,Tommy Byrne,Chicago White Sox,WSOX,1,1,1,2,1953,1953,0,No,0,0.0,0.0,0.0,0,0,0,0,0,0,0.0,0.0,0.0,0.0,0.0,0.0
<a href=/player/bystm001>bystm001</a>,Marty Bystrom,Philadelphia Phillies,PHILS,3,5,6,11,1984,1990,6,No,0,0.32,13.19,12.87,143,596,453,310,1528,1218,676.0,2713.0,2037.0,1725000.0,0.0,-1725000.0
<a href=/player/cabee001>cabee001</a>,Enos Cabell,Baltimore Orioles,ORLS,1,2,2,4,1974,1980,6,No,0,10.57,4.54,-6.03,1279,794,-485,5010,3158,-1852,0.0,0.0,0.0,16000.0,0.0,-16000.0
<a href=/player/cabee001>cabee001</a>,Enos Cabell,Houston Astros,ASTROS,2,3,3,6,1980,1989,9,No,0,-1.4,11.24,12.64,96,653,557,413,857,444,0.0,5214.0,5214.0,0.0,0.0,0.0
<a href=/player/cabee001>cabee001</a>,Enos Cabell,San Francisco Giants,GIANTS,2,3,3,6,1982,1984,2,No,0,2.91,-0.41,-3.32,293,116,-177,963,200,-763,0.0,0.0,0.0,0.0,0.0,0.0
<a href=/player/cabee001>cabee001</a>,Enos Cabell,Houston Astros,ASTROS,1,1,2,3,1985,1985,0,No,0,0.39,-0.13,-0.52,164,13,-151,506,41,-465,0.0,0.0,0.0,291667.0,0.0,-291667.0
<a href=/player/cabra002>cabra002</a>,Asdrubal Cabrera,Seattle Mariners,MARNRS,1,1,1,2,2006,2006,0,No,0,20.73,-0.89,-21.62,914,43,-871,3871,102,-3769,0.0,0.0,0.0,0.0,0.0,0.0
<a href=/player/cabra002>cabra002</a>,Asdrubal Cabrera,Cleveland Indians,INDINS,1,2,1,3,2014,2016,2,No,0,1.51,-0.51,-2.02,139,42,-97,559,124,-435,0.0,0.0,0.0,10000000.0,0.0,-10000000.0
<a href=/player/cabra002>cabra002</a>,Asdrubal Cabrera,New York Mets,METS,1,1,1,2,2018,2021,3,No,0,-0.75,-0.31,0.44,49,4,-45,185,0,-185,0.0,34.0,34.0,8250000.0,0.0,-8250000.0
<a href=/player/cabrf001>cabrf001</a>,Francisco Cabrera,Toronto Blue Jays,BJAYS,1,2,1,3,1989,1991,2,No,0,0.35,0.29,-0.06,335,127,-208,372,0,-372,284.0,625.0,341.0,71500.0,0.0,-71500.0
<a href=/player/cabrg001>cabrg001</a>,Genesis Cabrera,Tampa Bay Devil Rays,RAYS,2,5,5,10,2018,2020,2,Yes,0,6.49,6.47,-0.02,634,226,-408,1668,967,-701,343.0,0.0,-343.0,4100000.0,0.0,-4100000.0
<a href=/player/cabrj001>cabrj001</a>,Jose Cabrera,Cleveland Indians,INDINS,8,13,15,28,1997,2011,14,No,0,5.88,12.35,6.47,1245,1518,273,2426,3926,1500,767.0,1598.0,831.0,9756200.0,0.0,-9756200.0
<a href=/player/cabrj001>cabrj001</a>,Jose Cabrera,Atlanta Braves,BRAVES,1,2,1,3,2002,2003,1,No,0,-3.2,-1.6,1.6,184,136,-48,277,415,138,310.0,0.0,-310.0,0.0,0.0,0.0
<a href=/player/cabrj002>cabrj002</a>,Jolbert Cabrera,Cleveland Indians,INDINS,1,1,1,2,2002,2002,0,No,0,0.55,0.0,-0.55,138,0,-138,395,0,-395,0.0,0.0,0.0,266000.0,0.0,-266000.0
<a href=/player/cabrj002>cabrj002</a>,Jolbert Cabrera,Los Angeles Dodgers,DOGRS,2,2,3,5,2004,2004,0,No,0,0.37,0.0,-0.37,113,0,-113,391,0,-391,0.0,0.0,0.0,0.0,0.0,0.0
<a href=/player/cabrm001>cabrm001</a>,Miguel Cabrera,Florida Marlins,MARLNS,5,6,11,17,2007,2013,6,No,0,60.75,3.64,-57.11,2705,1161,-1544,9389,789,-8600,1298.0,2358.0,1060.0,18420219.0,0.0,-18420219.0
<a href=/player/cabrm002>cabrm002</a>,Melky Cabrera,New York Yankees,YANKS,2,5,3,8,2001,2013,12,No,1,3.9,2.44,-1.46,585,309,-276,511,6,-505,625.0,1000.0,375.0,1800000.0,0.0,-1800000.0
<a href=/player/cabrm002>cabrm002</a>,Melky Cabrera,Kansas City Royals,ROYALS,2,2,3,5,2011,2015,4,No,0,4.43,2.02,-2.41,119,130,11,504,19,-485,34.0,2126.0,2092.0,6850000.0,0.0,-6850000.0
<a href=/player/cabrm002>cabrm002</a>,Melky Cabrera,Chicago White Sox,WSOX,1,2,2,4,2017,2017,0,Yes,0,-1.04,0.0,1.04,58,0,-58,238,0,-238,0.0,0.0,0.0,15000000.0,0.0,-15000000.0
<a href=/player/cabro001>cabro001</a>,Orlando Cabrera,Montreal Expos,NATEX,2,6,6,12,2004,2009,5,No,0,1.16,-0.94,-2.1,763,893,130,429,3105,2676,809.0,182.0,-627.0,7352000.0,0.0,-7352000.0
<a href=/player/cabro001>cabro001</a>,Orlando Cabrera,Anaheim Angels,ANGELS,2,2,2,4,2007,2008,1,No,1,2.56,0.8,-1.76,161,33,-128,730,3,-727,0.0,590.0,590.0,8500000.0,0.0,-8500000.0
<a href=/player/cabro001>cabro001</a>,Orlando Cabrera,Oakland Athletics,ATLTCS,1,1,1,2,2009,2016,7,No,0,-0.05,-0.43,-0.38,59,54,-5,260,68,-192,0.0,3.0,3.0,4000000.0,0.0,-4000000.0
<a href=/player/cabro001>cabro001</a>,Orlando Cabrera,Cleveland Indians,INDINS,1,1,1,2,2011,2013,2,No,0,-0.03,-0.32,-0.29,39,9,-30,133,24,-109,0.0,0.0,0.0,1000000.0,0.0,-1000000.0
<a href=/player/cabrr001>cabrr001</a>,Ramon Cabrera,Pittsburgh Pirates,PIRATS,1,1,1,2,2012,2014,2,No,0,0.0,0.0,0.0,0,0,0,0,0,0,0.0,0.0,0.0,0.0,0.0,0.0
<a href=/player/cacec101>cacec101</a>,Craig Cacek,New York Mets,METS,1,1,1,2,1975,1975,0,No,0,-0.52,0.0,0.52,7,0,-7,21,0,-21,0.0,0.0,0.0,0.0,0.0,0.0
<a href=/player/cacee001>cacee001</a>,Edgar Caceres,Montreal Expos,NATEX,1,1,1,2,1988,1988,0,No,0,0.0,0.0,0.0,0,0,0,0,0,0,0.0,0.0,0.0,0.0,0.0,0.0
<a href=/player/cadag001>cadag001</a>,Greg Cadaret,Oakland Athletics,ATLTCS,3,5,4,9,1989,1998,9,No,0,13.62,32.12,18.5,801,794,-7,1223,2883,1660,2766.0,771.0,-1995.0,4272766.0,0.0,-4272766.0
<a href=/player/cadyh101>cadyh101</a>,Hick Cady,JerseyCity,JerseyCity,1,1,6,7,1912,1921,9,No,0,3.45,0.0,-3.45,321,0,-321,894,0,-894,0.0,0.0,0.0,0.0,0.0,0.0
<a href=/player/cadyh101>cadyh101</a>,Hick Cady,Boston Red Sox,RSOX,8,19,22,41,1918,1935,17,No,0,51.77,23.6,-28.17,3792,2718,-1074,15081,10291,-4790,0.0,1203.0,1203.0,45050.0,0.0,-45050.0
<a href=/player/cagew101>cagew101</a>,Wayne Cage,Cleveland Indians,INDINS,1,1,1,2,1981,1985,4,No,0,0.0,-0.52,-0.52,0,49,49,0,71,71,0.0,0.0,0.0,0.0,0.0,0.0
<a href=/player/cahit001>cahit001</a>,Trevor Cahill,Oakland Athletics,ATLTCS,3,5,5,10,2011,2015,4,No,0,0.11,4.67,4.56,286,252,-34,221,116,-105,1515.0,585.0,-930.0,3722500.0,0.0,-3722500.0
<a href=/player/cahit001>cahit001</a>,Trevor Cahill,Arizona Diamondbacks,DBACKS,1,2,1,3,2015,2015,0,Yes,0,-0.68,0.0,0.68,30,0,-30,5,0,-5,79.0,0.0,-79.0,0.0,0.0,0.0
<a href=/player/cahit001>cahit001</a>,Trevor Cahill,San Diego Padres,PADRS,1,3,4,7,2017,2017,0,Yes,0,-1.51,-0.81,0.7,107,22,-85,1,17,16,304.0,157.0,-147.0,4194700.0,0.0,-4194700.0
<a href=/player/cainb101>cainb101</a>,Bob Cain,Chicago White Sox,WSOX,2,4,2,6,1951,1955,4,No,0,0.66,6.53,5.87,71,225,154,61,356,295,448.0,1666.0,1218.0,7000.0,0.0,-7000.0
<a href=/player/cainb101>cainb101</a>,Bob Cain,Detroit Tigers,TIGRS,11,26,24,50,1952,1961,9,No,0,21.38,15.7,-5.68,2119,2215,96,3938,6442,2504,5639.0,2357.0,-3282.0,45200.0,0.0,-45200.0
<a href=/player/cainb101>cainb101</a>,Bob Cain,Baltimore Orioles,ORLS,1,1,2,3,1953,1955,2,No,0,0.0,1.98,1.98,0,78,78,0,84,84,0.0,699.0,699.0,13500.0,0.0,-13500.0
<a href=/player/cainb101>cainb101</a>,Bob Cain,New York Giants,GIANTS,1,1,1,2,1949,1949,0,No,0,3.79,0.0,-3.79,90,0,-90,79,0,-79,627.0,0.0,-627.0,0.0,0.0,0.0
<a href=/player/cainl001>cainl001</a>,Lorenzo Cain,Milwaukee Brewers,BREWRS,8,16,16,32,2010,2020,10,Yes,0,33.31,23.99,-9.32,2772,1309,-1463,10420,3997,-6423,777.0,2948.0,2171.0,20405500.0,0.0,-20405500.0
<a href=/player/cains101>cains101</a>,Sugar Cain,Philadelphia Athletics,ATLTCS,1,2,1,3,1935,1936,1,No,0,2.31,1.97,-0.34,270,46,-224,676,55,-621,552.0,447.0,-105.0,9500.0,0.0,-9500.0
<a href=/player/cains101>cains101</a>,Sugar Cain,St.Louis Browns,ORLS,1,1,1,2,1936,1939,3,No,0,1.16,-0.39,-1.55,107,75,-32,111,50,-61,851.0,427.0,-424.0,5500.0,0.0,-5500.0
<a href=/player/cairm001>cairm001</a>,Miguel Cairo,Los Angeles Dodgers,DOGRS,1,2,1,3,1995,1996,1,No,0,0.25,-0.12,-0.37,108,92,-16,250,358,108,0.0,0.0,0.0,0.0,0.0,0.0
<a href=/player/cairm001>cairm001</a>,Miguel Cairo,Seattle Mariners,MARNRS,2,3,3,6,1995,1997,2,No,0,0.75,-0.72,-1.47,99,11,-88,44,0,-44,434.0,126.0,-308.0,135000.0,0.0,-135000.0
<a href=/player/cairm001>cairm001</a>,Miguel Cairo,Toronto Blue Jays,BJAYS,1,1,1,2,1996,1996,0,No,0,0.57,0.0,-0.57,82,0,-82,179,0,-179,0.0,0.0,0.0,0.0,0.0,0.0
<a href=/player/cairm001>cairm001</a>,Miguel Cairo,Oakland Athletics,ATLTCS,6,11,10,21,2001,2012,11,No,2,22.23,5.23,-17.0,1569,359,-1210,3188,656,-2532,5533.0,556.0,-4977.0,2433333.0,0.0,-2433333.0
<a href=/player/caldi001>caldi001</a>,Ivan Calderon,Seattle Mariners,MARNRS,1,1,1,2,1986,1992,6,No,0,8.47,-0.89,-9.36,554,562,8,2313,1698,-615,0.0,0.0,0.0,0.0,0.0,0.0
<a href=/player/caldi001>caldi001</a>,Ivan Calderon,Chicago White Sox,WSOX,2,3,4,7,1990,1996,6,No,0,7.45,16.61,9.16,578,648,70,1665,2873,1208,266.0,0.0,-266.0,4830000.0,0.0,-4830000.0
<a href=/player/caldi001>caldi001</a>,Ivan Calderon,Montreal Expos,NATEX,1,1,2,3,1992,1993,1,No,0,-0.29,-0.63,-0.34,73,48,-25,239,5,-234,0.0,114.0,114.0,2600000.0,0.0,-2600000.0
<a href=/player/caldm001>caldm001</a>,Mike Caldwell,San Diego Padres,PADRS,1,1,2,3,1973,1976,3,No,0,0.92,5.26,4.34,238,321,83,143,1142,999,1380.0,0.0,-1380.0,0.0,0.0,0.0
<a href=/player/caldm001>caldm001</a>,Mike Caldwell,San Francisco Giants,GIANTS,3,6,6,12,1976,1979,3,No,1,0.11,-0.39,-0.5,172,638,466,406,1241,835,25.0,782.0,757.0,0.0,0.0,0.0
<a href=/player/caldm001>caldm001</a>,Mike Caldwell,St. Louis Cardinals,CARDS,1,1,1,2,1977,1977,0,No,0,0.39,0.0,-0.39,28,0,-28,5,0,-5,74.0,0.0,-74.0,0.0,0.0,0.0
<a href=/player/caldm001>caldm001</a>,Mike Caldwell,Cincinnati Reds,REDS,1,1,2,3,1977,1977,0,No,0,17.3,0.0,-17.3,239,0,-239,0,0,0,4814.0,0.0,-4814.0,0.0,0.0,0.0
<a href=/player/caldr101>caldr101</a>,Ray Caldwell,New York Yankees,YANKS,5,19,8,27,1918,1928,10,No,0,9.22,7.55,-1.67,1051,1233,182,2808,4705,1897,3476.0,418.0,-3058.0,39950.0,0.0,-39950.0
<a href=/player/calds101>calds101</a>,Sam Calderone,New York Giants,GIANTS,15,30,31,61,1954,1968,14,No,0,48.23,65.72,17.49,4661,4032,-629,15306,7933,-7373,2020.0,13164.0,11144.0,128000.0,0.0,-128000.0
<a href=/player/calek001>calek001</a>,Kiko Calero,St. Louis Cardinals,CARDS,1,3,1,4,2004,2008,4,No,0,22.03,0.48,-21.55,848,107,-741,2102,105,-1997,2465.0,933.0,-1532.0,305000.0,0.0,-305000.0
<a href=/player/calhj001>calhj001</a>,Jeff Calhoun,Houston Astros,ASTROS,1,1,1,2,1987,1987,0,No,0,1.02,-0.99,-2.01,90,38,-52,1,107,106,135.0,0.0,-135.0,0.0,0.0,0.0
<a href=/player/calhw001>calhw001</a>,Willie Calhoun,Los Angeles Dodgers,DOGRS,1,3,1,4,2017,2017,0,No,0,-1.3,0.52,1.82,240,18,-222,874,20,-854,69.0,149.0,80.0,0.0,0.0,0.0
<a href=/player/calla001>calla001</a>,Alberto Callaspo,Anaheim Angels,ANGELS,1,1,1,2,2006,2011,5,No,0,-1.33,0.7,2.03,79,125,46,203,0,-203,0.0,369.0,369.0,0.0,0.0,0.0
<a href=/player/calla001>calla001</a>,Alberto Callaspo,Arizona Diamondbacks,DBACKS,2,2,3,5,2007,2010,3,No,0,4.69,-1.41,-6.1,317,67,-250,1241,35,-1206,0.0,380.0,380.0,380000.0,0.0,-380000.0
<a href=/player/calla001>calla001</a>,Alberto Callaspo,Kansas City Royals,ROYALS,2,2,3,5,2010,2014,4,No,0,8.57,-0.23,-8.8,773,193,-580,1620,549,-1071,453.0,756.0,303.0,460000.0,0.0,-460000.0
<a href=/player/calla001>calla001</a>,Alberto Callaspo,Anaheim Angels,ANGELS,1,1,1,2,2013,2015,2,No,0,-0.57,-0.66,-0.09,177,104,-73,631,284,-347,0.0,0.0,0.0,0.0,0.0,0.0
<a href=/player/calla001>calla001</a>,Alberto Callaspo,Atlanta Braves,BRAVES,6,15,9,24,2015,2021,6,Yes,0,3.56,2.51,-1.05,557,291,-266,805,489,-316,986.0,676.0,-310.0,21307500.0,0.0,-21307500.0
<a href=/player/callb101>callb101</a>,Ben Callahan,New York Yankees,YANKS,1,3,1,4,1983,1984,1,No,0,-1.24,-0.76,0.48,9,12,3,14,0,-14,28.0,167.0,139.0,0.0,0.0,0.0
<a href=/player/callf101>callf101</a>,Frank Callaway,Philadelphia Athletics,ATLTCS,2,6,2,8,1922,1932,10,No,0,0.0,50.56,50.56,0,1369,1369,0,6016,6016,0.0,0.0,0.0,9900.0,0.0,-9900.0
<a href=/player/callj001>callj001</a>,Jamie Callahan,Boston Red Sox,RSOX,1,3,1,4,2017,2017,0,No,0,-0.57,0.56,1.13,43,31,-12,1,0,-1,62.0,81.0,19.0,0.0,0.0,0.0
<a href=/player/callj101>callj101</a>,Johnny Callison,Chicago White Sox,WSOX,3,3,4,7,1959,1978,19,No,0,41.04,68.05,27.01,1807,1541,-266,6860,1303,-5557,426.0,11173.0,10747.0,26000.0,0.0,-26000.0
<a href=/player/callj101>callj101</a>,Johnny Callison,Philadelphia Phillies,PHILS,4,8,8,16,1969,1984,15,No,0,29.76,14.53,-15.23,1654,1829,175,6186,1998,-4188,0.0,2963.0,2963.0,0.0,0.0,0.0
<a href=/player/callj101>callj101</a>,Johnny Callison,Chicago Cubs,CUBS,1,1,1,2,1972,1974,2,No,0,-0.69,0.4,1.09,137,190,53,442,14,-428,0.0,392.0,392.0,0.0,0.0,0.0
<a href=/player/callj102>callj102</a>,Joe Callahan,Boston Braves,BRAVES,1,1,1,2,1940,1941,1,No,0,0.0,-0.83,-0.83,0,44,44,0,24,24,0.0,186.0,186.0,0.0,0.0,0.0
<a href=/player/calll101>calll101</a>,Leo Callahan,Brooklyn Dodgers,DOGRS,4,9,6,15,1915,1927,12,No,0,6.65,17.83,11.18,787,1627,840,3022,6661,3639,0.0,0.0,0.0,27500.0,0.0,-27500.0
<a href=/player/callm001>callm001</a>,Mickey Callaway,Tampa Bay Devil Rays,RAYS,1,1,1,2,2001,2001,0,No,0,-0.61,0.0,0.61,26,0,-26,0,0,0,218.0,0.0,-218.0,0.0,0.0,0.0
<a href=/player/callm101>callm101</a>,Marty Callaghan,Cincinnati Reds,REDS,3,7,3,10,1930,1932,2,No,0,-0.61,5.83,6.44,32,321,289,78,1329,1251,9.0,0.0,-9.0,5500.0,0.0,-5500.0
<a href=/player/callr001>callr001</a>,Ron Calloway,Arizona Diamondbacks,DBACKS,1,1,1,2,1999,1999,0,No,0,-1.27,0.0,1.27,172,0,-172,460,0,-460,0.0,0.0,0.0,0.0,0.0,0.0
<a href=/player/calmd101>calmd101</a>,Dick Calmus,Los Angeles Dodgers,DOGRS,1,1,1,2,1967,1970,3,No,0,-0.13,-0.47,-0.34,2,60,58,2,11,9,13.0,186.0,173.0,0.0,0.0,0.0
<a href=/player/calvj101>calvj101</a>,Jack Calvo,Washington Senators,TWINS,4,8,6,14,1920,1933,13,No,0,25.21,15.96,-9.25,1580,828,-752,6114,3136,-2978,0.0,616.0,616.0,3600.0,0.0,-3600.0
<a href=/player/camae001>camae001</a>,Ernie Camacho,Oakland Athletics,ATLTCS,1,2,1,3,1981,1983,2,No,0,-0.08,-0.75,-0.67,14,83,69,5,0,-5,65.0,424.0,359.0,0.0,0.0,0.0
<a href=/player/camae001>camae001</a>,Ernie Camacho,Pittsburgh Pirates,PIRATS,1,2,2,4,1982,1983,1,No,0,4.04,-0.83,-4.87,410,24,-386,1402,12,-1390,0.0,132.0,132.0,0.0,0.0,0.0
<a href=/player/camae001>camae001</a>,Ernie Camacho,Milwaukee Brewers,BREWRS,1,3,2,5,1983,1987,4,No,0,7.32,0.25,-7.07,394,574,180,437,1374,937,1362.0,450.0,-912.0,600000.0,0.0,-600000.0
<a href=/player/camed001>camed001</a>,Daz Cameron,Houston Astros,ASTROS,1,3,3,6,2017,2021,4,Yes,0,-0.1,16.16,16.26,126,77,-49,429,7,-422,3.0,1431.0,1428.0,0.0,0.0,0.0
<a href=/player/cameh101>cameh101</a>,Hank Camelli,Pittsburgh Pirates,PIRATS,1,2,4,6,1946,1949,3,No,0,25.05,-0.22,-25.27,770,168,-602,3219,87,-3132,0.0,478.0,478.0,0.0,0.0,0.0
<a href=/player/cameh101>cameh101</a>,Hank Camelli,Boston Braves,BRAVES,1,1,1,2,1947,1947,0,No,0,0.0,0.0,0.0,0,0,0,0,0,0,0.0,0.0,0.0,0.0,0.0,0.0
<a href=/player/camem001>camem001</a>,Mike Cameron,Chicago White Sox,WSOX,1,1,1,2,1998,2014,16,No,0,5.52,29.25,23.73,146,2268,2122,636,9258,8622,0.0,0.0,0.0,230000.0,0.0,-230000.0
<a href=/player/camem001>camem001</a>,Mike Cameron,Cincinnati Reds,REDS,2,6,3,9,2000,2013,13,No,0,18.66,15.9,-2.76,696,1440,744,2678,3953,1275,381.0,721.0,340.0,8282695.0,0.0,-8282695.0
<a href=/player/camem001>camem001</a>,Mike Cameron,New York Mets,METS,4,4,6,10,2005,2014,9,No,2,10.48,1.88,-8.6,561,325,-236,2335,471,-1864,0.0,1630.0,1630.0,7760333.0,0.0,-7760333.0
<a href=/player/camia001>camia001</a>,Arquimedes Caminero,Pittsburgh Pirates,PIRATS,1,1,2,3,2016,2019,3,Yes,0,-0.38,0.0,0.38,18,0,-18,0,0,0,59.0,0.0,-59.0,532500.0,0.0,-532500.0
<a href=/player/camid102>camid102</a>,Dolph Camilli,Chicago Cubs,CUBS,1,1,1,2,1934,1935,1,No,0,12.75,-0.9,-13.65,540,51,-489,2322,159,-2163,0.0,0.0,0.0,0.0,0.0,0.0
<a href=/player/camid102>camid102</a>,Dolph Camilli,Philadelphia Phillies,PHILS,1,1,2,3,1938,1938,0,No,0,29.74,0.0,-29.74,839,0,-839,3606,0,-3606,0.0,0.0,0.0,0.0,0.0,0.0
<a href=/player/camid102>camid102</a>,Dolph Camilli,Brooklyn Dodgers,DOGRS,3,7,5,12,1943,1947,4,No,0,-0.39,6.32,6.71,76,587,511,39,2174,2135,380.0,123.0,-257.0,0.0,0.0,0.0
<a href=/player/camid102>camid102</a>,Dolph Camilli,New York Giants,GIANTS,1,1,1,2,1943,1943,0,No,0,0.0,0.0,0.0,0,0,0,0,0,0,0.0,0.0,0.0,0.0,0.0,0.0
<a href=/player/camik001>camik001</a>,Ken Caminiti,Houston Astros,ASTROS,15,31,38,69,1994,2011,17,No,2,59.26,30.42,-28.84,4671,6149,1478,11202,16044,4842,6620.0,5977.0,-643.0,31714000.0,0.0,-31714000.0
<a href=/player/camil101>camil101</a>,Lou Camilli,Cleveland Indians,INDINS,2,2,2,4,1973,1974,1,No,0,0.0,-0.03,-0.03,0,2,2,0,3,3,0.0,0.0,0.0,0.0,0.0,0.0
<a href=/player/camnh101>camnh101</a>,Howie Camnitz,Pittsburgh Pirates,PIRATS,2,7,5,12,1913,1915,2,No,0,18.65,3.36,-15.29,2062,268,-1794,7394,1089,-6305,942.0,0.0,-942.0,19200.0,0.0,-19200.0
<a href=/player/campb001>campb001</a>,Bill Campbell,Chicago Cubs,CUBS,4,10,8,18,1984,1987,3,No,0,1.78,8.04,6.26,606,1265,659,954,3508,2554,1010.0,823.0,-187.0,1753333.0,0.0,-1753333.0
<a href=/player/campb001>campb001</a>,Bill Campbell,Philadelphia Phillies,PHILS,1,2,1,3,1985,1986,1,No,0,-0.41,-0.15,0.26,159,118,-41,87,15,-72,193.0,313.0,120.0,0.0,0.0,0.0
<a href=/player/campb101>campb101</a>,Bert Campaneris,Texas Rangers,RNGRS,5,9,6,15,1979,1992,13,No,2,15.57,11.99,-3.58,1284,549,-735,3501,1738,-1763,4307.0,1272.0,-3035.0,190000.0,0.0,-190000.0
<a href=/player/campb102>campb102</a>,Bruce Campbell,Chicago White Sox,WSOX,2,3,2,5,1932,1940,8,No,0,17.91,-0.15,-18.06,925,353,-572,3007,1416,-1591,2296.0,0.0,-2296.0,17600.0,0.0,-17600.0
<a href=/player/campb102>campb102</a>,Bruce Campbell,St.Louis Browns,ORLS,2,2,4,6,1934,1936,2,No,0,10.32,-0.53,-10.85,553,210,-343,2157,827,-1330,0.0,0.0,0.0,4250.0,0.0,-4250.0
<a href=/player/campb102>campb102</a>,Bruce Campbell,Cleveland Indians,INDINS,1,1,1,2,1940,1940,0,No,0,2.7,0.27,-2.43,244,120,-124,931,482,-449,0.0,0.0,0.0,0.0,0.0,0.0
<a href=/player/campb102>campb102</a>,Bruce Campbell,Detroit Tigers,TIGRS,1,2,2,4,1941,1948,7,No,0,0.26,3.39,3.13,148,1062,914,484,4332,3848,0.0,0.0,0.0,10000.0,0.0,-10000.0
<a href=/player/campc102>campc102</a>,Cardell Camper,St. Louis Cardinals,CARDS,1,1,1,2,1976,1976,0,No,0,0.09,0.0,-0.09,3,0,-3,0,0,0,28.0,0.0,-28.0,0.0,0.0,0.0
<a href=/player/campc102>campc102</a>,Cardell Camper,Cleveland Indians,INDINS,1,1,1,2,1978,1984,6,No,0,0.0,1.54,1.54,0,201,201,0,722,722,0.0,0.0,0.0,0.0,0.0,0.0
<a href=/player/campd101>campd101</a>,Dave Campbell,Detroit Tigers,TIGRS,1,2,1,3,1969,1973,4,No,0,3.09,4.22,1.13,408,176,-232,1366,140,-1226,753.0,1147.0,394.0,12000.0,0.0,-12000.0
<a href=/player/campd101>campd101</a>,Dave Campbell,San Diego Padres,PADRS,2,2,2,4,1973,1973,0,No,0,-0.66,-1.27,-0.61,15,53,38,27,123,96,0.0,0.0,0.0,0.0,0.0,0.0
<a href=/player/campd101>campd101</a>,Dave Campbell,St. Louis Cardinals,CARDS,2,3,2,5,1973,1974,1,No,0,-0.06,0.43,0.49,44,52,8,40,67,27,0.0,34.0,34.0,0.0,0.0,0.0
<a href=/player/campd102>campd102</a>,Dave Campbell,Atlanta Braves,BRAVES,3,4,6,10,1979,1981,2,No,0,1.23,0.82,-0.41,177,350,173,304,857,553,541.0,927.0,386.0,150000.0,0.0,-150000.0
<a href=/player/campg101>campg101</a>,Gilly Campbell,Montreal,Montreal,1,1,3,4,1938,1940,2,No,0,-0.02,0.0,0.02,54,0,-54,147,0,-147,0.0,0.0,0.0,0.0,0.0,0.0
<a href=/player/camph102>camph102</a>,Howie Camp,New York Yankees,YANKS,3,12,4,16,1920,1928,8,No,0,-3.56,9.03,12.59,367,917,550,1242,3654,2412,159.0,0.0,-159.0,28250.0,0.0,-28250.0
<a href=/player/campj103>campj103</a>,Jim Campbell,St. Louis Cardinals,CARDS,3,5,4,9,1970,1971,1,No,0,0.65,1.05,0.4,128,66,-62,382,156,-226,18.0,0.0,-18.0,27000.0,0.0,-27000.0
<a href=/player/campj104>campj104</a>,Jim Campbell,Milwaukee Braves,BRAVES,1,1,1,2,1961,1961,0,No,0,-0.21,0.0,0.21,82,0,-82,264,0,-264,0.0,0.0,0.0,0.0,0.0,0.0
<a href=/player/campj105>campj105</a>,Jim Campanis,Kansas City Royals,ROYALS,3,7,6,13,1970,1979,9,No,1,2.78,26.16,23.38,582,1576,994,670,5382,4712,1583.0,1688.0,105.0,34500.0,0.0,-34500.0
<a href=/player/campk001>campk001</a>,Kevin Campbell,Los Angeles Dodgers,DOGRS,1,1,1,2,1991,1992,1,No,0,-0.19,0.0,0.19,57,0,-57,0,0,0,312.0,0.0,-312.0,0.0,0.0,0.0
<a href=/player/campm001>campm001</a>,Mike Campbell,Seattle Mariners,MARNRS,15,25,31,56,1989,2015,26,No,0,47.96,108.51,60.55,2885,3632,747,7463,9980,2517,4388.0,14029.0,9641.0,34882500.0,0.0,-34882500.0
<a href=/player/campm001>campm001</a>,Mike Campbell,Montreal Expos,NATEX,1,1,1,2,1990,1990,0,No,0,0.0,0.0,0.0,0,0,0,0,0,0,0.0,0.0,0.0,0.0,0.0,0.0
<a href=/player/campr101>campr101</a>,Ron Campbell,Chicago Cubs,CUBS,1,2,1,3,1969,1969,0,No,0,0.26,0.0,-0.26,146,6,-140,17,6,-11,358.0,0.0,-358.0,0.0,0.0,0.0
<a href=/player/camps002>camps002</a>,Shawn Camp,San Diego Padres,PADRS,1,2,1,3,2001,2001,0,No,0,0.0,-0.2,-0.2,0,13,13,0,15,15,0.0,0.0,0.0,0.0,0.0,0.0
<a href=/player/camps102>camps102</a>,Sal Campisi,St. Louis Cardinals,CARDS,1,2,2,4,1970,1970,0,No,0,0.05,0.0,-0.05,12,0,-12,0,0,0,13.0,0.0,-13.0,12000.0,0.0,-12000.0
<a href=/player/campt001>campt001</a>,Tony Campana,Chicago Cubs,CUBS,2,2,3,5,2013,2016,3,Yes,0,-0.35,0.27,0.62,55,31,-24,115,0,-115,0.0,43.0,43.0,0.0,0.0,0.0
<a href=/player/campt001>campt001</a>,Tony Campana,Arizona Diamondbacks,DBACKS,1,2,2,4,2014,2019,5,Yes,0,-0.49,0.11,0.6,34,4,-30,15,0,-15,19.0,9.0,-10.0,2884500.0,0.0,-2884500.0
<a href=/player/campv001>campv001</a>,Vicente Campos,Seattle Mariners,MARNRS,1,2,2,4,2012,2016,4,No,0,6.28,-2.3,-8.58,93,246,153,7,800,793,1527.0,405.0,-1122.0,0.0,0.0,0.0
<a href=/player/campv001>campv001</a>,Vicente Campos,New York Yankees,YANKS,2,5,4,9,2016,2020,4,No,0,0.57,4.82,4.25,14,385,371,2,241,239,47.0,836.0,789.0,6150000.0,0.0,-6150000.0
<a href=/player/campv101>campv101</a>,Vin Campbell,Pittsburgh Pirates,PIRATS,1,1,1,2,1912,1912,0,No,0,0.31,1.3,0.99,145,77,-68,680,274,-406,0.0,0.0,0.0,0.0,0.0,0.0
<a href=/player/canag001>canag001</a>,George Canale,Milwaukee Brewers,BREWRS,1,1,1,2,1991,1994,3,No,0,0.0,-0.85,-0.85,0,133,133,0,284,284,0.0,0.0,0.0,0.0,0.0,0.0
<a href=/player/canaj101>canaj101</a>,Jim Canavan,Louisville Colonels,LS3,1,2,1,3,1892,1895,3,No,0,-0.83,5.85,6.68,118,367,249,487,1608,1121,0.0,36.0,36.0,0.0,0.0,0.0
<a href=/player/candc001>candc001</a>,Casey Candaele,Montreal Expos,NATEX,2,3,2,5,1988,1992,4,No,0,3.38,-0.1,-3.48,603,204,-399,1471,4,-1467,0.0,350.0,350.0,110000.0,0.0,-110000.0
<a href=/player/candj001>candj001</a>,John Candelaria,Pittsburgh Pirates,PIRATS,4,8,9,17,1985,2001,16,No,2,9.24,22.17,12.93,548,1655,1107,771,2230,1459,2669.0,7059.0,4390.0,1290000.0,0.0,-1290000.0
<a href=/player/candj001>candj001</a>,John Candelaria,California Angels,ANGELS,1,1,2,3,1987,1987,0,No,0,-0.06,0.0,0.06,6,0,-6,5,0,-5,37.0,0.0,-37.0,800000.0,0.0,-800000.0
<a href=/player/candj001>candj001</a>,John Candelaria,New York Yankees,YANKS,2,2,3,5,1989,1991,2,No,0,5.91,-1.24,-7.15,488,76,-412,1534,238,-1296,49.0,0.0,-49.0,930000.0,0.0,-930000.0
<a href=/player/candj001>candj001</a>,John Candelaria,Minnesota Twins,TWINS,1,1,2,3,1990,1995,5,No,0,-0.21,0.48,0.69,13,536,523,0,1913,1913,64.0,0.0,-64.0,500000.0,0.0,-500000.0
<a href=/player/candj002>candj002</a>,Jeimer Candelario,Chicago Cubs,CUBS,1,3,2,5,2017,2018,1,No,0,6.56,1.19,-5.37,523,218,-305,2136,113,-2023,0.0,217.0,217.0,0.0,0.0,0.0
<a href=/player/candm101>candm101</a>,Milo Candini,New York Yankees,YANKS,1,2,2,4,1943,1946,3,No,0,9.48,0.6,-8.88,716,132,-584,1943,129,-1814,1434.0,1073.0,-361.0,0.0,0.0,0.0
<a href=/player/candm101>candm101</a>,Milo Candini,Washington Senators,TWINS,1,1,1,2,1949,1949,0,No,0,0.0,0.82,0.82,0,72,72,0,30,30,0.0,327.0,327.0,9000.0,0.0,-9000.0
<a href=/player/candt001>candt001</a>,Tom Candiotti,Cleveland Indians,INDINS,4,5,9,14,1991,1996,5,No,0,12.63,7.08,-5.55,801,582,-219,2368,1823,-545,1452.0,1275.0,-177.0,3575000.0,0.0,-3575000.0
<a href=/player/cangj001>cangj001</a>,John Cangelosi,Chicago White Sox,WSOX,1,1,1,2,1987,1988,1,No,0,3.32,-0.64,-3.96,350,57,-293,663,0,-663,6.0,282.0,276.0,0.0,0.0,0.0
<a href=/player/cangj001>cangj001</a>,John Cangelosi,Chicago White Sox,WSOX,4,6,5,11,1991,2004,13,No,0,0.31,-0.43,-0.74,194,297,103,252,131,-121,327.0,1874.0,1547.0,580000.0,0.0,-580000.0
<a href=/player/canhm001>canhm001</a>,Mark Canha,Colorado Rockies,ROCKS,1,1,2,3,2014,2014,0,Yes,0,9.92,0.0,-9.92,645,0,-645,2492,0,-2492,0.0,0.0,0.0,0.0,0.0,0.0
<a href=/player/cannc101>cannc101</a>,Chris Cannizzaro,New York Mets,METS,1,1,1,2,1966,1966,0,No,0,0.0,0.0,0.0,0,0,0,0,0,0,0.0,0.0,0.0,0.0,0.0,0.0
<a href=/player/cannc101>cannc101</a>,Chris Cannizzaro,Atlanta Braves,BRAVES,1,2,2,4,1966,1966,0,No,0,0.0,0.0,0.0,0,0,0,0,0,0,0.0,0.0,0.0,0.0,0.0,0.0
<a href=/player/cannc101>cannc101</a>,Chris Cannizzaro,Detroit Tigers,TIGRS,1,1,1,2,1967,1969,2,No,0,0.57,0.0,-0.57,25,0,-25,70,0,-70,0.0,0.0,0.0,0.0,0.0,0.0
<a href=/player/cannc101>cannc101</a>,Chris Cannizzaro,Pittsburgh Pirates,PIRATS,1,2,2,4,1969,1969,0,No,0,2.16,-0.66,-2.82,398,62,-336,1040,73,-967,429.0,0.0,-429.0,0.0,0.0,0.0
<a href=/player/cannc101>cannc101</a>,Chris Cannizzaro,San Diego Padres,PADRS,1,1,1,2,1971,1971,0,No,0,0.1,0.66,0.56,71,75,4,234,204,-30,0.0,0.0,0.0,0.0,0.0,0.0
<a href=/player/cannj101>cannj101</a>,Joe Cannon,Houston Astros,ASTROS,1,3,1,4,1978,1989,11,No,0,-3.72,7.9,11.62,160,965,805,206,3318,3112,249.0,0.0,-249.0,22500.0,0.0,-22500.0
<a href=/player/cannr101>cannr101</a>,Rip Cannell,Boston Braves,BRAVES,1,1,1,2,1905,1908,3,No,0,0.0,0.19,0.19,0,141,141,0,489,489,0.0,0.0,0.0,0.0,0.0,0.0
<a href=/player/canor001>canor001</a>,Robinson Cano,Seattle Mariners,MARNRS,3,7,8,15,2018,2021,3,Yes,0,4.65,-0.82,-5.47,602,81,-521,857,184,-673,558.0,101.0,-457.0,34758065.0,0.0,-34758065.0
<a href=/player/cansj001>cansj001</a>,Jose Canseco,Oakland Athletics,ATLTCS,3,4,7,11,1992,1997,5,No,0,2.61,2.8,0.19,709,476,-233,2747,1658,-1089,3.0,1280.0,1277.0,10500000.0,0.0,-10500000.0
<a href=/player/cansj001>cansj001</a>,Jose Canseco,Texas Rangers,RNGRS,1,1,2,3,1994,1996,2,No,0,5.55,0.51,-5.04,198,183,-15,882,778,-104,0.0,0.0,0.0,5100000.0,0.0,-5100000.0
<a href=/player/cansj001>cansj001</a>,Jose Canseco,Boston Red Sox,RSOX,3,6,7,13,1997,2002,5,No,0,1.09,4.19,3.1,233,432,199,580,538,-42,371.0,1801.0,1430.0,3375000.0,0.0,-3375000.0
<a href=/player/canso001>canso001</a>,Ozzie Canseco,St. Louis Cardinals,CARDS,1,1,1,2,1993,1993,0,No,0,0.0,0.0,0.0,0,0,0,0,0,0,0.0,0.0,0.0,140000.0,0.0,-140000.0
<a href=/player/cantb102>cantb102</a>,Ben Cantwell,New York Giants,GIANTS,1,4,1,5,1928,1928,0,No,0,11.88,2.32,-9.56,1432,52,-1380,2925,68,-2857,4700.0,475.0,-4225.0,21900.0,0.0,-21900.0
<a href=/player/cantg101>cantg101</a>,Guy Cantrell,FortWorth,FortWorth,2,3,4,7,1924,1925,1,No,0,-0.54,0.0,0.54,123,0,-123,67,0,-67,480.0,0.0,-480.0,0.0,0.0,0.0
<a href=/player/cantg101>cantg101</a>,Guy Cantrell,Toronto,Toronto,1,1,1,2,1930,1930,0,No,0,-0.32,0.0,0.32,32,0,-32,9,0,-9,105.0,0.0,-105.0,0.0,0.0,0.0
<a href=/player/cantj001>cantj001</a>,Jorge Cantu,Tampa Bay Devil Rays,RAYS,1,3,2,5,2007,2007,0,No,0,0.07,0.0,-0.07,27,0,-27,68,0,-68,0.0,0.0,0.0,0.0,0.0,0.0
<a href=/player/cantj001>cantj001</a>,Jorge Cantu,Florida Marlins,MARLNS,1,1,2,3,2010,2013,3,No,0,-0.56,0.0,0.56,30,0,-30,105,0,-105,0.0,0.0,0.0,6000000.0,0.0,-6000000.0
<a href=/player/canzr001>canzr001</a>,Russ Canzler,Baltimore Orioles,ORLS,1,1,1,2,2013,2013,0,Yes,0,0.0,0.0,0.0,0,0,0,0,0,0,0.0,0.0,0.0,0.0,0.0,0.0
<a href=/player/capej001>capej001</a>,Jose Capellan,Atlanta Braves,BRAVES,2,3,2,5,2004,2006,2,No,0,0.58,-1.28,-1.86,271,128,-143,2,1,-1,443.0,173.0,-270.0,3400000.0,0.0,-3400000.0
<a href=/player/capej001>capej001</a>,Jose Capellan,Milwaukee Brewers,BREWRS,1,1,1,2,2007,2007,0,No,0,-0.41,0.0,0.41,10,0,-10,0,0,0,42.0,0.0,-42.0,0.0,0.0,0.0
<a href=/player/capej001>capej001</a>,Jose Capellan,Detroit Tigers,TIGRS,2,2,2,4,2007,2008,1,No,0,-0.6,0.41,1.01,100,16,-84,6,0,-6,171.0,57.0,-114.0,395000.0,0.0,-395000.0
<a href=/player/capid101>capid101</a>,Doug Capilla,St. Louis Cardinals,CARDS,1,1,1,2,1977,1977,0,No,0,-0.48,-0.82,-0.34,67,82,15,42,7,-35,371.0,161.0,-210.0,0.0,0.0,0.0
<a href=/player/capid101>capid101</a>,Doug Capilla,Cincinnati Reds,REDS,1,1,1,2,1979,1984,5,No,0,2.35,0.0,-2.35,189,0,-189,25,0,-25,474.0,0.0,-474.0,0.0,0.0,0.0
<a href=/player/capid101>capid101</a>,Doug Capilla,Chicago Cubs,CUBS,1,1,1,2,1981,1983,2,No,0,0.0,0.62,0.62,0,56,56,0,40,40,0.0,368.0,368.0,0.0,0.0,0.0
<a href=/player/cappc001>cappc001</a>,Carter Capps,Seattle Mariners,MARNRS,5,8,7,15,2013,2017,4,Yes,0,10.74,4.38,-6.36,1184,445,-739,3959,1460,-2499,501.0,283.0,-218.0,11171300.0,0.0,-11171300.0
<a href=/player/cappc001>cappc001</a>,Carter Capps,Miami Marlins,MARLNS,3,8,6,14,2016,2019,3,No,0,12.29,-0.08,-12.37,540,354,-186,600,126,-474,2851.0,1392.0,-1459.0,550000.0,0.0,-550000.0
<a href=/player/cappg101>cappg101</a>,George Cappuzzello,Detroit Tigers,TIGRS,1,2,1,3,1978,1980,2,No,0,0.0,4.64,4.64,0,73,73,0,0,0,0.0,1101.0,1101.0,0.0,0.0,0.0
<a href=/player/cappm001>cappm001</a>,Matt Capps,Washington Nationals,NATEX,1,1,2,3,2010,2016,6,No,0,1.92,10.47,8.55,130,578,448,0,2276,2276,366.0,0.0,-366.0,3500000.0,0.0,-3500000.0
<a href=/player/caprn001>caprn001</a>,Nick Capra,Cincinnati Reds,REDS,1,1,1,2,1992,1993,1,No,0,0.0,-0.21,-0.21,0,12,12,0,0,0,0.0,13.0,13.0,0.0,0.0,0.0
<a href=/player/capuc001>capuc001</a>,Chris Capuano,Arizona Diamondbacks,DBACKS,3,10,7,17,2003,2008,5,No,2,15.65,2.42,-13.23,2019,225,-1794,5161,413,-4748,3052.0,809.0,-2243.0,3950667.0,0.0,-3950667.0
<a href=/player/caram001>caram001</a>,Matt Carasiti,Colorado Rockies,ROCKS,1,1,1,2,2017,2018,1,No,0,0.0,0.03,0.03,0,18,18,0,0,0,0.0,21.0,21.0,0.0,0.0,0.0
<a href=/player/carar001>carar001</a>,Ramon Caraballo,Atlanta Braves,BRAVES,1,1,1,2,1994,1994,0,No,0,-0.54,0.0,0.54,34,0,-34,110,0,-110,0.0,0.0,0.0,0.0,0.0,0.0
<a href=/player/carav001>carav001</a>,Victor Caratini,Atlanta Braves,BRAVES,1,1,3,4,2014,2015,1,No,0,0.97,0.31,-0.66,250,82,-168,677,130,-547,12.0,73.0,61.0,0.0,0.0,0.0
<a href=/player/carav001>carav001</a>,Victor Caratini,Chicago Cubs,CUBS,1,2,5,7,2020,2021,1,Yes,0,1.28,-0.94,-2.22,175,63,-112,411,44,-367,499.0,444.0,-55.0,22000000.0,0.0,-22000000.0
<a href=/player/carbb101>carbb101</a>,Bernie Carbo,Cincinnati Reds,REDS,1,1,1,2,1972,1974,2,No,0,4.23,0.42,-3.81,276,88,-188,828,198,-630,0.0,0.0,0.0,0.0,0.0,0.0
<a href=/player/carbb101>carbb101</a>,Bernie Carbo,St. Louis Cardinals,CARDS,10,15,16,31,1973,1978,5,No,0,43.88,7.39,-36.49,1933,556,-1377,5993,1737,-4256,2099.0,259.0,-1840.0,96000.0,0.0,-96000.0
<a href=/player/carbb101>carbb101</a>,Bernie Carbo,Boston Red Sox,RSOX,2,2,3,5,1976,1977,1,No,0,0.38,-1.58,-1.96,80,112,32,231,121,-110,0.0,373.0,373.0,0.0,0.0,0.0
<a href=/player/carbb101>carbb101</a>,Bernie Carbo,Milwaukee Brewers,BREWRS,1,2,1,3,1976,1976,0,No,0,4.95,0.0,-4.95,442,0,-442,1687,0,-1687,0.0,0.0,0.0,150000.0,0.0,-150000.0
<a href=/player/carda001>carda001</a>,Adrian Cardenas,Philadelphia Phillies,PHILS,2,4,2,6,2008,2012,4,No,0,4.22,2.37,-1.85,203,206,3,28,216,188,867.0,1849.0,982.0,8500000.0,0.0,-8500000.0
<a href=/player/cardd101>cardd101</a>,Don Cardwell,Philadelphia Phillies,PHILS,2,3,4,7,1960,1971,11,No,0,11.26,16.56,5.3,652,1580,928,1728,6417,4689,1893.0,0.0,-1893.0,60000.0,0.0,-60000.0
<a href=/player/cardd101>cardd101</a>,Don Cardwell,Chicago Cubs,CUBS,16,27,26,53,1962,1982,20,No,0,54.43,129.03,74.6,2307,6354,4047,4353,15923,11570,10563.0,16087.0,5524.0,552500.0,0.0,-552500.0
<a href=/player/cardd101>cardd101</a>,Don Cardwell,St. Louis Cardinals,CARDS,12,25,21,46,1962,1972,10,No,0,34.37,14.04,-20.33,3456,1142,-2314,8634,3489,-5145,3590.0,703.0,-2887.0,32500.0,0.0,-32500.0
<a href=/player/cardd101>cardd101</a>,Don Cardwell,Pittsburgh Pirates,PIRATS,2,3,3,6,1966,1968,2,No,0,2.29,1.17,-1.12,328,107,-221,391,68,-323,1500.0,578.0,-922.0,46000.0,0.0,-46000.0
<a href=/player/cardj001>cardj001</a>,Javier Cardona,Detroit Tigers,TIGRS,1,2,2,4,2002,2002,0,No,0,-0.46,0.97,1.43,15,108,93,42,363,321,0.0,0.0,0.0,0.0,0.0,0.0
<a href=/player/cardj001>cardj001</a>,Javier Cardona,St. Louis Cardinals,CARDS,1,1,1,2,2005,2007,2,No,0,0.0,0.63,0.63,0,158,158,0,388,388,0.0,0.0,0.0,0.0,0.0,0.0
<a href=/player/cardj101>cardj101</a>,Jose Cardenal,San Francisco Giants,GIANTS,1,1,1,2,1964,1970,6,No,0,4.59,5.91,1.32,396,290,-106,1562,803,-759,0.0,0.0,0.0,0.0,0.0,0.0
<a href=/player/cardj101>cardj101</a>,Jose Cardenal,California Angels,ANGELS,2,2,2,4,1967,1969,2,No,0,5.92,0.27,-5.65,592,183,-409,1768,444,-1324,0.0,0.0,0.0,20000.0,0.0,-20000.0
<a href=/player/cardj101>cardj101</a>,Jose Cardenal,Cleveland Indians,INDINS,9,14,15,29,1969,1984,15,No,0,49.1,10.79,-38.31,2903,2741,-162,10858,9463,-1395,38.0,317.0,279.0,169250.0,0.0,-169250.0
<a href=/player/cardj101>cardj101</a>,Jose Cardenal,St. Louis Cardinals,CARDS,2,4,3,7,1971,1971,0,No,0,0.65,0.42,-0.23,128,32,-96,382,84,-298,18.0,0.0,-18.0,27000.0,0.0,-27000.0
<a href=/player/cardj101>cardj101</a>,Jose Cardenal,Milwaukee Brewers,BREWRS,7,11,14,25,1971,1986,15,No,0,39.9,45.53,5.63,2646,2463,-183,7439,6326,-1113,5266.0,7453.0,2187.0,592300.0,0.0,-592300.0
<a href=/player/cardj101>cardj101</a>,Jose Cardenal,Chicago Cubs,CUBS,1,1,1,2,1977,1977,0,No,0,-0.61,0.0,0.61,116,0,-116,282,0,-282,0.0,0.0,0.0,150000.0,0.0,-150000.0
<a href=/player/cardl101>cardl101</a>,Leo Cardenas,Cincinnati Reds,REDS,2,2,3,5,1968,1972,4,No,0,13.24,2.94,-10.3,539,219,-320,1938,226,-1712,589.0,1800.0,1211.0,36500.0,0.0,-36500.0
<a href=/player/cardl101>cardl101</a>,Leo Cardenas,Minnesota Twins,TWINS,2,2,4,6,1971,1976,5,No,0,1.67,8.18,6.51,339,287,-52,635,15,-620,439.0,2568.0,2129.0,70000.0,0.0,-70000.0
<a href=/player/cardl101>cardl101</a>,Leo Cardenas,California Angels,ANGELS,1,1,2,3,1973,1974,1,No,0,-1.2,1.35,2.55,72,155,83,212,429,217,0.0,0.0,0.0,0.0,0.0,0.0
<a href=/player/cardl101>cardl101</a>,Leo Cardenas,Cleveland Indians,INDINS,2,4,2,6,1974,1974,0,No,0,1.58,-0.11,-1.69,267,15,-252,613,61,-552,0.0,0.0,0.0,19750.0,0.0,-19750.0
<a href=/player/carea101>carea101</a>,Andy Carey,New York Yankees,YANKS,1,1,1,2,1960,1960,0,No,0,0.75,1.28,0.53,141,87,-54,519,249,-270,0.0,0.0,0.0,0.0,0.0,0.0
<a href=/player/carea101>carea101</a>,Andy Carey,Kansas City Athletics,ATLTCS,19,40,34,74,1961,1976,15,No,0,67.84,34.29,-33.55,6835,3922,-2913,16048,11060,-4988,8728.0,3414.0,-5314.0,393100.0,0.0,-393100.0
<a href=/player/carea101>carea101</a>,Andy Carey,Chicago White Sox,WSOX,1,2,2,4,1961,1962,1,No,0,0.0,0.69,0.69,0,79,79,0,145,145,0.0,0.0,0.0,0.0,0.0,0.0
<a href=/player/carea101>carea101</a>,Andy Carey,Chicago White Sox,WSOX,2,2,4,6,1962,1967,5,No,0,0.03,-0.44,-0.47,53,14,-39,130,19,-111,0.0,0.0,0.0,0.0,0.0,0.0
<a href=/player/carer001>carer001</a>,Rod Carew,Minnesota Twins,TWINS,4,4,10,14,1979,1987,8,No,0,25.56,9.14,-16.42,1791,1507,-284,6644,5200,-1444,256.0,1637.0,1381.0,0.0,0.0,0.0
<a href=/player/caret102>caret102</a>,Tom Carey,St.Louis Browns,ORLS,2,2,2,4,1938,1939,1,No,0,-0.2,0.06,0.26,183,80,-103,325,42,-283,270.0,341.0,71.0,6000.0,0.0,-6000.0
<a href=/player/carlb001>carlb001</a>,Buddy Carlyle,Cincinnati Reds,REDS,1,1,1,2,1998,1998,0,No,0,-0.55,-0.23,0.32,22,8,-14,11,0,-11,122.0,16.0,-106.0,0.0,0.0,0.0
<a href=/player/carlh101>carlh101</a>,Hal Carlson,Philadelphia Phillies,PHILS,2,4,4,8,1927,1929,2,No,0,1.34,-1.88,-3.22,190,224,34,187,481,294,1211.0,585.0,-626.0,8850.0,0.0,-8850.0
<a href=/player/carlj101>carlj101</a>,Jim Carlin,New York Giants,GIANTS,1,3,1,4,1938,1940,2,No,0,0.0,3.47,3.47,0,123,123,0,517,517,0.0,0.0,0.0,0.0,0.0,0.0
<a href=/player/carll101>carll101</a>,Leon Carlson,Washington Senators,TWINS,4,8,6,14,1920,1933,13,No,0,25.21,15.96,-9.25,1580,828,-752,6114,3136,-2978,0.0,616.0,616.0,3600.0,0.0,-3600.0
<a href=/player/carlr101>carlr101</a>,Roy Carlyle,Washington Senators,TWINS,1,2,1,3,1925,1927,2,No,0,1.68,5.81,4.13,272,192,-80,587,672,85,1044.0,0.0,-1044.0,3600.0,0.0,-3600.0
<a href=/player/carls001>carls001</a>,Steve Carlton,St. Louis Cardinals,CARDS,11,16,17,33,1972,1978,6,No,0,113.27,16.17,-97.1,2933,696,-2237,7406,1939,-5467,13191.0,1843.0,-11348.0,96000.0,0.0,-96000.0
<a href=/player/carls001>carls001</a>,Steve Carlton,Cleveland Indians,INDINS,1,1,1,2,1987,1987,0,No,0,-1.35,0.0,1.35,13,0,-13,0,0,0,158.0,0.0,-158.0,0.0,0.0,0.0
<a href=/player/carls002>carls002</a>,Shane Carle,Pittsburgh Pirates,PIRATS,1,1,1,2,2014,2016,2,No,0,-0.02,-0.09,-0.07,6,84,78,0,2,2,12.0,141.0,129.0,0.0,0.0,0.0
<a href=/player/carls002>carls002</a>,Shane Carle,Pittsburgh Pirates,PIRATS,1,1,1,2,2018,2018,0,No,0,0.57,0.0,-0.57,115,0,-115,6,0,-6,217.0,0.0,-217.0,0.0,0.0,0.0
<a href=/player/carlt101>carlt101</a>,Tex Carleton,St. Louis Cardinals,CARDS,1,1,3,4,1934,1934,0,No,0,5.38,0.0,-5.38,264,0,-264,289,0,-289,2233.0,0.0,-2233.0,0.0,0.0,0.0
<a href=/player/carmd101>carmd101</a>,Duke Carmel,St. Louis Cardinals,CARDS,1,2,1,3,1960,1960,0,No,0,0.0,-0.2,-0.2,0,32,32,0,32,32,0.0,0.0,0.0,0.0,0.0,0.0
<a href=/player/carmd101>carmd101</a>,Duke Carmel,St. Louis Cardinals,CARDS,1,1,1,2,1961,1961,0,No,0,0.0,0.0,0.0,0,0,0,0,0,0,0.0,0.0,0.0,0.0,0.0,0.0
<a href=/player/carmd101>carmd101</a>,Duke Carmel,St. Louis Cardinals,CARDS,1,1,2,3,1963,1963,0,No,0,0.75,0.0,-0.75,47,0,-47,167,0,-167,0.0,0.0,0.0,0.0,0.0,0.0
<a href=/player/carmf001>carmf001</a>,Fausto Carmona,Philadelphia Phillies,PHILS,1,1,2,3,2014,2021,7,No,0,-0.44,1.78,2.22,18,191,173,15,89,74,131.0,227.0,96.0,0.0,0.0,0.0
<a href=/player/carne101>carne101</a>,Eddie Carnett,Chicago White Sox,WSOX,1,1,1,2,1944,1944,0,No,0,-0.29,0.0,0.29,32,0,-32,76,0,-76,6.0,0.0,-6.0,6000.0,0.0,-6000.0
<a href=/player/carpc001>carpc001</a>,Cris Carpenter,Florida Marlins,MARLNS,2,2,5,7,1993,1997,4,No,0,11.08,2.51,-8.57,787,607,-180,6,25,19,1408.0,1163.0,-245.0,3805000.0,0.0,-3805000.0
<a href=/player/carpc003>carpc003</a>,Chris Carpenter,Chicago Cubs,CUBS,1,2,1,3,2012,2012,0,No,0,-0.21,0.0,0.21,8,0,-8,0,0,0,18.0,0.0,-18.0,0.0,0.0,0.0
<a href=/player/carpd001>carpd001</a>,David Carpenter,St. Louis Cardinals,CARDS,1,1,2,3,2010,2010,0,No,0,0.2,-0.4,-0.6,126,40,-86,2,125,123,172.0,0.0,-172.0,0.0,0.0,0.0
<a href=/player/carpd001>carpd001</a>,David Carpenter,Houston Astros,ASTROS,4,10,10,20,2012,2019,7,No,0,17.22,11.07,-6.15,1238,246,-992,2359,341,-2018,4222.0,1816.0,-2406.0,8335000.0,0.0,-8335000.0
<a href=/player/carpd001>carpd001</a>,David Carpenter,Toronto Blue Jays,BJAYS,2,4,2,6,2012,2014,2,No,0,11.57,-0.01,-11.58,944,66,-878,3396,7,-3389,0.0,475.0,475.0,0.0,0.0,0.0
<a href=/player/carpd001>carpd001</a>,David Carpenter,Atlanta Braves,BRAVES,1,2,1,3,2015,2016,1,No,0,1.56,-0.24,-1.8,214,14,-200,2,7,5,580.0,79.0,-501.0,0.0,0.0,0.0
<a href=/player/carpd001>carpd001</a>,David Carpenter,New York Yankees,YANKS,5,9,8,17,2015,2020,5,Yes,0,-1.27,8.03,9.3,455,197,-258,1007,8,-999,308.0,1270.0,962.0,5236900.0,0.0,-5236900.0
<a href=/player/carpm001>carpm001</a>,Mike Carp,New York Mets,METS,1,7,3,10,2008,2010,2,No,0,8.89,-1.25,-10.14,554,358,-196,1346,179,-1167,2162.0,325.0,-1837.0,3398000.0,0.0,-3398000.0
<a href=/player/carra001>carra001</a>,Amalio Carreno,New York Yankees,YANKS,1,1,1,2,1988,1988,0,No,0,-0.34,-0.68,-0.34,6,50,44,1,149,148,10.0,0.0,-10.0,0.0,0.0,0.0
<a href=/player/carra101>carra101</a>,Alex Carrasquel,Chicago White Sox,WSOX,1,1,1,2,1949,1949,0,No,0,0.0,0.0,0.0,0,0,0,0,0,0,0.0,0.0,0.0,9600.0,0.0,-9600.0
<a href=/player/carrc001>carrc001</a>,Chuck Carr,Seattle Mariners,MARNRS,1,1,1,2,1988,1988,0,No,0,-0.3,0.0,0.3,16,0,-16,13,0,-13,0.0,0.0,0.0,0.0,0.0,0.0
<a href=/player/carrc001>carrc001</a>,Chuck Carr,New York Mets,METS,1,1,1,2,1991,1991,0,No,0,0.08,0.0,-0.08,22,0,-22,76,0,-76,0.0,0.0,0.0,0.0,0.0,0.0
<a href=/player/carrc001>carrc001</a>,Chuck Carr,Florida Marlins,MARLNS,1,2,1,3,1995,2004,9,No,0,0.38,0.0,-0.38,53,0,-53,163,0,-163,0.0,0.0,0.0,255000.0,0.0,-255000.0
<a href=/player/carrc003>carrc003</a>,Carlos Carrasco,Philadelphia Phillies,PHILS,3,6,6,12,2009,2015,6,No,0,27.43,-0.46,-27.89,716,374,-342,1539,630,-909,4038.0,442.0,-3596.0,1175000.0,0.0,-1175000.0
<a href=/player/carrc003>carrc003</a>,Carlos Carrasco,Cleveland Indians,INDINS,1,2,4,6,2021,2021,0,Yes,0,2.19,2.78,0.59,149,209,60,543,798,255,161.0,0.0,-161.0,0.0,0.0,0.0
<a href=/player/carrc004>carrc004</a>,Cody Carroll,New York Yankees,YANKS,1,3,1,4,2018,2019,1,Yes,0,-0.19,2.71,2.9,121,97,-24,0,0,0,451.0,259.0,-192.0,0.0,0.0,0.0
<a href=/player/carrc102>carrc102</a>,Cliff Carroll,St. Louis Cardinals,CARDS,1,1,1,2,1893,1899,6,No,0,-0.24,-0.54,-0.3,120,527,407,531,2249,1718,0.0,0.0,0.0,0.0,0.0,0.0
<a href=/player/carrc103>carrc103</a>,Clay Carroll,Atlanta Braves,BRAVES,3,5,5,10,1968,1970,2,No,0,13.88,3.02,-10.86,1605,185,-1420,1388,304,-1084,4147.0,923.0,-3224.0,0.0,0.0,0.0
<a href=/player/carrc103>carrc103</a>,Clay Carroll,Cincinnati Reds,REDS,1,1,2,3,1975,1977,2,No,0,2.01,-0.71,-2.72,37,24,-13,0,1,1,266.0,53.0,-213.0,0.0,0.0,0.0
<a href=/player/carrc103>carrc103</a>,Clay Carroll,Chicago White Sox,WSOX,1,1,1,2,1977,1979,2,No,0,1.83,2.34,0.51,102,130,28,14,0,-14,270.0,613.0,343.0,0.0,0.0,0.0
<a href=/player/carrc103>carrc103</a>,Clay Carroll,St. Louis Cardinals,CARDS,3,4,5,9,1977,1990,13,No,0,5.97,12.77,6.8,378,954,576,1263,2591,1328,1270.0,1727.0,457.0,740000.0,0.0,-740000.0
<a href=/player/carrc104>carrc104</a>,Cam Carreon,Chicago White Sox,WSOX,19,37,35,72,1965,1985,20,No,1,64.8,101.41,36.61,4868,5055,187,12442,15211,2769,10771.0,9695.0,-1076.0,609700.0,0.0,-609700.0
<a href=/player/carrc104>carrc104</a>,Cam Carreon,Cleveland Indians,INDINS,1,1,1,2,1966,1968,2,No,0,0.23,-0.03,-0.26,4,6,2,12,6,-6,0.0,0.0,0.0,0.0,0.0,0.0
<a href=/player/carrc105>carrc105</a>,Chico Carrasquel,Chicago White Sox,WSOX,16,28,29,57,1955,1969,14,No,0,20.76,44.3,23.54,2687,3479,792,5604,6611,1007,4631.0,7668.0,3037.0,148250.0,0.0,-148250.0
<a href=/player/carrc105>carrc105</a>,Chico Carrasquel,Cleveland Indians,INDINS,1,1,1,2,1958,1958,0,No,0,-0.4,-0.18,0.22,59,76,17,182,214,32,0.0,0.0,0.0,0.0,0.0,0.0
<a href=/player/carrc105>carrc105</a>,Chico Carrasquel,Kansas City Athletics,ATLTCS,3,4,4,8,1958,1963,5,No,0,10.42,2.16,-8.26,1077,611,-466,1138,1646,508,2603.0,934.0,-1669.0,0.0,0.0,0.0
<a href=/player/carrc106>carrc106</a>,Charlie Carr,Detroit Tigers,TIGRS,1,1,1,2,1904,1905,1,No,0,0.57,0.7,0.13,121,101,-20,464,399,-65,0.0,0.0,0.0,0.0,0.0,0.0
<a href=/player/carrd001>carrd001</a>,D.J. Carrasco,Pittsburgh Pirates,PIRATS,1,3,3,6,2010,2011,1,No,0,-0.12,0.71,0.83,82,105,23,69,301,232,68.0,0.0,-68.0,3450000.0,0.0,-3450000.0
<a href=/player/carrd103>carrd103</a>,Dixie Carroll,St. Louis Cardinals,CARDS,1,3,1,4,1921,1921,0,No,0,0.0,0.87,0.87,0,76,76,0,77,77,0.0,625.0,625.0,0.0,0.0,0.0
<a href=/player/carrd104>carrd104</a>,Don Carrithers,San Francisco Giants,GIANTS,1,1,1,2,1974,1974,0,No,0,2.04,-0.89,-2.93,151,29,-122,91,85,-6,904.0,0.0,-904.0,0.0,0.0,0.0
<a href=/player/carre001>carre001</a>,Ezequiel Carrera,New York Mets,METS,1,7,3,10,2008,2010,2,No,0,8.89,-1.25,-10.14,554,358,-196,1346,179,-1167,2162.0,325.0,-1837.0,3398000.0,0.0,-3398000.0
<a href=/player/carre001>carre001</a>,Ezequiel Carrera,Seattle Mariners,MARNRS,1,2,1,3,2010,2010,0,No,0,0.34,0.86,0.52,123,57,-66,406,238,-168,0.0,0.0,0.0,0.0,0.0,0.0
<a href=/player/carrh001>carrh001</a>,Hector Carrasco,Houston Astros,ASTROS,2,3,2,5,1992,1995,3,No,0,0.14,0.64,0.5,6,255,249,0,176,176,12.0,297.0,285.0,475000.0,0.0,-475000.0
<a href=/player/carrh001>carrh001</a>,Hector Carrasco,Florida Marlins,MARLNS,1,2,1,3,1993,1996,3,No,0,2.43,5.1,2.67,405,217,-188,18,182,164,808.0,1519.0,711.0,0.0,0.0,0.0
<a href=/player/carrh001>carrh001</a>,Hector Carrasco,Cincinnati Reds,REDS,6,8,9,17,1997,2013,16,No,0,0.95,26.14,25.19,565,1375,810,1114,3203,2089,629.0,5071.0,4442.0,600000.0,0.0,-600000.0
<a href=/player/carrh001>carrh001</a>,Hector Carrasco,Minnesota Twins,TWINS,1,1,1,2,2000,2007,7,No,0,-0.35,8.34,8.69,8,494,486,0,1716,1716,20.0,0.0,-20.0,825000.0,0.0,-825000.0
<a href=/player/carrj001>carrj001</a>,Jamey Carroll,Colorado Rockies,ROCKS,1,1,1,2,2007,2008,1,No,0,4.65,0.0,-4.65,206,0,-206,760,0,-760,0.0,0.0,0.0,1700000.0,0.0,-1700000.0
<a href=/player/carrm001>carrm001</a>,Mark Carreon,New York Mets,METS,1,2,2,4,1992,1993,1,No,0,-1.21,-0.71,0.5,101,102,1,364,8,-356,0.0,212.0,212.0,0.0,0.0,0.0
<a href=/player/carrm001>carrm001</a>,Mark Carreon,San Francisco Giants,GIANTS,1,1,2,3,1996,1998,2,No,0,0.64,-1.36,-2.0,38,243,205,156,9,-147,0.0,316.0,316.0,1000000.0,0.0,-1000000.0
<a href=/player/carro101>carro101</a>,Ownie Carroll,Detroit Tigers,TIGRS,1,3,2,5,1930,1932,2,No,0,0.55,-1.14,-1.69,146,271,125,467,761,294,97.0,731.0,634.0,18000.0,0.0,-18000.0
<a href=/player/carro101>carro101</a>,Ownie Carroll,Cincinnati Reds,REDS,2,3,2,5,1932,1936,4,No,0,1.3,1.6,0.3,315,394,79,966,1624,658,0.0,0.0,0.0,0.0,0.0,0.0
<a href=/player/carro101>carro101</a>,Ownie Carroll,St. Louis Cardinals,CARDS,1,2,2,4,1933,1934,1,No,0,-0.46,1.18,1.64,199,133,-66,354,117,-237,902.0,474.0,-428.0,0.0,0.0,0.0
<a href=/player/carrt101>carrt101</a>,Tom Carroll,Cincinnati Reds,REDS,1,1,1,2,1976,1976,0,No,0,0.0,0.0,0.0,0,0,0,0,0,0,0.0,0.0,0.0,0.0,0.0,0.0
<a href=/player/carrt102>carrt102</a>,Tom Carroll,New York Yankees,YANKS,1,2,2,4,1959,1959,0,No,0,0.31,0.0,-0.31,212,0,-212,603,0,-603,0.0,0.0,0.0,0.0,0.0,0.0
<a href=/player/carsf101>carsf101</a>,Frank Carswell,Detroit Tigers,TIGRS,1,1,1,2,1954,1955,1,No,0,0.0,0.0,0.0,0,0,0,0,0,0,0.0,0.0,0.0,0.0,0.0,0.0
<a href=/player/carsk102>carsk102</a>,Kid Carsey,Philadelphia Phillies,PHILS,1,2,1,3,1897,1902,5,No,0,5.09,11.56,6.47,465,423,-42,1577,1709,132,668.0,0.0,-668.0,0.0,0.0,0.0
<a href=/player/cartc001>cartc001</a>,Chris Carter,Washington Nationals,NATEX,1,1,2,3,2007,2009,2,No,0,-0.13,-0.35,-0.22,13,101,88,26,351,325,0.0,0.0,0.0,0.0,0.0,0.0
<a href=/player/cartc001>cartc001</a>,Chris Carter,Arizona Diamondbacks,DBACKS,1,1,1,2,2007,2008,1,No,0,0.0,0.0,0.0,0,0,0,0,0,0,0.0,0.0,0.0,0.0,0.0,0.0
<a href=/player/cartc001>cartc001</a>,Chris Carter,Boston Red Sox,RSOX,2,3,3,6,2009,2018,9,No,2,-0.21,0.36,0.57,100,49,-51,180,90,-90,0.0,41.0,41.0,400000.0,0.0,-400000.0
<a href=/player/cartc002>cartc002</a>,Chris Carter,Chicago White Sox,WSOX,3,4,4,8,2007,2013,6,No,0,8.07,7.63,-0.44,904,496,-408,3238,1978,-1260,173.0,202.0,29.0,5530000.0,0.0,-5530000.0
<a href=/player/cartc002>cartc002</a>,Chris Carter,Arizona Diamondbacks,DBACKS,6,14,16,30,2007,2018,11,Yes,0,24.99,30.17,5.18,855,1190,335,1319,2038,719,6760.0,6326.0,-434.0,14741000.0,0.0,-14741000.0
<a href=/player/cartc002>cartc002</a>,Chris Carter,Oakland Athletics,ATLTCS,1,3,2,5,2013,2016,3,No,0,8.06,4.16,-3.9,776,397,-379,2069,1228,-841,1629.0,325.0,-1304.0,0.0,0.0,0.0
<a href=/player/cartg001>cartg001</a>,Gary Carter,Montreal Expos,NATEX,8,12,13,25,1984,1994,10,No,3,12.47,18.81,6.34,1633,2299,666,4360,6804,2444,803.0,2583.0,1780.0,580000.0,0.0,-580000.0
<a href=/player/cartj001>cartj001</a>,Joe Carter,Chicago Cubs,CUBS,4,14,9,23,1984,1991,7,No,0,18.76,21.66,2.9,1968,1112,-856,6227,902,-5325,1933.0,5322.0,3389.0,1746666.0,0.0,-1746666.0
<a href=/player/cartj001>cartj001</a>,Joe Carter,Cleveland Indians,INDINS,7,14,14,28,1989,2001,12,No,1,72.08,42.66,-29.42,4239,2616,-1623,13848,10214,-3634,1815.0,172.0,-1643.0,14713332.0,0.0,-14713332.0
<a href=/player/cartj001>cartj001</a>,Joe Carter,San Diego Padres,PADRS,6,11,15,26,1990,1998,8,No,0,43.43,14.07,-29.36,3426,1340,-2086,13331,3496,-9835,1355.0,1888.0,533.0,8656667.0,0.0,-8656667.0
<a href=/player/cartj001>cartj001</a>,Joe Carter,Baltimore Orioles,ORLS,1,1,1,2,1998,1998,0,No,0,-0.25,0.0,0.25,41,0,-41,115,0,-115,0.0,0.0,0.0,3151380.0,0.0,-3151380.0
<a href=/player/cartj002>cartj002</a>,Jeff Carter,Montreal Expos,NATEX,6,10,11,21,1990,2015,25,No,4,16.22,44.07,27.85,1031,2186,1155,3868,6692,2824,225.0,3662.0,3437.0,8925555.0,0.0,-8925555.0
<a href=/player/cartl002>cartl002</a>,Lance Carter,Tampa Bay Devil Rays,RAYS,5,6,7,13,2006,2018,12,Yes,0,2.76,13.6,10.84,309,789,480,288,2263,1975,1120.0,1336.0,216.0,7137700.0,0.0,-7137700.0
<a href=/player/cartr101>cartr101</a>,Rico Carty,Atlanta Braves,BRAVES,1,1,1,2,1972,1972,0,No,0,-0.76,0.0,0.76,86,0,-86,347,0,-347,0.0,0.0,0.0,50000.0,0.0,-50000.0
<a href=/player/cartr101>cartr101</a>,Rico Carty,Toronto Blue Jays,BJAYS,7,11,12,23,1976,1987,11,No,0,14.45,14.78,0.33,2243,2025,-218,7347,6628,-719,668.0,1848.0,1180.0,0.0,0.0,0.0
<a href=/player/cartr101>cartr101</a>,Rico Carty,Cleveland Indians,INDINS,2,2,2,4,1978,1979,1,No,0,1.56,0.9,-0.66,236,36,-200,942,0,-942,0.0,405.0,405.0,0.0,0.0,0.0
<a href=/player/cartr101>cartr101</a>,Rico Carty,Toronto Blue Jays,BJAYS,2,2,3,5,1978,1992,14,No,0,1.35,13.31,11.96,41,1179,1138,163,3597,3434,0.0,519.0,519.0,0.0,0.0,0.0
<a href=/player/carts001>carts001</a>,Steve Carter,Pittsburgh Pirates,PIRATS,1,1,1,2,1991,1992,1,No,0,0.0,0.75,0.75,0,202,202,0,383,383,0.0,0.0,0.0,0.0,0.0,0.0
<a href=/player/carts001>carts001</a>,Steve Carter,Cincinnati Reds,REDS,1,1,1,2,1993,1993,0,No,0,0.0,-0.37,-0.37,0,46,46,0,71,71,0.0,0.0,0.0,0.0,0.0,0.0
<a href=/player/carum001>carum001</a>,Mike Caruso,San Francisco Giants,GIANTS,4,11,8,19,1997,2001,4,No,4,22.98,0.1,-22.88,1111,210,-901,1153,268,-885,2846.0,875.0,-1971.0,0.0,0.0,0.0
<a href=/player/carvm001>carvm001</a>,Marcos Carvajal,Colorado Rockies,ROCKS,1,1,1,2,2005,2009,4,No,0,0.0,1.41,1.41,0,312,312,0,1187,1187,0.0,0.0,0.0,316000.0,0.0,-316000.0
<a href=/player/carvm001>carvm001</a>,Marcos Carvajal,Seattle Mariners,MARNRS,1,1,1,2,2006,2006,0,No,0,0.0,0.0,0.0,0,0,0,0,0,0,0.0,0.0,0.0,0.0,0.0,0.0
<a href=/player/caryc001>caryc001</a>,Chuck Cary,Detroit Tigers,TIGRS,2,3,4,7,1987,1987,0,No,0,-0.06,-0.17,-0.11,109,31,-78,95,74,-21,258.0,0.0,-258.0,425000.0,0.0,-425000.0
<a href=/player/casac001>casac001</a>,Curt Casali,Detroit Tigers,TIGRS,1,1,1,2,2013,2013,0,No,0,1.92,0.0,-1.92,161,0,-161,466,0,-466,0.0,0.0,0.0,0.0,0.0,0.0
<a href=/player/casaj101>casaj101</a>,Jerry Casale,Los Angeles Angels,ANGELS,3,3,3,6,1961,1966,5,No,0,0.46,4.96,4.5,86,377,291,16,277,261,255.0,1606.0,1351.0,16500.0,0.0,-16500.0
<a href=/player/casap101>casap101</a>,Paul Casanova,Texas Rangers,RNGRS,2,3,2,5,1971,1975,4,No,0,-1.52,3.08,4.6,228,116,-112,569,150,-419,0.0,589.0,589.0,46000.0,0.0,-46000.0
<a href=/player/casar001>casar001</a>,Raul Casanova,New York Mets,METS,2,4,2,6,1992,1993,1,No,0,12.22,-0.41,-12.63,490,79,-411,1635,295,-1340,509.0,0.0,-509.0,2535000.0,0.0,-2535000.0
<a href=/player/casar001>casar001</a>,Raul Casanova,San Diego Padres,PADRS,2,4,4,8,1996,1998,2,No,0,1.67,-1.26,-2.93,549,225,-324,1460,118,-1342,1084.0,637.0,-447.0,0.0,0.0,0.0
<a href=/player/cascj101>cascj101</a>,Joe Cascarella,Boston Red Sox,RSOX,1,1,1,2,1936,1937,1,No,0,0.62,0.35,-0.27,64,46,-18,64,7,-57,515.0,120.0,-395.0,5500.0,0.0,-5500.0
<a href=/player/cascj101>cascj101</a>,Joe Cascarella,JerseyCity,JerseyCity,1,1,2,3,1933,1934,1,No,0,0.57,0.0,-0.57,102,0,-102,81,0,-81,680.0,0.0,-680.0,0.0,0.0,0.0
<a href=/player/cased101>cased101</a>,Doc Casey,Washington Senators,WSN,1,2,4,6,1899,1905,6,No,0,9.84,0.67,-9.17,735,113,-622,2984,291,-2693,0.0,635.0,635.0,0.0,0.0,0.0
<a href=/player/cased101>cased101</a>,Doc Casey,Chicago Cubs,CUBS,1,5,1,6,1905,1913,8,No,0,5.14,19.07,13.93,814,1001,187,3290,4393,1103,0.0,0.0,0.0,0.0,0.0,0.0
<a href=/player/caseg101>caseg101</a>,George Case,Washington Senators,TWINS,2,2,3,5,1945,1947,2,No,0,4.37,2.25,-2.12,345,207,-138,1463,828,-635,0.0,8.0,8.0,13500.0,0.0,-13500.0
<a href=/player/caseg101>caseg101</a>,George Case,Cleveland Indians,INDINS,1,1,1,2,1947,1947,0,No,0,-0.8,0.01,0.81,36,14,-22,89,5,-84,0.0,48.0,48.0,0.0,0.0,0.0
<a href=/player/cases001>cases001</a>,Sean Casey,Cleveland Indians,INDINS,1,1,1,2,1998,2001,3,No,0,16.71,10.28,-6.43,1075,138,-937,4478,17,-4461,0.0,2297.0,2297.0,0.0,0.0,0.0
<a href=/player/cases001>cases001</a>,Sean Casey,Cincinnati Reds,REDS,3,5,3,8,2005,2010,5,No,0,-0.54,0.35,0.89,75,62,-13,256,138,-118,100.0,133.0,33.0,9600000.0,0.0,-9600000.0
<a href=/player/cases001>cases001</a>,Sean Casey,Pittsburgh Pirates,PIRATS,1,1,1,2,2006,2008,2,No,0,-0.09,-0.33,-0.24,196,26,-170,692,0,-692,0.0,32.0,32.0,8500000.0,0.0,-8500000.0
<a href=/player/casha001>casha001</a>,Andrew Cashner,Chicago Cubs,CUBS,2,4,4,8,2012,2021,9,Yes,0,4.49,36.69,32.2,319,1310,991,393,5639,5246,1826.0,3.0,-1823.0,16500000.0,0.0,-16500000.0
<a href=/player/casha001>casha001</a>,Andrew Cashner,San Diego Padres,PADRS,4,12,9,21,2016,2021,5,Yes,0,1.39,-0.63,-2.02,553,209,-344,911,376,-535,973.0,576.0,-397.0,10660200.0,0.0,-10660200.0
<a href=/player/casha001>casha001</a>,Andrew Cashner,Baltimore Orioles,ORLS,1,2,2,4,2019,2019,0,Yes,0,-0.16,0.0,0.16,27,0,-27,0,0,0,161.0,0.0,-161.0,9500000.0,0.0,-9500000.0
<a href=/player/cashd101>cashd101</a>,Dave Cash,Pittsburgh Pirates,PIRATS,7,14,13,27,1973,1988,15,No,0,120.98,37.81,-83.17,5144,1852,-3292,19362,6781,-12581,6130.0,1614.0,-4516.0,807000.0,0.0,-807000.0
<a href=/player/cashd101>cashd101</a>,Dave Cash,Montreal Expos,NATEX,1,1,2,3,1979,1981,2,No,0,-0.55,-0.61,-0.06,130,27,-103,437,51,-386,0.0,0.0,0.0,300000.0,0.0,-300000.0
<a href=/player/cashk001>cashk001</a>,Kevin Cash,Toronto Blue Jays,BJAYS,2,2,2,4,2004,2005,1,No,0,2.43,-0.87,-3.3,152,5,-147,38,0,-38,1030.0,39.0,-991.0,302000.0,0.0,-302000.0
<a href=/player/cashk001>cashk001</a>,Kevin Cash,Houston Astros,ASTROS,1,1,1,2,2010,2012,2,No,0,-0.74,-1.16,-0.42,29,175,146,68,597,529,0.0,0.0,0.0,0.0,0.0,0.0
<a href=/player/cashn101>cashn101</a>,Norm Cash,Chicago White Sox,WSOX,5,8,10,18,1959,1969,10,No,0,11.6,14.81,3.21,1350,938,-412,4415,3667,-748,492.0,12.0,-480.0,77250.0,0.0,-77250.0
<a href=/player/cashn101>cashn101</a>,Norm Cash,Cleveland Indians,INDINS,1,1,1,2,1960,1960,0,No,0,51.66,-0.16,-51.82,2018,4,-2014,7776,5,-7771,0.0,0.0,0.0,0.0,0.0,0.0
<a href=/player/casia001>casia001</a>,Alexi Casilla,Anaheim Angels,ANGELS,1,1,1,2,2005,2006,1,No,0,3.58,-0.95,-4.53,515,71,-444,1764,0,-1764,0.0,145.0,145.0,0.0,0.0,0.0
<a href=/player/casia001>casia001</a>,Alexi Casilla,Tampa Bay Devil Rays,RAYS,1,1,1,2,2015,2015,0,No,0,0.0,0.0,0.0,0,0,0,0,0,0,0.0,0.0,0.0,0.0,0.0,0.0
<a href=/player/caskc101>caskc101</a>,Craig Caskey,Montreal Expos,NATEX,2,2,2,4,1975,1982,7,No,0,-0.34,2.72,3.06,51,271,220,126,355,229,0.0,1323.0,1323.0,0.0,0.0,0.0
<a href=/player/cassj101>cassj101</a>,Jack Cassini,Pittsburgh Pirates,PIRATS,4,5,10,15,1949,1958,9,No,0,6.64,6.37,-0.27,487,659,172,1903,1670,-233,58.0,1608.0,1550.0,0.0,0.0,0.0
<a href=/player/cassp101>cassp101</a>,Pete Cassidy,Brooklyn Dodgers,DOGRS,1,4,2,6,1899,1903,4,No,0,0.67,6.33,5.66,113,445,332,291,1743,1452,635.0,0.0,-635.0,0.0,0.0,0.0
<a href=/player/casss001>casss001</a>,Scott Cassidy,Boston Red Sox,RSOX,1,1,1,2,2005,2005,0,No,0,0.03,0.24,0.21,102,12,-90,3,18,15,165.0,0.0,-165.0,0.0,0.0,0.0
<a href=/player/casta001>casta001</a>,Alberto Castillo,St. Louis Cardinals,CARDS,1,3,2,5,1999,2000,1,No,0,0.12,1.62,1.5,212,64,-148,357,72,-285,353.0,583.0,230.0,1025000.0,0.0,-1025000.0
<a href=/player/casta001>casta001</a>,Alberto Castillo,Boston Red Sox,RSOX,1,1,1,2,2007,2007,0,No,0,-0.12,0.0,0.12,11,0,-11,36,0,-36,0.0,0.0,0.0,0.0,0.0,0.0
<a href=/player/casta002>casta002</a>,Alberto Castillo,San Francisco Giants,GIANTS,1,2,2,4,1997,1999,2,No,0,0.0,0.66,0.66,0,206,206,0,667,667,0.0,0.0,0.0,0.0,0.0,0.0
<a href=/player/casta003>casta003</a>,Alex Castellanos,St. Louis Cardinals,CARDS,1,1,2,3,2011,2013,2,No,0,-0.64,2.05,2.69,24,171,147,43,748,705,0.0,0.0,0.0,0.0,0.0,0.0
<a href=/player/casta003>casta003</a>,Alex Castellanos,Los Angeles Dodgers,DOGRS,1,1,2,3,2013,2015,2,No,0,0.0,0.0,0.0,0,0,0,0,0,0,0.0,0.0,0.0,490500.0,0.0,-490500.0
<a href=/player/castb001>castb001</a>,Braulio Castillo,Los Angeles Dodgers,DOGRS,1,2,1,3,1991,1994,3,No,0,-0.35,1.49,1.84,185,369,184,139,10,-129,244.0,706.0,462.0,165000.0,0.0,-165000.0
<a href=/player/castb001>castb001</a>,Braulio Castillo,Colorado Rockies,ROCKS,1,1,1,2,1993,1993,0,No,0,0.0,-0.99,-0.99,0,28,28,0,0,0,0.0,43.0,43.0,0.0,0.0,0.0
<a href=/player/castb002>castb002</a>,Bernie Castro,New York Yankees,YANKS,1,1,1,2,2001,2007,6,No,0,0.0,0.18,0.18,0,12,12,0,16,16,0.0,0.0,0.0,0.0,0.0,0.0
<a href=/player/castb101>castb101</a>,Bill Castro,New York Yankees,YANKS,1,1,1,2,1982,1982,0,No,0,0.0,-0.81,-0.81,0,30,30,0,60,60,0.0,0.0,0.0,0.0,0.0,0.0
<a href=/player/castc001>castc001</a>,Carmelo Castillo,Cleveland Indians,INDINS,1,1,1,2,1989,1989,0,No,0,-2.66,-0.06,2.6,167,32,-135,395,0,-395,0.0,117.0,117.0,0.0,0.0,0.0
<a href=/player/castd001>castd001</a>,Daniel Castro,Los Angeles Dodgers,DOGRS,1,1,1,2,2019,2019,0,No,0,0.0,0.14,0.14,0,30,30,0,57,57,0.0,0.0,0.0,0.0,0.0,0.0
<a href=/player/castd002>castd002</a>,Diego Castillo,Tampa Bay Devil Rays,RAYS,1,1,2,3,2021,2021,0,Yes,0,0.4,0.82,0.42,25,27,2,0,0,0,66.0,71.0,5.0,0.0,0.0,0.0
<a href=/player/castd003>castd003</a>,Daniel Castano,St. Louis Cardinals,CARDS,1,4,1,5,2017,2019,2,No,0,8.96,4.59,-4.37,386,278,-108,632,1177,545,1696.0,0.0,-1696.0,0.0,0.0,0.0
<a href=/player/castf001>castf001</a>,Frank Castillo,Chicago Cubs,CUBS,1,1,1,2,1997,1997,0,No,0,0.51,0.0,-0.51,28,0,-28,33,0,-33,259.0,0.0,-259.0,1740000.0,0.0,-1740000.0
<a href=/player/castf002>castf002</a>,Fabio Castro,Kansas City Royals,ROYALS,1,1,1,2,2005,2009,4,No,0,-0.01,1.76,1.77,4,316,312,0,978,978,25.0,0.0,-25.0,0.0,0.0,0.0
<a href=/player/castf002>castf002</a>,Fabio Castro,Texas Rangers,RNGRS,1,1,2,3,2006,2006,0,No,0,0.84,0.0,-0.84,51,0,-51,3,0,-3,106.0,0.0,-106.0,327000.0,0.0,-327000.0
<a href=/player/castf002>castf002</a>,Fabio Castro,Philadelphia Phillies,PHILS,1,1,1,2,2008,2009,1,No,0,0.0,0.6,0.6,0,115,115,0,148,148,0.0,0.0,0.0,0.0,0.0,0.0
<a href=/player/castj003>castj003</a>,Juan Castillo,New York Mets,METS,2,3,2,5,1995,1997,2,No,0,0.02,-0.19,-0.21,4,111,107,0,113,113,42.0,991.0,949.0,3213400.0,0.0,-3213400.0
<a href=/player/castj004>castj004</a>,Juan Castro,Los Angeles Dodgers,DOGRS,1,1,1,2,2000,2000,0,No,0,-1.03,0.0,1.03,571,0,-571,1469,0,-1469,0.0,0.0,0.0,0.0,0.0,0.0
<a href=/player/castj004>castj004</a>,Juan Castro,Minnesota Twins,TWINS,1,1,1,2,2006,2006,0,No,0,-0.18,0.0,0.18,115,0,-115,209,0,-209,0.0,0.0,0.0,1000000.0,0.0,-1000000.0
<a href=/player/castj004>castj004</a>,Juan Castro,Colorado Rockies,ROCKS,1,1,1,2,2008,2009,1,No,0,-1.17,-0.02,1.15,54,12,-42,166,6,-160,0.0,0.0,0.0,0.0,0.0,0.0
<a href=/player/castj006>castj006</a>,Jason Castro,Anaheim Angels,ANGELS,1,1,1,2,2020,2020,0,Yes,0,-0.16,0.0,0.16,9,0,-9,30,0,-30,0.0,0.0,0.0,6850000.0,0.0,-6850000.0
<a href=/player/castj007>castj007</a>,Jose Castillo,Tampa Bay Devil Rays,RAYS,4,8,12,20,2014,2020,6,Yes,0,10.52,4.14,-6.38,1388,617,-771,4818,2218,-2600,195.0,136.0,-59.0,3254200.0,0.0,-3254200.0
<a href=/player/castl001>castl001</a>,Luis Castillo,Florida Marlins,MARLNS,1,1,2,3,2005,2005,0,No,0,3.7,0.0,-3.7,227,0,-227,1036,0,-1036,0.0,0.0,0.0,5166667.0,0.0,-5166667.0
<a href=/player/castl001>castl001</a>,Luis Castillo,Minnesota Twins,TWINS,4,4,5,9,2007,2019,12,No,0,3.77,1.65,-2.12,558,466,-92,2185,1348,-837,5.0,417.0,412.0,5750000.0,0.0,-5750000.0
<a href=/player/castl003>castl003</a>,Luis Castillo,San Francisco Giants,GIANTS,1,2,1,3,2014,2015,1,No,0,0.08,-0.84,-0.92,15,49,34,2,138,136,47.0,0.0,-47.0,0.0,0.0,0.0
<a href=/player/castl003>castl003</a>,Luis Castillo,Miami Marlins,MARLNS,3,8,6,14,2016,2019,3,No,0,12.29,-0.08,-12.37,540,354,-186,600,126,-474,2851.0,1392.0,-1459.0,550000.0,0.0,-550000.0
<a href=/player/castl003>castl003</a>,Luis Castillo,San Diego Padres,PADRS,1,1,1,2,2016,2018,2,No,0,0.0,-0.52,-0.52,0,38,38,0,38,38,0.0,298.0,298.0,0.0,0.0,0.0
<a href=/player/castl003>castl003</a>,Luis Castillo,Miami Marlins,MARLNS,1,3,1,4,2017,2019,2,No,0,13.54,1.87,-11.67,336,112,-224,228,107,-121,2332.0,912.0,-1420.0,0.0,0.0,0.0
<a href=/player/castm002>castm002</a>,Miguel Castro,Toronto Blue Jays,BJAYS,1,4,2,6,2015,2018,3,No,0,-2.36,5.17,7.53,267,257,-10,284,987,703,875.0,49.0,-826.0,0.0,0.0,0.0
<a href=/player/castm002>castm002</a>,Miguel Castro,Colorado Rockies,ROCKS,1,1,1,2,2017,2017,0,Yes,0,3.43,0.0,-3.43,193,0,-193,0,0,0,725.0,0.0,-725.0,0.0,0.0,0.0
<a href=/player/castm002>castm002</a>,Miguel Castro,Baltimore Orioles,ORLS,1,1,2,3,2020,2020,0,Yes,0,0.7,0.0,-0.7,144,0,-144,0,0,0,238.0,0.0,-238.0,1050000.0,0.0,-1050000.0
<a href=/player/castm101>castm101</a>,Manny Castillo,Kansas City Royals,ROYALS,4,5,5,10,1981,1998,17,No,0,9.13,14.09,4.96,687,663,-24,1920,984,-936,1567.0,4931.0,3364.0,1360000.0,0.0,-1360000.0
<a href=/player/castn001>castn001</a>,Nick Castellanos,Detroit Tigers,TIGRS,1,2,2,4,2019,2019,0,Yes,0,1.75,0.0,-1.75,51,0,-51,225,0,-225,0.0,0.0,0.0,9950000.0,0.0,-9950000.0
<a href=/player/castp102>castp102</a>,Pete Castiglione,Pittsburgh Pirates,PIRATS,2,2,3,5,1953,1954,1,No,0,-1.73,1.18,2.91,123,120,-3,136,415,279,0.0,0.0,0.0,10000.0,0.0,-10000.0
<a href=/player/castr001>castr001</a>,Bobby Castillo,Los Angeles Dodgers,DOGRS,1,2,2,4,1982,1984,2,No,0,5.49,0.0,-5.49,260,0,-260,694,0,-694,1207.0,0.0,-1207.0,0.0,0.0,0.0
<a href=/player/castr002>castr002</a>,Ramon Castro,Houston Astros,ASTROS,2,2,3,5,1998,2001,3,No,0,0.69,1.51,0.82,282,374,92,531,18,-513,116.0,721.0,605.0,1600000.0,0.0,-1600000.0
<a href=/player/castr002>castr002</a>,Ramon Castro,New York Mets,METS,1,2,1,3,2009,2009,0,No,0,0.61,-0.14,-0.75,91,16,-75,287,0,-287,0.0,44.0,44.0,2625000.0,0.0,-2625000.0
<a href=/player/casts001>casts001</a>,Starlin Castro,Chicago Cubs,CUBS,2,5,3,8,2015,2016,1,No,0,12.91,0.3,-12.61,808,112,-696,2851,4,-2847,353.0,185.0,-168.0,6857143.0,0.0,-6857143.0
<a href=/player/casts001>casts001</a>,Starlin Castro,New York Yankees,YANKS,1,3,1,4,2017,2017,0,Yes,0,2.19,0.0,-2.19,342,0,-342,1369,0,-1369,8.0,0.0,-8.0,9857143.0,0.0,-9857143.0
<a href=/player/casts002>casts002</a>,Simon Castro,San Diego Padres,PADRS,7,19,13,32,2011,2021,10,Yes,0,17.4,14.23,-3.17,1323,1189,-134,3711,3610,-101,1751.0,362.0,-1389.0,9570500.0,0.0,-9570500.0
<a href=/player/castt001>castt001</a>,Tony Castillo,Toronto Blue Jays,BJAYS,1,2,1,3,1989,1991,2,No,0,0.35,0.29,-0.06,335,127,-208,372,0,-372,284.0,625.0,341.0,71500.0,0.0,-71500.0
<a href=/player/castt001>castt001</a>,Tony Castillo,Atlanta Braves,BRAVES,1,2,1,3,1991,1992,1,No,0,0.78,0.88,0.1,20,112,92,6,3,-3,71.0,184.0,113.0,165000.0,0.0,-165000.0
<a href=/player/castt001>castt001</a>,Tony Castillo,New York Mets,METS,1,2,2,4,1992,1993,1,No,0,-1.21,-0.71,0.5,101,102,1,364,8,-356,0.0,212.0,212.0,0.0,0.0,0.0
<a href=/player/castt001>castt001</a>,Tony Castillo,Toronto Blue Jays,BJAYS,1,2,2,4,1996,1998,2,No,0,-1.48,-0.91,0.57,123,26,-97,23,0,-23,336.0,210.0,-126.0,890000.0,0.0,-890000.0
<a href=/player/castv001>castv001</a>,Vinny Castilla,Colorado Rockies,ROCKS,8,14,14,28,1999,2002,3,No,0,5.44,1.04,-4.4,985,502,-483,1111,225,-886,2239.0,1232.0,-1007.0,15375000.0,0.0,-15375000.0
<a href=/player/castv001>castv001</a>,Vinny Castilla,Washington Nationals,NATEX,1,1,2,3,2005,2006,1,No,0,-0.84,0.0,0.84,72,0,-72,269,0,-269,0.0,0.0,0.0,3000000.0,0.0,-3000000.0
<a href=/player/castw001>castw001</a>,Wilkin Castillo,Arizona Diamondbacks,DBACKS,1,3,2,5,2008,2008,0,No,0,-0.17,-0.36,-0.19,138,44,-94,113,187,74,459.0,0.0,-459.0,402000.0,0.0,-402000.0
<a href=/player/castw002>castw002</a>,Welington Castillo,Chicago Cubs,CUBS,1,1,1,2,2015,2015,0,No,0,-0.34,-0.12,0.22,6,9,3,28,0,-28,0.0,27.0,27.0,0.0,0.0,0.0
<a href=/player/castw002>castw002</a>,Welington Castillo,Seattle Mariners,MARNRS,3,7,4,11,2015,2017,2,Yes,0,4.57,3.33,-1.24,655,244,-411,2424,508,-1916,92.0,403.0,311.0,9532900.0,0.0,-9532900.0
<a href=/player/castw002>castw002</a>,Welington Castillo,Chicago White Sox,WSOX,1,2,1,3,2019,2019,0,Yes,0,0.0,0.0,0.0,0,0,0,0,0,0,0.0,0.0,0.0,7250000.0,0.0,-7250000.0
<a href=/player/castw003>castw003</a>,Willi Castro,Cleveland Indians,INDINS,1,1,2,3,2018,2019,1,No,0,-0.75,0.14,0.89,191,71,-120,700,281,-419,0.0,0.0,0.0,0.0,0.0,0.0
<a href=/player/cataf001>cataf001</a>,Frank Catalanotto,Detroit Tigers,TIGRS,3,8,6,14,1999,2006,7,No,2,20.76,5.57,-15.19,1380,450,-930,3548,496,-3052,1196.0,1028.0,-168.0,1937500.0,0.0,-1937500.0
<a href=/player/cated101>cated101</a>,Danny Cater,Philadelphia Phillies,PHILS,1,2,2,4,1964,1966,2,No,0,0.7,1.42,0.72,243,96,-147,836,60,-776,0.0,543.0,543.0,6000.0,0.0,-6000.0
<a href=/player/cated101>cated101</a>,Danny Cater,Chicago White Sox,WSOX,2,2,2,4,1966,1969,3,No,0,4.01,0.88,-3.13,561,357,-204,2213,788,-1425,0.0,0.0,0.0,0.0,0.0,0.0
<a href=/player/cated101>cated101</a>,Danny Cater,Oakland Athletics,ATLTCS,7,16,9,25,1969,1976,7,No,0,16.4,13.94,-2.46,3230,1354,-1876,8120,3449,-4671,2546.0,1199.0,-1347.0,314600.0,0.0,-314600.0
<a href=/player/cated101>cated101</a>,Danny Cater,New York Yankees,YANKS,26,58,46,104,1972,2001,29,No,2,106.81,82.12,-24.69,7254,4598,-2656,18342,10064,-8278,21429.0,11941.0,-9488.0,5628333.0,0.0,-5628333.0
<a href=/player/cated101>cated101</a>,Danny Cater,Boston Red Sox,RSOX,1,1,1,2,1975,1975,0,No,0,-0.29,0.0,0.29,22,0,-22,36,0,-36,0.0,0.0,0.0,0.0,0.0,0.0
<a href=/player/catht101>catht101</a>,Ted Cather,St. Louis Cardinals,CARDS,1,2,1,3,1914,1914,0,No,0,0.65,1.83,1.18,156,44,-112,545,55,-490,0.0,460.0,460.0,2300.0,0.0,-2300.0
<a href=/player/catok001>catok001</a>,Keefe Cato,Cincinnati Reds,REDS,1,1,1,2,1984,1984,0,No,0,0.0,0.0,0.0,0,0,0,0,0,0,0.0,0.0,0.0,0.0,0.0,0.0
<a href=/player/caudb001>caudb001</a>,Bill Caudill,St. Louis Cardinals,CARDS,14,31,25,56,1977,1998,21,No,5,92.92,121.77,28.85,7343,5250,-2093,22954,17708,-5246,6532.0,3025.0,-3507.0,1533333.0,0.0,-1533333.0
<a href=/player/caudb001>caudb001</a>,Bill Caudill,Cincinnati Reds,REDS,1,2,1,3,1977,1981,4,No,0,2.78,3.66,0.88,288,112,-176,68,126,58,1033.0,1005.0,-28.0,85000.0,0.0,-85000.0
<a href=/player/caudb001>caudb001</a>,Bill Caudill,Chicago Cubs,CUBS,4,8,7,15,1982,1990,8,No,0,11.89,11.37,-0.52,835,655,-180,2292,401,-1891,1070.0,3028.0,1958.0,890000.0,0.0,-890000.0
<a href=/player/caudb001>caudb001</a>,Bill Caudill,New York Yankees,YANKS,3,6,4,10,1982,1987,5,No,0,15.14,5.21,-9.93,593,176,-417,734,188,-546,3682.0,1574.0,-2108.0,62500.0,0.0,-62500.0
<a href=/player/caudb001>caudb001</a>,Bill Caudill,Seattle Mariners,MARNRS,1,2,2,4,1983,1987,4,No,0,2.3,0.84,-1.46,79,391,312,1,1067,1066,329.0,228.0,-101.0,0.0,0.0,0.0
<a href=/player/caudb001>caudb001</a>,Bill Caudill,Oakland Athletics,ATLTCS,3,6,6,12,1984,1994,10,No,0,10.58,18.23,7.65,1212,796,-416,2291,2253,-38,1413.0,3814.0,2401.0,1837653.0,0.0,-1837653.0
<a href=/player/caulj101>caulj101</a>,Jake Caulfield,Philadelphia Athletics,ATLTCS,1,4,1,5,1946,1954,8,No,0,0.34,26.76,26.42,48,917,869,112,4210,4098,0.0,0.0,0.0,7000.0,0.0,-7000.0
<a href=/player/caulj101>caulj101</a>,Jake Caulfield,Oakland,Oakland,1,1,3,4,1945,1946,1,No,0,-0.24,0.0,0.24,44,0,-44,98,0,-98,0.0,0.0,0.0,0.0,0.0,0.0
<a href=/player/causr101>causr101</a>,Red Causey,New York Giants,GIANTS,1,5,1,6,1919,1926,7,No,0,8.66,14.34,5.68,964,460,-504,2314,555,-1759,3291.0,4306.0,1015.0,5412.0,0.0,-5412.0
<a href=/player/causr101>causr101</a>,Red Causey,Philadelphia Phillies,PHILS,6,12,11,23,1921,1936,15,No,0,25.95,-0.45,-26.4,1417,2380,963,5389,9549,4160,330.0,992.0,662.0,43100.0,0.0,-43100.0
<a href=/player/causr101>causr101</a>,Red Causey,New York Giants,GIANTS,1,5,1,6,1922,1924,2,No,0,0.0,-0.65,-0.65,0,89,89,0,166,166,0.0,0.0,0.0,4200.0,0.0,-4200.0
<a href=/player/causw101>causw101</a>,Wayne Causey,Baltimore Orioles,ORLS,4,11,7,18,1961,1973,12,No,0,20.55,30.35,9.8,1602,1797,195,5528,6131,603,845.0,306.0,-539.0,72000.0,0.0,-72000.0
<a href=/player/causw101>causw101</a>,Wayne Causey,Kansas City Athletics,ATLTCS,8,17,10,27,1966,1976,10,No,0,18.3,18.25,-0.05,3491,1911,-1580,8767,5651,-3116,2546.0,1199.0,-1347.0,314600.0,0.0,-314600.0
<a href=/player/causw101>causw101</a>,Wayne Causey,Chicago White Sox,WSOX,1,1,1,2,1968,1969,1,No,0,-0.3,-1.02,-0.72,4,96,92,11,141,130,0.0,0.0,0.0,0.0,0.0,0.0
<a href=/player/cavej001>cavej001</a>,Jake Cave,New York Yankees,YANKS,1,1,1,2,2018,2018,0,Yes,0,1.75,0.0,-1.75,281,0,-281,838,0,-838,0.0,0.0,0.0,0.0,0.0,0.0
<a href=/player/ceasd001>ceasd001</a>,Dylan Cease,Chicago Cubs,CUBS,1,4,1,5,2017,2020,3,No,0,6.48,3.51,-2.97,293,156,-137,969,150,-819,891.0,1319.0,428.0,0.0,0.0,0.0
<a href=/player/cecca101>cecca101</a>,Art Ceccarelli,Kansas City Athletics,ATLTCS,52,112,116,228,1956,1976,20,No,0,250.68,149.14,-101.54,20796,15499,-5297,51279,47670,-3609,28842.0,13383.0,-15459.0,673600.0,0.0,-673600.0
<a href=/player/cecca101>cecca101</a>,Art Ceccarelli,Chicago Cubs,CUBS,1,1,1,2,1960,1960,0,No,0,0.0,-0.85,-0.85,0,60,60,0,22,22,0.0,230.0,230.0,0.0,0.0,0.0
<a href=/player/cecca101>cecca101</a>,Art Ceccarelli,Baltimore Orioles,ORLS,1,2,1,3,1958,1958,0,No,0,0.0,0.0,0.0,0,0,0,0,0,0,0.0,0.0,0.0,0.0,0.0,0.0
<a href=/player/cecid001>cecid001</a>,Darrell Ceciliani,New York Mets,METS,1,1,1,2,2016,2016,0,No,0,-0.32,0.0,0.32,16,0,-16,34,0,-34,0.0,0.0,0.0,0.0,0.0,0.0
<a href=/player/cedaj001>cedaj001</a>,Jose Ceda,San Diego Padres,PADRS,1,1,1,2,2006,2007,1,No,0,0.0,0.81,0.81,0,44,44,0,142,142,0.0,0.0,0.0,0.0,0.0,0.0
<a href=/player/cedaj001>cedaj001</a>,Jose Ceda,Chicago Cubs,CUBS,1,1,1,2,2008,2009,1,No,0,0.05,0.05,0.0,49,142,93,2,0,-2,87.0,206.0,119.0,0.0,0.0,0.0
<a href=/player/cedea001>cedea001</a>,Andujar Cedeno,Houston Astros,ASTROS,15,31,38,69,1994,2011,17,No,2,59.26,30.42,-28.84,4671,6149,1478,11202,16044,4842,6620.0,5977.0,-643.0,31714000.0,0.0,-31714000.0
<a href=/player/cedea001>cedea001</a>,Andujar Cedeno,San Diego Padres,PADRS,5,8,9,17,1996,2006,10,No,1,4.5,17.6,13.1,1037,1883,846,3956,6307,2351,0.0,1106.0,1106.0,11375000.0,0.0,-11375000.0
<a href=/player/cedec001>cedec001</a>,Cesar Cedeno,Houston Astros,ASTROS,2,2,4,6,1981,1992,11,No,0,4.7,10.88,6.18,683,996,313,2507,3556,1049,0.0,0.0,0.0,0.0,0.0,0.0
<a href=/player/cedec001>cedec001</a>,Cesar Cedeno,Cincinnati Reds,REDS,1,1,1,2,1985,1985,0,No,0,1.15,0.0,-1.15,28,0,-28,82,0,-82,0.0,0.0,0.0,0.0,0.0,0.0
<a href=/player/ceded001>ceded001</a>,Domingo Cedeno,Toronto Blue Jays,BJAYS,1,2,2,4,1996,1998,2,No,0,-1.48,-0.91,0.57,123,26,-97,23,0,-23,336.0,210.0,-126.0,890000.0,0.0,-890000.0
<a href=/player/ceded001>ceded001</a>,Domingo Cedeno,Seattle Mariners,MARNRS,1,1,1,2,1999,2000,1,No,0,-0.52,0.0,0.52,32,0,-32,72,0,-72,0.0,0.0,0.0,0.0,0.0,0.0
<a href=/player/ceder001>ceder001</a>,Roger Cedeno,Los Angeles Dodgers,DOGRS,1,2,2,4,1998,2000,2,No,0,1.05,2.33,1.28,452,204,-248,1614,781,-833,0.0,0.0,0.0,280000.0,0.0,-280000.0
<a href=/player/ceder001>ceder001</a>,Roger Cedeno,New York Mets,METS,3,11,7,18,1999,2019,20,No,2,19.7,56.63,36.93,1217,2753,1536,1710,7808,6098,3509.0,2332.0,-1177.0,4085500.0,0.0,-4085500.0
<a href=/player/ceder001>ceder001</a>,Roger Cedeno,Houston Astros,ASTROS,2,4,4,8,2000,2008,8,No,0,0.51,2.1,1.59,210,1212,1002,625,3536,2911,615.0,482.0,-133.0,4015000.0,0.0,-4015000.0
<a href=/player/ceder001>ceder001</a>,Roger Cedeno,New York Mets,METS,1,1,1,2,2004,2004,0,No,0,-1.41,0.72,2.13,132,42,-90,284,147,-137,0.0,0.0,0.0,0.0,0.0,0.0
<a href=/player/ceder002>ceder002</a>,Ronny Cedeno,Chicago Cubs,CUBS,2,3,3,6,2009,2012,3,No,0,-3.45,0.86,4.31,326,217,-109,212,3,-209,676.0,339.0,-337.0,1625000.0,0.0,-1625000.0
<a href=/player/ceder002>ceder002</a>,Ronny Cedeno,Seattle Mariners,MARNRS,2,6,3,9,2009,2011,2,No,0,-0.04,2.82,2.86,447,179,-268,1426,514,-912,0.0,332.0,332.0,5822500.0,0.0,-5822500.0
<a href=/player/ceder002>ceder002</a>,Ronny Cedeno,Philadelphia Phillies,PHILS,1,1,1,2,2014,2014,0,Yes,0,0.0,0.0,0.0,0,0,0,0,0,0,0.0,0.0,0.0,0.0,0.0,0.0
<a href=/player/cedex001>cedex001</a>,Xavier Cedeno,Chicago White Sox,WSOX,1,1,2,3,2018,2018,0,Yes,0,0.32,0.0,-0.32,30,0,-30,0,0,0,24.0,0.0,-24.0,0.0,0.0,0.0
<a href=/player/celeg001>celeg001</a>,Gilberto Celestino,Houston Astros,ASTROS,1,2,1,3,2018,2018,0,Yes,0,0.45,1.4,0.95,104,28,-76,62,0,-62,256.0,70.0,-186.0,0.0,0.0,0.0
<a href=/player/cepeo101>cepeo101</a>,Orlando Cepeda,San Francisco Giants,GIANTS,3,4,4,8,1966,1971,5,No,0,19.86,3.15,-16.71,1237,353,-884,3225,458,-2767,1801.0,2055.0,254.0,45000.0,0.0,-45000.0
<a href=/player/cepeo101>cepeo101</a>,Orlando Cepeda,St. Louis Cardinals,CARDS,7,9,9,18,1969,1978,9,No,0,20.36,28.08,7.72,1905,1280,-625,3084,4748,1664,2982.0,616.0,-2366.0,202000.0,0.0,-202000.0
<a href=/player/cepeo101>cepeo101</a>,Orlando Cepeda,Atlanta Braves,BRAVES,1,1,1,2,1972,1973,1,No,0,0.0,-0.92,-0.92,3,30,27,3,16,13,0.0,162.0,162.0,0.0,0.0,0.0
<a href=/player/cerdj001>cerdj001</a>,Jaime Cerda,New York Mets,METS,1,1,1,2,2004,2004,0,No,0,0.63,0.0,-0.63,76,0,-76,0,0,0,194.0,0.0,-194.0,0.0,0.0,0.0
<a href=/player/ceror001>ceror001</a>,Rick Cerone,Cleveland Indians,INDINS,3,4,3,7,1976,1979,3,No,0,1.78,5.31,3.53,491,315,-176,1873,1149,-724,0.0,405.0,405.0,0.0,0.0,0.0
<a href=/player/ceror001>ceror001</a>,Rick Cerone,Toronto Blue Jays,BJAYS,5,9,9,18,1979,1987,8,No,0,10.29,14.89,4.6,1883,1679,-204,6026,5403,-623,668.0,1848.0,1180.0,0.0,0.0,0.0
<a href=/player/ceror001>ceror001</a>,Rick Cerone,New York Yankees,YANKS,11,19,17,36,1984,2001,17,No,1,53.32,21.89,-31.43,2509,1711,-798,6210,4002,-2208,9392.0,4206.0,-5186.0,4225000.0,0.0,-4225000.0
<a href=/player/ceror001>ceror001</a>,Rick Cerone,Atlanta Braves,BRAVES,1,3,1,4,1986,1986,0,No,0,1.33,-0.29,-1.62,68,76,8,242,144,-98,0.0,0.0,0.0,0.0,0.0,0.0
<a href=/player/cervb101>cervb101</a>,Bob Cerv,Kansas City Athletics,ATLTCS,20,41,35,76,1960,1976,16,No,0,70.19,35.04,-35.15,6993,4063,-2930,16448,11579,-4869,8728.0,3414.0,-5314.0,393100.0,0.0,-393100.0
<a href=/player/cervb101>cervb101</a>,Bob Cerv,Los Angeles Angels,ANGELS,2,3,4,7,1961,1965,4,No,0,3.26,2.99,-0.27,414,909,495,1204,2598,1394,209.0,725.0,516.0,0.0,0.0,0.0
<a href=/player/cervf001>cervf001</a>,Francisco Cervelli,New York Yankees,YANKS,3,4,4,8,2014,2021,7,Yes,0,12.5,3.51,-8.99,653,215,-438,1734,2,-1732,424.0,1059.0,635.0,5156000.0,0.0,-5156000.0
<a href=/player/cervh001>cervh001</a>,Hunter Cervenka,Boston Red Sox,RSOX,1,2,2,4,2012,2012,0,No,0,0.77,-0.16,-0.93,128,34,-94,2,106,104,223.0,0.0,-223.0,484000.0,0.0,-484000.0
<a href=/player/cervh001>cervh001</a>,Hunter Cervenka,Atlanta Braves,BRAVES,1,1,2,3,2016,2016,0,Yes,0,-0.38,0.0,0.38,45,0,-45,0,0,0,42.0,0.0,-42.0,0.0,0.0,0.0
<a href=/player/cespy001>cespy001</a>,Yoenis Cespedes,Oakland Athletics,ATLTCS,1,2,3,5,2014,2014,0,No,0,1.49,1.27,-0.22,51,46,-5,213,77,-136,0.0,230.0,230.0,0.0,0.0,0.0
<a href=/player/cespy001>cespy001</a>,Yoenis Cespedes,Boston Red Sox,RSOX,1,3,1,4,2014,2019,5,No,0,9.45,9.39,-0.06,366,170,-196,427,24,-403,794.0,2892.0,2098.0,10500000.0,0.0,-10500000.0
<a href=/player/cespy001>cespy001</a>,Yoenis Cespedes,Detroit Tigers,TIGRS,3,5,6,11,2015,2017,2,Yes,0,18.85,2.36,-16.49,941,142,-799,1424,106,-1318,2199.0,297.0,-1902.0,15200000.0,0.0,-15200000.0
<a href=/player/cessl001>cessl001</a>,Luis Cessa,New York Mets,METS,1,2,1,3,2015,2020,5,No,0,10.66,7.65,-3.01,148,316,168,14,1304,1290,1660.0,0.0,-1660.0,0.0,0.0,0.0
<a href=/player/cessl001>cessl001</a>,Luis Cessa,Detroit Tigers,TIGRS,2,4,4,8,2015,2017,2,Yes,0,11.2,2.36,-8.84,625,142,-483,120,106,-14,2199.0,297.0,-1902.0,4700000.0,0.0,-4700000.0
<a href=/player/cessl001>cessl001</a>,Luis Cessa,New York Yankees,YANKS,1,2,1,3,2021,2021,0,Yes,0,1.83,0.0,-1.83,88,0,-88,0,0,0,127.0,0.0,-127.0,3900000.0,0.0,-3900000.0
<a href=/player/cey-r001>cey-r001</a>,Ron Cey,Los Angeles Dodgers,DOGRS,1,1,2,3,1983,1985,2,No,0,6.09,0.0,-6.09,547,0,-547,2108,0,-2108,0.0,0.0,0.0,0.0,0.0,0.0
<a href=/player/cey-r001>cey-r001</a>,Ron Cey,Chicago Cubs,CUBS,2,2,2,4,1987,1988,1,No,0,1.79,-0.42,-2.21,345,63,-282,964,113,-851,0.0,37.0,37.0,0.0,0.0,0.0
<a href=/player/chace101>chace101</a>,Elio Chacon,New York Mets,METS,1,2,2,4,1964,1964,0,No,0,0.41,0.0,-0.41,120,0,-120,87,0,-87,740.0,0.0,-740.0,0.0,0.0,0.0
<a href=/player/chacj001>chacj001</a>,Jhoulys Chacin,Atlanta Braves,BRAVES,1,1,1,2,2016,2018,2,No,0,0.37,-0.08,-0.45,30,2,-28,2,0,-2,352.0,3.0,-349.0,0.0,0.0,0.0
<a href=/player/chacs001>chacs001</a>,Shawn Chacon,Colorado Rockies,ROCKS,2,2,3,5,2005,2016,11,No,0,4.6,14.9,10.3,108,571,463,3,403,400,641.0,3679.0,3038.0,2350000.0,0.0,-2350000.0
<a href=/player/chacs001>chacs001</a>,Shawn Chacon,New York Yankees,YANKS,1,1,1,2,2006,2006,0,No,0,1.4,-0.91,-2.31,143,40,-103,28,109,81,426.0,0.0,-426.0,3600000.0,0.0,-3600000.0
<a href=/player/chadr001>chadr001</a>,Ray Chadwick,Chicago White Sox,WSOX,1,1,1,2,1989,1989,0,No,0,0.0,0.0,0.0,0,0,0,0,0,0,0.0,0.0,0.0,0.0,0.0,0.0
<a href=/player/chafa001>chafa001</a>,Andrew Chafin,Arizona Diamondbacks,DBACKS,1,2,1,3,2020,2020,0,Yes,0,1.53,0.0,-1.53,88,0,-88,0,0,0,127.0,0.0,-127.0,3045000.0,0.0,-3045000.0
<a href=/player/chafa001>chafa001</a>,Andrew Chafin,Chicago Cubs,CUBS,1,1,2,3,2021,2021,0,Yes,0,1.44,-0.36,-1.8,29,14,-15,0,31,31,88.0,0.0,-88.0,2250000.0,0.0,-2250000.0
<a href=/player/chagl101>chagl101</a>,Leon Chagnon,Pittsburgh Pirates,PIRATS,6,9,6,15,1934,1946,12,No,0,4.27,17.42,13.15,232,1158,926,671,4034,3363,315.0,687.0,372.0,3000.0,0.0,-3000.0
<a href=/player/chakb101>chakb101</a>,Bob Chakales,Cleveland Indians,INDINS,4,5,6,11,1954,1965,11,No,0,10.14,21.84,11.7,1197,1200,3,4089,3837,-252,268.0,1913.0,1645.0,4800.0,0.0,-4800.0
<a href=/player/chakb101>chakb101</a>,Bob Chakales,Baltimore Orioles,ORLS,4,7,9,16,1954,1960,6,No,0,15.05,10.88,-4.17,745,881,136,1673,2506,833,2291.0,1208.0,-1083.0,0.0,0.0,0.0
<a href=/player/chakb101>chakb101</a>,Bob Chakales,Chicago White Sox,WSOX,17,31,30,61,1955,1969,14,No,0,22.96,44.36,21.4,3375,3578,203,7415,6981,-434,5139.0,7668.0,2529.0,156750.0,0.0,-156750.0
<a href=/player/chakb101>chakb101</a>,Bob Chakales,Washington Senators,TWINS,2,3,4,7,1957,1960,3,No,0,-2.93,-2.21,0.72,70,643,573,21,1367,1346,250.0,1860.0,1610.0,19500.0,0.0,-19500.0
<a href=/player/chald101>chald101</a>,Dave Chalk,California Angels,ANGELS,1,1,1,2,1979,1981,2,No,0,-0.06,0.18,0.24,9,217,208,9,598,589,0.0,0.0,0.0,0.0,0.0,0.0
<a href=/player/chald101>chald101</a>,Dave Chalk,Texas Rangers,RNGRS,4,8,5,13,1979,1992,13,No,2,15.39,12.05,-3.34,1067,540,-527,2903,1729,-1174,4307.0,1272.0,-3035.0,0.0,0.0,0.0
<a href=/player/chama002>chama002</a>,Adron Chambers,Houston Astros,ASTROS,1,1,2,3,2014,2014,0,Yes,0,0.0,0.0,0.0,0,0,0,0,0,0,0.0,0.0,0.0,0.0,0.0,0.0
<a href=/player/chamb101>chamb101</a>,Bill Champion,Philadelphia Phillies,PHILS,3,7,6,13,1972,1979,7,No,0,31.4,20.05,-11.35,1669,1025,-644,5610,3103,-2507,2357.0,4062.0,1705.0,29500.0,0.0,-29500.0
<a href=/player/chamc001>chamc001</a>,Chris Chambliss,Cleveland Indians,INDINS,5,10,12,22,1974,1980,6,No,0,19.8,1.33,-18.47,1334,439,-895,4058,397,-3661,2358.0,2962.0,604.0,38000.0,0.0,-38000.0
<a href=/player/chamc001>chamc001</a>,Chris Chambliss,New York Yankees,YANKS,15,29,25,54,1979,2001,22,No,1,62.96,24.19,-38.77,3819,2347,-1472,10447,5998,-4449,11315.0,5150.0,-6165.0,4715000.0,0.0,-4715000.0
<a href=/player/chamc001>chamc001</a>,Chris Chambliss,Toronto Blue Jays,BJAYS,2,3,4,7,1979,1985,6,No,0,4.77,5.46,0.69,1218,673,-545,3925,1647,-2278,3.0,1160.0,1157.0,0.0,0.0,0.0
<a href=/player/chamc101>chamc101</a>,Craig Chamberlain,Kansas City Royals,ROYALS,3,7,5,12,1982,1990,8,No,0,15.6,24.69,9.09,1105,393,-712,1343,512,-831,5715.0,4650.0,-1065.0,1318000.0,0.0,-1318000.0
<a href=/player/chamc102>chamc102</a>,Cliff Chambers,Chicago Cubs,CUBS,1,2,2,4,1948,1955,7,No,0,10.4,0.75,-9.65,514,154,-360,1252,339,-913,1459.0,506.0,-953.0,6500.0,0.0,-6500.0
<a href=/player/chamc102>chamc102</a>,Cliff Chambers,Pittsburgh Pirates,PIRATS,20,37,49,86,1951,1973,22,No,0,26.24,49.68,23.44,3262,4651,1389,9080,13358,4278,3705.0,3970.0,265.0,216500.0,0.0,-216500.0
<a href=/player/chamj101>chamj101</a>,Johnnie Chambers,Brooklyn Dodgers,DOGRS,1,1,1,2,1938,1938,0,No,0,0.0,-0.08,-0.08,0,26,26,0,4,4,0.0,71.0,71.0,0.0,0.0,0.0
<a href=/player/chamj101>chamj101</a>,Johnnie Chambers,Brooklyn Dodgers,DOGRS,1,2,1,3,1939,1939,0,No,0,0.0,0.13,0.13,0,32,32,0,99,99,0.0,0.0,0.0,0.0,0.0,0.0
<a href=/player/chamm101>chamm101</a>,Mike Champion,San Diego Padres,PADRS,2,3,2,5,1979,1981,2,No,0,-0.61,-0.41,0.2,27,234,207,51,691,640,0.0,0.0,0.0,0.0,0.0,0.0
<a href=/player/chamw001>chamw001</a>,Wes Chamberlain,Pittsburgh Pirates,PIRATS,2,4,2,6,1990,1991,1,No,0,3.0,-0.21,-3.21,512,23,-489,1575,37,-1538,0.0,0.0,0.0,925000.0,0.0,-925000.0
<a href=/player/chamw001>chamw001</a>,Wes Chamberlain,Philadelphia Phillies,PHILS,3,5,5,10,1994,2000,6,No,0,9.86,-2.15,-12.01,543,698,155,225,2244,2019,1674.0,703.0,-971.0,876500.0,0.0,-876500.0
<a href=/player/chamw001>chamw001</a>,Wes Chamberlain,Boston Red Sox,RSOX,1,1,1,2,1995,1995,0,No,0,0.0,-0.13,-0.13,0,16,16,0,27,27,0.0,0.0,0.0,0.0,0.0,0.0
<a href=/player/chamw001>chamw001</a>,Wes Chamberlain,Pittsburgh Pirates,PIRATS,1,2,2,4,1997,1997,0,No,0,0.0,0.0,0.0,0,0,0,0,0,0,0.0,0.0,0.0,0.0,0.0,0.0
<a href=/player/chanb101>chanb101</a>,Bob Chance,Cleveland Indians,INDINS,11,17,17,34,1964,1984,20,No,0,50.19,18.25,-31.94,3277,3447,170,11873,12142,269,38.0,317.0,279.0,210250.0,0.0,-210250.0
<a href=/player/chanb101>chanb101</a>,Bob Chance,California Angels,ANGELS,5,10,10,20,1969,1976,7,No,0,0.53,5.03,4.5,382,668,286,431,1911,1480,1134.0,244.0,-890.0,47000.0,0.0,-47000.0
<a href=/player/chanc101>chanc101</a>,Charlie Chant,Oakland Athletics,ATLTCS,1,1,1,2,1975,1978,3,No,0,-0.07,0.35,0.42,15,109,94,14,44,30,0.0,0.0,0.0,0.0,0.0,0.0
<a href=/player/chand101>chand101</a>,Darrel Chaney,Cincinnati Reds,REDS,3,3,3,6,1975,1984,9,No,1,-1.7,-0.05,1.65,379,275,-104,1206,474,-732,0.0,58.0,58.0,0.0,0.0,0.0
<a href=/player/chand102>chand102</a>,Dean Chance,Washington Senators,RNGRS,1,1,1,2,1960,1962,2,No,0,17.91,-0.43,-18.34,446,114,-332,442,220,-222,3710.0,0.0,-3710.0,0.0,0.0,0.0
<a href=/player/chand102>chand102</a>,Dean Chance,California Angels,ANGELS,3,4,5,9,1966,1969,3,No,0,10.95,8.69,-2.26,553,605,52,930,2108,1178,1992.0,0.0,-1992.0,45000.0,0.0,-45000.0
<a href=/player/chand102>chand102</a>,Dean Chance,Minnesota Twins,TWINS,2,5,4,9,1969,1971,2,No,0,19.42,3.86,-15.56,887,264,-623,3069,67,-3002,587.0,852.0,265.0,120000.0,0.0,-120000.0
<a href=/player/chand102>chand102</a>,Dean Chance,New York Mets,METS,1,2,1,3,1971,1971,0,No,0,0.49,0.0,-0.49,124,0,-124,28,0,-28,416.0,0.0,-416.0,0.0,0.0,0.0
<a href=/player/chapa001>chapa001</a>,Aroldis Chapman,Cincinnati Reds,REDS,1,1,4,5,2015,2018,3,Yes,0,7.44,-1.95,-9.39,300,91,-209,0,75,75,774.0,145.0,-629.0,8050000.0,0.0,-8050000.0
<a href=/player/chapa001>chapa001</a>,Aroldis Chapman,New York Yankees,YANKS,3,4,6,10,2016,2020,4,Yes,0,0.46,6.64,6.18,349,162,-187,932,8,-924,145.0,1176.0,1031.0,3936900.0,0.0,-3936900.0
<a href=/player/chapb102>chapb102</a>,Ben Chapman,New York Yankees,YANKS,1,1,1,2,1936,1940,4,No,0,4.03,0.53,-3.5,160,272,112,750,1066,316,0.0,0.0,0.0,10000.0,0.0,-10000.0
<a href=/player/chapb102>chapb102</a>,Ben Chapman,Washington Senators,TWINS,3,4,5,9,1937,1942,5,No,0,10.77,13.4,2.63,718,1031,313,2678,3529,851,623.0,1269.0,646.0,39500.0,0.0,-39500.0
<a href=/player/chapb102>chapb102</a>,Ben Chapman,Boston Red Sox,RSOX,1,1,2,3,1938,1940,2,No,0,5.73,1.22,-4.51,292,110,-182,1286,104,-1182,0.0,801.0,801.0,12500.0,0.0,-12500.0
<a href=/player/chapb102>chapb102</a>,Ben Chapman,Cleveland Indians,INDINS,1,1,1,2,1940,1940,0,No,0,-0.27,0.0,0.27,28,0,-28,121,0,-121,0.0,0.0,0.0,15000.0,0.0,-15000.0
<a href=/player/chapb102>chapb102</a>,Ben Chapman,Brooklyn Dodgers,DOGRS,1,1,1,2,1945,1945,0,No,0,-0.26,0.41,0.67,29,48,19,54,134,80,26.0,0.0,-26.0,0.0,0.0,0.0
<a href=/player/chapd001>chapd001</a>,Darrin Chapin,New York Yankees,YANKS,1,1,1,2,1992,1992,0,No,0,-0.07,2.19,2.26,2,142,140,0,549,549,6.0,0.0,-6.0,0.0,0.0,0.0
<a href=/player/chape101>chape101</a>,Ed Chapman,St. Louis Cardinals,CARDS,1,1,2,3,1933,1934,1,No,0,-0.19,0.0,0.19,12,0,-12,3,0,-3,29.0,0.0,-29.0,0.0,0.0,0.0
<a href=/player/chape101>chape101</a>,Ed Chapman,Washington Senators,TWINS,2,4,3,7,1934,1939,5,No,0,1.0,0.43,-0.57,49,132,83,167,445,278,0.0,0.0,0.0,6000.0,0.0,-6000.0
<a href=/player/chapf102>chapf102</a>,Fred Chapman,Washington Senators,TWINS,1,1,2,3,1937,1940,3,No,0,0.0,0.0,0.0,0,0,0,0,0,0,0.0,0.0,0.0,0.0,0.0,0.0
<a href=/player/chapf102>chapf102</a>,Fred Chapman,Philadelphia Athletics,ATLTCS,1,1,1,2,1941,1941,0,No,0,0.0,0.0,0.0,0,0,0,0,0,0,0.0,0.0,0.0,3000.0,0.0,-3000.0
<a href=/player/chapg101>chapg101</a>,Glenn Chapman,Cincinnati Reds,REDS,1,3,1,4,1939,1939,0,No,0,0.0,-0.1,-0.1,0,6,6,0,14,14,0.0,0.0,0.0,0.0,0.0,0.0
<a href=/player/chaph102>chaph102</a>,Harry Chapman,Chicago Cubs,CUBS,1,3,5,8,1912,1913,1,No,0,3.8,1.08,-2.72,112,82,-30,420,326,-94,0.0,0.0,0.0,7925.0,0.0,-7925.0
<a href=/player/chaph102>chaph102</a>,Harry Chapman,Cincinnati Reds,REDS,1,2,1,3,1913,1913,0,No,0,1.26,1.29,0.03,62,80,18,167,226,59,0.0,0.0,0.0,1500.0,0.0,-1500.0
<a href=/player/chaph102>chaph102</a>,Harry Chapman,St.Louis Browns,ORLS,1,3,1,4,1916,1916,0,No,0,0.0,0.05,0.05,0,27,27,0,42,42,0.0,0.0,0.0,4200.0,0.0,-4200.0
<a href=/player/chapj001>chapj001</a>,Jaye Chapman,Atlanta Braves,BRAVES,1,2,3,5,2012,2013,1,No,0,0.12,-0.62,-0.74,37,188,151,0,323,323,51.0,665.0,614.0,0.0,0.0,0.0
<a href=/player/chapk002>chapk002</a>,Kevin Chapman,Kansas City Royals,ROYALS,1,2,2,4,2012,2012,0,No,0,0.42,-0.3,-0.72,60,73,13,0,210,210,165.0,0.0,-165.0,0.0,0.0,0.0
<a href=/player/chapk002>chapk002</a>,Kevin Chapman,Atlanta Braves,BRAVES,1,2,1,3,2017,2018,1,No,0,0.0,-0.09,-0.09,0,84,84,0,184,184,0.0,0.0,0.0,0.0,0.0,0.0
<a href=/player/chapl101>chapl101</a>,Larry Chappell,Milwaukee,Milwaukee,1,1,2,3,1913,1915,2,No,0,-0.33,0.0,0.33,82,0,-82,278,0,-278,0.0,0.0,0.0,0.0,0.0,0.0
<a href=/player/chapl101>chapl101</a>,Larry Chappell,Chicago White Sox,WSOX,1,4,1,5,1915,1916,1,No,0,11.33,0.0,-11.33,533,0,-533,1606,0,-1606,1090.0,0.0,-1090.0,0.0,0.0,0.0
<a href=/player/chaps101>chaps101</a>,Sam Chapman,Philadelphia Athletics,ATLTCS,1,1,2,3,1951,1953,2,No,0,-0.66,0.02,0.68,94,196,102,273,612,339,0.0,0.0,0.0,16500.0,0.0,-16500.0
<a href=/player/chapt101>chapt101</a>,Tiny Chaplin,Boston Braves,BRAVES,7,21,11,32,1936,1952,16,No,0,22.0,38.45,16.45,1506,1907,401,5516,6570,1054,0.0,2449.0,2449.0,12500.0,0.0,-12500.0
<a href=/player/charc101>charc101</a>,Chappy Charles,St. Louis Cardinals,CARDS,2,4,6,10,1909,1920,11,No,0,9.92,20.82,10.9,510,1351,841,1289,5062,3773,2306.0,795.0,-1511.0,13500.0,0.0,-13500.0
<a href=/player/chare101>chare101</a>,Ed Charles,Milwaukee Braves,BRAVES,11,17,20,37,1961,1973,12,No,0,24.16,33.51,9.35,2325,1915,-410,6983,5059,-1924,2257.0,3206.0,949.0,95000.0,0.0,-95000.0
<a href=/player/chare101>chare101</a>,Ed Charles,Kansas City Athletics,ATLTCS,1,1,2,3,1967,1967,0,No,0,5.12,0.0,-5.12,279,0,-279,963,0,-963,0.0,0.0,0.0,25000.0,0.0,-25000.0
<a href=/player/charj001>charj001</a>,J.T. Chargois,Seattle Mariners,MARNRS,1,2,1,3,2021,2021,0,Yes,0,0.82,0.4,-0.42,27,25,-2,0,0,0,71.0,66.0,-5.0,100000.0,0.0,-100000.0
<a href=/player/charj101>charj101</a>,Joe Charboneau,Philadelphia Phillies,PHILS,1,1,1,2,1978,1978,0,No,0,1.54,0.0,-1.54,201,0,-201,722,0,-722,0.0,0.0,0.0,0.0,0.0,0.0
<a href=/player/charm101>charm101</a>,Mike Chartak,Washington Senators,TWINS,1,2,2,4,1942,1942,0,No,0,6.64,0.79,-5.85,330,98,-232,878,296,-582,1025.0,122.0,-903.0,7250.0,0.0,-7250.0
<a href=/player/charn001>charn001</a>,Norm Charlton,Montreal Expos,NATEX,1,2,1,3,1986,1986,0,No,0,6.55,-0.38,-6.93,483,101,-382,101,247,146,1511.0,0.0,-1511.0,0.0,0.0,0.0
<a href=/player/charn001>charn001</a>,Norm Charlton,Cincinnati Reds,REDS,1,1,1,2,1992,1994,2,No,0,2.11,6.33,4.22,256,188,-68,0,733,733,825.0,0.0,-825.0,1200000.0,0.0,-1200000.0
<a href=/player/chash101>chash101</a>,Hal Chase,New York Yankees,YANKS,2,3,3,6,1913,1914,1,No,0,2.78,-0.53,-3.31,160,153,-7,648,601,-47,0.0,0.0,0.0,6000.0,0.0,-6000.0
<a href=/player/chash101>chash101</a>,Hal Chase,Cincinnati Reds,REDS,2,2,4,6,1919,1921,2,No,0,1.08,0.47,-0.61,646,102,-544,2661,289,-2372,0.0,0.0,0.0,0.0,0.0,0.0
<a href=/player/chask101>chask101</a>,Ken Chase,Washington Senators,TWINS,16,29,30,59,1941,1963,22,No,0,24.05,43.96,19.91,2536,4015,1479,7469,11713,4244,2727.0,6408.0,3681.0,56000.0,0.0,-56000.0
<a href=/player/chask101>chask101</a>,Ken Chase,Boston Red Sox,RSOX,1,1,1,2,1943,1943,0,No,0,0.15,-0.6,-0.75,44,30,-14,46,127,81,388.0,0.0,-388.0,9000.0,0.0,-9000.0
<a href=/player/chatb101>chatb101</a>,Buster Chatham,Portland,Portland,1,1,2,3,1930,1930,0,No,0,-0.08,0.0,0.08,129,0,-129,512,0,-512,0.0,0.0,0.0,0.0,0.0,0.0
<a href=/player/chatt001>chatt001</a>,Tyler Chatwood,Anaheim Angels,ANGELS,1,1,1,2,2011,2015,4,No,0,10.24,6.02,-4.22,216,394,178,183,1342,1159,1517.0,0.0,-1517.0,0.0,0.0,0.0
<a href=/player/chava002>chava002</a>,Angel Chavez,Philadelphia Phillies,PHILS,2,2,3,5,2006,2006,0,No,0,-0.18,-0.09,0.09,80,28,-52,242,107,-135,0.0,0.0,0.0,0.0,0.0,0.0
<a href=/player/chave002>chave002</a>,Endy Chavez,New York Mets,METS,1,1,1,2,2001,2001,0,No,0,-0.82,0.0,0.82,29,0,-29,80,0,-80,0.0,0.0,0.0,0.0,0.0,0.0
<a href=/player/chave002>chave002</a>,Endy Chavez,Washington Nationals,NATEX,1,1,1,2,2005,2006,1,No,0,-0.42,1.06,1.48,91,152,61,118,472,354,0.0,0.0,0.0,0.0,0.0,0.0
<a href=/player/chave002>chave002</a>,Endy Chavez,New York Mets,METS,1,7,3,10,2008,2010,2,No,0,8.89,-1.25,-10.14,554,358,-196,1346,179,-1167,2162.0,325.0,-1837.0,3398000.0,0.0,-3398000.0
<a href=/player/chavj001>chavj001</a>,Jesse Chavez,Texas Rangers,RNGRS,1,1,1,2,2006,2006,0,No,0,-0.2,-0.07,0.13,174,2,-172,1,0,-1,247.0,24.0,-223.0,0.0,0.0,0.0
<a href=/player/chavj001>chavj001</a>,Jesse Chavez,Pittsburgh Pirates,PIRATS,1,1,1,2,2009,2010,1,No,0,0.0,-1.64,-1.64,0,54,54,0,193,193,0.0,0.0,0.0,402000.0,0.0,-402000.0
<a href=/player/chavj001>chavj001</a>,Jesse Chavez,Tampa Bay Devil Rays,RAYS,4,4,5,9,2009,2017,8,No,2,1.95,2.44,0.49,419,229,-190,659,511,-148,440.0,187.0,-253.0,0.0,0.0,0.0
<a href=/player/chavj001>chavj001</a>,Jesse Chavez,Atlanta Braves,BRAVES,1,3,2,5,2010,2010,0,No,0,2.01,-0.01,-2.02,319,93,-226,204,139,-65,734.0,60.0,-674.0,415000.0,0.0,-415000.0
<a href=/player/chavj001>chavj001</a>,Jesse Chavez,Oakland Athletics,ATLTCS,1,1,1,2,2015,2020,5,No,0,-0.06,6.06,6.12,44,261,217,0,0,0,124.0,789.0,665.0,2150000.0,0.0,-2150000.0
<a href=/player/chavj001>chavj001</a>,Jesse Chavez,Toronto Blue Jays,BJAYS,1,1,1,2,2016,2017,1,No,0,-0.09,-0.42,-0.33,45,11,-34,0,0,0,77.0,124.0,47.0,0.0,0.0,0.0
<a href=/player/chavj001>chavj001</a>,Jesse Chavez,Texas Rangers,RNGRS,1,1,1,2,2018,2018,0,Yes,0,1.95,0.0,-1.95,61,0,-61,0,0,0,117.0,0.0,-117.0,1000000.0,0.0,-1000000.0
<a href=/player/chavm001>chavm001</a>,Michael Chavis,Boston Red Sox,RSOX,1,1,1,2,2021,2021,0,Yes,0,0.09,-0.01,-0.1,12,20,8,42,1,-41,0.0,50.0,50.0,0.0,0.0,0.0
<a href=/player/chavo101>chavo101</a>,Ossie Chavarria,Oakland Athletics,ATLTCS,7,16,9,25,1969,1976,7,No,0,16.4,13.94,-2.46,3230,1354,-1876,8120,3449,-4671,2546.0,1199.0,-1347.0,314600.0,0.0,-314600.0
<a href=/player/chavo101>chavo101</a>,Ossie Chavarria,New York Yankees,YANKS,1,1,1,2,1971,1971,0,No,0,0.0,0.0,0.0,0,0,0,0,0,0,0.0,0.0,0.0,0.0,0.0,0.0
<a href=/player/chavr001>chavr001</a>,Raul Chavez,Houston Astros,ASTROS,1,2,1,3,1995,1998,3,No,0,1.28,3.85,2.57,256,330,74,42,1150,1108,419.0,0.0,-419.0,125000.0,0.0,-125000.0
<a href=/player/chavr001>chavr001</a>,Raul Chavez,Montreal Expos,NATEX,1,1,1,2,1998,1998,0,No,0,-0.03,-0.92,-0.89,1,52,51,1,110,109,0.0,0.0,0.0,0.0,0.0,0.0
<a href=/player/chead101>chead101</a>,Dave Cheadle,New York Yankees,YANKS,6,12,9,21,1973,1983,10,No,0,29.7,21.37,-8.33,2028,936,-1092,2549,2957,408,5698.0,1893.0,-3805.0,79000.0,0.0,-79000.0
<a href=/player/chead101>chead101</a>,Dave Cheadle,Atlanta Braves,BRAVES,1,1,1,2,1975,1975,0,No,0,0.0,0.0,0.0,0,0,0,0,0,0,0.0,0.0,0.0,0.0,0.0,0.0
<a href=/player/checc101>checc101</a>,Charlie Chech,Cincinnati Reds,REDS,1,2,1,3,1906,1906,0,No,0,0.0,-1.63,-1.63,0,80,80,0,329,329,0.0,0.0,0.0,0.0,0.0,0.0
<a href=/player/checc101>checc101</a>,Charlie Chech,Cleveland Indians,INDINS,1,3,1,4,1909,1911,2,No,0,-0.98,5.53,6.51,61,126,65,61,191,130,504.0,1513.0,1009.0,0.0,0.0,0.0
<a href=/player/checc101>checc101</a>,Charlie Chech,Boston Red Sox,RSOX,1,3,2,5,1909,1913,4,No,0,0.0,7.22,7.22,0,337,337,0,348,348,0.0,2273.0,2273.0,0.0,0.0,0.0
<a href=/player/checr001>checr001</a>,Robinson Checo,Detroit Tigers,TIGRS,2,4,3,7,1999,2002,3,No,0,-0.56,-0.4,0.16,98,120,22,61,10,-51,565.0,1738.0,1173.0,5300000.0,0.0,-5300000.0
<a href=/player/chenb001>chenb001</a>,Bruce Chen,Atlanta Braves,BRAVES,6,11,8,19,2000,2013,13,No,2,-2.19,26.51,28.7,234,947,713,131,621,490,1036.0,5596.0,4560.0,977500.0,0.0,-977500.0
<a href=/player/chenb001>chenb001</a>,Bruce Chen,Philadelphia Phillies,PHILS,1,2,2,4,2001,2003,2,No,0,-0.17,0.2,0.37,24,190,166,21,2,-19,181.0,268.0,87.0,300000.0,0.0,-300000.0
<a href=/player/chenb001>chenb001</a>,Bruce Chen,New York Mets,METS,1,4,3,7,2002,2005,3,No,0,2.12,1.12,-1.0,505,185,-320,25,27,2,939.0,263.0,-676.0,300000.0,0.0,-300000.0
<a href=/player/chenb001>chenb001</a>,Bruce Chen,Montreal Expos,NATEX,3,5,6,11,2002,2011,9,No,0,4.49,14.94,10.45,502,556,54,134,599,465,1610.0,3834.0,2224.0,8000000.0,0.0,-8000000.0
<a href=/player/chenl101>chenl101</a>,Larry Cheney,Chicago Cubs,CUBS,1,1,2,3,1915,1916,1,No,0,6.73,-0.02,-6.75,245,7,-238,251,8,-243,2183.0,0.0,-2183.0,7000.0,0.0,-7000.0
<a href=/player/chent101>chent101</a>,Tom Cheney,St. Louis Cardinals,CARDS,1,2,1,3,1959,1961,2,No,0,-0.1,-1.61,-1.51,146,68,-78,433,36,-397,156.0,353.0,197.0,0.0,0.0,0.0
<a href=/player/chent101>chent101</a>,Tom Cheney,Pittsburgh Pirates,PIRATS,1,1,1,2,1961,1963,2,No,0,5.09,3.47,-1.62,182,130,-52,131,73,-58,1180.0,658.0,-522.0,0.0,0.0,0.0
<a href=/player/cherp101>cherp101</a>,Paul Chervinko,St. Louis Cardinals,CARDS,1,1,1,2,1937,1937,0,No,0,-1.07,-0.18,0.89,42,8,-34,81,7,-74,0.0,0.0,0.0,0.0,0.0,0.0
<a href=/player/cherp101>cherp101</a>,Paul Chervinko,Brooklyn Dodgers,DOGRS,1,3,1,4,1938,1938,0,No,0,0.0,-0.02,-0.02,0,54,54,0,147,147,0.0,0.0,0.0,0.0,0.0,0.0
<a href=/player/cherr001>cherr001</a>,Rocky Cherry,Chicago Cubs,CUBS,1,2,1,3,2007,2007,0,No,0,-1.45,-0.48,0.97,90,8,-82,155,7,-148,100.0,52.0,-48.0,0.0,0.0,0.0
<a href=/player/chesb101>chesb101</a>,Bob Chesnes,SanFrancisco,SanFrancisco,1,1,5,6,1947,1948,1,No,0,2.62,0.0,-2.62,151,0,-151,185,0,-185,1135.0,0.0,-1135.0,0.0,0.0,0.0
<a href=/player/chesj101>chesj101</a>,Jack Chesbro,Pittsburgh Pirates,PIRATS,4,11,16,27,1899,1914,15,No,0,23.91,73.99,50.08,1271,3182,1911,4723,12859,8136,1693.0,797.0,-896.0,5000.0,0.0,-5000.0
<a href=/player/chias001>chias001</a>,Scott Chiamparino,Oakland Athletics,ATLTCS,2,3,3,6,1990,1997,7,No,0,11.13,4.36,-6.77,696,326,-370,2415,1227,-1188,327.0,177.0,-150.0,0.0,0.0,0.0
<a href=/player/chias002>chias002</a>,Scott Chiasson,Kansas City Royals,ROYALS,2,3,2,5,1999,2001,2,No,0,0.25,0.68,0.43,256,80,-176,31,9,-22,620.0,1109.0,489.0,250000.0,0.0,-250000.0
<a href=/player/chicm001>chicm001</a>,Matt Chico,Arizona Diamondbacks,DBACKS,3,4,6,10,2006,2017,11,Yes,1,2.26,8.21,5.95,227,419,192,110,431,321,1648.0,3571.0,1923.0,523500.0,0.0,-523500.0
<a href=/player/chict001>chict001</a>,Travis Chick,Florida Marlins,MARLNS,1,1,1,2,2004,2005,1,No,0,0.0,0.38,0.38,0,50,50,0,34,34,0.0,320.0,320.0,0.0,0.0,0.0
<a href=/player/chict001>chict001</a>,Travis Chick,San Diego Padres,PADRS,1,2,1,3,2005,2005,0,No,0,-0.01,0.54,0.55,4,58,54,3,241,238,20.0,0.0,-20.0,0.0,0.0,0.0
<a href=/player/chict001>chict001</a>,Travis Chick,Cincinnati Reds,REDS,1,1,2,3,2006,2007,1,No,0,-0.22,0.23,0.45,3,60,57,0,0,0,15.0,83.0,68.0,0.0,0.0,0.0
<a href=/player/chiff001>chiff001</a>,Floyd Chiffer,San Diego Padres,PADRS,1,1,1,2,1984,1985,1,No,0,0.0,0.0,0.0,0,0,0,0,0,0,0.0,0.0,0.0,0.0,0.0,0.0
<a href=/player/chilc101>chilc101</a>,Cupid Childs,Philadelphia Phillies,PHILS,1,2,1,3,1888,1888,0,No,0,0.0,0.08,0.08,0,1,1,0,3,3,0.0,0.0,0.0,0.0,0.0,0.0
<a href=/player/chilc101>chilc101</a>,Cupid Childs,Boston Reds,BS2,1,1,2,3,1891,1894,3,No,0,34.84,0.0,-34.84,1004,0,-1004,4749,0,-4749,0.0,0.0,0.0,0.0,0.0,0.0
<a href=/player/chilj001>chilj001</a>,Jason Childers,Milwaukee Brewers,BREWRS,1,2,2,4,2004,2004,0,No,0,0.0,0.0,0.0,0,0,0,0,0,0,0.0,0.0,0.0,0.0,0.0,0.0
<a href=/player/chilr101>chilr101</a>,Rich Chiles,Houston Astros,ASTROS,2,3,3,6,1972,1973,1,No,0,0.39,0.74,0.35,34,93,59,92,236,144,0.0,0.0,0.0,0.0,0.0,0.0
<a href=/player/chiol101>chiol101</a>,Lou Chiozza,Philadelphia Phillies,PHILS,2,3,3,6,1936,1941,5,No,0,-0.4,-4.65,-4.25,214,508,294,815,1907,1092,0.0,0.0,0.0,0.0,0.0,0.0
<a href=/player/chipb101>chipb101</a>,Bob Chipman,Brooklyn Dodgers,DOGRS,2,3,4,7,1944,1948,4,No,0,13.91,16.22,2.31,598,532,-66,1174,2362,1188,1878.0,0.0,-1878.0,0.0,0.0,0.0
<a href=/player/chirr001>chirr001</a>,Robinson Chirinos,Chicago Cubs,CUBS,4,8,9,17,2011,2019,8,Yes,0,18.8,9.35,-9.45,836,1392,556,1720,408,-1312,3536.0,2716.0,-820.0,1500000.0,0.0,-1500000.0
<a href=/player/chirr001>chirr001</a>,Robinson Chirinos,Texas Rangers,RNGRS,1,2,1,3,2020,2020,0,No,0,-0.08,0.0,0.08,12,0,-12,33,0,-33,0.0,0.0,0.0,5500000.0,0.0,-5500000.0
<a href=/player/chisj001>chisj001</a>,Jazz Chisholm,Arizona Diamondbacks,DBACKS,1,1,1,2,2019,2019,0,Yes,0,2.45,1.2,-1.25,145,16,-129,569,13,-556,0.0,131.0,131.0,0.0,0.0,0.0
<a href=/player/chist101>chist101</a>,Tom Chism,Baltimore Orioles,ORLS,1,1,1,2,1979,1979,0,No,0,0.0,0.0,0.0,0,0,0,0,0,0,0.0,0.0,0.0,0.0,0.0,0.0
<a href=/player/chith101>chith101</a>,Harry Chiti,Chicago Cubs,CUBS,1,1,2,3,1956,1957,1,No,0,0.0,-0.26,-0.26,0,26,26,0,57,57,0.0,0.0,0.0,0.0,0.0,0.0
<a href=/player/chith101>chith101</a>,Harry Chiti,Detroit Tigers,TIGRS,1,1,1,2,1961,1961,0,No,0,0.0,-0.1,-0.1,0,17,17,0,28,28,0.0,0.0,0.0,0.0,0.0,0.0
<a href=/player/chith101>chith101</a>,Harry Chiti,Baltimore Orioles,ORLS,1,3,1,4,1961,1962,1,No,0,-0.1,0.84,0.94,11,78,67,8,316,308,0.0,0.0,0.0,0.0,0.0,0.0
<a href=/player/chitn101>chitn101</a>,Nelson Chittum,St. Louis Cardinals,CARDS,1,1,1,2,1959,1961,2,No,0,0.95,0.35,-0.6,54,36,-18,7,4,-3,116.0,90.0,-26.0,0.0,0.0,0.0
<a href=/player/chitn101>chitn101</a>,Nelson Chittum,Boston Red Sox,RSOX,1,1,1,2,1960,1961,1,No,0,0.0,-0.17,-0.17,0,88,88,0,177,177,0.0,0.0,0.0,0.0,0.0,0.0
<a href=/player/chlub101>chlub101</a>,Bob Chlupsa,St. Louis Cardinals,CARDS,1,2,1,3,1972,1972,0,No,0,0.0,0.0,0.0,7,0,-7,7,0,-7,0.0,0.0,0.0,24000.0,0.0,-24000.0
<a href=/player/choad101>choad101</a>,Don Choate,St. Louis Cardinals,CARDS,12,25,21,46,1959,1972,13,No,0,38.14,29.59,-8.55,3497,1794,-1703,8651,6077,-2574,3788.0,703.0,-3085.0,32500.0,0.0,-32500.0
<a href=/player/choar001>choar001</a>,Randy Choate,New York Yankees,YANKS,8,19,13,32,2003,2014,11,Yes,2,26.42,21.86,-4.56,2170,1008,-1162,5379,2872,-2507,5079.0,2402.0,-2677.0,1920525.0,0.0,-1920525.0
<a href=/player/choar001>choar001</a>,Randy Choate,Montreal Expos,NATEX,1,1,1,2,2004,2004,0,No,0,0.27,-0.13,-0.4,220,38,-182,1,39,38,221.0,295.0,74.0,0.0,0.0,0.0
<a href=/player/choar001>choar001</a>,Randy Choate,Miami Marlins,MARLNS,3,6,9,15,2012,2019,7,Yes,0,16.03,11.46,-4.57,560,873,313,1297,2000,703,1929.0,1864.0,-65.0,9367000.0,0.0,-9367000.0
<a href=/player/choih001>choih001</a>,Hee-Seop Choi,Chicago Cubs,CUBS,2,3,4,7,2003,2010,7,No,0,2.37,22.6,20.23,134,924,790,491,4021,3530,0.0,0.0,0.0,13555000.0,0.0,-13555000.0
<a href=/player/choih001>choih001</a>,Hee-Seop Choi,Florida Marlins,MARLNS,10,19,25,44,2004,2019,15,Yes,0,75.87,54.29,-21.58,2478,2882,404,6294,8326,2032,10672.0,5424.0,-5248.0,38568667.0,0.0,-38568667.0
<a href=/player/choij001>choij001</a>,Ji-Man Choi,Milwaukee Brewers,BREWRS,1,1,2,3,2018,2018,0,No,0,4.5,-0.1,-4.6,301,27,-274,1126,80,-1046,0.0,0.0,0.0,0.0,0.0,0.0
<a href=/player/choim001>choim001</a>,Michael Choice,Oakland Athletics,ATLTCS,1,2,2,4,2013,2015,2,No,0,-2.08,1.42,3.5,87,121,34,281,314,33,0.0,14.0,14.0,0.0,0.0,0.0
<a href=/player/choos001>choos001</a>,Shin-Soo Choo,Seattle Mariners,MARNRS,2,3,3,6,2006,2009,3,No,0,20.83,-0.89,-21.72,711,185,-526,3021,497,-2524,0.0,0.0,0.0,3550000.0,0.0,-3550000.0
<a href=/player/choos001>choos001</a>,Shin-Soo Choo,Cleveland Indians,INDINS,4,8,11,19,2012,2019,7,Yes,0,9.51,23.51,14.0,376,937,561,1266,910,-356,399.0,4479.0,4080.0,22963900.0,0.0,-22963900.0
<a href=/player/choub001>choub001</a>,Bobby Chouinard,Baltimore Orioles,ORLS,1,2,1,3,1993,1995,2,No,0,0.46,5.28,4.82,13,339,326,0,1296,1296,177.0,0.0,-177.0,0.0,0.0,0.0
<a href=/player/chouf101>chouf101</a>,Felix Chouinard,Brooklyn Tip-Tops,BRF,1,1,1,2,1914,1919,5,No,0,0.0,1.87,1.87,0,129,129,0,138,138,0.0,1172.0,1172.0,0.0,0.0,0.0
<a href=/player/chrib102>chrib102</a>,Bruce Christensen,California Angels,ANGELS,3,7,5,12,1973,1990,17,No,0,42.82,58.13,15.31,1088,2050,962,2703,8018,5315,7556.0,2386.0,-5170.0,175000.0,0.0,-175000.0
<a href=/player/chric001>chric001</a>,Clay Christiansen,Minnesota Twins,TWINS,2,4,3,7,1987,1989,2,No,0,2.78,0.53,-2.25,304,43,-261,1185,20,-1165,0.0,435.0,435.0,103500.0,0.0,-103500.0
<a href=/player/chric101>chric101</a>,Cuckoo Christensen,StPaul,StPaul,1,1,2,3,1925,1925,0,No,0,2.0,0.0,-2.0,171,0,-171,595,0,-595,0.0,0.0,0.0,0.0,0.0,0.0
<a href=/player/chrij001>chrij001</a>,John Christensen,New York Mets,METS,6,12,11,23,1985,1994,9,No,0,8.23,9.35,1.12,636,686,50,644,1209,565,3320.0,3063.0,-257.0,4116666.0,0.0,-4116666.0
<a href=/player/chrij001>chrij001</a>,John Christensen,Boston Red Sox,RSOX,3,7,5,12,1986,1993,7,No,0,7.37,8.49,1.12,984,1130,146,3351,3154,-197,369.0,1455.0,1086.0,1275000.0,0.0,-1275000.0
<a href=/player/chrij002>chrij002</a>,Jason Christiansen,Pittsburgh Pirates,PIRATS,2,3,6,9,2000,2012,12,No,0,2.65,22.27,19.62,279,1549,1270,514,6007,5493,420.0,0.0,-420.0,11600000.0,0.0,-11600000.0
<a href=/player/chrij002>chrij002</a>,Jason Christiansen,St. Louis Cardinals,CARDS,2,2,3,5,2001,2003,2,No,0,0.48,-0.11,-0.59,363,22,-341,0,0,0,378.0,33.0,-345.0,1600000.0,0.0,-1600000.0
<a href=/player/chrij002>chrij002</a>,Jason Christiansen,San Francisco Giants,GIANTS,1,1,2,3,2005,2005,0,No,0,0.15,0.0,-0.15,12,0,-12,0,0,0,11.0,0.0,-11.0,1050000.0,0.0,-1050000.0
<a href=/player/chrij101>chrij101</a>,Joe Christopher,New York Mets,METS,3,5,5,10,1965,1969,4,No,0,-1.15,1.52,2.67,64,330,266,91,1115,1024,0.0,0.0,0.0,18000.0,0.0,-18000.0
<a href=/player/chrij101>chrij101</a>,Joe Christopher,Boston Red Sox,RSOX,3,6,5,11,1966,1968,2,No,0,22.76,3.78,-18.98,955,221,-734,2583,411,-2172,3084.0,1094.0,-1990.0,17000.0,0.0,-17000.0
<a href=/player/chrim001>chrim001</a>,Mike Christopher,Los Angeles Dodgers,DOGRS,2,3,2,5,1991,1993,2,No,0,1.24,0.37,-0.87,87,132,45,0,504,504,763.0,0.0,-763.0,240000.0,0.0,-240000.0
<a href=/player/chrim002>chrim002</a>,McKay Christensen,California Angels,ANGELS,1,4,2,6,1995,1997,2,No,0,5.3,-0.85,-6.15,439,40,-399,87,0,-87,1686.0,680.0,-1006.0,0.0,0.0,0.0
<a href=/player/chrim002>chrim002</a>,McKay Christensen,Chicago White Sox,WSOX,3,3,3,6,2001,2008,7,No,0,0.33,-1.03,-1.36,252,235,-17,819,471,-348,0.0,42.0,42.0,350000.0,0.0,-350000.0
<a href=/player/chrim101>chrim101</a>,Mike Chris,Detroit Tigers,TIGRS,1,2,1,3,1981,1986,5,No,0,-1.99,10.36,12.35,58,678,620,18,2558,2540,218.0,0.0,-218.0,0.0,0.0,0.0
<a href=/player/chrim102>chrim102</a>,Mark Christman,Detroit Tigers,TIGRS,3,9,7,16,1939,1948,9,No,0,19.29,21.11,1.82,2183,1686,-497,6579,6030,-549,3951.0,2317.0,-1634.0,44300.0,0.0,-44300.0
<a href=/player/chrin101>chrin101</a>,Neil Chrisley,Boston Red Sox,RSOX,2,7,5,12,1955,1963,8,No,0,0.69,2.88,2.19,731,424,-307,812,1170,358,1712.0,707.0,-1005.0,7000.0,0.0,-7000.0
<a href=/player/chrin101>chrin101</a>,Neil Chrisley,Washington Senators,TWINS,5,10,8,18,1958,1963,5,No,0,7.52,-2.19,-9.71,769,798,29,2600,2634,34,5.0,80.0,75.0,9500.0,0.0,-9500.0
<a href=/player/chrin101>chrin101</a>,Neil Chrisley,Detroit Tigers,TIGRS,5,8,11,19,1961,1970,9,No,0,40.14,34.88,-5.26,2089,1971,-118,6205,4897,-1308,4562.0,4033.0,-529.0,39000.0,0.0,-39000.0
<a href=/player/chrir001>chrir001</a>,Ryan Christenson,Oakland Athletics,ATLTCS,1,1,1,2,2001,2002,1,No,0,0.05,-0.17,-0.22,19,7,-12,5,7,2,0.0,0.0,0.0,267500.0,0.0,-267500.0
<a href=/player/chris001>chris001</a>,Steve Christmas,Cincinnati Reds,REDS,1,1,1,2,1983,1983,0,No,0,0.18,0.0,-0.18,12,0,-12,11,0,-11,0.0,0.0,0.0,0.0,0.0,0.0
<a href=/player/chulv001>chulv001</a>,Vinnie Chulk,Toronto Blue Jays,BJAYS,1,2,1,3,2006,2010,4,No,0,0.24,1.81,1.57,281,144,-137,251,0,-251,321.0,419.0,98.0,6148500.0,0.0,-6148500.0
<a href=/player/churb101>churb101</a>,Bubba Church,Philadelphia Phillies,PHILS,1,1,2,3,1952,1955,3,No,0,0.41,1.41,1.0,84,321,237,68,1119,1051,591.0,21.0,-570.0,0.0,0.0,0.0
<a href=/player/churb101>churb101</a>,Bubba Church,Cincinnati Reds,REDS,2,2,3,5,1953,1958,5,No,0,-0.15,3.49,3.64,100,111,11,46,68,22,450.0,619.0,169.0,0.0,0.0,0.0
<a href=/player/churb101>churb101</a>,Bubba Church,Chicago Cubs,CUBS,3,7,5,12,1955,1961,6,No,0,-0.03,2.29,2.32,58,334,276,20,837,817,147.0,324.0,177.0,0.0,0.0,0.0
<a href=/player/churc101>churc101</a>,Chuck Churn,Cincinnati Reds,REDS,1,1,1,2,1959,1959,0,No,0,0.16,0.0,-0.16,28,0,-28,6,0,-6,92.0,0.0,-92.0,0.0,0.0,0.0
<a href=/player/churr001>churr001</a>,Ryan Church,Cleveland Indians,INDINS,1,2,1,3,2004,2004,0,No,0,5.47,-0.76,-6.23,379,23,-356,1253,0,-1253,0.0,41.0,41.0,0.0,0.0,0.0
<a href=/player/churr001>churr001</a>,Ryan Church,Washington Nationals,NATEX,3,5,5,10,2007,2012,5,No,0,12.18,4.97,-7.21,1207,808,-399,2595,1406,-1189,688.0,605.0,-83.0,4767000.0,0.0,-4767000.0
<a href=/player/churr001>churr001</a>,Ryan Church,New York Mets,METS,2,3,2,5,2009,2010,1,No,0,1.2,2.55,1.35,59,221,162,200,788,588,0.0,0.0,0.0,7800000.0,0.0,-7800000.0
<a href=/player/churr001>churr001</a>,Ryan Church,Pittsburgh Pirates,PIRATS,1,3,3,6,2010,2011,1,No,0,-0.12,0.71,0.83,82,105,23,69,301,232,68.0,0.0,-68.0,3450000.0,0.0,-3450000.0
<a href=/player/ciana001>ciana001</a>,Archi Cianfrocco,Montreal Expos,NATEX,2,3,2,5,1993,1996,3,No,0,7.94,3.77,-4.17,1000,382,-618,1752,41,-1711,4901.0,800.0,-4101.0,990000.0,0.0,-990000.0
<a href=/player/cicej101>cicej101</a>,Joe Cicero,Nashville,Nashville,1,1,1,2,1932,1932,0,No,0,0.0,0.0,0.0,0,0,0,0,0,0,0.0,0.0,0.0,0.0,0.0,0.0
<a href=/player/cicej101>cicej101</a>,Joe Cicero,Boston Red Sox,RSOX,2,6,4,10,1930,1937,7,No,0,1.87,7.56,5.69,361,744,383,1356,1842,486,119.0,1357.0,1238.0,15100.0,0.0,-15100.0
<a href=/player/cicoa101>cicoa101</a>,Al Cicotte,Washington Senators,TWINS,2,2,2,4,1958,1962,4,No,0,0.47,0.34,-0.13,29,60,31,17,32,15,130.0,319.0,189.0,0.0,0.0,0.0
<a href=/player/cicoa101>cicoa101</a>,Al Cicotte,Detroit Tigers,TIGRS,1,2,3,5,1958,1964,6,No,0,0.2,14.33,14.13,125,305,180,263,345,82,132.0,2789.0,2657.0,0.0,0.0,0.0
<a href=/player/cicoa101>cicoa101</a>,Al Cicotte,Toronto,Toronto,2,2,5,7,1960,1961,1,No,0,6.5,0.0,-6.5,500,0,-500,1822,0,-1822,225.0,0.0,-225.0,0.0,0.0,0.0
<a href=/player/cimba001>cimba001</a>,Adam Cimber,San Diego Padres,PADRS,2,6,2,8,2018,2020,2,Yes,0,4.43,0.25,-4.18,334,116,-218,277,344,67,823.0,0.0,-823.0,0.0,0.0,0.0
<a href=/player/cimba001>cimba001</a>,Adam Cimber,Miami Marlins,MARLNS,1,3,2,5,2021,2021,0,Yes,0,1.51,-1.03,-2.54,88,53,-35,140,134,-6,112.0,0.0,-112.0,9675000.0,0.0,-9675000.0
<a href=/player/cimip101>cimip101</a>,Pete Cimino,Minnesota Twins,TWINS,3,8,6,14,1966,1971,5,No,0,25.4,14.58,-10.82,1429,584,-845,4690,560,-4130,873.0,2844.0,1971.0,153000.0,0.0,-153000.0
<a href=/player/cimog101>cimog101</a>,Gino Cimoli,Los Angeles Dodgers,DOGRS,2,4,4,8,1958,1965,7,No,0,0.26,12.64,12.38,143,755,612,569,2657,2088,0.0,0.0,0.0,15000.0,0.0,-15000.0
<a href=/player/cimog101>cimog101</a>,Gino Cimoli,St. Louis Cardinals,CARDS,1,2,1,3,1959,1961,2,No,0,-0.1,-1.61,-1.51,146,68,-78,433,36,-397,156.0,353.0,197.0,0.0,0.0,0.0
<a href=/player/cimog101>cimog101</a>,Gino Cimoli,Pittsburgh Pirates,PIRATS,1,1,1,2,1961,1963,2,No,0,-0.48,-0.36,0.12,37,152,115,131,355,224,0.0,0.0,0.0,0.0,0.0,0.0
<a href=/player/cingt001>cingt001</a>,Tony Cingrani,Cincinnati Reds,REDS,1,1,2,3,2017,2017,0,Yes,0,-0.01,0.0,0.01,103,0,-103,0,0,0,126.0,0.0,-126.0,1825000.0,0.0,-1825000.0
<a href=/player/cingt001>cingt001</a>,Tony Cingrani,Los Angeles Dodgers,DOGRS,1,2,2,4,2019,2019,0,No,0,0.0,-0.4,-0.4,0,24,24,0,39,39,0.0,0.0,0.0,0.0,0.0,0.0
<a href=/player/cinta001>cinta001</a>,Alex Cintron,Arizona Diamondbacks,DBACKS,1,1,1,2,2006,2007,1,No,0,-2.54,-0.3,2.24,159,2,-157,500,0,-500,0.0,3.0,3.0,0.0,0.0,0.0
<a href=/player/cirij001>cirij001</a>,Jeff Cirillo,Milwaukee Brewers,BREWRS,4,7,8,15,1999,2003,4,No,0,6.3,0.97,-5.33,590,668,78,2079,1251,-828,242.0,2859.0,2617.0,10900000.0,0.0,-10900000.0
<a href=/player/cirij001>cirij001</a>,Jeff Cirillo,Colorado Rockies,ROCKS,4,4,8,12,2001,2015,14,Yes,2,-0.9,12.98,13.88,392,1556,1164,842,90,-752,294.0,2735.0,2441.0,6250000.0,0.0,-6250000.0
<a href=/player/cirij001>cirij001</a>,Jeff Cirillo,Seattle Mariners,MARNRS,2,4,5,9,2004,2008,4,No,0,-0.53,1.64,2.17,147,104,-43,117,144,27,212.0,123.0,-89.0,750000.0,0.0,-750000.0
<a href=/player/cirip001>cirip001</a>,Pedro Ciriaco,Arizona Diamondbacks,DBACKS,1,3,3,6,2010,2010,0,No,0,0.71,-0.12,-0.83,105,82,-23,301,69,-232,0.0,68.0,68.0,5250000.0,0.0,-5250000.0
<a href=/player/cirip001>cirip001</a>,Pedro Ciriaco,Texas Rangers,RNGRS,1,1,1,2,2016,2016,0,No,0,0.0,0.0,0.0,0,0,0,0,0,0,0.0,0.0,0.0,0.0,0.0,0.0
<a href=/player/cishs001>cishs001</a>,Steve Cishek,Miami Marlins,MARLNS,2,2,1,3,2015,2018,3,No,0,-0.27,2.64,2.91,119,441,322,0,2,2,147.0,656.0,509.0,7763000.0,0.0,-7763000.0
<a href=/player/cishs001>cishs001</a>,Steve Cishek,Seattle Mariners,MARNRS,1,2,1,3,2017,2018,1,No,0,1.07,0.29,-0.78,28,24,-4,0,6,6,74.0,323.0,249.0,6000000.0,0.0,-6000000.0
<a href=/player/cissb101>cissb101</a>,Bill Cissell,Portland,Portland,1,1,4,5,1927,1933,6,No,0,-0.07,0.0,0.07,539,0,-539,2234,0,-2234,0.0,0.0,0.0,0.0,0.0,0.0
<a href=/player/cissb101>cissb101</a>,Bill Cissell,Chicago White Sox,WSOX,4,13,7,20,1932,1936,4,No,0,4.13,0.06,-4.07,711,272,-439,2521,849,-1672,0.0,39.0,39.0,28700.0,0.0,-28700.0
<a href=/player/cissb101>cissb101</a>,Bill Cissell,Cleveland Indians,INDINS,1,1,1,2,1933,1938,5,No,0,-0.68,7.0,7.68,102,270,168,452,151,-301,0.0,1369.0,1369.0,8500.0,0.0,-8500.0
<a href=/player/cissb101>cissb101</a>,Bill Cissell,Boston Red Sox,RSOX,3,4,4,8,1935,1943,8,No,0,21.33,10.89,-10.44,818,588,-230,3332,591,-2741,514.0,3526.0,3012.0,22500.0,0.0,-22500.0
<a href=/player/cissb101>cissb101</a>,Bill Cissell,Baltimore,Baltimore,1,1,2,3,1938,1938,0,No,0,0.62,0.0,-0.62,38,0,-38,155,0,-155,0.0,0.0,0.0,0.0,0.0,0.0
<a href=/player/claga001>claga001</a>,Anthony Claggett,Detroit Tigers,TIGRS,1,3,1,4,2006,2009,3,No,0,-0.32,2.79,3.11,6,247,241,0,1075,1075,19.0,0.0,-19.0,0.0,0.0,0.0
<a href=/player/clanj001>clanj001</a>,Jim Clancy,Houston Astros,ASTROS,1,1,2,3,1991,1992,1,No,0,-0.43,0.0,0.43,48,0,-48,3,0,-3,104.0,0.0,-104.0,0.0,0.0,0.0
<a href=/player/clara102>clara102</a>,Allie Clark,New York Yankees,YANKS,3,8,4,12,1947,1954,7,No,0,24.51,2.48,-22.03,1148,381,-767,2292,216,-2076,4702.0,1976.0,-2726.0,11500.0,0.0,-11500.0
<a href=/player/clara102>clara102</a>,Allie Clark,Cleveland Indians,INDINS,1,2,1,3,1951,1952,1,No,0,0.02,-0.66,-0.68,196,94,-102,612,273,-339,0.0,0.0,0.0,0.0,0.0,0.0
<a href=/player/clarb001>clarb001</a>,Bryan Clark,Seattle Mariners,MARNRS,1,1,1,2,1983,1986,3,No,0,-0.79,-1.19,-0.4,20,175,155,0,565,565,137.0,0.0,-137.0,0.0,0.0,0.0
<a href=/player/clarb002>clarb002</a>,Bobby Clark,California Angels,ANGELS,1,1,1,2,1983,1986,3,No,0,-1.24,-0.09,1.15,87,75,-12,290,0,-290,0.0,1154.0,1154.0,145000.0,0.0,-145000.0
<a href=/player/clarb003>clarb003</a>,Brady Clark,Cincinnati Reds,REDS,1,4,2,6,2002,2002,0,No,0,6.19,-0.7,-6.89,1101,12,-1089,365,10,-355,1151.0,84.0,-1067.0,233000.0,0.0,-233000.0
<a href=/player/clarb003>clarb003</a>,Brady Clark,Milwaukee Brewers,BREWRS,1,2,1,3,2007,2007,0,No,0,-0.33,-0.51,-0.18,47,24,-23,66,0,-66,0.0,45.0,45.0,0.0,0.0,0.0
<a href=/player/clarb101>clarb101</a>,Buzz Clarkson,Dallas,Dallas,1,1,1,2,1954,1954,0,No,0,0.0,0.0,0.0,0,0,0,0,0,0,0.0,0.0,0.0,0.0,0.0,0.0
<a href=/player/clarb101>clarb101</a>,Buzz Clarkson,Chicago Cubs,CUBS,1,2,4,6,1954,1955,1,No,0,0.0,0.0,0.0,0,0,0,0,0,0,0.0,0.0,0.0,0.0,0.0,0.0
<a href=/player/clarb102>clarb102</a>,Bill Clarkson,New York Giants,GIANTS,1,4,1,5,1928,1928,0,No,0,11.88,2.32,-9.56,1432,52,-1380,2925,68,-2857,4700.0,475.0,-4225.0,21900.0,0.0,-21900.0
<a href=/player/clarc101>clarc101</a>,Cap Clark,St. Louis Cardinals,CARDS,1,1,1,2,1937,1937,0,No,0,-0.15,0.0,0.15,52,0,-52,84,0,-84,0.0,0.0,0.0,0.0,0.0,0.0
<a href=/player/clard001>clard001</a>,Dave Clark,Cleveland Indians,INDINS,2,2,2,4,1989,1991,2,No,0,-0.8,2.26,3.06,222,155,-67,453,513,60,0.0,104.0,104.0,847500.0,0.0,-847500.0
<a href=/player/clard001>clard001</a>,Dave Clark,Pittsburgh Pirates,PIRATS,1,1,1,2,1996,1996,0,No,0,-0.05,0.0,0.05,15,0,-15,18,0,-18,0.0,0.0,0.0,800000.0,0.0,-800000.0
<a href=/player/clard101>clard101</a>,Danny Clark,Detroit Tigers,TIGRS,2,6,3,9,1922,1928,6,No,0,20.71,4.6,-16.11,377,336,-41,782,333,-449,2967.0,2739.0,-228.0,8000.0,0.0,-8000.0
<a href=/player/clard101>clard101</a>,Danny Clark,Boston Red Sox,RSOX,1,1,1,2,1924,1924,0,No,0,0.0,0.0,0.0,0,0,0,0,0,0,0.0,0.0,0.0,3300.0,0.0,-3300.0
<a href=/player/clard102>clard102</a>,Dad Clarkson,St. Louis Cardinals,CARDS,1,1,2,3,1895,1903,8,No,0,1.39,-4.82,-6.21,54,136,82,87,276,189,567.0,924.0,357.0,0.0,0.0,0.0
<a href=/player/clard103>clard103</a>,Dad Clarke,New York Giants,GIANTS,1,2,1,3,1897,1898,1,No,0,0.6,0.35,-0.25,16,84,68,25,348,323,191.0,0.0,-191.0,0.0,0.0,0.0
<a href=/player/clard105>clard105</a>,Doug Clarey,St. Louis Cardinals,CARDS,2,2,2,4,1977,1979,2,No,0,1.56,0.12,-1.44,333,7,-326,761,6,-755,0.0,0.0,0.0,0.0,0.0,0.0
<a href=/player/clare102>clare102</a>,Ellis Clary,Washington Senators,TWINS,1,3,2,5,1943,1946,3,No,0,0.45,8.73,8.28,110,267,157,206,710,504,209.0,1415.0,1206.0,3000.0,0.0,-3000.0
<a href=/player/clarf101>clarf101</a>,Fred Clarke,Louisville Colonels,LS3,1,12,5,17,1899,1900,1,No,0,267.1,0.0,-267.1,7388,0,-7388,29004,0,-29004,7568.0,0.0,-7568.0,4350.0,0.0,-4350.0
<a href=/player/clarg102>clarg102</a>,Grey Clarke,Milwaukee,Milwaukee,3,4,6,10,1943,1945,2,No,0,1.66,0.0,-1.66,525,0,-525,1977,0,-1977,0.0,0.0,0.0,0.0,0.0,0.0
<a href=/player/clarj001>clarj001</a>,Jack Clark,San Francisco Giants,GIANTS,5,8,10,18,1985,1992,7,No,0,17.86,24.68,6.82,1451,2054,603,3672,5784,2112,2390.0,2643.0,253.0,275000.0,0.0,-275000.0
<a href=/player/clarj001>clarj001</a>,Jack Clark,New York Yankees,YANKS,7,13,9,22,1988,2001,13,No,1,33.33,15.51,-17.82,1697,1345,-352,5213,4000,-1213,3631.0,1622.0,-2009.0,2990000.0,0.0,-2990000.0
<a href=/player/clarj003>clarj003</a>,Jermaine Clark,Seattle Mariners,MARNRS,1,2,1,3,2002,2002,0,No,0,-0.48,0.16,0.64,24,8,-16,54,0,-54,0.0,148.0,148.0,0.0,0.0,0.0
<a href=/player/clarj102>clarj102</a>,John Clarkson,Cleveland Spiders,CL4,1,1,1,2,1894,1894,0,No,0,0.0,-0.28,-0.28,0,8,8,0,18,18,0.0,99.0,99.0,0.0,0.0,0.0
<a href=/player/clarj103>clarj103</a>,Josh Clarke,Boston Braves,BRAVES,1,2,1,3,1911,1911,0,No,0,0.0,-0.19,-0.19,0,19,19,0,71,71,0.0,0.0,0.0,0.0,0.0,0.0
<a href=/player/clarj104>clarj104</a>,Jim Clark,Cleveland Indians,INDINS,4,4,4,8,1972,1984,12,No,0,1.73,3.37,1.64,106,325,219,15,736,721,290.0,598.0,308.0,0.0,0.0,0.0
<a href=/player/clarm002>clarm002</a>,Mark Clark,St. Louis Cardinals,CARDS,3,5,4,9,1993,1996,3,No,0,6.18,4.27,-1.91,282,470,188,117,1434,1317,1824.0,182.0,-1642.0,125000.0,0.0,-125000.0
<a href=/player/clarm002>clarm002</a>,Mark Clark,Cleveland Indians,INDINS,1,1,2,3,1996,1996,0,No,0,1.12,0.09,-1.03,109,8,-101,130,23,-107,1063.0,0.0,-1063.0,0.0,0.0,0.0
<a href=/player/clarm002>clarm002</a>,Mark Clark,New York Mets,METS,7,15,13,28,1997,2005,8,No,0,5.2,5.1,-0.1,1347,1947,600,1609,2988,1379,2422.0,1675.0,-747.0,19588333.0,0.0,-19588333.0
<a href=/player/clarm102>clarm102</a>,Mel Clark,Philadelphia Phillies,PHILS,1,4,4,8,1956,1956,0,No,0,0.0,0.0,0.0,0,0,0,0,0,0,0.0,0.0,0.0,0.0,0.0,0.0
<a href=/player/clarn101>clarn101</a>,Nig Clarke,Cleveland Indians,INDINS,1,1,1,2,1910,1910,0,No,0,-0.66,0.0,0.66,82,0,-82,292,0,-292,0.0,0.0,0.0,0.0,0.0,0.0
<a href=/player/clarr103>clarr103</a>,Ron Clark,Milwaukee Brewers,BREWRS,13,32,32,64,1970,1984,14,No,0,47.88,123.46,75.58,3414,6405,2991,8076,20920,12844,14309.0,8780.0,-5529.0,506701.0,0.0,-506701.0
<a href=/player/clarr103>clarr103</a>,Ron Clark,Oakland Athletics,ATLTCS,3,4,4,8,1972,1973,1,No,0,1.37,0.49,-0.88,156,75,-81,617,245,-372,0.0,22.0,22.0,117000.0,0.0,-117000.0
<a href=/player/clarr103>clarr103</a>,Ron Clark,Milwaukee Brewers,BREWRS,1,2,2,4,1972,1972,0,No,0,0.0,-0.49,-0.49,0,42,42,0,79,79,0.0,0.0,0.0,14000.0,0.0,-14000.0
<a href=/player/clarr103>clarr103</a>,Ron Clark,California Angels,ANGELS,3,5,4,9,1973,1976,3,No,0,2.26,3.03,0.77,402,170,-232,1412,564,-848,0.0,90.0,90.0,38500.0,0.0,-38500.0
<a href=/player/clarr103>clarr103</a>,Ron Clark,San Diego Padres,PADRS,1,1,1,2,1973,1973,0,No,0,0.0,0.0,0.0,1,0,-1,1,0,-1,0.0,0.0,0.0,0.0,0.0,0.0
<a href=/player/clars001>clars001</a>,Stan Clarke,Seattle Mariners,MARNRS,1,1,1,2,1987,1989,2,No,0,0.0,-0.08,-0.08,0,42,42,0,76,76,0.0,0.0,0.0,0.0,0.0,0.0
<a href=/player/clart002>clart002</a>,Tony Clark,San Diego Padres,PADRS,1,1,1,2,2008,2011,3,No,0,-0.63,-0.23,0.4,74,19,-55,155,0,-155,0.0,42.0,42.0,900000.0,0.0,-900000.0
<a href=/player/clart101>clart101</a>,Tommy Clarke,Cincinnati Reds,REDS,1,1,1,2,1918,1919,1,No,0,0.0,2.92,2.92,0,119,119,0,514,514,0.0,0.0,0.0,0.0,0.0,0.0
<a href=/player/clarw001>clarw001</a>,Will Clark,Baltimore Orioles,ORLS,1,2,1,3,2000,2004,4,No,0,2.14,-0.66,-2.8,51,88,37,197,221,24,0.0,0.0,0.0,6000000.0,0.0,-6000000.0
<a href=/player/clarw101>clarw101</a>,Watty Clark,Brooklyn Dodgers,DOGRS,1,2,1,3,1933,1936,3,No,0,2.63,7.41,4.78,203,384,181,478,1597,1119,188.0,0.0,-188.0,0.0,0.0,0.0
<a href=/player/clarw102>clarw102</a>,Walter Clarkson,New York Yankees,YANKS,1,2,1,3,1907,1907,0,No,0,-0.75,-1.19,-0.44,53,24,-29,88,22,-66,288.0,180.0,-108.0,0.0,0.0,0.0
<a href=/player/clase001>clase001</a>,Emmanuel Clase,San Diego Padres,PADRS,1,1,1,2,2018,2018,0,No,0,0.9,0.0,-0.9,22,0,-22,0,0,0,70.0,0.0,-70.0,0.0,0.0,0.0
<a href=/player/clase001>clase001</a>,Emmanuel Clase,Texas Rangers,RNGRS,1,2,2,4,2019,2020,1,No,0,2.79,0.06,-2.73,113,1,-112,120,0,-120,209.0,3.0,-206.0,1400000.0,0.0,-1400000.0
<a href=/player/clasg101>clasg101</a>,Gowell Claset,Philadelphia Athletics,ATLTCS,2,5,2,7,1933,1934,1,No,0,0.0,0.0,0.0,0,0,0,0,0,0,0.0,0.0,0.0,7600.0,0.0,-7600.0
<a href=/player/clasg101>clasg101</a>,Gowell Claset,Montreal,Montreal,1,1,1,2,1932,1933,1,No,0,-0.52,0.0,0.52,16,0,-16,5,0,-5,34.0,0.0,-34.0,0.0,0.0,0.0
<a href=/player/claua001>claua001</a>,Alex Claudio,Texas Rangers,RNGRS,1,1,1,2,2018,2018,0,No,0,0.7,0.0,-0.7,181,0,-181,0,0,0,243.0,0.0,-243.0,568450.0,0.0,-568450.0
<a href=/player/claub001>claub001</a>,Brandon Claussen,New York Yankees,YANKS,1,3,1,4,2003,2004,1,No,0,0.09,1.41,1.32,113,54,-59,110,209,99,929.0,0.0,-929.0,0.0,0.0,0.0
<a href=/player/clayd001>clayd001</a>,Danny Clay,Minnesota Twins,TWINS,1,2,2,4,1987,1987,0,No,0,-0.38,-0.91,-0.53,34,30,-4,3,0,-3,72.0,131.0,59.0,0.0,0.0,0.0
<a href=/player/clayd101>clayd101</a>,Dain Clay,St. Louis Cardinals,CARDS,1,3,2,5,1943,1946,3,No,0,7.07,3.43,-3.64,654,226,-428,2414,842,-1572,0.0,0.0,0.0,0.0,0.0,0.0
<a href=/player/clayd101>clayd101</a>,Dain Clay,Philadelphia Phillies,PHILS,1,1,1,2,1943,1946,3,No,0,3.39,-0.61,-4.0,433,49,-384,1699,175,-1524,0.0,0.0,0.0,0.0,0.0,0.0
<a href=/player/clayk101>clayk101</a>,Ken Clay,New York Yankees,YANKS,6,13,11,24,1980,1992,12,No,1,2.55,4.45,1.9,660,1293,633,1902,4072,2170,617.0,152.0,-465.0,400873.0,0.0,-400873.0
<a href=/player/clayk101>clayk101</a>,Ken Clay,Texas Rangers,RNGRS,4,10,10,20,1980,1987,7,No,0,9.35,8.94,-0.41,686,425,-261,1581,631,-950,2721.0,2684.0,-37.0,817500.0,0.0,-817500.0
<a href=/player/clayr001>clayr001</a>,Royce Clayton,San Francisco Giants,GIANTS,3,5,5,10,1995,2005,10,No,0,8.05,10.51,2.46,534,1493,959,1552,4581,3029,1216.0,932.0,-284.0,1340000.0,0.0,-1340000.0
<a href=/player/clayr001>clayr001</a>,Royce Clayton,St. Louis Cardinals,CARDS,6,9,11,20,1998,2004,6,No,1,9.85,14.81,4.96,1166,1148,-18,3977,1495,-2482,740.0,2465.0,1725.0,14483333.0,0.0,-14483333.0
<a href=/player/clayr001>clayr001</a>,Royce Clayton,Texas Rangers,RNGRS,4,8,9,17,2000,2007,7,No,0,55.21,8.97,-46.24,2508,350,-2158,9357,371,-8986,1660.0,2431.0,771.0,4500000.0,0.0,-4500000.0
<a href=/player/clayr001>clayr001</a>,Royce Clayton,Washington Nationals,NATEX,1,5,3,8,2006,2009,3,No,0,-0.61,0.43,1.04,705,795,90,181,2860,2679,809.0,139.0,-670.0,1352000.0,0.0,-1352000.0
<a href=/player/cleag001>cleag001</a>,Garrett Cleavinger,Baltimore Orioles,ORLS,1,3,1,4,2017,2017,0,No,0,-0.92,-0.85,0.07,41,10,-31,97,0,-97,2.0,155.0,153.0,4200000.0,0.0,-4200000.0
<a href=/player/cleag001>cleag001</a>,Garrett Cleavinger,Philadelphia Phillies,PHILS,1,1,1,2,2020,2020,0,Yes,0,0.14,0.0,-0.14,43,0,-43,3,0,-3,54.0,0.0,-54.0,0.0,0.0,0.0
<a href=/player/cleam001>cleam001</a>,Mark Clear,California Angels,ANGELS,2,4,3,7,1980,1986,6,No,0,8.12,4.18,-3.94,957,338,-619,2329,1304,-1025,1201.0,0.0,-1201.0,233333.0,0.0,-233333.0
<a href=/player/cleam001>cleam001</a>,Mark Clear,Boston Red Sox,RSOX,1,1,1,2,1985,1989,4,No,0,3.24,-3.59,-6.83,142,265,123,0,727,727,543.0,0.0,-543.0,580000.0,0.0,-580000.0
<a href=/player/clemd101>clemd101</a>,Doug Clemens,St. Louis Cardinals,CARDS,1,3,3,6,1964,1965,1,No,0,-0.83,5.23,6.06,340,107,-233,612,464,-148,674.0,9.0,-665.0,0.0,0.0,0.0
<a href=/player/clemd101>clemd101</a>,Doug Clemens,Chicago Cubs,CUBS,1,1,1,2,1966,1966,0,No,0,0.02,-0.19,-0.21,177,9,-168,288,12,-276,0.0,0.0,0.0,0.0,0.0,0.0
<a href=/player/cleme001>cleme001</a>,Edgard Clemente,Colorado Rockies,ROCKS,1,1,2,3,2000,2000,0,No,0,-0.95,0.0,0.95,46,0,-46,80,0,-80,0.0,0.0,0.0,0.0,0.0,0.0
<a href=/player/clemj001>clemj001</a>,Jeff Clement,Seattle Mariners,MARNRS,2,6,3,9,2009,2011,2,No,0,-0.04,2.82,2.86,447,179,-268,1426,514,-912,0.0,332.0,332.0,5822500.0,0.0,-5822500.0
<a href=/player/clemj101>clemj101</a>,Jack Clements,Philadelphia Phillies,PHILS,1,5,3,8,1897,1902,5,No,0,9.88,14.87,4.99,647,845,198,2475,2785,310,1192.0,3296.0,2104.0,0.0,0.0,0.0
<a href=/player/clemj101>clemj101</a>,Jack Clements,Boston Braves,BRAVES,1,1,1,2,1901,1903,2,No,0,0.0,3.14,3.14,0,226,226,0,830,830,0.0,0.0,0.0,0.0,0.0,0.0
<a href=/player/cleml101>cleml101</a>,Lance Clemons,Kansas City Royals,ROYALS,1,2,2,4,1971,1978,7,No,0,-0.79,21.38,22.17,228,897,669,24,3753,3729,523.0,0.0,-523.0,25250.0,0.0,-25250.0
<a href=/player/cleml101>cleml101</a>,Lance Clemons,Houston Astros,ASTROS,8,14,11,25,1972,1989,17,No,0,22.94,18.16,-4.78,1829,2074,245,3832,5559,1727,6887.0,3273.0,-3614.0,22500.0,0.0,-22500.0
<a href=/player/cleml101>cleml101</a>,Lance Clemons,St. Louis Cardinals,CARDS,2,3,2,5,1973,1974,1,No,0,-0.31,-0.3,0.01,31,60,29,0,20,20,206.0,249.0,43.0,0.0,0.0,0.0
<a href=/player/clemm001>clemm001</a>,Matt Clement,San Diego Padres,PADRS,7,14,12,26,2001,2010,9,No,2,6.07,13.68,7.61,986,984,-2,3612,3250,-362,532.0,273.0,-259.0,12382300.0,0.0,-12382300.0
<a href=/player/clemm001>clemm001</a>,Matt Clement,Florida Marlins,MARLNS,7,9,16,25,2002,2013,11,No,0,71.73,23.4,-48.33,3136,1557,-1579,9615,1244,-8371,3483.0,5887.0,2404.0,18420219.0,0.0,-18420219.0
<a href=/player/clemp001>clemp001</a>,Pat Clements,California Angels,ANGELS,3,5,7,12,1985,1988,3,No,2,1.4,3.61,2.21,825,316,-509,630,678,48,1883.0,911.0,-972.0,800000.0,0.0,-800000.0
<a href=/player/clemp001>clemp001</a>,Pat Clements,Pittsburgh Pirates,PIRATS,3,5,6,11,1986,2001,15,No,2,5.63,20.71,15.08,232,836,604,93,1605,1512,1758.0,5213.0,3455.0,1290000.0,0.0,-1290000.0
<a href=/player/clemp001>clemp001</a>,Pat Clements,New York Yankees,YANKS,7,13,9,22,1988,2001,13,No,1,33.33,15.51,-17.82,1697,1345,-352,5213,4000,-1213,3631.0,1622.0,-2009.0,2990000.0,0.0,-2990000.0
<a href=/player/clemp002>clemp002</a>,Paul Clemens,Atlanta Braves,BRAVES,2,5,3,8,2011,2019,8,No,1,1.07,6.63,5.56,249,230,-19,481,952,471,1075.0,36.0,-1039.0,0.0,0.0,0.0
<a href=/player/clemr001>clemr001</a>,Roger Clemens,Toronto Blue Jays,BJAYS,4,5,10,15,1999,2014,15,No,2,22.46,13.09,-9.37,202,706,504,20,1367,1347,3611.0,3125.0,-486.0,0.0,0.0,0.0
<a href=/player/clend101>clend101</a>,Donn Clendenon,Montreal Expos,NATEX,6,9,10,19,1969,1985,16,No,0,41.28,49.25,7.97,3185,3689,504,11568,12567,999,812.0,1543.0,731.0,243500.0,0.0,-243500.0
<a href=/player/clend101>clend101</a>,Donn Clendenon,Montreal Expos,NATEX,3,4,7,11,1969,1978,9,No,0,23.27,10.87,-12.4,2164,691,-1473,7829,895,-6934,648.0,4635.0,3987.0,50000.0,0.0,-50000.0
<a href=/player/cletm001>cletm001</a>,Maikel Cleto,New York Mets,METS,1,7,3,10,2008,2010,2,No,0,8.89,-1.25,-10.14,554,358,-196,1346,179,-1167,2162.0,325.0,-1837.0,3398000.0,0.0,-3398000.0
<a href=/player/cletm001>cletm001</a>,Maikel Cleto,Seattle Mariners,MARNRS,2,2,2,4,2010,2013,3,No,0,-1.07,7.49,8.56,140,351,211,292,1251,959,53.0,0.0,-53.0,3250000.0,0.0,-3250000.0
<a href=/player/cleve101>cleve101</a>,Elmer Cleveland,New York Giants,GIANTS,1,1,1,2,1888,1891,3,No,0,0.2,0.62,0.42,30,220,190,115,868,753,0.0,13.0,13.0,0.0,0.0,0.0
<a href=/player/clevm001>clevm001</a>,Mike Clevinger,Anaheim Angels,ANGELS,1,1,1,2,2014,2015,1,No,0,12.66,0.12,-12.54,107,32,-75,11,0,-11,1570.0,64.0,-1506.0,0.0,0.0,0.0
<a href=/player/clevm001>clevm001</a>,Mike Clevinger,Cleveland Indians,INDINS,1,3,6,9,2020,2020,0,Yes,0,0.62,-0.12,-0.74,5,36,31,4,78,74,57.0,44.0,-13.0,4100000.0,0.0,-4100000.0
<a href=/player/clevr101>clevr101</a>,Reggie Cleveland,St. Louis Cardinals,CARDS,27,55,49,104,1973,1998,25,No,8,106.47,182.0,75.53,10190,9338,-852,28502,29048,546,13842.0,9162.0,-4680.0,3130333.0,0.0,-3130333.0
<a href=/player/clevr101>clevr101</a>,Reggie Cleveland,Texas Rangers,RNGRS,4,6,8,14,1978,1979,1,No,0,5.31,0.81,-4.5,504,142,-362,304,339,35,2224.0,99.0,-2125.0,70000.0,0.0,-70000.0
<a href=/player/clevs001>clevs001</a>,Steve Clevenger,Chicago Cubs,CUBS,1,2,3,5,2013,2019,6,No,0,0.8,28.4,27.6,86,1050,964,220,287,67,272.0,3528.0,3256.0,0.0,0.0,0.0
<a href=/player/clevs001>clevs001</a>,Steve Clevenger,Baltimore Orioles,ORLS,1,1,2,3,2015,2019,4,No,0,-0.01,1.72,1.73,22,407,385,76,1659,1583,0.0,0.0,0.0,514000.0,0.0,-514000.0
<a href=/player/clevt101>clevt101</a>,Tex Clevenger,Boston Red Sox,RSOX,2,7,5,12,1955,1963,8,No,0,0.69,2.88,2.19,731,424,-307,812,1170,358,1712.0,707.0,-1005.0,7000.0,0.0,-7000.0
<a href=/player/clevt101>clevt101</a>,Tex Clevenger,Los Angeles Angels,ANGELS,2,3,4,7,1961,1965,4,No,0,3.26,2.99,-0.27,414,909,495,1204,2598,1394,209.0,725.0,516.0,0.0,0.0,0.0
<a href=/player/clibs101>clibs101</a>,Stan Cliburn,California Angels,ANGELS,1,1,1,2,1987,1988,1,No,0,0.0,-0.02,-0.02,0,1,1,0,2,2,0.0,0.0,0.0,0.0,0.0,0.0
<a href=/player/cliff101>cliff101</a>,Flea Clifton,Philadelphia Athletics,ATLTCS,1,1,1,2,1940,1949,9,No,0,0.0,0.0,0.0,0,0,0,0,0,0,0.0,0.0,0.0,0.0,0.0,0.0
<a href=/player/clifh101>clifh101</a>,Harlond Clift,St.Louis Browns,ORLS,1,2,3,5,1943,1943,0,No,0,8.73,-0.17,-8.9,267,27,-240,710,82,-628,1415.0,18.0,-1397.0,19000.0,0.0,-19000.0
<a href=/player/clinb101>clinb101</a>,Billy Clingman,Pittsburgh Pirates,PIRATS,1,1,2,3,1896,1899,3,No,0,5.69,-0.17,-5.86,500,17,-483,1976,58,-1918,0.0,0.0,0.0,0.0,0.0,0.0
<a href=/player/clinb101>clinb101</a>,Billy Clingman,Cleveland Indians,INDINS,1,2,1,3,1903,1919,16,No,0,0.0,38.48,38.48,0,1619,1619,0,6493,6493,0.0,0.0,0.0,0.0,0.0,0.0
<a href=/player/cling101>cling101</a>,Gene Clines,Pittsburgh Pirates,PIRATS,6,6,7,13,1974,1996,22,No,3,5.47,25.6,20.13,430,1427,997,942,5061,4119,1290.0,1438.0,148.0,2175000.0,0.0,-2175000.0
<a href=/player/cling101>cling101</a>,Gene Clines,New York Mets,METS,1,1,1,2,1975,1976,1,No,0,0.59,0.0,-0.59,116,0,-116,480,0,-480,0.0,0.0,0.0,0.0,0.0,0.0
<a href=/player/cling101>cling101</a>,Gene Clines,Texas Rangers,RNGRS,1,2,1,3,1977,1977,0,No,0,-0.19,0.49,0.68,220,42,-178,533,0,-533,0.0,151.0,151.0,0.0,0.0,0.0
<a href=/player/clinl101>clinl101</a>,Lou Clinton,Boston Red Sox,RSOX,2,4,3,7,1964,1968,4,No,0,0.42,3.78,3.36,367,414,47,747,1060,313,353.0,393.0,40.0,12500.0,0.0,-12500.0
<a href=/player/clinl101>clinl101</a>,Lou Clinton,Cleveland Indians,INDINS,3,5,5,10,1966,1969,3,No,0,1.75,2.6,0.85,303,267,-36,886,761,-125,0.0,0.0,0.0,0.0,0.0,0.0
<a href=/player/clint101>clint101</a>,Ty Cline,Cleveland Indians,INDINS,10,19,17,36,1962,1978,16,No,0,30.29,13.22,-17.07,2722,1767,-955,6203,6060,-143,3067.0,1183.0,-1884.0,115500.0,0.0,-115500.0
<a href=/player/clint101>clint101</a>,Ty Cline,Montreal Expos,NATEX,1,1,1,2,1970,1970,0,No,0,0.77,-0.42,-1.19,117,13,-104,196,29,-167,0.0,0.0,0.0,0.0,0.0,0.0
<a href=/player/clipt001>clipt001</a>,Tyler Clippard,New York Yankees,YANKS,1,1,1,2,2007,2010,3,No,0,10.01,0.23,-9.78,808,50,-758,14,0,-14,1392.0,178.0,-1214.0,0.0,0.0,0.0
<a href=/player/clipt001>clipt001</a>,Tyler Clippard,Washington Nationals,NATEX,2,3,3,6,2015,2019,4,No,0,2.49,1.58,-0.91,259,205,-54,948,591,-357,116.0,84.0,-32.0,5000000.0,0.0,-5000000.0
<a href=/player/clipt001>clipt001</a>,Tyler Clippard,Oakland Athletics,ATLTCS,2,3,2,5,2015,2018,3,No,0,0.29,-0.21,-0.5,61,9,-52,1,0,-1,97.0,43.0,-54.0,8300001.0,0.0,-8300001.0
<a href=/player/clipt001>clipt001</a>,Tyler Clippard,Arizona Diamondbacks,DBACKS,1,1,1,2,2016,2016,0,No,0,0.41,0.07,-0.34,75,2,-73,0,2,2,185.0,17.0,-168.0,0.0,0.0,0.0
<a href=/player/clipt001>clipt001</a>,Tyler Clippard,New York Yankees,YANKS,1,4,3,7,2017,2020,3,No,0,0.5,4.41,3.91,12,310,298,0,241,241,30.0,651.0,621.0,6150000.0,0.0,-6150000.0
<a href=/player/clipt001>clipt001</a>,Tyler Clippard,Chicago White Sox,WSOX,1,1,1,2,2017,2017,0,No,0,-0.25,0.0,0.25,17,0,-17,0,0,0,42.0,0.0,-42.0,0.0,0.0,0.0
<a href=/player/clonb001>clonb001</a>,Brad Clontz,Los Angeles Dodgers,DOGRS,4,7,7,14,1998,2010,12,No,1,0.28,3.05,2.77,258,110,-148,43,85,42,1690.0,777.0,-913.0,9633334.0,0.0,-9633334.0
<a href=/player/clonb001>clonb001</a>,Brad Clontz,Pittsburgh Pirates,PIRATS,1,1,1,2,1999,1999,0,No,0,0.0,0.0,0.0,0,0,0,0,0,0,0.0,0.0,0.0,350000.0,0.0,-350000.0
<a href=/player/clont101>clont101</a>,Tony Cloninger,Atlanta Braves,BRAVES,3,5,5,10,1968,1970,2,No,0,13.88,3.02,-10.86,1605,185,-1420,1388,304,-1084,4147.0,923.0,-3224.0,0.0,0.0,0.0
<a href=/player/clont101>clont101</a>,Tony Cloninger,Cincinnati Reds,REDS,1,1,1,2,1972,1972,0,No,0,-0.47,-0.17,0.3,34,44,10,3,100,97,78.0,0.0,-78.0,0.0,0.0,0.0
<a href=/player/closa101>closa101</a>,Al Closter,New York Yankees,YANKS,6,12,9,21,1973,1983,10,No,0,29.7,21.37,-8.33,2028,936,-1092,2549,2957,408,5698.0,1893.0,-3805.0,79000.0,0.0,-79000.0
<a href=/player/closj001>closj001</a>,JD Closser,Arizona Diamondbacks,DBACKS,1,2,1,3,2002,2003,1,No,0,-0.71,0.78,1.49,195,258,63,586,0,-586,0.0,220.0,220.0,0.0,0.0,0.0
<a href=/player/closj001>closj001</a>,JD Closser,Milwaukee Brewers,BREWRS,1,1,1,2,2007,2007,0,No,0,0.0,0.0,0.0,0,0,0,0,0,0,0.0,0.0,0.0,0.0,0.0,0.0
<a href=/player/clybd001>clybd001</a>,Danny Clyburn,Pittsburgh Pirates,PIRATS,2,2,2,4,1994,1996,2,No,0,0.55,-0.15,-0.7,210,145,-65,726,531,-195,0.0,0.0,0.0,350000.0,0.0,-350000.0
<a href=/player/clybd001>clybd001</a>,Danny Clyburn,Cincinnati Reds,REDS,1,2,1,3,1995,1995,0,No,0,-0.16,-0.17,-0.01,13,12,-1,29,2,-27,0.0,29.0,29.0,0.0,0.0,0.0
<a href=/player/clybd001>clybd001</a>,Danny Clyburn,Baltimore Orioles,ORLS,1,2,1,3,1999,2003,4,No,0,-0.26,4.13,4.39,28,143,115,89,20,-69,0.0,2220.0,2220.0,0.0,0.0,0.0
<a href=/player/clydd101>clydd101</a>,David Clyde,Texas Rangers,RNGRS,1,2,2,4,1978,1978,0,No,0,0.81,0.78,-0.03,88,77,-11,186,217,31,597.0,0.0,-597.0,0.0,0.0,0.0
<a href=/player/clydd101>clydd101</a>,David Clyde,Cleveland Indians,INDINS,1,2,3,5,1980,1980,0,No,0,-1.43,-0.55,0.88,119,28,-91,205,57,-148,0.0,0.0,0.0,0.0,0.0,0.0
<a href=/player/clymo101>clymo101</a>,Otis Clymer,Philadelphia Phillies,PHILS,1,2,3,5,1905,1911,6,No,0,1.77,5.1,3.33,253,872,619,1002,3354,2352,15.0,0.0,-15.0,0.0,0.0,0.0
<a href=/player/coang101>coang101</a>,Gil Coan,Washington Senators,TWINS,5,10,10,20,1954,1971,17,No,0,31.61,55.11,23.5,1852,3047,1195,6210,9678,3468,873.0,2844.0,1971.0,153000.0,0.0,-153000.0
<a href=/player/coang101>coang101</a>,Gil Coan,Chicago White Sox,WSOX,1,1,1,2,1955,1957,2,No,0,-0.19,0.73,0.92,13,107,94,14,116,102,0.0,0.0,0.0,0.0,0.0,0.0
<a href=/player/coatb001>coatb001</a>,Buck Coats,Chicago Cubs,CUBS,1,1,1,2,2007,2013,6,No,0,-0.15,-0.08,0.07,20,88,68,38,4,-34,0.0,134.0,134.0,0.0,0.0,0.0
<a href=/player/coatb001>coatb001</a>,Buck Coats,Cincinnati Reds,REDS,1,1,1,2,2007,2009,2,No,0,0.07,0.0,-0.07,8,0,-8,6,0,-6,0.0,0.0,0.0,0.0,0.0,0.0
<a href=/player/coatj101>coatj101</a>,Jim Coates,New York Yankees,YANKS,1,1,1,2,1963,1970,7,No,0,-0.87,9.42,10.29,40,624,584,6,95,89,133.0,1458.0,1325.0,0.0,0.0,0.0
<a href=/player/coatj101>coatj101</a>,Jim Coates,Washington Senators,RNGRS,1,1,1,2,1963,1966,3,No,0,-0.18,2.2,2.38,18,409,391,3,1505,1502,49.0,0.0,-49.0,0.0,0.0,0.0
<a href=/player/coatj101>coatj101</a>,Jim Coates,Cincinnati Reds,REDS,1,2,1,3,1965,1966,1,No,0,-0.16,-0.48,-0.32,102,22,-80,15,2,-13,336.0,52.0,-284.0,0.0,0.0,0.0
<a href=/player/cobba001>cobba001</a>,Alex Cobb,Baltimore Orioles,ORLS,1,2,1,3,2021,2021,0,Yes,0,1.73,-0.62,-2.35,19,26,7,1,72,71,280.0,0.0,-280.0,0.0,0.0,0.0
<a href=/player/cochd001>cochd001</a>,Dave Cochrane,New York Mets,METS,1,1,1,2,1985,1985,0,No,0,-0.38,-0.01,0.37,19,46,27,68,124,56,0.0,0.0,0.0,0.0,0.0,0.0
<a href=/player/cochd001>cochd001</a>,Dave Cochrane,Chicago White Sox,WSOX,4,7,7,14,1987,1994,7,No,0,14.45,7.51,-6.94,385,504,119,1,759,758,4103.0,4503.0,400.0,930000.0,0.0,-930000.0
<a href=/player/cochd001>cochd001</a>,Dave Cochrane,Kansas City Royals,ROYALS,1,1,1,2,1988,1988,0,No,0,-1.02,0.0,1.02,199,0,-199,494,0,-494,0.0,0.0,0.0,0.0,0.0,0.0
<a href=/player/cochm101>cochm101</a>,Mickey Cochrane,Portland,Portland,1,1,6,7,1924,1925,1,No,0,37.87,0.0,-37.87,1167,0,-1167,4861,0,-4861,0.0,0.0,0.0,0.0,0.0,0.0
<a href=/player/cochm101>cochm101</a>,Mickey Cochrane,Philadelphia Athletics,ATLTCS,2,3,4,7,1933,1935,2,No,0,15.67,0.35,-15.32,391,161,-230,1453,502,-951,735.0,0.0,-735.0,26167.0,0.0,-26167.0
<a href=/player/cocka001>cocka001</a>,Alan Cockrell,San Francisco Giants,GIANTS,1,1,1,2,1988,1988,0,No,0,0.0,0.0,0.0,0,0,0,0,0,0,0.0,0.0,0.0,0.0,0.0,0.0
<a href=/player/cocka001>cocka001</a>,Alan Cockrell,Minnesota Twins,TWINS,1,1,1,2,1990,1990,0,No,0,0.0,0.0,0.0,0,0,0,0,0,0,0.0,0.0,0.0,0.0,0.0,0.0
<a href=/player/coelr001>coelr001</a>,Robert Coello,Boston Red Sox,RSOX,1,1,1,2,2011,2011,0,No,0,0.0,0.0,0.0,0,0,0,0,0,0,0.0,0.0,0.0,0.0,0.0,0.0
<a href=/player/coffd101>coffd101</a>,Dick Coffman,Washington Senators,TWINS,6,16,10,26,1927,1941,14,No,0,54.71,66.87,12.16,4079,2617,-1462,12814,9775,-3039,8820.0,3821.0,-4999.0,91600.0,0.0,-91600.0
<a href=/player/coffd101>coffd101</a>,Dick Coffman,St.Louis Browns,ORLS,2,2,2,4,1932,1935,3,No,0,0.49,2.6,2.11,102,270,168,68,199,131,594.0,1667.0,1073.0,4500.0,0.0,-4500.0
<a href=/player/coffd101>coffd101</a>,Dick Coffman,Washington Senators,TWINS,3,4,3,7,1932,1937,5,No,0,8.57,12.76,4.19,616,294,-322,554,447,-107,4404.0,3142.0,-1262.0,6500.0,0.0,-6500.0
<a href=/player/coffk001>coffk001</a>,Kevin Coffman,Atlanta Braves,BRAVES,1,2,1,3,1988,1990,2,No,0,-1.22,-1.32,-0.1,28,92,64,13,296,283,123.0,0.0,-123.0,65000.0,0.0,-65000.0
<a href=/player/coffs101>coffs101</a>,Slick Coffman,Detroit Tigers,TIGRS,1,1,1,2,1940,1942,2,No,0,-0.71,2.31,3.02,63,163,100,18,525,507,224.0,0.0,-224.0,0.0,0.0,0.0
<a href=/player/coggf101>coggf101</a>,Frank Coggins,Washington Senators,RNGRS,1,1,1,2,1969,1969,0,No,0,0.0,0.0,0.0,0,0,0,0,0,0,0.0,0.0,0.0,0.0,0.0,0.0
<a href=/player/coggf101>coggf101</a>,Frank Coggins,Milwaukee Brewers,BREWRS,1,3,2,5,1970,1971,1,No,0,1.89,-2.52,-4.41,337,186,-151,1153,421,-732,0.0,0.0,0.0,0.0,0.0,0.0
<a href=/player/coggr101>coggr101</a>,Rich Coggins,Baltimore Orioles,ORLS,12,27,24,51,1974,1994,20,No,3,56.05,125.48,69.43,2623,5978,3355,5494,17245,11751,12340.0,14796.0,2456.0,860333.0,0.0,-860333.0
<a href=/player/coggr101>coggr101</a>,Rich Coggins,New York Yankees,YANKS,1,2,1,3,1976,1977,1,No,0,4.11,0.35,-3.76,80,152,72,116,536,420,850.0,0.0,-850.0,0.0,0.0,0.0
<a href=/player/coggr101>coggr101</a>,Rich Coggins,Chicago White Sox,WSOX,2,2,2,4,1976,1982,6,No,0,-1.26,0.67,1.93,72,526,454,197,1539,1342,0.0,6.0,6.0,0.0,0.0,0.0
<a href=/player/coghc001>coghc001</a>,Chris Coghlan,Chicago Cubs,CUBS,1,1,1,2,2016,2017,1,No,0,-1.21,0.0,1.21,51,0,-51,172,0,-172,0.0,0.0,0.0,4800000.0,0.0,-4800000.0
<a href=/player/coghc001>coghc001</a>,Chris Coghlan,Oakland Athletics,ATLTCS,1,1,1,2,2016,2016,0,No,0,0.6,-0.34,-0.94,48,16,-32,128,19,-109,0.0,0.0,0.0,0.0,0.0,0.0
<a href=/player/cokej101>cokej101</a>,Jimmie Coker,Baltimore Orioles,ORLS,17,34,32,66,1962,1994,32,No,3,53.81,109.37,55.56,3570,5799,2229,7519,12936,5417,13760.0,16382.0,2622.0,880833.0,0.0,-880833.0
<a href=/player/cokej101>cokej101</a>,Jimmie Coker,San Francisco Giants,GIANTS,1,1,1,2,1963,1964,1,No,0,0.0,-0.21,-0.21,0,20,20,0,0,0,0.0,27.0,27.0,0.0,0.0,0.0
<a href=/player/cokej101>cokej101</a>,Jimmie Coker,St. Louis Cardinals,CARDS,12,25,20,45,1964,1972,8,No,0,30.8,2.13,-28.67,3297,763,-2534,8519,1730,-6789,1865.0,703.0,-1162.0,32500.0,0.0,-32500.0
<a href=/player/cokep001>cokep001</a>,Phil Coke,New York Yankees,YANKS,1,3,1,4,2009,2013,4,No,0,21.17,14.94,-6.23,983,513,-470,2996,2148,-848,971.0,0.0,-971.0,812225.0,0.0,-812225.0
<a href=/player/colar101>colar101</a>,Rocky Colavito,Cleveland Indians,INDINS,3,3,5,8,1960,1964,4,No,0,21.16,4.21,-16.95,1210,620,-590,4904,2233,-2671,0.0,144.0,144.0,40000.0,0.0,-40000.0
<a href=/player/colar101>colar101</a>,Rocky Colavito,Detroit Tigers,TIGRS,4,6,6,12,1963,1972,9,No,0,7.82,5.86,-1.96,636,1217,581,727,2715,1988,1071.0,2815.0,1744.0,103000.0,0.0,-103000.0
<a href=/player/colar101>colar101</a>,Rocky Colavito,Kansas City Athletics,ATLTCS,14,30,24,54,1965,1976,11,No,0,49.39,42.65,-6.74,5788,4015,-1773,12719,12980,261,7766.0,2197.0,-5569.0,387100.0,0.0,-387100.0
<a href=/player/colar101>colar101</a>,Rocky Colavito,Cleveland Indians,INDINS,1,1,2,3,1967,1968,1,No,0,0.06,-0.19,-0.25,60,19,-41,220,22,-198,0.0,0.0,0.0,0.0,0.0,0.0
<a href=/player/colbg001>colbg001</a>,Greg Colbrunn,Minnesota Twins,TWINS,1,1,1,2,1997,1997,0,No,0,0.19,0.0,-0.19,56,0,-56,107,0,-107,0.0,0.0,0.0,750000.0,0.0,-750000.0
<a href=/player/colbg001>colbg001</a>,Greg Colbrunn,Colorado Rockies,ROCKS,2,2,3,5,1998,2000,2,No,0,0.16,-0.01,-0.17,36,31,-5,49,0,-49,11.0,44.0,33.0,735000.0,0.0,-735000.0
<a href=/player/colbg001>colbg001</a>,Greg Colbrunn,Seattle Mariners,MARNRS,1,2,1,3,2003,2004,1,No,0,-0.58,-0.37,0.21,20,19,-1,28,23,-5,0.0,0.0,0.0,750000.0,0.0,-750000.0
<a href=/player/colbj101>colbj101</a>,Jim Colborn,Chicago Cubs,CUBS,2,4,2,6,1971,1977,6,No,0,12.52,9.33,-3.19,493,821,328,508,3274,2766,3595.0,0.0,-3595.0,150000.0,0.0,-150000.0
<a href=/player/colbj101>colbj101</a>,Jim Colborn,Milwaukee Brewers,BREWRS,3,4,6,10,1976,1986,10,No,0,23.16,4.69,-18.47,1350,684,-666,3618,973,-2645,1204.0,2526.0,1322.0,487500.0,0.0,-487500.0
<a href=/player/colbj101>colbj101</a>,Jim Colborn,Kansas City Royals,ROYALS,1,1,1,2,1978,1980,2,No,0,-0.62,0.35,0.97,20,136,116,0,331,331,343.0,0.0,-343.0,0.0,0.0,0.0
<a href=/player/colbm101>colbm101</a>,Mike Colbern,Chicago White Sox,WSOX,3,4,4,8,1981,1987,6,No,0,4.43,7.04,2.61,422,580,158,1527,1402,-125,154.0,667.0,513.0,0.0,0.0,0.0
<a href=/player/colbn101>colbn101</a>,Nate Colbert,San Diego Padres,PADRS,4,5,8,13,1974,1977,3,No,0,-1.08,2.59,3.67,91,579,488,259,1031,772,183.0,1079.0,896.0,80000.0,0.0,-80000.0
<a href=/player/colbv101>colbv101</a>,Vince Colbert,Cleveland Indians,INDINS,1,1,1,2,1972,1972,0,No,0,0.0,0.0,0.0,0,0,0,0,0,0,0.0,0.0,0.0,0.0,0.0,0.0
<a href=/player/colbv101>colbv101</a>,Vince Colbert,Texas Rangers,RNGRS,1,2,1,3,1973,1974,1,No,0,0.0,1.79,1.79,0,272,272,0,1149,1149,0.0,0.0,0.0,0.0,0.0,0.0
<a href=/player/colea001>colea001</a>,Alex Cole,St. Louis Cardinals,CARDS,1,2,1,3,1990,1995,5,No,0,0.0,4.64,4.64,0,288,288,0,209,209,0.0,1818.0,1818.0,0.0,0.0,0.0
<a href=/player/colea001>colea001</a>,Alex Cole,San Diego Padres,PADRS,1,1,1,2,1990,1993,3,No,0,2.56,0.15,-2.41,226,73,-153,817,152,-665,0.0,0.0,0.0,0.0,0.0,0.0
<a href=/player/colea001>colea001</a>,Alex Cole,Cleveland Indians,INDINS,2,3,3,6,1992,1995,3,No,0,2.04,0.0,-2.04,211,0,-211,684,0,-684,0.0,0.0,0.0,162500.0,0.0,-162500.0
<a href=/player/colea002>colea002</a>,A.J. Cole,Washington Nationals,NATEX,2,6,4,10,2011,2018,7,Yes,0,12.32,19.68,7.36,414,407,-7,1035,430,-605,1666.0,3760.0,2094.0,12000000.0,0.0,-12000000.0
<a href=/player/colea002>colea002</a>,A.J. Cole,Oakland Athletics,ATLTCS,8,15,10,25,2013,2018,5,Yes,0,10.44,2.58,-7.86,1089,362,-727,2080,1057,-1023,1184.0,312.0,-872.0,8300001.0,0.0,-8300001.0
<a href=/player/coleb101>coleb101</a>,Bert Cole,SanFrancisco,SanFrancisco,1,1,1,2,1920,1920,0,No,0,0.72,0.0,-0.72,299,0,-299,192,0,-192,1487.0,0.0,-1487.0,0.0,0.0,0.0
<a href=/player/coleb101>coleb101</a>,Bert Cole,Chicago White Sox,WSOX,5,17,8,25,1927,1936,9,No,0,4.13,-0.01,-4.14,711,811,100,2521,3083,562,0.0,39.0,39.0,40200.0,0.0,-40200.0
<a href=/player/coleb102>coleb102</a>,Bob Coleman,Columbus,Columbus,1,1,1,2,1916,1916,0,No,0,0.21,0.0,-0.21,19,0,-19,36,0,-36,0.0,0.0,0.0,0.0,0.0,0.0
<a href=/player/colec102>colec102</a>,Chris Coletta,Boston Red Sox,RSOX,2,3,2,5,1972,1973,1,No,0,0.48,0.42,-0.06,203,17,-186,340,50,-290,0.0,0.0,0.0,0.0,0.0,0.0
<a href=/player/colec102>colec102</a>,Chris Coletta,California Angels,ANGELS,2,4,3,7,1973,1976,3,No,0,2.26,3.34,1.08,402,155,-247,1412,564,-848,0.0,0.0,0.0,38500.0,0.0,-38500.0
<a href=/player/coled001>coled001</a>,Darnell Coles,Seattle Mariners,MARNRS,1,1,1,2,1985,1988,3,No,0,0.21,-0.01,-0.22,247,3,-244,878,0,-878,0.0,21.0,21.0,0.0,0.0,0.0
<a href=/player/coled001>coled001</a>,Darnell Coles,Detroit Tigers,TIGRS,1,2,1,3,1987,1988,1,No,0,0.01,-0.36,-0.37,138,58,-80,389,196,-193,59.0,0.0,-59.0,170000.0,0.0,-170000.0
<a href=/player/coled001>coled001</a>,Darnell Coles,Pittsburgh Pirates,PIRATS,4,4,5,9,1988,1993,5,No,0,1.39,3.45,2.06,719,180,-539,2572,594,-1978,0.0,18.0,18.0,1125000.0,0.0,-1125000.0
<a href=/player/coled001>coled001</a>,Darnell Coles,Seattle Mariners,MARNRS,1,1,1,2,1990,1991,1,No,0,-0.86,0.55,1.41,52,104,52,122,289,167,0.0,0.0,0.0,690000.0,0.0,-690000.0
<a href=/player/coled003>coled003</a>,Dylan Coleman,San Diego Padres,PADRS,1,2,1,3,2020,2021,1,Yes,0,0.01,0.64,0.63,62,10,-52,176,0,-176,19.0,30.0,11.0,0.0,0.0,0.0
<a href=/player/coled101>coled101</a>,Dick Cole,St. Louis Cardinals,CARDS,3,10,5,15,1951,1954,3,No,0,10.75,2.71,-8.04,1144,382,-762,2713,1234,-1479,1601.0,388.0,-1213.0,41500.0,0.0,-41500.0
<a href=/player/coled101>coled101</a>,Dick Cole,Pittsburgh Pirates,PIRATS,10,17,19,36,1957,1973,16,No,0,-1.46,37.76,39.22,579,1672,1093,1223,4937,3714,386.0,2327.0,1941.0,17500.0,0.0,-17500.0
<a href=/player/coled102>coled102</a>,Dave Coleman,Boston Red Sox,RSOX,1,1,1,2,1979,1979,0,No,0,0.0,0.53,0.53,0,47,47,0,100,100,0.0,0.0,0.0,0.0,0.0,0.0
<a href=/player/coled103>coled103</a>,Dave Cole,Milwaukee Braves,BRAVES,1,2,1,3,1954,1955,1,No,0,-0.23,-0.06,0.17,37,25,-12,31,42,11,252.0,0.0,-252.0,0.0,0.0,0.0
<a href=/player/coled103>coled103</a>,Dave Cole,Philadelphia Phillies,PHILS,3,10,5,15,1955,1962,7,No,0,1.07,-1.95,-3.02,707,737,30,1985,2099,114,115.0,415.0,300.0,9000.0,0.0,-9000.0
<a href=/player/colee101>colee101</a>,Ed Cole,Cleveland Indians,INDINS,1,3,1,4,1938,1941,3,No,0,1.14,1.94,0.8,388,390,2,935,1415,480,285.0,0.0,-285.0,0.0,0.0,0.0
<a href=/player/colee102>colee102</a>,Ed Coleman,Philadelphia Athletics,ATLTCS,1,2,1,3,1935,1936,1,No,0,2.31,1.97,-0.34,270,46,-224,676,55,-621,552.0,447.0,-105.0,9500.0,0.0,-9500.0
<a href=/player/colee102>colee102</a>,Ed Coleman,St.Louis Browns,ORLS,2,3,2,5,1937,1938,1,No,0,0.0,0.03,0.03,0,126,126,0,533,533,0.0,46.0,46.0,4500.0,0.0,-4500.0
<a href=/player/colee102>colee102</a>,Ed Coleman,Portland,Portland,1,2,2,4,1931,1931,0,No,0,1.71,0.0,-1.71,253,0,-253,858,0,-858,33.0,0.0,-33.0,0.0,0.0,0.0
<a href=/player/coleg001>coleg001</a>,Gerrit Cole,Pittsburgh Pirates,PIRATS,2,2,9,11,2018,2021,3,Yes,0,15.58,5.92,-9.66,139,632,493,73,615,542,1782.0,1498.0,-284.0,0.0,0.0,0.0
<a href=/player/coleg101>coleg101</a>,Gordy Coleman,Cleveland Indians,INDINS,3,5,5,10,1959,1965,6,No,0,6.43,1.26,-5.17,1198,354,-844,3637,1453,-2184,454.0,0.0,-454.0,7500.0,0.0,-7500.0
<a href=/player/colej101>colej101</a>,Joe Coleman,Philadelphia Athletics,ATLTCS,1,2,1,3,1953,1954,1,No,0,1.98,0.0,-1.98,78,0,-78,84,0,-84,699.0,0.0,-699.0,7500.0,0.0,-7500.0
<a href=/player/colej102>colej102</a>,Joe Coleman,Washington Senators,RNGRS,6,10,11,21,1970,1976,6,No,0,30.0,-0.41,-30.41,2790,834,-1956,8622,1724,-6898,5481.0,1612.0,-3869.0,75900.0,0.0,-75900.0
<a href=/player/colej102>colej102</a>,Joe Coleman,Chicago Cubs,CUBS,4,5,5,10,1977,1979,2,No,0,7.62,-0.47,-8.09,937,193,-744,2458,302,-2156,1259.0,200.0,-1059.0,0.0,0.0,0.0
<a href=/player/colek101>colek101</a>,King Cole,Chicago Cubs,CUBS,1,2,2,4,1912,1915,3,No,0,-1.23,9.99,11.22,69,392,323,172,1573,1401,147.0,212.0,65.0,7400.0,0.0,-7400.0
<a href=/player/colem001>colem001</a>,Michael Coleman,Boston Red Sox,RSOX,1,2,1,3,2000,2001,1,No,0,-0.55,1.15,1.7,39,96,57,95,386,291,0.0,0.0,0.0,0.0,0.0,0.0
<a href=/player/colem001>colem001</a>,Michael Coleman,Cincinnati Reds,REDS,2,3,3,6,2001,2013,12,No,0,-0.92,19.24,20.16,177,833,656,524,1510,986,0.0,5071.0,5071.0,0.0,0.0,0.0
<a href=/player/coler101>coler101</a>,Rip Coleman,New York Yankees,YANKS,6,15,13,28,1957,1970,13,No,0,5.72,32.98,27.26,1633,2423,790,4235,5558,1323,2553.0,4978.0,2425.0,115500.0,0.0,-115500.0
<a href=/player/coler102>coler102</a>,Ray Coleman,St.Louis Browns,ORLS,1,1,2,3,1948,1948,0,No,0,-0.27,-0.18,0.09,68,15,-53,249,27,-222,0.0,0.0,0.0,0.0,0.0,0.0
<a href=/player/coler102>coler102</a>,Ray Coleman,Philadelphia Athletics,ATLTCS,36,79,78,157,1949,1976,27,No,0,93.22,74.94,-18.28,10595,9460,-1135,25786,29262,3476,12563.0,7417.0,-5146.0,500300.0,0.0,-500300.0
<a href=/player/coler102>coler102</a>,Ray Coleman,Chicago White Sox,WSOX,8,14,15,29,1952,1969,17,No,0,11.54,36.17,24.63,1591,2618,1027,4750,8911,4161,1710.0,1860.0,150.0,87250.0,0.0,-87250.0
<a href=/player/coler102>coler102</a>,Ray Coleman,St.Louis Browns,ORLS,22,50,44,94,1952,1994,42,No,3,83.66,149.23,65.57,4979,8789,3810,10385,25784,15399,18519.0,15968.0,-2551.0,970833.0,0.0,-970833.0
<a href=/player/colev001>colev001</a>,Vince Coleman,New York Mets,METS,1,2,1,3,1994,1994,0,No,0,-1.52,0.27,1.79,179,51,-128,801,201,-600,0.0,0.0,0.0,0.0,0.0,0.0
<a href=/player/colev001>colev001</a>,Vince Coleman,Kansas City Royals,ROYALS,1,1,1,2,1995,1997,2,No,0,0.28,0.01,-0.27,40,12,-28,176,0,-176,0.0,52.0,52.0,250000.0,0.0,-250000.0
<a href=/player/colev002>colev002</a>,Victor Cole,Kansas City Royals,ROYALS,3,3,4,7,1991,1994,3,No,0,-0.79,1.48,2.27,190,259,69,474,869,395,69.0,0.0,-69.0,0.0,0.0,0.0
<a href=/player/collb101>collb101</a>,Bill Collins,New York Giants,GIANTS,1,2,1,3,1910,1913,3,No,0,4.09,2.02,-2.07,544,293,-251,2338,817,-1521,0.0,0.0,0.0,0.0,0.0,0.0
<a href=/player/collb101>collb101</a>,Bill Collins,Boston Braves,BRAVES,2,5,6,11,1911,1914,3,No,0,3.16,-2.55,-5.71,559,378,-181,1829,1028,-801,21.0,614.0,593.0,0.0,0.0,0.0
<a href=/player/collb101>collb101</a>,Bill Collins,Newark,Newark,1,1,1,2,1913,1913,0,No,0,-0.85,0.0,0.85,32,0,-32,107,0,-107,0.0,0.0,0.0,0.0,0.0,0.0
<a href=/player/colld001>colld001</a>,Dave Collins,Seattle Mariners,MARNRS,4,6,7,13,1977,1987,10,No,0,16.55,11.78,-4.77,1031,881,-150,1983,1334,-649,2811.0,2774.0,-37.0,0.0,0.0,0.0
<a href=/player/colld001>colld001</a>,Dave Collins,New York Yankees,YANKS,1,4,2,6,1982,1985,3,No,0,24.16,-0.71,-24.87,840,62,-778,3265,0,-3265,136.0,360.0,224.0,650000.0,0.0,-650000.0
<a href=/player/colld001>colld001</a>,Dave Collins,Toronto Blue Jays,BJAYS,1,3,1,4,1984,1987,3,No,0,7.47,0.63,-6.84,580,109,-471,2252,0,-2252,0.0,317.0,317.0,650000.0,0.0,-650000.0
<a href=/player/colld001>colld001</a>,Dave Collins,Oakland Athletics,ATLTCS,1,1,1,2,1985,1986,1,No,0,1.38,0.0,-1.38,124,0,-124,476,0,-476,0.0,0.0,0.0,700000.0,0.0,-700000.0
<a href=/player/colld101>colld101</a>,Don Collins,Atlanta Braves,BRAVES,1,1,1,2,1980,1980,0,No,0,-0.05,0.0,0.05,4,0,-4,0,0,0,18.0,0.0,-18.0,0.0,0.0,0.0
<a href=/player/collj102>collj102</a>,Jackie Collum,St. Louis Cardinals,CARDS,2,4,2,6,1953,1954,1,No,0,4.37,-0.14,-4.51,196,106,-90,110,278,168,1014.0,107.0,-907.0,0.0,0.0,0.0
<a href=/player/collj102>collj102</a>,Jackie Collum,Cincinnati Reds,REDS,1,1,2,3,1956,1960,4,No,0,0.48,7.46,6.98,76,388,312,17,278,261,180.0,2357.0,2177.0,0.0,0.0,0.0
<a href=/player/collj102>collj102</a>,Jackie Collum,St. Louis Cardinals,CARDS,15,35,30,65,1956,1972,16,No,0,38.58,60.99,22.41,4144,2647,-1497,9926,7589,-2337,4766.0,5429.0,663.0,32500.0,0.0,-32500.0
<a href=/player/collj102>collj102</a>,Jackie Collum,Chicago Cubs,CUBS,1,2,1,3,1957,1965,8,No,0,-0.13,9.65,9.78,10,894,884,1,138,137,23.0,2255.0,2232.0,0.0,0.0,0.0
<a href=/player/collj102>collj102</a>,Jackie Collum,Minnesota Twins,TWINS,1,3,1,4,1962,1963,1,No,0,-0.08,-0.13,-0.05,2,12,10,0,6,6,4.0,58.0,54.0,0.0,0.0,0.0
<a href=/player/collj103>collj103</a>,Jimmy Collins,Boston Red Sox,RSOX,2,3,2,5,1907,1907,0,No,0,2.23,0.41,-1.82,214,102,-112,868,395,-473,0.0,30.0,30.0,0.0,0.0,0.0
<a href=/player/collk101>collk101</a>,Kevin Collins,New York Mets,METS,1,5,1,6,1969,1971,2,No,0,11.34,3.37,-7.97,538,281,-257,615,957,342,4078.0,0.0,-4078.0,0.0,0.0,0.0
<a href=/player/collk101>collk101</a>,Kevin Collins,Detroit Tigers,TIGRS,2,4,2,6,1973,1975,2,No,0,0.22,-0.05,-0.27,33,98,65,0,215,215,403.0,135.0,-268.0,27500.0,0.0,-27500.0
<a href=/player/colll001>colll001</a>,Lou Collier,Milwaukee Brewers,BREWRS,2,7,6,13,2002,2004,2,No,0,1.18,1.8,0.62,314,393,79,929,661,-268,437.0,1049.0,612.0,2750000.0,0.0,-2750000.0
<a href=/player/colll001>colll001</a>,Lou Collier,New York Mets,METS,2,4,4,8,2002,2003,1,No,0,-0.15,0.83,0.98,24,64,40,27,7,-20,29.0,147.0,118.0,0.0,0.0,0.0
<a href=/player/collp101>collp101</a>,Pat Collins,St.Louis Browns,ORLS,1,4,1,5,1925,1928,3,No,0,0.0,-0.47,-0.47,0,145,145,0,462,462,0.0,0.0,0.0,0.0,0.0,0.0
<a href=/player/collp101>collp101</a>,Pat Collins,StPaul,StPaul,6,8,13,21,1925,1930,5,No,0,6.53,0.0,-6.53,925,0,-925,2834,0,-2834,611.0,0.0,-611.0,0.0,0.0,0.0
<a href=/player/collr101>collr101</a>,Ripper Collins,St. Louis Cardinals,CARDS,1,2,1,3,1936,1942,6,No,0,2.86,15.14,12.28,328,366,38,1111,461,-650,437.0,3473.0,3036.0,0.0,0.0,0.0
<a href=/player/collr104>collr104</a>,Rip Collins,New York Yankees,YANKS,4,11,7,18,1921,1946,25,No,0,28.58,81.31,52.73,995,2473,1478,1312,4729,3417,7730.0,15194.0,7464.0,42500.0,0.0,-42500.0
<a href=/player/collr104>collr104</a>,Rip Collins,Boston Red Sox,RSOX,5,10,13,23,1922,1937,15,No,0,16.16,24.39,8.23,675,750,75,1305,1574,269,3851.0,4650.0,799.0,45550.0,0.0,-45550.0
<a href=/player/collr104>collr104</a>,Rip Collins,Detroit Tigers,TIGRS,1,1,1,2,1928,1928,0,No,0,0.0,0.2,0.2,0,58,58,0,63,63,0.0,511.0,511.0,0.0,0.0,0.0
<a href=/player/colls101>colls101</a>,Shano Collins,Chicago White Sox,WSOX,1,2,1,3,1921,1921,0,No,0,-2.09,3.07,5.16,680,108,-572,2600,485,-2115,0.0,0.0,0.0,0.0,0.0,0.0
<a href=/player/collt001>collt001</a>,Tim Collins,Toronto Blue Jays,BJAYS,4,18,13,31,2010,2018,8,No,0,25.98,29.42,3.44,2444,1447,-997,6892,4630,-2262,4668.0,4909.0,241.0,11482900.0,0.0,-11482900.0
<a href=/player/collt001>collt001</a>,Tim Collins,Atlanta Braves,BRAVES,1,3,2,5,2010,2010,0,No,0,2.01,-0.01,-2.02,319,93,-226,204,139,-65,734.0,60.0,-674.0,415000.0,0.0,-415000.0
<a href=/player/colmf101>colmf101</a>,Frank Colman,Toronto,Toronto,1,2,1,3,1942,1942,0,No,0,4.35,0.0,-4.35,338,0,-338,630,0,-630,555.0,0.0,-555.0,0.0,0.0,0.0
<a href=/player/coloa001>coloa001</a>,Alex Colome,Tampa Bay Devil Rays,RAYS,1,3,2,5,2018,2019,1,Yes,0,2.35,0.0,-2.35,144,0,-144,328,0,-328,139.0,0.0,-139.0,5300000.0,0.0,-5300000.0
<a href=/player/coloa001>coloa001</a>,Alex Colome,Seattle Mariners,MARNRS,2,2,3,5,2018,2019,1,Yes,0,3.4,2.23,-1.17,251,132,-119,571,482,-89,250.0,0.0,-250.0,581200.0,0.0,-581200.0
<a href=/player/colob001>colob001</a>,Bartolo Colon,Cleveland Indians,INDINS,10,19,27,46,2002,2021,19,Yes,0,63.04,99.19,36.15,2801,3478,677,9898,8220,-1678,3587.0,12440.0,8853.0,39810300.0,0.0,-39810300.0
<a href=/player/colob001>colob001</a>,Bartolo Colon,Montreal Expos,NATEX,1,2,4,6,2003,2004,1,No,0,5.15,-4.18,-9.33,48,270,222,7,107,100,913.0,449.0,-464.0,0.0,0.0,0.0
<a href=/player/coloj001>coloj001</a>,Jesus Colome,Oakland Athletics,ATLTCS,2,4,3,7,2000,2004,4,No,0,0.08,5.64,5.56,354,661,307,509,1663,1154,781.0,762.0,-19.0,201000.0,0.0,-201000.0
<a href=/player/color001>color001</a>,Roman Colon,Atlanta Braves,BRAVES,4,6,5,11,2005,2013,8,No,2,5.24,1.06,-4.18,591,125,-466,1015,0,-1015,1611.0,173.0,-1438.0,318500.0,0.0,-318500.0
<a href=/player/color001>color001</a>,Roman Colon,Detroit Tigers,TIGRS,1,1,1,2,2007,2007,0,No,0,0.27,0.0,-0.27,56,0,-56,1,0,-1,181.0,0.0,-181.0,0.0,0.0,0.0
<a href=/player/colpd101>colpd101</a>,Dick Colpaert,Cleveland Indians,INDINS,1,2,2,4,1973,1973,0,No,0,-0.78,0.0,0.78,55,0,-55,0,0,0,604.0,0.0,-604.0,0.0,0.0,0.0
<a href=/player/coltl101>coltl101</a>,Larry Colton,Philadelphia Phillies,PHILS,4,8,8,16,1970,1984,14,No,0,29.76,14.53,-15.23,1654,1829,175,6186,1998,-4188,0.0,2963.0,2963.0,0.0,0.0,0.0
<a href=/player/colub101>colub101</a>,Bob Coluccio,Milwaukee Brewers,BREWRS,1,1,1,2,1975,1975,0,No,0,-0.16,0.72,0.88,81,125,44,220,407,187,0.0,0.0,0.0,0.0,0.0,0.0
<a href=/player/colub101>colub101</a>,Bob Coluccio,Houston Astros,ASTROS,1,1,1,2,1978,1980,2,No,0,-0.06,0.27,0.33,5,26,21,4,6,2,0.0,75.0,75.0,0.0,0.0,0.0
<a href=/player/colub101>colub101</a>,Bob Coluccio,St. Louis Cardinals,CARDS,1,1,1,2,1978,1979,1,No,0,0.0,0.0,0.0,0,0,0,0,0,0,0.0,0.0,0.0,0.0,0.0,0.0
<a href=/player/colvt001>colvt001</a>,Tyler Colvin,Chicago Cubs,CUBS,1,2,2,4,2011,2013,2,No,0,17.66,0.03,-17.63,1081,55,-1026,4267,202,-4065,0.0,0.0,0.0,440000.0,0.0,-440000.0
<a href=/player/colys001>colys001</a>,Steve Colyer,Los Angeles Dodgers,DOGRS,2,2,2,4,2004,2006,2,No,0,-0.54,0.28,0.82,47,22,-25,5,40,35,96.0,0.0,-96.0,327500.0,0.0,-327500.0
<a href=/player/colys001>colys001</a>,Steve Colyer,Detroit Tigers,TIGRS,1,1,1,2,2005,2005,0,No,0,0.0,-0.39,-0.39,0,14,14,0,0,0,0.0,105.0,105.0,0.0,0.0,0.0
<a href=/player/combe101>combe101</a>,Earle Combs,Louisville,Louisville,1,1,2,3,1924,1924,0,No,0,44.77,0.0,-44.77,1455,0,-1455,6514,0,-6514,0.0,0.0,0.0,0.0,0.0,0.0
<a href=/player/combm101>combm101</a>,Merl Combs,Boston Red Sox,RSOX,1,2,1,3,1950,1953,3,No,0,0.17,2.98,2.81,40,263,223,137,929,792,0.0,0.0,0.0,0.0,0.0,0.0
<a href=/player/combm101>combm101</a>,Merl Combs,St.Louis Browns,ORLS,2,4,3,7,1951,1952,1,No,0,-0.57,0.21,0.78,160,272,112,343,951,608,171.0,0.0,-171.0,6000.0,0.0,-6000.0
<a href=/player/comew101>comew101</a>,Wayne Comer,Washington Senators,RNGRS,1,1,1,2,1963,1963,0,No,0,-0.87,-0.15,0.72,79,125,46,64,416,352,0.0,0.0,0.0,0.0,0.0,0.0
<a href=/player/comew101>comew101</a>,Wayne Comer,Milwaukee Brewers,BREWRS,2,4,3,7,1970,1971,1,No,0,0.11,-0.05,-0.16,77,28,-49,154,68,-86,0.0,0.0,0.0,0.0,0.0,0.0
<a href=/player/comoa101>comoa101</a>,Adam Comorosky,Pittsburgh Pirates,PIRATS,1,2,2,4,1933,1939,6,No,0,-1.61,11.63,13.24,298,385,87,1097,447,-650,0.0,2051.0,2051.0,0.0,0.0,0.0
<a href=/player/compc101>compc101</a>,Clint Compton,Atlanta Braves,BRAVES,1,2,2,4,1969,1970,1,No,0,9.24,2.87,-6.37,457,118,-339,1833,14,-1819,0.0,278.0,278.0,0.0,0.0,0.0
<a href=/player/compp101>compp101</a>,Pete Compton,St.Louis Browns,ORLS,1,4,1,5,1913,1916,3,No,0,0.0,8.53,8.53,0,318,318,0,1249,1249,0.0,0.0,0.0,3200.0,0.0,-3200.0
<a href=/player/comsk001>comsk001</a>,Keith Comstock,San Francisco Giants,GIANTS,7,13,17,30,1987,1998,11,No,2,21.03,37.78,16.75,1321,2343,1022,1429,4032,2603,4080.0,4148.0,68.0,9879278.0,0.0,-9879278.0
<a href=/player/condr101>condr101</a>,Ramon Conde,Los Angeles Dodgers,DOGRS,1,2,1,3,1962,1962,0,No,0,-0.44,0.03,0.47,14,53,39,19,130,111,0.0,0.0,0.0,0.0,0.0,0.0
<a href=/player/condr101>condr101</a>,Ramon Conde,Chicago White Sox,WSOX,1,1,2,3,1967,1967,0,No,0,0.0,0.0,0.0,0,0,0,0,0,0,0.0,0.0,0.0,0.0,0.0,0.0
<a href=/player/coned001>coned001</a>,David Cone,Kansas City Royals,ROYALS,1,2,3,5,1987,1988,1,No,0,20.17,-0.31,-20.48,379,19,-360,466,21,-445,3628.0,141.0,-3487.0,0.0,0.0,0.0
<a href=/player/coned001>coned001</a>,David Cone,New York Mets,METS,10,20,18,38,1992,2005,13,No,0,12.19,19.18,6.99,1467,3191,1724,1939,7500,5561,2972.0,2738.0,-234.0,27998333.0,0.0,-27998333.0
<a href=/player/coned001>coned001</a>,David Cone,Kansas City Royals,ROYALS,2,3,5,8,1995,1999,4,No,0,11.8,0.62,-11.18,520,251,-269,1598,135,-1463,391.0,629.0,238.0,0.0,0.0,0.0
<a href=/player/coned001>coned001</a>,David Cone,Toronto Blue Jays,BJAYS,1,1,3,4,1995,1997,2,No,0,20.23,-0.54,-20.77,149,27,-122,13,0,-13,2766.0,296.0,-2470.0,8000000.0,0.0,-8000000.0
<a href=/player/congd101>congd101</a>,Dick Conger,Philadelphia Phillies,PHILS,2,4,2,6,1943,1949,6,No,0,23.82,3.95,-19.87,519,273,-246,570,454,-116,4467.0,1587.0,-2880.0,0.0,0.0,0.0
<a href=/player/congh001>congh001</a>,Hank Conger,Anaheim Angels,ANGELS,2,2,3,5,2014,2019,5,No,0,0.06,3.14,3.08,81,228,147,251,604,353,0.0,587.0,587.0,517500.0,0.0,-517500.0
<a href=/player/conib101>conib101</a>,Billy Conigliaro,Boston Red Sox,RSOX,5,10,10,20,1971,1977,6,No,0,35.42,11.92,-23.5,1569,736,-833,4628,2092,-2536,3846.0,2344.0,-1502.0,155000.0,0.0,-155000.0
<a href=/player/conij001>conij001</a>,Jeff Conine,Florida Marlins,MARLNS,1,1,1,2,1997,1997,0,No,0,0.14,0.0,-0.14,93,0,-93,343,0,-343,0.0,0.0,0.0,2800000.0,0.0,-2800000.0
<a href=/player/conij001>conij001</a>,Jeff Conine,Kansas City Royals,ROYALS,1,1,1,2,1999,2002,3,No,0,6.89,-1.4,-8.29,751,38,-713,3005,2,-3003,0.0,378.0,378.0,0.0,0.0,0.0
<a href=/player/conij001>conij001</a>,Jeff Conine,Baltimore Orioles,ORLS,2,2,3,5,2003,2005,2,No,0,2.81,-0.96,-3.77,316,67,-249,1062,0,-1062,295.0,181.0,-114.0,4250000.0,0.0,-4250000.0
<a href=/player/conij001>conij001</a>,Jeff Conine,Baltimore Orioles,ORLS,1,1,1,2,2006,2006,0,No,0,-0.09,0.0,0.09,28,0,-28,107,0,-107,0.0,0.0,0.0,1700000.0,0.0,-1700000.0
<a href=/player/conij001>conij001</a>,Jeff Conine,Philadelphia Phillies,PHILS,1,1,2,3,2006,2006,0,No,0,-0.18,0.0,0.18,80,0,-80,242,0,-242,0.0,0.0,0.0,0.0,0.0,0.0
<a href=/player/conij001>conij001</a>,Jeff Conine,Cincinnati Reds,REDS,1,1,2,3,2007,2007,0,No,0,-0.79,0.0,0.79,21,0,-21,50,0,-50,0.0,0.0,0.0,2000000.0,0.0,-2000000.0
<a href=/player/conit101>conit101</a>,Tony Conigliaro,Boston Red Sox,RSOX,6,13,11,24,1970,1987,17,No,0,23.72,33.07,9.35,1247,1904,657,3411,5540,2129,3997.0,6601.0,2604.0,192500.0,0.0,-192500.0
<a href=/player/conlg101>conlg101</a>,Gene Conley,Milwaukee Braves,BRAVES,2,4,4,8,1959,1964,5,No,0,9.25,-0.88,-10.13,355,69,-286,908,184,-724,1090.0,0.0,-1090.0,0.0,0.0,0.0
<a href=/player/conlg101>conlg101</a>,Gene Conley,Philadelphia Phillies,PHILS,1,1,1,2,1960,1962,2,No,0,3.74,-0.05,-3.79,152,136,-16,188,41,-147,1447.0,547.0,-900.0,0.0,0.0,0.0
<a href=/player/connb102>connb102</a>,Bud Connolly,Boston Red Sox,RSOX,2,6,3,9,1925,1926,1,No,0,0.0,-1.32,-1.32,0,98,98,0,337,337,0.0,0.0,0.0,21750.0,0.0,-21750.0
<a href=/player/connb104>connb104</a>,Bruce Connatser,Cleveland Indians,INDINS,1,2,1,3,1932,1932,0,No,0,3.72,0.0,-3.72,330,0,-330,151,0,-151,1373.0,0.0,-1373.0,0.0,0.0,0.0
<a href=/player/connc101>connc101</a>,Chuck Connors,Brooklyn Dodgers,DOGRS,1,2,2,4,1950,1951,1,No,0,4.4,0.0,-4.4,849,35,-814,3484,35,-3449,0.0,0.0,0.0,0.0,0.0,0.0
<a href=/player/connf001>connf001</a>,Fritzie Connally,Chicago Cubs,CUBS,2,4,2,6,1983,1989,6,No,1,15.56,10.82,-4.74,1534,321,-1213,2801,249,-2552,1977.0,2213.0,236.0,0.0,0.0,0.0
<a href=/player/connf001>connf001</a>,Fritzie Connally,San Diego Padres,PADRS,1,1,1,2,1985,1985,0,No,0,0.35,0.0,-0.35,50,0,-50,135,0,-135,0.0,0.0,0.0,0.0,0.0,0.0
<a href=/player/connj101>connj101</a>,Joe Connolly,New York Giants,GIANTS,1,1,1,2,1922,1922,0,No,0,0.0,0.0,0.0,0,0,0,0,0,0,0.0,0.0,0.0,0.0,0.0,0.0
<a href=/player/connj101>connj101</a>,Joe Connolly,Cleveland Indians,INDINS,1,4,3,7,1924,1928,4,No,0,0.12,9.37,9.25,387,855,468,1555,3344,1789,0.0,0.0,0.0,0.0,0.0,0.0
<a href=/player/connj101>connj101</a>,Joe Connolly,Boston Red Sox,RSOX,1,2,1,3,1924,1924,0,No,0,0.0,0.0,0.0,0,0,0,0,0,0,0.0,0.0,0.0,3300.0,0.0,-3300.0
<a href=/player/connj105>connj105</a>,John Connor,Louisville Colonels,LS2,2,3,2,5,1885,1889,4,No,0,4.44,0.0,-4.44,98,0,-98,171,0,-171,1169.0,0.0,-1169.0,0.0,0.0,0.0
<a href=/player/connr102>connr102</a>,Roger Connor,Philadelphia Phillies,PHILS,1,1,3,4,1893,1898,5,No,0,4.81,-1.18,-5.99,157,549,392,700,2414,1714,0.0,168.0,168.0,0.0,0.0,0.0
<a href=/player/conrb101>conrb101</a>,Bill Conroy,Philadelphia Athletics,ATLTCS,2,4,2,6,1937,1946,9,No,0,1.34,-1.59,-2.93,190,315,125,733,931,198,0.0,888.0,888.0,5300.0,0.0,-5300.0
<a href=/player/conrt001>conrt001</a>,Tim Conroy,Oakland Athletics,ATLTCS,1,2,1,3,1985,1987,2,No,0,-1.98,1.12,3.1,136,41,-95,273,0,-273,468.0,648.0,180.0,425000.0,0.0,-425000.0
<a href=/player/consb101>consb101</a>,Billy Consolo,Boston Red Sox,RSOX,1,2,2,4,1959,1960,1,No,0,0.88,-0.17,-1.05,192,13,-179,454,12,-442,4.0,0.0,-4.0,0.0,0.0,0.0
<a href=/player/consb101>consb101</a>,Billy Consolo,Minnesota Twins,TWINS,1,1,1,2,1961,1962,1,No,0,0.0,-0.89,-0.89,0,108,108,0,398,398,0.0,0.0,0.0,0.0,0.0,0.0
<a href=/player/contj001>contj001</a>,Jason Conti,Arizona Diamondbacks,DBACKS,1,2,2,4,2001,2001,0,No,0,-0.05,0.9,0.95,103,38,-65,245,52,-193,290.0,243.0,-47.0,200000.0,0.0,-200000.0
<a href=/player/contj001>contj001</a>,Jason Conti,Tampa Bay Devil Rays,RAYS,1,1,1,2,2003,2003,0,No,0,-0.18,-0.18,0.0,30,49,19,52,142,90,0.0,0.0,0.0,0.0,0.0,0.0
<a href=/player/contj002>contj002</a>,Jose Contreras,New York Yankees,YANKS,1,2,1,3,2004,2004,0,No,0,9.88,-1.02,-10.9,156,10,-146,18,0,-18,2700.0,127.0,-2573.0,8500000.0,0.0,-8500000.0
<a href=/player/contj002>contj002</a>,Jose Contreras,Chicago White Sox,WSOX,1,2,1,3,2009,2009,0,No,0,0.9,0.0,-0.9,14,0,-14,4,0,-4,51.0,0.0,-51.0,10000000.0,0.0,-10000000.0
<a href=/player/contr001>contr001</a>,Roansy Contreras,New York Yankees,YANKS,1,4,1,5,2021,2021,0,Yes,0,-0.2,2.23,2.43,9,31,22,3,2,-1,54.0,433.0,379.0,0.0,0.0,0.0
<a href=/player/convj001>convj001</a>,Jim Converse,Seattle Mariners,MARNRS,1,1,1,2,1995,1995,0,No,0,0.01,0.28,0.27,12,40,28,0,176,176,52.0,0.0,-52.0,115000.0,0.0,-115000.0
<a href=/player/conwb101>conwb101</a>,Bill Conway,Lawrence,Lawrence,1,3,1,4,1886,1886,0,No,0,0.0,0.0,0.0,0,0,0,0,0,0,0.0,0.0,0.0,0.0,0.0,0.0
<a href=/player/conwd101>conwd101</a>,Dick Conway,Lawrence,Lawrence,1,3,1,4,1886,1886,0,No,0,0.0,0.0,0.0,0,0,0,0,0,0,0.0,0.0,0.0,0.0,0.0,0.0
<a href=/player/cookb001>cookb001</a>,Brent Cookson,San Francisco Giants,GIANTS,1,1,1,2,1995,1995,0,No,0,-0.49,-0.29,0.2,22,10,-12,38,0,-38,0.0,25.0,25.0,0.0,0.0,0.0
<a href=/player/cookc101>cookc101</a>,Cliff Cook,Cincinnati Reds,REDS,2,3,2,5,1962,1963,1,No,0,-1.36,0.31,1.67,146,63,-83,266,207,-59,61.0,0.0,-61.0,0.0,0.0,0.0
<a href=/player/cookd001>cookd001</a>,Dennis Cook,San Francisco Giants,GIANTS,2,4,4,8,1989,1995,6,No,0,14.97,0.18,-14.79,1080,283,-797,2467,146,-2321,4215.0,391.0,-3824.0,1545000.0,0.0,-1545000.0
<a href=/player/cookd001>cookd001</a>,Dennis Cook,Philadelphia Phillies,PHILS,2,3,2,5,1990,1992,2,No,0,3.82,-1.61,-5.43,693,143,-550,2178,167,-2011,96.0,163.0,67.0,120000.0,0.0,-120000.0
<a href=/player/cookd001>cookd001</a>,Dennis Cook,Los Angeles Dodgers,DOGRS,2,3,2,5,1991,1993,2,No,0,1.24,0.37,-0.87,87,132,45,0,504,504,763.0,0.0,-763.0,240000.0,0.0,-240000.0
<a href=/player/cookd001>cookd001</a>,Dennis Cook,Cleveland Indians,INDINS,1,1,1,2,1995,1995,0,No,0,1.82,0.0,-1.82,95,0,-95,0,0,0,346.0,0.0,-346.0,0.0,0.0,0.0
<a href=/player/cookd001>cookd001</a>,Dennis Cook,Florida Marlins,MARLNS,1,1,2,3,1997,1997,0,No,0,2.74,0.0,-2.74,494,0,-494,6,0,-6,678.0,0.0,-678.0,850000.0,0.0,-850000.0
<a href=/player/cookd001>cookd001</a>,Dennis Cook,New York Mets,METS,2,6,5,11,2001,2005,4,No,0,2.32,0.95,-1.37,695,209,-486,27,48,21,1207.0,444.0,-763.0,5800000.0,0.0,-5800000.0
<a href=/player/cookd102>cookd102</a>,Dusty Cooke,New York Yankees,YANKS,4,8,6,14,1933,1948,15,No,0,2.19,1.52,-0.67,1017,291,-726,3931,971,-2960,0.0,0.0,0.0,9000.0,0.0,-9000.0
<a href=/player/cookd102>cookd102</a>,Dusty Cooke,Cincinnati Reds,REDS,4,6,4,10,1938,1940,2,No,0,13.89,0.35,-13.54,908,158,-750,3350,491,-2859,0.0,0.0,0.0,0.0,0.0,0.0
<a href=/player/cooke101>cooke101</a>,Earl Cook,Cincinnati Reds,REDS,1,2,1,3,1939,1939,0,No,0,0.0,-0.02,-0.02,0,2,2,0,0,0,0.0,3.0,3.0,0.0,0.0,0.0
<a href=/player/cookm001>cookm001</a>,Mike Cook,California Angels,ANGELS,1,3,2,5,1988,1992,4,No,0,-0.32,6.07,6.39,96,81,-15,213,0,-213,64.0,1524.0,1460.0,0.0,0.0,0.0
<a href=/player/cookr001>cookr001</a>,Ryan Cook,Arizona Diamondbacks,DBACKS,6,12,12,24,2011,2021,10,Yes,0,55.85,12.58,-43.27,1986,909,-1077,2819,1176,-1643,7668.0,4077.0,-3591.0,13397833.0,0.0,-13397833.0
<a href=/player/cookr001>cookr001</a>,Ryan Cook,Oakland Athletics,ATLTCS,1,1,1,2,2015,2015,0,No,0,-0.75,0.0,0.75,7,0,-7,0,0,0,13.0,0.0,-13.0,1400000.0,0.0,-1400000.0
<a href=/player/coold101>coold101</a>,Duff Cooley,St. Louis Cardinals,CARDS,1,1,3,4,1896,1896,0,No,0,6.22,-0.47,-6.69,440,102,-338,2080,456,-1624,0.0,0.0,0.0,0.0,0.0,0.0
<a href=/player/cools001>cools001</a>,Scott Coolbaugh,Texas Rangers,RNGRS,1,1,1,2,1990,1991,1,No,0,-0.69,-0.03,0.66,60,3,-57,205,1,-204,0.0,0.0,0.0,100000.0,0.0,-100000.0
<a href=/player/cools001>cools001</a>,Scott Coolbaugh,San Diego Padres,PADRS,1,1,1,2,1992,1992,0,No,0,0.0,0.0,0.0,0,0,0,0,0,0,0.0,0.0,0.0,0.0,0.0,0.0
<a href=/player/coomr001>coomr001</a>,Ron Coomer,Chicago White Sox,WSOX,1,1,1,2,1993,1995,2,No,0,0.26,-0.04,-0.3,69,7,-62,137,0,-137,0.0,20.0,20.0,0.0,0.0,0.0
<a href=/player/coomr001>coomr001</a>,Ron Coomer,Los Angeles Dodgers,DOGRS,1,4,2,6,1995,1998,3,No,0,-0.49,1.39,1.88,829,429,-400,2713,30,-2683,618.0,819.0,201.0,218000.0,0.0,-218000.0
<a href=/player/coonj101>coonj101</a>,Johnny Cooney,New York Giants,GIANTS,1,4,1,5,1931,1931,0,No,0,0.0,0.0,0.0,0,0,0,0,0,0,0.0,0.0,0.0,0.0,0.0,0.0
<a href=/player/coonj101>coonj101</a>,Johnny Cooney,Brooklyn Dodgers,DOGRS,1,4,1,5,1937,1944,7,No,0,1.9,1.11,-0.79,125,343,218,330,1190,860,390.0,0.0,-390.0,10000.0,0.0,-10000.0
<a href=/player/coonj101>coonj101</a>,Johnny Cooney,Indianapolis,Indianapolis,1,2,3,5,1935,1936,1,No,0,2.11,0.0,-2.11,313,0,-313,1102,0,-1102,0.0,0.0,0.0,0.0,0.0,0.0
<a href=/player/coonj103>coonj103</a>,Jimmy Cooney,St. Louis Cardinals,CARDS,1,1,1,2,1925,1925,0,No,0,2.01,0.0,-2.01,174,0,-174,707,0,-707,0.0,0.0,0.0,4850.0,0.0,-4850.0
<a href=/player/coonj103>coonj103</a>,Jimmy Cooney,Chicago Cubs,CUBS,1,2,1,3,1927,1927,0,No,0,-0.69,2.92,3.61,89,54,-35,289,70,-219,56.0,552.0,496.0,15500.0,0.0,-15500.0
<a href=/player/coonj103>coonj103</a>,Jimmy Cooney,Philadelphia Phillies,PHILS,1,3,2,5,1927,1929,2,No,0,-0.72,-1.19,-0.47,18,135,117,33,192,159,0.0,529.0,529.0,8850.0,0.0,-8850.0
<a href=/player/coonj103>coonj103</a>,Jimmy Cooney,Boston Braves,BRAVES,1,3,1,4,1928,1928,0,No,0,0.0,-0.51,-0.51,0,14,14,0,6,6,0.0,65.0,65.0,10080.0,0.0,-10080.0
<a href=/player/coons001>coons001</a>,Sam Coonrod,San Francisco Giants,GIANTS,1,1,1,2,2021,2021,0,Yes,0,0.39,0.0,-0.39,82,0,-82,1,0,-1,127.0,0.0,-127.0,0.0,0.0,0.0
<a href=/player/coopb001>coopb001</a>,Brian Cooper,Anaheim Angels,ANGELS,1,1,1,2,2002,2003,1,No,0,-0.5,4.23,4.73,2,193,191,0,714,714,25.0,0.0,-25.0,0.0,0.0,0.0
<a href=/player/coopc001>coopc001</a>,Cecil Cooper,Boston Red Sox,RSOX,2,2,3,5,1976,1981,5,No,0,30.69,4.95,-25.74,1534,508,-1026,6654,1859,-4795,0.0,0.0,0.0,200000.0,0.0,-200000.0
<a href=/player/coopd001>coopd001</a>,Don Cooper,Minnesota Twins,TWINS,1,1,1,2,1982,1982,0,No,0,-0.05,0.0,0.05,4,0,-4,0,0,0,16.0,0.0,-16.0,0.0,0.0,0.0
<a href=/player/coopd001>coopd001</a>,Don Cooper,Toronto Blue Jays,BJAYS,1,1,1,2,1984,1984,0,No,0,-0.06,0.0,0.06,7,0,-7,0,0,0,30.0,0.0,-30.0,0.0,0.0,0.0
<a href=/player/coopg002>coopg002</a>,Garrett Cooper,Milwaukee Brewers,BREWRS,1,1,1,2,2017,2018,1,No,0,0.11,-0.14,-0.25,13,4,-9,45,0,-45,0.0,6.0,6.0,0.0,0.0,0.0
<a href=/player/coopg002>coopg002</a>,Garrett Cooper,New York Yankees,YANKS,1,2,2,4,2017,2017,0,Yes,0,5.67,0.0,-5.67,313,0,-313,917,0,-917,701.0,0.0,-701.0,0.0,0.0,0.0
<a href=/player/coopm101>coopm101</a>,Mort Cooper,St. Louis Cardinals,CARDS,1,1,2,3,1945,1946,1,No,0,4.41,4.13,-0.28,116,118,2,118,121,3,973.0,941.0,-32.0,15000.0,0.0,-15000.0
<a href=/player/coopm101>coopm101</a>,Mort Cooper,Boston Braves,BRAVES,2,2,4,6,1947,1951,4,No,0,-0.91,4.84,5.75,54,245,191,30,368,338,264.0,1549.0,1285.0,0.0,0.0,0.0
<a href=/player/coops001>coops001</a>,Scott Cooper,Boston Red Sox,RSOX,4,7,6,13,1995,1997,2,No,0,2.06,3.71,1.65,881,324,-557,1600,1071,-529,1046.0,345.0,-701.0,1638268.0,0.0,-1638268.0
<a href=/player/coopw101>coopw101</a>,Wilbur Cooper,Columbus,Columbus,1,1,1,2,1912,1912,0,No,0,52.68,0.0,-52.68,942,0,-942,1206,0,-1206,9590.0,0.0,-9590.0,0.0,0.0,0.0
<a href=/player/coopw101>coopw101</a>,Wilbur Cooper,Pittsburgh Pirates,PIRATS,4,6,7,13,1924,1932,8,No,0,11.08,42.87,31.79,1606,1347,-259,6101,4357,-1744,1307.0,3847.0,2540.0,22300.0,0.0,-22300.0
<a href=/player/coopw102>coopw102</a>,Walker Cooper,New York Giants,GIANTS,1,1,1,2,1949,1950,1,No,0,1.35,0.01,-1.34,97,60,-37,378,197,-181,0.0,0.0,0.0,0.0,0.0,0.0
<a href=/player/coopw102>coopw102</a>,Walker Cooper,Cincinnati Reds,REDS,9,17,23,40,1950,1965,15,No,0,91.55,24.9,-66.65,4942,2303,-2639,15926,5746,-10180,2749.0,1025.0,-1724.0,63000.0,0.0,-63000.0
<a href=/player/coppr001>coppr001</a>,Rocky Coppinger,Baltimore Orioles,ORLS,2,2,3,5,1999,2001,2,No,0,0.82,-0.96,-1.78,122,85,-37,12,0,-12,275.0,241.0,-34.0,620000.0,0.0,-620000.0
<a href=/player/coraa001>coraa001</a>,Alex Cora,Cleveland Indians,INDINS,1,1,1,2,2005,2006,1,No,0,2.32,-1.15,-3.47,301,46,-255,791,103,-688,0.0,0.0,0.0,1300000.0,0.0,-1300000.0
<a href=/player/coraj001>coraj001</a>,Joey Cora,San Diego Padres,PADRS,2,4,3,7,1991,1994,3,No,0,4.76,-1.77,-6.53,685,201,-484,2072,489,-1583,0.0,199.0,199.0,130000.0,0.0,-130000.0
<a href=/player/coraj001>coraj001</a>,Joey Cora,Seattle Mariners,MARNRS,2,2,3,5,1998,2002,4,No,0,2.76,7.06,4.3,178,558,380,725,2150,1425,0.0,0.0,0.0,1700000.0,0.0,-1700000.0
<a href=/player/corba001>corba001</a>,Archie Corbin,New York Mets,METS,3,4,5,9,1990,1994,4,No,1,-0.12,0.13,0.25,34,37,3,0,50,50,53.0,51.0,-2.0,0.0,0.0,0.0
<a href=/player/corba001>corba001</a>,Archie Corbin,Kansas City Royals,ROYALS,1,2,2,4,1992,1998,6,No,0,4.48,3.6,-0.88,352,157,-195,1116,0,-1116,0.0,1991.0,1991.0,0.0,0.0,0.0
<a href=/player/corbc101>corbc101</a>,Claude Corbitt,Syracuse,Syracuse,1,1,1,2,1953,1954,1,No,0,0.0,0.0,0.0,0,0,0,0,0,0,0.0,0.0,0.0,0.0,0.0,0.0
<a href=/player/corbc101>corbc101</a>,Claude Corbitt,Milwaukee,Milwaukee,1,1,3,4,1941,1941,0,No,0,0.04,0.0,-0.04,2,0,-2,5,0,-5,0.0,0.0,0.0,0.0,0.0,0.0
<a href=/player/corbd001>corbd001</a>,Doug Corbett,Minnesota Twins,TWINS,3,6,6,12,1982,1989,7,No,0,9.33,17.94,8.61,1193,1029,-164,3688,4105,417,852.0,435.0,-417.0,1243500.0,0.0,-1243500.0
<a href=/player/corbg101>corbg101</a>,Gene Corbett,Philadelphia Phillies,PHILS,1,1,1,2,1938,1938,0,No,0,0.0,2.49,2.49,0,100,100,0,421,421,0.0,0.0,0.0,0.0,0.0,0.0
<a href=/player/corbp001>corbp001</a>,Patrick Corbin,Anaheim Angels,ANGELS,1,4,1,5,2010,2012,2,No,0,13.1,6.5,-6.6,498,84,-414,497,11,-486,4323.0,1527.0,-2796.0,3700000.0,0.0,-3700000.0
<a href=/player/corct001>corct001</a>,Tim Corcoran,Detroit Tigers,TIGRS,1,1,1,2,1981,1981,0,No,0,-0.31,0.78,1.09,22,31,9,58,104,46,0.0,0.0,0.0,0.0,0.0,0.0
<a href=/player/corct101>corct101</a>,Tommy Corcoran,Brooklyn Dodgers,DOGRS,1,1,3,4,1896,1901,5,No,0,7.82,1.26,-6.56,1229,40,-1189,5155,66,-5089,0.0,447.0,447.0,0.0,0.0,0.0
<a href=/player/corde001>corde001</a>,Erik Cordier,Kansas City Royals,ROYALS,1,1,1,2,2007,2009,2,No,0,0.0,-1.12,-1.12,0,288,288,0,824,824,0.0,3.0,3.0,0.0,0.0,0.0
<a href=/player/cordf002>cordf002</a>,Francisco Cordero,Detroit Tigers,TIGRS,3,8,6,14,1999,2006,7,No,2,20.76,5.57,-15.19,1380,450,-930,3548,496,-3052,1196.0,1028.0,-168.0,1937500.0,0.0,-1937500.0
<a href=/player/cordf002>cordf002</a>,Francisco Cordero,Texas Rangers,RNGRS,4,10,8,18,2006,2013,7,No,4,5.26,17.27,12.01,930,1182,252,2448,4181,1733,1247.0,588.0,-659.0,7270260.0,0.0,-7270260.0
<a href=/player/cordf002>cordf002</a>,Francisco Cordero,Toronto Blue Jays,BJAYS,4,12,6,18,2012,2016,4,No,0,10.83,2.99,-7.84,1068,309,-759,3494,605,-2889,904.0,1431.0,527.0,11237500.0,0.0,-11237500.0
<a href=/player/cordf003>cordf003</a>,Franchy Cordero,San Diego Padres,PADRS,1,2,1,3,2020,2020,0,Yes,0,-0.21,-0.04,0.17,21,24,3,42,1,-41,30.0,54.0,24.0,0.0,0.0,0.0
<a href=/player/cordf003>cordf003</a>,Franchy Cordero,Kansas City Royals,ROYALS,1,4,2,6,2021,2021,0,Yes,0,-0.67,2.43,3.1,48,134,86,136,538,402,0.0,0.0,0.0,0.0,0.0,0.0
<a href=/player/cordj001>cordj001</a>,Jimmy Cordero,Toronto Blue Jays,BJAYS,3,6,4,10,2015,2016,1,No,0,-0.69,1.54,2.23,124,124,0,375,246,-129,55.0,171.0,116.0,0.0,0.0,0.0
<a href=/player/cordj001>cordj001</a>,Jimmy Cordero,Philadelphia Phillies,PHILS,1,1,1,2,2016,2016,0,Yes,0,-0.14,0.0,0.14,44,0,-44,0,0,0,57.0,0.0,-57.0,0.0,0.0,0.0
<a href=/player/cordr001>cordr001</a>,Ryan Cordell,Texas Rangers,RNGRS,3,5,4,9,2016,2018,2,Yes,0,3.83,1.66,-2.17,343,178,-165,233,474,241,460.0,162.0,-298.0,7350000.0,0.0,-7350000.0
<a href=/player/cordr001>cordr001</a>,Ryan Cordell,Milwaukee Brewers,BREWRS,1,1,1,2,2017,2017,0,No,0,-1.3,0.9,2.2,116,56,-60,287,0,-287,0.0,87.0,87.0,0.0,0.0,0.0
<a href=/player/cordw001>cordw001</a>,Wil Cordero,Montreal Expos,NATEX,1,2,3,5,1996,1999,3,No,0,2.1,0.16,-1.94,199,370,171,822,693,-129,0.0,483.0,483.0,0.0,0.0,0.0
<a href=/player/cordw001>cordw001</a>,Wil Cordero,Pittsburgh Pirates,PIRATS,3,4,4,8,2000,2003,3,No,0,3.54,-2.48,-6.02,691,175,-516,1112,396,-716,777.0,109.0,-668.0,2801667.0,0.0,-2801667.0
<a href=/player/coreb001>coreb001</a>,Bryan Corey,Texas Rangers,RNGRS,1,1,1,2,2006,2010,4,No,0,0.28,-2.25,-2.53,32,34,2,0,2,2,111.0,241.0,130.0,0.0,0.0,0.0
<a href=/player/corem001>corem001</a>,Mark Corey,Cincinnati Reds,REDS,1,1,1,2,1999,1999,0,No,0,-0.3,0.0,0.3,29,0,-29,1,0,-1,35.0,0.0,-35.0,0.0,0.0,0.0
<a href=/player/corem001>corem001</a>,Mark Corey,New York Mets,METS,2,4,3,7,2002,2002,0,No,0,4.04,-0.58,-4.62,267,21,-246,904,25,-879,36.0,163.0,127.0,362500.0,0.0,-362500.0
<a href=/player/corml001>corml001</a>,Lance Cormier,Arizona Diamondbacks,DBACKS,8,19,20,39,2005,2018,13,Yes,0,24.88,36.62,11.74,1440,1497,57,1874,2669,795,8219.0,7967.0,-252.0,18358000.0,0.0,-18358000.0
<a href=/player/cormr001>cormr001</a>,Rheal Cormier,St. Louis Cardinals,CARDS,2,3,3,6,1995,1996,1,No,0,1.59,0.67,-0.92,214,226,12,117,434,317,740.0,182.0,-558.0,125000.0,0.0,-125000.0
<a href=/player/cormr001>cormr001</a>,Rheal Cormier,Boston Red Sox,RSOX,2,4,3,7,1996,1997,1,No,0,-1.72,2.82,4.54,535,239,-296,705,937,232,864.0,0.0,-864.0,0.0,0.0,0.0
<a href=/player/cormr001>cormr001</a>,Rheal Cormier,Philadelphia Phillies,PHILS,1,1,1,2,2006,2007,1,No,0,0.06,0.0,-0.06,54,0,-54,0,0,0,51.0,0.0,-51.0,2500000.0,0.0,-2500000.0
<a href=/player/cornj001>cornj001</a>,Jeff Cornell,Kansas City Royals,ROYALS,1,1,1,2,1982,1982,0,No,0,-0.98,0.0,0.98,46,0,-46,4,0,-4,115.0,0.0,-115.0,0.0,0.0,0.0
<a href=/player/cornm101>cornm101</a>,Mardie Cornejo,New York Mets,METS,3,5,3,8,1979,1987,8,No,0,3.46,0.88,-2.58,161,240,79,111,73,-38,1165.0,842.0,-323.0,0.0,0.0,0.0
<a href=/player/cornr001>cornr001</a>,Reid Cornelius,Montreal Expos,NATEX,1,1,1,2,1995,1997,2,No,0,-0.1,4.43,4.53,20,337,317,20,1419,1399,173.0,0.0,-173.0,0.0,0.0,0.0
<a href=/player/cornr001>cornr001</a>,Reid Cornelius,New York Mets,METS,8,17,14,31,1996,2005,9,No,0,5.29,6.22,0.93,1355,2056,701,1632,3118,1486,2422.0,2738.0,316.0,19588333.0,0.0,-19588333.0
<a href=/player/cornr001>cornr001</a>,Reid Cornelius,Arizona Diamondbacks,DBACKS,1,1,1,2,1998,1998,0,No,0,0.99,0.0,-0.99,53,0,-53,47,0,-47,433.0,0.0,-433.0,0.0,0.0,0.0
<a href=/player/corpc001>corpc001</a>,Carlos Corporan,Houston Astros,ASTROS,1,1,1,2,2015,2019,4,No,0,-0.51,0.0,0.51,33,0,-33,121,0,-121,0.0,0.0,0.0,0.0,0.0,0.0
<a href=/player/corre001>corre001</a>,Ed Correa,Chicago White Sox,WSOX,2,6,5,11,1985,1991,6,No,0,14.64,2.56,-12.08,1223,446,-777,4038,1366,-2672,817.0,277.0,-540.0,640000.0,0.0,-640000.0
<a href=/player/corrf101>corrf101</a>,Frank Corridon,Chicago Cubs,CUBS,1,1,1,2,1904,1905,1,No,0,7.74,0.21,-7.53,277,100,-177,367,403,36,2861.0,0.0,-2861.0,0.0,0.0,0.0
<a href=/player/corrf101>corrf101</a>,Frank Corridon,Philadelphia Phillies,PHILS,1,2,2,4,1910,1914,4,No,0,-1.76,8.98,10.74,14,260,246,17,282,265,118.0,2276.0,2158.0,0.0,0.0,0.0
<a href=/player/corrf101>corrf101</a>,Frank Corridon,Cincinnati Reds,REDS,3,9,7,16,1910,1914,4,No,0,44.03,8.35,-35.68,2926,785,-2141,11991,2646,-9345,753.0,872.0,119.0,0.0,0.0,0.0
<a href=/player/corrk001>corrk001</a>,Kevin Correia,Minnesota Twins,TWINS,1,1,1,2,2014,2014,0,No,0,-1.38,0.0,1.38,18,0,-18,6,0,-6,74.0,0.0,-74.0,5500000.0,0.0,-5500000.0
<a href=/player/corrp102>corrp102</a>,Pat Corrales,Philadelphia Phillies,PHILS,9,17,16,33,1965,1984,19,No,0,32.54,23.78,-8.76,2044,2671,627,6114,5833,-281,1729.0,2166.0,437.0,32000.0,0.0,-32000.0
<a href=/player/corrp102>corrp102</a>,Pat Corrales,St. Louis Cardinals,CARDS,4,6,5,11,1968,1971,3,No,0,5.07,0.97,-4.1,849,114,-735,2705,290,-2415,0.0,0.0,0.0,0.0,0.0,0.0
<a href=/player/corrp102>corrp102</a>,Pat Corrales,Cincinnati Reds,REDS,1,1,1,2,1972,1973,1,No,0,-0.44,0.02,0.46,73,3,-70,214,2,-212,0.0,0.0,0.0,0.0,0.0,0.0
<a href=/player/corrr001>corrr001</a>,Rod Correia,Oakland Athletics,ATLTCS,1,1,1,2,1992,1992,0,No,0,-0.45,0.0,0.45,84,0,-84,184,0,-184,0.0,0.0,0.0,0.0,0.0,0.0
<a href=/player/corrr101>corrr101</a>,Red Corriden,Cincinnati Reds,REDS,3,8,5,13,1912,1913,1,No,0,9.38,6.71,-2.67,842,270,-572,2287,704,-1583,1567.0,500.0,-1067.0,11280.0,0.0,-11280.0
<a href=/player/corrv101>corrv101</a>,Vic Correll,Boston Red Sox,RSOX,1,1,1,2,1974,1974,0,No,0,-0.68,0.02,0.7,299,2,-297,1000,1,-999,0.0,0.0,0.0,0.0,0.0,0.0
<a href=/player/cortd001>cortd001</a>,David Cortes,Atlanta Braves,BRAVES,1,2,1,3,1998,1998,0,No,0,1.03,0.19,-0.84,187,28,-159,2,49,47,290.0,0.0,-290.0,0.0,0.0,0.0
<a href=/player/cortd001>cortd001</a>,David Cortes,Colorado Rockies,ROCKS,1,1,1,2,1998,1998,0,No,0,-0.03,0.0,0.03,8,0,-8,0,0,0,11.0,0.0,-11.0,0.0,0.0,0.0
<a href=/player/cortd002>cortd002</a>,Dan Cortes,Chicago White Sox,WSOX,1,2,1,3,2006,2009,3,No,0,0.0,0.32,0.32,0,103,103,0,0,0,0.0,266.0,266.0,0.0,0.0,0.0
<a href=/player/cortd002>cortd002</a>,Dan Cortes,Kansas City Royals,ROYALS,5,11,10,21,2009,2021,12,Yes,0,13.34,47.45,34.11,880,2988,2108,2084,10524,8440,3202.0,2429.0,-773.0,26600000.0,0.0,-26600000.0
<a href=/player/cortf001>cortf001</a>,Fernando Cortez,Tampa Bay Devil Rays,RAYS,1,2,1,3,2006,2012,6,No,0,0.65,3.83,3.18,266,274,8,855,7,-848,0.0,991.0,991.0,337200.0,0.0,-337200.0
<a href=/player/cortn001>cortn001</a>,Nestor Cortes,New York Yankees,YANKS,1,1,1,2,2019,2019,0,No,0,-0.64,0.0,0.64,5,0,-5,0,0,0,23.0,0.0,-23.0,0.0,0.0,0.0
<a href=/player/cosaj001>cosaj001</a>,Jarred Cosart,Philadelphia Phillies,PHILS,2,5,5,10,2011,2018,7,No,0,10.84,2.57,-8.27,1005,441,-564,3635,1629,-2006,674.0,0.0,-674.0,10400000.0,0.0,-10400000.0
<a href=/player/cosaj001>cosaj001</a>,Jarred Cosart,Houston Astros,ASTROS,3,8,7,15,2014,2019,5,Yes,0,5.86,22.81,16.95,902,718,-184,1801,1734,-67,1776.0,1238.0,-538.0,2712000.0,0.0,-2712000.0
<a href=/player/cosaj001>cosaj001</a>,Jarred Cosart,Miami Marlins,MARLNS,3,8,6,14,2016,2019,3,No,0,12.29,-0.08,-12.37,540,354,-186,600,126,-474,2851.0,1392.0,-1459.0,550000.0,0.0,-550000.0
<a href=/player/coscj101>coscj101</a>,Joe Coscarart,Seattle,Seattle,1,1,3,4,1934,1936,2,No,0,-1.51,0.0,1.51,190,0,-190,705,0,-705,0.0,0.0,0.0,0.0,0.0,0.0
<a href=/player/coscj101>coscj101</a>,Joe Coscarart,Boston Braves,BRAVES,1,2,1,3,1936,1940,4,No,0,0.0,8.2,8.2,0,205,205,0,253,253,0.0,2031.0,2031.0,0.0,0.0,0.0
<a href=/player/coscp101>coscp101</a>,Pete Coscarart,Brooklyn Dodgers,DOGRS,1,4,1,5,1941,1948,7,No,0,4.25,10.42,6.17,798,406,-392,2943,1540,-1403,336.0,0.0,-336.0,0.0,0.0,0.0
<a href=/player/cosgm101>cosgm101</a>,Mike Cosgrove,Toronto Blue Jays,BJAYS,1,1,1,2,1978,1978,0,No,0,0.0,0.0,0.0,0,0,0,0,0,0,0.0,0.0,0.0,0.0,0.0,0.0
<a href=/player/cosmj101>cosmj101</a>,Jim Cosman,St. Louis Cardinals,CARDS,2,3,2,5,1968,1969,1,No,0,-0.33,0.06,0.39,57,49,-8,101,68,-33,0.0,0.0,0.0,0.0,0.0,0.0
<a href=/player/costj001>costj001</a>,John Costello,St. Louis Cardinals,CARDS,1,1,1,2,1990,1992,2,No,0,-0.22,0.35,0.57,8,251,243,0,558,558,19.0,0.0,-19.0,105000.0,0.0,-105000.0
<a href=/player/costj001>costj001</a>,John Costello,Montreal Expos,NATEX,1,1,1,2,1990,1990,0,No,0,0.08,0.0,-0.08,54,0,-54,2,0,-2,105.0,0.0,-105.0,0.0,0.0,0.0
<a href=/player/costm001>costm001</a>,Mike Costanzo,Philadelphia Phillies,PHILS,1,3,2,5,2007,2011,4,No,0,12.75,0.63,-12.12,681,613,-68,2271,356,-1915,252.0,579.0,327.0,1217500.0,0.0,-1217500.0
<a href=/player/costm001>costm001</a>,Mike Costanzo,Houston Astros,ASTROS,1,5,1,6,2007,2009,2,No,0,11.62,3.81,-7.81,860,316,-544,1797,1340,-457,1330.0,0.0,-1330.0,382000.0,0.0,-382000.0
<a href=/player/costt001>costt001</a>,Tim Costo,Cleveland Indians,INDINS,3,5,4,9,1991,2011,20,No,2,-0.89,31.87,32.76,280,1811,1531,957,7142,6185,0.0,594.0,594.0,1117500.0,0.0,-1117500.0
<a href=/player/costt001>costt001</a>,Tim Costo,Cincinnati Reds,REDS,4,6,5,11,1994,1998,4,No,0,1.13,0.5,-0.63,524,257,-267,786,677,-109,1638.0,269.0,-1369.0,299000.0,0.0,-299000.0
<a href=/player/cotah001>cotah001</a>,Humberto Cota,Tampa Bay Devil Rays,RAYS,1,2,2,4,1999,2001,2,No,0,-1.06,1.13,2.19,241,216,-25,708,680,-28,0.0,91.0,91.0,0.0,0.0,0.0
<a href=/player/cothc001>cothc001</a>,Caleb Cotham,New York Yankees,YANKS,4,8,7,15,2015,2020,5,Yes,0,-1.49,8.03,9.52,440,197,-243,1007,8,-999,290.0,1270.0,980.0,3936900.0,0.0,-3936900.0
<a href=/player/cottc101>cottc101</a>,Chuck Cottier,Milwaukee Braves,BRAVES,1,4,2,6,1960,1966,6,No,0,17.87,5.81,-12.06,1212,765,-447,3111,2935,-176,1033.0,0.0,-1033.0,0.0,0.0,0.0
<a href=/player/cottc101>cottc101</a>,Chuck Cottier,Detroit Tigers,TIGRS,1,1,1,2,1961,1961,0,No,0,0.48,-0.79,-1.27,430,24,-406,1410,5,-1405,0.0,55.0,55.0,0.0,0.0,0.0
<a href=/player/cottc101>cottc101</a>,Chuck Cottier,Seattle Pilots,BREWRS,1,2,1,3,1968,1968,0,No,0,0.0,0.0,0.0,0,0,0,0,0,0,0.0,0.0,0.0,0.0,0.0,0.0
<a href=/player/cottd101>cottd101</a>,Dick Cotter,Philadelphia Phillies,PHILS,1,2,1,3,1912,1912,0,No,0,-0.17,-0.4,-0.23,26,24,-2,61,67,6,0.0,0.0,0.0,0.0,0.0,0.0
<a href=/player/cotth001>cotth001</a>,Henry Cotto,Chicago Cubs,CUBS,2,7,4,11,1984,1987,3,No,0,2.88,0.38,-2.5,447,379,-68,818,354,-464,766.0,789.0,23.0,873333.0,0.0,-873333.0
<a href=/player/cotth001>cotth001</a>,Henry Cotto,New York Yankees,YANKS,5,11,7,18,1987,2001,14,No,1,23.63,17.74,-5.89,1905,1277,-628,5748,3988,-1760,3609.0,1551.0,-2058.0,2400000.0,0.0,-2400000.0
<a href=/player/cotth001>cotth001</a>,Henry Cotto,Seattle Mariners,MARNRS,3,4,4,8,1993,1995,2,No,0,2.56,0.14,-2.42,232,106,-126,671,357,-314,133.0,12.0,-121.0,900000.0,0.0,-900000.0
<a href=/player/cottj001>cottj001</a>,Jharel Cotton,Los Angeles Dodgers,DOGRS,1,3,2,5,2016,2019,3,No,0,5.79,5.89,0.1,131,179,48,13,293,280,1774.0,1084.0,-690.0,0.0,0.0,0.0
<a href=/player/cottn001>cottn001</a>,Neal Cotts,Oakland Athletics,ATLTCS,4,8,8,16,2002,2012,10,No,2,15.18,3.42,-11.76,801,269,-532,480,656,176,4974.0,275.0,-4699.0,2433333.0,0.0,-2433333.0
<a href=/player/cottn001>cottn001</a>,Neal Cotts,Chicago White Sox,WSOX,2,2,4,6,2006,2011,5,No,0,-0.16,-0.4,-0.24,216,27,-189,2,0,-2,336.0,97.0,-239.0,400000.0,0.0,-400000.0
<a href=/player/cottn001>cottn001</a>,Neal Cotts,Milwaukee Brewers,BREWRS,1,1,1,2,2015,2015,0,No,0,-0.08,0.0,0.08,18,0,-18,0,0,0,41.0,0.0,-41.0,3000000.0,0.0,-3000000.0
<a href=/player/cougm101>cougm101</a>,Marlan Coughtry,Los Angeles Angels,ANGELS,1,1,1,2,1962,1962,0,No,0,0.19,-0.07,-0.26,6,40,34,16,51,35,0.0,0.0,0.0,0.0,0.0,0.0
<a href=/player/coulc101>coulc101</a>,Chip Coulter,St. Louis Cardinals,CARDS,9,16,14,30,1971,1976,5,No,0,14.55,3.01,-11.54,1564,430,-1134,3017,530,-2487,3834.0,1012.0,-2822.0,0.0,0.0,0.0
<a href=/player/coumf101>coumf101</a>,Fritz Coumbe,Boston Red Sox,RSOX,23,51,62,113,1914,1937,23,No,0,210.47,131.21,-79.26,10024,6525,-3499,28339,20821,-7518,29017.0,15462.0,-13555.0,136800.0,0.0,-136800.0
<a href=/player/coumf101>coumf101</a>,Fritz Coumbe,Cleveland Indians,INDINS,2,4,3,7,1920,1922,2,No,0,0.0,4.94,4.94,0,176,176,0,151,151,0.0,1214.0,1214.0,0.0,0.0,0.0
<a href=/player/counc001>counc001</a>,Craig Counsell,Colorado Rockies,ROCKS,2,2,2,4,1997,1999,2,No,0,2.24,-0.51,-2.75,215,135,-80,663,189,-474,51.0,38.0,-13.0,0.0,0.0,0.0
<a href=/player/counc001>counc001</a>,Craig Counsell,Florida Marlins,MARLNS,1,1,1,2,1999,1999,0,No,0,0.34,0.0,-0.34,50,0,-50,122,0,-122,0.0,0.0,0.0,245000.0,0.0,-245000.0
<a href=/player/counc001>counc001</a>,Craig Counsell,Arizona Diamondbacks,DBACKS,3,10,7,17,2003,2008,5,No,2,15.65,2.42,-13.23,2019,225,-1794,5161,413,-4748,3052.0,809.0,-2243.0,3950667.0,0.0,-3950667.0
<a href=/player/courc101>courc101</a>,Clint Courtney,New York Yankees,YANKS,13,34,28,62,1951,1970,19,No,0,44.17,77.56,33.39,5653,4508,-1145,17995,10870,-7125,3212.0,11561.0,8349.0,302500.0,0.0,-302500.0
<a href=/player/courc101>courc101</a>,Clint Courtney,Baltimore Orioles,ORLS,4,7,9,16,1954,1960,6,No,0,15.05,10.88,-4.17,745,881,136,1673,2506,833,2291.0,1208.0,-1083.0,0.0,0.0,0.0
<a href=/player/courc101>courc101</a>,Clint Courtney,Chicago White Sox,WSOX,17,31,30,61,1955,1969,14,No,0,22.96,44.36,21.4,3375,3578,203,7415,6981,-434,5139.0,7668.0,2529.0,156750.0,0.0,-156750.0
<a href=/player/courc101>courc101</a>,Clint Courtney,Washington Senators,TWINS,2,3,2,5,1960,1962,2,No,0,0.48,0.05,-0.43,150,222,72,361,823,462,0.0,80.0,80.0,0.0,0.0,0.0
<a href=/player/courc101>courc101</a>,Clint Courtney,Baltimore Orioles,ORLS,4,11,7,18,1961,1973,12,No,0,20.55,30.35,9.8,1602,1797,195,5528,6131,603,845.0,306.0,-539.0,72000.0,0.0,-72000.0
<a href=/player/coure101>coure101</a>,Ernie Courtney,New York Yankees,YANKS,1,2,1,3,1903,1909,6,No,0,0.01,19.09,19.08,92,667,575,343,2757,2414,0.0,0.0,0.0,0.0,0.0,0.0
<a href=/player/coure101>coure101</a>,Ernie Courtney,Detroit Tigers,TIGRS,1,4,2,6,1903,1911,8,No,0,0.0,16.79,16.79,0,801,801,0,3453,3453,0.0,39.0,39.0,0.0,0.0,0.0
<a href=/player/courj001>courj001</a>,John Courtright,Cincinnati Reds,REDS,6,12,8,20,1995,2010,15,No,0,11.19,26.95,15.76,438,1436,998,728,5040,4312,2595.0,2089.0,-506.0,13266667.0,0.0,-13266667.0
<a href=/player/coutj001>coutj001</a>,Jon Coutlangus,Cincinnati Reds,REDS,1,1,1,2,2008,2008,0,No,0,0.0,0.0,0.0,0,0,0,0,0,0,0.0,0.0,0.0,0.0,0.0,0.0
<a href=/player/coveh101>coveh101</a>,Harry Coveleski,Philadelphia Phillies,PHILS,1,2,2,4,1910,1914,4,No,0,-1.76,8.98,10.74,14,260,246,17,282,265,118.0,2276.0,2158.0,0.0,0.0,0.0
<a href=/player/coves101>coves101</a>,Stan Coveleski,Cleveland Indians,INDINS,1,1,2,3,1924,1926,2,No,0,9.07,1.24,-7.83,146,60,-86,190,31,-159,1502.0,281.0,-1221.0,7500.0,0.0,-7500.0
<a href=/player/covit101>covit101</a>,Tex Covington,Boston Braves,BRAVES,1,2,1,3,1918,1924,6,No,0,0.0,6.61,6.61,0,377,377,0,384,384,0.0,3083.0,3083.0,0.0,0.0,0.0
<a href=/player/coviw101>coviw101</a>,Wes Covington,Chicago White Sox,WSOX,11,17,21,38,1961,1969,8,No,0,15.81,27.33,11.52,1761,2250,489,3197,3489,292,3384.0,5251.0,1867.0,77750.0,0.0,-77750.0
<a href=/player/coviw101>coviw101</a>,Wes Covington,Kansas City Athletics,ATLTCS,1,1,1,2,1961,1964,3,No,0,4.13,1.74,-2.39,522,327,-195,1544,1037,-507,0.0,0.0,0.0,0.0,0.0,0.0
<a href=/player/coviw101>coviw101</a>,Wes Covington,Philadelphia Phillies,PHILS,1,1,1,2,1966,1966,0,No,0,-0.19,0.56,0.75,9,79,70,12,139,127,0.0,0.0,0.0,0.0,0.0,0.0
<a href=/player/cowab101>cowab101</a>,Billy Cowan,Chicago Cubs,CUBS,1,1,1,2,1965,1965,0,No,0,-0.74,-0.18,0.56,82,90,8,162,216,54,0.0,0.0,0.0,0.0,0.0,0.0
<a href=/player/cowab101>cowab101</a>,Billy Cowan,New York Mets,METS,3,5,4,9,1965,1968,3,No,0,-1.53,0.0,1.53,303,5,-298,741,5,-736,0.0,0.0,0.0,11000.0,0.0,-11000.0
<a href=/player/cowab101>cowab101</a>,Billy Cowan,Atlanta Braves,BRAVES,3,3,7,10,1966,1971,5,No,0,0.93,0.07,-0.86,220,226,6,719,711,-8,0.0,0.0,0.0,0.0,0.0,0.0
<a href=/player/cowab101>cowab101</a>,Billy Cowan,Chicago Cubs,CUBS,1,1,1,2,1966,1966,0,No,0,-0.17,0.0,0.17,34,0,-34,66,0,-66,0.0,0.0,0.0,0.0,0.0,0.0
<a href=/player/cowea001>cowea001</a>,Al Cowens,Kansas City Royals,ROYALS,3,5,4,9,1979,1986,7,No,0,14.42,8.44,-5.98,1272,909,-363,3936,3256,-680,0.0,0.0,0.0,0.0,0.0,0.0
<a href=/player/cowea001>cowea001</a>,Al Cowens,California Angels,ANGELS,2,2,3,5,1980,1983,3,No,0,11.24,4.47,-6.77,864,189,-675,3432,669,-2763,0.0,43.0,43.0,0.0,0.0,0.0
<a href=/player/cowgc001>cowgc001</a>,Collin Cowgill,Arizona Diamondbacks,DBACKS,6,12,12,24,2011,2021,10,Yes,0,55.85,12.58,-43.27,1986,909,-1077,2819,1176,-1643,7668.0,4077.0,-3591.0,13397833.0,0.0,-13397833.0
<a href=/player/cowgc001>cowgc001</a>,Collin Cowgill,Oakland Athletics,ATLTCS,1,1,1,2,2012,2014,2,No,0,-0.46,0.0,0.46,23,0,-23,63,0,-63,0.0,0.0,0.0,482500.0,0.0,-482500.0
<a href=/player/cowgc001>cowgc001</a>,Collin Cowgill,New York Mets,METS,1,1,1,2,2013,2013,0,Yes,0,2.7,0.0,-2.7,211,0,-211,466,0,-466,0.0,0.0,0.0,493520.0,0.0,-493520.0
<a href=/player/cowlj001>cowlj001</a>,Joe Cowley,New York Yankees,YANKS,8,20,16,36,1985,2001,16,No,1,26.31,24.47,-1.84,1960,2459,499,6255,8654,2399,4152.0,66.0,-4086.0,945873.0,0.0,-945873.0
<a href=/player/cowlj001>cowlj001</a>,Joe Cowley,Chicago White Sox,WSOX,2,3,2,5,1987,1988,1,No,0,3.17,2.88,-0.29,408,247,-161,1164,1016,-148,35.0,0.0,-35.0,460000.0,0.0,-460000.0
<a href=/player/cox-b101>cox-b101</a>,Billy Cox,Pittsburgh Pirates,PIRATS,1,3,3,6,1947,1950,3,No,0,26.56,1.84,-24.72,1156,287,-869,3340,710,-2630,3832.0,295.0,-3537.0,0.0,0.0,0.0
<a href=/player/cox-b101>cox-b101</a>,Billy Cox,Brooklyn Dodgers,DOGRS,1,2,3,5,1954,1954,0,No,0,0.54,0.0,-0.54,53,0,-53,213,0,-213,0.0,0.0,0.0,19000.0,0.0,-19000.0
<a href=/player/cox-b101>cox-b101</a>,Billy Cox,Baltimore Orioles,ORLS,2,3,3,6,1955,1956,1,No,0,5.21,-0.32,-5.53,337,154,-183,1279,434,-845,0.0,0.0,0.0,0.0,0.0,0.0
<a href=/player/cox-b102>cox-b102</a>,Bill Cox,Chicago White Sox,WSOX,2,2,2,4,1938,1947,9,No,0,-2.43,6.39,8.82,179,330,151,132,908,776,1157.0,1317.0,160.0,11300.0,0.0,-11300.0
<a href=/player/cox-b103>cox-b103</a>,Bobby Cox,Chicago Cubs,CUBS,2,3,2,5,1966,1966,0,No,0,-0.17,0.0,0.17,34,0,-34,66,0,-66,0.0,0.0,0.0,0.0,0.0,0.0
<a href=/player/cox-b103>cox-b103</a>,Bobby Cox,Atlanta Braves,BRAVES,2,2,5,7,1967,1971,4,No,0,0.93,0.07,-0.86,220,226,6,719,711,-8,0.0,0.0,0.0,0.0,0.0,0.0
<a href=/player/cox-c101>cox-c101</a>,Casey Cox,Texas Rangers,RNGRS,1,1,1,2,1972,1972,0,No,0,-0.07,-0.11,-0.04,11,10,-1,1,0,-1,44.0,10.0,-34.0,22500.0,0.0,-22500.0
<a href=/player/cox-d002>cox-d002</a>,Darron Cox,Cincinnati Reds,REDS,2,4,2,6,1993,1996,3,No,0,1.51,1.69,0.18,53,302,249,0,11,11,157.0,464.0,307.0,817000.0,0.0,-817000.0
<a href=/player/cox-d101>cox-d101</a>,Dick Cox,Portland,Portland,1,1,1,2,1924,1924,0,No,0,2.99,0.0,-2.99,246,0,-246,937,0,-937,0.0,0.0,0.0,0.0,0.0,0.0
<a href=/player/cox-j101>cox-j101</a>,Jeff Cox,Oakland Athletics,ATLTCS,1,2,3,5,1982,1982,0,No,0,0.0,-0.02,-0.02,0,8,8,0,20,20,0.0,0.0,0.0,0.0,0.0,0.0
<a href=/player/cox-l101>cox-l101</a>,Larry Cox,Philadelphia Phillies,PHILS,2,2,2,4,1975,1977,2,No,0,0.0,0.0,0.0,0,0,0,0,0,0,0.0,0.0,0.0,0.0,0.0,0.0
<a href=/player/cox-l101>cox-l101</a>,Larry Cox,Seattle Mariners,MARNRS,2,2,2,4,1977,1978,1,No,0,0.54,0.0,-0.54,61,0,-61,139,0,-139,0.0,0.0,0.0,0.0,0.0,0.0
<a href=/player/cox-l101>cox-l101</a>,Larry Cox,Chicago Cubs,CUBS,1,1,1,2,1979,1979,0,No,0,-0.17,0.0,0.17,205,0,-205,595,0,-595,0.0,0.0,0.0,0.0,0.0,0.0
<a href=/player/cox-l101>cox-l101</a>,Larry Cox,Seattle Mariners,MARNRS,2,7,7,14,1980,1985,5,No,0,8.79,3.61,-5.18,489,434,-55,632,1358,726,2623.0,1017.0,-1606.0,175000.0,0.0,-175000.0
<a href=/player/cox-t101>cox-t101</a>,Ted Cox,Boston Red Sox,RSOX,2,6,3,9,1978,1987,9,No,0,14.86,20.93,6.07,699,715,16,1362,2220,858,3997.0,3996.0,-1.0,0.0,0.0,0.0
<a href=/player/cox-t101>cox-t101</a>,Ted Cox,Cleveland Indians,INDINS,7,12,15,27,1979,2011,32,No,2,34.83,55.22,20.39,1613,2690,1077,5923,9199,3276,2682.0,4370.0,1688.0,1767500.0,0.0,-1767500.0
<a href=/player/cozac101>cozac101</a>,Charlie Cozart,Boston Braves,BRAVES,5,9,7,16,1945,1952,7,No,0,-0.23,24.05,24.28,358,893,535,547,3244,2697,596.0,423.0,-173.0,0.0,0.0,0.0
<a href=/player/cozaz001>cozaz001</a>,Zack Cozart,Anaheim Angels,ANGELS,1,2,2,4,2019,2019,0,Yes,0,0.0,0.0,0.0,0,0,0,0,0,0,0.0,0.0,0.0,12666667.0,0.0,-12666667.0
<a href=/player/crabe101>crabe101</a>,Estel Crabtree,Cincinnati Reds,REDS,2,3,2,5,1932,1936,4,No,0,1.3,1.6,0.3,315,394,79,966,1624,658,0.0,0.0,0.0,0.0,0.0,0.0
<a href=/player/crabt001>crabt001</a>,Tim Crabtree,Toronto Blue Jays,BJAYS,2,2,2,4,1998,2000,2,No,0,2.83,0.48,-2.35,256,54,-202,65,137,72,762.0,0.0,-762.0,0.0,0.0,0.0
<a href=/player/cradw101>cradw101</a>,Walt Craddock,Kansas City Athletics,ATLTCS,2,3,2,5,1959,1960,1,No,0,0.38,0.95,0.57,208,110,-98,47,6,-41,663.0,207.0,-456.0,0.0,0.0,0.0
<a href=/player/crafh101>crafh101</a>,Harry Craft,Cincinnati Reds,REDS,1,2,1,3,1942,1946,4,No,0,0.0,8.15,8.15,0,451,451,0,1756,1756,0.0,0.0,0.0,0.0,0.0,0.0
<a href=/player/crafm101>crafm101</a>,Molly Craft,Washington Senators,TWINS,3,6,4,10,1920,1933,13,No,0,2.2,13.36,11.16,219,847,628,852,3211,2359,0.0,616.0,616.0,2000.0,0.0,-2000.0
<a href=/player/cragh101>cragh101</a>,Howard Craghead,Oakland,Oakland,1,1,1,2,1931,1931,0,No,0,-0.09,0.0,0.09,30,0,-30,3,0,-3,69.0,0.0,-69.0,0.0,0.0,0.0
<a href=/player/cragh101>cragh101</a>,Howard Craghead,Brooklyn Dodgers,DOGRS,1,1,1,2,1934,1934,0,No,0,0.0,-0.05,-0.05,0,12,12,0,1,1,0.0,30.0,30.0,0.0,0.0,0.0
<a href=/player/craia001>craia001</a>,Allen Craig,St. Louis Cardinals,CARDS,1,2,3,5,2014,2015,1,Yes,0,1.43,5.3,3.87,264,83,-181,204,89,-115,1078.0,836.0,-242.0,0.0,0.0,0.0
<a href=/player/crair001>crair001</a>,Rod Craig,Seattle Mariners,MARNRS,1,1,1,2,1981,1981,0,No,0,-0.52,0.0,0.52,49,0,-49,71,0,-71,0.0,0.0,0.0,0.0,0.0,0.0
<a href=/player/crair101>crair101</a>,Roger Craig,New York Mets,METS,5,7,7,14,1963,1968,5,No,0,-1.04,-0.58,0.46,574,211,-363,1232,612,-620,498.0,0.0,-498.0,11000.0,0.0,-11000.0
<a href=/player/crair101>crair101</a>,Roger Craig,St. Louis Cardinals,CARDS,1,2,1,3,1964,1966,2,No,0,-0.38,-2.37,-1.99,106,64,-42,54,43,-11,193.0,373.0,180.0,0.0,0.0,0.0
<a href=/player/cramd102>cramd102</a>,Doc Cramer,Philadelphia Athletics,ATLTCS,1,2,3,5,1936,1936,0,No,0,2.69,-1.63,-4.32,1023,75,-948,4530,240,-4290,12.0,35.0,23.0,0.0,0.0,0.0
<a href=/player/cramd102>cramd102</a>,Doc Cramer,Boston Red Sox,RSOX,5,13,12,25,1940,1956,16,No,0,20.2,30.94,10.74,2442,1730,-712,7673,4243,-3430,4828.0,6235.0,1407.0,136500.0,0.0,-136500.0
<a href=/player/cramd102>cramd102</a>,Doc Cramer,Washington Senators,TWINS,3,5,4,9,1941,1946,5,No,0,3.39,-0.33,-3.72,1062,197,-865,4332,521,-3811,0.0,315.0,315.0,17000.0,0.0,-17000.0
<a href=/player/cramg101>cramg101</a>,Jerry Cram,Kansas City Royals,ROYALS,2,3,2,5,1973,1975,2,No,0,0.3,0.06,-0.24,41,220,179,3,772,769,132.0,15.0,-117.0,0.0,0.0,0.0
<a href=/player/cramg101>cramg101</a>,Jerry Cram,New York Mets,METS,1,1,1,2,1976,1976,0,No,0,-0.04,0.0,0.04,4,0,-4,0,0,0,13.0,0.0,-13.0,0.0,0.0,0.0
<a href=/player/crand101>crand101</a>,Doc Crandall,New York Giants,GIANTS,1,1,1,2,1913,1913,0,No,0,0.0,0.07,0.07,2,30,28,2,79,77,0.0,0.0,0.0,3300.0,0.0,-3300.0
<a href=/player/crand102>crand102</a>,Del Crandall,Milwaukee Braves,BRAVES,10,14,18,32,1963,1973,10,No,0,11.77,26.43,14.66,1218,1711,493,2811,4870,2059,2257.0,2054.0,-203.0,95000.0,0.0,-95000.0
<a href=/player/crand102>crand102</a>,Del Crandall,San Francisco Giants,GIANTS,4,5,5,10,1965,1972,7,No,0,-1.79,6.98,8.77,417,676,259,885,653,-232,457.0,3174.0,2717.0,17000.0,0.0,-17000.0
<a href=/player/crans102>crans102</a>,Sam Crane,Baltimore,Baltimore,2,2,6,8,1917,1926,9,No,0,0.62,0.0,-0.62,475,0,-475,1668,0,-1668,0.0,0.0,0.0,0.0,0.0,0.0
<a href=/player/cravg101>cravg101</a>,Gavvy Cravath,Chicago White Sox,WSOX,1,3,1,4,1909,1910,1,No,0,-0.91,1.19,2.1,140,48,-92,366,63,-303,237.0,502.0,265.0,2400.0,0.0,-2400.0
<a href=/player/crawc002>crawc002</a>,Carl Crawford,Boston Red Sox,RSOX,7,22,14,36,2012,2019,7,Yes,0,37.54,19.18,-18.36,2738,1439,-1299,4768,4566,-202,4720.0,1908.0,-2812.0,4708000.0,0.0,-4708000.0
<a href=/player/crawg101>crawg101</a>,Glenn Crawford,St. Louis Cardinals,CARDS,1,2,1,3,1945,1947,2,No,0,0.82,2.98,2.16,208,221,13,883,855,-28,0.0,0.0,0.0,0.0,0.0,0.0
<a href=/player/crawj002>crawj002</a>,J.P. Crawford,Philadelphia Phillies,PHILS,2,3,4,7,2018,2019,1,Yes,0,7.13,-0.08,-7.21,336,92,-244,1315,2,-1313,47.0,142.0,95.0,18878833.0,0.0,-18878833.0
<a href=/player/crawj101>crawj101</a>,Jake Crawford,St.Louis Browns,ORLS,1,1,3,4,1952,1953,1,No,0,0.0,-0.5,-0.5,0,57,57,0,111,111,0.0,0.0,0.0,0.0,0.0,0.0
<a href=/player/crawj102>crawj102</a>,Jim Crawford,Houston Astros,ASTROS,6,11,9,20,1975,1989,14,No,0,10.73,12.05,1.32,1452,1687,235,3403,4505,1102,3386.0,1859.0,-1527.0,22500.0,0.0,-22500.0
<a href=/player/crawp101>crawp101</a>,Pat Crawford,New York Giants,GIANTS,4,12,8,20,1930,1949,19,No,0,15.74,55.73,39.99,1379,2796,1417,3945,10503,6558,2269.0,334.0,-1935.0,0.0,0.0,0.0
<a href=/player/crawp101>crawp101</a>,Pat Crawford,Cincinnati Reds,REDS,3,7,3,10,1930,1932,2,No,0,-0.61,5.83,6.44,32,321,289,78,1329,1251,9.0,0.0,-9.0,5500.0,0.0,-5500.0
<a href=/player/craww101>craww101</a>,Willie Crawford,Los Angeles Dodgers,DOGRS,2,2,3,5,1976,1980,4,No,0,3.14,0.58,-2.56,380,210,-170,1405,594,-811,0.0,0.0,0.0,0.0,0.0,0.0
<a href=/player/craww101>craww101</a>,Willie Crawford,St. Louis Cardinals,CARDS,21,44,41,85,1976,1998,22,No,7,91.08,159.62,68.54,8485,7341,-1144,23608,25445,1837,10540.0,4019.0,-6521.0,3088333.0,0.0,-3088333.0
<a href=/player/craww101>craww101</a>,Willie Crawford,San Francisco Giants,GIANTS,1,2,2,4,1977,1979,2,No,0,-0.16,-0.23,-0.07,100,281,181,275,873,598,0.0,0.0,0.0,0.0,0.0,0.0
<a href=/player/craww101>craww101</a>,Willie Crawford,Houston Astros,ASTROS,2,2,3,5,1977,1989,12,No,0,-2.01,11.63,13.64,225,1155,930,447,2964,2517,0.0,408.0,408.0,705000.0,0.0,-705000.0
<a href=/player/creeb101>creeb101</a>,Birdie Cree,Baltimore,Baltimore,1,1,2,3,1914,1914,0,No,0,3.24,0.0,-3.24,151,0,-151,567,0,-567,0.0,0.0,0.0,0.0,0.0,0.0
<a href=/player/creed001>creed001</a>,Doug Creek,St. Louis Cardinals,CARDS,7,12,13,25,1995,2004,9,No,1,7.92,19.88,11.96,1477,1521,44,4061,3047,-1014,1672.0,2465.0,793.0,14938333.0,0.0,-14938333.0
<a href=/player/creek001>creek001</a>,Keith Creel,Kansas City Royals,ROYALS,1,1,1,2,1985,1988,3,No,0,0.31,-0.07,-0.38,15,4,-11,0,2,2,186.0,0.0,-186.0,0.0,0.0,0.0
<a href=/player/cresc001>cresc001</a>,Cesar Crespo,New York Mets,METS,3,6,4,10,1998,2002,4,No,0,4.04,-0.58,-4.62,267,21,-246,904,25,-879,36.0,163.0,127.0,362500.0,0.0,-362500.0
<a href=/player/cresc001>cresc001</a>,Cesar Crespo,Florida Marlins,MARLNS,8,11,19,30,2001,2013,12,No,0,78.22,23.68,-54.54,3802,1869,-1933,11801,2165,-9636,3483.0,6395.0,2912.0,18420219.0,0.0,-18420219.0
<a href=/player/cresc001>cresc001</a>,Cesar Crespo,San Diego Padres,PADRS,1,1,1,2,2002,2007,5,No,0,-0.39,0.0,0.39,52,0,-52,79,0,-79,0.0,0.0,0.0,0.0,0.0,0.0
<a href=/player/cresf001>cresf001</a>,Felipe Crespo,San Francisco Giants,GIANTS,1,1,1,2,2001,2001,0,No,0,-0.27,-0.56,-0.29,33,26,-7,47,0,-47,0.0,45.0,45.0,425000.0,0.0,-425000.0
<a href=/player/crewt001>crewt001</a>,Tim Crews,Milwaukee Brewers,BREWRS,1,2,1,3,1986,1991,5,No,0,9.4,4.13,-5.27,749,517,-232,173,1958,1785,2632.0,0.0,-2632.0,90000.0,0.0,-90000.0
<a href=/player/crick001>crick001</a>,Kyle Crick,San Francisco Giants,GIANTS,3,8,5,13,2018,2020,2,No,0,12.26,2.28,-9.98,738,296,-442,1562,1215,-347,600.0,0.0,-600.0,14750000.0,0.0,-14750000.0
<a href=/player/crics001>crics001</a>,Stefan Crichton,Baltimore Orioles,ORLS,1,1,1,2,2018,2018,0,No,0,0.6,0.0,-0.6,143,0,-143,0,0,0,239.0,0.0,-239.0,0.0,0.0,0.0
<a href=/player/cridj101>cridj101</a>,Jerry Crider,Minnesota Twins,TWINS,1,1,1,2,1969,1970,1,No,0,0.19,0.0,-0.19,64,0,-64,26,0,-26,273.0,0.0,-273.0,0.0,0.0,0.0
<a href=/player/crigl101>crigl101</a>,Lou Criger,Boston Red Sox,RSOX,1,1,2,3,1908,1908,0,No,0,0.74,0.0,-0.74,75,0,-75,254,0,-254,0.0,0.0,0.0,0.0,0.0,0.0
<a href=/player/crigl101>crigl101</a>,Lou Criger,St.Louis Browns,ORLS,1,1,2,3,1909,1914,5,No,0,-0.17,4.1,4.27,27,164,137,82,228,146,0.0,1597.0,1597.0,0.0,0.0,0.0
<a href=/player/crimc001>crimc001</a>,Chuck Crim,Milwaukee Brewers,BREWRS,3,6,5,11,1991,2001,10,No,0,-0.34,7.28,7.62,339,916,577,839,2349,1510,388.0,1418.0,1030.0,9763333.0,0.0,-9763333.0
<a href=/player/crimj101>crimj101</a>,Jack Crimian,St. Louis Cardinals,CARDS,3,5,3,8,1953,1957,4,No,0,0.94,3.21,2.27,322,305,-17,645,897,252,0.0,0.0,0.0,0.0,0.0,0.0
<a href=/player/crimj101>crimj101</a>,Jack Crimian,Toronto,Toronto,1,1,2,3,1955,1956,1,No,0,-0.36,0.0,0.36,109,0,-109,30,0,-30,383.0,0.0,-383.0,0.0,0.0,0.0
<a href=/player/crimj101>crimj101</a>,Jack Crimian,Kansas City Athletics,ATLTCS,40,86,88,174,1956,1976,20,No,0,134.11,73.29,-60.82,13270,9412,-3858,30102,25264,-4838,19786.0,12575.0,-7211.0,506100.0,0.0,-506100.0
<a href=/player/crisc001>crisc001</a>,Coco Crisp,St. Louis Cardinals,CARDS,1,2,1,3,2002,2002,0,No,0,9.03,0.46,-8.57,435,28,-407,1848,33,-1815,0.0,256.0,256.0,0.0,0.0,0.0
<a href=/player/crisc001>crisc001</a>,Coco Crisp,Cleveland Indians,INDINS,2,4,6,10,2006,2011,5,No,0,6.08,6.32,0.24,533,659,126,1913,1893,-20,29.0,785.0,756.0,1950000.0,0.0,-1950000.0
<a href=/player/crisc001>crisc001</a>,Coco Crisp,Boston Red Sox,RSOX,3,3,3,6,2008,2011,3,No,0,2.63,2.03,-0.6,242,122,-120,216,1,-215,304.0,336.0,32.0,6238333.0,0.0,-6238333.0
<a href=/player/crisc001>crisc001</a>,Coco Crisp,Oakland Athletics,ATLTCS,1,2,1,3,2016,2016,0,No,0,0.12,0.0,-0.12,20,0,-20,64,0,-64,0.0,0.0,0.0,0.0,0.0,0.0
<a href=/player/crisd102>crisd102</a>,Dave Criscione,Texas Rangers,RNGRS,2,2,2,4,1976,1983,7,No,0,0.06,0.27,0.21,7,39,32,10,0,-10,0.0,172.0,172.0,0.0,0.0,0.0
<a href=/player/crisl101>crisl101</a>,Leo Cristante,Chicago White Sox,WSOX,3,8,6,14,1954,1961,7,No,0,23.22,8.09,-15.13,1221,1065,-156,3572,3021,-551,2246.0,488.0,-1758.0,62000.0,0.0,-62000.0
<a href=/player/crisl101>crisl101</a>,Leo Cristante,Detroit Tigers,TIGRS,4,7,7,14,1955,1964,9,No,0,0.54,14.97,14.43,185,396,211,295,399,104,451.0,2991.0,2540.0,0.0,0.0,0.0
<a href=/player/crisp101>crisp101</a>,Pat Crisham,Brooklyn Dodgers,DOGRS,2,4,2,6,1899,1902,3,No,0,3.35,2.49,-0.86,192,219,27,742,830,88,0.0,0.0,0.0,0.0,0.0,0.0
<a href=/player/crith101>crith101</a>,Hughie Critz,Cincinnati Reds,REDS,1,1,1,2,1930,1935,5,No,0,4.07,2.73,-1.34,676,316,-360,2985,266,-2719,0.0,2226.0,2226.0,16000.0,0.0,-16000.0
<a href=/player/cronc002>cronc002</a>,C.J. Cron,Anaheim Angels,ANGELS,1,1,1,2,2018,2018,0,Yes,0,2.33,0.0,-2.33,140,0,-140,560,0,-560,0.0,0.0,0.0,0.0,0.0,0.0
<a href=/player/cronj001>cronj001</a>,Jake Cronenworth,Tampa Bay Devil Rays,RAYS,1,2,3,5,2019,2020,1,Yes,0,7.81,-0.02,-7.83,393,42,-351,1521,139,-1382,2.0,0.0,-2.0,4100000.0,0.0,-4100000.0
<a href=/player/cronj101>cronj101</a>,Joe Cronin,Washington Senators,TWINS,2,2,3,5,1934,1937,3,No,0,31.56,-0.69,-32.25,1409,59,-1350,5830,180,-5650,0.0,0.0,0.0,30000.0,0.0,-30000.0
<a href=/player/cronj102>cronj102</a>,Jack Cronin,New York Giants,GIANTS,5,14,7,21,1903,1921,18,No,0,51.29,48.92,-2.37,2751,2179,-572,9350,7604,-1746,2651.0,2915.0,264.0,6400.0,0.0,-6400.0
<a href=/player/cronj103>cronj103</a>,Jim Cronin,Philadelphia Athletics,ATLTCS,1,4,2,6,1929,1936,7,No,0,0.0,5.27,5.27,0,394,394,0,395,395,0.0,2946.0,2946.0,7500.0,0.0,-7500.0
<a href=/player/cronj103>cronj103</a>,Jim Cronin,Portland,Portland,1,1,2,3,1929,1930,1,No,0,0.04,0.0,-0.04,25,0,-25,63,0,-63,0.0,0.0,0.0,0.0,0.0,0.0
<a href=/player/cronr101>cronr101</a>,Ray Crone,Milwaukee Braves,BRAVES,1,3,1,4,1957,1960,3,No,0,3.25,5.66,2.41,395,272,-123,1122,1140,18,434.0,0.0,-434.0,0.0,0.0,0.0
<a href=/player/cronr101>cronr101</a>,Ray Crone,San Francisco Giants,GIANTS,1,1,1,2,1958,1958,0,No,0,0.0,-0.49,-0.49,0,34,34,0,3,3,0.0,69.0,69.0,0.0,0.0,0.0
<a href=/player/crooj101>crooj101</a>,Jack Crooks,Washington Senators,WSN,1,3,1,4,1896,1897,1,No,0,-1.24,0.18,1.42,153,159,6,636,662,26,0.0,0.0,0.0,0.0,0.0,0.0
<a href=/player/crosb001>crosb001</a>,Bubba Crosby,Los Angeles Dodgers,DOGRS,1,2,1,3,2003,2004,1,No,0,0.65,0.19,-0.46,406,152,-254,260,302,42,712.0,3.0,-709.0,0.0,0.0,0.0
<a href=/player/crosb002>crosb002</a>,Bobby Crosby,Pittsburgh Pirates,PIRATS,1,3,3,6,2010,2011,1,No,0,-0.12,0.71,0.83,82,105,23,69,301,232,68.0,0.0,-68.0,3450000.0,0.0,-3450000.0
<a href=/player/crose101>crose101</a>,Ed Crosby,St. Louis Cardinals,CARDS,1,2,2,4,1973,1974,1,No,0,0.19,0.24,0.05,36,16,-20,60,0,-60,0.0,24.0,24.0,0.0,0.0,0.0
<a href=/player/crose101>crose101</a>,Ed Crosby,St. Louis Cardinals,CARDS,5,7,6,13,1974,1977,3,No,0,-2.01,-0.59,1.42,565,81,-484,1331,100,-1231,66.0,23.0,-43.0,0.0,0.0,0.0
<a href=/player/crosf103>crosf103</a>,Frankie Crosetti,SanFrancisco,SanFrancisco,1,1,2,3,1930,1931,1,No,0,24.49,0.0,-24.49,1683,0,-1683,7268,0,-7268,0.0,0.0,0.0,0.0,0.0,0.0
<a href=/player/crosk101>crosk101</a>,Ken Crosby,New York Yankees,YANKS,1,2,1,3,1973,1974,1,No,0,0.0,0.04,0.04,0,7,7,0,0,0,0.0,46.0,46.0,0.0,0.0,0.0
<a href=/player/crosk101>crosk101</a>,Ken Crosby,St. Louis Cardinals,CARDS,2,2,2,4,1975,1977,2,No,0,3.7,-0.38,-4.08,206,52,-154,136,5,-131,1203.0,111.0,-1092.0,0.0,0.0,0.0
<a href=/player/crosl101>crosl101</a>,Lave Cross,Philadelphia Phillies,PHILS,1,5,3,8,1897,1902,5,No,0,9.88,14.87,4.99,647,845,198,2475,2785,310,1192.0,3296.0,2104.0,0.0,0.0,0.0
<a href=/player/crosm101>crosm101</a>,Monte Cross,Pittsburgh Pirates,PIRATS,1,3,1,4,1896,1901,5,No,0,1.66,8.07,6.41,433,743,310,1375,3049,1674,1892.0,0.0,-1892.0,0.0,0.0,0.0
<a href=/player/crosm101>crosm101</a>,Monte Cross,St. Louis Cardinals,CARDS,2,4,7,11,1897,1899,2,No,0,17.28,9.65,-7.63,1436,631,-805,5066,2410,-2656,3837.0,1192.0,-2645.0,0.0,0.0,0.0
<a href=/player/croub101>croub101</a>,Buck Crouse,Muskegon,Muskegon,1,1,1,2,1923,1923,0,No,0,3.5,0.0,-3.5,470,0,-470,1469,0,-1469,0.0,0.0,0.0,0.0,0.0,0.0
<a href=/player/croub103>croub103</a>,Bill Crouch,Brooklyn Dodgers,DOGRS,2,9,3,12,1940,1947,7,No,0,2.8,7.69,4.89,657,371,-286,1221,447,-774,1499.0,2793.0,1294.0,17500.0,0.0,-17500.0
<a href=/player/crouf101>crouf101</a>,Frank Croucher,Detroit Tigers,TIGRS,1,2,2,4,1941,1948,7,No,0,0.26,3.39,3.13,148,1062,914,484,4332,3848,0.0,0.0,0.0,10000.0,0.0,-10000.0
<a href=/player/crouf101>crouf101</a>,Frank Croucher,Washington Senators,TWINS,2,3,2,5,1942,1943,1,No,0,0.0,-0.59,-0.59,0,49,49,0,37,37,0.0,315.0,315.0,0.0,0.0,0.0
<a href=/player/crouh001>crouh001</a>,Hans Crouse,Texas Rangers,RNGRS,1,4,3,7,2021,2021,0,Yes,0,0.8,-1.21,-2.01,74,9,-65,29,0,-29,300.0,64.0,-236.0,9766666.0,0.0,-9766666.0
<a href=/player/crouj101>crouj101</a>,Jack Crouch,St.Louis Browns,ORLS,6,8,9,17,1933,1947,14,No,0,4.89,14.56,9.67,718,1651,933,2367,5208,2841,122.0,1515.0,1393.0,19500.0,0.0,-19500.0
<a href=/player/crouj101>crouj101</a>,Jack Crouch,St.Louis Browns,ORLS,1,1,1,2,1931,1931,0,No,0,0.0,-0.51,-0.51,0,40,40,0,144,144,0.0,0.0,0.0,0.0,0.0,0.0
<a href=/player/crour001>crour001</a>,Rich Croushore,St. Louis Cardinals,CARDS,2,6,4,10,1999,2003,4,No,0,3.2,2.78,-0.42,870,638,-232,626,106,-520,1171.0,1638.0,467.0,860000.0,0.0,-860000.0
<a href=/player/crour001>crour001</a>,Rich Croushore,Colorado Rockies,ROCKS,7,13,12,25,2000,2002,2,No,0,6.04,1.37,-4.67,876,433,-443,660,150,-510,2239.0,928.0,-1311.0,9375000.0,0.0,-9375000.0
<a href=/player/crour001>crour001</a>,Rich Croushore,Boston Red Sox,RSOX,1,1,1,2,2001,2001,0,No,0,0.0,0.0,0.0,0,0,0,0,0,0,0.0,0.0,0.0,0.0,0.0,0.0
<a href=/player/crowa001>crowa001</a>,Aaron Crow,Kansas City Royals,ROYALS,1,1,2,3,2014,2019,5,Yes,0,0.0,1.69,1.69,0,103,103,0,1,1,0.0,488.0,488.0,1475000.0,0.0,-1475000.0
<a href=/player/crowd001>crowd001</a>,Dean Crow,Seattle Mariners,MARNRS,1,3,2,5,1997,1998,1,No,0,0.42,-0.64,-1.06,53,29,-24,0,2,2,389.0,290.0,-99.0,1300000.0,0.0,-1300000.0
<a href=/player/crowd001>crowd001</a>,Dean Crow,Detroit Tigers,TIGRS,4,11,7,18,1999,2002,3,No,1,3.62,7.62,4.0,1493,652,-841,3797,1742,-2055,861.0,1164.0,303.0,6750000.0,0.0,-6750000.0
<a href=/player/crowg101>crowg101</a>,George Crowe,Milwaukee Braves,BRAVES,1,1,2,3,1956,1958,2,No,0,2.52,1.6,-0.92,321,61,-260,1082,221,-861,0.0,0.0,0.0,0.0,0.0,0.0
<a href=/player/crowg101>crowg101</a>,George Crowe,Cincinnati Reds,REDS,3,5,8,13,1958,1966,8,No,0,5.3,5.9,0.6,751,639,-112,1876,2223,347,111.0,126.0,15.0,0.0,0.0,0.0
<a href=/player/crowg102>crowg102</a>,General Crowder,Washington Senators,TWINS,1,1,1,2,1927,1928,1,No,0,10.9,0.35,-10.55,230,70,-160,243,79,-164,1985.0,612.0,-1373.0,6000.0,0.0,-6000.0
<a href=/player/crowg102>crowg102</a>,General Crowder,St.Louis Browns,ORLS,21,40,49,89,1930,1952,22,No,0,132.72,109.57,-23.15,6415,9088,2673,21139,29444,8305,12102.0,15510.0,3408.0,207500.0,0.0,-207500.0
<a href=/player/crowj001>crowj001</a>,Jim Crowell,Cleveland Indians,INDINS,1,4,2,6,1997,1998,1,No,0,5.24,-0.51,-5.75,1014,98,-916,190,187,-3,2567.0,112.0,-2455.0,0.0,0.0,0.0
<a href=/player/crowt101>crowt101</a>,Terry Crowley,Cincinnati Reds,REDS,2,2,2,4,1976,1976,0,No,0,0.0,0.0,0.0,7,0,-7,7,0,-7,0.0,0.0,0.0,0.0,0.0,0.0
<a href=/player/croww001>croww001</a>,Wil Crowe,Washington Nationals,NATEX,1,2,1,3,2020,2020,0,Yes,0,-0.15,0.0,0.15,53,0,-53,41,0,-41,350.0,0.0,-350.0,0.0,0.0,0.0
<a href=/player/croze001>croze001</a>,Eric Crozier,Cleveland Indians,INDINS,1,1,1,2,2004,2004,0,No,0,0.08,0.37,0.29,14,24,10,39,80,41,0.0,0.0,0.0,0.0,0.0,0.0
<a href=/player/crucf001>crucf001</a>,Francisco Cruceta,Los Angeles Dodgers,DOGRS,1,3,1,4,2002,2004,2,No,0,-0.33,0.6,0.93,92,177,85,4,5,1,830.0,299.0,-531.0,3250000.0,0.0,-3250000.0
<a href=/player/crudm001>crudm001</a>,Mike Crudale,St. Louis Cardinals,CARDS,1,2,1,3,2003,2003,0,No,0,0.23,0.18,-0.05,18,36,18,0,0,0,28.0,54.0,26.0,0.0,0.0,0.0
<a href=/player/cruiw101>cruiw101</a>,Walton Cruise,Jacksonville,Jacksonville,1,1,1,2,1914,1914,0,No,0,4.18,0.0,-4.18,330,0,-330,1185,0,-1185,0.0,0.0,0.0,0.0,0.0,0.0
<a href=/player/crumc101>crumc101</a>,Cal Crum,Boston Braves,BRAVES,1,2,1,3,1918,1924,6,No,0,0.0,6.61,6.61,0,377,377,0,384,384,0.0,3083.0,3083.0,0.0,0.0,0.0
<a href=/player/crumr101>crumr101</a>,Roy Crumpler,Detroit Tigers,TIGRS,1,9,2,11,1921,1941,20,No,0,0.0,3.03,3.03,0,202,202,0,144,144,0.0,1168.0,1168.0,3000.0,0.0,-3000.0
<a href=/player/cruzd001>cruzd001</a>,Deivi Cruz,Los Angeles Dodgers,DOGRS,1,2,1,3,1996,1997,1,No,0,5.99,0.0,-5.99,703,0,-703,2550,0,-2550,0.0,0.0,0.0,0.0,0.0,0.0
<a href=/player/cruzd001>cruzd001</a>,Deivi Cruz,San Francisco Giants,GIANTS,1,1,1,2,2005,2005,0,No,0,-0.11,0.0,0.11,20,0,-20,54,0,-54,0.0,0.0,0.0,800000.0,0.0,-800000.0
<a href=/player/cruze001>cruze001</a>,Enrique Cruz,Milwaukee Brewers,BREWRS,2,3,2,5,2006,2008,2,No,1,0.0,2.38,2.38,0,391,391,0,0,0,0.0,399.0,399.0,0.0,0.0,0.0
<a href=/player/cruzf001>cruzf001</a>,Fausto Cruz,Oakland Athletics,ATLTCS,1,2,1,3,1996,1996,0,No,0,-0.36,-1.09,-0.73,14,73,59,40,263,223,0.0,0.0,0.0,0.0,0.0,0.0
<a href=/player/cruzh101>cruzh101</a>,Hector Cruz,St. Louis Cardinals,CARDS,18,38,36,74,1977,1998,21,No,7,91.47,158.37,66.9,7749,7153,-596,23063,25308,2245,8671.0,3716.0,-4955.0,3088333.0,0.0,-3088333.0
<a href=/player/cruzh101>cruzh101</a>,Hector Cruz,Chicago Cubs,CUBS,2,2,2,4,1978,1982,4,No,0,-0.38,6.63,7.01,106,367,261,248,237,-11,65.0,1587.0,1522.0,0.0,0.0,0.0
<a href=/player/cruzh101>cruzh101</a>,Hector Cruz,San Francisco Giants,GIANTS,1,1,1,2,1979,1980,1,No,0,0.27,-0.45,-0.72,126,60,-66,298,3,-295,0.0,138.0,138.0,0.0,0.0,0.0
<a href=/player/cruzh101>cruzh101</a>,Hector Cruz,Cincinnati Reds,REDS,2,2,2,4,1980,1983,3,No,0,-0.22,-1.97,-1.75,88,175,87,175,252,77,0.0,269.0,269.0,0.0,0.0,0.0
<a href=/player/cruzj002>cruzj002</a>,Julio Cruz,Seattle Mariners,MARNRS,2,2,3,5,1983,1986,3,No,0,7.91,6.82,-1.09,932,587,-345,3406,2494,-912,0.0,0.0,0.0,425000.0,0.0,-425000.0
<a href=/player/cruzj003>cruzj003</a>,Jacob Cruz,San Francisco Giants,GIANTS,5,7,9,16,1998,2008,10,No,2,4.17,4.04,-0.13,448,693,245,250,471,221,1207.0,1349.0,142.0,1508500.0,0.0,-1508500.0
<a href=/player/cruzj003>cruzj003</a>,Jacob Cruz,Cleveland Indians,INDINS,4,6,9,15,2001,2011,10,No,0,5.18,10.77,5.59,588,1134,546,2019,3716,1697,29.0,785.0,756.0,2536200.0,0.0,-2536200.0
<a href=/player/cruzj004>cruzj004</a>,Jose Cruz,Seattle Mariners,MARNRS,4,4,6,10,1997,2003,6,No,2,10.57,1.28,-9.29,708,186,-522,2905,0,-2905,34.0,643.0,609.0,255000.0,0.0,-255000.0
<a href=/player/cruzj004>cruzj004</a>,Jose Cruz,Tampa Bay Devil Rays,RAYS,1,2,1,3,2005,2007,2,No,0,-1.33,-0.8,0.53,64,109,45,245,5,-240,0.0,1106.0,1106.0,0.0,0.0,0.0
<a href=/player/cruzj004>cruzj004</a>,Jose Cruz,Arizona Diamondbacks,DBACKS,1,2,2,4,2005,2005,0,No,0,-0.2,0.0,0.2,4,0,-4,13,0,-13,0.0,0.0,0.0,4000000.0,0.0,-4000000.0
<a href=/player/cruzj005>cruzj005</a>,Juan Cruz,Chicago Cubs,CUBS,2,4,3,7,2004,2004,0,No,0,1.21,-0.22,-1.43,97,23,-74,6,19,13,216.0,5.0,-211.0,300000.0,0.0,-300000.0
<a href=/player/cruzj005>cruzj005</a>,Juan Cruz,Atlanta Braves,BRAVES,1,3,1,4,2004,2013,9,No,0,-3.0,25.61,28.61,78,476,398,55,578,523,230.0,4719.0,4489.0,370000.0,0.0,-370000.0
<a href=/player/cruzj005>cruzj005</a>,Juan Cruz,Oakland Athletics,ATLTCS,1,1,1,2,2006,2008,2,No,0,3.52,0.44,-3.08,276,54,-222,28,0,-28,622.0,283.0,-339.0,0.0,0.0,0.0
<a href=/player/cruzl001>cruzl001</a>,Luis Cruz,Boston Red Sox,RSOX,1,1,1,2,2002,2004,2,No,0,0.0,-0.39,-0.39,0,52,52,0,79,79,0.0,0.0,0.0,0.0,0.0,0.0
<a href=/player/cruzn001>cruzn001</a>,Nelson Cruz,Detroit Tigers,TIGRS,2,4,4,8,2000,2002,2,No,1,3.02,0.94,-2.08,1389,171,-1218,3537,610,-2927,741.0,454.0,-287.0,5550000.0,0.0,-5550000.0
<a href=/player/cruzn001>cruzn001</a>,Nelson Cruz,Houston Astros,ASTROS,1,1,1,2,2002,2002,0,No,0,-0.43,0.0,0.43,39,0,-39,15,0,-15,161.0,0.0,-161.0,375000.0,0.0,-375000.0
<a href=/player/cruzn002>cruzn002</a>,Nelson Cruz,New York Mets,METS,1,1,1,2,2000,2003,3,No,0,0.0,0.01,0.01,0,47,47,0,92,92,0.0,0.0,0.0,0.0,0.0,0.0
<a href=/player/cruzn002>cruzn002</a>,Nelson Cruz,Oakland Athletics,ATLTCS,1,2,1,3,2004,2006,2,No,0,-0.55,-0.87,-0.32,86,51,-35,10,156,146,151.0,0.0,-151.0,0.0,0.0,0.0
<a href=/player/cruzn002>cruzn002</a>,Nelson Cruz,Milwaukee Brewers,BREWRS,10,19,21,40,2006,2020,14,Yes,1,46.28,26.59,-19.69,3627,1663,-1964,13855,4499,-9356,777.0,3218.0,2441.0,28905500.0,0.0,-28905500.0
<a href=/player/cruzn002>cruzn002</a>,Nelson Cruz,Minnesota Twins,TWINS,1,2,2,4,2021,2021,0,Yes,0,0.48,0.33,-0.15,55,6,-49,238,2,-236,0.0,80.0,80.0,13000000.0,0.0,-13000000.0
<a href=/player/cruzo001>cruzo001</a>,Oneil Cruz,Los Angeles Dodgers,DOGRS,1,2,1,3,2017,2017,0,No,0,0.11,0.39,0.28,2,48,46,9,0,-9,0.0,60.0,60.0,0.0,0.0,0.0
<a href=/player/cruzt001>cruzt001</a>,Todd Cruz,Philadelphia Phillies,PHILS,1,1,1,2,1979,1980,1,No,0,0.34,-0.26,-0.6,55,64,9,126,7,-119,0.0,183.0,183.0,0.0,0.0,0.0
<a href=/player/cruzt001>cruzt001</a>,Todd Cruz,Kansas City Royals,ROYALS,3,5,4,9,1979,1986,7,No,0,14.42,8.44,-5.98,1272,909,-363,3936,3256,-680,0.0,0.0,0.0,0.0,0.0,0.0
<a href=/player/cruzt001>cruzt001</a>,Todd Cruz,California Angels,ANGELS,1,1,1,2,1980,1980,0,No,0,-0.28,0.0,0.28,90,0,-90,311,0,-311,0.0,0.0,0.0,0.0,0.0,0.0
<a href=/player/cruzt001>cruzt001</a>,Todd Cruz,Chicago White Sox,WSOX,6,11,9,20,1981,1994,13,No,0,14.41,9.4,-5.01,691,899,208,1049,2235,1186,4103.0,4503.0,400.0,1513333.0,0.0,-1513333.0
<a href=/player/cruzt002>cruzt002</a>,Tony Cruz,St. Louis Cardinals,CARDS,1,1,1,2,2015,2015,0,Yes,0,-0.12,0.0,0.12,4,0,-4,5,0,-5,0.0,0.0,0.0,775000.0,0.0,-775000.0
<a href=/player/cruzt101>cruzt101</a>,Tommy Cruz,St. Louis Cardinals,CARDS,5,9,6,15,1973,1976,3,No,0,2.63,1.5,-1.13,416,182,-234,619,510,-109,1142.0,401.0,-741.0,7800.0,0.0,-7800.0
<a href=/player/cruzt101>cruzt101</a>,Tommy Cruz,Chicago White Sox,WSOX,1,3,3,6,1977,1978,1,No,0,1.55,0.0,-1.55,299,0,-299,869,0,-869,0.0,0.0,0.0,70000.0,0.0,-70000.0
<a href=/player/cruzv101>cruzv101</a>,Victor Cruz,St. Louis Cardinals,CARDS,10,22,18,40,1977,1998,21,No,4,72.28,127.33,55.05,5696,4654,-1042,17434,16355,-1079,7151.0,4578.0,-2573.0,1533333.0,0.0,-1533333.0
<a href=/player/cruzv101>cruzv101</a>,Victor Cruz,Toronto Blue Jays,BJAYS,2,4,3,7,1978,1987,9,No,0,9.74,-0.53,-10.27,696,982,286,2252,3389,1137,494.0,317.0,-177.0,650000.0,0.0,-650000.0
<a href=/player/cruzv101>cruzv101</a>,Victor Cruz,Cleveland Indians,INDINS,6,11,12,23,1980,2011,31,No,2,35.2,55.22,20.02,1530,2690,1160,5654,9199,3545,2682.0,4370.0,1688.0,1767500.0,0.0,-1767500.0
<a href=/player/cruzv101>cruzv101</a>,Victor Cruz,Pittsburgh Pirates,PIRATS,1,1,1,2,1982,1984,2,No,0,0.8,-0.08,-0.88,18,3,-15,0,3,3,75.0,0.0,-75.0,0.0,0.0,0.0
<a href=/player/cubbm101>cubbm101</a>,Mike Cubbage,Texas Rangers,RNGRS,5,14,9,23,1976,1988,12,No,0,43.04,39.52,-3.52,2266,2145,-121,8188,7408,-780,2609.0,4285.0,1676.0,330000.0,0.0,-330000.0
<a href=/player/cubid001>cubid001</a>,Darwin Cubillan,Toronto Blue Jays,BJAYS,1,2,1,3,2000,2002,2,No,0,25.41,3.65,-21.76,1836,80,-1756,8047,8,-8039,53.0,1300.0,1247.0,0.0,0.0,0.0
<a href=/player/cubid001>cubid001</a>,Darwin Cubillan,Texas Rangers,RNGRS,1,1,1,2,2001,2001,0,No,0,0.24,0.0,-0.24,55,0,-55,0,0,0,79.0,0.0,-79.0,0.0,0.0,0.0
<a href=/player/cuccc101>cuccc101</a>,Cookie Cuccurullo,Pittsburgh Pirates,PIRATS,1,1,1,2,1946,1946,0,No,0,0.0,0.0,0.0,0,0,0,0,0,0,0.0,0.0,0.0,0.0,0.0,0.0
<a href=/player/cucct101>cucct101</a>,Tony Cuccinello,Cincinnati Reds,REDS,5,9,12,21,1932,1942,10,No,0,46.0,30.81,-15.19,3034,1950,-1084,10521,6810,-3711,2379.0,542.0,-1837.0,5500.0,0.0,-5500.0
<a href=/player/cucct101>cucct101</a>,Tony Cuccinello,Brooklyn Dodgers,DOGRS,5,10,8,18,1935,1948,13,No,0,23.18,15.94,-7.24,1423,1121,-302,4586,3821,-765,1769.0,791.0,-978.0,0.0,0.0,0.0
<a href=/player/cucct101>cucct101</a>,Tony Cuccinello,Boston Braves,BRAVES,1,1,2,3,1940,1943,3,No,0,-0.49,4.14,4.63,88,264,176,324,377,53,0.0,1753.0,1753.0,0.0,0.0,0.0
<a href=/player/cuelb101>cuelb101</a>,Bobby Cuellar,Texas Rangers,RNGRS,2,3,2,5,1978,1984,6,No,0,4.64,3.01,-1.63,361,454,93,939,1279,340,0.0,259.0,259.0,0.0,0.0,0.0
<a href=/player/cuelm101>cuelm101</a>,Mike Cuellar,St. Louis Cardinals,CARDS,10,18,16,34,1965,1976,11,No,0,25.61,13.65,-11.96,1956,974,-982,3292,632,-2660,6302.0,2494.0,-3808.0,0.0,0.0,0.0
<a href=/player/cuelm101>cuelm101</a>,Mike Cuellar,Houston Astros,ASTROS,2,4,3,7,1968,1970,2,No,0,13.55,1.65,-11.9,563,230,-333,804,931,127,6085.0,0.0,-6085.0,0.0,0.0,0.0
<a href=/player/cuetd101>cuetd101</a>,Bert Cueto,Minnesota Twins,TWINS,1,1,1,2,1962,1969,7,No,0,0.0,-0.14,-0.14,0,21,21,0,53,53,0.0,0.0,0.0,0.0,0.0,0.0
<a href=/player/cuetj001>cuetj001</a>,Johnny Cueto,Cincinnati Reds,REDS,2,3,4,7,2015,2021,6,Yes,0,0.37,-1.23,-1.6,27,231,204,0,147,147,281.0,1419.0,1138.0,10000000.0,0.0,-10000000.0
<a href=/player/cuetm101>cuetm101</a>,Manuel Cueto,Cincinnati Reds,REDS,1,2,1,3,1920,1920,0,No,0,0.0,-0.61,-0.61,0,10,10,0,8,8,0.0,55.0,55.0,0.0,0.0,0.0
<a href=/player/cuevn001>cuevn001</a>,Noel Cuevas,Los Angeles Dodgers,DOGRS,1,1,1,2,2014,2015,1,No,0,-1.35,0.28,1.63,76,105,29,155,1,-154,0.0,175.0,175.0,0.0,0.0,0.0
<a href=/player/culbc001>culbc001</a>,Charlie Culberson,San Francisco Giants,GIANTS,1,1,2,3,2012,2015,3,No,0,-1.89,4.02,5.91,142,193,51,337,828,491,0.0,0.0,0.0,0.0,0.0,0.0
<a href=/player/culbc001>culbc001</a>,Charlie Culberson,Los Angeles Dodgers,DOGRS,4,17,9,26,2017,2021,4,Yes,0,6.07,9.48,3.41,927,279,-648,2727,1007,-1720,545.0,229.0,-316.0,71371000.0,0.0,-71371000.0
<a href=/player/culbl101>culbl101</a>,Leon Culberson,Boston Red Sox,RSOX,5,13,10,23,1947,1956,9,No,0,13.4,14.7,1.3,2053,1460,-593,7010,4777,-2233,1880.0,1611.0,-269.0,136000.0,0.0,-136000.0
<a href=/player/culbl101>culbl101</a>,Leon Culberson,Washington Senators,TWINS,2,3,2,5,1948,1952,4,No,0,2.29,4.22,1.93,258,435,177,600,1605,1005,0.0,0.0,0.0,11000.0,0.0,-11000.0
<a href=/player/culld101>culld101</a>,Dick Culler,Chicago White Sox,WSOX,1,3,1,4,1943,1943,0,No,0,0.0,0.0,0.0,0,0,0,0,0,0,0.0,0.0,0.0,8600.0,0.0,-8600.0
<a href=/player/culld101>culld101</a>,Dick Culler,Milwaukee,Milwaukee,1,2,2,4,1944,1945,1,No,0,2.0,0.0,-2.0,395,0,-395,1542,0,-1542,0.0,0.0,0.0,0.0,0.0,0.0
<a href=/player/culld101>culld101</a>,Dick Culler,Boston Braves,BRAVES,1,2,1,3,1948,1948,0,No,0,-0.05,-0.28,-0.23,48,34,-14,105,82,-23,0.0,0.0,0.0,0.0,0.0,0.0
<a href=/player/cullj101>cullj101</a>,Jack Cullen,New York Yankees,YANKS,1,3,1,4,1967,1968,1,No,0,-0.17,-0.55,-0.38,26,78,52,40,208,168,0.0,0.0,0.0,0.0,0.0,0.0
<a href=/player/culln101>culln101</a>,Nick Cullop,NewOrleans,NewOrleans,1,1,6,7,1913,1915,2,No,0,-0.98,0.0,0.98,48,0,-48,37,0,-37,303.0,0.0,-303.0,0.0,0.0,0.0
<a href=/player/culln101>culln101</a>,Nick Cullop,New York Yankees,YANKS,5,14,12,26,1918,1931,13,No,0,64.97,61.9,-3.07,2396,2093,-303,7435,5797,-1638,6303.0,6917.0,614.0,44500.0,0.0,-44500.0
<a href=/player/culln101>culln101</a>,Nick Cullop,Cleveland Indians,INDINS,1,3,1,4,1912,1915,3,No,0,0.0,1.09,1.09,0,280,280,0,1151,1151,0.0,0.0,0.0,0.0,0.0,0.0
<a href=/player/culln102>culln102</a>,Nick Cullop,New York Yankees,YANKS,1,2,1,3,1926,1926,0,No,0,10.55,0.57,-9.98,311,18,-293,225,24,-201,1748.0,108.0,-1640.0,3000.0,0.0,-3000.0
<a href=/player/culln102>culln102</a>,Nick Cullop,Cincinnati Reds,REDS,1,2,1,3,1931,1933,2,No,0,0.0,-0.65,-0.65,0,108,108,0,270,270,0.0,0.0,0.0,0.0,0.0,0.0
<a href=/player/culln102>culln102</a>,Nick Cullop,Omaha,Omaha,1,1,2,3,1924,1924,0,No,0,0.0,0.0,0.0,2,0,-2,2,0,-2,0.0,0.0,0.0,0.0,0.0,0.0
<a href=/player/cullr101>cullr101</a>,Roy Cullenbine,Brooklyn Dodgers,DOGRS,1,1,1,2,1940,1940,0,No,0,5.56,-0.12,-5.68,273,57,-216,1080,113,-967,0.0,0.0,0.0,5000.0,0.0,-5000.0
<a href=/player/cullr101>cullr101</a>,Roy Cullenbine,St.Louis Browns,ORLS,1,2,2,4,1942,1947,5,No,0,0.79,6.64,5.85,98,330,232,296,878,582,122.0,1025.0,903.0,7500.0,0.0,-7500.0
<a href=/player/cullr101>cullr101</a>,Roy Cullenbine,New York Yankees,YANKS,1,2,2,4,1942,1946,4,No,0,14.72,6.82,-7.9,514,360,-154,2082,1425,-657,0.0,0.0,0.0,17500.0,0.0,-17500.0
<a href=/player/cullr101>cullr101</a>,Roy Cullenbine,Cleveland Indians,INDINS,2,3,3,6,1945,1948,3,No,0,14.82,4.87,-9.95,401,354,-47,1659,1291,-368,0.0,0.0,0.0,9500.0,0.0,-9500.0
<a href=/player/cullt101>cullt101</a>,Tim Cullen,Washington Senators,RNGRS,12,27,21,48,1968,1988,20,No,0,46.51,51.95,5.44,2991,4295,1304,9420,12528,3108,3885.0,6824.0,2939.0,527000.0,0.0,-527000.0
<a href=/player/cullt101>cullt101</a>,Tim Cullen,Chicago White Sox,WSOX,1,1,1,2,1968,1970,2,No,0,1.36,0.33,-1.03,414,125,-289,1147,306,-841,0.0,0.0,0.0,15500.0,0.0,-15500.0
<a href=/player/culmw101>culmw101</a>,Wil Culmer,Philadelphia Phillies,PHILS,3,6,5,11,1982,1987,5,No,0,5.02,15.9,10.88,358,462,104,942,672,-270,1316.0,2480.0,1164.0,1109333.0,0.0,-1109333.0
<a href=/player/culpr101>culpr101</a>,Ray Culp,Philadelphia Phillies,PHILS,3,5,4,9,1966,1974,8,No,0,1.53,-0.19,-1.72,157,456,299,216,1329,1113,1082.0,376.0,-706.0,32000.0,0.0,-32000.0
<a href=/player/culpr101>culpr101</a>,Ray Culp,Chicago Cubs,CUBS,1,1,3,4,1967,1969,2,No,0,10.79,0.0,-10.79,312,0,-312,404,0,-404,3277.0,0.0,-3277.0,17500.0,0.0,-17500.0
<a href=/player/culvg101>culvg101</a>,George Culver,Cleveland Indians,INDINS,1,3,1,4,1967,1968,1,No,0,1.38,0.99,-0.39,316,130,-186,387,265,-122,982.0,0.0,-982.0,27000.0,0.0,-27000.0
<a href=/player/culvg101>culvg101</a>,George Culver,Cincinnati Reds,REDS,1,1,1,2,1969,1971,2,No,0,0.66,-2.29,-2.95,22,70,48,20,16,-4,170.0,199.0,29.0,0.0,0.0,0.0
<a href=/player/culvg101>culvg101</a>,George Culver,St. Louis Cardinals,CARDS,10,17,16,33,1970,1976,6,No,0,18.66,2.65,-16.01,1836,551,-1285,3058,773,-2285,4547.0,1012.0,-3535.0,0.0,0.0,0.0
<a href=/player/cumbj101>cumbj101</a>,John Cumberland,New York Yankees,YANKS,1,1,1,2,1970,1971,1,No,0,1.35,-0.37,-1.72,122,18,-104,71,5,-66,663.0,62.0,-601.0,0.0,0.0,0.0
<a href=/player/cumbj101>cumbj101</a>,John Cumberland,San Francisco Giants,GIANTS,1,1,1,2,1972,1972,0,No,0,-0.81,0.0,0.81,28,0,-28,6,0,-6,65.0,0.0,-65.0,0.0,0.0,0.0
<a href=/player/cumbj101>cumbj101</a>,John Cumberland,St. Louis Cardinals,CARDS,4,5,5,10,1972,1977,5,No,0,20.99,-1.61,-22.6,875,118,-757,2900,9,-2891,1249.0,251.0,-998.0,47500.0,0.0,-47500.0
<a href=/player/cummj001>cummj001</a>,John Cummings,Los Angeles Dodgers,DOGRS,1,2,1,3,1996,1996,0,No,0,0.39,0.36,-0.03,64,43,-21,0,121,121,244.0,0.0,-244.0,305000.0,0.0,-305000.0
<a href=/player/cummm001>cummm001</a>,Midre Cummings,Minnesota Twins,TWINS,3,4,5,9,1992,2007,15,No,4,7.13,32.16,25.03,551,1268,717,733,4894,4161,2091.0,723.0,-1368.0,0.0,0.0,0.0
<a href=/player/cummm001>cummm001</a>,Midre Cummings,Minnesota Twins,TWINS,1,1,1,2,2000,2000,0,No,0,0.06,0.0,-0.06,21,0,-21,31,0,-31,0.0,0.0,0.0,300000.0,0.0,-300000.0
<a href=/player/cumms001>cumms001</a>,Steve Cummings,Toronto Blue Jays,BJAYS,1,3,1,4,1990,1990,0,No,0,-0.34,0.18,0.52,4,3,-1,0,0,0,23.0,47.0,24.0,102500.0,0.0,-102500.0
<a href=/player/cumms001>cumms001</a>,Steve Cummings,Cleveland Indians,INDINS,1,1,1,2,1991,1991,0,No,0,0.0,0.0,0.0,0,0,0,0,0,0,0.0,0.0,0.0,0.0,0.0,0.0
<a href=/player/cunna001>cunna001</a>,Aaron Cunningham,Chicago White Sox,WSOX,2,3,3,6,2007,2008,1,No,0,3.05,0.09,-2.96,495,97,-398,49,356,307,721.0,0.0,-721.0,396000.0,0.0,-396000.0
<a href=/player/cunna001>cunna001</a>,Aaron Cunningham,Arizona Diamondbacks,DBACKS,6,14,16,30,2007,2018,11,Yes,0,24.99,30.17,5.18,855,1190,335,1319,2038,719,6760.0,6326.0,-434.0,14741000.0,0.0,-14741000.0
<a href=/player/cunna001>cunna001</a>,Aaron Cunningham,Oakland Athletics,ATLTCS,1,2,2,4,2010,2016,6,No,0,1.29,5.52,4.23,209,624,415,584,2066,1482,0.0,0.0,0.0,0.0,0.0,0.0
<a href=/player/cunna001>cunna001</a>,Aaron Cunningham,San Diego Padres,PADRS,2,2,2,4,2011,2013,2,No,0,-0.47,-0.16,0.31,82,34,-48,109,1,-108,34.0,54.0,20.0,0.0,0.0,0.0
<a href=/player/cunnb101>cunnb101</a>,Bill Cunningham,Washington Senators,TWINS,1,3,1,4,1912,1916,4,No,0,0.0,13.55,13.55,0,546,546,0,2246,2246,0.0,0.0,0.0,0.0,0.0,0.0
<a href=/player/cunnb102>cunnb102</a>,Bill Cunningham,New York Giants,GIANTS,2,4,3,7,1923,1927,4,No,0,14.64,1.52,-13.12,912,442,-470,3712,1550,-2162,0.0,87.0,87.0,25500.0,0.0,-25500.0
<a href=/player/cunnb103>cunnb103</a>,Bert Cunningham,Louisville Colonels,LS3,1,12,5,17,1899,1900,1,No,0,267.1,0.0,-267.1,7388,0,-7388,29004,0,-29004,7568.0,0.0,-7568.0,4350.0,0.0,-4350.0
<a href=/player/cunnb104>cunnb104</a>,Bruce Cunningham,Chicago Cubs,CUBS,1,6,1,7,1928,1932,4,No,0,4.13,16.12,11.99,1036,317,-719,2232,1321,-911,4216.0,0.0,-4216.0,13000.0,0.0,-13000.0
<a href=/player/cunnb104>cunnb104</a>,Bruce Cunningham,Boston Braves,BRAVES,1,3,1,4,1932,1937,5,No,0,0.0,10.04,10.04,0,601,601,0,2506,2506,0.0,0.0,0.0,0.0,0.0,0.0
<a href=/player/cunnj101>cunnj101</a>,Joe Cunningham,St. Louis Cardinals,CARDS,1,1,1,2,1961,1963,2,No,0,6.2,-0.25,-6.45,256,39,-217,1030,108,-922,0.0,0.0,0.0,0.0,0.0,0.0
<a href=/player/cunnj101>cunnj101</a>,Joe Cunningham,Chicago White Sox,WSOX,3,4,5,9,1964,1969,5,No,0,-1.84,4.73,6.57,327,350,23,584,1283,699,492.0,0.0,-492.0,70250.0,0.0,-70250.0
<a href=/player/cunnt001>cunnt001</a>,Todd Cunningham,Pittsburgh Pirates,PIRATS,1,1,1,2,2018,2018,0,No,0,0.0,0.0,0.0,0,0,0,0,0,0,0.0,0.0,0.0,0.0,0.0,0.0
<a href=/player/cunnw001>cunnw001</a>,Will Cunnane,San Diego Padres,PADRS,1,2,2,4,2000,2001,1,No,0,-1.16,-0.17,0.99,82,43,-39,8,97,89,184.0,0.0,-184.0,230000.0,0.0,-230000.0
<a href=/player/currc101>currc101</a>,Clarence Currie,Chicago Cubs,CUBS,2,9,2,11,1903,1913,10,No,0,5.14,24.13,18.99,814,1109,295,3290,4566,1276,0.0,1329.0,1329.0,0.0,0.0,0.0
<a href=/player/currl101>currl101</a>,Lafayette Currence,Pittsburgh Pirates,PIRATS,1,1,1,2,1973,1975,2,No,0,-0.47,0.0,0.47,8,0,-8,0,0,0,56.0,0.0,-56.0,0.0,0.0,0.0
<a href=/player/currt101>currt101</a>,Tony Curry,Philadelphia Phillies,PHILS,1,2,1,3,1962,1962,0,No,0,0.0,-1.42,-1.42,19,65,46,19,111,92,0.0,0.0,0.0,0.0,0.0,0.0
<a href=/player/currt101>currt101</a>,Tony Curry,Cleveland Indians,INDINS,1,1,1,2,1966,1966,0,No,0,0.0,-0.53,-0.53,0,33,33,0,52,52,0.0,0.0,0.0,0.0,0.0,0.0
<a href=/player/currt101>currt101</a>,Tony Curry,Houston Astros,ASTROS,1,1,1,2,1966,1969,3,No,0,0.0,0.09,0.09,0,8,8,0,4,4,0.0,55.0,55.0,0.0,0.0,0.0
<a href=/player/curtc001>curtc001</a>,Chad Curtis,California Angels,ANGELS,1,1,1,2,1995,1995,0,No,0,2.21,4.36,2.15,248,139,-109,1136,643,-493,0.0,0.0,0.0,0.0,0.0,0.0
<a href=/player/curtc001>curtc001</a>,Chad Curtis,Detroit Tigers,TIGRS,4,5,7,12,1996,2005,9,No,2,2.51,3.42,0.91,198,222,24,668,170,-498,0.0,1903.0,1903.0,2600000.0,0.0,-2600000.0
<a href=/player/curtc001>curtc001</a>,Chad Curtis,Cleveland Indians,INDINS,1,1,1,2,1997,1997,0,No,0,4.23,-0.27,-4.5,340,9,-331,1162,0,-1162,0.0,50.0,50.0,900000.0,0.0,-900000.0
<a href=/player/curtc001>curtc001</a>,Chad Curtis,New York Yankees,YANKS,1,1,2,3,1999,2005,6,No,0,0.61,0.05,-0.56,146,1,-145,511,0,-511,0.0,4.0,4.0,2000000.0,0.0,-2000000.0
<a href=/player/curtc101>curtc101</a>,Cliff Curtis,Boston Braves,BRAVES,2,5,6,11,1911,1914,3,No,0,3.16,-2.55,-5.71,559,378,-181,1829,1028,-801,21.0,614.0,593.0,0.0,0.0,0.0
<a href=/player/curtc101>curtc101</a>,Cliff Curtis,Chicago Cubs,CUBS,1,1,1,2,1911,1911,0,No,0,0.3,-0.25,-0.55,36,2,-34,32,1,-31,285.0,6.0,-279.0,0.0,0.0,0.0
<a href=/player/curtc101>curtc101</a>,Cliff Curtis,Brooklyn Dodgers,DOGRS,1,1,1,2,1913,1914,1,No,0,0.0,-0.85,-0.85,0,32,32,0,107,107,0.0,0.0,0.0,2400.0,0.0,-2400.0
<a href=/player/curtj001>curtj001</a>,John Curtis,Boston Red Sox,RSOX,1,3,3,6,1973,1978,5,No,0,14.84,4.69,-10.15,678,283,-395,435,79,-356,3953.0,2795.0,-1158.0,53000.0,0.0,-53000.0
<a href=/player/curtj001>curtj001</a>,John Curtis,St. Louis Cardinals,CARDS,21,44,41,85,1976,1998,22,No,7,91.08,159.62,68.54,8485,7341,-1144,23608,25445,1837,10540.0,4019.0,-6521.0,3088333.0,0.0,-3088333.0
<a href=/player/curtj003>curtj003</a>,John Curtiss,Minnesota Twins,TWINS,1,1,1,2,2019,2019,0,Yes,0,0.04,0.0,-0.04,1,0,-1,0,0,0,7.0,0.0,-7.0,0.0,0.0,0.0
<a href=/player/curtj003>curtj003</a>,John Curtiss,Tampa Bay Devil Rays,RAYS,1,1,1,2,2021,2021,0,Yes,0,0.85,0.0,-0.85,70,0,-70,5,0,-5,120.0,0.0,-120.0,0.0,0.0,0.0
<a href=/player/curtj003>curtj003</a>,John Curtiss,Miami Marlins,MARLNS,1,1,1,2,2021,2021,0,Yes,0,-0.78,0.02,0.8,12,5,-7,0,16,16,13.0,0.0,-13.0,0.0,0.0,0.0
<a href=/player/curtj102>curtj102</a>,Jack Curtis,Chicago Cubs,CUBS,11,16,18,34,1962,1982,20,No,0,39.15,78.99,39.84,1575,3797,2222,3570,10356,6786,7275.0,9948.0,2673.0,430000.0,0.0,-430000.0
<a href=/player/curtj102>curtj102</a>,Jack Curtis,Milwaukee Braves,BRAVES,3,5,6,11,1962,1966,4,No,0,-0.69,3.0,3.69,105,383,278,317,708,391,15.0,0.0,-15.0,0.0,0.0,0.0
<a href=/player/curtz001>curtz001</a>,Zac Curtis,Arizona Diamondbacks,DBACKS,1,3,2,5,2016,2019,3,Yes,0,21.55,3.22,-18.33,745,61,-684,3265,58,-3207,14.0,514.0,500.0,2600000.0,0.0,-2600000.0
<a href=/player/cusij101>cusij101</a>,Jack Cusick,Chicago Cubs,CUBS,8,19,17,36,1951,1965,14,No,0,4.94,22.84,17.9,1454,1928,474,3922,2504,-1418,1451.0,4951.0,3500.0,86800.0,0.0,-86800.0
<a href=/player/custj001>custj001</a>,Jack Cust,Arizona Diamondbacks,DBACKS,1,2,1,3,2002,2003,1,No,0,-0.71,0.78,1.49,195,258,63,586,0,-586,0.0,220.0,220.0,0.0,0.0,0.0
<a href=/player/custj001>custj001</a>,Jack Cust,Colorado Rockies,ROCKS,1,1,1,2,2003,2003,0,No,0,0.41,-0.18,-0.59,28,19,-9,85,30,-55,0.0,0.0,0.0,0.0,0.0,0.0
<a href=/player/cutsg101>cutsg101</a>,George Cutshaw,Brooklyn Dodgers,DOGRS,2,3,4,7,1918,1929,11,No,0,13.23,38.94,25.71,700,1051,351,2619,1612,-1007,779.0,8893.0,8114.0,0.0,0.0,0.0
<a href=/player/cuylk101>cuylk101</a>,Kiki Cuyler,Pittsburgh Pirates,PIRATS,1,1,2,3,1927,1929,2,No,0,26.3,0.83,-25.47,949,209,-740,4196,845,-3351,0.0,0.0,0.0,11000.0,0.0,-11000.0
<a href=/player/cvenm101>cvenm101</a>,Mike Cvengros,Pittsburgh Pirates,PIRATS,1,2,1,3,1927,1927,0,No,0,0.0,0.0,0.0,0,0,0,0,0,0,0.0,0.0,0.0,3500.0,0.0,-3500.0
<a href=/player/czajj001>czajj001</a>,Jim Czajkowski,Pittsburgh Pirates,PIRATS,1,1,1,2,1990,1990,0,No,0,0.0,0.0,0.0,0,0,0,0,0,0,0.0,0.0,0.0,0.0,0.0,0.0
<a href=/player/daalo001>daalo001</a>,Omar Daal,Los Angeles Dodgers,DOGRS,1,1,1,2,1995,1995,0,No,0,-1.33,0.0,1.33,193,0,-193,16,0,-16,353.0,0.0,-353.0,156000.0,0.0,-156000.0
<a href=/player/daalo001>daalo001</a>,Omar Daal,Arizona Diamondbacks,DBACKS,9,20,18,38,2000,2012,12,No,3,42.56,26.41,-16.15,3086,1039,-2047,7001,1054,-5947,9526.0,4276.0,-5250.0,24075667.0,0.0,-24075667.0
<a href=/player/daalo001>daalo001</a>,Omar Daal,Philadelphia Phillies,PHILS,1,1,2,3,2001,2004,3,No,0,1.59,0.34,-1.25,77,20,-57,48,3,-45,484.0,61.0,-423.0,2750000.0,0.0,-2750000.0
<a href=/player/dacqj101>dacqj101</a>,John D'Acquisto,San Francisco Giants,GIANTS,3,6,6,12,1976,1979,3,No,1,0.11,-0.39,-0.5,172,638,466,406,1241,835,25.0,782.0,757.0,0.0,0.0,0.0
<a href=/player/dacqj101>dacqj101</a>,John D'Acquisto,St. Louis Cardinals,CARDS,1,2,1,3,1977,1978,1,No,0,-0.62,0.98,1.6,351,116,-235,172,6,-166,1013.0,278.0,-735.0,0.0,0.0,0.0
<a href=/player/dacqj101>dacqj101</a>,John D'Acquisto,San Diego Padres,PADRS,1,2,1,3,1980,1982,2,No,0,0.35,-0.35,-0.7,22,101,79,0,292,292,62.0,0.0,-62.0,0.0,0.0,0.0
<a href=/player/dadep101>dadep101</a>,Paul Dade,Cleveland Indians,INDINS,1,1,1,2,1979,1985,6,No,0,0.22,13.96,13.74,144,888,744,375,3538,3163,0.0,0.0,0.0,0.0,0.0,0.0
<a href=/player/dahlb101>dahlb101</a>,Babe Dahlgren,Brooklyn Dodgers,DOGRS,1,1,2,3,1943,1944,1,No,0,1.46,-0.98,-2.44,136,102,-34,565,268,-297,0.0,0.0,0.0,0.0,0.0,0.0
<a href=/player/dahlb101>dahlb101</a>,Babe Dahlgren,Philadelphia Phillies,PHILS,1,1,2,3,1943,1943,0,No,0,1.71,0.0,-1.71,302,0,-302,1252,0,-1252,0.0,0.0,0.0,0.0,0.0,0.0
<a href=/player/dahlb102>dahlb102</a>,Bill Dahlen,Chicago Cubs,CUBS,2,2,2,4,1899,1904,5,No,0,0.82,1.9,1.08,60,141,81,257,578,321,0.0,0.0,0.0,0.0,0.0,0.0
<a href=/player/dahlb102>dahlb102</a>,Bill Dahlen,Brooklyn Dodgers,DOGRS,1,1,3,4,1903,1903,0,No,0,14.54,0.0,-14.54,579,0,-579,2281,0,-2281,0.0,0.0,0.0,0.0,0.0,0.0
<a href=/player/dahlb102>dahlb102</a>,Bill Dahlen,New York Giants,GIANTS,4,11,6,17,1907,1921,14,No,0,45.64,34.38,-11.26,2445,1600,-845,8369,5323,-3046,1733.0,2915.0,1182.0,6400.0,0.0,-6400.0
<a href=/player/dahlj101>dahlj101</a>,Jerry Dahlke,Chicago White Sox,WSOX,3,10,4,14,1951,1953,2,No,0,2.36,0.32,-2.04,404,226,-178,236,372,136,2232.0,741.0,-1491.0,0.0,0.0,0.0
<a href=/player/dalcb101>dalcb101</a>,Bruce Dal Canton,Pittsburgh Pirates,PIRATS,3,5,5,10,1970,1974,4,No,0,25.46,1.32,-24.14,1582,453,-1129,5382,666,-4716,1881.0,1147.0,-734.0,76500.0,0.0,-76500.0
<a href=/player/dalcb101>dalcb101</a>,Bruce Dal Canton,Kansas City Royals,ROYALS,1,3,2,5,1975,1976,1,No,0,1.17,0.35,-0.82,138,8,-130,32,0,-32,436.0,23.0,-413.0,0.0,0.0,0.0
<a href=/player/daleb102>daleb102</a>,Bud Daley,Cleveland Indians,INDINS,8,15,14,29,1958,1968,10,No,0,101.35,32.49,-68.86,4418,2446,-1972,15260,8973,-6287,4502.0,562.0,-3940.0,0.0,0.0,0.0
<a href=/player/daleb102>daleb102</a>,Bud Daley,Baltimore Orioles,ORLS,1,1,1,2,1958,1958,0,No,0,7.09,3.24,-3.85,236,64,-172,216,72,-144,1742.0,614.0,-1128.0,0.0,0.0,0.0
<a href=/player/daleb102>daleb102</a>,Bud Daley,Kansas City Athletics,ATLTCS,1,1,2,3,1961,1963,2,No,0,0.61,-2.0,-2.61,160,152,-8,86,345,259,813.0,227.0,-586.0,0.0,0.0,0.0
<a href=/player/daleb102>daleb102</a>,Bud Daley,New York Yankees,YANKS,2,4,3,7,1964,1966,2,No,0,1.12,2.59,1.47,72,260,188,65,33,-32,521.0,611.0,90.0,84000.0,0.0,-84000.0
<a href=/player/dalec001>dalec001</a>,Carl Dale,St. Louis Cardinals,CARDS,7,13,12,25,1996,2004,8,No,1,8.44,23.16,14.72,1305,1318,13,4128,1707,-2421,1089.0,4162.0,3073.0,14483333.0,0.0,-14483333.0
<a href=/player/dalec001>dalec001</a>,Carl Dale,Oakland Athletics,ATLTCS,1,1,1,2,1999,2000,1,No,0,-0.37,0.82,1.19,8,63,55,0,212,212,12.0,0.0,-12.0,0.0,0.0,0.0
<a href=/player/dalep101>dalep101</a>,Pete Daley,Boston Red Sox,RSOX,1,1,1,2,1959,1960,1,No,0,0.26,0.22,-0.04,73,80,7,243,24,-219,0.0,304.0,304.0,0.0,0.0,0.0
<a href=/player/dalet101>dalet101</a>,Tom Daley,Cincinnati Reds,REDS,4,11,8,19,1909,1914,5,No,0,44.03,9.97,-34.06,2926,905,-2021,11991,3124,-8867,753.0,872.0,119.0,0.0,0.0,0.0
<a href=/player/dalet101>dalet101</a>,Tom Daley,Philadelphia Athletics,ATLTCS,2,2,2,4,1914,1916,2,No,0,2.39,4.17,1.78,150,333,183,485,1339,854,0.0,0.0,0.0,0.0,0.0,0.0
<a href=/player/dallb001>dallb001</a>,Brian Dallimore,Houston Astros,ASTROS,1,1,1,2,2000,2000,0,No,0,0.0,0.0,0.0,0,0,0,0,0,0,0.0,0.0,0.0,0.0,0.0,0.0
<a href=/player/dalld101>dalld101</a>,Dom Dallessandro,SanDiego,SanDiego,1,1,1,2,1939,1939,0,No,0,8.69,0.0,-8.69,678,0,-678,2093,0,-2093,0.0,0.0,0.0,0.0,0.0,0.0
<a href=/player/dalld101>dalld101</a>,Dom Dallessandro,Boston Red Sox,RSOX,1,4,1,5,1937,1937,0,No,0,0.0,0.0,0.0,0,0,0,0,0,0,0.0,0.0,0.0,3000.0,0.0,-3000.0
<a href=/player/dalrc101>dalrc101</a>,Clay Dalrymple,Philadelphia Phillies,PHILS,1,1,1,2,1969,1969,0,No,0,1.63,-2.28,-3.91,73,103,30,201,259,58,0.0,0.0,0.0,0.0,0.0,0.0
<a href=/player/daltj101>daltj101</a>,Jack Dalton,DesMoines,DesMoines,1,1,2,3,1910,1910,0,No,0,2.48,0.0,-2.48,205,0,-205,830,0,-830,0.0,0.0,0.0,0.0,0.0,0.0
<a href=/player/dalyt101>dalyt101</a>,Tom Daly,Chicago White Sox,WSOX,2,3,2,5,1903,1905,2,No,0,1.3,-0.02,-1.32,324,98,-226,1382,394,-988,0.0,0.0,0.0,0.0,0.0,0.0
<a href=/player/dalyt102>dalyt102</a>,Tom Daly,Chicago Cubs,CUBS,2,8,5,13,1921,1926,5,No,0,29.39,11.6,-17.79,1120,351,-769,4097,694,-3403,1929.0,2961.0,1032.0,13500.0,0.0,-13500.0
<a href=/player/damaj101>damaj101</a>,Jack Damaska,St. Louis Cardinals,CARDS,1,2,2,4,1964,1967,3,No,0,0.0,-0.48,-0.48,0,55,55,0,111,111,0.0,0.0,0.0,0.0,0.0,0.0
<a href=/player/damaj101>damaj101</a>,Jack Damaska,Pittsburgh Pirates,PIRATS,5,8,9,17,1968,1973,5,No,0,-0.64,0.41,1.05,22,41,19,70,35,-35,0.0,36.0,36.0,17500.0,0.0,-17500.0
<a href=/player/damij001>damij001</a>,Jeff D'Amico,Milwaukee Brewers,BREWRS,2,7,6,13,2002,2004,2,No,0,1.18,1.8,0.62,314,393,79,929,661,-268,437.0,1049.0,612.0,2750000.0,0.0,-2750000.0
<a href=/player/damij002>damij002</a>,Jeff D'Amico,Oakland Athletics,ATLTCS,9,14,13,27,1999,2009,10,No,2,17.9,16.23,-1.67,1131,951,-180,1914,3253,1339,7029.0,1397.0,-5632.0,1148500.0,0.0,-1148500.0
<a href=/player/damij002>damij002</a>,Jeff D'Amico,Cleveland Indians,INDINS,1,1,1,2,2002,2002,0,No,0,0.0,0.0,0.0,0,0,0,0,0,0,0.0,0.0,0.0,0.0,0.0,0.0
<a href=/player/damij002>damij002</a>,Jeff D'Amico,Philadelphia Phillies,PHILS,1,1,1,2,2002,2002,0,No,0,0.0,0.0,0.0,0,0,0,0,0,0,0.0,0.0,0.0,0.0,0.0,0.0
<a href=/player/damoj001>damoj001</a>,Johnny Damon,Kansas City Royals,ROYALS,2,3,5,8,2001,2008,7,No,0,28.96,3.25,-25.71,1295,867,-428,5271,2850,-2421,0.0,359.0,359.0,0.0,0.0,0.0
<a href=/player/danfd101>danfd101</a>,Dave Danforth,Columbus,Columbus,1,1,6,7,1921,1928,7,No,0,8.94,0.0,-8.94,274,0,-274,261,0,-261,2053.0,0.0,-2053.0,0.0,0.0,0.0
<a href=/player/danib101>danib101</a>,Bert Daniels,New York Yankees,YANKS,6,17,13,30,1913,1931,18,No,0,64.97,69.67,4.7,2396,2595,199,7435,7892,457,6303.0,6917.0,614.0,44500.0,0.0,-44500.0
<a href=/player/danib102>danib102</a>,Bennie Daniels,Pittsburgh Pirates,PIRATS,1,3,1,4,1960,1961,1,No,0,4.94,2.05,-2.89,573,87,-486,984,20,-964,2463.0,268.0,-2195.0,0.0,0.0,0.0
<a href=/player/danij101>danij101</a>,Jake Daniel,Washington Senators,TWINS,1,1,2,3,1937,1944,7,No,0,-0.16,0.0,0.16,12,0,-12,30,0,-30,0.0,0.0,0.0,0.0,0.0,0.0
<a href=/player/danij102>danij102</a>,Jack Daniels,Milwaukee Braves,BRAVES,3,5,4,9,1956,1961,5,No,0,0.97,1.02,0.05,134,117,-17,436,294,-142,0.0,0.0,0.0,0.0,0.0,0.0
<a href=/player/danik001>danik001</a>,Kal Daniels,Cincinnati Reds,REDS,3,5,5,10,1989,1997,8,No,1,8.78,16.08,7.3,969,1208,239,2884,4618,1734,1277.0,269.0,-1008.0,325000.0,0.0,-325000.0
<a href=/player/danik001>danik001</a>,Kal Daniels,Los Angeles Dodgers,DOGRS,1,1,1,2,1992,1992,0,No,0,-0.61,0.0,0.61,48,0,-48,122,0,-122,0.0,0.0,0.0,2500000.0,0.0,-2500000.0
<a href=/player/dankj001>dankj001</a>,John Danks,Texas Rangers,RNGRS,1,3,2,5,2006,2010,4,No,0,19.87,1.7,-18.17,323,47,-276,31,7,-24,4762.0,663.0,-4099.0,0.0,0.0,0.0
<a href=/player/danni101>danni101</a>,Ike Danning,Pittsburgh Pirates,PIRATS,1,2,1,3,1927,1927,0,No,0,0.0,0.0,0.0,0,0,0,0,0,0,0.0,0.0,0.0,3500.0,0.0,-3500.0
<a href=/player/danzb101>danzb101</a>,Babe Danzig,St.Louis Browns,ORLS,2,6,5,11,1912,1924,12,No,0,0.0,-0.88,-0.88,0,143,143,0,396,396,0.0,10.0,10.0,0.0,0.0,0.0
<a href=/player/darcp101>darcp101</a>,Pat Darcy,Houston Astros,ASTROS,1,2,1,3,1974,1974,0,No,0,0.18,-0.02,-0.2,88,30,-58,67,34,-33,560.0,0.0,-560.0,0.0,0.0,0.0
<a href=/player/darcp101>darcp101</a>,Pat Darcy,Cincinnati Reds,REDS,2,2,3,5,1977,1977,0,No,0,17.3,0.39,-16.91,239,28,-211,0,5,5,4814.0,74.0,-4740.0,0.0,0.0,0.0
<a href=/player/darev001>darev001</a>,Vic Darensbourg,Florida Marlins,MARLNS,4,9,11,20,2002,2015,13,No,0,11.51,22.72,11.21,893,1533,640,2983,2710,-273,1797.0,5078.0,3281.0,13177000.0,0.0,-13177000.0
<a href=/player/darka101>darka101</a>,Al Dark,Boston Braves,BRAVES,3,12,6,18,1949,1960,11,No,0,49.35,33.68,-15.67,2025,1559,-466,7279,6319,-960,2138.0,0.0,-2138.0,0.0,0.0,0.0
<a href=/player/darka101>darka101</a>,Al Dark,St. Louis Cardinals,CARDS,2,2,2,4,1958,1959,1,No,0,10.79,2.4,-8.39,630,129,-501,1116,47,-1069,995.0,497.0,-498.0,40000.0,0.0,-40000.0
<a href=/player/darka101>darka101</a>,Al Dark,Chicago Cubs,CUBS,1,3,1,4,1960,1961,1,No,0,4.05,4.05,0.0,233,260,27,447,1040,593,1208.0,0.0,-1208.0,0.0,0.0,0.0
<a href=/player/darka101>darka101</a>,Al Dark,Philadelphia Phillies,PHILS,1,1,1,2,1960,1960,0,No,0,0.33,-0.9,-1.23,50,26,-24,152,89,-63,0.0,0.0,0.0,0.0,0.0,0.0
<a href=/player/darka101>darka101</a>,Al Dark,Milwaukee Braves,BRAVES,2,3,3,6,1960,1961,1,No,0,3.31,-0.59,-3.9,499,56,-443,1886,5,-1881,0.0,122.0,122.0,0.0,0.0,0.0
<a href=/player/darka101>darka101</a>,Al Dark,New York Giants,GIANTS,11,22,22,44,1956,1968,12,No,0,37.88,26.25,-11.63,3162,2563,-599,10326,4535,-5791,1384.0,7539.0,6155.0,95000.0,0.0,-95000.0
<a href=/player/darlr001>darlr001</a>,Ron Darling,Texas Rangers,RNGRS,2,3,2,5,1982,1984,2,No,0,21.02,0.29,-20.73,680,235,-445,875,838,-37,5969.0,0.0,-5969.0,400000.0,0.0,-400000.0
<a href=/player/darlr001>darlr001</a>,Ron Darling,New York Mets,METS,2,3,2,5,1991,1992,1,No,0,-0.46,-0.67,-0.21,29,186,157,7,7,0,134.0,344.0,210.0,4233334.0,0.0,-4233334.0
<a href=/player/darlr001>darlr001</a>,Ron Darling,Montreal Expos,NATEX,1,1,2,3,1991,1991,0,No,0,3.31,0.0,-3.31,127,0,-127,1,0,-1,2170.0,0.0,-2170.0,0.0,0.0,0.0
<a href=/player/darnt001>darnt001</a>,Travis d'Arnaud,Philadelphia Phillies,PHILS,1,3,2,5,2009,2013,4,No,0,-0.14,16.2,16.34,41,202,161,2,264,262,517.0,2108.0,1591.0,0.0,0.0,0.0
<a href=/player/darnt001>darnt001</a>,Travis d'Arnaud,Toronto Blue Jays,BJAYS,1,4,3,7,2012,2016,4,No,0,18.37,4.87,-13.5,742,311,-431,2152,493,-1659,2154.0,2473.0,319.0,0.0,0.0,0.0
<a href=/player/darrg101>darrg101</a>,George Darrow,Philadelphia Phillies,PHILS,1,2,1,3,1934,1935,1,No,0,0.0,1.54,1.54,0,70,70,0,62,62,0.0,500.0,500.0,0.0,0.0,0.0
<a href=/player/darrm001>darrm001</a>,Mike Darr,Detroit Tigers,TIGRS,1,2,1,3,1997,1997,0,No,0,2.51,-0.37,-2.88,188,52,-136,612,129,-483,0.0,0.0,0.0,0.0,0.0,0.0
<a href=/player/darvy001>darvy001</a>,Yu Darvish,Texas Rangers,RNGRS,1,1,3,4,2017,2017,0,Yes,0,0.52,0.02,-0.5,18,13,-5,20,37,17,149.0,0.0,-149.0,11000000.0,0.0,-11000000.0
<a href=/player/darvy001>darvy001</a>,Yu Darvish,Chicago Cubs,CUBS,1,2,5,7,2020,2021,1,Yes,0,1.28,-0.94,-2.22,175,63,-112,411,44,-367,499.0,444.0,-55.0,22000000.0,0.0,-22000000.0
<a href=/player/darwb101>darwb101</a>,Bobby Darwin,Los Angeles Dodgers,DOGRS,1,1,1,2,1971,1971,0,No,0,5.3,0.0,-5.3,490,0,-490,1998,0,-1998,0.0,0.0,0.0,9600.0,0.0,-9600.0
<a href=/player/darwb101>darwb101</a>,Bobby Darwin,Minnesota Twins,TWINS,1,1,1,2,1975,1976,1,No,0,-0.02,1.75,1.77,80,87,7,282,327,45,0.0,0.0,0.0,0.0,0.0,0.0
<a href=/player/darwb101>darwb101</a>,Bobby Darwin,Milwaukee Brewers,BREWRS,2,4,2,6,1976,1976,0,No,0,3.64,0.57,-3.07,542,69,-473,1808,219,-1589,335.0,0.0,-335.0,150000.0,0.0,-150000.0
<a href=/player/darwb101>darwb101</a>,Bobby Darwin,Boston Red Sox,RSOX,1,1,1,2,1977,1977,0,No,0,-0.19,-0.27,-0.08,11,12,1,12,0,-12,0.0,38.0,38.0,0.0,0.0,0.0
<a href=/player/darwd001>darwd001</a>,Danny Darwin,Texas Rangers,RNGRS,2,3,2,5,1985,1991,6,No,0,9.16,3.49,-5.67,280,372,92,750,977,227,1044.0,361.0,-683.0,431500.0,0.0,-431500.0
<a href=/player/darwd001>darwd001</a>,Danny Darwin,Milwaukee Brewers,BREWRS,1,1,2,3,1986,1991,5,No,0,12.22,4.82,-7.4,446,196,-250,220,0,-220,2307.0,2588.0,281.0,610000.0,0.0,-610000.0
<a href=/player/darwd001>darwd001</a>,Danny Darwin,Pittsburgh Pirates,PIRATS,1,1,1,2,1996,2001,5,No,0,-0.94,2.3,3.24,30,397,367,12,11,-1,127.0,672.0,545.0,550000.0,0.0,-550000.0
<a href=/player/darwd001>darwd001</a>,Danny Darwin,Chicago White Sox,WSOX,7,14,18,32,1997,2011,14,No,0,8.23,24.04,15.81,946,1419,473,129,1458,1329,2956.0,3428.0,472.0,22052500.0,0.0,-22052500.0
<a href=/player/darwj001>darwj001</a>,Jeff Darwin,Seattle Mariners,MARNRS,3,4,4,8,1993,1995,2,No,0,2.56,0.14,-2.42,232,106,-126,671,357,-314,133.0,12.0,-121.0,900000.0,0.0,-900000.0
<a href=/player/darwj001>darwj001</a>,Jeff Darwin,Florida Marlins,MARLNS,1,2,1,3,1993,1994,1,No,0,-0.16,1.68,1.84,2,140,138,0,529,529,12.0,0.0,-12.0,0.0,0.0,0.0
<a href=/player/darwj001>darwj001</a>,Jeff Darwin,Seattle Mariners,MARNRS,1,1,1,2,1995,1995,0,No,0,0.71,0.36,-0.35,38,33,-5,0,88,88,133.0,0.0,-133.0,0.0,0.0,0.0
<a href=/player/daubj101>daubj101</a>,Jake Daubert,Brooklyn Dodgers,DOGRS,3,4,3,7,1919,1927,8,No,0,12.12,3.41,-8.71,877,824,-53,3785,3220,-565,0.0,0.0,0.0,17500.0,0.0,-17500.0
<a href=/player/daugj001>daugj001</a>,Jack Daugherty,Montreal Expos,NATEX,2,3,2,5,1988,1992,4,No,0,1.14,-0.02,-1.16,385,218,-167,919,35,-884,0.0,350.0,350.0,0.0,0.0,0.0
<a href=/player/daugj001>daugj001</a>,Jack Daugherty,Houston Astros,ASTROS,1,1,1,2,1993,1993,0,No,0,-0.37,0.0,0.37,46,0,-46,71,0,-71,0.0,0.0,0.0,0.0,0.0,0.0
<a href=/player/dauld001>dauld001</a>,Darren Daulton,Philadelphia Phillies,PHILS,1,1,1,2,1997,1999,2,No,0,0.48,0.53,0.05,52,24,-28,152,81,-71,0.0,0.0,0.0,4825000.0,0.0,-4825000.0
<a href=/player/davaj001>davaj001</a>,Jeff DaVanon,Oakland Athletics,ATLTCS,3,7,5,12,1999,2003,4,No,0,20.51,6.2,-14.31,1029,288,-741,2006,1023,-983,4166.0,874.0,-3292.0,3050000.0,0.0,-3050000.0
<a href=/player/davaj101>davaj101</a>,Jerry DaVanon,San Diego Padres,PADRS,1,2,2,4,1969,1970,1,No,0,-0.17,0.16,0.33,66,87,21,122,263,141,0.0,0.0,0.0,7500.0,0.0,-7500.0
<a href=/player/davaj101>davaj101</a>,Jerry DaVanon,St. Louis Cardinals,CARDS,1,1,1,2,1970,1972,2,No,0,0.63,1.29,0.66,38,162,124,94,7,-87,0.0,264.0,264.0,10000.0,0.0,-10000.0
<a href=/player/davaj101>davaj101</a>,Jerry DaVanon,Baltimore Orioles,ORLS,1,1,1,2,1972,1972,0,No,0,-0.28,0.0,0.28,41,0,-41,52,0,-52,0.0,0.0,0.0,0.0,0.0,0.0
<a href=/player/davaj101>davaj101</a>,Jerry DaVanon,California Angels,ANGELS,2,2,3,5,1973,1974,1,No,0,-0.01,0.0,0.01,245,0,-245,776,0,-776,0.0,0.0,0.0,0.0,0.0,0.0
<a href=/player/davaj101>davaj101</a>,Jerry DaVanon,Houston Astros,ASTROS,5,9,7,16,1976,1985,9,No,0,14.67,9.46,-5.21,1469,1015,-454,4721,2946,-1775,118.0,0.0,-118.0,0.0,0.0,0.0
<a href=/player/davav101>davav101</a>,Vic Davalillo,Cleveland Indians,INDINS,1,1,1,2,1968,1969,1,No,0,3.22,-0.35,-3.57,126,57,-69,437,133,-304,0.0,0.0,0.0,0.0,0.0,0.0
<a href=/player/davav101>davav101</a>,Vic Davalillo,California Angels,ANGELS,1,1,1,2,1969,1969,0,No,0,0.58,-0.31,-0.89,176,37,-139,304,62,-242,0.0,0.0,0.0,0.0,0.0,0.0
<a href=/player/davav101>davav101</a>,Vic Davalillo,St. Louis Cardinals,CARDS,3,4,5,9,1971,1972,1,No,0,10.59,4.12,-6.47,503,282,-221,1140,1112,-28,1651.0,28.0,-1623.0,0.0,0.0,0.0
<a href=/player/davay101>davay101</a>,Yo-Yo Davalillo,Washington Senators,TWINS,1,4,4,8,1956,1956,0,No,0,0.0,0.0,0.0,0,0,0,0,0,0,0.0,0.0,0.0,0.0,0.0,0.0
<a href=/player/davel101>davel101</a>,Lum Davenport,Chicago White Sox,WSOX,1,4,1,5,1924,1924,0,No,0,0.0,-0.04,-0.04,0,6,6,0,5,5,0.0,0.0,0.0,0.0,0.0,0.0
<a href=/player/davet001>davet001</a>,Tom Davey,Toronto Blue Jays,BJAYS,3,5,3,8,1999,2002,3,No,0,6.14,2.49,-3.65,321,312,-9,1103,1201,98,104.0,25.0,-79.0,0.0,0.0,0.0
<a href=/player/davet001>davet001</a>,Tom Davey,Seattle Mariners,MARNRS,1,2,1,3,2000,2001,1,No,0,0.34,1.23,0.89,184,142,-42,130,469,339,215.0,0.0,-215.0,1850000.0,0.0,-1850000.0
<a href=/player/davia003>davia003</a>,Austin Davis,Philadelphia Phillies,PHILS,1,1,1,2,2020,2020,0,Yes,0,-0.1,0.0,0.1,25,0,-25,0,0,0,40.0,0.0,-40.0,0.0,0.0,0.0
<a href=/player/davia003>davia003</a>,Austin Davis,Pittsburgh Pirates,PIRATS,1,1,1,2,2021,2021,0,Yes,0,-0.01,0.09,0.1,20,12,-8,1,42,41,50.0,0.0,-50.0,0.0,0.0,0.0
<a href=/player/davib003>davib003</a>,Ben Davis,San Diego Padres,PADRS,5,11,10,21,2001,2011,10,No,2,32.57,7.85,-24.72,553,890,337,877,2877,2000,4718.0,843.0,-3875.0,3727500.0,0.0,-3727500.0
<a href=/player/davib003>davib003</a>,Ben Davis,Seattle Mariners,MARNRS,11,20,22,42,2004,2015,11,No,0,19.53,35.16,15.63,1825,2443,618,3973,7974,4001,3326.0,2794.0,-532.0,27402500.0,0.0,-27402500.0
<a href=/player/davib102>davib102</a>,Bob Davis,Washington Senators,RNGRS,5,8,6,14,1960,1970,10,No,0,4.25,-0.08,-4.33,404,380,-24,701,1268,567,1913.0,6.0,-1907.0,0.0,0.0,0.0
<a href=/player/davib105>davib105</a>,Brock Davis,Chicago Cubs,CUBS,2,4,2,6,1971,1977,6,No,0,12.52,9.33,-3.19,493,821,328,508,3274,2766,3595.0,0.0,-3595.0,150000.0,0.0,-150000.0
<a href=/player/davib105>davib105</a>,Brock Davis,Chicago Cubs,CUBS,1,2,1,3,1975,1976,1,No,0,5.2,-0.21,-5.41,136,50,-86,0,3,3,592.0,115.0,-477.0,0.0,0.0,0.0
<a href=/player/davib106>davib106</a>,Bill Davis,Cleveland Indians,INDINS,1,1,1,2,1968,1969,1,No,0,-0.28,0.3,0.58,31,72,41,66,242,176,0.0,0.0,0.0,0.0,0.0,0.0
<a href=/player/davib106>davib106</a>,Bill Davis,San Diego Padres,PADRS,1,2,2,4,1969,1970,1,No,0,-0.17,0.16,0.33,66,87,21,122,263,141,0.0,0.0,0.0,7500.0,0.0,-7500.0
<a href=/player/davib106>davib106</a>,Bill Davis,St. Louis Cardinals,CARDS,1,2,1,3,1969,1969,0,No,0,0.0,0.0,0.0,0,0,0,0,0,0,0.0,0.0,0.0,0.0,0.0,0.0
<a href=/player/davib107>davib107</a>,Bill Davidson,Chicago Cubs,CUBS,1,3,1,4,1910,1912,2,No,0,-2.31,2.43,4.74,377,121,-256,1406,145,-1261,0.0,1039.0,1039.0,0.0,0.0,0.0
<a href=/player/davic001>davic001</a>,Chili Davis,Anaheim Angels,ANGELS,1,1,2,3,1996,1997,1,No,0,2.4,-0.6,-3.0,140,2,-138,567,0,-567,0.0,14.0,14.0,3800000.0,0.0,-3800000.0
<a href=/player/davic003>davic003</a>,Chris Davis,Texas Rangers,RNGRS,1,2,1,3,2011,2012,1,No,0,15.4,1.58,-13.82,1387,61,-1326,4679,0,-4679,1230.0,162.0,-1068.0,442160.0,0.0,-442160.0
<a href=/player/davic103>davic103</a>,Curt Davis,Philadelphia Phillies,PHILS,1,2,2,4,1936,1939,3,No,0,4.25,4.0,-0.25,195,450,255,507,1597,1090,830.0,231.0,-599.0,0.0,0.0,0.0
<a href=/player/davic103>davic103</a>,Curt Davis,Chicago Cubs,CUBS,1,4,1,5,1938,1938,0,No,0,10.27,2.49,-7.78,576,26,-550,361,27,-334,2894.0,224.0,-2670.0,0.0,0.0,0.0
<a href=/player/davic103>davic103</a>,Curt Davis,St. Louis Cardinals,CARDS,1,2,5,7,1940,1942,2,No,0,22.71,2.24,-20.47,811,200,-611,2272,485,-1787,3020.0,487.0,-2533.0,0.0,0.0,0.0
<a href=/player/david002>david002</a>,Doug Davis,Milwaukee Brewers,BREWRS,2,4,4,8,2006,2008,2,No,0,5.76,-0.61,-6.37,192,321,129,188,507,319,1641.0,616.0,-1025.0,6600000.0,0.0,-6600000.0
<a href=/player/david101>david101</a>,Dick Davis,Milwaukee Brewers,BREWRS,1,1,1,2,1981,1982,1,No,0,0.64,-1.38,-2.02,73,44,-29,177,0,-177,0.0,658.0,658.0,0.0,0.0,0.0
<a href=/player/david101>david101</a>,Dick Davis,Philadelphia Phillies,PHILS,2,2,2,4,1982,1983,1,No,0,0.12,-0.15,-0.27,4,45,41,12,86,74,0.0,0.0,0.0,160000.0,0.0,-160000.0
<a href=/player/david101>david101</a>,Dick Davis,Toronto Blue Jays,BJAYS,1,1,1,2,1982,1982,0,No,0,-0.62,-1.26,-0.64,39,72,33,86,197,111,0.0,0.0,0.0,0.0,0.0,0.0
<a href=/player/david102>david102</a>,Dixie Davis,Philadelphia Phillies,PHILS,4,9,10,19,1919,1929,10,No,0,27.15,17.61,-9.54,1789,754,-1035,5788,2055,-3733,4451.0,3446.0,-1005.0,8500.0,0.0,-8500.0
<a href=/player/david102>david102</a>,Dixie Davis,Louisville,Louisville,1,1,2,3,1920,1920,0,No,0,13.94,0.0,-13.94,426,0,-426,476,0,-476,3715.0,0.0,-3715.0,0.0,0.0,0.0
<a href=/player/davie001>davie001</a>,Eric Davis,Cincinnati Reds,REDS,7,10,14,24,1991,2006,15,No,0,9.83,13.67,3.84,1375,1603,228,1854,3165,1311,1702.0,3067.0,1365.0,19601333.0,0.0,-19601333.0
<a href=/player/davie001>davie001</a>,Eric Davis,Los Angeles Dodgers,DOGRS,2,2,2,4,1993,1994,1,No,0,0.31,-0.01,-0.32,62,6,-56,227,0,-227,26.0,16.0,-10.0,2000000.0,0.0,-2000000.0
<a href=/player/davie002>davie002</a>,Erik Davis,San Diego Padres,PADRS,1,2,1,3,2011,2011,0,No,0,0.1,-0.13,-0.23,20,102,82,0,267,267,26.0,0.0,-26.0,0.0,0.0,0.0
<a href=/player/davig001>davig001</a>,Glenn Davis,Houston Astros,ASTROS,18,34,44,78,1991,2011,20,No,2,96.08,54.59,-41.49,5446,7053,1607,12673,18656,5983,12589.0,8412.0,-4177.0,34919000.0,0.0,-34919000.0
<a href=/player/davig102>davig102</a>,George Davis,Cleveland Spiders,CL4,1,1,1,2,1893,1894,1,No,0,44.6,3.16,-41.44,1100,169,-931,4807,778,-4029,0.0,0.0,0.0,0.0,0.0,0.0
<a href=/player/davih101>davih101</a>,Harry Davis,New York Giants,GIANTS,1,2,1,3,1896,1897,1,No,0,2.13,1.45,-0.68,213,63,-150,903,270,-633,0.0,0.0,0.0,0.0,0.0,0.0
<a href=/player/davih103>davih103</a>,Harry Davis,Toledo,Toledo,1,1,2,3,1936,1937,1,No,0,0.27,0.0,-0.27,120,0,-120,527,0,-527,0.0,0.0,0.0,0.0,0.0,0.0
<a href=/player/davih103>davih103</a>,Harry Davis,St.Louis Browns,ORLS,1,1,1,2,1937,1938,1,No,0,0.0,-0.24,-0.24,0,6,6,0,6,6,0.0,46.0,46.0,4500.0,0.0,-4500.0
<a href=/player/davii001>davii001</a>,Ike Davis,New York Mets,METS,2,3,3,6,2014,2020,6,Yes,0,0.95,0.19,-0.76,209,16,-193,397,34,-363,190.0,0.0,-190.0,0.0,0.0,0.0
<a href=/player/davii102>davii102</a>,Ike Davis,Chicago White Sox,WSOX,5,17,8,25,1928,1936,8,No,0,4.13,-0.01,-4.14,711,811,100,2521,3083,562,0.0,39.0,39.0,28700.0,0.0,-28700.0
<a href=/player/davij001>davij001</a>,Jody Davis,New York Mets,METS,3,3,4,7,1979,1983,4,No,0,-1.38,0.13,1.51,103,92,-11,175,59,-116,0.0,110.0,110.0,0.0,0.0,0.0
<a href=/player/davij001>davij001</a>,Jody Davis,Chicago Cubs,CUBS,1,1,2,3,1988,1990,2,No,0,-1.32,-1.22,0.1,92,28,-64,296,13,-283,0.0,123.0,123.0,1108333.0,0.0,-1108333.0
<a href=/player/davij002>davij002</a>,Joel Davis,Chicago White Sox,WSOX,1,2,1,3,1989,1989,0,No,0,0.24,0.81,0.57,9,66,57,0,229,229,99.0,0.0,-99.0,0.0,0.0,0.0
<a href=/player/davij003>davij003</a>,John Davis,Kansas City Royals,ROYALS,2,5,3,8,1987,1989,2,No,0,6.71,1.86,-4.85,503,45,-458,494,0,-494,4503.0,794.0,-3709.0,62500.0,0.0,-62500.0
<a href=/player/davij004>davij004</a>,J.J. Davis,Pittsburgh Pirates,PIRATS,1,1,1,2,2004,2004,0,No,0,-0.39,0.0,0.39,14,0,-14,28,0,-28,0.0,0.0,0.0,300000.0,0.0,-300000.0
<a href=/player/davij004>davij004</a>,J.J. Davis,Washington Nationals,NATEX,1,3,1,4,2005,2005,0,No,0,-0.93,0.4,1.33,16,68,52,9,280,271,74.0,0.0,-74.0,674000.0,0.0,-674000.0
<a href=/player/davij005>davij005</a>,Jason Davis,Cleveland Indians,INDINS,1,1,1,2,2007,2007,0,No,0,-0.42,0.0,0.42,21,0,-21,0,0,0,77.0,0.0,-77.0,670000.0,0.0,-670000.0
<a href=/player/davij006>davij006</a>,J.D. Davis,Houston Astros,ASTROS,1,2,3,5,2019,2019,0,Yes,0,2.03,0.0,-2.03,269,0,-269,893,0,-893,0.0,0.0,0.0,0.0,0.0,0.0
<a href=/player/davij008>davij008</a>,Jaylin Davis,Minnesota Twins,TWINS,1,3,1,4,2019,2019,0,No,0,-0.71,-0.29,0.42,26,15,-11,68,0,-68,0.0,34.0,34.0,0.0,0.0,0.0
<a href=/player/davij103>davij103</a>,Jim Davis,Chicago Cubs,CUBS,5,10,9,19,1956,1965,9,No,0,7.39,7.94,0.55,637,1087,450,1408,195,-1213,1395.0,2758.0,1363.0,0.0,0.0,0.0
<a href=/player/davij104>davij104</a>,Jacke Davis,Philadelphia Phillies,PHILS,1,1,1,2,1962,1962,0,No,0,0.0,0.0,0.0,0,0,0,0,0,0,0.0,0.0,0.0,0.0,0.0,0.0
<a href=/player/davij104>davij104</a>,Jacke Davis,Los Angeles Angels,ANGELS,1,1,1,2,1963,1963,0,No,0,0.0,0.59,0.59,0,60,60,0,227,227,0.0,0.0,0.0,0.0,0.0,0.0
<a href=/player/davij104>davij104</a>,Jacke Davis,New York Mets,METS,1,2,1,3,1963,1964,1,No,0,0.0,0.75,0.75,0,47,47,0,167,167,0.0,0.0,0.0,0.0,0.0,0.0
<a href=/player/davik001>davik001</a>,Kane Davis,Cleveland Indians,INDINS,3,6,5,11,2000,2007,7,No,0,13.63,7.12,-6.51,820,378,-442,2478,197,-2281,718.0,1361.0,643.0,5247000.0,0.0,-5247000.0
<a href=/player/davik001>davik001</a>,Kane Davis,Milwaukee Brewers,BREWRS,2,4,5,9,2001,2004,3,No,0,0.49,3.61,3.12,225,470,245,5,59,54,355.0,808.0,453.0,1700000.0,0.0,-1700000.0
<a href=/player/davik001>davik001</a>,Kane Davis,Colorado Rockies,ROCKS,1,1,1,2,2002,2002,0,No,0,-0.32,0.0,0.32,32,0,-32,0,0,0,42.0,0.0,-42.0,0.0,0.0,0.0
<a href=/player/davik002>davik002</a>,Kyle Davies,Atlanta Braves,BRAVES,1,1,1,2,2007,2007,0,No,0,2.27,-0.08,-2.35,104,18,-86,8,0,-8,1593.0,23.0,-1570.0,0.0,0.0,0.0
<a href=/player/davik003>davik003</a>,Khris Davis,Milwaukee Brewers,BREWRS,1,1,2,3,2016,2021,5,Yes,0,7.32,0.75,-6.57,637,43,-594,2601,99,-2502,0.0,0.0,0.0,0.0,0.0,0.0
<a href=/player/davik003>davik003</a>,Khris Davis,Oakland Athletics,ATLTCS,1,3,3,6,2021,2021,0,Yes,0,-0.26,0.18,0.44,104,178,74,346,635,289,0.0,0.0,0.0,0.0,0.0,0.0
<a href=/player/davik101>davik101</a>,Kiddo Davis,Philadelphia Phillies,PHILS,6,8,7,15,1932,1938,6,No,0,3.83,2.02,-1.81,878,681,-197,1633,2179,546,1889.0,1053.0,-836.0,0.0,0.0,0.0
<a href=/player/davik101>davik101</a>,Kiddo Davis,New York Giants,GIANTS,4,13,6,19,1934,1949,15,No,0,8.93,67.35,58.42,1284,2487,1203,4538,9914,5376,296.0,0.0,-296.0,0.0,0.0,0.0
<a href=/player/davik101>davik101</a>,Kiddo Davis,St. Louis Cardinals,CARDS,1,1,1,2,1934,1934,0,No,0,1.16,-0.69,-1.85,100,69,-31,424,216,-208,0.0,0.0,0.0,0.0,0.0,0.0
<a href=/player/davik101>davik101</a>,Kiddo Davis,Philadelphia Phillies,PHILS,2,2,2,4,1934,1938,4,No,0,3.63,3.37,-0.26,486,292,-194,589,597,8,1889.0,1053.0,-836.0,0.0,0.0,0.0
<a href=/player/davim001>davim001</a>,Mark Davis,Philadelphia Phillies,PHILS,2,5,3,8,1982,1988,6,No,0,12.97,14.82,1.85,911,983,72,587,531,-56,5303.0,1684.0,-3619.0,0.0,0.0,0.0
<a href=/player/davim001>davim001</a>,Mark Davis,San Francisco Giants,GIANTS,7,13,17,30,1987,1998,11,No,2,21.03,37.78,16.75,1321,2343,1022,1429,4032,2603,4080.0,4148.0,68.0,9879278.0,0.0,-9879278.0
<a href=/player/davim001>davim001</a>,Mark Davis,Kansas City Royals,ROYALS,1,1,1,2,1992,1992,0,No,0,-0.44,-0.51,-0.07,28,19,-9,1,0,-1,50.0,134.0,84.0,3625000.0,0.0,-3625000.0
<a href=/player/davim001>davim001</a>,Mark Davis,Atlanta Braves,BRAVES,1,1,1,2,1993,1993,0,No,0,-0.41,0.0,0.41,50,0,-50,3,0,-3,94.0,0.0,-94.0,0.0,0.0,0.0
<a href=/player/davim003>davim003</a>,Mark Davidson,Minnesota Twins,TWINS,1,1,1,2,1989,1989,0,No,0,-0.51,0.0,0.51,175,0,-175,371,0,-371,0.0,0.0,0.0,0.0,0.0,0.0
<a href=/player/davim004>davim004</a>,Mark Davis,Chicago White Sox,WSOX,8,15,20,35,1989,2011,22,No,0,8.04,34.84,26.8,949,1768,819,131,1458,1327,2956.0,4642.0,1686.0,22052500.0,0.0,-22052500.0
<a href=/player/davim005>davim005</a>,Matt Davidson,Arizona Diamondbacks,DBACKS,2,2,3,5,2013,2019,6,Yes,0,5.03,0.01,-5.02,528,264,-264,941,37,-904,435.0,676.0,241.0,4875000.0,0.0,-4875000.0
<a href=/player/davir001>davir001</a>,Ron Davis,Chicago Cubs,CUBS,1,1,1,2,1978,1979,1,No,0,5.87,-0.14,-6.01,147,93,-54,2,57,55,875.0,512.0,-363.0,0.0,0.0,0.0
<a href=/player/davir001>davir001</a>,Ron Davis,New York Yankees,YANKS,12,22,19,41,1982,2001,19,No,1,71.79,28.19,-43.6,3910,1960,-1950,9749,5314,-4435,10685.0,4016.0,-6669.0,4250000.0,0.0,-4250000.0
<a href=/player/davir001>davir001</a>,Ron Davis,Minnesota Twins,TWINS,2,3,4,7,1986,1990,4,No,0,-0.88,-0.16,0.72,76,144,68,2,101,99,157.0,373.0,216.0,725000.0,0.0,-725000.0
<a href=/player/davir002>davir002</a>,Russ Davis,New York Yankees,YANKS,7,17,11,28,1995,2005,10,No,3,11.23,27.71,16.48,1522,1444,-78,2037,4006,1969,5289.0,3046.0,-2243.0,8771150.0,0.0,-8771150.0
<a href=/player/davir003>davir003</a>,Rajai Davis,Pittsburgh Pirates,PIRATS,1,2,1,3,2007,2008,1,No,0,0.22,-1.2,-1.42,63,32,-31,181,31,-150,0.0,253.0,253.0,0.0,0.0,0.0
<a href=/player/davir003>davir003</a>,Rajai Davis,Oakland Athletics,ATLTCS,3,3,4,7,2010,2013,3,No,0,1.06,1.29,0.23,369,113,-256,1185,361,-824,62.0,82.0,20.0,1350000.0,0.0,-1350000.0
<a href=/player/davir003>davir003</a>,Rajai Davis,Oakland Athletics,ATLTCS,1,1,1,2,2017,2017,0,Yes,0,-0.05,0.0,0.05,17,0,-17,38,0,-38,0.0,0.0,0.0,6000000.0,0.0,-6000000.0
<a href=/player/davir004>davir004</a>,Rookie Davis,New York Yankees,YANKS,4,8,7,15,2015,2020,5,Yes,0,-1.49,8.03,9.52,440,197,-243,1007,8,-999,290.0,1270.0,980.0,3936900.0,0.0,-3936900.0
<a href=/player/davir102>davir102</a>,Ron Davis,Houston Astros,ASTROS,3,4,4,8,1968,1970,2,No,0,0.52,-0.91,-1.43,57,214,157,102,233,131,43.0,477.0,434.0,23500.0,0.0,-23500.0
<a href=/player/davir102>davir102</a>,Ron Davis,St. Louis Cardinals,CARDS,3,8,6,14,1968,1972,4,No,0,11.85,2.24,-9.61,1182,243,-939,1248,521,-727,1854.0,299.0,-1555.0,17500.0,0.0,-17500.0
<a href=/player/davir102>davir102</a>,Ron Davis,San Diego Padres,PADRS,3,4,4,8,1969,1971,2,No,0,-1.24,2.5,3.74,167,452,285,311,1178,867,100.0,445.0,345.0,0.0,0.0,0.0
<a href=/player/davis001>davis001</a>,Storm Davis,Baltimore Orioles,ORLS,3,3,4,7,1986,1994,8,No,0,2.67,10.31,7.64,375,899,524,1012,1698,686,188.0,2337.0,2149.0,1160000.0,0.0,-1160000.0
<a href=/player/davis001>davis001</a>,Storm Davis,San Diego Padres,PADRS,1,1,2,3,1987,1990,3,No,0,2.97,0.04,-2.93,88,202,114,0,145,145,1392.0,296.0,-1096.0,605000.0,0.0,-605000.0
<a href=/player/davis001>davis001</a>,Storm Davis,Kansas City Royals,ROYALS,1,1,1,2,1991,1992,1,No,0,1.4,0.32,-1.08,48,32,-16,0,77,77,268.0,0.0,-268.0,0.0,0.0,0.0
<a href=/player/davis002>davis002</a>,Steve Davis,Cleveland Indians,INDINS,1,1,2,3,1989,1989,0,No,0,0.0,0.0,0.0,0,0,0,0,0,0,0.0,0.0,0.0,0.0,0.0,0.0
<a href=/player/davis101>davis101</a>,Spud Davis,St. Louis Cardinals,CARDS,2,4,5,9,1928,1936,8,No,0,28.36,11.55,-16.81,2032,988,-1044,7440,3573,-3867,0.0,0.0,0.0,0.0,0.0,0.0
<a href=/player/davis101>davis101</a>,Spud Davis,Philadelphia Phillies,PHILS,1,2,1,3,1933,1940,7,No,0,4.53,0.74,-3.79,321,311,-10,1140,949,-191,0.0,0.0,0.0,0.0,0.0,0.0
<a href=/player/davis101>davis101</a>,Spud Davis,Cincinnati Reds,REDS,1,3,1,4,1938,1948,10,No,0,2.9,43.86,40.96,235,653,418,553,968,415,703.0,7065.0,6362.0,0.0,0.0,0.0
<a href=/player/davit004>davit004</a>,Taylor Davis,Baltimore Orioles,ORLS,1,1,1,2,2021,2021,0,Yes,0,0.08,0.0,-0.08,2,0,-2,6,0,-6,0.0,0.0,0.0,0.0,0.0,0.0
<a href=/player/davit102>davit102</a>,Ted Davidson,Cincinnati Reds,REDS,3,5,6,11,1968,1977,9,No,0,4.56,11.78,7.22,256,1321,1065,307,585,278,1267.0,4200.0,2933.0,0.0,0.0,0.0
<a href=/player/davit103>davit103</a>,Tommy Davis,Los Angeles Dodgers,DOGRS,6,9,10,19,1966,1972,6,No,0,27.49,11.4,-16.09,1888,711,-1177,5026,2330,-2696,1193.0,6.0,-1187.0,136500.0,0.0,-136500.0
<a href=/player/davit103>davit103</a>,Tommy Davis,New York Mets,METS,2,5,4,9,1967,1974,7,No,0,2.47,11.88,9.41,357,948,591,832,3426,2594,1066.0,0.0,-1066.0,89000.0,0.0,-89000.0
<a href=/player/davit103>davit103</a>,Tommy Davis,Seattle Pilots,BREWRS,2,2,4,6,1969,1972,3,No,0,-0.5,-1.08,-0.58,86,286,200,322,855,533,0.0,0.0,0.0,87000.0,0.0,-87000.0
<a href=/player/davit103>davit103</a>,Tommy Davis,Chicago Cubs,CUBS,2,2,2,4,1972,1972,0,No,0,3.61,-0.19,-3.8,704,17,-687,2601,56,-2545,7.0,0.0,-7.0,25000.0,0.0,-25000.0
<a href=/player/daviw001>daviw001</a>,Wade Davis,Tampa Bay Devil Rays,RAYS,8,14,20,34,2012,2020,8,Yes,0,32.69,16.85,-15.84,1967,1086,-881,5025,2972,-2053,4433.0,3274.0,-1159.0,15365300.0,0.0,-15365300.0
<a href=/player/daviw001>daviw001</a>,Wade Davis,Kansas City Royals,ROYALS,2,2,2,4,2016,2021,5,Yes,0,2.88,1.39,-1.49,170,395,225,242,1580,1338,176.0,0.0,-176.0,16050000.0,0.0,-16050000.0
<a href=/player/daviw102>daviw102</a>,Willie Davis,Los Angeles Dodgers,DOGRS,3,3,4,7,1973,1985,12,No,1,3.51,12.41,8.9,209,1218,1009,663,733,70,128.0,2419.0,2291.0,235000.0,0.0,-235000.0
<a href=/player/daviw102>daviw102</a>,Willie Davis,Montreal Expos,NATEX,3,5,6,11,1974,1986,12,No,1,17.33,12.88,-4.45,1044,1340,296,2808,2454,-354,744.0,4288.0,3544.0,110000.0,0.0,-110000.0
<a href=/player/daviw102>daviw102</a>,Willie Davis,Texas Rangers,RNGRS,1,1,2,3,1975,1976,1,No,0,1.54,-0.79,-2.33,98,15,-83,376,2,-374,0.0,63.0,63.0,0.0,0.0,0.0
<a href=/player/daviw102>daviw102</a>,Willie Davis,St. Louis Cardinals,CARDS,2,2,2,4,1975,1976,1,No,0,1.7,0.0,-1.7,141,0,-141,522,0,-522,0.0,0.0,0.0,0.0,0.0,0.0
<a href=/player/daviz001>daviz001</a>,Zach Davies,Baltimore Orioles,ORLS,1,1,1,2,2015,2015,0,No,0,8.07,-0.72,-8.79,223,55,-168,218,238,20,1843.0,0.0,-1843.0,0.0,0.0,0.0
<a href=/player/daviz001>daviz001</a>,Zach Davies,Milwaukee Brewers,BREWRS,1,2,3,5,2019,2019,0,Yes,0,7.39,0.0,-7.39,203,0,-203,779,0,-779,208.0,0.0,-208.0,2600000.0,0.0,-2600000.0
<a href=/player/daviz001>daviz001</a>,Zach Davies,San Diego Padres,PADRS,1,5,2,7,2020,2020,0,Yes,0,-0.94,0.0,0.94,63,0,-63,44,0,-44,444.0,0.0,-444.0,5250000.0,0.0,-5250000.0
<a href=/player/dawkt001>dawkt001</a>,Travis Dawkins,Los Angeles Dodgers,DOGRS,1,1,2,3,2003,2003,0,No,0,-0.04,-0.09,-0.05,3,2,-1,3,1,-2,0.0,9.0,9.0,0.0,0.0,0.0
<a href=/player/dawkt001>dawkt001</a>,Travis Dawkins,Kansas City Royals,ROYALS,1,1,1,2,2004,2004,0,No,0,0.0,-0.15,-0.15,0,14,14,0,16,16,0.0,0.0,0.0,0.0,0.0,0.0
<a href=/player/dawkt001>dawkt001</a>,Travis Dawkins,Philadelphia Phillies,PHILS,1,1,1,2,2008,2008,0,No,0,0.0,0.0,0.0,0,0,0,0,0,0,0.0,0.0,0.0,0.0,0.0,0.0
<a href=/player/dawlb001>dawlb001</a>,Bill Dawley,Cincinnati Reds,REDS,2,5,3,8,1983,1989,6,No,0,5.92,4.25,-1.67,542,577,35,401,2023,1622,1019.0,0.0,-1019.0,117500.0,0.0,-117500.0
<a href=/player/dawlb001>dawlb001</a>,Bill Dawley,Chicago White Sox,WSOX,10,19,23,42,1986,2011,25,No,0,68.95,44.22,-24.73,3148,2784,-364,8811,5639,-3172,3371.0,6620.0,3249.0,22245000.0,0.0,-22245000.0
<a href=/player/day-b101>day-b101</a>,Bill Day,Philadelphia Phillies,PHILS,1,3,1,4,1890,1890,0,No,0,-0.87,0.47,1.34,43,31,-12,162,139,-23,150.0,0.0,-150.0,0.0,0.0,0.0
<a href=/player/day-b102>day-b102</a>,Boots Day,St. Louis Cardinals,CARDS,1,1,1,2,1969,1970,1,No,0,-0.21,0.11,0.32,11,12,1,8,3,-5,0.0,24.0,24.0,0.0,0.0,0.0
<a href=/player/day-b102>day-b102</a>,Boots Day,Chicago Cubs,CUBS,1,1,1,2,1970,1970,0,No,0,1.88,0.48,-1.4,449,66,-383,1274,215,-1059,0.0,0.0,0.0,0.0,0.0,0.0
<a href=/player/day-c101>day-c101</a>,Pea Ridge Day,Brooklyn Dodgers,DOGRS,1,1,1,2,1932,1932,0,No,0,0.0,-0.36,-0.36,0,64,64,0,226,226,0.0,0.0,0.0,0.0,0.0,0.0
<a href=/player/day-z001>day-z001</a>,Zach Day,New York Yankees,YANKS,6,10,8,18,2000,2013,13,Yes,1,11.39,22.07,10.68,570,1540,970,441,4696,4255,3809.0,682.0,-3127.0,14660923.0,0.0,-14660923.0
<a href=/player/day-z001>day-z001</a>,Zach Day,Cleveland Indians,INDINS,4,5,6,11,2001,2013,12,No,0,25.47,16.42,-9.05,1444,1195,-249,5183,2962,-2221,1044.0,843.0,-201.0,404400.0,0.0,-404400.0
<a href=/player/day-z001>day-z001</a>,Zach Day,Washington Nationals,NATEX,1,3,1,4,2005,2005,0,No,0,-0.93,0.4,1.33,16,68,52,9,280,271,74.0,0.0,-74.0,674000.0,0.0,-674000.0
<a href=/player/dayeb001>dayeb001</a>,Brian Dayett,New York Yankees,YANKS,15,35,29,64,1984,2001,17,No,2,51.54,46.2,-5.34,4234,4156,-78,12356,13647,1291,8714.0,1911.0,-6803.0,3498873.0,0.0,-3498873.0
<a href=/player/daylk001>daylk001</a>,Ken Dayley,Atlanta Braves,BRAVES,2,4,2,6,1984,1992,8,No,0,2.53,5.32,2.79,820,917,97,385,3026,2641,1122.0,0.0,-1122.0,725000.0,0.0,-725000.0
<a href=/player/daytg001>daytg001</a>,Grant Dayton,Miami Marlins,MARLNS,1,1,1,2,2015,2018,3,No,0,0.57,0.0,-0.57,103,4,-99,1,0,-1,150.0,12.0,-138.0,0.0,0.0,0.0
<a href=/player/dealc101>dealc101</a>,Cot Deal,Boston Red Sox,RSOX,1,1,1,2,1949,1949,0,No,0,-1.31,0.0,1.31,72,0,-72,22,0,-22,218.0,0.0,-218.0,0.0,0.0,0.0
<a href=/player/dealc102>dealc102</a>,Charlie Deal,Chicago Cubs,CUBS,2,8,5,13,1921,1926,5,No,0,29.39,11.6,-17.79,1120,351,-769,4097,694,-3403,1929.0,2961.0,1032.0,13500.0,0.0,-13500.0
<a href=/player/deana001>deana001</a>,Austin Dean,Miami Marlins,MARLNS,1,1,1,2,2020,2020,0,Yes,0,0.03,0.0,-0.03,25,0,-25,45,0,-45,0.0,0.0,0.0,0.0,0.0,0.0
<a href=/player/deand102>deand102</a>,Dizzy Dean,St. Louis Cardinals,CARDS,3,5,10,15,1938,1942,4,No,0,31.65,12.49,-19.16,1205,794,-411,2511,848,-1663,5245.0,3418.0,-1827.0,0.0,0.0,0.0
<a href=/player/deanp101>deanp101</a>,Paul Dean,New York Giants,GIANTS,1,3,1,4,1941,1941,0,No,0,6.28,-0.7,-6.98,205,44,-161,186,32,-154,1502.0,319.0,-1183.0,0.0,0.0,0.0
<a href=/player/deant101>deant101</a>,Tommy Dean,Los Angeles Dodgers,DOGRS,1,2,1,3,1969,1970,1,No,0,-3.36,0.06,3.42,214,64,-150,569,4,-565,47.0,148.0,101.0,0.0,0.0,0.0
<a href=/player/deanw101>deanw101</a>,Wayland Dean,Louisville,Louisville,1,1,1,2,1924,1924,0,No,0,-0.79,0.0,0.79,118,0,-118,96,0,-96,831.0,0.0,-831.0,0.0,0.0,0.0
<a href=/player/deanw101>deanw101</a>,Wayland Dean,New York Giants,GIANTS,5,8,6,14,1925,1932,7,No,0,44.2,17.47,-26.73,1941,1197,-744,7676,4275,-3401,795.0,550.0,-245.0,27600.0,0.0,-27600.0
<a href=/player/deaza001>deaza001</a>,Alejandro de Aza,Chicago White Sox,WSOX,1,1,2,3,2014,2014,0,Yes,0,0.28,0.0,-0.28,50,0,-50,201,0,-201,0.0,0.0,0.0,4250000.0,0.0,-4250000.0
<a href=/player/deaza001>deaza001</a>,Alejandro de Aza,Baltimore Orioles,ORLS,1,2,1,3,2015,2015,0,Yes,0,1.11,0.0,-1.11,60,0,-60,178,0,-178,0.0,0.0,0.0,0.0,0.0,0.0
<a href=/player/deaza001>deaza001</a>,Alejandro de Aza,Boston Red Sox,RSOX,1,1,1,2,2015,2015,0,Yes,0,-0.25,0.0,0.25,24,0,-24,75,0,-75,0.0,0.0,0.0,5000000.0,0.0,-5000000.0
<a href=/player/debad101>debad101</a>,Dennis DeBarr,Toronto Blue Jays,BJAYS,3,3,4,7,1978,1992,14,No,0,1.35,15.16,13.81,41,1283,1242,163,4027,3864,0.0,519.0,519.0,0.0,0.0,0.0
<a href=/player/debad101>debad101</a>,Dennis DeBarr,Cleveland Indians,INDINS,1,1,1,2,1978,1979,1,No,0,0.0,0.9,0.9,0,36,36,0,0,0,0.0,405.0,405.0,0.0,0.0,0.0
<a href=/player/debeh101>debeh101</a>,Hank DeBerry,Brooklyn Dodgers,DOGRS,8,19,13,32,1931,1948,17,No,0,60.59,33.88,-26.71,3224,2883,-341,11104,10453,-651,2159.0,791.0,-1368.0,10000.0,0.0,-10000.0
<a href=/player/decaa101>decaa101</a>,Art Decatur,Brooklyn Dodgers,DOGRS,4,10,4,14,1925,1934,9,No,0,-0.65,8.73,9.38,212,888,676,179,3061,2882,1356.0,260.0,-1096.0,35250.0,0.0,-35250.0
<a href=/player/decaa101>decaa101</a>,Art Decatur,Philadelphia Phillies,PHILS,5,9,9,18,1928,1940,12,No,0,39.18,41.3,2.12,1904,2696,792,7415,9869,2454,0.0,0.0,0.0,21000.0,0.0,-21000.0
<a href=/player/decid001>decid001</a>,Doug DeCinces,Baltimore Orioles,ORLS,1,2,1,3,1982,1983,1,No,0,18.92,1.8,-17.12,787,226,-561,3268,901,-2367,0.0,0.0,0.0,0.0,0.0,0.0
<a href=/player/deckj001>deckj001</a>,Jaff Decker,San Diego Padres,PADRS,2,3,2,5,2013,2019,6,Yes,0,1.1,0.61,-0.49,248,107,-141,694,312,-382,3.0,0.0,-3.0,0.0,0.0,0.0
<a href=/player/deckj101>deckj101</a>,Joe Decker,Chicago Cubs,CUBS,2,5,2,7,1972,1976,4,No,0,12.2,0.19,-12.01,299,239,-60,0,36,36,2874.0,554.0,-2320.0,72500.0,0.0,-72500.0
<a href=/player/deckm101>deckm101</a>,Marty Decker,Philadelphia Phillies,PHILS,4,7,5,12,1983,1992,9,No,1,3.32,3.9,0.58,591,613,22,223,793,570,1674.0,2750.0,1076.0,375000.0,0.0,-375000.0
<a href=/player/dedmj001>dedmj001</a>,Jeff Dedmon,Atlanta Braves,BRAVES,1,1,1,2,1988,1988,0,No,0,0.04,0.0,-0.04,21,0,-21,0,0,0,101.0,0.0,-101.0,0.0,0.0,0.0
<a href=/player/deerj101>deerj101</a>,John Deering,Detroit Tigers,TIGRS,1,1,1,2,1903,1903,0,No,0,0.23,-0.15,-0.38,18,1,-17,23,3,-20,180.0,0.0,-180.0,0.0,0.0,0.0
<a href=/player/deerr001>deerr001</a>,Rob Deer,San Francisco Giants,GIANTS,1,1,2,3,1985,1985,0,No,0,6.86,0.0,-6.86,667,0,-667,2711,0,-2711,0.0,0.0,0.0,0.0,0.0,0.0
<a href=/player/deesc101>deesc101</a>,Charlie Dees,San Francisco Giants,GIANTS,1,1,1,2,1963,1963,0,No,0,-0.82,0.0,0.82,98,0,-98,288,0,-288,0.0,0.0,0.0,0.0,0.0,0.0
<a href=/player/defrj001>defrj001</a>,Justin De Fratus,Seattle Mariners,MARNRS,1,1,1,2,2016,2016,0,No,0,0.0,0.0,0.0,0,0,0,0,0,0,0.0,0.0,0.0,0.0,0.0,0.0
<a href=/player/deicg001>deicg001</a>,Greg Deichmann,Oakland Athletics,ATLTCS,1,2,1,3,2021,2021,0,No,0,-0.36,1.44,1.8,14,29,15,31,0,-31,0.0,88.0,88.0,0.0,0.0,0.0
<a href=/player/dejam101>dejam101</a>,Mike Dejan,Washington Senators,TWINS,1,1,2,3,1940,1940,0,No,0,-0.07,0.0,0.07,12,0,-12,19,0,-19,0.0,0.0,0.0,0.0,0.0,0.0
<a href=/player/dejed001>dejed001</a>,David DeJesus,Kansas City Royals,ROYALS,2,3,4,7,2010,2015,5,No,0,2.28,-1.02,-3.3,251,29,-222,513,7,-506,252.0,223.0,-29.0,4700000.0,0.0,-4700000.0
<a href=/player/dejed001>dejed001</a>,David DeJesus,Washington Nationals,NATEX,1,1,1,2,2013,2013,0,Yes,0,1.66,0.0,-1.66,200,0,-200,647,0,-647,0.0,0.0,0.0,0.0,0.0,0.0
<a href=/player/dejed001>dejed001</a>,David DeJesus,Tampa Bay Devil Rays,RAYS,1,1,1,2,2015,2015,0,Yes,0,-0.65,0.0,0.65,30,0,-30,60,0,-60,0.0,0.0,0.0,0.0,0.0,0.0
<a href=/player/dejei001>dejei001</a>,Ivan De Jesus,Los Angeles Dodgers,DOGRS,2,4,4,8,1977,1984,7,No,0,15.47,7.3,-8.17,1806,765,-1041,7323,1796,-5527,184.0,243.0,59.0,0.0,0.0,0.0
<a href=/player/dejei001>dejei001</a>,Ivan De Jesus,Chicago Cubs,CUBS,1,1,2,3,1982,1996,14,No,0,2.92,68.77,65.85,463,2510,2047,1655,10525,8870,0.0,0.0,0.0,0.0,0.0,0.0
<a href=/player/dejei001>dejei001</a>,Ivan De Jesus,Philadelphia Phillies,PHILS,1,2,1,3,1985,1986,1,No,0,-0.41,-0.15,0.26,159,118,-41,87,15,-72,193.0,313.0,120.0,0.0,0.0,0.0
<a href=/player/dejei002>dejei002</a>,Ivan De Jesus,Boston Red Sox,RSOX,1,4,2,6,2012,2019,7,No,0,7.63,8.07,0.44,566,624,58,6,2223,2217,907.0,22.0,-885.0,521000.0,0.0,-521000.0
<a href=/player/dejei002>dejei002</a>,Ivan De Jesus,Los Angeles Dodgers,DOGRS,5,22,14,36,2012,2021,9,Yes,0,4.41,31.13,26.72,1016,1541,525,2843,5562,2719,1152.0,835.0,-317.0,78709000.0,0.0,-78709000.0
<a href=/player/dejei002>dejei002</a>,Ivan De Jesus,Baltimore Orioles,ORLS,1,2,2,4,2014,2014,0,Yes,0,0.24,-0.08,-0.32,17,19,2,41,45,4,0.0,0.0,0.0,515000.0,0.0,-515000.0
<a href=/player/dejej001>dejej001</a>,Jose De Jesus,Kansas City Royals,ROYALS,1,1,1,2,1990,1990,0,No,0,3.18,-0.71,-3.89,106,74,-32,114,114,0,935.0,0.0,-935.0,0.0,0.0,0.0
<a href=/player/dejem001>dejem001</a>,Mike DeJean,New York Yankees,YANKS,1,1,1,2,1995,1999,4,No,0,3.76,1.56,-2.2,517,379,-138,13,1412,1399,884.0,0.0,-884.0,0.0,0.0,0.0
<a href=/player/dejem001>dejem001</a>,Mike DeJean,Colorado Rockies,ROCKS,3,5,5,10,2001,2002,1,No,0,3.56,0.31,-3.25,524,189,-335,63,5,-58,907.0,301.0,-606.0,0.0,0.0,0.0
<a href=/player/dejem001>dejem001</a>,Mike DeJean,Milwaukee Brewers,BREWRS,1,1,2,3,2003,2004,1,No,0,0.18,0.23,0.05,36,18,-18,0,0,0,54.0,28.0,-26.0,1700000.0,0.0,-1700000.0
<a href=/player/dejem001>dejem001</a>,Mike DeJean,Baltimore Orioles,ORLS,1,1,1,2,2004,2004,0,No,0,0.3,-0.72,-1.02,88,23,-65,0,73,73,141.0,0.0,-141.0,1500000.0,0.0,-1500000.0
<a href=/player/dejoc001>dejoc001</a>,Chase De Jong,Toronto Blue Jays,BJAYS,1,2,1,3,2015,2015,0,No,0,0.08,0.0,-0.08,21,0,-21,15,0,-15,0.0,0.0,0.0,0.0,0.0,0.0
<a href=/player/dejoc001>dejoc001</a>,Chase De Jong,Los Angeles Dodgers,DOGRS,3,4,7,11,2017,2021,4,Yes,0,1.11,1.7,0.59,140,258,118,0,6,6,277.0,419.0,142.0,0.0,0.0,0.0
<a href=/player/dejoc001>dejoc001</a>,Chase De Jong,Seattle Mariners,MARNRS,1,2,2,4,2018,2018,0,No,0,0.01,-0.01,-0.02,6,28,22,0,0,0,56.0,44.0,-12.0,0.0,0.0,0.0
<a href=/player/delaa101>delaa101</a>,Art Delaney,Boston Braves,BRAVES,2,4,3,7,1929,1938,9,No,0,1.82,35.74,33.92,75,1097,1022,255,4575,4320,0.0,229.0,229.0,27000.0,0.0,-27000.0
<a href=/player/delaa101>delaa101</a>,Art Delaney,St. Louis Cardinals,CARDS,1,5,1,6,1924,1925,1,No,0,0.0,0.0,0.0,0,0,0,0,0,0,0.0,0.0,0.0,0.0,0.0,0.0
<a href=/player/delab001>delab001</a>,Bryan De La Cruz,Houston Astros,ASTROS,1,2,1,3,2021,2021,0,No,0,1.08,-0.33,-1.41,66,26,-40,219,0,-219,14.0,64.0,50.0,0.0,0.0,0.0
<a href=/player/delad001>delad001</a>,Dane de la Rosa,Tampa Bay Devil Rays,RAYS,1,1,1,2,2013,2016,3,No,0,1.24,0.17,-1.07,84,113,29,0,0,0,224.0,307.0,83.0,0.0,0.0,0.0
<a href=/player/delae001>delae001</a>,Eulogio de la Cruz,Detroit Tigers,TIGRS,2,8,3,11,2007,2010,3,No,0,-0.1,-1.19,-1.09,705,27,-678,1077,3,-1074,1506.0,303.0,-1203.0,12380000.0,0.0,-12380000.0
<a href=/player/delaf001>delaf001</a>,Francisco de la Rosa,Baltimore Orioles,ORLS,2,3,2,5,1992,1998,6,No,1,0.0,6.46,6.46,0,315,315,0,0,0,0.0,1327.0,1327.0,0.0,0.0,0.0
<a href=/player/delaf101>delaf101</a>,Frank Delahanty,New York Yankees,YANKS,1,2,1,3,1907,1907,0,No,0,-0.75,-1.19,-0.44,53,24,-29,88,22,-66,288.0,180.0,-108.0,0.0,0.0,0.0
<a href=/player/delaj001>delaj001</a>,Jorge de la Rosa,Boston Red Sox,RSOX,1,4,1,5,2003,2008,5,No,0,0.73,17.72,16.99,728,123,-605,51,11,-40,1381.0,2025.0,644.0,634000.0,0.0,-634000.0
<a href=/player/delaj001>delaj001</a>,Jorge de la Rosa,Arizona Diamondbacks,DBACKS,3,10,7,17,2003,2008,5,No,2,15.65,2.42,-13.23,2019,225,-1794,5161,413,-4748,3052.0,809.0,-2243.0,3950667.0,0.0,-3950667.0
<a href=/player/delaj001>delaj001</a>,Jorge de la Rosa,Milwaukee Brewers,BREWRS,1,1,1,2,2006,2007,1,No,0,0.15,2.81,2.66,39,146,107,5,521,516,536.0,0.0,-536.0,337000.0,0.0,-337000.0
<a href=/player/delaj001>delaj001</a>,Jorge de la Rosa,Kansas City Royals,ROYALS,2,2,2,4,2008,2009,1,No,0,16.05,3.8,-12.25,529,125,-404,399,215,-184,3760.0,215.0,-3545.0,397000.0,0.0,-397000.0
<a href=/player/delaj002>delaj002</a>,Jose de la Torre,Cleveland Indians,INDINS,1,1,1,2,2012,2012,0,No,0,-0.13,-0.07,0.06,7,43,36,0,123,123,34.0,0.0,-34.0,0.0,0.0,0.0
<a href=/player/delaj103>delaj103</a>,Jim Delahanty,Boston Braves,BRAVES,3,5,7,12,1906,1911,5,No,0,21.78,13.27,-8.51,936,1115,179,3703,3822,119,0.0,1733.0,1733.0,0.0,0.0,0.0
<a href=/player/delaj103>delaj103</a>,Jim Delahanty,Washington Senators,TWINS,1,1,2,3,1909,1916,7,No,0,7.92,6.2,-1.72,375,528,153,1583,1839,256,0.0,2.0,2.0,0.0,0.0,0.0
<a href=/player/delam101>delam101</a>,Miguel de la Hoz,Cleveland Indians,INDINS,1,1,1,2,1964,1968,4,No,0,0.66,1.17,0.51,304,484,180,660,1408,748,0.0,0.0,0.0,0.0,0.0,0.0
<a href=/player/delam101>delam101</a>,Miguel de la Hoz,Atlanta Braves,BRAVES,1,1,1,2,1969,1969,0,No,0,0.0,0.0,0.0,1,0,-1,1,0,-1,0.0,0.0,0.0,0.0,0.0,0.0
<a href=/player/delar001>delar001</a>,Roland DeLaMaza,Cleveland Indians,INDINS,1,1,1,2,1997,1997,0,No,0,0.01,0.19,0.18,1,23,22,0,96,96,6.0,0.0,-6.0,0.0,0.0,0.0
<a href=/player/delar002>delar002</a>,Rob Delaney,Baltimore Orioles,ORLS,1,1,1,2,2013,2013,0,No,0,0.0,0.02,0.02,0,9,9,0,24,24,0.0,0.0,0.0,0.0,0.0,0.0
<a href=/player/delar003>delar003</a>,Rubby de la Rosa,Los Angeles Dodgers,DOGRS,5,22,14,36,2012,2021,9,Yes,0,4.41,31.13,26.72,1016,1541,525,2843,5562,2719,1152.0,835.0,-317.0,78709000.0,0.0,-78709000.0
<a href=/player/delar003>delar003</a>,Rubby de la Rosa,Boston Red Sox,RSOX,3,6,4,10,2014,2019,5,Yes,0,1.08,2.41,1.33,219,69,-150,105,2,-103,1466.0,676.0,-790.0,3666000.0,0.0,-3666000.0
<a href=/player/delas001>delas001</a>,Steve Delabar,Seattle Mariners,MARNRS,3,3,3,6,2012,2017,5,No,0,0.53,0.24,-0.29,150,54,-96,0,135,135,429.0,187.0,-242.0,480700.0,0.0,-480700.0
<a href=/player/delcm001>delcm001</a>,Manny Delcarmen,Boston Red Sox,RSOX,1,2,1,3,2010,2010,0,No,0,-0.13,0.0,0.13,18,0,-18,1,0,-1,25.0,0.0,-25.0,905000.0,0.0,-905000.0
<a href=/player/delej001>delej001</a>,Jose DeLeon,Pittsburgh Pirates,PIRATS,4,4,5,9,1986,1996,10,No,2,5.81,20.24,14.43,348,988,640,726,4016,3290,1290.0,0.0,-1290.0,2175000.0,0.0,-2175000.0
<a href=/player/delej001>delej001</a>,Jose DeLeon,Chicago White Sox,WSOX,4,5,8,13,1988,1995,7,No,0,7.31,21.81,14.5,486,1116,630,375,3946,3571,3561.0,856.0,-2705.0,1847500.0,0.0,-1847500.0
<a href=/player/delej001>delej001</a>,Jose DeLeon,Philadelphia Phillies,PHILS,1,1,1,2,1993,1993,0,No,0,1.58,-0.28,-1.86,92,34,-58,0,1,1,435.0,58.0,-377.0,275000.0,0.0,-275000.0
<a href=/player/delej001>delej001</a>,Jose DeLeon,Chicago White Sox,WSOX,1,1,1,2,1995,1995,0,No,0,-0.11,-0.11,0.0,14,9,-5,2,0,-2,25.0,29.0,4.0,705000.0,0.0,-705000.0
<a href=/player/delej003>delej003</a>,Jose De Leon,Los Angeles Dodgers,DOGRS,2,4,2,6,2017,2018,1,No,0,0.72,1.62,0.9,74,236,162,205,820,615,229.0,0.0,-229.0,9000000.0,0.0,-9000000.0
<a href=/player/delej003>delej003</a>,Jose De Leon,Tampa Bay Devil Rays,RAYS,1,1,1,2,2019,2019,0,No,0,-0.93,0.0,0.93,23,0,-23,5,0,-5,73.0,0.0,-73.0,558000.0,0.0,-558000.0
<a href=/player/delel001>delel001</a>,Luis DeLeon,St. Louis Cardinals,CARDS,1,3,3,6,1982,1992,10,No,0,19.37,59.81,40.44,1893,1695,-198,5833,6828,995,883.0,553.0,-330.0,0.0,0.0,0.0
<a href=/player/delgb101>delgb101</a>,Bobby Del Greco,Pittsburgh Pirates,PIRATS,1,2,1,3,1956,1965,9,No,0,0.09,18.14,18.05,108,1409,1301,317,5853,5536,29.0,0.0,-29.0,0.0,0.0,0.0
<a href=/player/delgb101>delgb101</a>,Bobby Del Greco,St. Louis Cardinals,CARDS,2,3,2,5,1957,1958,1,No,0,0.52,-0.27,-0.79,98,41,-57,124,86,-38,94.0,0.0,-94.0,0.0,0.0,0.0
<a href=/player/delgb101>delgb101</a>,Bobby Del Greco,Philadelphia Phillies,PHILS,2,2,2,4,1961,1966,5,No,0,1.55,4.69,3.14,336,601,265,1049,1683,634,0.0,0.0,0.0,0.0,0.0,0.0
<a href=/player/delgc001>delgc001</a>,Carlos Delgado,Florida Marlins,MARLNS,4,5,7,12,2005,2012,7,No,0,5.44,-2.44,-7.88,820,896,76,2563,1545,-1018,767.0,1030.0,263.0,7995000.0,0.0,-7995000.0
<a href=/player/delgj001>delgj001</a>,Jesus Delgado,Boston Red Sox,RSOX,14,38,25,63,2005,2019,14,Yes,0,93.01,61.11,-31.9,5581,3052,-2529,12204,8864,-3340,8381.0,6378.0,-2003.0,13099733.0,0.0,-13099733.0
<a href=/player/delgp101>delgp101</a>,Puchy Delgado,Seattle Mariners,MARNRS,3,8,8,16,1979,1985,6,No,0,8.79,3.44,-5.35,489,639,150,632,1953,1321,2623.0,1017.0,-1606.0,175000.0,0.0,-175000.0
<a href=/player/delgr001>delgr001</a>,Randall Delgado,Atlanta Braves,BRAVES,4,10,11,21,2013,2019,6,Yes,0,22.68,8.16,-14.52,2194,1203,-991,6430,4358,-2072,1394.0,147.0,-1247.0,14250000.0,0.0,-14250000.0
<a href=/player/delgw001>delgw001</a>,Wilson Delgado,Seattle Mariners,MARNRS,1,2,1,3,1995,1997,2,No,0,9.08,-0.25,-9.33,394,28,-366,492,0,-492,2970.0,373.0,-2597.0,0.0,0.0,0.0
<a href=/player/delgw001>delgw001</a>,Wilson Delgado,San Francisco Giants,GIANTS,1,1,1,2,2000,2000,0,No,0,-0.01,-0.24,-0.23,31,11,-20,51,13,-38,0.0,0.0,0.0,0.0,0.0,0.0
<a href=/player/delgw001>delgw001</a>,Wilson Delgado,New York Yankees,YANKS,1,1,1,2,2000,2000,0,No,0,0.59,0.0,-0.59,47,0,-47,118,0,-118,0.0,0.0,0.0,213000.0,0.0,-213000.0
<a href=/player/delgw001>delgw001</a>,Wilson Delgado,St. Louis Cardinals,CARDS,1,1,1,2,2004,2005,1,No,0,0.72,-1.41,-2.13,42,132,90,147,284,137,0.0,0.0,0.0,0.0,0.0,0.0
<a href=/player/delke101>delke101</a>,Eddie Delker,Philadelphia Phillies,PHILS,1,2,1,3,1933,1940,7,No,0,4.53,0.74,-3.79,321,311,-10,1140,949,-191,0.0,0.0,0.0,0.0,0.0,0.0
<a href=/player/delld001>delld001</a>,David Dellucci,Arizona Diamondbacks,DBACKS,1,3,2,5,2003,2003,0,No,0,-0.2,0.48,0.68,53,45,-8,58,183,125,91.0,0.0,-91.0,1200000.0,0.0,-1200000.0
<a href=/player/delld001>delld001</a>,David Dellucci,Texas Rangers,RNGRS,1,1,2,3,2006,2008,2,No,0,0.74,-0.83,-1.57,132,42,-90,301,7,-294,0.0,525.0,525.0,0.0,0.0,0.0
<a href=/player/delmn001>delmn001</a>,Nicky Delmonico,Baltimore Orioles,ORLS,1,1,1,2,2013,2013,0,No,0,0.0,0.01,0.01,0,29,29,0,0,0,0.0,66.0,66.0,0.0,0.0,0.0
<a href=/player/deloa001>deloa001</a>,Abel de los Santos,Texas Rangers,RNGRS,1,2,1,3,2014,2015,1,No,0,0.0,-1.13,-1.13,4,18,14,0,0,0,5.0,129.0,124.0,0.0,0.0,0.0
<a href=/player/deloe001>deloe001</a>,Enyel De Los Santos,Seattle Mariners,MARNRS,2,3,3,6,2015,2016,1,No,0,1.44,-0.13,-1.57,26,49,23,0,0,0,71.0,128.0,57.0,0.0,0.0,0.0
<a href=/player/deloe001>deloe001</a>,Enyel De Los Santos,San Diego Padres,PADRS,1,1,1,2,2017,2018,1,No,0,-0.8,1.85,2.65,74,162,88,6,656,650,174.0,0.0,-174.0,0.0,0.0,0.0
<a href=/player/delof001>delof001</a>,Fautino de los Santos,Chicago White Sox,WSOX,2,5,4,9,2008,2011,3,No,0,24.92,-0.88,-25.8,1177,181,-996,4107,638,-3469,1718.0,20.0,-1698.0,3600000.0,0.0,-3600000.0
<a href=/player/delof001>delof001</a>,Fautino de los Santos,Oakland Athletics,ATLTCS,1,1,1,2,2012,2013,1,No,0,0.0,0.32,0.32,0,27,27,0,93,93,0.0,0.0,0.0,482500.0,0.0,-482500.0
<a href=/player/delsj101>delsj101</a>,Jim Delsing,Chicago White Sox,WSOX,1,1,1,2,1948,1950,2,No,0,0.07,0.11,0.04,21,84,63,33,277,244,0.0,0.0,0.0,0.0,0.0,0.0
<a href=/player/delsj101>delsj101</a>,Jim Delsing,New York Yankees,YANKS,2,8,4,12,1950,1954,4,No,0,21.38,0.72,-20.66,1235,437,-798,2252,180,-2072,6559.0,1785.0,-4774.0,29000.0,0.0,-29000.0
<a href=/player/delsj101>delsj101</a>,Jim Delsing,St.Louis Browns,ORLS,8,14,16,30,1952,1960,8,No,0,32.49,23.42,-9.07,2082,1835,-247,5453,4904,-549,5614.0,2626.0,-2988.0,41000.0,0.0,-41000.0
<a href=/player/delsj101>delsj101</a>,Jim Delsing,Detroit Tigers,TIGRS,1,2,3,5,1956,1957,1,No,0,0.97,-0.45,-1.42,230,140,-90,562,387,-175,0.0,0.0,0.0,0.0,0.0,0.0
<a href=/player/delsj101>delsj101</a>,Jim Delsing,Detroit Tigers,TIGRS,2,5,4,9,1958,1960,2,No,0,-1.58,7.47,9.05,379,604,225,1361,2163,802,0.0,0.0,0.0,7000.0,0.0,-7000.0
<a href=/player/delsj101>delsj101</a>,Jim Delsing,Washington Senators,TWINS,1,1,2,3,1959,1959,0,No,0,0.0,0.0,0.0,0,0,0,0,0,0,0.0,0.0,0.0,0.0,0.0,0.0
<a href=/player/delur001>delur001</a>,Rich DeLucia,St. Louis Cardinals,CARDS,7,12,13,25,1995,2004,9,No,1,7.92,19.88,11.96,1477,1521,44,4061,3047,-1014,1672.0,2465.0,793.0,14938333.0,0.0,-14938333.0
<a href=/player/delur001>delur001</a>,Rich DeLucia,San Francisco Giants,GIANTS,1,1,1,2,1997,1997,0,No,0,2.02,0.0,-2.02,98,0,-98,0,0,0,342.0,0.0,-342.0,625000.0,0.0,-625000.0
<a href=/player/demaa101>demaa101</a>,Al Demaree,New York Giants,GIANTS,1,3,1,4,1915,1915,0,No,0,8.83,1.16,-7.67,856,106,-750,2811,431,-2380,1477.0,0.0,-1477.0,0.0,0.0,0.0
<a href=/player/demaa101>demaa101</a>,Al Demaree,Philadelphia Phillies,PHILS,1,1,2,3,1917,1917,0,No,0,2.22,-0.19,-2.41,48,56,8,45,40,-5,423.0,388.0,-35.0,0.0,0.0,0.0
<a href=/player/demaa101>demaa101</a>,Al Demaree,Chicago Cubs,CUBS,2,2,2,4,1917,1919,2,No,0,5.43,2.39,-3.04,362,196,-166,1143,734,-409,667.0,0.0,-667.0,0.0,0.0,0.0
<a href=/player/demab101>demab101</a>,Billy DeMars,Philadelphia Athletics,ATLTCS,36,79,78,157,1949,1976,27,No,0,93.22,74.94,-18.28,10595,9460,-1135,25786,29262,3476,12563.0,7417.0,-5146.0,500300.0,0.0,-500300.0
<a href=/player/demac001>demac001</a>,Chris Demaria,Kansas City Royals,ROYALS,1,1,1,2,2005,2005,0,No,0,-0.18,0.0,0.18,20,0,-20,0,0,0,41.0,0.0,-41.0,0.0,0.0,0.0
<a href=/player/demaf102>demaf102</a>,Frank Demaree,Chicago Cubs,CUBS,4,7,6,13,1938,1943,5,No,0,18.58,4.9,-13.68,1563,631,-932,5453,2299,-3154,405.0,0.0,-405.0,33000.0,0.0,-33000.0
<a href=/player/demaj101>demaj101</a>,Joe DeMaestri,Chicago White Sox,WSOX,2,6,4,10,1951,1963,12,No,0,1.43,25.02,23.59,363,1422,1059,910,5079,4169,614.0,0.0,-614.0,0.0,0.0,0.0
<a href=/player/demaj101>demaj101</a>,Joe DeMaestri,St.Louis Browns,ORLS,1,2,2,4,1952,1954,2,No,0,-0.79,-0.8,-0.01,24,89,65,20,141,121,48.0,0.0,-48.0,19250.0,0.0,-19250.0
<a href=/player/demaj101>demaj101</a>,Joe DeMaestri,Chicago White Sox,WSOX,4,11,8,19,1953,1961,8,No,0,18.88,11.66,-7.22,2482,1258,-1224,8241,3866,-4375,2246.0,488.0,-1758.0,62000.0,0.0,-62000.0
<a href=/player/demaj101>demaj101</a>,Joe DeMaestri,Kansas City Athletics,ATLTCS,23,46,43,89,1959,1976,17,No,0,99.11,44.56,-54.55,8270,5153,-3117,21179,15408,-5771,8728.0,3756.0,-4972.0,440600.0,0.0,-440600.0
<a href=/player/demed101>demed101</a>,Don Demeter,Los Angeles Dodgers,DOGRS,2,3,3,6,1961,1962,1,No,0,7.87,-0.43,-8.3,525,100,-425,2040,21,-2019,0.0,267.0,267.0,6000.0,0.0,-6000.0
<a href=/player/demed101>demed101</a>,Don Demeter,Philadelphia Phillies,PHILS,5,10,12,22,1963,1979,16,No,0,31.38,66.18,34.8,2079,2296,217,6720,6242,-478,3363.0,10159.0,6796.0,74500.0,0.0,-74500.0
<a href=/player/demed101>demed101</a>,Don Demeter,Detroit Tigers,TIGRS,1,2,2,4,1966,1970,4,No,0,1.01,15.29,14.28,93,323,230,284,412,128,0.0,2887.0,2887.0,0.0,0.0,0.0
<a href=/player/demed101>demed101</a>,Don Demeter,Boston Red Sox,RSOX,1,2,1,3,1967,1968,1,No,0,7.67,2.77,-4.9,564,128,-436,2155,127,-2028,0.0,1094.0,1094.0,17000.0,0.0,-17000.0
<a href=/player/demes001>demes001</a>,Sam Demel,Oakland Athletics,ATLTCS,2,3,3,6,2010,2011,1,No,0,-1.42,0.36,1.78,153,120,-33,22,437,415,191.0,0.0,-191.0,3200000.0,0.0,-3200000.0
<a href=/player/demes101>demes101</a>,Steve Demeter,Detroit Tigers,TIGRS,1,1,1,2,1960,1974,14,No,0,-0.16,51.66,51.82,4,2018,2014,5,7776,7771,0.0,0.0,0.0,0.0,0.0,0.0
<a href=/player/demet001>demet001</a>,Travis Demeritte,Texas Rangers,RNGRS,1,1,2,3,2016,2017,1,No,0,0.0,0.05,0.05,0,35,35,0,0,0,0.0,137.0,137.0,0.0,0.0,0.0
<a href=/player/demet001>demet001</a>,Travis Demeritte,Atlanta Braves,BRAVES,1,2,1,3,2019,2021,2,No,0,-1.28,0.82,2.1,67,117,50,219,0,-219,3.0,208.0,205.0,0.0,0.0,0.0
<a href=/player/demmr101>demmr101</a>,Ray Demmitt,New York Yankees,YANKS,1,2,1,3,1909,1909,0,No,0,6.01,0.0,-6.01,373,0,-373,970,0,-970,1597.0,0.0,-1597.0,0.0,0.0,0.0
<a href=/player/demog101>demog101</a>,Gene DeMontreville,Washington Senators,WSN,2,4,6,10,1897,1900,3,No,0,18.96,3.72,-15.24,481,583,102,1837,2412,575,1122.0,0.0,-1122.0,0.0,0.0,0.0
<a href=/player/demog101>demog101</a>,Gene DeMontreville,Baltimore Orioles,BLN,1,1,1,2,1899,1899,0,No,0,1.39,0.0,-1.39,82,0,-82,346,0,-346,0.0,0.0,0.0,0.0,0.0,0.0
<a href=/player/demog101>demog101</a>,Gene DeMontreville,Chicago Cubs,CUBS,1,1,1,2,1899,1904,5,No,0,0.82,0.51,-0.31,60,59,-1,257,232,-25,0.0,0.0,0.0,0.0,0.0,0.0
<a href=/player/demog101>demog101</a>,Gene DeMontreville,Baltimore Orioles,BLN,1,2,1,3,1899,1906,7,No,0,-0.36,0.13,0.49,87,2,-85,281,8,-273,204.0,0.0,-204.0,0.0,0.0,0.0
<a href=/player/dempr001>dempr001</a>,Rick Dempsey,Minnesota Twins,TWINS,2,2,2,4,1972,1980,8,No,0,1.08,2.89,1.81,159,539,380,367,1671,1304,0.0,0.0,0.0,9000.0,0.0,-9000.0
<a href=/player/dempr001>dempr001</a>,Rick Dempsey,New York Yankees,YANKS,14,28,25,53,1976,2001,25,No,1,121.7,35.26,-86.44,6187,2228,-3959,13911,5384,-8527,21228.0,6192.0,-15036.0,4415000.0,0.0,-4415000.0
<a href=/player/dempr002>dempr002</a>,Ryan Dempster,Texas Rangers,RNGRS,1,2,1,3,1996,1999,3,No,0,5.47,5.31,-0.16,331,108,-223,288,10,-278,2639.0,1801.0,-838.0,0.0,0.0,0.0
<a href=/player/dempr002>dempr002</a>,Ryan Dempster,Florida Marlins,MARLNS,6,12,13,25,2002,2012,10,No,2,-4.59,10.93,15.52,421,1075,654,816,2503,1687,1364.0,2172.0,808.0,12425000.0,0.0,-12425000.0
<a href=/player/dempr002>dempr002</a>,Ryan Dempster,Chicago Cubs,CUBS,1,1,2,3,2012,2016,4,No,0,0.17,0.0,-0.17,12,0,-12,0,0,0,207.0,0.0,-207.0,14000000.0,0.0,-14000000.0
<a href=/player/dendm001>dendm001</a>,Matt den Dekker,New York Mets,METS,1,1,1,2,2015,2018,3,No,0,0.77,2.89,2.12,74,425,351,149,3,-146,0.0,416.0,416.0,0.0,0.0,0.0
<a href=/player/deneb101>deneb101</a>,Bill Denehy,New York Mets,METS,1,2,1,3,1967,1967,0,No,0,-0.14,0.0,0.14,6,0,-6,0,0,0,6.0,0.0,-6.0,8000.0,0.0,-8000.0
<a href=/player/deneb101>deneb101</a>,Bill Denehy,Washington Senators,RNGRS,1,2,1,3,1969,1970,1,No,0,0.0,1.6,1.6,0,167,167,0,535,535,0.0,0.0,0.0,0.0,0.0,0.0
<a href=/player/deneb101>deneb101</a>,Bill Denehy,New York Mets,METS,1,2,1,3,1971,1971,0,No,0,0.49,0.0,-0.49,124,0,-124,28,0,-28,416.0,0.0,-416.0,0.0,0.0,0.0
<a href=/player/deneb101>deneb101</a>,Bill Denehy,Detroit Tigers,TIGRS,4,4,4,8,1971,1973,2,No,0,0.39,1.92,1.53,72,72,0,148,3,-145,36.0,356.0,320.0,0.0,0.0,0.0
<a href=/player/denkt001>denkt001</a>,Travis Denker,Los Angeles Dodgers,DOGRS,1,1,1,2,2007,2008,1,No,0,0.11,-1.0,-1.11,24,128,104,42,142,100,0.0,0.0,0.0,0.0,0.0,0.0
<a href=/player/dennd101>dennd101</a>,Don Dennis,St. Louis Cardinals,CARDS,1,2,2,4,1966,1967,1,No,0,2.36,-0.3,-2.66,603,24,-579,1918,71,-1847,0.0,0.0,0.0,9000.0,0.0,-9000.0
<a href=/player/dennj001>dennj001</a>,John Denny,St. Louis Cardinals,CARDS,1,2,1,3,1979,1980,1,No,0,5.72,-0.43,-6.15,56,86,30,0,270,270,1178.0,0.0,-1178.0,0.0,0.0,0.0
<a href=/player/dennj001>dennj001</a>,John Denny,Cleveland Indians,INDINS,2,3,5,8,1982,1988,6,No,0,18.1,2.33,-15.77,276,149,-127,246,0,-246,3118.0,1599.0,-1519.0,0.0,0.0,0.0
<a href=/player/dennj001>dennj001</a>,John Denny,Philadelphia Phillies,PHILS,2,3,4,7,1985,1987,2,No,0,4.94,1.72,-3.22,271,272,1,922,426,-496,542.0,530.0,-12.0,1109333.0,0.0,-1109333.0
<a href=/player/denoc001>denoc001</a>,Chris Denorfia,Cincinnati Reds,REDS,1,1,2,3,2007,2008,1,No,0,0.33,-0.06,-0.39,33,44,11,73,0,-73,0.0,59.0,59.0,0.0,0.0,0.0
<a href=/player/denoc001>denoc001</a>,Chris Denorfia,San Diego Padres,PADRS,6,7,11,18,2014,2021,7,Yes,0,7.75,2.2,-5.55,614,468,-146,1581,617,-964,1057.0,783.0,-274.0,3900000.0,0.0,-3900000.0
<a href=/player/dentb001>dentb001</a>,Bucky Dent,Chicago White Sox,WSOX,6,10,14,24,1977,1997,20,No,1,14.82,36.25,21.43,1260,2444,1184,3433,7568,4135,1605.0,4459.0,2854.0,790500.0,0.0,-790500.0
<a href=/player/dentb001>dentb001</a>,Bucky Dent,New York Yankees,YANKS,3,3,6,9,1982,1983,1,No,0,15.14,0.27,-14.87,1400,37,-1363,1541,144,-1397,1801.0,0.0,-1801.0,0.0,0.0,0.0
<a href=/player/dents101>dents101</a>,Sam Dente,Boston Red Sox,RSOX,2,5,3,8,1947,1955,8,No,0,0.52,24.8,24.28,500,919,419,1627,990,-637,67.0,3427.0,3360.0,0.0,0.0,0.0
<a href=/player/dents101>dents101</a>,Sam Dente,St.Louis Browns,ORLS,12,22,27,49,1948,1960,12,No,0,27.3,29.76,2.46,2866,3068,202,7448,7690,242,6528.0,6057.0,-471.0,55500.0,0.0,-55500.0
<a href=/player/dents101>dents101</a>,Sam Dente,Washington Senators,TWINS,18,31,34,65,1951,1963,12,No,0,44.58,4.58,-40.0,3103,4341,1238,10756,11476,720,1213.0,4683.0,3470.0,38500.0,0.0,-38500.0
<a href=/player/depaj002>depaj002</a>,Jorge de Paula,Colorado Rockies,ROCKS,1,1,1,2,2001,2001,0,No,0,0.44,-0.59,-1.03,10,14,4,0,0,0,81.0,22.0,-59.0,0.0,0.0,0.0
<a href=/player/dernb001>dernb001</a>,Bob Dernier,Philadelphia Phillies,PHILS,3,6,4,10,1984,1986,2,No,0,8.36,-0.43,-8.79,1292,232,-1060,3847,16,-3831,227.0,557.0,330.0,0.0,0.0,0.0
<a href=/player/derom001>derom001</a>,Mark DeRosa,Chicago Cubs,CUBS,5,9,12,21,2008,2019,11,Yes,0,20.07,8.55,-11.52,907,1464,557,2034,410,-1624,3536.0,2836.0,-700.0,6250000.0,0.0,-6250000.0
<a href=/player/derom001>derom001</a>,Mark DeRosa,Cleveland Indians,INDINS,1,1,2,3,2009,2013,4,No,0,0.42,4.0,3.58,68,311,243,262,0,-262,0.0,883.0,883.0,5500000.0,0.0,-5500000.0
<a href=/player/derrc101>derrc101</a>,Claud Derrick,Philadelphia Athletics,ATLTCS,2,5,3,8,1912,1916,4,No,0,0.94,11.21,10.27,71,847,776,237,3547,3310,0.0,0.0,0.0,0.0,0.0,0.0
<a href=/player/derrc101>derrc101</a>,Claud Derrick,Detroit Tigers,TIGRS,1,1,1,2,1912,1912,0,No,0,0.22,0.0,-0.22,23,0,-23,73,0,-73,0.0,0.0,0.0,0.0,0.0,0.0
<a href=/player/derrc101>derrc101</a>,Claud Derrick,Cincinnati Reds,REDS,1,1,1,2,1914,1916,2,No,0,-0.41,-2.49,-2.08,28,250,222,105,875,770,0.0,0.0,0.0,3300.0,0.0,-3300.0
<a href=/player/derrm101>derrm101</a>,Mike Derrick,Pittsburgh Pirates,PIRATS,2,3,3,6,1967,1969,2,No,0,2.16,-0.09,-2.25,398,87,-311,1040,143,-897,429.0,0.0,-429.0,0.0,0.0,0.0
<a href=/player/derrp101>derrp101</a>,Paul Derringer,St. Louis Cardinals,CARDS,2,4,7,11,1933,1941,8,No,0,35.44,3.4,-32.04,1483,791,-692,3153,2855,-298,8479.0,390.0,-8089.0,10000.0,0.0,-10000.0
<a href=/player/derrr101>derrr101</a>,Russ Derry,Philadelphia Athletics,ATLTCS,1,4,1,5,1946,1954,8,No,0,0.34,26.76,26.42,48,917,869,112,4210,4098,0.0,0.0,0.0,7000.0,0.0,-7000.0
<a href=/player/desag101>desag101</a>,Gene Desautels,Boston Red Sox,RSOX,4,12,11,23,1940,1956,16,No,0,20.74,30.94,10.2,2288,1730,-558,6966,4243,-2723,4828.0,6235.0,1407.0,124000.0,0.0,-124000.0
<a href=/player/desca001>desca001</a>,Anthony DeSclafani,Toronto Blue Jays,BJAYS,3,15,11,26,2012,2018,6,No,0,24.75,21.38,-3.37,2099,1087,-1012,5739,3162,-2577,4668.0,4579.0,-89.0,8732900.0,0.0,-8732900.0
<a href=/player/desca001>desca001</a>,Anthony DeSclafani,Miami Marlins,MARLNS,2,5,4,9,2014,2015,1,Yes,0,5.93,0.44,-5.49,229,31,-198,228,27,-201,1943.0,265.0,-1678.0,9400000.0,0.0,-9400000.0
<a href=/player/deshd001>deshd001</a>,Delino DeShields,Montreal Expos,NATEX,4,8,9,17,1993,2006,13,No,0,63.97,29.14,-34.83,1073,1003,-70,2180,960,-1220,5870.0,7544.0,1674.0,9965000.0,0.0,-9965000.0
<a href=/player/deshd002>deshd002</a>,Delino DeShields,Texas Rangers,RNGRS,1,2,2,4,2019,2020,1,No,0,2.79,0.06,-2.73,113,1,-112,120,0,-120,209.0,3.0,-206.0,1400000.0,0.0,-1400000.0
<a href=/player/deshj001>deshj001</a>,Jim Deshaies,New York Yankees,YANKS,4,8,5,13,1985,1989,4,No,0,16.4,-1.53,-17.93,1169,149,-1020,2749,144,-2605,4224.0,1295.0,-2929.0,1022000.0,0.0,-1022000.0
<a href=/player/deshj001>deshj001</a>,Jim Deshaies,Minnesota Twins,TWINS,1,1,3,4,1993,1996,3,No,0,-0.08,0.11,0.19,10,5,-5,6,0,-6,51.0,80.0,29.0,700000.0,0.0,-700000.0
<a href=/player/deshj101>deshj101</a>,Jimmie DeShong,Philadelphia Athletics,ATLTCS,3,7,3,10,1932,1934,2,No,0,0.0,1.78,1.78,0,84,84,0,89,89,0.0,644.0,644.0,7600.0,0.0,-7600.0
<a href=/player/deshj101>deshj101</a>,Jimmie DeShong,New York Yankees,YANKS,1,2,2,4,1936,1940,4,No,0,1.79,4.55,2.76,337,355,18,641,541,-100,1980.0,2260.0,280.0,0.0,0.0,0.0
<a href=/player/desij001>desij001</a>,John DeSilva,Detroit Tigers,TIGRS,1,1,1,2,1993,1994,1,No,0,-0.01,0.43,0.44,6,60,54,0,227,227,16.0,0.0,-16.0,0.0,0.0,0.0
<a href=/player/desij001>desij001</a>,John DeSilva,Los Angeles Dodgers,DOGRS,1,1,1,2,1994,1994,0,No,0,-0.12,0.0,0.12,2,0,-2,0,0,0,26.0,0.0,-26.0,0.0,0.0,0.0
<a href=/player/despo001>despo001</a>,Odrisamer Despaigne,San Diego Padres,PADRS,1,1,1,2,2016,2016,0,Yes,0,-0.22,0.0,0.22,19,0,-19,0,0,0,82.0,0.0,-82.0,0.0,0.0,0.0
<a href=/player/desse001>desse001</a>,Elmer Dessens,Cincinnati Reds,REDS,2,5,6,11,2002,2012,10,No,0,1.97,3.61,1.64,937,1076,139,2944,1747,-1197,922.0,809.0,-113.0,6375000.0,0.0,-6375000.0
<a href=/player/desse001>desse001</a>,Elmer Dessens,Arizona Diamondbacks,DBACKS,1,1,1,2,2004,2004,0,No,0,0.84,0.0,-0.84,117,0,-117,15,0,-15,325.0,0.0,-325.0,4000000.0,0.0,-4000000.0
<a href=/player/desse001>desse001</a>,Elmer Dessens,Kansas City Royals,ROYALS,1,1,4,5,2006,2007,1,No,0,0.09,-0.05,-0.14,38,40,2,1,5,4,69.0,613.0,544.0,1700000.0,0.0,-1700000.0
<a href=/player/desse001>desse001</a>,Elmer Dessens,Los Angeles Dodgers,DOGRS,1,1,2,3,2007,2007,0,No,0,-0.51,-0.33,0.18,24,47,23,0,66,66,45.0,0.0,-45.0,0.0,0.0,0.0
<a href=/player/desto001>desto001</a>,Orestes Destrade,New York Yankees,YANKS,1,1,1,2,1988,1988,0,No,0,-0.23,-0.06,0.17,36,16,-20,53,0,-53,0.0,43.0,43.0,0.0,0.0,0.0
<a href=/player/dethb101>dethb101</a>,Bob Detherage,Los Angeles Dodgers,DOGRS,1,3,1,4,1976,1981,5,No,0,0.46,19.38,18.92,71,542,471,226,2055,1829,0.0,0.0,0.0,0.0,0.0,0.0
<a href=/player/dethb101>dethb101</a>,Bob Detherage,St. Louis Cardinals,CARDS,1,2,2,4,1976,1978,2,No,0,6.18,-0.3,-6.48,183,31,-152,702,19,-683,0.0,118.0,118.0,0.0,0.0,0.0
<a href=/player/dethb101>dethb101</a>,Bob Detherage,Houston Astros,ASTROS,1,2,1,3,1977,1978,1,No,0,0.09,-0.34,-0.43,21,13,-8,7,21,14,0.0,0.0,0.0,0.0,0.0,0.0
<a href=/player/detog101>detog101</a>,George Detore,Toledo,Toledo,1,1,2,3,1933,1933,0,No,0,0.0,0.0,0.0,0,0,0,0,0,0,0.0,0.0,0.0,0.0,0.0,0.0
<a href=/player/detog101>detog101</a>,George Detore,Philadelphia Athletics,ATLTCS,1,2,1,3,1934,1934,0,No,0,0.0,0.0,0.0,0,0,0,0,0,0,0.0,0.0,0.0,0.0,0.0,0.0
<a href=/player/dettj001>dettj001</a>,John Dettmer,Texas Rangers,RNGRS,2,2,2,4,1995,1995,0,No,0,0.0,-0.14,-0.14,0,37,37,0,73,73,0.0,12.0,12.0,155000.0,0.0,-155000.0
<a href=/player/dettt101>dettt101</a>,Tom Dettore,Pittsburgh Pirates,PIRATS,1,2,1,3,1974,1975,1,No,0,-0.35,-0.31,0.04,112,84,-28,49,134,85,471.0,0.0,-471.0,0.0,0.0,0.0
<a href=/player/detwr001>detwr001</a>,Ross Detwiler,Washington Nationals,NATEX,2,2,3,5,2014,2020,6,No,0,-1.11,0.0,1.11,40,4,-36,34,0,-34,129.0,5.0,-124.0,3000000.0,0.0,-3000000.0
<a href=/player/devec001>devec001</a>,Chris Devenski,Chicago White Sox,WSOX,1,3,2,5,2012,2012,0,No,0,4.38,0.83,-3.55,242,35,-207,1,0,-1,927.0,104.0,-823.0,0.0,0.0,0.0
<a href=/player/devej001>devej001</a>,Jose Devers,New York Yankees,YANKS,1,3,1,4,2017,2017,0,Yes,0,2.19,0.0,-2.19,342,0,-342,1369,0,-1369,8.0,0.0,-8.0,9857143.0,0.0,-9857143.0
<a href=/player/devem001>devem001</a>,Mike Devereaux,Los Angeles Dodgers,DOGRS,2,2,3,5,1989,1995,6,No,2,12.98,8.5,-4.48,878,214,-664,3485,205,-3280,0.0,1800.0,1800.0,0.0,0.0,0.0
<a href=/player/devem001>devem001</a>,Mike Devereaux,Chicago White Sox,WSOX,1,1,1,2,1995,1995,0,No,0,0.4,0.0,-0.4,29,0,-29,57,0,-57,0.0,0.0,0.0,1350000.0,0.0,-1350000.0
<a href=/player/devia101>devia101</a>,Adrian Devine,Atlanta Braves,BRAVES,3,8,3,11,1976,1983,7,No,0,3.71,6.12,2.41,495,566,71,1015,2078,1063,923.0,87.0,-836.0,33500.0,0.0,-33500.0
<a href=/player/devia101>devia101</a>,Adrian Devine,Texas Rangers,RNGRS,4,9,7,16,1977,1988,11,No,0,9.87,29.07,19.2,738,2027,1289,1844,7192,5348,1774.0,2974.0,1200.0,330000.0,0.0,-330000.0
<a href=/player/devia101>devia101</a>,Adrian Devine,Atlanta Braves,BRAVES,2,3,5,8,1979,1981,2,No,0,1.23,1.75,0.52,177,210,33,304,347,43,541.0,927.0,386.0,150000.0,0.0,-150000.0
<a href=/player/devij001>devij001</a>,Joey Devine,Atlanta Braves,BRAVES,2,3,2,5,2008,2008,0,No,0,1.55,1.01,-0.54,122,88,-34,170,345,175,206.0,0.0,-206.0,7000000.0,0.0,-7000000.0
<a href=/player/devoa101>devoa101</a>,Al DeVormer,New York Yankees,YANKS,1,2,2,4,1923,1934,11,No,0,-0.1,9.14,9.24,74,571,497,223,688,465,0.0,4054.0,4054.0,0.0,0.0,0.0
<a href=/player/devod001>devod001</a>,Doug DeVore,Arizona Diamondbacks,DBACKS,1,1,2,3,2005,2005,0,No,0,0.0,-0.47,-0.47,0,13,13,0,0,0,0.0,24.0,24.0,0.0,0.0,0.0
<a href=/player/devoj101>devoj101</a>,Josh Devore,New York Giants,GIANTS,1,4,1,5,1913,1913,0,No,0,44.86,-0.25,-45.11,1467,52,-1415,5586,39,-5547,1664.0,335.0,-1329.0,8100.0,0.0,-8100.0
<a href=/player/devoj101>devoj101</a>,Josh Devore,Philadelphia Phillies,PHILS,2,2,2,4,1914,1916,2,No,0,-0.55,-0.56,-0.01,51,83,32,152,333,181,0.0,0.0,0.0,0.0,0.0,0.0
<a href=/player/dewib001>dewib001</a>,Blake DeWitt,Los Angeles Dodgers,DOGRS,2,4,4,8,2010,2013,3,No,0,0.08,2.91,2.83,324,264,-60,960,343,-617,0.0,1182.0,1182.0,410000.0,0.0,-410000.0
<a href=/player/dewim001>dewim001</a>,Matt DeWitt,St. Louis Cardinals,CARDS,1,3,2,5,1999,2000,1,No,0,0.12,1.62,1.5,212,64,-148,357,72,-285,353.0,583.0,230.0,1025000.0,0.0,-1025000.0
<a href=/player/dewim001>dewim001</a>,Matt DeWitt,Toronto Blue Jays,BJAYS,2,3,5,8,2001,2001,0,No,0,1.34,-0.46,-1.8,17,81,64,2,117,115,302.0,78.0,-224.0,0.0,0.0,0.0
<a href=/player/dewim001>dewim001</a>,Matt DeWitt,Chicago White Sox,WSOX,1,1,1,2,2001,2001,0,No,0,0.28,0.0,-0.28,16,0,-16,0,0,0,57.0,0.0,-57.0,0.0,0.0,0.0
<a href=/player/diaza001>diaza001</a>,Alex Diaz,New York Mets,METS,1,2,2,4,1991,1991,0,No,0,-0.75,0.0,0.75,42,0,-42,88,0,-88,0.0,0.0,0.0,0.0,0.0,0.0
<a href=/player/diaza001>diaza001</a>,Alex Diaz,Montreal Expos,NATEX,1,1,1,2,1991,1992,1,No,0,-0.85,0.0,0.85,133,0,-133,284,0,-284,0.0,0.0,0.0,0.0,0.0,0.0
<a href=/player/diaza002>diaza002</a>,Argenis Diaz,Boston Red Sox,RSOX,3,4,4,8,2009,2010,1,No,0,0.8,1.92,1.12,204,165,-39,735,496,-239,0.0,3.0,3.0,0.0,0.0,0.0
<a href=/player/diaza003>diaza003</a>,Aledmys Diaz,St. Louis Cardinals,CARDS,1,1,1,2,2017,2017,0,Yes,0,2.14,0.0,-2.14,130,0,-130,452,0,-452,0.0,0.0,0.0,2500000.0,0.0,-2500000.0
<a href=/player/diaza003>diaza003</a>,Aledmys Diaz,Toronto Blue Jays,BJAYS,1,1,1,2,2018,2018,0,Yes,0,2.79,0.0,-2.79,170,0,-170,625,0,-625,0.0,0.0,0.0,2000000.0,0.0,-2000000.0
<a href=/player/diazb001>diazb001</a>,Bo Diaz,Boston Red Sox,RSOX,2,6,3,9,1978,1987,9,No,0,14.86,20.93,6.07,699,715,16,1362,2220,858,3997.0,3996.0,-1.0,0.0,0.0,0.0
<a href=/player/diazb001>diazb001</a>,Bo Diaz,Cleveland Indians,INDINS,2,2,4,6,1981,1983,2,No,1,5.91,2.75,-3.16,333,68,-265,1253,0,-1253,0.0,1236.0,1236.0,0.0,0.0,0.0
<a href=/player/diazb001>diazb001</a>,Bo Diaz,Philadelphia Phillies,PHILS,4,7,8,15,1985,1988,3,No,0,7.67,0.31,-7.36,1238,246,-992,3588,287,-3301,737.0,444.0,-293.0,1255000.0,0.0,-1255000.0
<a href=/player/diazc001>diazc001</a>,Carlos Diaz,Seattle Mariners,MARNRS,1,1,1,2,1981,1981,0,No,0,-0.3,-0.28,0.02,38,89,51,3,360,357,76.0,0.0,-76.0,0.0,0.0,0.0
<a href=/player/diazc001>diazc001</a>,Carlos Diaz,Atlanta Braves,BRAVES,1,1,1,2,1982,1983,1,No,0,2.04,0.0,-2.04,116,6,-110,7,0,-7,261.0,11.0,-250.0,33500.0,0.0,-33500.0
<a href=/player/diazc001>diazc001</a>,Carlos Diaz,New York Mets,METS,5,9,8,17,1983,2002,19,No,2,9.94,33.47,23.53,1212,944,-268,3663,1895,-1768,473.0,5145.0,4672.0,876667.0,0.0,-876667.0
<a href=/player/diaze002>diaze002</a>,Einar Diaz,Cleveland Indians,INDINS,2,3,3,6,2002,2012,10,No,0,4.1,24.75,20.65,161,1080,919,366,4413,4047,970.0,8.0,-962.0,1601500.0,0.0,-1601500.0
<a href=/player/diaze002>diaze002</a>,Einar Diaz,Texas Rangers,RNGRS,2,5,5,10,2004,2007,3,No,0,27.72,7.35,-20.37,1181,154,-1027,4083,5,-4078,1652.0,1074.0,-578.0,0.0,0.0,0.0
<a href=/player/diaze003>diaze003</a>,Eddy Diaz,Milwaukee Brewers,BREWRS,1,1,1,2,1998,1998,0,No,0,0.0,-0.18,-0.18,0,2,2,0,0,0,0.0,1.0,1.0,0.0,0.0,0.0
<a href=/player/diaze006>diaze006</a>,Edwin Diaz,Seattle Mariners,MARNRS,3,7,8,15,2018,2021,3,Yes,0,4.65,-0.82,-5.47,602,81,-521,857,184,-673,558.0,101.0,-457.0,34758065.0,0.0,-34758065.0
<a href=/player/diazf001>diazf001</a>,Felix Diaz,San Francisco Giants,GIANTS,1,2,1,3,2002,2002,0,No,0,-0.46,1.76,2.22,19,46,27,1,205,204,148.0,0.0,-148.0,0.0,0.0,0.0
<a href=/player/diazi001>diazi001</a>,Isan Diaz,Arizona Diamondbacks,DBACKS,2,7,4,11,2016,2019,3,Yes,0,30.63,10.0,-20.63,1052,220,-832,3757,754,-3003,1784.0,544.0,-1240.0,2600000.0,0.0,-2600000.0
<a href=/player/diazi001>diazi001</a>,Isan Diaz,Milwaukee Brewers,BREWRS,1,4,1,5,2018,2018,0,Yes,0,-6.06,7.26,13.32,541,147,-394,1645,651,-994,270.0,0.0,-270.0,0.0,0.0,0.0
<a href=/player/diazj002>diazj002</a>,Jose Diaz,Los Angeles Dodgers,DOGRS,1,3,2,5,2003,2003,0,No,0,0.4,0.21,-0.19,110,61,-49,377,246,-131,0.0,0.0,0.0,0.0,0.0,0.0
<a href=/player/diazj002>diazj002</a>,Jose Diaz,New York Mets,METS,1,2,2,4,2004,2006,2,No,0,16.49,0.86,-15.63,150,111,-39,8,71,63,2502.0,670.0,-1832.0,0.0,0.0,0.0
<a href=/player/diazj002>diazj002</a>,Jose Diaz,Texas Rangers,RNGRS,1,1,1,2,2006,2006,0,No,0,-0.17,-0.19,-0.02,4,26,22,0,88,88,20.0,0.0,-20.0,0.0,0.0,0.0
<a href=/player/diazj003>diazj003</a>,Juan Diaz,Seattle Mariners,MARNRS,1,2,1,3,2010,2010,0,No,0,0.34,0.86,0.52,123,57,-66,406,238,-168,0.0,0.0,0.0,0.0,0.0,0.0
<a href=/player/diazj006>diazj006</a>,Jairo Diaz,Anaheim Angels,ANGELS,2,2,3,5,2014,2015,1,No,0,0.21,-0.33,-0.54,286,38,-248,259,98,-161,305.0,0.0,-305.0,0.0,0.0,0.0
<a href=/player/diazl001>diazl001</a>,Lewin Diaz,Minnesota Twins,TWINS,1,1,3,4,2019,2020,1,Yes,0,0.54,0.34,-0.2,54,55,1,169,0,-169,0.0,128.0,128.0,0.0,0.0,0.0
<a href=/player/diazm001>diazm001</a>,Mike Diaz,Chicago Cubs,CUBS,4,10,8,18,1984,1987,3,No,0,1.78,8.04,6.26,606,1265,659,954,3508,2554,1010.0,823.0,-187.0,1753333.0,0.0,-1753333.0
<a href=/player/diazm001>diazm001</a>,Mike Diaz,Philadelphia Phillies,PHILS,1,1,1,2,1985,1985,0,No,0,1.11,0.0,-1.11,247,0,-247,606,0,-606,0.0,0.0,0.0,0.0,0.0,0.0
<a href=/player/diazm001>diazm001</a>,Mike Diaz,Pittsburgh Pirates,PIRATS,1,1,1,2,1988,1992,4,No,0,-0.59,4.39,4.98,40,398,358,158,1161,1003,0.0,0.0,0.0,172500.0,0.0,-172500.0
<a href=/player/diazm002>diazm002</a>,Mario Diaz,Seattle Mariners,MARNRS,1,1,1,2,1990,1992,2,No,0,-0.07,0.0,0.07,16,0,-16,23,0,-23,0.0,0.0,0.0,0.0,0.0,0.0
<a href=/player/diazm003>diazm003</a>,Matt Diaz,Kansas City Royals,ROYALS,1,1,1,2,2005,2005,0,No,0,4.7,0.0,-4.7,578,0,-578,1671,0,-1671,0.0,0.0,0.0,0.0,0.0,0.0
<a href=/player/diazm003>diazm003</a>,Matt Diaz,Pittsburgh Pirates,PIRATS,1,1,1,2,2011,2011,0,No,0,-1.08,0.0,1.08,67,0,-67,155,0,-155,0.0,0.0,0.0,2125000.0,0.0,-2125000.0
<a href=/player/diazm004>diazm004</a>,Miguel Diaz,Minnesota Twins,TWINS,1,1,1,2,2016,2017,1,No,0,-0.81,-0.14,0.67,142,11,-131,8,0,-8,326.0,54.0,-272.0,0.0,0.0,0.0
<a href=/player/diazr001>diazr001</a>,Robinzon Diaz,Toronto Blue Jays,BJAYS,1,1,1,2,2008,2017,9,No,0,0.65,38.31,37.66,43,1235,1192,144,5272,5128,0.0,0.0,0.0,0.0,0.0,0.0
<a href=/player/diazv001>diazv001</a>,Victor Diaz,Los Angeles Dodgers,DOGRS,1,3,2,5,2003,2003,0,No,0,0.4,0.21,-0.19,110,61,-49,377,246,-131,0.0,0.0,0.0,0.0,0.0,0.0
<a href=/player/diazv001>diazv001</a>,Victor Diaz,New York Mets,METS,6,11,10,21,2006,2021,15,Yes,0,6.15,20.68,14.53,483,1142,659,1006,3198,2192,2473.0,2300.0,-173.0,18564800.0,0.0,-18564800.0
<a href=/player/diazy001>diazy001</a>,Yandy Diaz,Cleveland Indians,INDINS,2,5,4,9,2018,2021,3,Yes,0,4.35,4.54,0.19,327,378,51,1228,1477,249,22.0,0.0,-22.0,18667000.0,0.0,-18667000.0
<a href=/player/diazy002>diazy002</a>,Yennsy Diaz,Toronto Blue Jays,BJAYS,1,3,1,4,2021,2021,0,No,0,-0.51,2.02,2.53,63,30,-33,3,2,-1,137.0,452.0,315.0,0.0,0.0,0.0
<a href=/player/dicka001>dicka001</a>,Alex Dickerson,Pittsburgh Pirates,PIRATS,2,2,3,5,2013,2015,2,No,0,-0.24,-0.25,-0.01,118,29,-89,314,41,-273,172.0,3.0,-169.0,0.0,0.0,0.0
<a href=/player/dicka001>dicka001</a>,Alex Dickerson,San Diego Padres,PADRS,1,1,1,2,2019,2019,0,Yes,0,1.35,0.0,-1.35,219,0,-219,653,0,-653,0.0,0.0,0.0,0.0,0.0,0.0
<a href=/player/dickc001>dickc001</a>,Chris Dickerson,Cincinnati Reds,REDS,1,1,1,2,2010,2010,0,No,0,-0.29,-0.1,0.19,25,13,-12,61,32,-29,0.0,0.0,0.0,415000.0,0.0,-415000.0
<a href=/player/dickc001>dickc001</a>,Chris Dickerson,Milwaukee Brewers,BREWRS,1,1,1,2,2011,2011,0,No,0,0.49,0.18,-0.31,85,43,-42,72,2,-70,0.0,99.0,99.0,0.0,0.0,0.0
<a href=/player/dickc001>dickc001</a>,Chris Dickerson,Pittsburgh Pirates,PIRATS,1,1,1,2,2014,2014,0,No,0,-0.04,0.0,0.04,41,0,-41,112,0,-112,0.0,0.0,0.0,0.0,0.0,0.0
<a href=/player/dickc002>dickc002</a>,Corey Dickerson,Colorado Rockies,ROCKS,1,2,2,4,2016,2020,4,Yes,0,4.27,1.19,-3.08,307,448,141,1191,8,-1183,0.0,649.0,649.0,0.0,0.0,0.0
<a href=/player/dickc002>dickc002</a>,Corey Dickerson,Tampa Bay Devil Rays,RAYS,1,1,3,4,2018,2018,0,Yes,0,4.09,0.0,-4.09,179,0,-179,675,0,-675,0.0,0.0,0.0,0.0,0.0,0.0
<a href=/player/dickc002>dickc002</a>,Corey Dickerson,Pittsburgh Pirates,PIRATS,1,1,1,2,2019,2019,0,No,0,0.39,0.0,-0.39,34,0,-34,137,0,-137,0.0,0.0,0.0,8500000.0,0.0,-8500000.0
<a href=/player/dickc002>dickc002</a>,Corey Dickerson,Miami Marlins,MARLNS,1,3,2,5,2021,2021,0,Yes,0,1.51,-1.03,-2.54,88,53,-35,140,134,-6,112.0,0.0,-112.0,9675000.0,0.0,-9675000.0
<a href=/player/dickj101>dickj101</a>,Jim Dickson,Houston Astros,ASTROS,2,4,2,6,1964,1966,2,No,0,0.87,1.76,0.89,66,278,212,152,894,742,15.0,0.0,-15.0,0.0,0.0,0.0
<a href=/player/dickj102>dickj102</a>,Johnny Dickshot,Pittsburgh Pirates,PIRATS,1,3,1,4,1938,1941,3,No,0,0.0,-0.2,-0.2,0,90,90,0,209,209,0.0,0.0,0.0,0.0,0.0,0.0
<a href=/player/dickl101>dickl101</a>,Leo Dickerman,Brooklyn Dodgers,DOGRS,1,1,1,2,1924,1924,0,No,0,1.56,3.16,1.6,94,42,-52,92,61,-31,751.0,454.0,-297.0,4000.0,0.0,-4000.0
<a href=/player/dickm101>dickm101</a>,Murry Dickson,Pittsburgh Pirates,PIRATS,1,1,3,4,1954,1954,0,No,0,6.26,0.0,-6.26,158,0,-158,179,0,-179,1396.0,0.0,-1396.0,0.0,0.0,0.0
<a href=/player/dickm101>dickm101</a>,Murry Dickson,Philadelphia Phillies,PHILS,4,7,7,14,1956,1968,12,No,0,28.54,33.07,4.53,1270,1974,704,1527,5948,4421,4802.0,2050.0,-2752.0,0.0,0.0,0.0
<a href=/player/dickm101>dickm101</a>,Murry Dickson,Kansas City Athletics,ATLTCS,1,1,2,3,1958,1958,0,No,0,-0.64,0.0,0.64,12,0,-12,7,0,-7,61.0,0.0,-61.0,0.0,0.0,0.0
<a href=/player/dickr001>dickr001</a>,R.A. Dickey,Minnesota Twins,TWINS,1,1,1,2,2008,2008,0,No,0,0.19,0.0,-0.19,34,0,-34,4,0,-4,337.0,0.0,-337.0,0.0,0.0,0.0
<a href=/player/dickr001>dickr001</a>,R.A. Dickey,New York Mets,METS,5,10,9,19,2012,2021,9,Yes,0,5.89,21.61,15.72,446,1069,623,898,3007,2109,2473.0,2300.0,-173.0,18229800.0,0.0,-18229800.0
<a href=/player/didib101>didib101</a>,Bob Didier,Atlanta Braves,BRAVES,1,1,1,2,1973,1973,0,No,0,0.28,0.0,-0.28,7,0,-7,25,0,-25,0.0,0.0,0.0,0.0,0.0,0.0
<a href=/player/didib101>didib101</a>,Bob Didier,Boston Red Sox,RSOX,1,1,1,2,1974,1974,0,No,0,0.0,0.0,0.0,0,0,0,0,0,0,0.0,0.0,0.0,19000.0,0.0,-19000.0
<a href=/player/diehp001>diehp001</a>,Phillip Diehl,New York Yankees,YANKS,2,2,3,5,2019,2021,2,Yes,0,-0.25,4.81,5.06,91,193,102,175,423,248,43.0,128.0,85.0,0.0,0.0,0.0
<a href=/player/diekj001>diekj001</a>,Jake Diekman,Philadelphia Phillies,PHILS,3,8,8,16,2015,2021,6,Yes,0,15.67,15.69,0.02,537,994,457,893,2918,2025,2310.0,1839.0,-471.0,535500.0,0.0,-535500.0
<a href=/player/diekj001>diekj001</a>,Jake Diekman,Texas Rangers,RNGRS,1,1,2,3,2018,2020,2,Yes,0,-0.87,-0.06,0.81,48,4,-44,0,0,0,43.0,17.0,-26.0,2712500.0,0.0,-2712500.0
<a href=/player/diekj001>diekj001</a>,Jake Diekman,Kansas City Royals,ROYALS,1,1,2,3,2019,2019,0,Yes,0,1.78,0.0,-1.78,121,0,-121,1,0,-1,307.0,0.0,-307.0,2250000.0,0.0,-2250000.0
<a href=/player/dierc101>dierc101</a>,Chuck Diering,St. Louis Cardinals,CARDS,1,2,1,3,1951,1951,0,No,0,0.42,0.0,-0.42,122,0,-122,75,0,-75,427.0,0.0,-427.0,25000.0,0.0,-25000.0
<a href=/player/dierc101>dierc101</a>,Chuck Diering,New York Giants,GIANTS,1,4,1,5,1953,1957,4,No,0,0.0,2.61,2.61,0,252,252,0,49,49,0.0,709.0,709.0,0.0,0.0,0.0
<a href=/player/dierl101>dierl101</a>,Larry Dierker,Houston Astros,ASTROS,5,9,7,16,1976,1985,9,No,0,14.67,9.46,-5.21,1469,1015,-454,4721,2946,-1775,118.0,0.0,-118.0,0.0,0.0,0.0
<a href=/player/dietb101>dietb101</a>,Bill Dietrich,Portland,Portland,2,2,4,6,1932,1943,11,No,0,2.15,0.0,-2.15,315,0,-315,237,0,-237,1995.0,0.0,-1995.0,0.0,0.0,0.0
<a href=/player/dietd001>dietd001</a>,Derek Dietrich,Tampa Bay Devil Rays,RAYS,4,8,9,17,2012,2020,8,Yes,0,5.31,13.57,8.26,749,1287,538,2527,4524,1997,283.0,217.0,-66.0,508800.0,0.0,-508800.0
<a href=/player/dietd102>dietd102</a>,Dutch Dietz,Pittsburgh Pirates,PIRATS,3,7,5,12,1943,1950,7,No,0,25.55,9.13,-16.42,1198,585,-613,3347,932,-2415,3940.0,2301.0,-1639.0,0.0,0.0,0.0
<a href=/player/difem001>difem001</a>,Mike Difelice,Tampa Bay Devil Rays,RAYS,2,3,3,6,2001,2003,2,No,0,0.72,-0.23,-0.95,68,152,84,104,387,283,243.0,290.0,47.0,3750000.0,0.0,-3750000.0
<a href=/player/diggb001>diggb001</a>,Ben Diggins,Los Angeles Dodgers,DOGRS,1,2,2,4,2002,2003,1,No,0,-0.76,-0.63,0.13,70,35,-35,11,67,56,164.0,0.0,-164.0,0.0,0.0,0.0
<a href=/player/dilaj101>dilaj101</a>,Jack DiLauro,Detroit Tigers,TIGRS,1,1,1,2,1968,1968,0,No,0,1.13,0.0,-1.13,46,0,-46,12,0,-12,191.0,0.0,-191.0,0.0,0.0,0.0
<a href=/player/dillb101>dillb101</a>,Bill Dillman,St. Louis Cardinals,CARDS,3,3,3,6,1970,1975,5,No,0,-0.22,-0.44,-0.22,36,35,-1,2,53,51,92.0,0.0,-92.0,0.0,0.0,0.0
<a href=/player/dillb102>dillb102</a>,Bob Dillinger,St.Louis Browns,ORLS,1,2,5,7,1949,1951,2,No,0,2.11,-0.19,-2.3,207,217,10,887,812,-75,0.0,0.0,0.0,0.0,0.0,0.0
<a href=/player/dillb102>dillb102</a>,Bob Dillinger,Chicago White Sox,WSOX,1,1,1,2,1952,1952,0,No,0,0.0,0.0,0.0,0,0,0,0,0,0,0.0,0.0,0.0,0.0,0.0,0.0
<a href=/player/dilld101>dilld101</a>,Don Dillard,Cleveland Indians,INDINS,10,19,17,36,1962,1978,16,No,0,30.29,13.22,-17.07,2722,1767,-955,6203,6060,-143,3067.0,1183.0,-1884.0,115500.0,0.0,-115500.0
<a href=/player/dilld101>dilld101</a>,Don Dillard,Atlanta Braves,BRAVES,2,3,3,6,1966,1966,0,No,0,0.0,0.0,0.0,0,0,0,0,0,0,0.0,0.0,0.0,0.0,0.0,0.0
<a href=/player/dillg001>dillg001</a>,Gordon Dillard,Baltimore Orioles,ORLS,2,3,2,5,1988,1990,2,No,0,3.17,2.97,-0.2,157,238,81,279,1027,748,944.0,0.0,-944.0,1150000.0,0.0,-1150000.0
<a href=/player/dillj001>dillj001</a>,Joe Dillon,Oakland Athletics,ATLTCS,1,1,1,2,2009,2009,0,No,0,0.16,1.07,0.91,15,129,114,35,587,552,0.0,0.0,0.0,0.0,0.0,0.0
<a href=/player/dillp101>dillp101</a>,Pickles Dillhoefer,Chicago Cubs,CUBS,1,3,2,5,1917,1926,9,No,0,1.4,43.04,41.64,84,484,400,105,724,619,802.0,5642.0,4840.0,5000.0,0.0,-5000.0
<a href=/player/dillp101>dillp101</a>,Pickles Dillhoefer,Philadelphia Phillies,PHILS,4,9,10,19,1919,1929,10,No,0,27.15,17.61,-9.54,1789,754,-1035,5788,2055,-3733,4451.0,3446.0,-1005.0,8500.0,0.0,-8500.0
<a href=/player/dills101>dills101</a>,Steve Dillard,Boston Red Sox,RSOX,1,1,3,4,1978,1978,0,No,0,-0.82,0.0,0.82,56,0,-56,143,0,-143,0.0,0.0,0.0,0.0,0.0,0.0
<a href=/player/dills101>dills101</a>,Steve Dillard,Detroit Tigers,TIGRS,2,3,4,7,1979,1980,1,No,0,0.12,0.0,-0.12,242,21,-221,584,43,-541,0.0,0.0,0.0,0.0,0.0,0.0
<a href=/player/dilom001>dilom001</a>,Miguel Dilone,Pittsburgh Pirates,PIRATS,5,9,10,19,1978,1984,6,No,0,24.55,-1.47,-26.02,1160,294,-866,2724,444,-2280,3108.0,299.0,-2809.0,300000.0,0.0,-300000.0
<a href=/player/dilom001>dilom001</a>,Miguel Dilone,Cleveland Indians,INDINS,1,1,1,2,1983,1983,0,No,0,-0.08,-0.19,-0.11,4,4,0,3,0,-3,0.0,35.0,35.0,225000.0,0.0,-225000.0
<a href=/player/dilom001>dilom001</a>,Miguel Dilone,Chicago White Sox,WSOX,2,3,3,6,1983,1985,2,No,0,0.33,0.15,-0.18,77,5,-72,7,0,-7,121.0,16.0,-105.0,0.0,0.0,0.0
<a href=/player/dimaj101>dimaj101</a>,Joe DiMaggio,SanFrancisco,SanFrancisco,1,1,5,6,1934,1935,1,No,0,79.19,0.0,-79.19,1736,0,-1736,7672,0,-7672,0.0,0.0,0.0,0.0,0.0,0.0
<a href=/player/dimav101>dimav101</a>,Vince DiMaggio,SanDiego,SanDiego,1,1,3,4,1936,1937,1,No,0,4.92,0.0,-4.92,282,0,-282,1150,0,-1150,0.0,0.0,0.0,0.0,0.0,0.0
<a href=/player/dimav101>dimav101</a>,Vince DiMaggio,Boston Braves,BRAVES,6,18,10,28,1939,1952,13,No,0,22.0,33.53,11.53,1506,1625,119,5516,5420,-96,0.0,2449.0,2449.0,12500.0,0.0,-12500.0
<a href=/player/dimav101>dimav101</a>,Vince DiMaggio,New York Yankees,YANKS,1,1,3,4,1939,1942,3,No,0,-0.21,-0.14,0.07,10,36,26,21,81,60,0.0,0.0,0.0,0.0,0.0,0.0
<a href=/player/dimav101>dimav101</a>,Vince DiMaggio,Cincinnati Reds,REDS,2,2,2,4,1940,1940,0,No,0,14.03,1.36,-12.67,872,93,-779,3269,350,-2919,0.0,0.0,0.0,0.0,0.0,0.0
<a href=/player/dimav101>dimav101</a>,Vince DiMaggio,Pittsburgh Pirates,PIRATS,2,2,2,4,1945,1946,1,No,0,2.29,2.69,0.4,133,135,2,517,71,-446,0.0,666.0,666.0,0.0,0.0,0.0
<a href=/player/dimav101>dimav101</a>,Vince DiMaggio,Philadelphia Phillies,PHILS,2,2,2,4,1946,1948,2,No,0,-0.3,1.87,2.17,67,348,281,179,1271,1092,0.0,0.0,0.0,0.0,0.0,0.0
<a href=/player/dimmm101>dimmm101</a>,Mike Dimmel,Baltimore Orioles,ORLS,1,1,1,2,1979,1984,5,No,0,0.02,1.56,1.54,6,333,327,3,761,758,0.0,0.0,0.0,0.0,0.0,0.0
<a href=/player/dinek101>dinek101</a>,Kerry Dineen,New York Yankees,YANKS,2,2,2,4,1977,1977,0,No,0,-0.28,0.0,0.28,74,0,-74,58,0,-58,0.0,0.0,0.0,0.0,0.0,0.0
<a href=/player/dingc001>dingc001</a>,Craig Dingman,New York Yankees,YANKS,1,1,1,2,2001,2006,5,No,0,-0.59,0.44,1.03,14,10,-4,0,0,0,22.0,81.0,59.0,0.0,0.0,0.0
<a href=/player/dinnb101>dinnb101</a>,Bill Dinneen,Boston Red Sox,RSOX,1,1,2,3,1907,1907,0,No,0,3.72,-0.2,-3.92,136,4,-132,159,0,-159,1305.0,7.0,-1298.0,0.0,0.0,0.0
<a href=/player/dipif001>dipif001</a>,Frank DiPino,Milwaukee Brewers,BREWRS,2,5,4,9,1982,1986,4,No,0,18.77,6.8,-11.97,1695,100,-1595,3977,0,-3977,2039.0,1974.0,-65.0,625000.0,0.0,-625000.0
<a href=/player/dipif001>dipif001</a>,Frank DiPino,Houston Astros,ASTROS,1,1,1,2,1986,1987,1,No,0,0.82,0.84,0.02,324,84,-240,15,169,154,631.0,0.0,-631.0,280000.0,0.0,-280000.0
<a href=/player/diplm001>diplm001</a>,Marcos Diplan,Texas Rangers,RNGRS,1,3,2,5,2015,2015,0,No,0,4.24,4.26,0.02,471,35,-436,105,4,-101,683.0,553.0,-130.0,0.0,0.0,0.0
<a href=/player/dipoj001>dipoj001</a>,Jerry DiPoto,Cleveland Indians,INDINS,5,11,9,20,1994,2001,7,No,0,59.36,5.4,-53.96,3537,380,-3157,10591,1129,-9462,3110.0,195.0,-2915.0,7871666.0,0.0,-7871666.0
<a href=/player/dipoj001>dipoj001</a>,Jerry DiPoto,New York Mets,METS,2,2,2,4,1996,1998,2,No,1,5.63,1.87,-3.76,436,53,-383,18,63,45,802.0,479.0,-323.0,225000.0,0.0,-225000.0
<a href=/player/distd101>distd101</a>,Dutch Distel,St. Louis Cardinals,CARDS,1,4,1,5,1918,1918,0,No,0,0.0,0.57,0.57,0,80,80,0,312,312,0.0,0.0,0.0,0.0,0.0,0.0
<a href=/player/ditma101>ditma101</a>,Art Ditmar,Kansas City Athletics,ATLTCS,38,80,81,161,1957,1976,19,No,0,137.3,59.64,-77.66,12943,8836,-4107,29783,24655,-5128,18720.0,9434.0,-9286.0,506100.0,0.0,-506100.0
<a href=/player/ditma101>ditma101</a>,Art Ditmar,New York Yankees,YANKS,3,6,4,10,1961,1966,5,No,0,-0.26,3.2,3.46,405,420,15,1128,119,-1009,748.0,1424.0,676.0,84000.0,0.0,-84000.0
<a href=/player/dittj101>dittj101</a>,Jack Dittmer,Milwaukee Braves,BRAVES,3,8,5,13,1957,1961,4,No,0,-1.07,-0.69,0.38,297,102,-195,661,325,-336,138.0,0.0,-138.0,0.0,0.0,0.0
<a href=/player/dittj101>dittj101</a>,Jack Dittmer,Detroit Tigers,TIGRS,1,1,1,2,1957,1958,1,No,0,0.0,0.0,0.0,0,0,0,0,0,0,0.0,0.0,0.0,0.0,0.0,0.0
<a href=/player/dixob001>dixob001</a>,Brandon Dixon,Los Angeles Dodgers,DOGRS,3,7,6,13,2015,2019,4,No,0,7.85,6.19,-1.66,1100,293,-807,3346,616,-2730,1782.0,1084.0,-698.0,0.0,0.0,0.0
<a href=/player/dixok001>dixok001</a>,Ken Dixon,Baltimore Orioles,ORLS,2,2,2,4,1987,1994,7,No,0,8.5,12.96,4.46,214,773,559,205,3122,2917,1800.0,214.0,-1586.0,155000.0,0.0,-155000.0
<a href=/player/dixol101>dixol101</a>,Leo Dixon,StPaul,StPaul,7,9,17,26,1925,1935,10,No,0,6.06,0.0,-6.06,1070,0,-1070,3296,0,-3296,611.0,0.0,-611.0,0.0,0.0,0.0
<a href=/player/dixol101>dixol101</a>,Leo Dixon,New York Giants,GIANTS,1,3,1,4,1920,1920,0,No,0,0.0,0.0,0.0,0,0,0,0,0,0,0.0,0.0,0.0,1800.0,0.0,-1800.0
<a href=/player/dixos101>dixos101</a>,Sonny Dixon,Washington Senators,TWINS,2,2,2,4,1954,1955,1,No,0,-0.73,0.12,0.85,10,44,34,3,18,15,35.0,179.0,144.0,0.0,0.0,0.0
<a href=/player/dixos101>dixos101</a>,Sonny Dixon,Chicago White Sox,WSOX,1,4,2,6,1954,1956,2,No,0,0.81,2.11,1.3,331,206,-125,724,121,-603,571.0,421.0,-150.0,8500.0,0.0,-8500.0
<a href=/player/dixos101>dixos101</a>,Sonny Dixon,Kansas City Athletics,ATLTCS,1,2,2,4,1955,1956,1,No,0,-0.12,3.23,3.35,6,249,243,1,578,577,13.0,134.0,121.0,0.0,0.0,0.0
<a href=/player/dixot101>dixot101</a>,Tom Dixon,New York Mets,METS,1,1,1,2,1983,1983,0,No,0,-0.19,0.0,0.19,8,0,-8,0,0,0,11.0,0.0,-11.0,0.0,0.0,0.0
<a href=/player/dixot101>dixot101</a>,Tom Dixon,Montreal Expos,NATEX,1,1,1,2,1983,1984,1,No,0,0.0,-0.07,-0.07,0,5,5,0,5,5,0.0,0.0,0.0,0.0,0.0,0.0
<a href=/player/dlugb001>dlugb001</a>,Brent Dlugach,Detroit Tigers,TIGRS,1,1,1,2,2010,2011,1,No,0,0.0,0.0,0.0,0,0,0,0,0,0,0.0,0.0,0.0,0.0,0.0,0.0
<a href=/player/doakb101>doakb101</a>,Bill Doak,St. Louis Cardinals,CARDS,1,1,1,2,1924,1924,0,No,0,4.95,2.82,-2.13,152,36,-116,144,45,-99,1187.0,359.0,-828.0,0.0,0.0,0.0
<a href=/player/dobbd101>dobbd101</a>,Dan Dobbek,Minnesota Twins,TWINS,1,1,1,2,1962,1969,7,No,0,0.0,-1.16,-1.16,0,407,407,0,897,897,0.0,0.0,0.0,0.0,0.0,0.0
<a href=/player/dobsj101>dobsj101</a>,Joe Dobson,Cleveland Indians,INDINS,2,4,5,9,1940,1945,5,No,0,20.77,6.72,-14.05,691,626,-65,1095,1460,365,4952.0,2948.0,-2004.0,22322.0,0.0,-22322.0
<a href=/player/dobsj101>dobsj101</a>,Joe Dobson,Boston Red Sox,RSOX,3,9,8,17,1950,1956,6,No,0,14.02,9.79,-4.23,1662,1085,-577,5506,3192,-2314,1880.0,1611.0,-269.0,111000.0,0.0,-111000.0
<a href=/player/dobsp101>dobsp101</a>,Pat Dobson,Detroit Tigers,TIGRS,1,2,1,3,1969,1973,4,No,0,3.09,4.22,1.13,408,176,-232,1366,140,-1226,753.0,1147.0,394.0,12000.0,0.0,-12000.0
<a href=/player/dobsp101>dobsp101</a>,Pat Dobson,San Diego Padres,PADRS,2,3,5,8,1970,1978,8,No,0,5.53,1.56,-3.97,208,961,753,208,2714,2506,1767.0,691.0,-1076.0,35500.0,0.0,-35500.0
<a href=/player/dobsp101>dobsp101</a>,Pat Dobson,Baltimore Orioles,ORLS,12,27,22,49,1972,1994,22,No,3,53.13,90.0,36.87,3098,4599,1501,7090,11622,4532,12003.0,13691.0,1688.0,846833.0,0.0,-846833.0
<a href=/player/dobsp101>dobsp101</a>,Pat Dobson,Atlanta Braves,BRAVES,5,8,11,19,1973,1977,4,No,0,13.07,0.66,-12.41,518,456,-62,701,235,-466,2735.0,1060.0,-1675.0,58000.0,0.0,-58000.0
<a href=/player/dobsp101>dobsp101</a>,Pat Dobson,New York Yankees,YANKS,5,8,8,16,1975,1983,8,No,0,30.56,15.51,-15.05,1856,842,-1014,2195,2957,762,5679.0,0.0,-5679.0,79000.0,0.0,-79000.0
<a href=/player/dobyl101>dobyl101</a>,Larry Doby,Cleveland Indians,INDINS,11,18,18,36,1955,1968,13,No,0,111.88,34.63,-77.25,5110,3069,-2041,17444,11205,-6239,4502.0,562.0,-3940.0,52000.0,0.0,-52000.0
<a href=/player/dobyl101>dobyl101</a>,Larry Doby,Chicago White Sox,WSOX,15,26,28,54,1957,1969,12,No,0,18.37,37.27,18.9,2207,3220,1013,3806,5515,1709,4631.0,7668.0,3037.0,148250.0,0.0,-148250.0
<a href=/player/dobyl101>dobyl101</a>,Larry Doby,Baltimore Orioles,ORLS,3,4,5,9,1958,1960,2,No,0,14.22,11.82,-2.4,668,719,51,1551,2462,911,2254.0,614.0,-1640.0,0.0,0.0,0.0
<a href=/player/dobyl101>dobyl101</a>,Larry Doby,Cleveland Indians,INDINS,1,1,1,2,1959,1964,5,No,0,-0.62,11.39,12.01,18,835,817,64,3298,3234,0.0,0.0,0.0,0.0,0.0,0.0
<a href=/player/doddt001>doddt001</a>,Tom Dodd,New York Yankees,YANKS,1,3,1,4,1982,1983,1,No,0,-0.79,-0.41,0.38,55,69,14,159,249,90,0.0,0.0,0.0,250000.0,0.0,-250000.0
<a href=/player/doddt001>doddt001</a>,Tom Dodd,Toronto Blue Jays,BJAYS,5,11,10,21,1982,2002,20,No,2,27.04,54.84,27.8,1781,2798,1017,5518,11043,5525,3160.0,1213.0,-1947.0,5387500.0,0.0,-5387500.0
<a href=/player/dodgj101>dodgj101</a>,John Dodge,Philadelphia Phillies,PHILS,1,1,1,2,1913,1913,0,No,0,0.1,2.9,2.8,94,88,-6,344,336,-8,0.0,0.0,0.0,1800.0,0.0,-1800.0
<a href=/player/dohej101>dohej101</a>,John Doherty,California Angels,ANGELS,1,1,1,2,1977,1978,1,No,0,0.0,0.11,0.11,0,10,10,0,25,25,0.0,0.0,0.0,0.0,0.0,0.0
<a href=/player/dohms001>dohms001</a>,Scott Dohmann,Colorado Rockies,ROCKS,2,3,3,6,2006,2007,1,No,0,0.87,-0.8,-1.67,160,227,67,478,3,-475,128.0,305.0,177.0,662000.0,0.0,-662000.0
<a href=/player/dolac101>dolac101</a>,Cozy Dolan,Chicago White Sox,WSOX,2,3,2,5,1903,1905,2,No,0,1.3,-0.02,-1.32,324,98,-226,1382,394,-988,0.0,0.0,0.0,0.0,0.0,0.0
<a href=/player/dolac102>dolac102</a>,Cozy Dolan,Philadelphia Phillies,PHILS,1,2,2,4,1913,1917,4,No,0,0.05,0.62,0.57,35,329,294,151,1239,1088,0.0,147.0,147.0,2750.0,0.0,-2750.0
<a href=/player/dolac102>dolac102</a>,Cozy Dolan,Pittsburgh Pirates,PIRATS,1,5,3,8,1913,1915,2,No,0,18.03,3.31,-14.72,1733,233,-1500,6155,938,-5217,795.0,0.0,-795.0,11400.0,0.0,-11400.0
<a href=/player/domij001>domij001</a>,Juan Dominguez,Texas Rangers,RNGRS,1,1,3,4,2006,2008,2,No,0,0.0,-0.39,-0.39,0,74,74,0,9,9,0.0,769.0,769.0,0.0,0.0,0.0
<a href=/player/domij002>domij002</a>,Jose Dominguez,Los Angeles Dodgers,DOGRS,1,2,2,4,2014,2018,4,No,0,0.23,0.98,0.75,5,298,293,0,4,4,17.0,353.0,336.0,501000.0,0.0,-501000.0
<a href=/player/domim001>domim001</a>,Matt Dominguez,Miami Marlins,MARLNS,1,2,1,3,2012,2012,0,No,0,1.76,-0.39,-2.15,340,81,-259,1309,338,-971,0.0,0.0,0.0,0.0,0.0,0.0
<a href=/player/donaj001>donaj001</a>,Josh Donaldson,Chicago Cubs,CUBS,1,4,2,6,2008,2009,1,No,0,13.08,4.54,-8.54,545,124,-421,2047,74,-1973,213.0,718.0,505.0,0.0,0.0,0.0
<a href=/player/donaj001>donaj001</a>,Josh Donaldson,Oakland Athletics,ATLTCS,3,3,7,10,2014,2021,7,Yes,0,20.44,7.94,-12.5,562,462,-100,2468,938,-1530,0.0,1747.0,1747.0,2425000.0,0.0,-2425000.0
<a href=/player/donaj001>donaj001</a>,Josh Donaldson,Toronto Blue Jays,BJAYS,1,2,1,3,2018,2018,0,Yes,0,0.4,0.0,-0.4,16,0,-16,60,0,-60,0.0,0.0,0.0,23000000.0,0.0,-23000000.0
<a href=/player/donaj002>donaj002</a>,Jason Donald,Philadelphia Phillies,PHILS,3,6,6,12,2009,2015,6,No,0,27.43,-0.46,-27.89,716,374,-342,1539,630,-909,4038.0,442.0,-3596.0,1175000.0,0.0,-1175000.0
<a href=/player/donaj002>donaj002</a>,Jason Donald,Cleveland Indians,INDINS,4,8,11,19,2012,2019,7,Yes,0,9.51,23.51,14.0,376,937,561,1266,910,-356,399.0,4479.0,4080.0,22963900.0,0.0,-22963900.0
<a href=/player/donaj101>donaj101</a>,John Donaldson,Oakland Athletics,ATLTCS,1,1,1,2,1969,1972,3,No,0,-1.0,0.07,1.07,95,60,-35,378,103,-275,0.0,0.0,0.0,14500.0,0.0,-14500.0
<a href=/player/donaj101>donaj101</a>,John Donaldson,Milwaukee Brewers,BREWRS,1,1,1,2,1970,1970,0,No,0,0.26,-0.21,-0.47,51,121,70,113,453,340,0.0,0.0,0.0,0.0,0.0,0.0
<a href=/player/donaj101>donaj101</a>,John Donaldson,Oakland Athletics,ATLTCS,1,1,1,2,1971,1971,0,No,0,0.0,-0.15,-0.15,0,8,8,0,1,1,0.0,17.0,17.0,0.0,0.0,0.0
<a href=/player/donaj101>donaj101</a>,John Donaldson,Detroit Tigers,TIGRS,1,1,1,2,1972,1972,0,No,0,0.0,0.0,0.0,0,0,0,0,0,0,0.0,0.0,0.0,0.0,0.0,0.0
<a href=/player/donaj103>donaj103</a>,Jiggs Donahue,Chicago White Sox,WSOX,1,3,1,4,1909,1910,1,No,0,-0.91,1.19,2.1,140,48,-92,366,63,-303,237.0,502.0,265.0,2400.0,0.0,-2400.0
<a href=/player/donar101>donar101</a>,Red Donahue,St. Louis Cardinals,CARDS,2,4,7,11,1897,1899,2,No,0,17.28,9.65,-7.63,1436,631,-805,5066,2410,-2656,3837.0,1192.0,-2645.0,0.0,0.0,0.0
<a href=/player/donar101>donar101</a>,Red Donahue,St.Louis Browns,ORLS,1,1,1,2,1903,1903,0,No,0,4.62,0.28,-4.34,142,16,-126,222,24,-198,1669.0,183.0,-1486.0,0.0,0.0,0.0
<a href=/player/donar101>donar101</a>,Red Donahue,Cleveland Indians,INDINS,1,1,1,2,1905,1905,0,No,0,3.83,0.0,-3.83,57,0,-57,92,0,-92,723.0,0.0,-723.0,0.0,0.0,0.0
<a href=/player/donas101>donas101</a>,She Donahue,Philadelphia Phillies,PHILS,1,2,1,3,1905,1905,0,No,0,0.0,0.2,0.2,0,16,16,0,52,52,0.0,0.0,0.0,0.0,0.0,0.0
<a href=/player/donlm101>donlm101</a>,Mike Donlin,Cincinnati Reds,REDS,3,5,4,9,1904,1910,6,No,0,32.35,12.28,-20.07,1177,389,-788,4679,862,-3817,9.0,2982.0,2973.0,3300.0,0.0,-3300.0
<a href=/player/donlm101>donlm101</a>,Mike Donlin,Boston Braves,BRAVES,1,1,1,2,1912,1914,2,No,0,1.3,0.31,-0.99,77,145,68,274,680,406,0.0,0.0,0.0,0.0,0.0,0.0
<a href=/player/donnb001>donnb001</a>,Brendan Donnelly,Anaheim Angels,ANGELS,1,1,1,2,2006,2007,1,No,0,0.55,0.0,-0.55,29,0,-29,0,0,0,62.0,0.0,-62.0,950000.0,0.0,-950000.0
<a href=/player/donnc001>donnc001</a>,Chris Donnels,Arizona Diamondbacks,DBACKS,1,1,1,2,2003,2003,0,No,0,0.0,0.0,0.0,0,0,0,0,0,0,0.0,0.0,0.0,0.0,0.0,0.0
<a href=/player/donnj101>donnj101</a>,Jim Donnelly,Baltimore Orioles,BLN,2,4,6,10,1896,1903,7,No,0,2.95,7.66,4.71,454,485,31,1885,2090,205,0.0,0.0,0.0,0.0,0.0,0.0
<a href=/player/donnj101>donnj101</a>,Jim Donnelly,New York Giants,GIANTS,1,3,2,5,1897,1903,6,No,0,-0.53,7.63,8.16,24,437,413,105,1697,1592,0.0,0.0,0.0,0.0,0.0,0.0
<a href=/player/donod101>donod101</a>,Dick Donovan,Washington Senators,RNGRS,4,7,5,12,1961,1970,9,No,0,4.25,0.29,-3.96,404,337,-67,701,1154,453,1913.0,6.0,-1907.0,0.0,0.0,0.0
<a href=/player/donoj103>donoj103</a>,Jim Donohue,St. Louis Cardinals,CARDS,1,2,1,3,1960,1960,0,No,0,0.0,-0.2,-0.2,0,32,32,0,32,32,0.0,0.0,0.0,0.0,0.0,0.0
<a href=/player/donoj103>donoj103</a>,Jim Donohue,Detroit Tigers,TIGRS,1,1,1,2,1961,1961,0,No,0,1.6,-0.1,-1.7,100,6,-94,33,3,-30,374.0,36.0,-338.0,0.0,0.0,0.0
<a href=/player/donoj103>donoj103</a>,Jim Donohue,Los Angeles Angels,ANGELS,2,2,2,4,1962,1966,4,No,0,0.28,3.36,3.08,44,277,233,4,244,240,109.0,1232.0,1123.0,16500.0,0.0,-16500.0
<a href=/player/donop102>donop102</a>,Pete Donohue,Cincinnati Reds,REDS,4,9,4,13,1930,1932,2,No,0,-0.65,6.36,7.01,300,397,97,801,1584,783,303.0,0.0,-303.0,27500.0,0.0,-27500.0
<a href=/player/dooir101>dooir101</a>,Red Dooin,Philadelphia Phillies,PHILS,2,3,2,5,1915,1918,3,No,0,-0.57,3.71,4.28,32,454,422,123,1633,1510,0.0,338.0,338.0,0.0,0.0,0.0
<a href=/player/doolm101>doolm101</a>,Mickey Doolin,Baltimore Terrapins,BLF,1,1,2,3,1915,1916,1,No,0,0.08,0.0,-0.08,24,0,-24,92,0,-92,0.0,0.0,0.0,0.0,0.0,0.0
<a href=/player/dools001>dools001</a>,Sean Doolittle,Oakland Athletics,ATLTCS,3,5,6,11,2017,2021,4,Yes,0,3.83,7.65,3.82,466,297,-169,88,313,225,792.0,885.0,93.0,0.0,0.0,0.0
<a href=/player/dopsj001>dopsj001</a>,John Dopson,Montreal Expos,NATEX,2,3,4,7,1988,1992,4,No,2,6.16,6.42,0.26,597,552,-45,1669,1976,307,1455.0,0.0,-1455.0,132500.0,0.0,-132500.0
<a href=/player/dorab001>dorab001</a>,Bill Doran,Houston Astros,ASTROS,1,1,3,4,1990,1992,2,No,0,2.7,-0.24,-2.94,260,60,-200,933,65,-868,0.0,497.0,497.0,934000.0,0.0,-934000.0
<a href=/player/dorif101>dorif101</a>,Fritz Dorish,Chicago White Sox,WSOX,1,1,1,2,1955,1955,0,No,0,1.53,0.18,-1.35,96,32,-64,11,68,57,256.0,0.0,-256.0,0.0,0.0,0.0
<a href=/player/dormc101>dormc101</a>,Charlie Dorman,Chicago White Sox,WSOX,1,1,1,2,1923,1923,0,No,0,0.0,0.08,0.08,0,23,23,0,75,75,0.0,0.0,0.0,1950.0,0.0,-1950.0
<a href=/player/dorng101>dorng101</a>,Gus Dorner,Cleveland Indians,INDINS,1,2,1,3,1903,1919,16,No,0,0.0,38.48,38.48,0,1619,1619,0,6493,6493,0.0,0.0,0.0,0.0,0.0,0.0
<a href=/player/dorng101>dorng101</a>,Gus Dorner,Cincinnati Reds,REDS,2,2,4,6,1906,1912,6,No,0,-4.64,3.06,7.7,324,62,-262,398,87,-311,3265.0,704.0,-2561.0,0.0,0.0,0.0
<a href=/player/dorsb001>dorsb001</a>,Brian Dorsett,Oakland Athletics,ATLTCS,1,2,1,3,1987,1987,0,No,0,-0.62,0.31,0.93,21,61,40,12,249,237,224.0,0.0,-224.0,0.0,0.0,0.0
<a href=/player/dorsb001>dorsb001</a>,Brian Dorsett,Cleveland Indians,INDINS,1,1,1,2,1988,1989,1,No,0,-0.14,0.0,0.14,7,0,-7,12,0,-12,0.0,0.0,0.0,0.0,0.0,0.0
<a href=/player/dorsb001>dorsb001</a>,Brian Dorsett,California Angels,ANGELS,1,1,1,2,1988,1988,0,No,0,-0.19,0.0,0.19,22,0,-22,60,0,-60,0.0,0.0,0.0,0.0,0.0,0.0
<a href=/player/dorsb001>dorsb001</a>,Brian Dorsett,San Diego Padres,PADRS,1,1,1,2,1991,1991,0,No,0,0.0,0.0,0.0,0,0,0,0,0,0,0.0,0.0,0.0,0.0,0.0,0.0
<a href=/player/dorsj001>dorsj001</a>,Jim Dorsey,California Angels,ANGELS,3,7,5,12,1981,1992,11,No,1,-0.2,18.35,18.55,173,631,458,348,1947,1599,512.0,2439.0,1927.0,0.0,0.0,0.0
<a href=/player/doteo001>doteo001</a>,Octavio Dotel,New York Mets,METS,3,11,7,18,1999,2019,20,No,2,19.7,56.63,36.93,1217,2753,1536,1710,7808,6098,3509.0,2332.0,-1177.0,4085500.0,0.0,-4085500.0
<a href=/player/doteo001>doteo001</a>,Octavio Dotel,Houston Astros,ASTROS,2,4,3,7,2004,2011,7,No,2,1.22,3.09,1.87,62,180,118,0,686,686,198.0,0.0,-198.0,2800000.0,0.0,-2800000.0
<a href=/player/doteo001>doteo001</a>,Octavio Dotel,Kansas City Royals,ROYALS,1,1,1,2,2007,2011,4,No,0,-0.08,2.27,2.35,18,104,86,0,8,8,23.0,1593.0,1570.0,5000000.0,0.0,-5000000.0
<a href=/player/doteo001>doteo001</a>,Octavio Dotel,Pittsburgh Pirates,PIRATS,1,2,2,4,2010,2015,5,No,0,0.31,2.14,1.83,38,219,181,1,259,258,56.0,1307.0,1251.0,3250000.0,0.0,-3250000.0
<a href=/player/doteo001>doteo001</a>,Octavio Dotel,Los Angeles Dodgers,DOGRS,1,1,1,2,2010,2010,0,No,0,-0.1,0.0,0.1,16,0,-16,0,0,0,16.0,0.0,-16.0,0.0,0.0,0.0
<a href=/player/doteo001>doteo001</a>,Octavio Dotel,Toronto Blue Jays,BJAYS,1,4,4,8,2011,2014,3,No,0,0.4,6.43,6.03,344,416,72,89,1599,1510,547.0,15.0,-532.0,4329600.0,0.0,-4329600.0
<a href=/player/dotsr001>dotsr001</a>,Richard Dotson,California Angels,ANGELS,1,3,3,6,1977,1990,13,No,0,18.22,44.27,26.05,460,1735,1275,586,6912,6326,4818.0,1336.0,-3482.0,175000.0,0.0,-175000.0
<a href=/player/dotsr001>dotsr001</a>,Richard Dotson,Chicago White Sox,WSOX,3,5,7,12,1987,1997,10,No,0,-1.68,12.63,14.31,132,1505,1373,105,4423,4318,928.0,727.0,-201.0,1340000.0,0.0,-1340000.0
<a href=/player/dottd101>dottd101</a>,Dutch Dotterer,Cincinnati Reds,REDS,1,1,1,2,1960,1960,0,No,0,0.0,0.0,0.0,0,0,0,0,0,0,0.0,0.0,0.0,0.0,0.0,0.0
<a href=/player/doubf001>doubf001</a>,Felix Doubront,Boston Red Sox,RSOX,1,1,1,2,2014,2020,6,No,0,0.42,-0.14,-0.56,8,122,114,8,271,263,61.0,0.0,-61.0,586000.0,0.0,-586000.0
<a href=/player/dougk101>dougk101</a>,Klondike Douglass,St. Louis Cardinals,CARDS,2,4,7,11,1897,1899,2,No,0,17.28,9.65,-7.63,1436,631,-805,5066,2410,-2656,3837.0,1192.0,-2645.0,0.0,0.0,0.0
<a href=/player/dougl101>dougl101</a>,Larry Douglas,Pittsburgh Pirates,PIRATS,3,8,4,12,1916,1922,6,No,0,39.97,14.79,-25.18,1164,990,-174,2135,3762,1627,8893.0,711.0,-8182.0,9650.0,0.0,-9650.0
<a href=/player/dougp101>dougp101</a>,Phil Douglas,Chicago Cubs,CUBS,4,10,7,17,1919,1926,7,No,0,35.21,12.09,-23.12,1416,566,-850,4591,1420,-3171,3907.0,3229.0,-678.0,22006.0,0.0,-22006.0
<a href=/player/dougp102>dougp102</a>,Patsy Dougherty,Boston Red Sox,RSOX,1,1,1,2,1904,1908,4,No,0,1.13,2.47,1.34,234,263,29,989,1019,30,0.0,0.0,0.0,0.0,0.0,0.0
<a href=/player/dougw101>dougw101</a>,Whammy Douglas,Pittsburgh Pirates,PIRATS,9,16,18,34,1959,1973,14,No,0,-0.94,37.67,38.61,564,1623,1059,1204,4862,3658,386.0,2327.0,1941.0,17500.0,0.0,-17500.0
<a href=/player/doumr001>doumr001</a>,Ryan Doumit,Minnesota Twins,TWINS,1,1,1,2,2013,2014,1,No,0,-0.66,0.0,0.66,100,0,-100,166,0,-166,0.0,0.0,0.0,3500000.0,0.0,-3500000.0
<a href=/player/doutt101>doutt101</a>,Taylor Douthit,St. Louis Cardinals,CARDS,1,1,1,2,1931,1931,0,No,0,-0.27,-0.24,0.03,192,45,-147,798,169,-629,0.0,0.0,0.0,0.0,0.0,0.0
<a href=/player/doutt101>doutt101</a>,Taylor Douthit,Chicago Cubs,CUBS,1,1,1,2,1933,1933,0,No,0,0.0,0.17,0.17,0,31,31,0,92,92,0.0,0.0,0.0,0.0,0.0,0.0
<a href=/player/dowdk001>dowdk001</a>,Kyle Dowdy,Detroit Tigers,TIGRS,1,2,1,3,2018,2018,0,Yes,0,0.14,0.0,-0.14,71,0,-71,281,0,-281,0.0,0.0,0.0,1750000.0,0.0,-1750000.0
<a href=/player/dowdt101>dowdt101</a>,Tommy Dowd,St. Louis Cardinals,CARDS,2,2,5,7,1897,1899,2,No,0,0.17,-2.08,-2.25,225,312,87,972,1336,364,0.0,0.0,0.0,0.0,0.0,0.0
<a href=/player/dowdt101>dowdt101</a>,Tommy Dowd,Philadelphia Phillies,PHILS,1,5,3,8,1897,1902,5,No,0,9.88,14.87,4.99,647,845,198,2475,2785,310,1192.0,3296.0,2104.0,0.0,0.0,0.0
<a href=/player/dowld101>dowld101</a>,Dave Dowling,Chicago Cubs,CUBS,3,5,5,10,1968,1976,8,No,0,1.41,-2.65,-4.06,244,580,336,611,1135,524,48.0,653.0,605.0,0.0,0.0,0.0
<a href=/player/downa101>downa101</a>,Al Downing,New York Yankees,YANKS,28,61,49,110,1969,2001,32,No,2,108.82,84.98,-23.84,7372,4874,-2498,18658,11141,-7517,21552.0,11941.0,-9611.0,5675833.0,0.0,-5675833.0
<a href=/player/downa101>downa101</a>,Al Downing,Oakland Athletics,ATLTCS,1,2,1,3,1970,1971,1,No,0,0.4,-0.79,-1.19,86,96,10,104,141,37,283.0,0.0,-283.0,62000.0,0.0,-62000.0
<a href=/player/downa101>downa101</a>,Al Downing,Milwaukee Brewers,BREWRS,2,2,2,4,1971,1972,1,No,0,5.66,0.71,-4.95,389,170,-219,459,431,-28,2693.0,0.0,-2693.0,0.0,0.0,0.0
<a href=/player/downb001>downb001</a>,Brian Downing,Chicago White Sox,WSOX,8,12,15,27,1977,1997,20,No,0,45.63,32.75,-12.88,2200,2303,103,7990,6201,-1789,3475.0,5246.0,1771.0,1390000.0,0.0,-1390000.0
<a href=/player/downk001>downk001</a>,Kelly Downs,Philadelphia Phillies,PHILS,2,3,3,6,1984,1985,1,No,0,3.94,-0.28,-4.22,400,66,-334,337,103,-234,2374.0,85.0,-2289.0,0.0,0.0,0.0
<a href=/player/downs001>downs001</a>,Scott Downs,Chicago Cubs,CUBS,1,2,1,3,1998,2002,4,No,0,0.0,-0.23,-0.23,0,10,10,0,7,7,0.0,68.0,68.0,0.0,0.0,0.0
<a href=/player/downs001>downs001</a>,Scott Downs,Minnesota Twins,TWINS,2,3,3,6,1999,2006,7,No,0,2.68,7.1,4.42,288,208,-80,99,24,-75,1148.0,2925.0,1777.0,8250000.0,0.0,-8250000.0
<a href=/player/downs001>downs001</a>,Scott Downs,Chicago Cubs,CUBS,2,2,3,5,2000,2001,1,No,2,-1.2,2.57,3.77,27,114,87,25,431,406,207.0,0.0,-207.0,0.0,0.0,0.0
<a href=/player/downs001>downs001</a>,Scott Downs,Anaheim Angels,ANGELS,1,1,1,2,2013,2016,3,No,0,0.07,0.69,0.62,50,89,39,0,1,1,42.0,349.0,307.0,0.0,0.0,0.0
<a href=/player/downt101>downt101</a>,Tom Downey,Chicago Cubs,CUBS,1,2,1,3,1909,1909,0,No,0,2.39,-0.63,-3.02,347,20,-327,1320,55,-1265,0.0,0.0,0.0,0.0,0.0,0.0
<a href=/player/doylb101>doylb101</a>,Brian Doyle,Texas Rangers,RNGRS,1,3,1,4,1977,1978,1,No,0,-0.74,-0.56,0.18,93,93,0,171,128,-43,0.0,0.0,0.0,0.0,0.0,0.0
<a href=/player/doylc102>doylc102</a>,Carl Doyle,Philadelphia Athletics,ATLTCS,1,4,1,5,1937,1940,3,No,0,0.0,6.28,6.28,0,278,278,0,321,321,0.0,1514.0,1514.0,0.0,0.0,0.0
<a href=/player/doylc102>doylc102</a>,Carl Doyle,Brooklyn Dodgers,DOGRS,1,5,2,7,1940,1946,6,No,0,2.24,22.24,20.0,200,770,570,485,2187,1702,487.0,3020.0,2533.0,0.0,0.0,0.0
<a href=/player/doyld102>doyld102</a>,Denny Doyle,Philadelphia Phillies,PHILS,1,1,3,4,1973,1974,1,No,0,3.34,0.0,-3.34,155,59,-96,564,114,-450,0.0,0.0,0.0,40000.0,0.0,-40000.0
<a href=/player/doyld102>doyld102</a>,Denny Doyle,California Angels,ANGELS,1,1,2,3,1975,1976,1,No,0,2.26,0.0,-2.26,343,0,-343,1298,0,-1298,0.0,0.0,0.0,0.0,0.0,0.0
<a href=/player/doylj103>doylj103</a>,Jack Doyle,New York Giants,GIANTS,1,1,2,3,1895,1901,6,No,0,6.54,3.48,-3.06,232,673,441,1038,2853,1815,0.0,0.0,0.0,0.0,0.0,0.0
<a href=/player/doylj103>doylj103</a>,Jack Doyle,Baltimore Orioles,BLN,2,4,4,8,1897,1899,2,No,0,2.28,18.6,16.32,271,446,175,1095,1688,593,148.0,1122.0,974.0,0.0,0.0,0.0
<a href=/player/doylj103>doylj103</a>,Jack Doyle,New York Giants,GIANTS,1,1,3,4,1901,1902,1,No,0,-0.18,1.46,1.64,75,273,198,299,1133,834,0.0,0.0,0.0,0.0,0.0,0.0
<a href=/player/doylj107>doylj107</a>,Jim Doyle,Utica,Utica,1,1,1,2,1909,1909,0,No,0,-0.19,0.0,0.19,7,0,-7,15,0,-15,0.0,0.0,0.0,0.0,0.0,0.0
<a href=/player/doylj107>doylj107</a>,Jim Doyle,Cincinnati Reds,REDS,1,2,1,3,1910,1910,0,No,0,0.0,-0.59,-0.59,0,21,21,0,69,69,0.0,0.0,0.0,0.0,0.0,0.0
<a href=/player/doyll101>doyll101</a>,Larry Doyle,New York Giants,GIANTS,1,3,1,4,1916,1916,0,No,0,2.13,0.44,-1.69,153,40,-113,610,161,-449,0.0,0.0,0.0,7400.0,0.0,-7400.0
<a href=/player/doyll101>doyll101</a>,Larry Doyle,Chicago Cubs,CUBS,1,3,1,4,1918,1918,0,No,0,1.89,7.03,5.14,176,71,-105,557,112,-445,0.0,807.0,807.0,0.0,0.0,0.0
<a href=/player/doyll101>doyll101</a>,Larry Doyle,Boston Braves,BRAVES,2,3,3,6,1918,1921,3,No,0,20.68,4.26,-16.42,840,475,-365,2277,2024,-253,3450.0,0.0,-3450.0,0.0,0.0,0.0
<a href=/player/doylp101>doylp101</a>,Paul Doyle,Houston Astros,ASTROS,2,3,2,5,1968,1970,2,No,0,0.43,-0.44,-0.87,270,122,-148,685,445,-240,117.0,0.0,-117.0,12000.0,0.0,-12000.0
<a href=/player/dozib001>dozib001</a>,Brian Dozier,Minnesota Twins,TWINS,2,4,6,10,2018,2020,2,Yes,0,-0.18,1.88,2.06,171,61,-110,244,205,-39,170.0,200.0,30.0,9000000.0,0.0,-9000000.0
<a href=/player/dozid001>dozid001</a>,D.J. Dozier,New York Mets,METS,2,4,2,6,1992,1993,1,No,0,12.22,-0.41,-12.63,490,79,-411,1635,295,-1340,509.0,0.0,-509.0,2535000.0,0.0,-2535000.0
<a href=/player/dozit001>dozit001</a>,Tom Dozier,St. Louis Cardinals,CARDS,1,2,1,3,1983,1985,2,No,0,-0.15,0.1,0.25,4,16,12,0,0,0,19.0,30.0,11.0,0.0,0.0,0.0
<a href=/player/drabd001>drabd001</a>,Doug Drabek,Chicago White Sox,WSOX,2,3,3,6,1984,1985,1,No,0,3.61,-0.06,-3.67,409,47,-362,1330,158,-1172,395.0,0.0,-395.0,0.0,0.0,0.0
<a href=/player/drabd001>drabd001</a>,Doug Drabek,New York Yankees,YANKS,10,18,16,34,1986,2001,15,No,1,53.73,20.66,-33.07,2413,1594,-819,5894,4002,-1892,9392.0,3621.0,-5771.0,3550000.0,0.0,-3550000.0
<a href=/player/drabk001>drabk001</a>,Kyle Drabek,Philadelphia Phillies,PHILS,1,3,2,5,2009,2013,4,No,0,-0.14,16.2,16.34,41,202,161,2,264,262,517.0,2108.0,1591.0,0.0,0.0,0.0
<a href=/player/drabm101>drabm101</a>,Moe Drabowsky,Chicago Cubs,CUBS,7,13,11,24,1961,1977,16,No,0,12.22,41.5,29.28,942,3000,2058,716,8425,7709,3637.0,5246.0,1609.0,122500.0,0.0,-122500.0
<a href=/player/drabm101>drabm101</a>,Moe Drabowsky,Kansas City Royals,ROYALS,1,1,1,2,1970,1970,0,No,0,-0.15,0.16,0.31,42,14,-28,6,48,42,100.0,0.0,-100.0,45000.0,0.0,-45000.0
<a href=/player/drabm101>drabm101</a>,Moe Drabowsky,Baltimore Orioles,ORLS,2,2,2,4,1970,1972,2,No,0,1.01,0.63,-0.38,203,38,-165,59,94,35,264.0,0.0,-264.0,0.0,0.0,0.0
<a href=/player/dragd101>dragd101</a>,Dick Drago,Kansas City Royals,ROYALS,1,1,1,2,1973,1980,7,No,0,8.32,8.3,-0.02,211,249,38,1,0,-1,1642.0,2477.0,835.0,37500.0,0.0,-37500.0
<a href=/player/dragd101>dragd101</a>,Dick Drago,Boston Red Sox,RSOX,2,2,4,6,1976,1977,1,No,0,-0.61,0.0,0.61,67,0,-67,25,0,-25,301.0,0.0,-301.0,0.0,0.0,0.0
<a href=/player/dragd101>dragd101</a>,Dick Drago,California Angels,ANGELS,1,1,1,2,1977,1979,2,No,0,0.01,4.21,4.2,36,96,60,0,0,0,119.0,637.0,518.0,0.0,0.0,0.0
<a href=/player/dragd101>dragd101</a>,Dick Drago,Boston Red Sox,RSOX,1,1,1,2,1981,1981,0,No,0,-0.69,0.0,0.69,39,0,-39,0,0,0,161.0,0.0,-161.0,0.0,0.0,0.0
<a href=/player/drahb001>drahb001</a>,Brian Drahman,Milwaukee Brewers,BREWRS,1,1,1,2,1989,1989,0,No,0,0.65,-0.25,-0.9,38,7,-31,0,0,0,129.0,101.0,-28.0,0.0,0.0,0.0
<a href=/player/drako001>drako001</a>,Oliver Drake,Baltimore Orioles,ORLS,1,1,1,2,2017,2017,0,No,0,-0.08,0.0,0.08,141,0,-141,0,0,0,196.0,0.0,-196.0,0.0,0.0,0.0
<a href=/player/drakt101>drakt101</a>,Tom Drake,Nashville,Nashville,1,2,1,3,1941,1941,0,No,0,-0.18,0.0,0.18,33,0,-33,24,0,-24,74.0,0.0,-74.0,0.0,0.0,0.0
<a href=/player/dravd001>dravd001</a>,Dave Dravecky,Pittsburgh Pirates,PIRATS,1,1,1,2,1981,1981,0,No,0,11.89,0.0,-11.89,409,0,-409,304,0,-304,2701.0,0.0,-2701.0,0.0,0.0,0.0
<a href=/player/dravd001>dravd001</a>,Dave Dravecky,San Diego Padres,PADRS,7,11,13,24,1987,2002,15,No,2,21.85,22.61,0.76,1316,1503,187,3009,1610,-1399,2250.0,5770.0,3520.0,10183333.0,0.0,-10183333.0
<a href=/player/dreeb101>dreeb101</a>,Bill Dreesen,Boston Braves,BRAVES,4,6,5,11,1931,1938,7,No,0,5.87,8.49,2.62,599,1115,516,2168,4417,2249,0.0,0.0,0.0,0.0,0.0,0.0
<a href=/player/dreic101>dreic101</a>,Clem Dreisewerd,Boston Red Sox,RSOX,2,5,3,8,1947,1955,8,No,0,0.52,24.8,24.28,500,919,419,1627,990,-637,67.0,3427.0,3360.0,0.0,0.0,0.0
<a href=/player/dresc101>dresc101</a>,Chuck Dressen,StPaul,StPaul,1,1,1,2,1924,1924,0,No,0,8.47,0.0,-8.47,630,0,-630,2488,0,-2488,0.0,0.0,0.0,0.0,0.0,0.0
<a href=/player/dresl101>dresl101</a>,Lee Dressen,SaltLakeCity,SaltLakeCity,1,1,2,3,1913,1913,0,No,0,-0.05,0.0,0.05,46,0,-46,118,0,-118,0.0,0.0,0.0,0.0,0.0,0.0
<a href=/player/dresr001>dresr001</a>,Ryan Drese,Cleveland Indians,INDINS,2,3,3,6,2002,2012,10,No,0,4.1,24.75,20.65,161,1080,919,366,4413,4047,970.0,8.0,-962.0,1601500.0,0.0,-1601500.0
<a href=/player/dresr101>dresr101</a>,Rob Dressler,San Francisco Giants,GIANTS,2,2,3,5,1978,1980,2,No,0,0.48,-0.42,-0.9,55,129,74,87,398,311,39.0,0.0,-39.0,0.0,0.0,0.0
<a href=/player/drewf101>drewf101</a>,Frank Drews,Brooklyn Dodgers,DOGRS,1,1,2,3,1944,1951,7,No,0,0.22,0.92,0.7,95,99,4,335,257,-78,0.0,0.0,0.0,0.0,0.0,0.0
<a href=/player/drewj001>drewj001</a>,J.D. Drew,St. Louis Cardinals,CARDS,2,3,5,8,2003,2021,18,Yes,0,10.7,51.54,40.84,366,1812,1446,926,2456,1530,134.0,9250.0,9116.0,7050000.0,0.0,-7050000.0
<a href=/player/drews001>drews001</a>,Stephen Drew,Arizona Diamondbacks,DBACKS,1,1,1,2,2012,2012,0,No,0,0.06,0.0,-0.06,39,0,-39,172,0,-172,0.0,0.0,0.0,0.0,0.0,0.0
<a href=/player/drews001>drews001</a>,Stephen Drew,Boston Red Sox,RSOX,2,4,3,7,2014,2015,1,No,0,-0.74,0.06,0.8,196,27,-169,628,66,-562,0.0,0.0,0.0,10100000.0,0.0,-10100000.0
<a href=/player/drewt001>drewt001</a>,Tim Drew,Cleveland Indians,INDINS,10,19,27,46,2002,2021,19,Yes,0,63.04,99.19,36.15,2801,3478,677,9898,8220,-1678,3587.0,12440.0,8853.0,39810300.0,0.0,-39810300.0
<a href=/player/dried001>dried001</a>,Dan Driessen,Cincinnati Reds,REDS,4,7,6,13,1984,1988,4,No,0,14.57,5.9,-8.67,1034,276,-758,1158,371,-787,4251.0,1901.0,-2350.0,1777500.0,0.0,-1777500.0
<a href=/player/dried001>dried001</a>,Dan Driessen,Montreal Expos,NATEX,4,4,6,10,1985,1990,5,No,0,0.02,-2.18,-2.2,184,103,-81,337,103,-234,424.0,129.0,-295.0,0.0,0.0,0.0
<a href=/player/drisj101>drisj101</a>,Jim Driscoll,Texas Rangers,RNGRS,1,2,1,3,1972,1975,3,No,0,0.39,2.11,1.72,55,66,11,69,0,-69,0.0,589.0,589.0,20000.0,0.0,-20000.0
<a href=/player/dropw101>dropw101</a>,Walt Dropo,Boston Red Sox,RSOX,2,6,6,12,1952,1956,4,No,0,8.2,10.1,1.9,1335,867,-468,4777,3045,-1732,507.0,401.0,-106.0,80000.0,0.0,-80000.0
<a href=/player/dropw101>dropw101</a>,Walt Dropo,Detroit Tigers,TIGRS,6,11,11,22,1954,1964,10,No,0,2.44,17.09,14.65,689,625,-64,1873,996,-877,460.0,3101.0,2641.0,37500.0,0.0,-37500.0
<a href=/player/dropw101>dropw101</a>,Walt Dropo,Cincinnati Reds,REDS,1,1,1,2,1959,1959,0,No,0,0.4,-0.13,-0.53,155,52,-103,398,89,-309,0.0,0.0,0.0,2000.0,0.0,-2000.0
<a href=/player/druhc101>druhc101</a>,Carl Druhot,Cincinnati Reds,REDS,1,1,1,2,1906,1908,2,No,0,1.02,-0.02,-1.04,32,1,-31,57,1,-56,398.0,0.0,-398.0,0.0,0.0,0.0
<a href=/player/druhc101>druhc101</a>,Carl Druhot,St. Louis Cardinals,CARDS,1,1,1,2,1907,1907,0,No,0,0.0,-0.73,-0.73,0,6,6,0,2,2,0.0,20.0,20.0,0.0,0.0,0.0
<a href=/player/drumk101>drumk101</a>,Keith Drumright,Chicago Cubs,CUBS,1,1,1,2,1977,1977,0,No,0,-0.56,0.0,0.56,17,0,-17,59,0,-59,0.0,0.0,0.0,0.0,0.0,0.0
<a href=/player/drumk101>drumk101</a>,Keith Drumright,Houston Astros,ASTROS,1,1,1,2,1979,1979,0,No,0,0.0,-0.01,-0.01,0,28,28,0,3,3,0.0,67.0,67.0,0.0,0.0,0.0
<a href=/player/drumk101>drumk101</a>,Keith Drumright,Chicago Cubs,CUBS,2,3,2,5,1980,1982,2,No,0,1.71,0.0,-1.71,188,0,-188,646,0,-646,0.0,0.0,0.0,0.0,0.0,0.0
<a href=/player/drumt001>drumt001</a>,Tim Drummond,Pittsburgh Pirates,PIRATS,2,3,3,6,1988,1988,0,No,0,13.41,0.21,-13.2,931,40,-891,3050,103,-2947,0.0,0.0,0.0,62500.0,0.0,-62500.0
<a href=/player/drumt001>drumt001</a>,Tim Drummond,New York Mets,METS,2,6,3,9,1989,1991,2,No,2,34.39,9.58,-24.81,807,164,-643,0,204,204,6852.0,1699.0,-5153.0,378000.0,0.0,-378000.0
<a href=/player/drurb001>drurb001</a>,Brandon Drury,Atlanta Braves,BRAVES,4,10,11,21,2013,2019,6,Yes,0,22.68,8.16,-14.52,2194,1203,-991,6430,4358,-2072,1394.0,147.0,-1247.0,14250000.0,0.0,-14250000.0
<a href=/player/drurb001>drurb001</a>,Brandon Drury,Arizona Diamondbacks,DBACKS,1,4,2,6,2018,2019,1,Yes,0,-0.29,-0.4,-0.11,18,72,54,57,272,215,0.0,0.0,0.0,0.0,0.0,0.0
<a href=/player/drurb001>drurb001</a>,Brandon Drury,New York Yankees,YANKS,1,2,1,3,2018,2020,2,No,0,-1.13,4.31,5.44,271,53,-218,932,4,-928,0.0,823.0,823.0,621900.0,0.0,-621900.0
<a href=/player/dubim101>dubim101</a>,Monk Dubiel,Philadelphia Phillies,PHILS,1,2,2,4,1948,1954,6,No,0,13.76,7.72,-6.04,587,642,55,227,2516,2289,2431.0,597.0,-1834.0,0.0,0.0,0.0
<a href=/player/dubim101>dubim101</a>,Monk Dubiel,Chicago Cubs,CUBS,1,1,1,2,1952,1952,0,No,0,0.0,0.0,0.0,0,0,0,0,0,0,0.0,0.0,0.0,0.0,0.0,0.0
<a href=/player/dubob001>dubob001</a>,Brian Dubois,Baltimore Orioles,ORLS,1,1,1,2,1989,1989,0,No,0,0.82,-0.74,-1.56,18,33,15,0,111,111,283.0,0.0,-283.0,0.0,0.0,0.0
<a href=/player/duboj001>duboj001</a>,Jason Dubois,Chicago Cubs,CUBS,3,4,3,7,2005,2012,7,No,0,-0.65,-0.26,0.39,39,149,110,125,101,-24,0.0,192.0,192.0,320000.0,0.0,-320000.0
<a href=/player/dubom001>dubom001</a>,Mauricio Dubon,Boston Red Sox,RSOX,1,4,1,5,2016,2019,3,No,0,5.97,-0.24,-6.21,440,43,-397,1667,0,-1667,0.0,128.0,128.0,515000.0,0.0,-515000.0
<a href=/player/dubom001>dubom001</a>,Mauricio Dubon,Milwaukee Brewers,BREWRS,1,1,2,3,2019,2019,0,Yes,0,1.96,0.94,-1.02,156,80,-76,473,2,-471,0.0,121.0,121.0,0.0,0.0,0.0
<a href=/player/duceb001>duceb001</a>,Rob Ducey,Toronto Blue Jays,BJAYS,1,2,1,3,1992,1993,1,No,0,0.36,1.7,1.34,277,77,-200,834,0,-834,0.0,311.0,311.0,725000.0,0.0,-725000.0
<a href=/player/duceb001>duceb001</a>,Rob Ducey,Philadelphia Phillies,PHILS,1,1,1,2,2000,2000,0,No,0,-0.16,0.0,0.16,5,0,-5,15,0,-15,0.0,0.0,0.0,500000.0,0.0,-500000.0
<a href=/player/duceb001>duceb001</a>,Rob Ducey,Toronto Blue Jays,BJAYS,1,1,1,2,2000,2000,0,No,0,-0.11,-0.22,-0.11,142,35,-107,217,116,-101,0.0,0.0,0.0,0.0,0.0,0.0
<a href=/player/duchj001>duchj001</a>,Justin Duchscherer,Boston Red Sox,RSOX,2,2,2,4,2001,2006,5,No,0,-0.88,4.6,5.48,19,437,418,26,1551,1525,44.0,0.0,-44.0,1500000.0,0.0,-1500000.0
<a href=/player/duchj001>duchj001</a>,Justin Duchscherer,Texas Rangers,RNGRS,2,2,2,4,2002,2002,0,No,0,12.24,0.0,-12.24,669,0,-669,8,0,-8,1966.0,0.0,-1966.0,0.0,0.0,0.0
<a href=/player/duckb001>duckb001</a>,Brandon Duckworth,Philadelphia Phillies,PHILS,5,11,7,18,2003,2013,10,No,2,0.36,22.51,22.15,393,644,251,101,485,384,2150.0,4335.0,2185.0,8825000.0,0.0,-8825000.0
<a href=/player/duckj101>duckj101</a>,Jim Duckworth,Washington Senators,RNGRS,1,1,1,2,1966,1967,1,No,0,-0.83,0.26,1.09,16,97,81,2,370,368,36.0,0.0,-36.0,0.0,0.0,0.0
<a href=/player/duckj101>duckj101</a>,Jim Duckworth,Kansas City Athletics,ATLTCS,1,1,1,2,1966,1968,2,No,0,-0.42,1.47,1.89,10,176,166,3,18,15,43.0,460.0,417.0,0.0,0.0,0.0
<a href=/player/dudal001>dudal001</a>,Lucas Duda,New York Mets,METS,1,1,1,2,2017,2017,0,Yes,0,0.13,0.0,-0.13,52,0,-52,200,0,-200,0.0,0.0,0.0,7250000.0,0.0,-7250000.0
<a href=/player/dudlc101>dudlc101</a>,Clise Dudley,Brooklyn Dodgers,DOGRS,2,6,3,9,1930,1936,6,No,0,9.9,18.06,8.16,811,786,-25,1763,3200,1437,2519.0,0.0,-2519.0,18200.0,0.0,-18200.0
<a href=/player/duffd001>duffd001</a>,Danny Duffy,Kansas City Royals,ROYALS,1,2,1,3,2021,2021,0,Yes,0,0.0,0.0,0.0,0,0,0,0,0,0,0.0,0.0,0.0,15500000.0,0.0,-15500000.0
<a href=/player/dufff101>dufff101</a>,Frank Duffy,Cincinnati Reds,REDS,4,5,7,12,1971,1988,17,No,0,3.96,42.07,38.11,701,1797,1096,2673,5857,3184,86.0,981.0,895.0,0.0,0.0,0.0
<a href=/player/dufff101>dufff101</a>,Frank Duffy,San Francisco Giants,GIANTS,1,2,1,3,1971,1973,2,No,0,40.19,-0.73,-40.92,981,92,-889,2877,77,-2800,3392.0,613.0,-2779.0,84000.0,0.0,-84000.0
<a href=/player/dufff101>dufff101</a>,Frank Duffy,Cleveland Indians,INDINS,1,1,1,2,1978,1978,0,No,0,-0.74,0.15,0.89,70,6,-64,120,0,-120,0.0,28.0,28.0,0.0,0.0,0.0
<a href=/player/duffj102>duffj102</a>,Jim Duffalo,San Francisco Giants,GIANTS,1,1,1,2,1965,1966,1,No,0,0.23,1.35,1.12,44,140,96,8,7,-1,133.0,191.0,58.0,0.0,0.0,0.0
<a href=/player/duffm001>duffm001</a>,Matt Duff,St. Louis Cardinals,CARDS,1,1,1,2,2004,2004,0,No,0,0.0,3.28,3.28,0,145,145,0,606,606,0.0,0.0,0.0,0.0,0.0,0.0
<a href=/player/duffm002>duffm002</a>,Matt Duffy,San Francisco Giants,GIANTS,2,5,3,8,2016,2017,1,Yes,0,1.48,0.39,-1.09,241,87,-154,809,81,-728,306.0,728.0,422.0,7000000.0,0.0,-7000000.0
<a href=/player/dugag101>dugag101</a>,Gus Dugas,Pittsburgh Pirates,PIRATS,2,4,4,8,1932,1938,6,No,0,21.37,8.93,-12.44,671,581,-90,1015,1370,355,4458.0,2252.0,-2206.0,0.0,0.0,0.0
<a href=/player/dugag101>dugag101</a>,Gus Dugas,Philadelphia Phillies,PHILS,2,4,2,6,1933,1934,1,No,0,0.0,-2.07,-2.07,0,73,73,0,272,272,0.0,0.0,0.0,0.0,0.0,0.0
<a href=/player/dugaj101>dugaj101</a>,Joe Dugan,Philadelphia Athletics,ATLTCS,3,5,5,10,1922,1930,8,No,0,8.5,19.12,10.62,610,716,106,1746,2392,646,1683.0,1623.0,-60.0,18500.0,0.0,-18500.0
<a href=/player/dugaj101>dugaj101</a>,Joe Dugan,Washington Senators,TWINS,2,3,3,6,1922,1933,11,No,0,2.2,14.57,12.37,219,710,491,852,2665,1813,0.0,616.0,616.0,0.0,0.0,0.0
<a href=/player/dugaj101>dugaj101</a>,Joe Dugan,Boston Red Sox,RSOX,3,7,10,17,1922,1935,13,No,0,18.05,-3.44,-21.49,1736,754,-982,6924,2797,-4127,0.0,159.0,159.0,16300.0,0.0,-16300.0
<a href=/player/dugeo101>dugeo101</a>,Oscar Dugey,Boston Braves,BRAVES,1,3,1,4,1915,1917,2,No,0,5.22,6.66,1.44,653,350,-303,2277,1416,-861,0.0,0.0,0.0,0.0,0.0,0.0
<a href=/player/duggr001>duggr001</a>,Robert Dugger,Seattle Mariners,MARNRS,1,3,2,5,2017,2020,3,No,0,-0.89,1.81,2.7,38,291,253,23,1091,1068,267.0,0.0,-267.0,0.0,0.0,0.0
<a href=/player/dukee001>dukee001</a>,Elijah Dukes,Tampa Bay Devil Rays,RAYS,1,1,1,2,2007,2007,0,No,0,1.99,0.0,-1.99,188,0,-188,750,0,-750,0.0,0.0,0.0,380000.0,0.0,-380000.0
<a href=/player/duket101>duket101</a>,Tom Dukes,New York Yankees,YANKS,1,1,1,2,1965,1965,0,No,0,0.0,0.05,0.05,0,20,20,0,3,3,0.0,61.0,61.0,0.0,0.0,0.0
<a href=/player/duket101>duket101</a>,Tom Dukes,Atlanta Braves,BRAVES,1,3,3,6,1966,1970,4,No,0,-2.48,0.0,2.48,260,0,-260,50,0,-50,409.0,0.0,-409.0,0.0,0.0,0.0
<a href=/player/duket101>duket101</a>,Tom Dukes,San Diego Padres,PADRS,2,3,5,8,1970,1978,8,No,0,5.53,1.56,-3.97,208,961,753,208,2714,2506,1767.0,691.0,-1076.0,35500.0,0.0,-35500.0
<a href=/player/duket101>duket101</a>,Tom Dukes,Baltimore Orioles,ORLS,12,23,21,44,1972,1994,22,No,3,49.02,86.1,37.08,2274,4602,2328,4427,11355,6928,10789.0,13691.0,2902.0,713333.0,0.0,-713333.0
<a href=/player/dukez001>dukez001</a>,Zach Duke,Pittsburgh Pirates,PIRATS,1,1,1,2,2010,2011,1,No,0,0.13,0.0,-0.13,41,0,-41,23,0,-23,230.0,0.0,-230.0,4300000.0,0.0,-4300000.0
<a href=/player/dukez001>dukez001</a>,Zach Duke,Chicago White Sox,WSOX,1,1,1,2,2016,2019,3,No,0,1.15,-1.57,-2.72,107,96,-11,0,280,280,125.0,0.0,-125.0,0.0,0.0,0.0
<a href=/player/dukez001>dukez001</a>,Zach Duke,Minnesota Twins,TWINS,1,2,2,4,2018,2019,1,Yes,0,-0.01,0.01,0.02,28,6,-22,0,0,0,44.0,56.0,12.0,2150000.0,0.0,-2150000.0
<a href=/player/dulib101>dulib101</a>,Bob Duliba,St. Louis Cardinals,CARDS,1,1,1,2,1963,1963,0,No,0,-0.04,0.0,0.04,128,0,-128,7,0,-7,241.0,0.0,-241.0,0.0,0.0,0.0
<a href=/player/dulib101>dulib101</a>,Bob Duliba,California Angels,ANGELS,1,1,1,2,1965,1965,0,No,0,0.53,0.0,-0.53,78,0,-78,8,0,-8,193.0,0.0,-193.0,0.0,0.0,0.0
<a href=/player/dulib101>dulib101</a>,Bob Duliba,Boston Red Sox,RSOX,7,14,15,29,1966,1977,11,No,0,34.3,14.63,-19.67,1704,1106,-598,5095,2714,-2381,3875.0,3907.0,32.0,155000.0,0.0,-155000.0
<a href=/player/dumap001>dumap001</a>,Phil Dumatrait,Boston Red Sox,RSOX,1,2,1,3,2003,2004,1,No,0,-1.4,0.92,2.32,12,55,43,6,0,-6,54.0,147.0,93.0,0.0,0.0,0.0
<a href=/player/dumog101>dumog101</a>,George Dumont,Washington Senators,TWINS,3,5,4,9,1919,1933,14,No,0,-0.71,14.2,14.91,37,1313,1276,32,5773,5741,106.0,0.0,-106.0,34200.0,0.0,-34200.0
<a href=/player/duncc002>duncc002</a>,Chris Duncan,St. Louis Cardinals,CARDS,1,1,1,2,2009,2010,1,No,0,0.0,0.64,0.64,0,51,51,0,170,170,0.0,0.0,0.0,825000.0,0.0,-825000.0
<a href=/player/duncd101>duncd101</a>,Dave Duncan,Oakland Athletics,ATLTCS,1,2,2,4,1973,1975,2,No,0,10.02,2.05,-7.97,777,294,-483,3090,901,-2189,0.0,0.0,0.0,0.0,0.0,0.0
<a href=/player/duncd101>duncd101</a>,Dave Duncan,Cleveland Indians,INDINS,3,4,5,9,1975,1983,8,No,0,1.76,7.83,6.07,284,560,276,867,1386,519,202.0,1484.0,1282.0,0.0,0.0,0.0
<a href=/player/duncd101>duncd101</a>,Dave Duncan,Baltimore Orioles,ORLS,1,1,1,2,1976,1980,4,No,0,0.0,3.73,3.73,0,377,377,0,1155,1155,0.0,0.0,0.0,0.0,0.0,0.0
<a href=/player/duncm001>duncm001</a>,Mariano Duncan,Los Angeles Dodgers,DOGRS,2,3,3,6,1989,1993,4,No,0,3.28,8.3,5.02,375,891,516,1244,2884,1640,269.0,0.0,-269.0,3370000.0,0.0,-3370000.0
<a href=/player/duncm001>duncm001</a>,Mariano Duncan,New York Yankees,YANKS,1,2,1,3,1997,1997,0,No,0,-0.08,0.0,0.08,39,0,-39,176,0,-176,0.0,0.0,0.0,870000.0,0.0,-870000.0
<a href=/player/dunct101>dunct101</a>,Taylor Duncan,Atlanta Braves,BRAVES,11,19,24,43,1972,1986,14,No,0,30.99,9.46,-21.53,1998,2587,589,5259,6910,1651,4220.0,2478.0,-1742.0,95000.0,0.0,-95000.0
<a href=/player/dungs101>dungs101</a>,Sam Dungan,Chicago Cubs,CUBS,1,1,1,2,1894,1894,0,No,0,0.13,1.25,1.12,8,40,32,37,107,70,0.0,385.0,385.0,0.0,0.0,0.0
<a href=/player/dungs101>dungs101</a>,Sam Dungan,Chicago Cubs,CUBS,2,6,2,8,1900,1902,2,No,0,10.49,0.81,-9.68,648,153,-495,2353,607,-1746,0.0,0.0,0.0,0.0,0.0,0.0
<a href=/player/dunkd101>dunkd101</a>,Davy Dunkle,Chicago White Sox,WSOX,1,1,1,2,1903,1903,0,No,0,-0.88,1.48,2.36,53,86,33,69,383,314,548.0,0.0,-548.0,0.0,0.0,0.0
<a href=/player/dunna001>dunna001</a>,Adam Dunn,Cincinnati Reds,REDS,1,2,3,5,2008,2010,2,No,0,-0.36,-0.17,0.19,44,138,94,187,113,-74,0.0,459.0,459.0,13000000.0,0.0,-13000000.0
<a href=/player/dunna001>dunna001</a>,Adam Dunn,Chicago White Sox,WSOX,1,2,1,3,2014,2014,0,Yes,0,-0.03,0.0,0.03,25,0,-25,76,0,-76,0.0,0.0,0.0,15000000.0,0.0,-15000000.0
<a href=/player/dunnd001>dunnd001</a>,Dane Dunning,Washington Nationals,NATEX,1,3,1,4,2016,2020,4,No,0,16.01,2.64,-13.37,233,310,77,19,1309,1290,3554.0,0.0,-3554.0,0.0,0.0,0.0
<a href=/player/dunnd001>dunnd001</a>,Dane Dunning,Chicago White Sox,WSOX,1,2,1,3,2020,2020,0,Yes,0,0.72,0.0,-0.72,29,0,-29,4,0,-4,353.0,0.0,-353.0,0.0,0.0,0.0
<a href=/player/dunnj002>dunnj002</a>,Justin Dunn,New York Mets,METS,1,5,3,8,2018,2018,0,Yes,0,-0.49,0.0,0.49,191,0,-191,565,0,-565,376.0,0.0,-376.0,16500000.0,0.0,-16500000.0
<a href=/player/dunnm001>dunnm001</a>,Mike Dunne,St. Louis Cardinals,CARDS,2,4,3,7,1987,1997,10,No,2,43.01,2.09,-40.92,1782,407,-1375,6646,1438,-5208,1043.0,0.0,-1043.0,0.0,0.0,0.0
<a href=/player/dunnm001>dunnm001</a>,Mike Dunne,Pittsburgh Pirates,PIRATS,1,3,2,5,1989,1989,0,No,0,-1.22,-1.21,0.01,20,71,51,0,253,253,300.0,0.0,-300.0,222500.0,0.0,-222500.0
<a href=/player/dunnm002>dunnm002</a>,Michael Dunn,New York Yankees,YANKS,2,5,3,8,2001,2013,12,No,1,3.9,2.44,-1.46,585,309,-276,511,6,-505,625.0,1000.0,375.0,1800000.0,0.0,-1800000.0
<a href=/player/dunnm002>dunnm002</a>,Michael Dunn,Atlanta Braves,BRAVES,1,2,1,3,2010,2014,4,No,0,6.58,3.15,-3.43,1022,499,-523,990,1984,994,984.0,0.0,-984.0,2225000.0,0.0,-2225000.0
<a href=/player/dunns002>dunns002</a>,Scott Dunn,Cincinnati Reds,REDS,1,1,1,2,2003,2005,2,No,0,0.0,5.59,5.59,0,260,260,0,1102,1102,0.0,0.0,0.0,0.0,0.0,0.0
<a href=/player/dunns002>dunns002</a>,Scott Dunn,Chicago White Sox,WSOX,1,3,2,5,2003,2004,1,No,0,0.04,0.32,0.28,21,41,20,0,2,2,90.0,416.0,326.0,330000.0,0.0,-330000.0
<a href=/player/dunns101>dunns101</a>,Steve Dunning,Cleveland Indians,INDINS,6,8,8,16,1973,1976,3,No,0,-3.1,-1.46,1.64,208,89,-119,203,44,-159,1382.0,1189.0,-193.0,89000.0,0.0,-89000.0
<a href=/player/dunns101>dunns101</a>,Steve Dunning,Texas Rangers,RNGRS,2,3,2,5,1975,1977,2,No,0,0.0,0.93,0.93,0,21,21,0,0,0,0.0,278.0,278.0,0.0,0.0,0.0
<a href=/player/dunns101>dunns101</a>,Steve Dunning,Chicago White Sox,WSOX,2,5,5,10,1975,1978,3,No,0,1.08,-0.17,-1.25,421,278,-143,1261,1093,-168,18.0,0.0,-18.0,70000.0,0.0,-70000.0
<a href=/player/dunns101>dunns101</a>,Steve Dunning,Montreal Expos,NATEX,3,6,6,12,1976,1983,7,No,0,4.1,3.12,-0.98,573,1002,429,1861,2648,787,25.0,308.0,283.0,0.0,0.0,0.0
<a href=/player/dunns101>dunns101</a>,Steve Dunning,St. Louis Cardinals,CARDS,1,1,1,2,1977,1977,0,No,0,0.18,0.0,-0.18,6,0,-6,0,0,0,55.0,0.0,-55.0,0.0,0.0,0.0
<a href=/player/dunnt001>dunnt001</a>,Todd Dunn,Milwaukee Brewers,BREWRS,1,1,1,2,1999,2000,1,No,0,0.0,0.16,0.16,0,56,56,0,128,128,0.0,0.0,0.0,0.0,0.0,0.0
<a href=/player/dunss001>dunss001</a>,Shawon Dunston,Cleveland Indians,INDINS,7,12,14,26,1998,2011,13,No,0,4.4,12.56,8.16,1064,1445,381,2423,3925,1502,442.0,1477.0,1035.0,9756200.0,0.0,-9756200.0
<a href=/player/dunss001>dunss001</a>,Shawon Dunston,St. Louis Cardinals,CARDS,1,1,1,2,1999,2001,2,No,0,0.26,0.85,0.59,42,305,263,97,956,859,0.0,0.0,0.0,610000.0,0.0,-610000.0
<a href=/player/dunwt001>dunwt001</a>,Todd Dunwoody,Florida Marlins,MARLNS,1,1,1,2,1999,1999,0,No,0,-1.52,0.0,1.52,61,0,-61,195,0,-195,0.0,0.0,0.0,222000.0,0.0,-222000.0
<a href=/player/durae001>durae001</a>,Erubiel Durazo,Arizona Diamondbacks,DBACKS,2,2,3,5,2002,2004,2,No,0,5.68,1.54,-4.14,454,142,-312,1405,84,-1321,325.0,783.0,458.0,4375000.0,0.0,-4375000.0
<a href=/player/durar001>durar001</a>,Roberto Duran,Toronto Blue Jays,BJAYS,1,1,1,2,1996,1996,0,No,0,-0.1,0.0,0.1,32,0,-32,0,0,0,78.0,0.0,-78.0,0.0,0.0,0.0
<a href=/player/durbk101>durbk101</a>,Blaine Durbin,Chicago Cubs,CUBS,1,2,1,3,1909,1909,0,No,0,2.39,-0.63,-3.02,347,20,-327,1320,55,-1265,0.0,0.0,0.0,0.0,0.0,0.0
<a href=/player/durbk101>durbk101</a>,Blaine Durbin,Cincinnati Reds,REDS,1,1,2,3,1909,1910,1,No,0,0.0,0.92,0.92,1,124,123,0,278,278,0.0,0.0,0.0,0.0,0.0,0.0
<a href=/player/durer101>durer101</a>,Ryne Duren,Baltimore Orioles,ORLS,6,15,10,25,1956,1973,17,No,0,20.81,32.2,11.39,1684,2354,670,5686,7591,1905,973.0,480.0,-493.0,72000.0,0.0,-72000.0
<a href=/player/durer101>durer101</a>,Ryne Duren,Kansas City Athletics,ATLTCS,50,107,110,217,1957,1976,19,No,0,243.41,144.18,-99.23,19841,14910,-4931,49436,46172,-3264,28049.0,12074.0,-15975.0,661100.0,0.0,-661100.0
<a href=/player/durer101>durer101</a>,Ryne Duren,New York Yankees,YANKS,1,3,2,5,1961,1962,1,No,0,3.35,0.73,-2.62,729,113,-616,2005,155,-1850,725.0,95.0,-630.0,0.0,0.0,0.0
<a href=/player/durhd101>durhd101</a>,Don Durham,St. Louis Cardinals,CARDS,3,3,3,6,1973,1973,0,No,0,-1.09,0.0,1.09,16,0,-16,0,0,0,121.0,0.0,-121.0,0.0,0.0,0.0
<a href=/player/durhe101>durhe101</a>,Ed Durham,Boston Red Sox,RSOX,5,12,11,23,1932,1940,8,No,0,26.52,36.5,9.98,1813,1321,-492,6379,4051,-2328,2979.0,4057.0,1078.0,56000.0,0.0,-56000.0
<a href=/player/durhl001>durhl001</a>,Leon Durham,St. Louis Cardinals,CARDS,2,4,2,6,1980,1984,4,No,1,14.5,6.0,-8.5,1050,498,-552,4046,39,-4007,0.0,1190.0,1190.0,0.0,0.0,0.0
<a href=/player/durhl001>durhl001</a>,Leon Durham,Chicago Cubs,CUBS,1,1,2,3,1988,1989,1,No,0,-0.23,1.9,2.13,21,108,87,56,7,-49,0.0,221.0,221.0,1383333.0,0.0,-1383333.0
<a href=/player/durhr001>durhr001</a>,Ray Durham,Chicago White Sox,WSOX,1,2,1,3,2002,2005,3,No,0,1.21,0.09,-1.12,54,62,8,248,0,-248,0.0,239.0,239.0,6300000.0,0.0,-6300000.0
<a href=/player/durhr001>durhr001</a>,Ray Durham,San Francisco Giants,GIANTS,1,1,2,3,2008,2011,3,No,0,0.68,0.19,-0.49,41,33,-8,122,16,-106,0.0,0.0,0.0,7500000.0,0.0,-7500000.0
<a href=/player/durol101>durol101</a>,Leo Durocher,Cincinnati Reds,REDS,4,7,8,15,1933,1943,10,No,0,2.09,48.62,46.53,936,2007,1071,3163,5265,2102,264.0,8479.0,8215.0,23000.0,0.0,-23000.0
<a href=/player/durol101>durol101</a>,Leo Durocher,St. Louis Cardinals,CARDS,1,1,4,5,1937,1941,4,No,0,1.05,2.09,1.04,345,108,-237,1195,269,-926,0.0,390.0,390.0,10000.0,0.0,-10000.0
<a href=/player/dursc101>dursc101</a>,Cedric Durst,St.Louis Browns,ORLS,4,6,5,11,1927,1935,8,No,0,9.57,7.29,-2.28,658,806,148,956,588,-368,3247.0,5119.0,1872.0,22500.0,0.0,-22500.0
<a href=/player/dursc101>dursc101</a>,Cedric Durst,New York Yankees,YANKS,1,2,1,3,1930,1946,16,No,0,-0.48,56.84,57.32,102,1057,955,330,1589,1259,0.0,9506.0,9506.0,6000.0,0.0,-6000.0
<a href=/player/dusae101>dusae101</a>,Erv Dusak,St. Louis Cardinals,CARDS,1,2,1,3,1951,1952,1,No,0,2.13,0.47,-1.66,381,51,-330,862,202,-660,20.0,0.0,-20.0,0.0,0.0,0.0
<a href=/player/duvaa001>duvaa001</a>,Adam Duvall,San Francisco Giants,GIANTS,1,2,1,3,2015,2015,0,No,0,6.27,0.49,-5.78,455,19,-436,1700,17,-1683,51.0,166.0,115.0,0.0,0.0,0.0
<a href=/player/duvaa001>duvaa001</a>,Adam Duvall,Cincinnati Reds,REDS,2,2,4,6,2018,2019,1,Yes,0,2.16,-0.13,-2.29,225,45,-180,613,43,-570,87.0,56.0,-31.0,645000.0,0.0,-645000.0
<a href=/player/duvaa001>duvaa001</a>,Adam Duvall,Miami Marlins,MARLNS,1,1,1,2,2021,2021,0,Yes,0,1.19,-0.24,-1.43,55,42,-13,216,123,-93,0.0,0.0,0.0,0.0,0.0,0.0
<a href=/player/dwyej001>dwyej001</a>,Jim Dwyer,St. Louis Cardinals,CARDS,2,2,2,4,1975,1975,0,No,0,0.76,0.22,-0.54,232,27,-205,370,21,-349,0.0,0.0,0.0,0.0,0.0,0.0
<a href=/player/dwyej001>dwyej001</a>,Jim Dwyer,Montreal Expos,NATEX,1,2,2,4,1976,1978,2,No,0,-0.15,2.45,2.6,60,488,428,138,1259,1121,0.0,0.0,0.0,0.0,0.0,0.0
<a href=/player/dwyej001>dwyej001</a>,Jim Dwyer,New York Mets,METS,1,1,1,2,1976,1977,1,No,0,0.0,0.0,0.0,0,0,0,0,0,0,0.0,0.0,0.0,0.0,0.0,0.0
<a href=/player/dwyej001>dwyej001</a>,Jim Dwyer,St. Louis Cardinals,CARDS,1,1,1,2,1978,1980,2,No,0,-0.04,0.0,0.04,73,0,-73,208,0,-208,0.0,0.0,0.0,0.0,0.0,0.0
<a href=/player/dwyej001>dwyej001</a>,Jim Dwyer,Baltimore Orioles,ORLS,3,3,3,6,1988,1989,1,No,0,0.65,0.0,-0.65,177,0,-177,388,0,-388,72.0,0.0,-72.0,300000.0,0.0,-300000.0
<a href=/player/dwyej001>dwyej001</a>,Jim Dwyer,Minnesota Twins,TWINS,1,1,1,2,1989,1990,1,No,0,0.0,0.0,0.0,13,0,-13,11,0,-11,0.0,0.0,0.0,200000.0,0.0,-200000.0
<a href=/player/dwyej001>dwyej001</a>,Jim Dwyer,Montreal Expos,NATEX,1,1,1,2,1990,1990,0,No,0,-0.44,0.0,0.44,37,0,-37,75,0,-75,0.0,0.0,0.0,0.0,0.0,0.0
<a href=/player/dybzj001>dybzj001</a>,Jerry Dybzinski,Cleveland Indians,INDINS,21,27,34,61,1983,2020,37,Yes,2,32.15,125.61,93.46,3762,4140,378,11221,11952,731,4030.0,10939.0,6909.0,46229400.0,0.0,-46229400.0
<a href=/player/dyckj101>dyckj101</a>,Jim Dyck,Baltimore Orioles,ORLS,1,1,1,2,1954,1955,1,No,0,0.0,-0.81,-0.81,2,132,130,2,439,437,0.0,0.0,0.0,0.0,0.0,0.0
<a href=/player/dye-j001>dye-j001</a>,Jermaine Dye,Atlanta Braves,BRAVES,10,22,20,42,1997,2015,18,No,3,92.83,25.73,-67.1,5070,2997,-2073,17034,7559,-9475,5280.0,1624.0,-3656.0,29165000.0,0.0,-29165000.0
<a href=/player/dye-j001>dye-j001</a>,Jermaine Dye,Kansas City Royals,ROYALS,1,1,1,2,2001,2002,1,No,0,0.0,-2.28,-2.28,0,194,194,0,805,805,0.0,0.0,0.0,3800000.0,0.0,-3800000.0
<a href=/player/dye-j001>dye-j001</a>,Jermaine Dye,Colorado Rockies,ROCKS,1,1,3,4,2001,2003,2,No,0,2.82,0.24,-2.58,394,89,-305,1663,292,-1371,0.0,28.0,28.0,0.0,0.0,0.0
<a href=/player/dyerd101>dyerd101</a>,Duffy Dyer,New York Mets,METS,2,2,2,4,1974,1976,2,No,0,3.09,-0.34,-3.43,385,82,-303,1370,216,-1154,0.0,0.0,0.0,0.0,0.0,0.0
<a href=/player/dyerd101>dyerd101</a>,Duffy Dyer,Montreal Expos,NATEX,2,2,2,4,1980,1982,2,No,0,-0.57,0.11,0.68,52,34,-18,132,69,-63,0.0,0.0,0.0,0.0,0.0,0.0
<a href=/player/dykej101>dykej101</a>,Jimmy Dykes,Detroit Tigers,TIGRS,1,1,1,2,1960,1960,0,No,0,0.0,0.0,0.0,0,0,0,0,0,0,0.0,0.0,0.0,0.0,0.0,0.0
<a href=/player/dyksa001>dyksa001</a>,Allan Dykstra,San Diego Padres,PADRS,1,1,1,2,2011,2011,0,No,0,0.0,0.0,0.0,0,0,0,0,0,0,0.0,0.0,0.0,0.0,0.0,0.0
<a href=/player/dyksl001>dyksl001</a>,Lenny Dykstra,New York Mets,METS,14,22,24,46,1989,1999,10,No,1,42.74,12.21,-30.53,2762,1749,-1013,6221,1744,-4477,4175.0,4730.0,555.0,13614666.0,0.0,-13614666.0
<a href=/player/dysoj001>dysoj001</a>,Jarrod Dyson,Kansas City Royals,ROYALS,1,1,1,2,2017,2018,1,No,0,2.72,1.04,-1.68,111,9,-102,390,0,-390,0.0,136.0,136.0,0.0,0.0,0.0
<a href=/player/dysoj001>dysoj001</a>,Jarrod Dyson,Pittsburgh Pirates,PIRATS,1,1,1,2,2020,2020,0,No,0,-0.08,0.0,0.08,11,0,-11,11,0,-11,0.0,0.0,0.0,2000000.0,0.0,-2000000.0
<a href=/player/dysos001>dysos001</a>,Sam Dyson,Miami Marlins,MARLNS,1,1,2,3,2015,2018,3,No,0,2.95,-0.63,-3.58,128,108,-20,0,185,185,355.0,9.0,-346.0,507500.0,0.0,-507500.0
<a href=/player/dysos001>dysos001</a>,Sam Dyson,Texas Rangers,RNGRS,1,2,1,3,2017,2017,0,Yes,0,2.87,0.0,-2.87,313,0,-313,0,0,0,478.0,0.0,-478.0,0.0,0.0,0.0
<a href=/player/dysos001>dysos001</a>,Sam Dyson,San Francisco Giants,GIANTS,1,1,3,4,2019,2019,0,Yes,0,-0.29,-0.51,-0.22,15,17,2,0,47,47,34.0,0.0,-34.0,5000000.0,0.0,-5000000.0
<a href=/player/earla101>earla101</a>,Arnold Earley,Boston Red Sox,RSOX,1,3,2,5,1965,1968,3,No,0,0.78,1.64,0.86,187,156,-31,154,15,-139,353.0,393.0,40.0,12500.0,0.0,-12500.0
<a href=/player/earla101>earla101</a>,Arnold Earley,Atlanta Braves,BRAVES,2,4,3,7,1966,1966,0,No,0,-0.17,-0.08,0.09,59,17,-42,34,18,-16,53.0,0.0,-53.0,0.0,0.0,0.0
<a href=/player/earla101>earla101</a>,Arnold Earley,Chicago Cubs,CUBS,1,1,1,2,1967,1967,0,No,0,-0.22,0.0,0.22,4,0,-4,0,0,0,4.0,0.0,-4.0,0.0,0.0,0.0
<a href=/player/earlj101>earlj101</a>,Jake Early,Washington Senators,TWINS,1,1,1,2,1946,1946,0,No,0,1.42,0.0,-1.42,87,0,-87,268,0,-268,0.0,0.0,0.0,0.0,0.0,0.0
<a href=/player/earng101>earng101</a>,George Earnshaw,Baltimore,Baltimore,1,1,2,3,1928,1928,0,No,0,17.91,0.0,-17.91,438,0,-438,562,0,-562,4060.0,0.0,-4060.0,0.0,0.0,0.0
<a href=/player/earng101>earng101</a>,George Earnshaw,Philadelphia Athletics,ATLTCS,1,2,2,4,1933,1935,2,No,0,3.62,0.35,-3.27,76,161,85,105,502,397,735.0,0.0,-735.0,7500.0,0.0,-7500.0
<a href=/player/earng101>earng101</a>,George Earnshaw,Brooklyn Dodgers,DOGRS,5,10,7,17,1936,1947,11,No,0,-0.88,35.78,36.66,116,1457,1341,57,5839,5782,553.0,123.0,-430.0,0.0,0.0,0.0
<a href=/player/easld001>easld001</a>,Damion Easley,California Angels,ANGELS,1,1,1,2,1996,1996,0,No,0,17.79,-0.3,-18.09,841,15,-826,3512,0,-3512,0.0,72.0,72.0,305000.0,0.0,-305000.0
<a href=/player/easll001>easll001</a>,Logan Easley,New York Yankees,YANKS,10,18,16,34,1986,2001,15,No,1,53.73,20.66,-33.07,2413,1594,-819,5894,4002,-1892,9392.0,3621.0,-5771.0,3550000.0,0.0,-3550000.0
<a href=/player/easlm001>easlm001</a>,Mike Easler,Houston Astros,ASTROS,2,3,2,5,1975,1978,3,No,0,0.55,-0.53,-1.08,312,183,-129,705,518,-187,441.0,66.0,-375.0,0.0,0.0,0.0
<a href=/player/easlm001>easlm001</a>,Mike Easler,St. Louis Cardinals,CARDS,1,1,1,2,1976,1976,0,No,0,-0.35,0.0,0.35,21,0,-21,59,0,-59,0.0,0.0,0.0,0.0,0.0,0.0
<a href=/player/easlm001>easlm001</a>,Mike Easler,California Angels,ANGELS,1,1,1,2,1977,1977,0,No,0,7.88,0.0,-7.88,549,0,-549,1829,0,-1829,0.0,0.0,0.0,0.0,0.0,0.0
<a href=/player/easlm001>easlm001</a>,Mike Easler,Boston Red Sox,RSOX,1,1,3,4,1979,1979,0,No,0,7.58,0.0,-7.58,539,0,-539,1810,0,-1810,0.0,0.0,0.0,0.0,0.0,0.0
<a href=/player/easlm001>easlm001</a>,Mike Easler,Pittsburgh Pirates,PIRATS,6,11,12,23,1983,2001,18,No,2,33.23,24.35,-8.88,1162,1792,630,2465,2590,125,5314.0,7695.0,2381.0,1290000.0,0.0,-1290000.0
<a href=/player/easlm001>easlm001</a>,Mike Easler,Boston Red Sox,RSOX,2,2,2,4,1986,1987,1,No,0,1.83,2.07,0.24,231,268,37,788,1096,308,0.0,0.0,0.0,0.0,0.0,0.0
<a href=/player/easlm001>easlm001</a>,Mike Easler,New York Yankees,YANKS,2,3,3,6,1986,1989,3,No,0,-1.2,3.08,4.28,102,129,27,211,183,-28,200.0,783.0,583.0,658333.0,0.0,-658333.0
<a href=/player/easlm001>easlm001</a>,Mike Easler,Philadelphia Phillies,PHILS,4,6,6,12,1987,1989,2,No,0,-2.64,0.15,2.79,234,140,-94,689,302,-387,0.0,49.0,49.0,1095000.0,0.0,-1095000.0
<a href=/player/eastc101>eastc101</a>,Carl East,Minneapolis,Minneapolis,1,1,1,2,1924,1932,8,No,0,0.09,0.0,-0.09,2,0,-2,8,0,-8,0.0,0.0,0.0,0.0,0.0,0.0
<a href=/player/eastc101>eastc101</a>,Carl East,LittleRock,LittleRock,2,3,7,10,1915,1916,1,No,0,0.33,0.0,-0.33,131,0,-131,145,0,-145,73.0,0.0,-73.0,0.0,0.0,0.0
<a href=/player/eastj001>eastj001</a>,Jamie Easterly,Milwaukee Brewers,BREWRS,1,3,2,5,1983,1987,4,No,0,7.32,0.25,-7.07,394,574,180,437,1374,937,1362.0,450.0,-912.0,600000.0,0.0,-600000.0
<a href=/player/eastp101>eastp101</a>,Paul Easterling,Philadelphia Athletics,ATLTCS,2,4,2,6,1938,1947,9,No,0,0.0,6.93,6.93,0,1140,1140,0,4751,4751,0.0,0.0,0.0,12000.0,0.0,-12000.0
<a href=/player/eastr101>eastr101</a>,Rawly Eastwick,Cincinnati Reds,REDS,2,2,2,4,1977,1984,7,No,0,1.53,-0.48,-2.01,271,67,-204,32,42,10,635.0,371.0,-264.0,23200.0,0.0,-23200.0
<a href=/player/eastr101>eastr101</a>,Rawly Eastwick,New York Yankees,YANKS,2,2,3,5,1978,1980,2,No,0,-1.22,-0.23,0.99,221,59,-162,235,123,-112,369.0,0.0,-369.0,220000.0,0.0,-220000.0
<a href=/player/eastr102>eastr102</a>,Roy Easterwood,Chicago Cubs,CUBS,1,1,1,2,1948,1948,0,No,0,0.0,0.0,0.0,0,0,0,0,0,0,0.0,0.0,0.0,0.0,0.0,0.0
<a href=/player/eatoa001>eatoa001</a>,Adam Eaton,Philadelphia Phillies,PHILS,3,6,5,11,1999,2003,4,No,0,6.55,1.13,-5.42,362,281,-81,360,99,-261,2958.0,1114.0,-1844.0,6615000.0,0.0,-6615000.0
<a href=/player/eatoa001>eatoa001</a>,Adam Eaton,San Diego Padres,PADRS,9,21,20,41,2006,2021,15,Yes,0,51.12,29.32,-21.8,2292,1830,-462,7839,5012,-2827,1512.0,4191.0,2679.0,15535200.0,0.0,-15535200.0
<a href=/player/eatoa002>eatoa002</a>,Adam Eaton,Arizona Diamondbacks,DBACKS,2,4,7,11,2013,2018,5,Yes,0,18.83,2.34,-16.49,681,392,-289,2515,1311,-1204,400.0,119.0,-281.0,491000.0,0.0,-491000.0
<a href=/player/eatoa002>eatoa002</a>,Adam Eaton,Chicago White Sox,WSOX,2,3,4,7,2016,2020,4,Yes,0,3.36,0.15,-3.21,339,7,-332,1313,0,-1313,353.0,102.0,-251.0,2750000.0,0.0,-2750000.0
<a href=/player/eatoc101>eatoc101</a>,Craig Eaton,Kansas City Royals,ROYALS,3,5,4,9,1980,1986,6,No,0,14.42,8.44,-5.98,1272,909,-363,3936,3256,-680,0.0,0.0,0.0,0.0,0.0,0.0
<a href=/player/eaveg001>eaveg001</a>,Gary Eave,Atlanta Braves,BRAVES,1,2,1,3,1990,1990,0,No,0,0.04,-1.77,-1.81,8,140,132,0,577,577,90.0,0.0,-90.0,0.0,0.0,0.0
<a href=/player/eaveg001>eaveg001</a>,Gary Eave,Seattle Mariners,MARNRS,1,1,1,2,1990,1993,3,No,0,0.0,0.74,0.74,0,152,152,0,0,0,0.0,749.0,749.0,0.0,0.0,0.0
<a href=/player/eavev101>eavev101</a>,Vallie Eaves,Chicago Cubs,CUBS,1,1,1,2,1943,1943,0,No,0,0.0,0.36,0.36,0,64,64,0,136,136,0.0,0.0,0.0,0.0,0.0,0.0
<a href=/player/eberd001>eberd001</a>,Derrin Ebert,Chicago Cubs,CUBS,1,1,1,2,2003,2003,0,No,0,0.0,0.0,0.0,0,0,0,0,0,0,0.0,0.0,0.0,0.0,0.0,0.0
<a href=/player/eckec101>eckec101</a>,Charlie Eckert,Philadelphia Athletics,ATLTCS,2,4,2,6,1922,1930,8,No,0,-0.04,11.94,11.98,62,781,719,204,2980,2776,0.0,0.0,0.0,7800.0,0.0,-7800.0
<a href=/player/ecked001>ecked001</a>,Dennis Eckersley,Cleveland Indians,INDINS,11,17,24,41,1978,2011,33,No,4,62.43,64.43,2.0,2207,3216,1009,7220,10249,3029,6797.0,7509.0,712.0,1767500.0,0.0,-1767500.0
<a href=/player/ecked001>ecked001</a>,Dennis Eckersley,Boston Red Sox,RSOX,1,2,1,3,1984,1987,3,No,0,10.18,-0.52,-10.7,204,504,300,312,2176,1864,1592.0,0.0,-1592.0,0.0,0.0,0.0
<a href=/player/ecked001>ecked001</a>,Dennis Eckersley,Chicago Cubs,CUBS,1,2,3,5,1987,1987,0,No,0,15.94,0.0,-15.94,542,0,-542,0,0,0,1911.0,0.0,-1911.0,0.0,0.0,0.0
<a href=/player/ecked001>ecked001</a>,Dennis Eckersley,Oakland Athletics,ATLTCS,1,1,1,2,1996,1997,1,No,0,0.59,-0.62,-1.21,237,12,-225,1,0,-1,339.0,60.0,-279.0,0.0,0.0,0.0
<a href=/player/eckee001>eckee001</a>,Eric Eckenstahler,Detroit Tigers,TIGRS,1,2,1,3,2004,2004,0,No,0,0.0,0.0,0.0,0,0,0,0,0,0,0.0,0.0,0.0,0.0,0.0,0.0
<a href=/player/eckho101>eckho101</a>,Ox Eckhardt,Brooklyn Dodgers,DOGRS,2,7,3,10,1936,1944,8,No,0,1.9,2.87,0.97,125,593,468,330,2189,1859,390.0,0.0,-390.0,10000.0,0.0,-10000.0
<a href=/player/ecksd001>ecksd001</a>,David Eckstein,Toronto Blue Jays,BJAYS,1,1,1,2,2008,2012,4,No,0,-0.14,-0.21,-0.07,18,19,1,73,0,-73,0.0,54.0,54.0,4500000.0,0.0,-4500000.0
<a href=/player/eddyc001>eddyc001</a>,Chris Eddy,Kansas City Royals,ROYALS,1,1,1,2,1996,1996,0,No,0,0.0,0.0,0.0,0,0,0,0,0,0,0.0,0.0,0.0,0.0,0.0,0.0
<a href=/player/eddyd101>eddyd101</a>,Don Eddy,Chicago White Sox,WSOX,1,2,1,3,1972,1973,1,No,0,0.0,-0.08,-0.08,0,74,74,0,295,295,0.0,0.0,0.0,0.0,0.0,0.0
<a href=/player/edelj101>edelj101</a>,Joe Edelen,St. Louis Cardinals,CARDS,5,7,8,15,1981,1996,15,No,1,-2.44,12.91,15.35,324,1354,1030,346,3284,2938,992.0,1563.0,571.0,4150000.0,0.0,-4150000.0
<a href=/player/edenm101>edenm101</a>,Mike Eden,San Francisco Giants,GIANTS,5,10,8,18,1976,1995,19,No,1,14.15,26.8,12.65,1367,2042,675,3556,6654,3098,4215.0,726.0,-3489.0,1545000.0,0.0,-1545000.0
<a href=/player/edent001>edent001</a>,Tom Edens,Kansas City Royals,ROYALS,1,1,1,2,1984,1984,0,No,0,-0.19,-0.3,-0.11,4,9,5,3,14,11,24.0,0.0,-24.0,0.0,0.0,0.0
<a href=/player/edent001>edent001</a>,Tom Edens,New York Mets,METS,14,22,24,46,1989,1999,10,No,1,42.74,12.21,-30.53,2762,1749,-1013,6221,1744,-4477,4175.0,4730.0,555.0,13614666.0,0.0,-13614666.0
<a href=/player/edent001>edent001</a>,Tom Edens,Florida Marlins,MARLNS,3,4,4,8,1992,1996,4,No,0,2.95,5.1,2.15,559,217,-342,22,182,160,1105.0,1519.0,414.0,0.0,0.0,0.0
<a href=/player/edent001>edent001</a>,Tom Edens,Houston Astros,ASTROS,1,1,1,2,1994,1995,1,No,0,0.14,0.12,-0.02,6,101,95,0,172,172,12.0,0.0,-12.0,475000.0,0.0,-475000.0
<a href=/player/edgeb102>edgeb102</a>,Butch Edge,Atlanta Braves,BRAVES,1,1,1,2,1981,1981,0,No,0,0.0,0.0,0.0,0,0,0,0,0,0,0.0,0.0,0.0,0.0,0.0,0.0
<a href=/player/edgeb102>edgeb102</a>,Butch Edge,Chicago White Sox,WSOX,2,3,3,6,1982,1987,5,No,0,4.43,7.04,2.61,422,580,158,1527,1402,-125,154.0,667.0,513.0,0.0,0.0,0.0
<a href=/player/edmoj001>edmoj001</a>,Jim Edmonds,Anaheim Angels,ANGELS,3,3,4,7,2000,2006,6,No,1,38.49,19.72,-18.77,1121,1048,-73,4373,3794,-579,132.0,383.0,251.0,4000000.0,0.0,-4000000.0
<a href=/player/edmoj001>edmoj001</a>,Jim Edmonds,St. Louis Cardinals,CARDS,3,4,5,9,2007,2019,12,No,0,8.35,13.42,5.07,974,1243,269,2950,3660,710,577.0,194.0,-383.0,13224540.0,0.0,-13224540.0
<a href=/player/edmoj001>edmoj001</a>,Jim Edmonds,Milwaukee Brewers,BREWRS,2,2,2,4,2010,2011,1,No,0,0.39,-0.11,-0.5,98,68,-30,104,63,-41,0.0,99.0,99.0,850000.0,0.0,-850000.0
<a href=/player/edwab101>edwab101</a>,Bruce Edwards,Brooklyn Dodgers,DOGRS,3,6,7,13,1951,1958,7,No,0,4.28,2.12,-2.16,1667,685,-982,5534,2062,-3472,435.0,267.0,-168.0,50000.0,0.0,-50000.0
<a href=/player/edwac001>edwac001</a>,Carl Edwards,Texas Rangers,RNGRS,1,4,1,5,2013,2013,0,No,0,4.33,-0.09,-4.42,1129,13,-1116,283,0,-283,1426.0,253.0,-1173.0,0.0,0.0,0.0
<a href=/player/edwac001>edwac001</a>,Carl Edwards,Chicago Cubs,CUBS,1,1,1,2,2019,2019,0,Yes,0,-0.23,0.21,0.44,4,28,24,0,0,0,5.0,30.0,25.0,1500000.0,0.0,-1500000.0
<a href=/player/edwad101>edwad101</a>,Dave Edwards,Minnesota Twins,TWINS,1,1,1,2,1980,1980,0,No,0,-0.7,0.0,0.7,129,0,-129,181,0,-181,0.0,0.0,0.0,0.0,0.0,0.0
<a href=/player/edwad102>edwad102</a>,Doc Edwards,Cleveland Indians,INDINS,3,6,7,13,1963,1970,7,No,0,12.89,19.01,6.12,824,1350,526,1390,4230,2840,3166.0,784.0,-2382.0,51000.0,0.0,-51000.0
<a href=/player/edwad102>edwad102</a>,Doc Edwards,Kansas City Athletics,ATLTCS,11,24,17,41,1965,1976,11,No,0,26.47,18.12,-8.35,4341,1975,-2366,9113,5030,-4083,5181.0,2140.0,-3041.0,368100.0,0.0,-368100.0
<a href=/player/edwad102>edwad102</a>,Doc Edwards,New York Yankees,YANKS,1,1,1,2,1966,1967,1,No,0,0.0,0.17,0.17,0,86,86,0,184,184,0.0,0.0,0.0,0.0,0.0,0.0
<a href=/player/edwad102>edwad102</a>,Doc Edwards,Cleveland Indians,INDINS,2,4,4,8,1967,1969,2,No,0,1.58,2.6,1.02,217,267,50,702,761,59,0.0,0.0,0.0,0.0,0.0,0.0
<a href=/player/edwah101>edwah101</a>,Hank Edwards,Chicago Cubs,CUBS,5,9,8,17,1950,1961,11,No,0,9.53,14.09,4.56,932,1704,772,1551,6601,5050,802.0,0.0,-802.0,17500.0,0.0,-17500.0
<a href=/player/edwah101>edwah101</a>,Hank Edwards,Cincinnati Reds,REDS,1,1,1,2,1952,1955,3,No,0,-0.02,0.91,0.93,8,94,86,18,38,20,0.0,396.0,396.0,0.0,0.0,0.0
<a href=/player/edwah101>edwah101</a>,Hank Edwards,Chicago White Sox,WSOX,5,13,10,23,1952,1961,9,No,0,17.5,10.87,-6.63,3154,1282,-1872,10106,3886,-6220,2246.0,536.0,-1710.0,62000.0,0.0,-62000.0
<a href=/player/edwaj001>edwaj001</a>,Jon Edwards,Texas Rangers,RNGRS,1,2,1,3,2015,2015,0,No,0,0.11,-0.05,-0.16,22,37,15,0,82,82,32.0,0.0,-32.0,508500.0,0.0,-508500.0
<a href=/player/edwaj101>edwaj101</a>,Johnny Edwards,Cincinnati Reds,REDS,2,2,3,5,1968,1973,5,No,0,0.72,-0.31,-1.03,158,137,-21,466,367,-99,0.0,0.0,0.0,0.0,0.0,0.0
<a href=/player/edwaj101>edwaj101</a>,Johnny Edwards,St. Louis Cardinals,CARDS,3,4,4,8,1968,1971,3,No,0,5.4,-0.19,-5.59,715,29,-686,2340,38,-2302,0.0,0.0,0.0,0.0,0.0,0.0
<a href=/player/edwam101>edwam101</a>,Mike Edwards,Pittsburgh Pirates,PIRATS,5,9,10,19,1978,1984,6,No,0,24.55,-1.47,-26.02,1160,294,-866,2724,444,-2280,3108.0,299.0,-2809.0,300000.0,0.0,-300000.0
<a href=/player/efliz001>efliz001</a>,Zach Eflin,San Diego Padres,PADRS,2,5,4,9,2014,2016,2,No,0,8.85,0.65,-8.2,684,254,-430,2593,1079,-1514,26.0,0.0,-26.0,1293600.0,0.0,-1293600.0
<a href=/player/efliz001>efliz001</a>,Zach Eflin,Los Angeles Dodgers,DOGRS,1,2,2,4,2014,2015,1,No,0,6.34,0.44,-5.9,200,144,-56,184,563,379,1751.0,0.0,-1751.0,0.0,0.0,0.0
<a href=/player/eganb101>eganb101</a>,Ben Egan,Philadelphia Athletics,ATLTCS,2,5,3,8,1913,1916,3,No,0,0.94,10.04,9.1,71,783,712,237,3271,3034,0.0,0.0,0.0,0.0,0.0,0.0
<a href=/player/eganb101>eganb101</a>,Ben Egan,Boston Red Sox,RSOX,23,51,62,113,1914,1937,23,No,0,210.47,131.21,-79.26,10024,6525,-3499,28339,20821,-7518,29017.0,15462.0,-13555.0,136800.0,0.0,-136800.0
<a href=/player/egand101>egand101</a>,Dick Egan,Detroit Tigers,TIGRS,1,1,2,3,1965,1965,0,No,0,0.0,0.0,0.0,0,0,0,0,0,0,0.0,0.0,0.0,0.0,0.0,0.0
<a href=/player/egand101>egand101</a>,Dick Egan,California Angels,ANGELS,2,3,2,5,1966,1966,0,No,0,-0.66,0.75,1.41,48,38,-10,5,6,1,150.0,129.0,-21.0,8500.0,0.0,-8500.0
<a href=/player/egant101>egant101</a>,Tom Egan,California Angels,ANGELS,8,17,17,34,1970,1976,6,No,0,13.31,15.37,2.06,1179,1226,47,3267,3750,483,2333.0,345.0,-1988.0,137100.0,0.0,-137100.0
<a href=/player/eganw101>eganw101</a>,Wish Egan,St. Louis Cardinals,CARDS,1,2,1,3,1906,1907,1,No,0,0.0,-0.14,-0.14,0,22,22,0,79,79,0.0,0.0,0.0,0.0,0.0,0.0
<a href=/player/ege-c001>ege-c001</a>,Cody Ege,Texas Rangers,RNGRS,2,4,2,6,2015,2017,2,Yes,0,2.24,2.95,0.71,421,128,-293,185,0,-185,487.0,355.0,-132.0,0.0,0.0,0.0
<a href=/player/ehmkh101>ehmkh101</a>,Howard Ehmke,Detroit Tigers,TIGRS,2,6,3,9,1922,1928,6,No,0,20.71,4.6,-16.11,377,336,-41,782,333,-449,2967.0,2739.0,-228.0,8000.0,0.0,-8000.0
<a href=/player/ehmkh101>ehmkh101</a>,Howard Ehmke,Boston Red Sox,RSOX,3,7,7,14,1926,1928,2,No,0,8.68,3.68,-5.0,175,373,198,208,792,584,1623.0,1683.0,60.0,28750.0,0.0,-28750.0
<a href=/player/ehrer101>ehrer101</a>,Red Ehret,Pittsburgh Pirates,PIRATS,4,10,8,18,1895,1910,15,No,0,26.22,58.36,32.14,1335,2331,996,4583,8981,4398,3859.0,4337.0,478.0,0.0,0.0,0.0
<a href=/player/ehrer101>ehrer101</a>,Red Ehret,St. Louis Cardinals,CARDS,5,8,13,21,1895,1899,4,No,0,45.5,0.55,-44.95,2073,759,-1314,7733,2872,-4861,1422.0,668.0,-754.0,0.0,0.0,0.0
<a href=/player/ehrer101>ehrer101</a>,Red Ehret,Cincinnati Reds,REDS,2,5,2,7,1898,1898,0,No,0,7.73,2.21,-5.52,627,66,-561,2681,105,-2576,267.0,786.0,519.0,0.0,0.0,0.0
<a href=/player/ehrhr101>ehrhr101</a>,Rube Ehrhardt,Brooklyn Dodgers,DOGRS,1,2,1,3,1929,1933,4,No,0,1.02,-0.43,-1.45,222,187,-35,631,496,-135,148.0,0.0,-148.0,0.0,0.0,0.0
<a href=/player/eibnb001>eibnb001</a>,Brett Eibner,Kansas City Royals,ROYALS,1,1,1,2,2016,2018,2,No,0,-0.79,-0.67,0.12,44,31,-13,123,46,-77,0.0,0.0,0.0,0.0,0.0,0.0
<a href=/player/eibnb001>eibnb001</a>,Brett Eibner,Oakland Athletics,ATLTCS,1,1,1,2,2017,2017,0,Yes,0,-0.35,0.0,0.35,17,0,-17,36,0,-36,0.0,0.0,0.0,0.0,0.0,0.0
<a href=/player/eichj001>eichj001</a>,Juan Eichelberger,San Diego Padres,PADRS,4,7,5,12,1982,1994,12,No,1,4.07,-0.5,-4.57,850,470,-380,2345,1007,-1338,402.0,1199.0,797.0,130000.0,0.0,-130000.0
<a href=/player/eichm001>eichm001</a>,Mark Eichhorn,California Angels,ANGELS,1,1,2,3,1992,1995,3,No,0,1.7,0.36,-1.34,77,277,200,0,834,834,311.0,0.0,-311.0,1805000.0,0.0,-1805000.0
<a href=/player/eickj001>eickj001</a>,Jerad Eickhoff,Texas Rangers,RNGRS,5,14,16,30,2015,2021,6,Yes,0,11.03,13.28,2.25,790,293,-497,1664,16,-1648,2536.0,2164.0,-372.0,3762500.0,0.0,-3762500.0
<a href=/player/eilad001>eilad001</a>,Dave Eiland,Cleveland Indians,INDINS,1,1,2,3,1993,1993,0,No,0,0.0,0.0,0.0,0,0,0,0,0,0,0.0,0.0,0.0,0.0,0.0,0.0
<a href=/player/eiscj001>eiscj001</a>,Joey Eischen,Texas Rangers,RNGRS,1,3,1,4,1991,1991,0,No,0,2.41,-0.71,-3.12,510,12,-498,30,0,-30,668.0,186.0,-482.0,0.0,0.0,0.0
<a href=/player/eiscj001>eiscj001</a>,Joey Eischen,Montreal Expos,NATEX,3,4,4,8,1995,2000,5,No,0,2.32,1.96,-0.36,552,545,-7,1710,1297,-413,362.0,850.0,488.0,2625000.0,0.0,-2625000.0
<a href=/player/eiscj001>eiscj001</a>,Joey Eischen,Los Angeles Dodgers,DOGRS,1,2,1,3,1996,1996,0,No,0,0.39,0.36,-0.03,64,43,-21,0,121,121,244.0,0.0,-244.0,305000.0,0.0,-305000.0
<a href=/player/eiscj001>eiscj001</a>,Joey Eischen,Detroit Tigers,TIGRS,3,4,5,9,1996,2005,9,No,2,2.15,3.03,0.88,155,158,3,547,170,-377,0.0,1659.0,1659.0,600000.0,0.0,-600000.0
<a href=/player/eiscj001>eiscj001</a>,Joey Eischen,San Diego Padres,PADRS,1,1,1,2,1997,1997,0,No,0,-0.06,0.0,0.06,2,0,-2,1,0,-1,4.0,0.0,-4.0,0.0,0.0,0.0
<a href=/player/eiseh101>eiseh101</a>,Harry Eisenstat,Detroit Tigers,TIGRS,1,2,1,3,1939,1941,2,No,0,4.92,0.45,-4.47,206,151,-55,69,490,421,771.0,0.0,-771.0,0.0,0.0,0.0
<a href=/player/eisej001>eisej001</a>,Jim Eisenreich,Florida Marlins,MARLNS,15,33,38,71,1998,2019,21,Yes,0,116.45,94.42,-22.03,4698,5470,772,15425,16217,792,10496.0,10160.0,-336.0,68580667.0,0.0,-68580667.0
<a href=/player/elars001>elars001</a>,Scott Elarton,Houston Astros,ASTROS,1,1,2,3,2001,2001,0,No,0,-2.27,0.82,3.09,45,8,-37,39,12,-27,348.0,86.0,-262.0,400000.0,0.0,-400000.0
<a href=/player/elbek101>elbek101</a>,Kid Elberfeld,Detroit Tigers,TIGRS,2,5,4,9,1903,1911,8,No,0,19.09,16.8,-2.29,667,893,226,2757,3796,1039,0.0,39.0,39.0,0.0,0.0,0.0
<a href=/player/elded001>elded001</a>,Dave Elder,Texas Rangers,RNGRS,1,1,1,2,2001,2002,1,No,0,0.13,-0.54,-0.67,19,36,17,0,0,0,76.0,73.0,-3.0,0.0,0.0,0.0
<a href=/player/eldrc001>eldrc001</a>,Cal Eldred,Milwaukee Brewers,BREWRS,1,2,2,4,2000,2000,0,No,0,18.62,-2.6,-21.22,696,55,-641,2756,47,-2709,354.0,437.0,83.0,0.0,0.0,0.0
<a href=/player/elial101>elial101</a>,Lee Elia,Philadelphia Phillies,PHILS,1,2,2,4,1964,1966,2,No,0,0.7,1.42,0.72,243,96,-147,836,60,-776,0.0,543.0,543.0,6000.0,0.0,-6000.0
<a href=/player/elial101>elial101</a>,Lee Elia,Chicago Cubs,CUBS,1,1,1,2,1969,1969,0,No,0,0.0,-0.33,-0.33,0,44,44,0,49,49,0.0,0.0,0.0,0.0,0.0,0.0
<a href=/player/eliar001>eliar001</a>,Roenis Elias,Seattle Mariners,MARNRS,2,3,3,6,2015,2018,3,No,0,-0.47,2.16,2.63,84,70,-14,9,13,4,729.0,1001.0,272.0,0.0,0.0,0.0
<a href=/player/eliar001>eliar001</a>,Roenis Elias,Boston Red Sox,RSOX,1,1,1,2,2018,2018,0,Yes,0,1.06,0.0,-1.06,71,0,-71,2,0,-2,294.0,0.0,-294.0,0.0,0.0,0.0
<a href=/player/eliar001>eliar001</a>,Roenis Elias,Seattle Mariners,MARNRS,1,2,3,5,2019,2020,1,Yes,0,-0.26,0.45,0.71,55,27,-28,1,0,-1,72.0,60.0,-12.0,2210000.0,0.0,-2210000.0
<a href=/player/ellar101>ellar101</a>,Roy Ellam,Indianapolis,Indianapolis,1,1,1,2,1918,1918,0,No,0,-0.09,0.0,0.09,26,0,-26,105,0,-105,0.0,0.0,0.0,0.0,0.0,0.0
<a href=/player/ellef101>ellef101</a>,Frank Ellerbe,Washington Senators,TWINS,1,1,1,2,1921,1921,0,No,0,-0.22,-0.7,-0.48,235,59,-176,999,195,-804,0.0,0.0,0.0,4000.0,0.0,-4000.0
<a href=/player/elles001>elles001</a>,Seth Elledge,Seattle Mariners,MARNRS,1,1,1,2,2018,2020,2,No,0,-0.06,1.02,1.08,35,29,-6,2,0,-2,70.0,85.0,15.0,0.0,0.0,0.0
<a href=/player/ellia001>ellia001</a>,A.J. Ellis,Los Angeles Dodgers,DOGRS,3,5,4,9,2016,2017,1,Yes,0,0.14,0.23,0.09,78,14,-64,181,40,-141,47.0,0.0,-47.0,8500000.0,0.0,-8500000.0
<a href=/player/ellib102>ellib102</a>,Babe Ellison,Detroit Tigers,TIGRS,1,1,1,2,1920,1925,5,No,0,0.0,0.72,0.72,0,299,299,0,192,192,0.0,1487.0,1487.0,0.0,0.0,0.0
<a href=/player/ellib103>ellib103</a>,Bob Elliott,Pittsburgh Pirates,PIRATS,1,2,4,6,1946,1949,3,No,0,25.05,-0.22,-25.27,770,168,-602,3219,87,-3132,0.0,478.0,478.0,0.0,0.0,0.0
<a href=/player/ellib103>ellib103</a>,Bob Elliott,Boston Braves,BRAVES,2,2,3,5,1952,1952,0,No,0,0.63,-0.49,-1.12,142,78,-64,320,9,-311,118.0,210.0,92.0,0.0,0.0,0.0
<a href=/player/ellib103>ellib103</a>,Bob Elliott,St.Louis Browns,ORLS,22,48,46,94,1953,1994,41,No,3,94.31,149.93,55.62,5238,8648,3410,10875,24828,13953,20367.0,16826.0,-3541.0,970833.0,0.0,-970833.0
<a href=/player/ellib104>ellib104</a>,Bruce Ellingsen,Los Angeles Dodgers,DOGRS,3,3,3,6,1974,1989,15,No,1,1.59,34.0,32.41,516,1066,550,2026,4107,2081,126.0,200.0,74.0,1720000.0,0.0,-1720000.0
<a href=/player/ellic001>ellic001</a>,Chris Ellis,Anaheim Angels,ANGELS,1,4,2,6,2015,2020,5,No,0,2.92,20.49,17.57,366,607,241,466,2409,1943,1135.0,0.0,-1135.0,8500000.0,0.0,-8500000.0
<a href=/player/ellic001>ellic001</a>,Chris Ellis,Atlanta Braves,BRAVES,2,6,2,8,2016,2017,1,Yes,0,2.2,1.46,-0.74,256,33,-223,58,35,-23,887.0,339.0,-548.0,13307500.0,0.0,-13307500.0
<a href=/player/ellic101>ellic101</a>,Claude Elliott,New York Giants,GIANTS,5,12,7,19,1906,1921,15,No,0,45.64,34.49,-11.15,2445,1674,-771,8369,5360,-3009,1733.0,3268.0,1535.0,6400.0,0.0,-6400.0
<a href=/player/ellid001>ellid001</a>,Donnie Elliott,Philadelphia Phillies,PHILS,1,1,1,2,1992,1994,2,No,0,0.0,1.78,1.78,0,118,118,0,116,116,0.0,909.0,909.0,0.0,0.0,0.0
<a href=/player/ellid001>ellid001</a>,Donnie Elliott,Atlanta Braves,BRAVES,1,3,1,4,1993,1997,4,No,0,-0.25,11.08,11.33,189,636,447,337,2705,2368,105.0,0.0,-105.0,0.0,0.0,0.0
<a href=/player/ellid101>ellid101</a>,Dock Ellis,Pittsburgh Pirates,PIRATS,6,13,12,25,1975,1988,13,No,0,109.3,32.91,-76.39,4660,1733,-2927,17124,6632,-10492,6130.0,687.0,-5443.0,807000.0,0.0,-807000.0
<a href=/player/ellid101>ellid101</a>,Dock Ellis,New York Yankees,YANKS,2,4,2,6,1977,1985,8,No,1,-3.76,2.42,6.18,344,31,-313,885,0,-885,78.0,651.0,573.0,0.0,0.0,0.0
<a href=/player/ellid101>ellid101</a>,Dock Ellis,Texas Rangers,RNGRS,1,1,2,3,1979,1979,0,No,0,-1.27,0.0,1.27,34,0,-34,28,0,-28,255.0,0.0,-255.0,0.0,0.0,0.0
<a href=/player/ellig102>ellig102</a>,Glenn Elliott,Boston Braves,BRAVES,3,11,3,14,1950,1960,10,No,0,8.19,21.05,12.86,794,939,145,1824,3291,1467,2135.0,2034.0,-101.0,0.0,0.0,0.0
<a href=/player/ellij001>ellij001</a>,Jason Ellison,San Francisco Giants,GIANTS,1,1,1,2,2007,2007,0,No,0,-0.24,-0.12,0.12,63,4,-59,48,3,-45,0.0,26.0,26.0,0.0,0.0,0.0
<a href=/player/ellij101>ellij101</a>,John Ellis,New York Yankees,YANKS,5,8,9,17,1972,1987,15,No,0,9.09,48.73,39.64,1757,1810,53,5603,6602,999,883.0,1959.0,1076.0,246600.0,0.0,-246600.0
<a href=/player/ellij101>ellij101</a>,John Ellis,Cleveland Indians,INDINS,2,2,3,5,1975,1984,9,No,0,-1.14,5.9,7.04,334,687,353,942,2159,1217,0.0,317.0,317.0,0.0,0.0,0.0
<a href=/player/ellij102>ellij102</a>,Jim Ellis,Chicago Cubs,CUBS,2,3,3,6,1968,1974,6,No,0,-0.08,14.65,14.73,111,1174,1063,205,2396,2191,0.0,1177.0,1177.0,0.0,0.0,0.0
<a href=/player/ellij102>ellij102</a>,Jim Ellis,Los Angeles Dodgers,DOGRS,1,1,1,2,1968,1968,0,No,0,0.22,0.0,-0.22,4,0,-4,1,0,-1,16.0,0.0,-16.0,0.0,0.0,0.0
<a href=/player/ellij102>ellij102</a>,Jim Ellis,St. Louis Cardinals,CARDS,1,2,3,5,1970,1972,2,No,0,0.0,0.71,0.71,0,95,95,0,203,203,0.0,0.0,0.0,17500.0,0.0,-17500.0
<a href=/player/ellij103>ellij103</a>,Jumbo Elliott,Brooklyn Dodgers,DOGRS,2,6,3,9,1930,1936,6,No,0,9.9,18.06,8.16,811,786,-25,1763,3200,1437,2519.0,0.0,-2519.0,18200.0,0.0,-18200.0
<a href=/player/ellil101>ellil101</a>,Larry Elliot,New York Mets,METS,1,2,1,3,1967,1969,2,No,0,0.0,5.12,5.12,0,279,279,0,963,963,0.0,0.0,0.0,0.0,0.0,0.0
<a href=/player/ellim001>ellim001</a>,Mark Ellis,Kansas City Royals,ROYALS,2,3,5,8,2001,2008,7,No,0,28.96,3.25,-25.71,1295,867,-428,5271,2850,-2421,0.0,359.0,359.0,0.0,0.0,0.0
<a href=/player/ellim001>ellim001</a>,Mark Ellis,Oakland Athletics,ATLTCS,1,1,2,3,2011,2013,2,No,0,1.57,-0.29,-1.86,70,3,-67,286,0,-286,0.0,15.0,15.0,6000000.0,0.0,-6000000.0
<a href=/player/ellir001>ellir001</a>,Robert Ellis,Chicago White Sox,WSOX,1,1,1,2,1996,1996,0,No,0,0.23,-0.03,-0.26,3,31,28,0,102,102,15.0,0.0,-15.0,0.0,0.0,0.0
<a href=/player/ellir001>ellir001</a>,Robert Ellis,Cleveland Indians,INDINS,1,1,1,2,2004,2004,0,No,0,0.0,0.0,0.0,0,0,0,0,0,0,0.0,0.0,0.0,0.0,0.0,0.0
<a href=/player/ellir102>ellir102</a>,Rube Ellis,Cincinnati Reds,REDS,4,11,8,19,1909,1914,5,No,0,44.03,9.97,-34.06,2926,905,-2021,11991,3124,-8867,753.0,872.0,119.0,0.0,0.0,0.0
<a href=/player/ellis101>ellis101</a>,Sammy Ellis,Cincinnati Reds,REDS,1,1,2,3,1967,1969,2,No,0,-1.33,-0.19,1.14,84,70,-14,53,8,-45,492.0,163.0,-329.0,26500.0,0.0,-26500.0
<a href=/player/ellis101>ellis101</a>,Sammy Ellis,California Angels,ANGELS,2,2,3,5,1969,1971,2,No,0,-0.28,1.28,1.56,144,213,69,353,599,246,88.0,0.0,-88.0,0.0,0.0,0.0
<a href=/player/ellis101>ellis101</a>,Sammy Ellis,Chicago White Sox,WSOX,1,1,1,2,1969,1969,0,No,0,0.0,-1.06,-1.06,0,16,16,0,0,0,0.0,37.0,37.0,27500.0,0.0,-27500.0
<a href=/player/ellsd101>ellsd101</a>,Dick Ellsworth,Chicago Cubs,CUBS,2,2,5,7,1966,1969,3,No,0,9.7,0.67,-9.03,376,60,-316,446,59,-387,3653.0,458.0,-3195.0,17500.0,0.0,-17500.0
<a href=/player/ellsd101>ellsd101</a>,Dick Ellsworth,Philadelphia Phillies,PHILS,2,3,3,6,1967,1974,7,No,0,0.86,0.9,0.04,97,392,295,157,1287,1130,624.0,0.0,-624.0,32000.0,0.0,-32000.0
<a href=/player/ellsd101>ellsd101</a>,Dick Ellsworth,Boston Red Sox,RSOX,3,6,6,12,1969,1973,4,No,0,5.38,12.96,7.58,1093,699,-394,2374,1115,-1259,1155.0,3166.0,2011.0,26500.0,0.0,-26500.0
<a href=/player/elshr101>elshr101</a>,Roy Elsh,Chicago White Sox,WSOX,4,12,5,17,1926,1936,10,No,0,0.81,1.51,0.7,234,542,308,748,1962,1214,0.0,39.0,39.0,19600.0,0.0,-19600.0
<a href=/player/elstd101>elstd101</a>,Don Elston,Chicago Cubs,CUBS,5,9,9,18,1955,1964,9,No,0,9.43,6.83,-2.6,1051,943,-108,3111,3013,-98,133.0,368.0,235.0,0.0,0.0,0.0
<a href=/player/elstd101>elstd101</a>,Don Elston,Brooklyn Dodgers,DOGRS,1,1,2,3,1957,1961,4,No,0,9.65,-0.13,-9.78,894,10,-884,138,1,-137,2255.0,23.0,-2232.0,0.0,0.0,0.0
<a href=/player/ely-b101>ely-b101</a>,Bones Ely,St. Louis Cardinals,CARDS,4,6,12,18,1896,1899,3,No,0,25.49,14.57,-10.92,2211,1134,-1077,8166,3896,-4270,4212.0,3935.0,-277.0,0.0,0.0,0.0
<a href=/player/ely-j001>ely-j001</a>,John Ely,Chicago White Sox,WSOX,1,2,1,3,2009,2011,2,No,0,-1.22,-0.64,0.58,67,318,251,36,1445,1409,372.0,0.0,-372.0,0.0,0.0,0.0
<a href=/player/ely-j001>ely-j001</a>,John Ely,Los Angeles Dodgers,DOGRS,2,2,3,5,2012,2013,1,No,0,0.0,-0.1,-0.1,0,21,21,0,53,53,0.0,0.0,0.0,0.0,0.0,0.0
<a href=/player/emaub001>emaub001</a>,Brad Emaus,Toronto Blue Jays,BJAYS,1,1,2,3,2011,2011,0,No,0,0.0,0.0,0.0,0,0,0,0,0,0,0.0,0.0,0.0,0.0,0.0,0.0
<a href=/player/embra001>embra001</a>,Alan Embree,Cleveland Indians,INDINS,15,20,25,45,1997,2020,23,Yes,2,33.89,80.62,46.73,2990,2655,-335,9123,6094,-3029,3747.0,9391.0,5644.0,44554400.0,0.0,-44554400.0
<a href=/player/embra001>embra001</a>,Alan Embree,Atlanta Braves,BRAVES,4,7,6,13,1998,2005,7,No,2,48.92,11.19,-37.73,1492,384,-1108,1201,926,-275,9346.0,229.0,-9117.0,4543000.0,0.0,-4543000.0
<a href=/player/embra001>embra001</a>,Alan Embree,Arizona Diamondbacks,DBACKS,2,2,2,4,1998,2000,2,No,0,0.32,-0.45,-0.77,300,22,-278,1,28,27,416.0,0.0,-416.0,200000.0,0.0,-200000.0
<a href=/player/embra001>embra001</a>,Alan Embree,San Francisco Giants,GIANTS,1,2,1,3,2001,2001,0,No,0,-0.03,0.0,0.03,39,0,-39,0,0,0,102.0,0.0,-102.0,2400000.0,0.0,-2400000.0
<a href=/player/embra001>embra001</a>,Alan Embree,San Diego Padres,PADRS,1,2,2,4,2002,2006,4,No,0,1.41,0.0,-1.41,227,0,-227,0,0,0,535.0,0.0,-535.0,500000.0,0.0,-500000.0
<a href=/player/embrr101>embrr101</a>,Red Embree,Cleveland Indians,INDINS,2,3,2,5,1947,1952,5,No,0,0.44,-0.63,-1.07,236,272,36,640,835,195,230.0,0.0,-230.0,0.0,0.0,0.0
<a href=/player/embrr101>embrr101</a>,Red Embree,New York Yankees,YANKS,2,7,3,10,1948,1954,6,No,0,24.48,2.06,-22.42,970,341,-629,1730,188,-1542,4702.0,1746.0,-2956.0,11500.0,0.0,-11500.0
<a href=/player/encaa001>encaa001</a>,Angelo Encarnacion,Pittsburgh Pirates,PIRATS,2,3,3,6,1997,1998,1,No,0,-0.39,-0.19,0.2,43,160,117,68,469,401,0.0,0.0,0.0,0.0,0.0,0.0
<a href=/player/encaa001>encaa001</a>,Angelo Encarnacion,San Diego Padres,PADRS,1,1,1,2,1997,1999,2,No,0,-0.06,0.0,0.06,11,0,-11,17,0,-17,0.0,0.0,0.0,0.0,0.0,0.0
<a href=/player/encae001>encae001</a>,Edwin Encarnacion,Texas Rangers,RNGRS,1,2,1,3,2001,2003,2,No,0,2.17,-0.72,-2.89,634,36,-598,2326,2,-2324,0.0,598.0,598.0,300000.0,0.0,-300000.0
<a href=/player/encae001>encae001</a>,Edwin Encarnacion,Cincinnati Reds,REDS,1,3,1,4,2009,2012,3,No,0,24.68,7.61,-17.07,1033,330,-703,4205,1298,-2907,160.0,0.0,-160.0,2425000.0,0.0,-2425000.0
<a href=/player/encae001>encae001</a>,Edwin Encarnacion,Cleveland Indians,INDINS,2,5,4,9,2018,2021,3,Yes,0,2.01,4.54,2.53,137,378,241,491,1477,986,0.0,0.0,0.0,18667000.0,0.0,-18667000.0
<a href=/player/encae001>encae001</a>,Edwin Encarnacion,Seattle Mariners,MARNRS,1,2,1,3,2019,2019,0,Yes,0,0.67,0.0,-0.67,44,0,-44,197,0,-197,0.0,0.0,0.0,0.0,0.0,0.0
<a href=/player/encaj001>encaj001</a>,Juan Encarnacion,Detroit Tigers,TIGRS,1,2,1,3,2001,2006,5,No,0,1.7,6.8,5.1,135,487,352,357,1976,1619,97.0,0.0,-97.0,4400000.0,0.0,-4400000.0
<a href=/player/encaj001>encaj001</a>,Juan Encarnacion,Cincinnati Reds,REDS,1,3,1,4,2002,2003,1,No,0,1.48,-2.8,-4.28,415,76,-339,1688,70,-1618,0.0,613.0,613.0,2400000.0,0.0,-2400000.0
<a href=/player/encaj001>encaj001</a>,Juan Encarnacion,Florida Marlins,MARLNS,1,1,1,2,2003,2005,2,No,0,-0.06,0.0,0.06,86,0,-86,350,0,-350,0.0,0.0,0.0,3450000.0,0.0,-3450000.0
<a href=/player/encaj001>encaj001</a>,Juan Encarnacion,Los Angeles Dodgers,DOGRS,2,6,5,11,2004,2008,4,No,0,2.71,12.71,10.0,623,499,-124,1632,1049,-583,321.0,2036.0,1715.0,9106667.0,0.0,-9106667.0
<a href=/player/encam001>encam001</a>,Mario Encarnacion,Oakland Athletics,ATLTCS,1,3,1,4,2001,2004,3,No,0,0.03,2.82,2.79,154,394,240,507,1663,1156,28.0,0.0,-28.0,201000.0,0.0,-201000.0
<a href=/player/enges001>enges001</a>,Steve Engel,Chicago Cubs,CUBS,1,2,1,3,1986,1988,2,No,0,5.63,1.35,-4.28,521,292,-229,2104,758,-1346,0.0,0.0,0.0,0.0,0.0,0.0
<a href=/player/englc101>englc101</a>,Charlie English,Chicago White Sox,WSOX,1,2,1,3,1933,1933,0,No,0,0.0,0.0,0.0,0,0,0,0,0,0,0.0,0.0,0.0,6000.0,0.0,-6000.0
<a href=/player/englc101>englc101</a>,Charlie English,Galveston,Galveston,1,2,1,3,1934,1934,0,No,0,0.0,0.0,0.0,0,0,0,0,0,0,0.0,0.0,0.0,0.0,0.0,0.0
<a href=/player/engld001>engld001</a>,Dave Engle,California Angels,ANGELS,1,4,1,5,1979,1985,6,No,0,6.38,17.39,11.01,810,834,24,2648,3570,922,1590.0,0.0,-1590.0,0.0,0.0,0.0
<a href=/player/engld001>engld001</a>,Dave Engle,Minnesota Twins,TWINS,1,1,2,3,1986,1986,0,No,0,-0.07,-0.75,-0.68,35,19,-16,93,38,-55,0.0,0.0,0.0,0.0,0.0,0.0
<a href=/player/englg101>englg101</a>,Gil English,New York Giants,GIANTS,2,3,2,5,1933,1937,4,No,0,3.13,0.5,-2.63,166,211,45,157,299,142,1053.0,322.0,-731.0,0.0,0.0,0.0
<a href=/player/englg101>englg101</a>,Gil English,Boston Braves,BRAVES,6,18,10,28,1938,1952,14,No,0,22.0,33.53,11.53,1506,1625,119,5516,5420,-96,0.0,2449.0,2449.0,12500.0,0.0,-12500.0
<a href=/player/englw101>englw101</a>,Woody English,Chicago Cubs,CUBS,1,2,1,3,1936,1938,2,No,0,-0.75,0.91,1.66,248,78,-170,579,238,-341,469.0,0.0,-469.0,0.0,0.0,0.0
<a href=/player/ennid101>ennid101</a>,Del Ennis,Philadelphia Phillies,PHILS,2,4,3,7,1956,1958,2,No,0,-2.41,0.14,2.55,379,229,-150,1019,841,-178,226.0,0.0,-226.0,0.0,0.0,0.0
<a href=/player/ennid101>ennid101</a>,Del Ennis,St. Louis Cardinals,CARDS,2,5,5,10,1958,1963,5,No,0,8.1,2.95,-5.15,969,458,-511,3320,993,-2327,89.0,111.0,22.0,0.0,0.0,0.0
<a href=/player/ennid101>ennid101</a>,Del Ennis,Cincinnati Reds,REDS,1,1,2,3,1959,1961,2,No,0,-0.82,0.02,0.84,26,10,-16,100,1,-99,0.0,22.0,22.0,0.0,0.0,0.0
<a href=/player/ennsd001>ennsd001</a>,Dietrich Enns,New York Yankees,YANKS,1,2,1,3,2017,2017,0,No,0,0.02,-0.11,-0.13,48,9,-39,2,2,0,203.0,112.0,-91.0,0.0,0.0,0.0
<a href=/player/enrib001>enrib001</a>,Barry Enright,Arizona Diamondbacks,DBACKS,1,1,1,2,2012,2012,0,No,0,-0.92,0.0,0.92,7,0,-7,0,0,0,36.0,0.0,-36.0,0.0,0.0,0.0
<a href=/player/ens-m101>ens-m101</a>,Mutz Ens,Chicago White Sox,WSOX,1,5,1,6,1913,1928,15,No,0,0.0,32.48,32.48,0,1734,1734,0,6165,6165,0.0,0.0,0.0,0.0,0.0,0.0
<a href=/player/eovan001>eovan001</a>,Nathan Eovaldi,Los Angeles Dodgers,DOGRS,1,2,2,4,2012,2014,2,No,0,2.73,9.76,7.03,137,350,213,121,1120,999,1127.0,40.0,-1087.0,0.0,0.0,0.0
<a href=/player/eovan001>eovan001</a>,Nathan Eovaldi,Miami Marlins,MARLNS,2,4,7,11,2014,2019,5,Yes,0,6.27,8.73,2.46,210,736,526,177,1879,1702,1889.0,737.0,-1152.0,7867000.0,0.0,-7867000.0
<a href=/player/eovan001>eovan001</a>,Nathan Eovaldi,Tampa Bay Devil Rays,RAYS,1,1,1,2,2018,2018,0,Yes,0,6.72,0.26,-6.46,80,13,-67,8,2,-6,1057.0,133.0,-924.0,2000000.0,0.0,-2000000.0
<a href=/player/eppea101>eppea101</a>,Al Epperly,Boston Braves,BRAVES,4,14,5,19,1949,1960,11,No,0,7.36,21.56,14.2,1117,1270,153,2487,5255,2768,2162.0,0.0,-2162.0,6600.0,0.0,-6600.0
<a href=/player/epstm101>epstm101</a>,Mike Epstein,Baltimore Orioles,ORLS,12,25,24,49,1967,1994,27,No,3,56.83,90.93,34.1,3175,4948,1773,6934,10778,3844,11841.0,16499.0,4658.0,888333.0,0.0,-888333.0
<a href=/player/epstm101>epstm101</a>,Mike Epstein,Washington Senators,RNGRS,15,28,30,58,1971,1992,21,No,2,67.34,36.18,-31.16,3624,2189,-1435,6695,5567,-1128,11858.0,4741.0,-7117.0,245000.0,0.0,-245000.0
<a href=/player/epstm101>epstm101</a>,Mike Epstein,Oakland Athletics,ATLTCS,3,5,3,8,1972,1976,4,No,0,2.06,2.63,0.57,1252,324,-928,3174,1015,-2159,720.0,264.0,-456.0,133800.0,0.0,-133800.0
<a href=/player/epstm101>epstm101</a>,Mike Epstein,Texas Rangers,RNGRS,7,19,12,31,1973,1988,15,No,0,43.57,39.21,-4.36,2413,2544,131,8647,8625,-22,2773.0,4668.0,1895.0,457000.0,0.0,-457000.0
<a href=/player/erarg101>erarg101</a>,Greg Erardi,Milwaukee Brewers,BREWRS,1,1,1,2,1973,1973,0,No,0,0.0,0.0,0.0,0,0,0,0,0,0,0.0,0.0,0.0,0.0,0.0,0.0
<a href=/player/eraue101>eraue101</a>,Eddie Erautt,Cincinnati Reds,REDS,2,2,3,5,1953,1960,7,No,0,0.4,11.83,11.43,116,584,468,24,388,364,287.0,3371.0,3084.0,0.0,0.0,0.0
<a href=/player/eraue101>eraue101</a>,Eddie Erautt,St. Louis Cardinals,CARDS,1,3,1,4,1954,1954,0,No,0,0.0,-0.06,-0.06,0,66,66,0,271,271,0.0,0.0,0.0,0.0,0.0,0.0
<a href=/player/erauj101>erauj101</a>,Joe Erautt,Chicago White Sox,WSOX,1,1,1,2,1951,1951,0,No,0,0.0,-0.88,-0.88,0,34,34,0,99,99,0.0,0.0,0.0,0.0,0.0,0.0
<a href=/player/erdot001>erdot001</a>,Todd Erdos,Arizona Diamondbacks,DBACKS,2,3,2,5,1998,2004,6,No,0,-0.53,1.16,1.69,349,725,376,906,2569,1663,102.0,0.0,-102.0,750000.0,0.0,-750000.0
<a href=/player/erice101>erice101</a>,Eric Erickson,Detroit Tigers,TIGRS,1,1,1,2,1919,1919,0,No,0,2.21,1.79,-0.42,242,48,-194,265,27,-238,2068.0,280.0,-1788.0,0.0,0.0,0.0
<a href=/player/erich101>erich101</a>,Hank Erickson,Louisville,Louisville,1,1,2,3,1934,1934,0,No,0,0.0,0.0,0.0,0,0,0,0,0,0,0.0,0.0,0.0,0.0,0.0,0.0
<a href=/player/erich102>erich102</a>,Hal Erickson,Cleveland Indians,INDINS,1,1,1,2,1952,1953,1,No,0,-0.15,0.0,0.15,36,0,-36,4,0,-4,97.0,0.0,-97.0,0.0,0.0,0.0
<a href=/player/ericr101>ericr101</a>,Roger Erickson,Minnesota Twins,TWINS,4,5,7,12,1982,1986,4,No,0,11.35,2.12,-9.23,555,275,-280,2031,106,-1925,297.0,1461.0,1164.0,620000.0,0.0,-620000.0
<a href=/player/ericr101>ericr101</a>,Roger Erickson,New York Yankees,YANKS,1,2,2,4,1983,1986,3,No,0,1.05,0.96,-0.09,566,53,-513,2201,0,-2201,0.0,233.0,233.0,180000.0,0.0,-180000.0
<a href=/player/erics001>erics001</a>,Scott Erickson,Minnesota Twins,TWINS,1,1,2,3,1995,1997,2,No,0,13.23,-1.6,-14.83,211,28,-183,27,0,-27,3863.0,231.0,-3632.0,1862500.0,0.0,-1862500.0
<a href=/player/erics001>erics001</a>,Scott Erickson,New York Mets,METS,1,1,1,2,2004,2004,0,No,0,0.2,0.0,-0.2,4,0,-4,0,0,0,57.0,0.0,-57.0,700000.0,0.0,-700000.0
<a href=/player/erlir001>erlir001</a>,Robbie Erlin,Texas Rangers,RNGRS,1,2,1,3,2011,2012,1,No,0,-0.83,1.99,2.82,224,92,-132,92,0,-92,1056.0,234.0,-822.0,0.0,0.0,0.0
<a href=/player/esasn001>esasn001</a>,Nick Esasky,Cincinnati Reds,REDS,2,3,4,7,1988,1991,3,No,0,5.15,-2.88,-8.03,374,383,9,948,1386,438,486.0,0.0,-486.0,1340000.0,0.0,-1340000.0
<a href=/player/escan101>escan101</a>,Nino Escalera,Cincinnati Reds,REDS,2,4,3,7,1958,1960,2,No,0,3.11,-0.2,-3.31,276,20,-256,63,2,-61,598.0,41.0,-557.0,0.0,0.0,0.0
<a href=/player/escas001>escas001</a>,Sergio Escalona,Philadelphia Phillies,PHILS,1,1,1,2,2011,2011,0,No,0,0.45,0.0,-0.45,95,0,-95,0,0,0,83.0,0.0,-83.0,0.0,0.0,0.0
<a href=/player/escoa001>escoa001</a>,Angel Escobar,San Francisco Giants,GIANTS,1,1,1,2,1988,1988,0,No,0,0.0,0.0,0.0,0,0,0,0,0,0,0.0,0.0,0.0,0.0,0.0,0.0
<a href=/player/escoa002>escoa002</a>,Alex Escobar,New York Mets,METS,3,9,8,17,2001,2008,7,No,0,12.43,-0.5,-12.93,1334,336,-998,2309,1012,-1297,1613.0,327.0,-1286.0,8000000.0,0.0,-8000000.0
<a href=/player/escoa002>escoa002</a>,Alex Escobar,Chicago White Sox,WSOX,1,1,1,2,2005,2009,4,No,0,0.37,0.79,0.42,33,129,96,99,430,331,0.0,0.0,0.0,0.0,0.0,0.0
<a href=/player/escoa003>escoa003</a>,Alcides Escobar,Milwaukee Brewers,BREWRS,8,16,16,32,2010,2020,10,Yes,0,33.31,23.99,-9.32,2772,1309,-1463,10420,3997,-6423,777.0,2948.0,2171.0,20405500.0,0.0,-20405500.0
<a href=/player/escoe001>escoe001</a>,Eduardo Escobar,Chicago White Sox,WSOX,1,2,1,3,2012,2012,0,No,0,5.04,0.22,-4.82,686,12,-674,2423,0,-2423,173.0,170.0,-3.0,480000.0,0.0,-480000.0
<a href=/player/escoe001>escoe001</a>,Eduardo Escobar,Minnesota Twins,TWINS,1,1,3,4,2018,2018,0,Yes,0,5.55,0.0,-5.55,364,0,-364,1544,0,-1544,0.0,0.0,0.0,4850000.0,0.0,-4850000.0
<a href=/player/escoe001>escoe001</a>,Eduardo Escobar,Arizona Diamondbacks,DBACKS,1,1,2,3,2021,2021,0,Yes,0,0.3,0.0,-0.3,48,0,-48,199,0,-199,0.0,0.0,0.0,7666667.0,0.0,-7666667.0
<a href=/player/escoe002>escoe002</a>,Edwin Escobar,San Francisco Giants,GIANTS,1,2,2,4,2014,2016,2,No,0,2.1,2.59,0.49,267,120,-147,1,96,95,779.0,924.0,145.0,0.0,0.0,0.0
<a href=/player/escoe002>escoe002</a>,Edwin Escobar,Texas Rangers,RNGRS,1,1,1,2,2010,2010,0,No,0,0.0,0.0,0.0,0,0,0,0,0,0,0.0,0.0,0.0,0.0,0.0,0.0
<a href=/player/escoj001>escoj001</a>,Jose Escobar,Toronto Blue Jays,BJAYS,2,4,2,6,1985,1985,0,No,0,1.41,-1.31,-2.72,202,123,-79,317,361,44,109.0,0.0,-109.0,185000.0,0.0,-185000.0
<a href=/player/escoy001>escoy001</a>,Yunel Escobar,Atlanta Braves,BRAVES,2,5,5,10,2010,2015,5,No,0,10.05,1.22,-8.83,679,438,-241,1672,1292,-380,1064.0,60.0,-1004.0,1260000.0,0.0,-1260000.0
<a href=/player/escoy001>escoy001</a>,Yunel Escobar,Toronto Blue Jays,BJAYS,3,15,11,26,2012,2018,6,No,0,24.75,21.38,-3.37,2099,1087,-1012,5739,3162,-2577,4668.0,4579.0,-89.0,8732900.0,0.0,-8732900.0
<a href=/player/escoy001>escoy001</a>,Yunel Escobar,Miami Marlins,MARLNS,1,1,1,2,2012,2018,6,No,0,3.12,4.17,1.05,290,608,318,1107,2132,1025,0.0,0.0,0.0,0.0,0.0,0.0
<a href=/player/escoy001>escoy001</a>,Yunel Escobar,Tampa Bay Devil Rays,RAYS,3,7,8,15,2015,2020,5,Yes,0,1.14,10.45,9.31,141,997,856,395,3417,3022,283.0,217.0,-66.0,508800.0,0.0,-508800.0
<a href=/player/escoy001>escoy001</a>,Yunel Escobar,Oakland Athletics,ATLTCS,3,4,3,7,2015,2018,3,No,0,2.32,0.73,-1.59,200,47,-153,592,0,-592,97.0,159.0,62.0,8300001.0,0.0,-8300001.0
<a href=/player/escoy001>escoy001</a>,Yunel Escobar,Washington Nationals,NATEX,1,2,2,4,2015,2019,4,No,0,1.55,-0.45,-2.0,221,66,-155,948,0,-948,0.0,84.0,84.0,5000000.0,0.0,-5000000.0
<a href=/player/eshet001>eshet001</a>,Tom Eshelman,Houston Astros,ASTROS,2,8,3,11,2015,2020,5,No,0,7.89,4.62,-3.27,397,276,-121,183,0,-183,2153.0,753.0,-1400.0,5115800.0,0.0,-5115800.0
<a href=/player/eshet001>eshet001</a>,Tom Eshelman,Philadelphia Phillies,PHILS,1,1,1,2,2019,2019,0,No,0,0.08,0.0,-0.08,34,0,-34,3,0,-3,295.0,0.0,-295.0,0.0,0.0,0.0
<a href=/player/espia001>espia001</a>,Alvaro Espinoza,Cleveland Indians,INDINS,5,12,10,22,1996,2001,5,No,0,73.82,8.63,-65.19,4077,457,-3620,13151,1605,-11546,1815.0,172.0,-1643.0,13083332.0,0.0,-13083332.0
<a href=/player/espid001>espid001</a>,Danny Espinosa,Washington Nationals,NATEX,2,2,4,6,2016,2021,5,Yes,0,0.18,-0.03,-0.21,109,104,-5,255,6,-249,93.0,215.0,122.0,2875000.0,0.0,-2875000.0
<a href=/player/espin101>espin101</a>,Nino Espinosa,New York Mets,METS,3,4,5,9,1979,1982,3,No,0,4.44,-0.21,-4.65,406,349,-57,1033,867,-166,1086.0,501.0,-585.0,200000.0,0.0,-200000.0
<a href=/player/espis001>espis001</a>,Santiago Espinal,Boston Red Sox,RSOX,1,1,2,3,2018,2019,1,No,0,2.77,0.48,-2.29,120,79,-41,312,264,-48,6.0,0.0,-6.0,0.0,0.0,0.0
<a href=/player/espyc001>espyc001</a>,Cecil Espy,Chicago White Sox,WSOX,1,2,1,3,1982,1986,4,No,0,0.16,7.02,6.86,20,523,503,12,1875,1863,0.0,0.0,0.0,0.0,0.0,0.0
<a href=/player/espyc001>espyc001</a>,Cecil Espy,Los Angeles Dodgers,DOGRS,1,3,1,4,1985,1987,2,No,0,13.58,2.02,-11.56,1414,166,-1248,4553,618,-3935,0.0,0.0,0.0,0.0,0.0,0.0
<a href=/player/essec101>essec101</a>,Chuck Essegian,Philadelphia Phillies,PHILS,3,3,3,6,1958,1967,9,No,0,-2.49,2.9,5.39,310,762,452,923,1927,1004,0.0,0.0,0.0,20000.0,0.0,-20000.0
<a href=/player/essec101>essec101</a>,Chuck Essegian,St. Louis Cardinals,CARDS,17,32,26,58,1959,1972,13,No,0,32.69,16.32,-16.37,3575,2596,-979,8857,7912,-945,2795.0,1167.0,-1628.0,42500.0,0.0,-42500.0
<a href=/player/essec101>essec101</a>,Chuck Essegian,Baltimore Orioles,ORLS,2,3,3,6,1961,1968,7,No,0,0.91,10.3,9.39,413,715,302,408,702,294,1330.0,1894.0,564.0,21750.0,0.0,-21750.0
<a href=/player/essec101>essec101</a>,Chuck Essegian,Cleveland Indians,INDINS,1,1,1,2,1963,1963,0,No,0,-1.47,-0.76,0.71,101,78,-23,254,21,-233,0.0,264.0,264.0,0.0,0.0,0.0
<a href=/player/essij001>essij001</a>,Jim Essian,Atlanta Braves,BRAVES,1,2,1,3,1975,1978,3,No,0,4.99,0.0,-4.99,219,0,-219,667,0,-667,0.0,0.0,0.0,0.0,0.0,0.0
<a href=/player/essij001>essij001</a>,Jim Essian,Philadelphia Phillies,PHILS,9,22,16,38,1975,1999,24,No,0,25.13,40.88,15.75,3277,4153,876,11430,11792,362,522.0,1259.0,737.0,2950000.0,0.0,-2950000.0
<a href=/player/essij001>essij001</a>,Jim Essian,Chicago White Sox,WSOX,1,2,1,3,1978,1979,1,No,0,6.89,-0.37,-7.26,401,28,-373,1175,0,-1175,453.0,189.0,-264.0,0.0,0.0,0.0
<a href=/player/essij001>essij001</a>,Jim Essian,Chicago White Sox,WSOX,6,11,9,20,1981,1994,13,No,0,14.41,9.4,-5.01,691,899,208,1049,2235,1186,4103.0,4503.0,400.0,1513333.0,0.0,-1513333.0
<a href=/player/essij001>essij001</a>,Jim Essian,Seattle Mariners,MARNRS,1,1,1,2,1983,1983,0,No,0,0.09,0.0,-0.09,48,0,-48,112,0,-112,0.0,0.0,0.0,0.0,0.0,0.0
<a href=/player/essij001>essij001</a>,Jim Essian,Cleveland Indians,INDINS,4,5,5,10,1983,1991,8,No,0,-1.49,1.08,2.57,295,262,-33,344,266,-78,443.0,1475.0,1032.0,250000.0,0.0,-250000.0
<a href=/player/estab001>estab001</a>,Bobby Estalella,Philadelphia Phillies,PHILS,2,2,2,4,1999,2001,2,No,0,2.6,1.2,-1.4,159,168,9,468,14,-454,132.0,378.0,246.0,910000.0,0.0,-910000.0
<a href=/player/estab001>estab001</a>,Bobby Estalella,San Francisco Giants,GIANTS,1,2,1,3,2001,2001,0,No,0,-0.01,-0.14,-0.13,3,54,51,6,3,-3,0.0,103.0,103.0,310000.0,0.0,-310000.0
<a href=/player/estab101>estab101</a>,Bobby Estalella,St.Louis Browns,ORLS,1,1,1,2,1941,1941,0,No,0,2.84,0.39,-2.45,133,9,-124,517,36,-481,0.0,0.0,0.0,3500.0,0.0,-3500.0
<a href=/player/estab101>estab101</a>,Bobby Estalella,Washington Senators,TWINS,1,3,1,4,1943,1943,0,No,0,7.97,3.2,-4.77,391,117,-274,1546,505,-1041,0.0,0.0,0.0,0.0,0.0,0.0
<a href=/player/estab101>estab101</a>,Bobby Estalella,Washington Senators,TWINS,2,7,2,9,1940,1943,3,No,0,7.97,0.58,-7.39,391,342,-49,1546,1354,-192,0.0,0.0,0.0,0.0,0.0,0.0
<a href=/player/estes001>estes001</a>,Shawn Estes,Seattle Mariners,MARNRS,1,2,1,3,1995,1997,2,No,0,9.08,-0.25,-9.33,394,28,-366,492,0,-492,2970.0,373.0,-2597.0,0.0,0.0,0.0
<a href=/player/estes001>estes001</a>,Shawn Estes,San Francisco Giants,GIANTS,2,3,3,6,2001,2002,1,No,0,1.82,5.08,3.26,158,272,114,416,1026,610,398.0,0.0,-398.0,4725000.0,0.0,-4725000.0
<a href=/player/estes001>estes001</a>,Shawn Estes,New York Mets,METS,1,2,4,6,2002,2003,1,No,0,-0.7,0.31,1.01,12,159,147,10,345,335,84.0,18.0,-66.0,6200000.0,0.0,-6200000.0
<a href=/player/estog101>estog101</a>,George Estock,Philadelphia Phillies,PHILS,1,2,1,3,1946,1946,0,No,0,0.0,-0.34,-0.34,0,6,6,0,20,20,0.0,0.0,0.0,0.0,0.0,0.0
<a href=/player/estrf101>estrf101</a>,Frank Estrada,New York Mets,METS,1,4,1,5,1971,1973,2,No,0,45.16,0.14,-45.02,957,146,-811,2120,526,-1594,6672.0,0.0,-6672.0,45950.0,0.0,-45950.0
<a href=/player/estrf101>estrf101</a>,Frank Estrada,California Angels,ANGELS,1,1,1,2,1972,1972,0,No,0,0.0,0.25,0.25,0,14,14,0,0,0,0.0,33.0,33.0,0.0,0.0,0.0
<a href=/player/estrf101>estrf101</a>,Frank Estrada,Baltimore Orioles,ORLS,11,22,20,42,1972,1994,22,No,3,48.77,86.1,37.33,2260,4602,2342,4427,11355,6928,10756.0,13691.0,2935.0,713333.0,0.0,-713333.0
<a href=/player/estrj001>estrj001</a>,Johnny Estrada,Philadelphia Phillies,PHILS,1,1,1,2,2002,2004,2,No,0,2.07,2.65,0.58,255,118,-137,939,132,-807,0.0,1089.0,1089.0,0.0,0.0,0.0
<a href=/player/estrj001>estrj001</a>,Johnny Estrada,Atlanta Braves,BRAVES,3,3,4,7,2005,2009,4,No,0,0.07,1.31,1.24,257,330,73,619,191,-428,113.0,864.0,751.0,1385000.0,0.0,-1385000.0
<a href=/player/estrj001>estrj001</a>,Johnny Estrada,Arizona Diamondbacks,DBACKS,7,17,19,36,2006,2018,12,Yes,0,24.81,35.93,11.12,1150,1382,232,1829,2226,397,7355.0,7967.0,612.0,18358000.0,0.0,-18358000.0
<a href=/player/estrj001>estrj001</a>,Johnny Estrada,Milwaukee Brewers,BREWRS,1,1,1,2,2007,2008,1,No,0,0.0,0.21,0.21,0,115,115,0,0,0,0.0,171.0,171.0,3400000.0,0.0,-3400000.0
<a href=/player/estrl001>estrl001</a>,Leo Estrella,New York Mets,METS,1,1,1,2,1998,1998,0,No,0,0.02,-0.32,-0.34,2,52,50,0,229,229,14.0,0.0,-14.0,0.0,0.0,0.0
<a href=/player/estrl001>estrl001</a>,Leo Estrella,Toronto Blue Jays,BJAYS,1,2,1,3,2000,2002,2,No,0,0.0,0.91,0.91,0,36,36,0,6,6,0.0,543.0,543.0,0.0,0.0,0.0
<a href=/player/estrl001>estrl001</a>,Leo Estrella,Milwaukee Brewers,BREWRS,1,2,2,4,2004,2010,6,No,0,-0.79,2.11,2.9,88,447,359,5,72,67,156.0,1275.0,1119.0,0.0,0.0,0.0
<a href=/player/estrm001>estrm001</a>,Marco Estrada,Milwaukee Brewers,BREWRS,2,2,4,6,2014,2015,1,Yes,0,9.8,3.6,-6.2,257,149,-108,446,572,126,2060.0,0.0,-2060.0,10825000.0,0.0,-10825000.0
<a href=/player/etchb101>etchb101</a>,Buck Etchison,Boston Braves,BRAVES,2,4,3,7,1944,1948,4,No,0,-0.05,3.33,3.38,48,389,341,105,1497,1392,0.0,0.0,0.0,0.0,0.0,0.0
<a href=/player/etheb101>etheb101</a>,Bobby Etheridge,San Francisco Giants,GIANTS,1,3,1,4,1969,1969,0,No,0,1.07,0.0,-1.07,369,0,-369,821,0,-821,333.0,0.0,-333.0,0.0,0.0,0.0
<a href=/player/etheb101>etheb101</a>,Bobby Etheridge,St. Louis Cardinals,CARDS,1,1,1,2,1971,1971,0,No,0,0.0,0.0,0.0,0,0,0,0,0,0,0.0,0.0,0.0,0.0,0.0,0.0
<a href=/player/ethes001>ethes001</a>,Seth Etherton,Anaheim Angels,ANGELS,2,2,2,4,2000,2003,3,No,0,-0.49,-0.61,-0.12,14,26,12,10,0,-10,90.0,218.0,128.0,200000.0,0.0,-200000.0
<a href=/player/ethia001>ethia001</a>,Andre Ethier,Oakland Athletics,ATLTCS,2,3,3,6,2005,2009,4,No,0,23.37,1.53,-21.84,1497,237,-1260,5594,589,-5005,0.0,230.0,230.0,4000000.0,0.0,-4000000.0
<a href=/player/etten101>etten101</a>,Nick Etten,Philadelphia Phillies,PHILS,1,1,3,4,1943,1955,12,No,0,11.41,0.0,-11.41,568,0,-568,2373,0,-2373,0.0,0.0,0.0,0.0,0.0,0.0
<a href=/player/evanb103>evanb103</a>,Bill Evans,Chicago White Sox,WSOX,1,1,2,3,1950,1950,0,No,0,0.07,0.0,-0.07,18,0,-18,4,0,-4,46.0,0.0,-46.0,0.0,0.0,0.0
<a href=/player/evanc101>evanc101</a>,Chick Evans,Hartford,Hartford,1,1,1,2,1909,1909,0,No,0,-1.01,0.0,1.01,34,0,-34,19,0,-19,156.0,0.0,-156.0,0.0,0.0,0.0
<a href=/player/evand001>evand001</a>,Darrell Evans,Atlanta Braves,BRAVES,5,7,13,20,1976,1983,7,No,0,20.68,4.17,-16.51,1646,914,-732,6239,1922,-4317,541.0,2701.0,2160.0,480000.0,0.0,-480000.0
<a href=/player/evanj101>evanj101</a>,Joe Evans,Cleveland Indians,INDINS,1,1,1,2,1923,1923,0,No,0,-0.16,3.1,3.26,106,126,20,421,479,58,0.0,0.0,0.0,0.0,0.0,0.0
<a href=/player/evanr101>evanr101</a>,Red Evans,Boston Red Sox,RSOX,1,2,3,5,1939,1947,8,No,0,0.0,1.66,1.66,0,64,64,0,50,50,0.0,452.0,452.0,0.0,0.0,0.0
<a href=/player/evanr101>evanr101</a>,Red Evans,Brooklyn Dodgers,DOGRS,1,3,1,4,1939,1958,19,No,0,0.0,68.5,68.5,0,2166,2166,0,9470,9470,0.0,0.0,0.0,3000.0,0.0,-3000.0
<a href=/player/evant002>evant002</a>,Terry Evans,St. Louis Cardinals,CARDS,1,1,2,3,2006,2006,0,No,0,0.02,-0.08,-0.1,20,32,12,21,35,14,0.0,250.0,250.0,0.0,0.0,0.0
<a href=/player/eveld001>eveld001</a>,Dana Eveland,Milwaukee Brewers,BREWRS,2,4,4,8,2006,2008,2,No,0,5.76,-0.61,-6.37,192,321,129,188,507,319,1641.0,616.0,-1025.0,6600000.0,0.0,-6600000.0
<a href=/player/eveld001>eveld001</a>,Dana Eveland,Arizona Diamondbacks,DBACKS,6,14,16,30,2007,2018,11,Yes,0,24.99,30.17,5.18,855,1190,335,1319,2038,719,6760.0,6326.0,-434.0,14741000.0,0.0,-14741000.0
<a href=/player/eveld001>eveld001</a>,Dana Eveland,Toronto Blue Jays,BJAYS,1,1,1,2,2010,2010,0,No,0,-0.24,0.0,0.24,4,0,-4,1,0,-1,29.0,0.0,-29.0,419500.0,0.0,-419500.0
<a href=/player/eveld001>eveld001</a>,Dana Eveland,Los Angeles Dodgers,DOGRS,1,1,2,3,2011,2011,0,No,0,0.14,0.0,-0.14,16,0,-16,0,0,0,97.0,0.0,-97.0,0.0,0.0,0.0
<a href=/player/evera001>evera001</a>,Adam Everett,Boston Red Sox,RSOX,2,3,2,5,1999,2002,3,No,0,14.08,6.19,-7.89,828,255,-573,3105,1011,-2094,0.0,174.0,174.0,7333333.0,0.0,-7333333.0
<a href=/player/everb001>everb001</a>,Bryan Eversgerd,St. Louis Cardinals,CARDS,2,4,4,8,1995,1998,3,No,0,0.65,-1.89,-2.54,140,207,67,86,512,426,308.0,331.0,23.0,4525000.0,0.0,-4525000.0
<a href=/player/everb001>everb001</a>,Bryan Eversgerd,Montreal Expos,NATEX,1,2,3,5,1996,1999,3,No,0,2.1,0.16,-1.94,199,370,171,822,693,-129,0.0,483.0,483.0,0.0,0.0,0.0
<a href=/player/everb001>everb001</a>,Bryan Eversgerd,Boston Red Sox,RSOX,1,1,1,2,1996,1997,1,No,0,-0.38,0.72,1.1,4,40,36,0,115,115,4.0,0.0,-4.0,0.0,0.0,0.0
<a href=/player/everb101>everb101</a>,Bill Everitt,Chicago Cubs,CUBS,2,6,2,8,1900,1902,2,No,0,10.49,0.81,-9.68,648,153,-495,2353,607,-1746,0.0,0.0,0.0,0.0,0.0,0.0
<a href=/player/everc001>everc001</a>,Carl Everett,Florida Marlins,MARLNS,6,11,11,22,1994,2012,18,No,2,16.62,28.92,12.3,1306,1618,312,3448,4973,1525,3020.0,2057.0,-963.0,6848000.0,0.0,-6848000.0
<a href=/player/everc001>everc001</a>,Carl Everett,New York Mets,METS,2,2,2,4,1997,1998,1,No,0,9.61,-0.25,-9.86,320,126,-194,1058,184,-874,114.0,81.0,-33.0,704000.0,0.0,-704000.0
<a href=/player/everc001>everc001</a>,Carl Everett,Houston Astros,ASTROS,1,1,2,3,1999,2007,8,No,0,5.72,12.38,6.66,239,649,410,1010,2374,1364,0.0,0.0,0.0,2500000.0,0.0,-2500000.0
<a href=/player/everc001>everc001</a>,Carl Everett,Boston Red Sox,RSOX,1,1,1,2,2001,2002,1,No,0,1.7,0.47,-1.23,179,16,-163,731,1,-730,0.0,174.0,174.0,7333333.0,0.0,-7333333.0
<a href=/player/everc001>everc001</a>,Carl Everett,Texas Rangers,RNGRS,2,2,4,6,2003,2012,9,No,0,3.3,12.83,9.53,309,596,287,1005,849,-156,152.0,1248.0,1096.0,9150000.0,0.0,-9150000.0
<a href=/player/everc001>everc001</a>,Carl Everett,Montreal Expos,NATEX,6,12,11,23,2004,2013,9,Yes,0,5.06,12.16,7.1,1610,2141,531,3085,4119,1034,1054.0,2237.0,1183.0,10653000.0,0.0,-10653000.0
<a href=/player/everh101>everh101</a>,Hoot Evers,Detroit Tigers,TIGRS,18,41,43,84,1952,1964,12,No,0,49.33,53.4,4.07,4601,4657,56,11266,12496,1230,8483.0,9258.0,775.0,157700.0,0.0,-157700.0
<a href=/player/everh101>everh101</a>,Hoot Evers,Baltimore Orioles,ORLS,1,1,1,2,1955,1957,2,No,0,-0.08,4.69,4.77,42,162,120,71,146,75,0.0,1239.0,1239.0,0.0,0.0,0.0
<a href=/player/everh101>everh101</a>,Hoot Evers,Cleveland Indians,INDINS,2,3,2,5,1956,1960,4,No,0,0.41,0.01,-0.4,48,37,-11,138,74,-64,0.0,27.0,27.0,0.0,0.0,0.0
<a href=/player/everj102>everj102</a>,Johnny Evers,Chicago Cubs,CUBS,1,1,2,3,1914,1915,1,No,0,7.06,1.39,-5.67,318,134,-184,1353,540,-813,0.0,0.0,0.0,0.0,0.0,0.0
<a href=/player/everl101>everl101</a>,Leon Everitt,Los Angeles Dodgers,DOGRS,1,2,1,3,1969,1970,1,No,0,-3.36,0.06,3.42,214,64,-150,569,4,-565,47.0,148.0,101.0,0.0,0.0,0.0
<a href=/player/ewinb101>ewinb101</a>,Buck Ewing,New York Giants,GIANTS,1,1,1,2,1893,1902,9,No,0,3.16,44.67,41.51,169,1096,927,778,4791,4013,0.0,0.0,0.0,0.0,0.0,0.0
<a href=/player/ewinb102>ewinb102</a>,Bob Ewing,Cincinnati Reds,REDS,4,11,9,20,1910,1914,4,No,0,53.01,6.59,-46.42,3186,799,-2387,12273,2663,-9610,3029.0,990.0,-2039.0,0.0,0.0,0.0
<a href=/player/eyres001>eyres001</a>,Scott Eyre,Texas Rangers,RNGRS,1,1,1,2,1994,1995,1,No,0,-0.39,-0.52,-0.13,82,102,20,5,252,247,635.0,0.0,-635.0,0.0,0.0,0.0
<a href=/player/eyres001>eyres001</a>,Scott Eyre,Chicago White Sox,WSOX,2,4,3,7,2000,2004,4,No,0,0.83,1.08,0.25,92,158,66,0,3,3,327.0,1239.0,912.0,580000.0,0.0,-580000.0
<a href=/player/eyres001>eyres001</a>,Scott Eyre,Chicago Cubs,CUBS,1,1,1,2,2008,2011,3,No,0,1.69,-0.64,-2.33,121,14,-107,0,0,0,133.0,24.0,-109.0,3800000.0,0.0,-3800000.0
<a href=/player/ezzeh101>ezzeh101</a>,Homer Ezzell,St.Louis Browns,ORLS,2,5,2,7,1924,1928,4,No,0,0.51,-0.58,-1.09,148,221,73,508,688,180,0.0,0.0,0.0,0.0,0.0,0.0
<a href=/player/ezzeh101>ezzeh101</a>,Homer Ezzell,Boston Red Sox,RSOX,1,2,1,3,1925,1927,2,No,0,0.0,1.87,1.87,0,185,185,0,714,714,0.0,0.0,0.0,7200.0,0.0,-7200.0
<a href=/player/ezzeh101>ezzeh101</a>,Homer Ezzell,Detroit Tigers,TIGRS,3,7,6,13,1925,1934,9,No,0,25.64,16.48,-9.16,1182,968,-214,3618,3598,-20,3712.0,0.0,-3712.0,12500.0,0.0,-12500.0
<a href=/player/fabrj001>fabrj001</a>,Jorge Fabregas,Anaheim Angels,ANGELS,1,2,2,4,1997,1998,1,No,0,1.16,1.24,0.08,151,175,24,342,727,385,178.0,0.0,-178.0,1092000.0,0.0,-1092000.0
<a href=/player/fabrj001>fabrj001</a>,Jorge Fabregas,Arizona Diamondbacks,DBACKS,10,23,21,44,1998,2012,14,No,3,42.86,25.86,-17.0,3128,1205,-1923,7041,1494,-5547,9612.0,4323.0,-5289.0,28375667.0,0.0,-28375667.0
<a href=/player/fabrj001>fabrj001</a>,Jorge Fabregas,New York Mets,METS,1,1,1,2,1998,1999,1,No,0,0.41,0.0,-0.41,82,0,-82,260,0,-260,0.0,0.0,0.0,0.0,0.0,0.0
<a href=/player/fabrj001>fabrj001</a>,Jorge Fabregas,Anaheim Angels,ANGELS,1,3,2,5,2002,2002,0,No,0,-0.5,0.27,0.77,52,39,-13,74,76,2,47.0,0.0,-47.0,500000.0,0.0,-500000.0
<a href=/player/faett101>faett101</a>,Tony Faeth,Cleveland Indians,INDINS,1,3,1,4,1920,1922,2,No,0,0.0,4.21,4.21,0,138,138,0,140,140,0.0,1087.0,1087.0,0.0,0.0,0.0
<a href=/player/faheb101>faheb101</a>,Bill Fahey,Texas Rangers,RNGRS,3,8,8,16,1978,1985,7,No,1,13.84,11.07,-2.77,1150,730,-420,2985,2621,-364,918.0,0.0,-918.0,475000.0,0.0,-475000.0
<a href=/player/fainf101>fainf101</a>,Ferris Fain,Philadelphia Athletics,ATLTCS,51,119,130,249,1953,1976,23,No,0,220.72,117.73,-102.99,17901,16276,-1625,45475,48056,2581,21193.0,17462.0,-3731.0,561100.0,0.0,-561100.0
<a href=/player/fainf101>fainf101</a>,Ferris Fain,Chicago White Sox,WSOX,3,8,6,14,1954,1961,7,No,0,23.22,8.09,-15.13,1221,1065,-156,3572,3021,-551,2246.0,488.0,-1758.0,62000.0,0.0,-62000.0
<a href=/player/fairj102>fairj102</a>,Jim Fairey,Los Angeles Dodgers,DOGRS,1,2,2,4,1973,1973,0,No,0,0.0,0.0,0.0,0,0,0,0,0,0,0.0,0.0,0.0,0.0,0.0,0.0
<a href=/player/fairp001>fairp001</a>,Peter Fairbanks,Texas Rangers,RNGRS,1,1,1,2,2019,2019,0,Yes,0,0.13,0.71,0.58,94,33,-61,0,135,135,245.0,0.0,-245.0,0.0,0.0,0.0
<a href=/player/fairr101>fairr101</a>,Ron Fairly,Los Angeles Dodgers,DOGRS,1,2,2,4,1969,1979,10,No,0,17.55,18.66,1.11,718,1264,546,2642,4042,1400,0.0,0.0,0.0,0.0,0.0,0.0
<a href=/player/fairr101>fairr101</a>,Ron Fairly,Montreal Expos,NATEX,2,2,3,5,1974,1978,4,No,0,1.8,0.0,-1.8,180,0,-180,415,0,-415,0.0,0.0,0.0,0.0,0.0,0.0
<a href=/player/fairr101>fairr101</a>,Ron Fairly,Oakland Athletics,ATLTCS,1,1,2,3,1977,1977,0,No,0,2.36,0.0,-2.36,132,0,-132,528,0,-528,0.0,0.0,0.0,0.0,0.0,0.0
<a href=/player/fairr101>fairr101</a>,Ron Fairly,Toronto Blue Jays,BJAYS,1,1,2,3,1977,1977,0,No,0,-0.31,0.0,0.31,91,0,-91,268,0,-268,0.0,0.0,0.0,0.0,0.0,0.0
<a href=/player/fairs001>fairs001</a>,Stuart Fairchild,Cincinnati Reds,REDS,1,2,2,4,2020,2020,0,No,0,0.09,0.33,0.24,136,6,-130,368,0,-368,0.0,23.0,23.0,0.0,0.0,0.0
<a href=/player/fajah001>fajah001</a>,Hector Fajardo,Pittsburgh Pirates,PIRATS,2,3,2,5,1991,1992,1,No,0,2.39,2.58,0.19,362,141,-221,1290,483,-807,354.0,265.0,-89.0,2600000.0,0.0,-2600000.0
<a href=/player/fajah001>fajah001</a>,Hector Fajardo,Texas Rangers,RNGRS,1,1,1,2,1995,1996,1,No,0,0.0,-0.09,-0.09,0,79,79,0,171,171,0.0,0.0,0.0,0.0,0.0,0.0
<a href=/player/falcp001>falcp001</a>,Pete Falcone,San Francisco Giants,GIANTS,4,4,4,8,1975,1980,5,No,0,8.84,-2.74,-11.58,1201,362,-839,3011,889,-2122,2820.0,416.0,-2404.0,0.0,0.0,0.0
<a href=/player/falcp001>falcp001</a>,Pete Falcone,St. Louis Cardinals,CARDS,13,30,25,55,1978,1998,20,No,5,88.69,122.16,33.47,7023,5057,-1966,21036,17168,-3868,8355.0,3102.0,-5253.0,1533333.0,0.0,-1533333.0
<a href=/player/falkb101>falkb101</a>,Bibb Falk,Chicago White Sox,WSOX,1,1,1,2,1929,1929,0,No,0,4.02,-0.57,-4.59,286,43,-243,886,100,-786,0.0,0.0,0.0,0.0,0.0,0.0
<a href=/player/falkc101>falkc101</a>,Cy Falkenberg,Indianapolis,Indianapolis,1,1,2,3,1917,1917,0,No,0,-1.12,0.0,1.12,30,0,-30,29,0,-29,242.0,0.0,-242.0,0.0,0.0,0.0
<a href=/player/falts001>falts001</a>,Steve Falteisek,Cleveland Indians,INDINS,1,1,1,2,2000,2003,3,No,0,0.0,0.0,0.0,0,0,0,0,0,0,0.0,0.0,0.0,0.0,0.0,0.0
<a href=/player/famij001>famij001</a>,Jeurys Familia,New York Mets,METS,4,6,6,12,2018,2021,3,No,0,0.27,-1.18,-1.45,70,57,-13,112,54,-58,101.0,38.0,-63.0,8496765.0,0.0,-8496765.0
<a href=/player/fanof101>fanof101</a>,Frank Fanovich,Philadelphia Athletics,ATLTCS,1,2,1,3,1953,1954,1,No,0,1.98,0.0,-1.98,78,0,-78,84,0,-84,699.0,0.0,-699.0,7500.0,0.0,-7500.0
<a href=/player/fanzc101>fanzc101</a>,Carmen Fanzone,Boston Red Sox,RSOX,2,3,2,5,1970,1973,3,No,0,-0.16,0.69,0.85,416,99,-317,970,175,-795,0.0,0.0,0.0,0.0,0.0,0.0
<a href=/player/farij001>farij001</a>,Jacob Faria,Tampa Bay Devil Rays,RAYS,1,1,1,2,2019,2019,0,No,0,-0.56,0.24,0.8,18,37,19,0,107,107,26.0,0.0,-26.0,0.0,0.0,0.0
<a href=/player/farip001>farip001</a>,Paul Faries,San Diego Padres,PADRS,1,1,1,2,1992,1992,0,No,0,-0.11,0.0,0.11,15,0,-15,39,0,-39,0.0,0.0,0.0,122500.0,0.0,-122500.0
<a href=/player/farlb101>farlb101</a>,Bob Farley,San Francisco Giants,GIANTS,1,4,2,6,1961,1964,3,No,0,7.93,4.13,-3.8,685,341,-344,242,140,-102,2569.0,1260.0,-1309.0,0.0,0.0,0.0
<a href=/player/farlb101>farlb101</a>,Bob Farley,Chicago White Sox,WSOX,1,1,1,2,1962,1964,2,No,0,-0.53,1.73,2.26,36,142,106,65,409,344,0.0,0.0,0.0,0.0,0.0,0.0
<a href=/player/farme101>farme101</a>,Ed Farmer,Cleveland Indians,INDINS,1,1,2,3,1973,1973,0,No,0,0.01,0.34,0.33,24,29,5,0,0,0,135.0,373.0,238.0,0.0,0.0,0.0
<a href=/player/farme101>farme101</a>,Ed Farmer,Detroit Tigers,TIGRS,1,2,1,3,1974,1975,1,No,0,0.0,-0.06,-0.06,0,74,74,0,215,215,0.0,0.0,0.0,0.0,0.0,0.0
<a href=/player/farme101>farme101</a>,Ed Farmer,Philadelphia Phillies,PHILS,1,1,1,2,1974,1974,0,No,0,0.64,0.0,-0.64,3,0,-3,0,0,0,33.0,0.0,-33.0,22500.0,0.0,-22500.0
<a href=/player/farme101>farme101</a>,Ed Farmer,Milwaukee Brewers,BREWRS,1,3,1,4,1978,1982,4,No,0,-0.15,-1.81,-1.66,16,109,93,7,0,-7,99.0,822.0,723.0,0.0,0.0,0.0
<a href=/player/farme101>farme101</a>,Ed Farmer,Texas Rangers,RNGRS,2,3,4,7,1979,1979,0,No,0,4.47,0.48,-3.99,245,63,-182,304,166,-138,701.0,0.0,-701.0,35000.0,0.0,-35000.0
<a href=/player/farmj101>farmj101</a>,Jack Farmer,Louisville,Louisville,1,1,1,2,1916,1916,0,No,0,0.16,0.0,-0.16,55,0,-55,181,0,-181,0.0,0.0,0.0,0.0,0.0,0.0
<a href=/player/farmk001>farmk001</a>,Kyle Farmer,Los Angeles Dodgers,DOGRS,3,12,8,20,2018,2021,3,Yes,0,5.8,8.33,2.53,663,133,-530,2223,501,-1722,299.0,229.0,-70.0,36964000.0,0.0,-36964000.0
<a href=/player/farnk001>farnk001</a>,Kyle Farnsworth,Chicago Cubs,CUBS,2,3,4,7,2005,2007,2,No,0,-0.78,-0.48,0.3,158,253,95,155,60,-95,276.0,414.0,138.0,0.0,0.0,0.0
<a href=/player/farnk001>farnk001</a>,Kyle Farnsworth,Detroit Tigers,TIGRS,2,2,3,5,2005,2010,5,No,0,1.05,3.3,2.25,154,202,48,1,7,6,323.0,1262.0,939.0,1975000.0,0.0,-1975000.0
<a href=/player/farnk001>farnk001</a>,Kyle Farnsworth,New York Yankees,YANKS,1,1,1,2,2008,2008,0,No,0,-0.51,-0.8,-0.29,16,33,17,0,101,101,48.0,0.0,-48.0,5916666.0,0.0,-5916666.0
<a href=/player/farnk001>farnk001</a>,Kyle Farnsworth,Kansas City Royals,ROYALS,1,2,3,5,2010,2016,6,No,0,-0.01,2.01,2.02,93,319,226,139,204,65,60.0,734.0,674.0,7250000.0,0.0,-7250000.0
<a href=/player/farqd001>farqd001</a>,Danny Farquhar,Toronto Blue Jays,BJAYS,1,2,1,3,2010,2013,3,No,0,-0.15,1.6,1.75,9,345,336,0,1185,1185,44.0,0.0,-44.0,0.0,0.0,0.0
<a href=/player/farqd001>farqd001</a>,Danny Farquhar,Oakland Athletics,ATLTCS,2,2,2,4,2011,2013,2,No,0,-0.54,1.44,1.98,24,104,80,0,361,361,62.0,38.0,-24.0,0.0,0.0,0.0
<a href=/player/farqd001>farqd001</a>,Danny Farquhar,New York Yankees,YANKS,1,2,1,3,2012,2014,2,No,0,0.38,3.31,2.93,163,360,197,0,1180,1180,533.0,0.0,-533.0,0.0,0.0,0.0
<a href=/player/farqd001>farqd001</a>,Danny Farquhar,Seattle Mariners,MARNRS,4,7,6,13,2015,2017,2,Yes,0,9.3,3.09,-6.21,1092,200,-892,3957,584,-3373,347.0,283.0,-64.0,10679600.0,0.0,-10679600.0
<a href=/player/farrd101>farrd101</a>,Doc Farrell,New York Giants,GIANTS,2,4,4,8,1927,1930,3,No,0,-1.4,7.13,8.53,721,460,-261,1415,1177,-238,3501.0,2253.0,-1248.0,8500.0,0.0,-8500.0
<a href=/player/farrd101>farrd101</a>,Doc Farrell,Boston Braves,BRAVES,6,10,8,18,1929,1938,9,No,0,9.08,21.19,12.11,804,2028,1224,2499,7932,5433,1075.0,89.0,-986.0,23000.0,0.0,-23000.0
<a href=/player/farrd101>farrd101</a>,Doc Farrell,New York Giants,GIANTS,1,2,1,3,1930,1930,0,No,0,1.35,-0.6,-1.95,115,121,6,352,457,105,0.0,0.0,0.0,0.0,0.0,0.0
<a href=/player/farrd101>farrd101</a>,Doc Farrell,New York Yankees,YANKS,1,5,1,6,1934,1934,0,No,0,0.0,0.0,0.0,0,0,0,0,0,0,0.0,0.0,0.0,2000.0,0.0,-2000.0
<a href=/player/farrd102>farrd102</a>,Duke Farrell,Pittsburgh Pirates,PIRATS,1,2,1,3,1893,1898,5,No,0,8.69,24.59,15.9,343,431,88,1384,752,-632,0.0,4984.0,4984.0,0.0,0.0,0.0
<a href=/player/farrd102>farrd102</a>,Duke Farrell,Washington Senators,WSN,1,2,3,5,1894,1894,0,No,0,30.33,-0.6,-30.93,706,32,-674,1804,50,-1754,5250.0,309.0,-4941.0,0.0,0.0,0.0
<a href=/player/farrd102>farrd102</a>,Duke Farrell,New York Giants,GIANTS,1,3,1,4,1896,1896,0,No,0,5.07,2.79,-2.28,227,49,-178,829,211,-618,60.0,0.0,-60.0,0.0,0.0,0.0
<a href=/player/farrd102>farrd102</a>,Duke Farrell,Washington Senators,WSN,1,2,4,6,1899,1905,6,No,0,9.84,0.67,-9.17,735,113,-622,2984,291,-2693,0.0,635.0,635.0,0.0,0.0,0.0
<a href=/player/farrj001>farrj001</a>,John Farrell,Cleveland Indians,INDINS,1,1,1,2,1996,1996,0,No,0,-0.37,0.0,0.37,2,0,-2,0,0,0,19.0,0.0,-19.0,0.0,0.0,0.0
<a href=/player/farrj001>farrj001</a>,John Farrell,Toronto Blue Jays,BJAYS,2,4,2,6,2012,2014,2,No,0,11.57,-0.01,-11.58,944,66,-878,3396,7,-3389,0.0,475.0,475.0,0.0,0.0,0.0
<a href=/player/farrs001>farrs001</a>,Steve Farr,Pittsburgh Pirates,PIRATS,1,1,1,2,1983,1983,0,No,0,0.94,0.0,-0.94,50,0,-50,0,0,0,394.0,0.0,-394.0,0.0,0.0,0.0
<a href=/player/farrs001>farrs001</a>,Steve Farr,Cleveland Indians,INDINS,1,2,1,3,1994,1994,0,No,0,-0.23,-0.01,0.22,19,13,-6,0,0,0,165.0,38.0,-127.0,1850000.0,0.0,-1850000.0
<a href=/player/farrt101>farrt101</a>,Turk Farrell,Philadelphia Phillies,PHILS,7,14,15,29,1961,1979,18,No,0,36.73,77.38,40.65,2596,3152,556,7221,9470,2249,6229.0,10159.0,3930.0,74500.0,0.0,-74500.0
<a href=/player/fasas001>fasas001</a>,Sal Fasano,Kansas City Royals,ROYALS,1,2,1,3,2001,2003,2,No,0,-0.28,-0.5,-0.22,31,265,234,74,964,890,19.0,0.0,-19.0,320000.0,0.0,-320000.0
<a href=/player/fasas001>fasas001</a>,Sal Fasano,Milwaukee Brewers,BREWRS,1,2,3,5,2002,2004,2,No,0,0.27,-0.5,-0.77,39,52,13,76,74,-2,0.0,47.0,47.0,2750000.0,0.0,-2750000.0
<a href=/player/fasas001>fasas001</a>,Sal Fasano,Philadelphia Phillies,PHILS,1,1,1,2,2006,2006,0,No,0,-0.27,0.0,0.27,28,0,-28,57,0,-57,0.0,0.0,0.0,425000.0,0.0,-425000.0
<a href=/player/fassj001>fassj001</a>,Jeff Fassero,Montreal Expos,NATEX,4,7,8,15,1996,2015,19,No,2,7.51,27.66,20.15,330,1142,812,781,3109,2328,1820.0,3591.0,1771.0,7545000.0,0.0,-7545000.0
<a href=/player/fassj001>fassj001</a>,Jeff Fassero,Seattle Mariners,MARNRS,1,1,1,2,1999,1999,0,No,0,0.0,0.0,0.0,7,0,-7,0,0,0,52.0,0.0,-52.0,5016667.0,0.0,-5016667.0
<a href=/player/fassj001>fassj001</a>,Jeff Fassero,Chicago Cubs,CUBS,1,1,2,3,2002,2003,1,No,0,-0.52,0.0,0.52,153,0,-153,10,0,-10,287.0,0.0,-287.0,2800000.0,0.0,-2800000.0
<a href=/player/faula001>faula001</a>,Andrew Faulkner,Texas Rangers,RNGRS,1,1,1,2,2017,2017,0,No,0,0.0,0.0,0.0,0,0,0,0,0,0,0.0,0.0,0.0,0.0,0.0,0.0
<a href=/player/fausb101>fausb101</a>,Buck Fausett,Galveston,Galveston,1,2,1,3,1934,1934,0,No,0,0.0,0.0,0.0,0,0,0,0,0,0,0.0,0.0,0.0,0.0,0.0,0.0
<a href=/player/fazie101>fazie101</a>,Ernie Fazio,Houston Astros,ASTROS,3,4,3,7,1965,1969,4,No,0,-0.71,1.07,1.78,88,138,50,90,443,353,49.0,55.0,6.0,0.0,0.0,0.0
<a href=/player/featt001>featt001</a>,Taylor Featherston,Anaheim Angels,ANGELS,1,1,1,2,2016,2016,0,No,0,-0.27,0.0,0.27,19,0,-19,28,0,-28,0.0,0.0,0.0,0.0,0.0,0.0
<a href=/player/fedet001>fedet001</a>,Tim Federowicz,Boston Red Sox,RSOX,1,4,2,6,2011,2012,1,No,0,0.34,0.23,-0.11,124,8,-116,300,0,-300,273.0,114.0,-159.0,0.0,0.0,0.0
<a href=/player/fedet001>fedet001</a>,Tim Federowicz,Los Angeles Dodgers,DOGRS,4,10,8,18,2014,2021,7,Yes,0,6.08,11.37,5.29,476,899,423,1306,2454,1148,1807.0,359.0,-1448.0,21000000.0,0.0,-21000000.0
<a href=/player/fedet001>fedet001</a>,Tim Federowicz,Cleveland Indians,INDINS,1,1,1,2,2019,2019,0,No,0,-0.46,0.0,0.46,30,0,-30,83,0,-83,3.0,0.0,-3.0,0.0,0.0,0.0
<a href=/player/feldm001>feldm001</a>,Mike Felder,Seattle Mariners,MARNRS,1,2,1,3,1993,1994,1,No,0,17.17,-0.83,-18.0,486,79,-407,529,288,-241,3414.0,0.0,-3414.0,959000.0,0.0,-959000.0
<a href=/player/felds001>felds001</a>,Scott Feldman,Chicago Cubs,CUBS,1,2,3,5,2013,2019,6,No,0,0.8,28.4,27.6,86,1050,964,220,287,67,272.0,3528.0,3256.0,0.0,0.0,0.0
<a href=/player/felds001>felds001</a>,Scott Feldman,Houston Astros,ASTROS,1,1,1,2,2016,2016,0,Yes,0,-0.56,0.0,0.56,14,0,-14,0,0,0,45.0,0.0,-45.0,0.0,0.0,0.0
<a href=/player/felig101>felig101</a>,Gus Felix,Boston Braves,BRAVES,8,16,14,30,1925,1938,13,No,0,15.59,19.03,3.44,1577,2611,1034,4396,9724,5328,4040.0,1364.0,-2676.0,46800.0,0.0,-46800.0
<a href=/player/felig101>felig101</a>,Gus Felix,Brooklyn Dodgers,DOGRS,1,2,1,3,1927,1927,0,No,0,0.0,0.0,0.0,0,0,0,0,0,0,0.0,0.0,0.0,12000.0,0.0,-12000.0
<a href=/player/felij001>felij001</a>,Junior Felix,Toronto Blue Jays,BJAYS,4,7,8,15,1990,2002,12,No,2,4.59,23.06,18.47,622,749,127,2444,2988,544,0.0,935.0,935.0,255000.0,0.0,-255000.0
<a href=/player/felim001>felim001</a>,Michael Feliz,Houston Astros,ASTROS,1,4,1,5,2018,2019,1,No,0,3.26,12.09,8.83,813,71,-742,1676,16,-1660,1316.0,1238.0,-78.0,0.0,0.0,0.0
<a href=/player/felin001>felin001</a>,Neftali Feliz,Atlanta Braves,BRAVES,4,8,6,14,2007,2009,2,No,1,51.72,9.48,-42.24,2314,404,-1910,8153,1445,-6708,2789.0,84.0,-2705.0,15385000.0,0.0,-15385000.0
<a href=/player/felip001>felip001</a>,Pedro Feliz,Houston Astros,ASTROS,5,12,11,23,2010,2019,9,No,0,16.82,11.27,-5.55,1278,372,-906,2484,343,-2141,4222.0,1988.0,-2234.0,12835000.0,0.0,-12835000.0
<a href=/player/felip002>felip002</a>,Pedro Feliciano,Cincinnati Reds,REDS,1,4,2,6,2002,2002,0,No,0,6.19,-0.7,-6.89,1101,12,-1089,365,10,-355,1151.0,84.0,-1067.0,233000.0,0.0,-233000.0
<a href=/player/felsh101>felsh101</a>,Happy Felsch,Milwaukee,Milwaukee,1,1,2,3,1914,1915,1,No,0,19.42,0.0,-19.42,749,0,-749,3134,0,-3134,0.0,0.0,0.0,0.0,0.0,0.0
<a href=/player/fenwb101>fenwb101</a>,Bobby Fenwick,Houston Astros,ASTROS,2,3,4,7,1972,1977,5,No,0,-0.92,-3.42,-2.5,71,191,120,200,517,317,0.0,0.0,0.0,0.0,0.0,0.0
<a href=/player/fenwb101>fenwb101</a>,Bobby Fenwick,Chicago Cubs,CUBS,13,24,24,48,1973,1990,17,No,0,18.74,18.43,-0.31,3099,2396,-703,8125,5700,-2425,1137.0,4804.0,3667.0,1020000.0,0.0,-1020000.0
<a href=/player/ferga101>ferga101</a>,Alex Ferguson,Boston Red Sox,RSOX,1,2,2,4,1925,1925,0,No,0,-1.49,-0.59,0.9,98,12,-86,146,10,-136,166.0,84.0,-82.0,14000.0,0.0,-14000.0
<a href=/player/fergg101>fergg101</a>,Cecil Ferguson,Louisville,Louisville,1,1,1,2,1905,1906,1,No,0,0.11,0.0,-0.11,74,0,-74,37,0,-37,353.0,0.0,-353.0,0.0,0.0,0.0
<a href=/player/fergg101>fergg101</a>,Cecil Ferguson,New York Giants,GIANTS,4,11,6,17,1907,1921,14,No,0,45.64,34.38,-11.26,2445,1600,-845,8369,5323,-3046,1733.0,2915.0,1182.0,6400.0,0.0,-6400.0
<a href=/player/fergg101>fergg101</a>,Cecil Ferguson,Boston Braves,BRAVES,1,1,1,2,1911,1911,0,No,0,0.0,0.74,0.74,0,39,39,0,168,168,0.0,0.0,0.0,0.0,0.0,0.0
<a href=/player/fergj101>fergj101</a>,Joe Ferguson,Los Angeles Dodgers,DOGRS,1,3,1,4,1976,1981,5,No,0,0.46,19.38,18.92,71,542,471,226,2055,1829,0.0,0.0,0.0,0.0,0.0,0.0
<a href=/player/fergj101>fergj101</a>,Joe Ferguson,St. Louis Cardinals,CARDS,1,2,2,4,1976,1978,2,No,0,6.18,-0.3,-6.48,183,31,-152,702,19,-683,0.0,118.0,118.0,0.0,0.0,0.0
<a href=/player/fergj101>fergj101</a>,Joe Ferguson,Houston Astros,ASTROS,3,5,4,9,1978,1985,7,No,0,14.88,3.62,-11.26,1417,819,-598,4695,2223,-2472,0.0,0.0,0.0,0.0,0.0,0.0
<a href=/player/fermf001>fermf001</a>,Felix Fermin,Pittsburgh Pirates,PIRATS,2,4,5,9,1989,2000,11,No,0,14.38,27.85,13.47,1120,1409,289,4205,5288,1083,0.0,260.0,260.0,7200000.0,0.0,-7200000.0
<a href=/player/fermf001>fermf001</a>,Felix Fermin,Cleveland Indians,INDINS,2,4,3,7,1993,2011,18,No,2,-0.2,32.44,32.64,237,1648,1411,811,6543,5732,0.0,594.0,594.0,1117500.0,0.0,-1117500.0
<a href=/player/fermr001>fermr001</a>,Ramon Fermin,Oakland Athletics,ATLTCS,1,2,1,3,1996,1996,0,No,0,-0.36,-1.09,-0.73,14,73,59,40,263,223,0.0,0.0,0.0,0.0,0.0,0.0
<a href=/player/fernc102>fernc102</a>,Chico Fernandez,Brooklyn Dodgers,DOGRS,4,7,10,17,1957,1968,11,No,0,6.9,5.9,-1.0,1472,995,-477,2872,985,-1887,1656.0,2078.0,422.0,122000.0,0.0,-122000.0
<a href=/player/fernc102>fernc102</a>,Chico Fernandez,Philadelphia Phillies,PHILS,1,2,3,5,1959,1962,3,No,0,0.43,-1.4,-1.83,456,279,-177,1595,804,-791,81.0,0.0,-81.0,9000.0,0.0,-9000.0
<a href=/player/fernc102>fernc102</a>,Chico Fernandez,Detroit Tigers,TIGRS,3,4,4,8,1963,1967,4,No,0,5.69,-0.02,-5.71,445,329,-116,1466,94,-1372,122.0,751.0,629.0,29000.0,0.0,-29000.0
<a href=/player/fernc102>fernc102</a>,Chico Fernandez,New York Mets,METS,4,8,5,13,1964,1970,6,No,0,3.02,7.06,4.04,629,598,-31,1532,2197,665,1019.0,0.0,-1019.0,88000.0,0.0,-88000.0
<a href=/player/fernc102>fernc102</a>,Chico Fernandez,Milwaukee Braves,BRAVES,1,1,2,3,1963,1963,0,No,0,-1.36,0.0,1.36,58,0,-58,157,0,-157,0.0,0.0,0.0,0.0,0.0,0.0
<a href=/player/ferne101>ferne101</a>,Ed Fernandes,Portland,Portland,1,1,2,3,1940,1940,0,No,0,-0.29,0.0,0.29,28,0,-28,41,0,-41,0.0,0.0,0.0,0.0,0.0,0.0
<a href=/player/fernf101>fernf101</a>,Frank Fernandez,New York Yankees,YANKS,28,61,49,110,1969,2001,32,No,2,108.82,84.98,-23.84,7372,4874,-2498,18658,11141,-7517,21552.0,11941.0,-9611.0,5675833.0,0.0,-5675833.0
<a href=/player/fernf101>fernf101</a>,Frank Fernandez,Oakland Athletics,ATLTCS,5,12,6,18,1971,1976,5,No,0,13.14,12.72,-0.42,2868,1140,-1728,6939,2992,-3947,2263.0,1076.0,-1187.0,223600.0,0.0,-223600.0
<a href=/player/fernf101>fernf101</a>,Frank Fernandez,Oakland Athletics,ATLTCS,1,1,1,2,1971,1972,1,No,0,0.91,-0.2,-1.11,20,28,8,61,38,-23,0.0,0.0,0.0,20000.0,0.0,-20000.0
<a href=/player/fernn101>fernn101</a>,Nanny Fernandez,Boston Braves,BRAVES,1,2,1,3,1948,1950,2,No,0,-0.55,1.6,2.15,55,137,82,158,356,198,0.0,0.0,0.0,0.0,0.0,0.0
<a href=/player/fernn101>fernn101</a>,Nanny Fernandez,Brooklyn Dodgers,DOGRS,1,1,2,3,1949,1949,0,No,0,0.39,0.0,-0.39,65,0,-65,218,0,-218,0.0,0.0,0.0,0.0,0.0,0.0
<a href=/player/ferns001>ferns001</a>,Sid Fernandez,Los Angeles Dodgers,DOGRS,1,2,2,4,1983,1986,3,No,0,29.07,1.25,-27.82,528,343,-185,590,279,-311,4754.0,437.0,-4317.0,0.0,0.0,0.0
<a href=/player/fernt001>fernt001</a>,Tony Fernandez,Toronto Blue Jays,BJAYS,3,6,5,11,1990,2002,12,No,2,20.28,30.05,9.77,1139,1849,710,3266,7778,4512,2800.0,760.0,-2040.0,4737500.0,0.0,-4737500.0
<a href=/player/fernt001>fernt001</a>,Tony Fernandez,San Diego Padres,PADRS,3,5,7,12,1992,1998,6,No,0,1.84,1.85,0.01,597,293,-304,1664,174,-1490,1084.0,1146.0,62.0,2100000.0,0.0,-2100000.0
<a href=/player/fernt001>fernt001</a>,Tony Fernandez,New York Mets,METS,1,1,1,2,1993,1993,0,No,0,9.11,-0.58,-9.69,422,31,-391,1579,91,-1488,0.0,0.0,0.0,2300000.0,0.0,-2300000.0
<a href=/player/ferra101>ferra101</a>,Al Ferrara,San Diego Padres,PADRS,1,1,1,2,1971,1971,0,No,0,0.06,-0.52,-0.58,32,52,20,37,68,31,0.0,0.0,0.0,0.0,0.0,0.0
<a href=/player/ferrc101>ferrc101</a>,Cy Ferry,Buffalo,Buffalo,1,2,4,6,1903,1904,1,No,0,16.79,0.0,-16.79,801,0,-801,3453,0,-3453,39.0,0.0,-39.0,0.0,0.0,0.0
<a href=/player/ferrd102>ferrd102</a>,Don Ferrarese,Chicago White Sox,WSOX,29,56,55,111,1954,1971,17,No,0,64.71,122.48,57.77,7633,8254,621,20626,20005,-621,7158.0,13512.0,6354.0,248750.0,0.0,-248750.0
<a href=/player/ferrd102>ferrd102</a>,Don Ferrarese,Baltimore Orioles,ORLS,3,4,5,9,1958,1960,2,No,0,14.22,11.82,-2.4,668,719,51,1551,2462,911,2254.0,614.0,-1640.0,0.0,0.0,0.0
<a href=/player/ferrd102>ferrd102</a>,Don Ferrarese,Cleveland Indians,INDINS,6,11,11,22,1959,1968,9,No,0,95.02,18.27,-76.75,3674,1436,-2238,12659,5344,-7315,4502.0,50.0,-4452.0,0.0,0.0,0.0
<a href=/player/ferrd102>ferrd102</a>,Don Ferrarese,Philadelphia Phillies,PHILS,1,1,2,3,1962,1964,2,No,0,1.5,-0.14,-1.64,76,44,-32,5,11,6,170.0,137.0,-33.0,0.0,0.0,0.0
<a href=/player/ferrd102>ferrd102</a>,Don Ferrarese,St. Louis Cardinals,CARDS,2,2,2,4,1963,1964,1,No,0,1.09,0.0,-1.09,128,0,-128,23,0,-23,329.0,0.0,-329.0,0.0,0.0,0.0
<a href=/player/ferrh101>ferrh101</a>,Hobe Ferris,New York Yankees,YANKS,3,6,6,12,1907,1911,4,No,0,37.76,7.87,-29.89,2601,491,-2110,10473,2011,-8462,0.0,0.0,0.0,0.0,0.0,0.0
<a href=/player/ferrj101>ferrj101</a>,Jack Ferry,Pittsburgh Pirates,PIRATS,1,2,1,3,1913,1915,2,No,0,0.0,3.36,3.36,0,200,200,0,183,183,0.0,1648.0,1648.0,2400.0,0.0,-2400.0
<a href=/player/ferrm101>ferrm101</a>,Mike Ferraro,Seattle Pilots,BREWRS,3,5,5,10,1969,1971,2,No,0,-0.36,0.51,0.87,44,202,158,5,21,16,119.0,376.0,257.0,17500.0,0.0,-17500.0
<a href=/player/ferrm101>ferrm101</a>,Mike Ferraro,Baltimore Orioles,ORLS,2,3,3,6,1971,1973,2,No,0,-0.61,-0.01,0.6,124,47,-77,406,80,-326,0.0,0.0,0.0,0.0,0.0,0.0
<a href=/player/ferrm101>ferrm101</a>,Mike Ferraro,Milwaukee Brewers,BREWRS,1,1,1,2,1973,1973,0,No,0,0.0,-0.16,-0.16,0,2,2,0,0,0,0.0,22.0,22.0,0.0,0.0,0.0
<a href=/player/ferrr101>ferrr101</a>,Rick Ferrell,St.Louis Browns,ORLS,2,3,3,6,1933,1935,2,No,0,12.74,1.35,-11.39,735,162,-573,2638,528,-2110,489.0,0.0,-489.0,13500.0,0.0,-13500.0
<a href=/player/ferrr101>ferrr101</a>,Rick Ferrell,Boston Red Sox,RSOX,3,7,5,12,1937,1940,3,No,0,25.02,12.69,-12.33,1633,702,-931,5994,2554,-3440,2353.0,1424.0,-929.0,33500.0,0.0,-33500.0
<a href=/player/ferrr101>ferrr101</a>,Rick Ferrell,Washington Senators,TWINS,1,1,1,2,1941,1941,0,No,0,0.7,-0.89,-1.59,273,35,-238,934,22,-912,0.0,199.0,199.0,8500.0,0.0,-8500.0
<a href=/player/ferrr101>ferrr101</a>,Rick Ferrell,St.Louis Browns,ORLS,1,1,2,3,1944,1944,0,No,0,4.02,0.0,-4.02,227,0,-227,837,0,-837,0.0,0.0,0.0,0.0,0.0,0.0
<a href=/player/ferrs101>ferrs101</a>,Sergio Ferrer,Minnesota Twins,TWINS,1,1,1,2,1975,1976,1,No,0,0.0,0.0,0.0,0,0,0,0,0,0,0.0,0.0,0.0,0.0,0.0,0.0
<a href=/player/ferrs101>ferrs101</a>,Sergio Ferrer,Philadelphia Phillies,PHILS,1,1,1,2,1977,1977,0,No,0,0.0,0.0,0.0,0,0,0,0,0,0,0.0,0.0,0.0,0.0,0.0,0.0
<a href=/player/ferrs101>ferrs101</a>,Sergio Ferrer,New York Yankees,YANKS,1,1,1,2,1977,1977,0,No,0,-0.3,0.0,0.3,69,0,-69,49,0,-49,0.0,0.0,0.0,0.0,0.0,0.0
<a href=/player/ferrt001>ferrt001</a>,Tony Ferreira,Kansas City Royals,ROYALS,6,8,12,20,1986,2008,22,No,2,34.09,26.19,-7.9,1455,2623,1168,5453,9054,3601,1537.0,1236.0,-301.0,900000.0,0.0,-900000.0
<a href=/player/ferrt101>ferrt101</a>,Tom Ferrick,Washington Senators,TWINS,19,34,35,69,1948,1963,15,No,0,46.33,1.08,-45.25,3341,4737,1396,11069,13056,1987,1598.0,4683.0,3085.0,53500.0,0.0,-53500.0
<a href=/player/ferrt101>ferrt101</a>,Tom Ferrick,St.Louis Browns,ORLS,11,21,24,45,1950,1960,10,No,0,30.8,26.53,-4.27,2470,2935,465,5868,7663,1795,6528.0,5672.0,-856.0,55500.0,0.0,-55500.0
<a href=/player/ferrt101>ferrt101</a>,Tom Ferrick,New York Yankees,YANKS,1,3,1,4,1951,1954,3,No,0,18.48,1.84,-16.64,407,209,-198,444,108,-336,3513.0,1042.0,-2471.0,11500.0,0.0,-11500.0
<a href=/player/ferrw101>ferrw101</a>,Wes Ferrell,Cleveland Indians,INDINS,3,6,5,11,1934,1940,6,No,0,24.33,10.74,-13.59,727,766,39,1921,2878,957,2729.0,210.0,-2519.0,10500.0,0.0,-10500.0
<a href=/player/ferrw101>ferrw101</a>,Wes Ferrell,Boston Red Sox,RSOX,3,7,5,12,1937,1940,3,No,0,25.02,12.69,-12.33,1633,702,-931,5994,2554,-3440,2353.0,1424.0,-929.0,33500.0,0.0,-33500.0
<a href=/player/fettl101>fettl101</a>,Lou Fette,StPaul,StPaul,1,1,2,3,1936,1936,0,No,0,7.87,0.0,-7.87,215,0,-215,255,0,-255,2064.0,0.0,-2064.0,0.0,0.0,0.0
<a href=/player/fettm001>fettm001</a>,Mike Fetters,California Angels,ANGELS,1,2,1,3,1991,1993,2,No,0,7.27,-1.33,-8.6,302,68,-234,0,0,0,1003.0,307.0,-696.0,120000.0,0.0,-120000.0
<a href=/player/fettm001>fettm001</a>,Mike Fetters,Milwaukee Brewers,BREWRS,2,5,3,8,1997,2001,4,No,0,0.99,0.01,-0.98,271,614,343,839,2349,1510,81.0,415.0,334.0,6930000.0,0.0,-6930000.0
<a href=/player/fettm001>fettm001</a>,Mike Fetters,Cleveland Indians,INDINS,3,4,4,8,1997,2003,6,No,0,0.37,6.29,5.92,252,231,-21,2,1,-1,442.0,849.0,407.0,4300000.0,0.0,-4300000.0
<a href=/player/fettm001>fettm001</a>,Mike Fetters,Los Angeles Dodgers,DOGRS,2,5,2,7,2001,2004,3,No,0,0.21,-0.68,-0.89,194,255,61,4,12,8,974.0,483.0,-491.0,4975000.0,0.0,-4975000.0
<a href=/player/fettm001>fettm001</a>,Mike Fetters,Pittsburgh Pirates,PIRATS,1,1,1,2,2002,2003,1,No,0,-1.29,-0.54,0.75,112,18,-94,0,0,0,130.0,25.0,-105.0,2275000.0,0.0,-2275000.0
<a href=/player/fewsc101>fewsc101</a>,Chick Fewster,New York Yankees,YANKS,2,7,3,10,1922,1928,6,No,0,-3.56,9.12,12.68,367,900,533,1242,3603,2361,159.0,0.0,-159.0,15750.0,0.0,-15750.0
<a href=/player/fewsc101>fewsc101</a>,Chick Fewster,Boston Red Sox,RSOX,2,5,5,10,1924,1925,1,No,0,9.31,0.12,-9.19,860,387,-473,3360,1555,-1805,0.0,0.0,0.0,3300.0,0.0,-3300.0
<a href=/player/feyej001>feyej001</a>,Jonathon Feyereisen,Cleveland Indians,INDINS,1,4,1,5,2016,2018,2,No,0,0.85,4.57,3.72,262,129,-133,807,2,-805,102.0,377.0,275.0,0.0,0.0,0.0
<a href=/player/feyej001>feyej001</a>,Jonathon Feyereisen,New York Yankees,YANKS,1,1,1,2,2019,2019,0,No,0,0.3,0.0,-0.3,47,0,-47,0,0,0,86.0,0.0,-86.0,0.0,0.0,0.0
<a href=/player/feyej001>feyej001</a>,Jonathon Feyereisen,Milwaukee Brewers,BREWRS,2,4,3,7,2021,2021,0,Yes,0,2.75,4.04,1.29,94,185,91,3,588,585,385.0,59.0,-326.0,0.0,0.0,0.0
<a href=/player/fialn101>fialn101</a>,Neil Fiala,St. Louis Cardinals,CARDS,5,7,8,15,1981,1996,15,No,1,-2.44,12.91,15.35,324,1354,1030,346,3284,2938,992.0,1563.0,571.0,4150000.0,0.0,-4150000.0
<a href=/player/fielb001>fielb001</a>,Bruce Fields,Detroit Tigers,TIGRS,1,1,1,2,1987,1988,1,No,0,-0.08,0.0,0.08,42,0,-42,76,0,-76,0.0,0.0,0.0,0.0,0.0,0.0
<a href=/player/fielc001>fielc001</a>,Cecil Fielder,Kansas City Royals,ROYALS,1,1,1,2,1983,1984,1,No,0,0.26,0.46,0.2,220,113,-107,558,284,-274,0.0,3.0,3.0,0.0,0.0,0.0
<a href=/player/fielc001>fielc001</a>,Cecil Fielder,Detroit Tigers,TIGRS,2,2,4,6,1996,1997,1,No,0,1.0,-0.38,-1.38,176,46,-130,749,180,-569,0.0,0.0,0.0,9237500.0,0.0,-9237500.0
<a href=/player/fielj001>fielj001</a>,Josh Fields,Chicago White Sox,WSOX,5,8,8,16,2009,2016,7,Yes,0,-0.62,-1.54,-0.92,448,360,-88,1240,736,-504,233.0,625.0,392.0,14311000.0,0.0,-14311000.0
<a href=/player/fielj002>fielj002</a>,Josh Fields,Seattle Mariners,MARNRS,3,4,4,8,2011,2013,2,No,0,0.23,-0.5,-0.73,8,119,111,0,404,404,114.0,0.0,-114.0,1000000.0,0.0,-1000000.0
<a href=/player/fielj002>fielj002</a>,Josh Fields,Houston Astros,ASTROS,1,1,1,2,2016,2016,0,Yes,0,1.94,0.0,-1.94,245,0,-245,1,0,-1,352.0,0.0,-352.0,900000.0,0.0,-900000.0
<a href=/player/fielp001>fielp001</a>,Prince Fielder,Detroit Tigers,TIGRS,2,3,3,6,2013,2017,4,Yes,0,2.62,17.41,14.79,380,607,227,1632,2693,1061,0.0,0.0,0.0,34000000.0,0.0,-34000000.0
<a href=/player/fierm001>fierm001</a>,Michael Fiers,Milwaukee Brewers,BREWRS,3,6,7,13,2015,2020,5,Yes,0,-0.06,8.37,8.43,453,778,325,1232,2675,1443,1628.0,6.0,-1622.0,1084900.0,0.0,-1084900.0
<a href=/player/fierm001>fierm001</a>,Michael Fiers,Detroit Tigers,TIGRS,1,1,2,3,2018,2018,0,Yes,0,4.25,0.0,-4.25,56,0,-56,0,0,0,918.0,0.0,-918.0,6000000.0,0.0,-6000000.0
<a href=/player/fifed101>fifed101</a>,Danny Fife,Detroit Tigers,TIGRS,2,4,2,6,1973,1975,2,No,0,3.13,3.41,0.28,58,109,51,0,215,215,1038.0,609.0,-429.0,0.0,0.0,0.0
<a href=/player/fifes001>fifes001</a>,Stephen Fife,Boston Red Sox,RSOX,1,4,2,6,2011,2012,1,No,0,0.34,0.23,-0.11,124,8,-116,300,0,-300,273.0,114.0,-159.0,0.0,0.0,0.0
<a href=/player/figgc001>figgc001</a>,Chone Figgins,Colorado Rockies,ROCKS,1,1,1,2,2001,2001,0,No,0,22.36,-0.35,-22.71,936,12,-924,4075,19,-4056,0.0,0.0,0.0,0.0,0.0,0.0
<a href=/player/figuc001>figuc001</a>,Cole Figueroa,San Diego Padres,PADRS,1,4,1,5,2010,2012,2,No,0,1.36,-1.01,-2.37,435,168,-267,53,716,663,1270.0,0.0,-1270.0,401300.0,0.0,-401300.0
<a href=/player/figue101>figue101</a>,Ed Figueroa,San Francisco Giants,GIANTS,1,1,2,3,1973,1973,0,No,0,6.67,0.0,-6.67,58,0,-58,0,0,0,1050.0,0.0,-1050.0,0.0,0.0,0.0
<a href=/player/figue101>figue101</a>,Ed Figueroa,California Angels,ANGELS,2,5,4,9,1975,1990,15,No,0,42.88,51.46,8.58,1084,1992,908,2703,8018,5315,7553.0,1336.0,-6217.0,175000.0,0.0,-175000.0
<a href=/player/figuj101>figuj101</a>,Jesus Figueroa,Chicago Cubs,CUBS,1,3,2,5,1980,1980,0,No,0,-0.93,0.0,0.93,72,0,-72,267,0,-267,0.0,0.0,0.0,0.0,0.0,0.0
<a href=/player/figul001>figul001</a>,Luis Figueroa,New York Mets,METS,1,4,3,7,2002,2005,3,No,0,2.12,1.12,-1.0,505,185,-320,25,27,2,939.0,263.0,-676.0,300000.0,0.0,-300000.0
<a href=/player/figun001>figun001</a>,Nelson Figueroa,New York Mets,METS,4,6,6,12,1998,1999,1,No,0,13.09,0.3,-12.79,1229,42,-1187,4418,40,-4378,991.0,86.0,-905.0,5050000.0,0.0,-5050000.0
<a href=/player/figun001>figun001</a>,Nelson Figueroa,Arizona Diamondbacks,DBACKS,9,20,18,38,2000,2012,12,No,3,42.56,26.41,-16.15,3086,1039,-2047,7001,1054,-5947,9526.0,4276.0,-5250.0,24075667.0,0.0,-24075667.0
<a href=/player/filet001>filet001</a>,Tom Filer,New York Yankees,YANKS,1,2,1,3,1981,1983,2,No,0,-0.25,-0.42,-0.17,16,57,41,13,187,174,122.0,0.0,-122.0,0.0,0.0,0.0
<a href=/player/filld101>filld101</a>,Dana Fillingim,Indianapolis,Indianapolis,1,1,2,3,1918,1918,0,No,0,6.61,0.0,-6.61,377,0,-377,384,0,-384,3083.0,0.0,-3083.0,0.0,0.0,0.0
<a href=/player/filld101>filld101</a>,Dana Fillingim,Beaumont,Beaumont,1,2,1,3,1924,1924,0,No,0,-0.96,0.0,0.96,36,0,-36,13,0,-13,104.0,0.0,-104.0,0.0,0.0,0.0
<a href=/player/fillh001>fillh001</a>,Heath Fillmyer,Oakland Athletics,ATLTCS,1,2,3,5,2018,2019,1,No,0,0.62,1.28,0.66,62,124,62,5,0,-5,390.0,254.0,-136.0,0.0,0.0,0.0
<a href=/player/filsp001>filsp001</a>,Pete Filson,New York Yankees,YANKS,4,8,8,16,1982,1992,10,No,0,8.27,12.89,4.62,1161,565,-596,2474,1712,-762,2564.0,669.0,-1895.0,913333.0,0.0,-913333.0
<a href=/player/filsp001>filsp001</a>,Pete Filson,Minnesota Twins,TWINS,1,1,1,2,1986,1986,0,No,0,-0.13,0.0,0.13,3,0,-3,0,0,0,35.0,0.0,-35.0,0.0,0.0,0.0
<a href=/player/filsp001>filsp001</a>,Pete Filson,Chicago White Sox,WSOX,6,11,12,23,1987,1997,10,No,0,68.61,10.72,-57.89,2705,1926,-779,10284,5529,-4755,1119.0,1575.0,456.0,1600000.0,0.0,-1600000.0
<a href=/player/fimpj001>fimpj001</a>,Jack Fimple,Cleveland Indians,INDINS,18,31,36,67,1981,2001,20,No,1,116.55,78.96,-37.59,6988,5496,-1492,21431,20127,-1304,7765.0,4126.0,-3639.0,20493332.0,0.0,-20493332.0
<a href=/player/fincb101>fincb101</a>,Bill Fincher,LittleRock,LittleRock,2,3,7,10,1915,1916,1,No,0,0.33,0.0,-0.33,131,0,-131,145,0,-145,73.0,0.0,-73.0,0.0,0.0,0.0
<a href=/player/finet101>finet101</a>,Tommy Fine,Boston Red Sox,RSOX,1,3,1,4,1947,1947,0,No,0,0.0,0.0,0.0,0,0,0,0,0,0,0.0,0.0,0.0,6000.0,0.0,-6000.0
<a href=/player/fingr001>fingr001</a>,Rollie Fingers,San Diego Padres,PADRS,12,21,25,46,1980,1993,13,No,1,78.65,50.21,-28.44,3246,4423,1177,10088,11380,1292,4862.0,3507.0,-1355.0,3006667.0,0.0,-3006667.0
<a href=/player/fingr001>fingr001</a>,Rollie Fingers,St. Louis Cardinals,CARDS,8,19,15,34,1980,1998,18,No,4,64.49,118.5,54.01,5600,4432,-1168,17434,16118,-1316,5735.0,2617.0,-3118.0,1533333.0,0.0,-1533333.0
<a href=/player/finij101>finij101</a>,Jim Finigan,New York Yankees,YANKS,16,45,38,83,1953,1970,17,No,0,48.62,78.17,29.55,7017,4726,-2291,22732,11340,-11392,3607.0,11554.0,7947.0,313000.0,0.0,-313000.0
<a href=/player/finij101>finij101</a>,Jim Finigan,Kansas City Athletics,ATLTCS,40,86,88,174,1956,1976,20,No,0,134.11,73.29,-60.82,13270,9412,-3858,30102,25264,-4838,19786.0,12575.0,-7211.0,506100.0,0.0,-506100.0
<a href=/player/finij101>finij101</a>,Jim Finigan,Detroit Tigers,TIGRS,3,5,5,10,1958,1961,3,No,0,2.6,0.25,-2.35,222,502,280,114,1399,1285,733.0,40.0,-693.0,0.0,0.0,0.0
<a href=/player/finij101>finij101</a>,Jim Finigan,San Francisco Giants,GIANTS,1,1,2,3,1958,1958,0,No,0,-0.15,0.0,0.15,48,0,-48,130,0,-130,0.0,0.0,0.0,0.0,0.0,0.0
<a href=/player/finlc001>finlc001</a>,Chuck Finley,Cleveland Indians,INDINS,3,5,8,13,2002,2011,9,No,0,6.54,15.23,8.69,561,1074,513,1946,3677,1731,285.0,785.0,500.0,9861948.0,0.0,-9861948.0
<a href=/player/finls001>finls001</a>,Steve Finley,Baltimore Orioles,ORLS,1,3,1,4,1991,1993,2,No,0,24.17,0.73,-23.44,904,185,-719,2612,764,-1848,2435.0,0.0,-2435.0,0.0,0.0,0.0
<a href=/player/finls001>finls001</a>,Steve Finley,Houston Astros,ASTROS,15,31,38,69,1994,2011,17,No,2,59.26,30.42,-28.84,4671,6149,1478,11202,16044,4842,6620.0,5977.0,-643.0,31714000.0,0.0,-31714000.0
<a href=/player/finls001>finls001</a>,Steve Finley,Arizona Diamondbacks,DBACKS,1,2,3,5,2004,2008,4,No,0,1.02,-0.45,-1.47,105,67,-38,363,129,-234,0.0,19.0,19.0,7800000.0,0.0,-7800000.0
<a href=/player/finls001>finls001</a>,Steve Finley,Anaheim Angels,ANGELS,1,1,1,2,2005,2006,1,No,0,1.13,-0.63,-1.76,139,18,-121,481,52,-429,0.0,0.0,0.0,6000000.0,0.0,-6000000.0
<a href=/player/finnb001>finnb001</a>,Brandon Finnegan,Kansas City Royals,ROYALS,1,3,2,5,2015,2015,0,No,0,-1.23,0.27,1.5,231,13,-218,147,0,-147,1419.0,244.0,-1175.0,0.0,0.0,0.0
<a href=/player/finnh102>finnh102</a>,Happy Finneran,New York Yankees,YANKS,5,14,8,22,1919,1946,27,No,0,28.58,90.66,62.08,995,2697,1702,1312,4980,3668,7730.0,17113.0,9383.0,42500.0,0.0,-42500.0
<a href=/player/finnh102>finnh102</a>,Happy Finneran,Baltimore Terrapins,BLF,1,1,1,2,1914,1914,0,No,0,1.87,0.0,-1.87,129,0,-129,138,0,-138,1172.0,0.0,-1172.0,0.0,0.0,0.0
<a href=/player/finnn101>finnn101</a>,Neal Finn,Brooklyn Dodgers,DOGRS,6,13,10,23,1932,1948,16,No,0,22.8,18.44,-4.36,1723,1313,-410,5249,4047,-1202,2633.0,2535.0,-98.0,0.0,0.0,0.0
<a href=/player/fiorm101>fiorm101</a>,Mike Fiore,Kansas City Royals,ROYALS,2,2,2,4,1970,1971,1,No,0,-0.54,-0.26,0.28,134,74,-60,256,197,-59,0.0,0.0,0.0,17000.0,0.0,-17000.0
<a href=/player/fiorm101>fiorm101</a>,Mike Fiore,Boston Red Sox,RSOX,1,1,1,2,1972,1972,0,No,0,-0.15,-0.78,-0.63,17,45,28,13,84,71,0.0,0.0,0.0,0.0,0.0,0.0
<a href=/player/fiorm101>fiorm101</a>,Mike Fiore,St. Louis Cardinals,CARDS,1,2,1,3,1972,1972,0,No,0,0.0,0.0,0.0,7,0,-7,7,0,-7,0.0,0.0,0.0,24000.0,0.0,-24000.0
<a href=/player/fires001>fires001</a>,Steve Fireovid,San Diego Padres,PADRS,5,8,9,17,1983,1992,9,No,1,0.01,11.95,11.94,244,925,681,351,1136,785,610.0,1770.0,1160.0,375000.0,0.0,-375000.0
<a href=/player/fiscb101>fiscb101</a>,Bill Fischer,Chicago White Sox,WSOX,3,10,4,14,1951,1953,2,No,0,2.36,0.32,-2.04,404,226,-178,236,372,136,2232.0,741.0,-1491.0,0.0,0.0,0.0
<a href=/player/fiscb101>fiscb101</a>,Bill Fischer,Chicago White Sox,WSOX,14,22,25,47,1958,1969,11,No,0,14.88,32.86,17.98,2012,2738,726,3483,4385,902,3780.0,6927.0,3147.0,112250.0,0.0,-112250.0
<a href=/player/fiscb101>fiscb101</a>,Bill Fischer,Washington Senators,TWINS,1,1,1,2,1960,1961,1,No,0,0.73,-0.15,-0.88,92,28,-64,23,5,-18,304.0,72.0,-232.0,0.0,0.0,0.0
<a href=/player/fiscb101>fiscb101</a>,Bill Fischer,Detroit Tigers,TIGRS,1,2,2,4,1961,1961,0,No,0,2.6,-0.03,-2.63,199,50,-149,85,51,-34,733.0,40.0,-693.0,0.0,0.0,0.0
<a href=/player/fiscc101>fiscc101</a>,Carl Fischer,Washington Senators,TWINS,4,5,4,9,1932,1937,5,No,0,9.38,12.91,3.53,664,338,-326,592,470,-122,4696.0,3368.0,-1328.0,13000.0,0.0,-13000.0
<a href=/player/fiscc101>fiscc101</a>,Carl Fischer,St.Louis Browns,ORLS,1,1,1,2,1932,1935,3,No,0,0.34,1.79,1.45,58,222,164,45,161,116,368.0,1375.0,1007.0,0.0,0.0,0.0
<a href=/player/fiscc101>fiscc101</a>,Carl Fischer,Washington Senators,TWINS,2,3,2,5,1932,1937,5,No,0,6.78,12.58,5.8,394,270,-124,393,428,35,3029.0,2990.0,-39.0,6500.0,0.0,-6500.0
<a href=/player/fisch101>fisch101</a>,Hank Fischer,Atlanta Braves,BRAVES,1,1,1,2,1966,1966,0,No,0,-0.77,-1.28,-0.51,22,18,-4,11,8,-3,114.0,89.0,-25.0,17000.0,0.0,-17000.0
<a href=/player/fisch101>fisch101</a>,Hank Fischer,Cincinnati Reds,REDS,1,1,3,4,1966,1966,0,No,0,0.24,0.0,-0.24,30,0,-30,18,0,-18,173.0,0.0,-173.0,0.0,0.0,0.0
<a href=/player/fiscj001>fiscj001</a>,Jeff Fischer,Montreal Expos,NATEX,1,1,1,2,1989,1992,3,No,0,-0.18,0.98,1.16,4,87,83,0,234,234,10.0,0.0,-10.0,0.0,0.0,0.0
<a href=/player/fiscm001>fiscm001</a>,Mike Fischlin,New York Yankees,YANKS,2,4,2,6,1977,1979,2,No,0,-0.57,3.2,3.77,493,187,-306,951,449,-502,300.0,202.0,-98.0,0.0,0.0,0.0
<a href=/player/fiscm001>fiscm001</a>,Mike Fischlin,Houston Astros,ASTROS,1,1,2,3,1981,1981,0,No,0,0.93,0.0,-0.93,387,0,-387,855,0,-855,0.0,0.0,0.0,0.0,0.0,0.0
<a href=/player/fiscm001>fiscm001</a>,Mike Fischlin,Cleveland Indians,INDINS,1,1,1,2,1985,1988,3,No,0,-0.63,0.0,0.63,71,0,-71,116,0,-116,0.0,0.0,0.0,190000.0,0.0,-190000.0
<a href=/player/fiscw101>fiscw101</a>,William Fischer,Chicago Cubs,CUBS,2,5,2,7,1916,1918,2,No,0,4.43,7.54,3.11,398,188,-210,1271,487,-784,0.0,807.0,807.0,4000.0,0.0,-4000.0
<a href=/player/fishb001>fishb001</a>,Brian Fisher,Atlanta Braves,BRAVES,2,4,2,6,1984,1986,2,No,0,2.56,-0.7,-3.26,185,172,-13,242,460,218,585.0,0.0,-585.0,0.0,0.0,0.0
<a href=/player/fishb001>fishb001</a>,Brian Fisher,New York Yankees,YANKS,10,18,16,34,1986,2001,15,No,1,53.73,20.66,-33.07,2413,1594,-819,5894,4002,-1892,9392.0,3621.0,-5771.0,3550000.0,0.0,-3550000.0
<a href=/player/fishc103>fishc103</a>,Chauncey Fisher,Cincinnati Reds,REDS,1,3,1,4,1896,1906,10,No,0,0.1,7.82,7.72,152,1229,1077,519,5155,4636,447.0,0.0,-447.0,0.0,0.0,0.0
<a href=/player/fishd001>fishd001</a>,Derek Fisher,Houston Astros,ASTROS,3,5,5,10,2019,2021,2,No,0,0.6,-1.15,-1.75,122,50,-72,365,0,-365,14.0,185.0,171.0,0.0,0.0,0.0
<a href=/player/fishd001>fishd001</a>,Derek Fisher,Toronto Blue Jays,BJAYS,1,1,2,3,2021,2021,0,Yes,0,0.02,0.0,-0.02,4,0,-4,8,0,-8,0.0,0.0,0.0,0.0,0.0,0.0
<a href=/player/fishe102>fishe102</a>,Eddie Fisher,San Francisco Giants,GIANTS,1,4,2,6,1961,1964,3,No,0,7.93,4.13,-3.8,685,341,-344,242,140,-102,2569.0,1260.0,-1309.0,0.0,0.0,0.0
<a href=/player/fishe102>fishe102</a>,Eddie Fisher,Chicago White Sox,WSOX,3,3,5,8,1966,1968,2,No,0,3.09,3.97,0.88,451,321,-130,592,529,-63,702.0,507.0,-195.0,31250.0,0.0,-31250.0
<a href=/player/fishe102>fishe102</a>,Eddie Fisher,Baltimore Orioles,ORLS,5,11,8,19,1967,1973,6,No,0,0.02,-1.5,-1.52,551,253,-298,598,477,-121,1557.0,66.0,-1491.0,38500.0,0.0,-38500.0
<a href=/player/fishe102>fishe102</a>,Eddie Fisher,Cleveland Indians,INDINS,2,2,2,4,1968,1969,1,No,0,1.36,0.1,-1.26,454,40,-414,65,2,-63,1319.0,92.0,-1227.0,57000.0,0.0,-57000.0
<a href=/player/fishe102>fishe102</a>,Eddie Fisher,California Angels,ANGELS,3,3,4,7,1972,1973,1,No,0,0.84,0.81,-0.03,311,114,-197,800,359,-441,399.0,0.0,-399.0,0.0,0.0,0.0
<a href=/player/fishj001>fishj001</a>,John Fishel,Houston Astros,ASTROS,1,3,1,4,1989,1989,0,No,0,0.0,-0.25,-0.25,0,40,40,0,31,31,0.0,290.0,290.0,0.0,0.0,0.0
<a href=/player/fishj101>fishj101</a>,Jack Fisher,Baltimore Orioles,ORLS,17,34,32,66,1962,1994,32,No,3,53.81,109.37,55.56,3570,5799,2229,7519,12936,5417,13760.0,16382.0,2622.0,880833.0,0.0,-880833.0
<a href=/player/fishj101>fishj101</a>,Jack Fisher,New York Mets,METS,2,5,4,9,1967,1974,7,No,0,2.47,11.88,9.41,357,948,591,832,3426,2594,1066.0,0.0,-1066.0,89000.0,0.0,-89000.0
<a href=/player/fishj101>fishj101</a>,Jack Fisher,Chicago White Sox,WSOX,10,19,17,36,1968,1985,17,No,1,25.12,25.96,0.84,2431,1834,-597,5166,6145,979,6713.0,2182.0,-4531.0,181950.0,0.0,-181950.0
<a href=/player/fishj101>fishj101</a>,Jack Fisher,Cincinnati Reds,REDS,1,1,2,3,1970,1970,0,No,0,0.0,0.0,0.0,0,0,0,0,0,0,0.0,0.0,0.0,0.0,0.0,0.0
<a href=/player/fishs101>fishs101</a>,Showboat Fisher,Washington Senators,TWINS,1,1,1,2,1924,1924,0,No,0,0.0,0.09,0.09,0,2,2,0,8,8,0.0,0.0,0.0,0.0,0.0,0.0
<a href=/player/fishs101>fishs101</a>,Showboat Fisher,New York Giants,GIANTS,1,2,1,3,1930,1930,0,No,0,1.35,-0.6,-1.95,115,121,6,352,457,105,0.0,0.0,0.0,0.0,0.0,0.0
<a href=/player/fishs101>fishs101</a>,Showboat Fisher,St. Louis Cardinals,CARDS,1,1,1,2,1932,1932,0,No,0,-0.2,0.0,0.2,18,0,-18,24,0,-24,0.0,0.0,0.0,0.0,0.0,0.0
<a href=/player/fisht101>fisht101</a>,Tom Fisher,Baltimore Orioles,ORLS,3,6,5,11,1969,1973,4,No,0,0.65,-0.01,-0.66,284,47,-237,424,80,-344,279.0,0.0,-279.0,0.0,0.0,0.0
<a href=/player/fisht103>fisht103</a>,Bob Fisher,Newark,Newark,1,2,2,4,1912,1912,0,No,0,-0.4,0.0,0.4,214,0,-214,788,0,-788,0.0,0.0,0.0,0.0,0.0,0.0
<a href=/player/fistd001>fistd001</a>,Doug Fister,Seattle Mariners,MARNRS,1,2,4,6,2011,2016,5,No,0,9.61,3.11,-6.5,89,386,297,9,432,423,1381.0,727.0,-654.0,858500.0,0.0,-858500.0
<a href=/player/fistd001>fistd001</a>,Doug Fister,Detroit Tigers,TIGRS,6,8,9,17,2013,2021,8,Yes,0,15.02,0.6,-14.42,865,612,-253,879,652,-227,3688.0,1450.0,-2238.0,16515000.0,0.0,-16515000.0
<a href=/player/fitza101>fitza101</a>,Al Fitzmorris,Toronto Blue Jays,BJAYS,2,2,5,7,1976,1982,6,No,0,7.38,0.73,-6.65,1001,234,-767,3318,766,-2552,442.0,249.0,-193.0,0.0,0.0,0.0
<a href=/player/fitze101>fitze101</a>,Ed FitzGerald,Washington Senators,TWINS,1,1,2,3,1959,1962,3,No,0,0.95,-2.61,-3.56,49,330,281,143,541,398,0.0,528.0,528.0,0.0,0.0,0.0
<a href=/player/fitze101>fitze101</a>,Ed FitzGerald,Sacramento,Sacramento,1,1,2,3,1947,1947,0,No,0,-0.99,0.0,0.99,295,0,-295,686,0,-686,0.0,0.0,0.0,0.0,0.0,0.0
<a href=/player/fitzf101>fitzf101</a>,Freddie Fitzsimmons,New York Giants,GIANTS,2,4,2,6,1937,1940,3,No,0,11.39,3.66,-7.73,220,153,-67,272,527,255,2128.0,105.0,-2023.0,0.0,0.0,0.0
<a href=/player/fitzf101>fitzf101</a>,Freddie Fitzsimmons,Indianapolis,Indianapolis,1,1,2,3,1925,1926,1,No,0,24.43,0.0,-24.43,806,0,-806,991,0,-991,7537.0,0.0,-7537.0,0.0,0.0,0.0
<a href=/player/fitzh101>fitzh101</a>,Howard Fitzgerald,WichitaFalls,WichitaFalls,1,1,3,4,1926,1926,0,No,0,-0.79,0.0,0.79,31,0,-31,103,0,-103,0.0,0.0,0.0,0.0,0.0,0.0
<a href=/player/fitzm001>fitzm001</a>,Mike Fitzgerald,New York Mets,METS,1,4,1,5,1984,1989,5,No,0,17.64,11.38,-6.26,1847,600,-1247,5919,2448,-3471,1489.0,0.0,-1489.0,356000.0,0.0,-356000.0
<a href=/player/fitzm102>fitzm102</a>,Justin Fitzgerald,New York Yankees,YANKS,1,3,1,4,1911,1911,0,No,0,0.0,0.0,0.0,0,0,0,0,0,0,0.0,0.0,0.0,0.0,0.0,0.0
<a href=/player/fitzs101>fitzs101</a>,Shaun Fitzmaurice,Pittsburgh Pirates,PIRATS,1,1,1,2,1969,1970,1,No,0,0.0,-0.12,-0.12,0,10,10,0,17,17,0.0,0.0,0.0,0.0,0.0,0.0
<a href=/player/flacm101>flacm101</a>,Max Flack,Chicago Cubs,CUBS,1,1,1,2,1922,1931,9,No,0,0.33,6.65,6.32,340,856,516,1364,3009,1645,0.0,0.0,0.0,0.0,0.0,0.0
<a href=/player/flagi101>flagi101</a>,Ira Flagstead,Detroit Tigers,TIGRS,1,1,1,2,1923,1923,0,No,0,14.79,0.0,-14.79,789,0,-789,3399,0,-3399,0.0,0.0,0.0,5000.0,0.0,-5000.0
<a href=/player/flagw101>flagw101</a>,Wally Flager,Cincinnati Reds,REDS,1,1,1,2,1945,1946,1,No,0,0.35,1.86,1.51,49,48,-1,187,55,-132,0.0,473.0,473.0,0.0,0.0,0.0
<a href=/player/flahj001>flahj001</a>,John Flaherty,Boston Red Sox,RSOX,1,1,1,2,1994,1995,1,No,0,-0.35,0.07,0.42,193,60,-133,594,158,-436,0.0,0.0,0.0,0.0,0.0,0.0
<a href=/player/flahj001>flahj001</a>,John Flaherty,Detroit Tigers,TIGRS,7,15,18,33,1996,2010,14,No,1,12.92,23.75,10.83,4861,1561,-3300,12744,2643,-10101,4562.0,6757.0,2195.0,12079000.0,0.0,-12079000.0
<a href=/player/flahj001>flahj001</a>,John Flaherty,San Diego Padres,PADRS,4,5,7,12,1997,2006,9,No,1,-1.64,18.57,20.21,633,1149,516,2378,3615,1237,0.0,1106.0,1106.0,10525000.0,0.0,-10525000.0
<a href=/player/flahp101>flahp101</a>,Patsy Flaherty,Pittsburgh Pirates,PIRATS,1,3,1,4,1901,1901,0,No,0,0.0,-0.42,-0.42,0,14,14,0,21,21,0.0,133.0,133.0,0.0,0.0,0.0
<a href=/player/flahp101>flahp101</a>,Patsy Flaherty,Pittsburgh Pirates,PIRATS,1,3,1,4,1906,1910,4,No,0,14.38,6.11,-8.27,866,332,-534,3143,1286,-1857,1417.0,0.0,-1417.0,0.0,0.0,0.0
<a href=/player/flanj101>flanj101</a>,John Flannery,California Angels,ANGELS,1,3,1,4,1977,1979,2,No,0,0.12,1.23,1.11,29,53,24,3,0,-3,151.0,726.0,575.0,0.0,0.0,0.0
<a href=/player/flanm001>flanm001</a>,Mike Flanagan,Baltimore Orioles,ORLS,2,2,3,5,1987,1992,5,No,0,14.47,-0.96,-15.43,424,50,-374,0,0,0,3299.0,808.0,-2491.0,625000.0,0.0,-625000.0
<a href=/player/flemd001>flemd001</a>,Dave Fleming,Seattle Mariners,MARNRS,1,1,1,2,1995,1996,1,No,0,0.36,-0.46,-0.82,9,7,-2,0,0,0,96.0,63.0,-33.0,750000.0,0.0,-750000.0
<a href=/player/fleml101>fleml101</a>,Les Fleming,Detroit Tigers,TIGRS,1,1,3,4,1940,1946,6,No,0,0.0,0.0,0.0,0,0,0,0,0,0,0.0,0.0,0.0,0.0,0.0,0.0
<a href=/player/fleml101>fleml101</a>,Les Fleming,Cleveland Indians,INDINS,1,1,1,2,1947,1948,1,No,0,0.08,0.0,-0.08,24,0,-24,38,0,-38,0.0,0.0,0.0,0.0,0.0,0.0
<a href=/player/fleml101>fleml101</a>,Les Fleming,Chicago Cubs,CUBS,1,2,4,6,1954,1955,1,No,0,0.0,0.0,0.0,0,0,0,0,0,0,0.0,0.0,0.0,0.0,0.0,0.0
<a href=/player/fleta001>fleta001</a>,Aaron Fletcher,Washington Nationals,NATEX,1,3,2,5,2019,2020,1,No,0,0.05,-0.26,-0.31,39,55,16,0,1,1,84.0,72.0,-12.0,0.0,0.0,0.0
<a href=/player/fleta101>fleta101</a>,Art Fletcher,New York Giants,GIANTS,3,6,4,10,1920,1927,7,No,0,19.5,24.64,5.14,1124,966,-158,4554,3993,-561,0.0,87.0,87.0,25500.0,0.0,-25500.0
<a href=/player/fletd001>fletd001</a>,Darrin Fletcher,Los Angeles Dodgers,DOGRS,3,4,3,7,1990,1993,3,No,0,0.33,0.79,0.46,142,182,40,165,513,348,763.0,96.0,-667.0,340000.0,0.0,-340000.0
<a href=/player/fletd001>fletd001</a>,Darrin Fletcher,Philadelphia Phillies,PHILS,1,2,1,3,1991,1992,1,No,0,3.4,-0.7,-4.1,643,88,-555,2169,2,-2167,0.0,163.0,163.0,0.0,0.0,0.0
<a href=/player/flete101>flete101</a>,Elbie Fletcher,Boston Braves,BRAVES,1,1,2,3,1939,1940,1,No,0,26.17,-0.07,-26.24,916,2,-914,3819,3,-3816,0.0,0.0,0.0,6000.0,0.0,-6000.0
<a href=/player/flete101>flete101</a>,Elbie Fletcher,Pittsburgh Pirates,PIRATS,1,1,1,2,1947,1954,7,No,0,0.0,0.08,0.08,0,24,24,0,38,38,0.0,0.0,0.0,0.0,0.0,0.0
<a href=/player/flets001>flets001</a>,Scott Fletcher,Chicago Cubs,CUBS,3,6,6,12,1983,1990,7,No,0,9.95,11.91,1.96,748,630,-118,2292,307,-1985,429.0,3028.0,2599.0,890000.0,0.0,-890000.0
<a href=/player/flets001>flets001</a>,Scott Fletcher,Chicago White Sox,WSOX,2,6,5,11,1985,1991,6,No,0,14.64,2.56,-12.08,1223,446,-777,4038,1366,-2672,817.0,277.0,-540.0,640000.0,0.0,-640000.0
<a href=/player/flets001>flets001</a>,Scott Fletcher,Texas Rangers,RNGRS,3,5,6,11,1989,1992,3,No,0,24.82,3.73,-21.09,1170,237,-933,3620,767,-2853,3192.0,327.0,-2865.0,2411539.0,0.0,-2411539.0
<a href=/player/fletv101>fletv101</a>,Van Fletcher,Seattle,Seattle,1,1,2,3,1954,1954,0,No,0,-0.18,0.0,0.18,18,0,-18,1,0,-1,36.0,0.0,-36.0,0.0,0.0,0.0
<a href=/player/flicl101>flicl101</a>,Lew Flick,Philadelphia Athletics,ATLTCS,1,5,1,6,1944,1946,2,No,0,0.0,1.19,1.19,0,162,162,0,669,669,0.0,0.0,0.0,3000.0,0.0,-3000.0
<a href=/player/flinj101>flinj101</a>,John Flinn,Baltimore Orioles,ORLS,1,1,1,2,1979,1985,6,No,0,-0.16,4.14,4.3,20,441,421,0,1068,1068,111.0,0.0,-111.0,0.0,0.0,0.0
<a href=/player/flooc101>flooc101</a>,Curt Flood,Cincinnati Reds,REDS,3,6,6,12,1957,1960,3,No,0,46.58,-0.35,-46.93,2142,12,-2130,7009,0,-7009,805.0,19.0,-786.0,0.0,0.0,0.0
<a href=/player/flooc101>flooc101</a>,Curt Flood,St. Louis Cardinals,CARDS,30,57,53,110,1969,1998,29,No,7,115.3,176.27,60.97,11163,8552,-2611,30164,29400,-764,12224.0,4453.0,-7771.0,3323333.0,0.0,-3323333.0
<a href=/player/flooc101>flooc101</a>,Curt Flood,Philadelphia Phillies,PHILS,1,2,3,5,1970,1977,7,No,0,1.17,0.0,-1.17,48,0,-48,40,0,-40,179.0,0.0,-179.0,0.0,0.0,0.0
<a href=/player/florb001>florb001</a>,Bryce Florie,San Diego Padres,PADRS,5,11,11,22,1996,2006,10,No,1,7.75,31.03,23.28,1053,1823,770,3065,7183,4118,514.0,4.0,-510.0,9096680.0,0.0,-9096680.0
<a href=/player/florb001>florb001</a>,Bryce Florie,Milwaukee Brewers,BREWRS,5,6,9,15,1997,2006,9,No,0,5.19,3.94,-1.25,464,930,466,104,158,54,934.0,1869.0,935.0,5057000.0,0.0,-5057000.0
<a href=/player/florb001>florb001</a>,Bryce Florie,Detroit Tigers,TIGRS,2,2,2,4,1999,2009,10,No,0,-2.59,5.58,8.17,83,168,85,11,25,14,378.0,2722.0,2344.0,4250000.0,0.0,-4250000.0
<a href=/player/flord002>flord002</a>,Dylan Floro,Cincinnati Reds,REDS,1,3,2,5,2018,2018,0,Yes,0,1.09,0.0,-1.09,176,0,-176,2,0,-2,299.0,0.0,-299.0,0.0,0.0,0.0
<a href=/player/flord002>flord002</a>,Dylan Floro,Los Angeles Dodgers,DOGRS,1,1,2,3,2021,2021,0,Yes,0,1.46,0.61,-0.85,133,82,-51,0,4,4,192.0,120.0,-72.0,0.0,0.0,0.0
<a href=/player/florg101>florg101</a>,Gil Flores,California Angels,ANGELS,1,1,1,2,1978,1978,0,No,0,-0.14,0.0,0.14,81,0,-81,139,0,-139,0.0,0.0,0.0,0.0,0.0,0.0
<a href=/player/florj001>florj001</a>,Jose Flores,Philadelphia Phillies,PHILS,1,1,1,2,1999,1999,0,No,0,0.0,-0.52,-0.52,0,32,32,0,72,72,0.0,0.0,0.0,0.0,0.0,0.0
<a href=/player/florj001>florj001</a>,Jose Flores,Milwaukee Brewers,BREWRS,2,4,5,9,2001,2004,3,No,0,0.49,3.61,3.12,225,470,245,5,59,54,355.0,808.0,453.0,1700000.0,0.0,-1700000.0
<a href=/player/florj001>florj001</a>,Jose Flores,Oakland Athletics,ATLTCS,1,1,1,2,2002,2002,0,No,0,0.0,0.0,0.0,0,0,0,0,0,0,0.0,0.0,0.0,0.0,0.0,0.0
<a href=/player/flork001>flork001</a>,Kevin Flora,California Angels,ANGELS,1,2,1,3,1995,1995,0,No,0,-0.59,-0.19,0.4,154,11,-143,102,18,-84,370.0,0.0,-370.0,250000.0,0.0,-250000.0
<a href=/player/flork001>flork001</a>,Kevin Flora,California Angels,ANGELS,1,1,1,2,1996,1996,0,No,0,0.0,0.0,0.0,0,0,0,0,0,0,0.0,0.0,0.0,0.0,0.0,0.0
<a href=/player/flork002>flork002</a>,Kendry Flores,San Francisco Giants,GIANTS,1,2,1,3,2014,2015,1,No,0,0.08,-0.84,-0.92,15,49,34,2,138,136,47.0,0.0,-47.0,0.0,0.0,0.0
<a href=/player/florr001>florr001</a>,Randy Flores,New York Yankees,YANKS,1,2,1,3,2001,2001,0,No,0,-0.24,0.36,0.6,75,15,-60,0,55,55,195.0,0.0,-195.0,0.0,0.0,0.0
<a href=/player/florr003>florr003</a>,Ramon Flores,New York Yankees,YANKS,1,2,1,3,2015,2016,1,No,0,-0.41,-0.02,0.39,5,51,46,0,127,127,14.0,0.0,-14.0,0.0,0.0,0.0
<a href=/player/florr003>florr003</a>,Ramon Flores,Seattle Mariners,MARNRS,2,2,2,4,2015,2016,1,No,0,-1.57,-0.48,1.09,168,33,-135,462,77,-385,3.0,3.0,0.0,512000.0,0.0,-512000.0
<a href=/player/flowb101>flowb101</a>,Ben Flowers,Detroit Tigers,TIGRS,2,3,3,6,1955,1956,1,No,0,0.07,0.0,-0.07,14,0,-14,13,0,-13,117.0,0.0,-117.0,0.0,0.0,0.0
<a href=/player/flowb101>flowb101</a>,Ben Flowers,St. Louis Cardinals,CARDS,1,3,2,5,1956,1958,2,No,0,5.63,6.28,0.65,262,246,-16,209,231,22,1575.0,1837.0,262.0,0.0,0.0,0.0
<a href=/player/flowb101>flowb101</a>,Ben Flowers,Philadelphia Phillies,PHILS,2,8,4,12,1957,1962,5,No,0,1.07,-3.22,-4.29,707,621,-86,1985,2063,78,115.0,0.0,-115.0,9000.0,0.0,-9000.0
<a href=/player/flowb101>flowb101</a>,Ben Flowers,Brooklyn Dodgers,DOGRS,1,1,1,2,1957,1958,1,No,0,0.0,0.0,0.0,0,0,0,0,0,0,0.0,0.0,0.0,0.0,0.0,0.0
<a href=/player/flowj101>flowj101</a>,Jake Flowers,St. Louis Cardinals,CARDS,1,1,1,2,1927,1927,0,No,0,1.57,-1.16,-2.73,405,36,-369,1391,37,-1354,0.0,282.0,282.0,0.0,0.0,0.0
<a href=/player/flowj101>flowj101</a>,Jake Flowers,St. Louis Cardinals,CARDS,1,2,2,4,1933,1934,1,No,0,-0.46,1.18,1.64,199,133,-66,354,117,-237,902.0,474.0,-428.0,0.0,0.0,0.0
<a href=/player/flowt001>flowt001</a>,Tyler Flowers,Atlanta Braves,BRAVES,5,12,14,26,2008,2014,6,No,0,17.06,9.0,-8.06,2364,1258,-1106,2896,3420,524,3035.0,1593.0,-1442.0,26080000.0,0.0,-26080000.0
<a href=/player/floyb101>floyb101</a>,Bobby Floyd,Baltimore Orioles,ORLS,3,3,3,6,1970,1972,2,No,0,0.9,0.48,-0.42,370,80,-290,415,100,-315,264.0,100.0,-164.0,12500.0,0.0,-12500.0
<a href=/player/floyc001>floyc001</a>,Cliff Floyd,Montreal Expos,NATEX,2,3,4,7,1997,2003,6,No,0,22.05,5.37,-16.68,1335,746,-589,2646,1263,-1383,1408.0,2772.0,1364.0,3988333.0,0.0,-3988333.0
<a href=/player/floyc001>floyc001</a>,Cliff Floyd,Florida Marlins,MARLNS,3,7,8,15,2002,2012,10,No,2,-0.85,8.19,9.04,199,784,585,190,1558,1368,741.0,2057.0,1316.0,6500000.0,0.0,-6500000.0
<a href=/player/floyc001>floyc001</a>,Cliff Floyd,Montreal Expos,NATEX,1,1,2,3,2002,2005,3,No,0,1.55,0.77,-0.78,47,122,75,190,49,-141,0.0,598.0,598.0,0.0,0.0,0.0
<a href=/player/floyg001>floyg001</a>,Gavin Floyd,Philadelphia Phillies,PHILS,1,2,1,3,2006,2007,1,No,0,16.18,-0.17,-16.35,196,21,-175,20,22,2,3223.0,174.0,-3049.0,330000.0,0.0,-330000.0
<a href=/player/flynb001>flynb001</a>,Brian Flynn,Detroit Tigers,TIGRS,1,3,2,5,2012,2017,5,No,0,-1.8,11.54,13.34,208,344,136,437,741,304,809.0,2395.0,1586.0,1175000.0,0.0,-1175000.0
<a href=/player/flynb001>flynb001</a>,Brian Flynn,Miami Marlins,MARLNS,1,2,1,3,2014,2015,1,No,0,1.69,0.0,-1.69,103,0,-103,1,0,-1,488.0,0.0,-488.0,0.0,0.0,0.0
<a href=/player/flync102>flync102</a>,Carney Flynn,New York Giants,GIANTS,1,3,1,4,1896,1896,0,No,0,5.07,2.79,-2.28,227,49,-178,829,211,-618,60.0,0.0,-60.0,0.0,0.0,0.0
<a href=/player/flynd001>flynd001</a>,Doug Flynn,Cincinnati Reds,REDS,3,6,5,11,1977,1990,13,No,0,13.19,18.54,5.35,1751,636,-1115,5361,1105,-4256,2918.0,3754.0,836.0,450000.0,0.0,-450000.0
<a href=/player/flynd001>flynd001</a>,Doug Flynn,New York Mets,METS,2,5,2,7,1981,1986,5,No,0,-0.02,4.68,4.7,485,655,170,913,2610,1697,596.0,0.0,-596.0,170000.0,0.0,-170000.0
<a href=/player/foggj001>foggj001</a>,Josh Fogg,Chicago White Sox,WSOX,1,3,2,5,2001,2002,1,No,0,9.76,-1.6,-11.36,587,29,-558,520,5,-515,4516.0,401.0,-4115.0,300000.0,0.0,-300000.0
<a href=/player/foilh101>foilh101</a>,Hank Foiles,Cleveland Indians,INDINS,19,29,31,60,1956,1984,28,No,0,66.93,53.91,-13.02,5439,5565,126,15838,18340,2502,4436.0,3464.0,-972.0,307350.0,0.0,-307350.0
<a href=/player/foilh101>foilh101</a>,Hank Foiles,Pittsburgh Pirates,PIRATS,1,3,1,4,1959,1961,2,No,0,-1.03,1.61,2.64,207,144,-63,561,494,-67,547.0,0.0,-547.0,0.0,0.0,0.0
<a href=/player/foilh101>foilh101</a>,Hank Foiles,Kansas City Athletics,ATLTCS,2,3,2,5,1960,1960,0,No,0,0.0,-0.84,-0.84,0,59,59,0,186,186,0.0,0.0,0.0,0.0,0.0,0.0
<a href=/player/foilh101>foilh101</a>,Hank Foiles,Pittsburgh Pirates,PIRATS,1,1,1,2,1960,1960,0,No,0,0.37,0.0,-0.37,24,0,-24,76,0,-76,0.0,0.0,0.0,0.0,0.0,0.0
<a href=/player/foilh101>foilh101</a>,Hank Foiles,Cleveland Indians,INDINS,1,1,2,3,1960,1960,0,No,0,0.09,-0.21,-0.3,26,42,16,61,127,66,0.0,0.0,0.0,0.0,0.0,0.0
<a href=/player/folet001>folet001</a>,Tom Foley,Cincinnati Reds,REDS,1,3,2,5,1985,1989,4,No,0,0.22,4.93,4.71,144,460,316,269,1695,1426,243.0,0.0,-243.0,117500.0,0.0,-117500.0
<a href=/player/folet001>folet001</a>,Tom Foley,Philadelphia Phillies,PHILS,2,4,4,8,1986,1987,1,No,0,2.35,0.09,-2.26,749,102,-647,1893,18,-1875,306.0,201.0,-105.0,635000.0,0.0,-635000.0
<a href=/player/folit001>folit001</a>,Tim Foli,New York Mets,METS,2,5,3,8,1972,1979,7,No,0,27.3,7.07,-20.23,2407,595,-1812,9387,2358,-7029,284.0,578.0,294.0,110000.0,0.0,-110000.0
<a href=/player/folit001>folit001</a>,Tim Foli,Montreal Expos,NATEX,2,3,2,5,1977,1985,8,No,0,-0.58,9.5,10.08,142,932,790,516,3359,2843,0.0,0.0,0.0,95000.0,0.0,-95000.0
<a href=/player/folit001>folit001</a>,Tim Foli,New York Mets,METS,2,3,3,6,1979,1981,2,No,0,2.69,-0.73,-3.42,413,378,-35,1617,1583,-34,0.0,0.0,0.0,195000.0,0.0,-195000.0
<a href=/player/folit001>folit001</a>,Tim Foli,Pittsburgh Pirates,PIRATS,6,11,12,23,1981,2001,20,No,2,29.01,21.11,-7.9,1089,1851,762,2045,2799,754,5314.0,7059.0,1745.0,1290000.0,0.0,-1290000.0
<a href=/player/folit001>folit001</a>,Tim Foli,California Angels,ANGELS,1,1,2,3,1983,1983,0,No,0,-0.39,0.0,0.39,61,0,-61,172,0,-172,0.0,0.0,0.0,0.0,0.0,0.0
<a href=/player/folit001>folit001</a>,Tim Foli,New York Yankees,YANKS,3,7,5,12,1984,1989,5,No,0,23.0,1.52,-21.48,1607,253,-1354,6240,680,-5560,0.0,0.0,0.0,2062000.0,0.0,-2062000.0
<a href=/player/folkr101>folkr101</a>,Rich Folkers,New York Mets,METS,1,4,4,8,1971,1975,4,No,0,1.94,1.36,-0.58,244,340,96,49,280,231,763.0,880.0,117.0,0.0,0.0,0.0
<a href=/player/folkr101>folkr101</a>,Rich Folkers,St. Louis Cardinals,CARDS,4,7,5,12,1974,1976,2,No,0,2.63,1.37,-1.26,416,126,-290,619,461,-158,1142.0,0.0,-1142.0,0.0,0.0,0.0
<a href=/player/folkr101>folkr101</a>,Rich Folkers,Milwaukee Brewers,BREWRS,1,2,1,3,1977,1986,9,No,0,2.06,21.52,19.46,58,1149,1091,0,4658,4658,821.0,0.0,-821.0,45000.0,0.0,-45000.0
<a href=/player/foltm001>foltm001</a>,Mike Foltynewicz,Houston Astros,ASTROS,2,4,3,7,2015,2018,3,Yes,0,4.87,5.33,0.46,316,563,247,420,1880,1460,2027.0,215.0,-1812.0,0.0,0.0,0.0
<a href=/player/fondd101>fondd101</a>,Dee Fondy,Brooklyn Dodgers,DOGRS,1,2,2,4,1950,1951,1,No,0,4.4,0.0,-4.4,849,35,-814,3484,35,-3449,0.0,0.0,0.0,0.0,0.0,0.0
<a href=/player/fondd101>fondd101</a>,Dee Fondy,Chicago Cubs,CUBS,4,7,6,13,1957,1961,4,No,0,9.53,8.89,-0.64,897,921,24,1516,3331,1815,802.0,0.0,-802.0,17500.0,0.0,-17500.0
<a href=/player/fondd101>fondd101</a>,Dee Fondy,Pittsburgh Pirates,PIRATS,2,2,3,5,1957,1959,2,No,0,-0.1,0.64,0.74,201,169,-32,449,473,24,0.0,0.0,0.0,0.0,0.0,0.0
<a href=/player/fonsl101>fonsl101</a>,Lew Fonseca,Cleveland Indians,INDINS,1,1,1,2,1931,1935,4,No,0,0.72,8.34,7.62,163,522,359,614,2094,1480,3.0,0.0,-3.0,10000.0,0.0,-10000.0
<a href=/player/fontj001>fontj001</a>,Joe Fontenot,San Francisco Giants,GIANTS,1,3,1,4,1997,2004,7,No,0,-0.78,10.35,11.13,14,712,698,11,6,-5,128.0,1135.0,1007.0,0.0,0.0,0.0
<a href=/player/fontm001>fontm001</a>,Mike Fontenot,Baltimore Orioles,ORLS,1,3,2,5,2005,2005,0,No,0,4.2,-1.01,-5.21,574,102,-472,1675,424,-1251,0.0,0.0,0.0,0.0,0.0,0.0
<a href=/player/fontm001>fontm001</a>,Mike Fontenot,Chicago Cubs,CUBS,1,1,1,2,2010,2010,0,No,0,0.38,0.0,-0.38,113,0,-113,328,0,-328,0.0,0.0,0.0,1000000.0,0.0,-1000000.0
<a href=/player/fontr001>fontr001</a>,Ray Fontenot,Texas Rangers,RNGRS,1,4,4,8,1979,1985,6,No,0,12.8,8.35,-4.45,488,521,33,1323,2076,753,918.0,0.0,-918.0,475000.0,0.0,-475000.0
<a href=/player/fontr001>fontr001</a>,Ray Fontenot,New York Yankees,YANKS,15,35,29,64,1984,2001,17,No,2,51.54,46.2,-5.34,4234,4156,-78,12356,13647,1291,8714.0,1911.0,-6803.0,3498873.0,0.0,-3498873.0
<a href=/player/fontr001>fontr001</a>,Ray Fontenot,Chicago Cubs,CUBS,1,3,2,5,1986,1987,1,No,0,-0.8,-0.88,-0.08,87,76,-11,1,2,1,373.0,157.0,-216.0,873333.0,0.0,-873333.0
<a href=/player/fontw001>fontw001</a>,Wilmer Font,Los Angeles Dodgers,DOGRS,1,1,1,2,2018,2018,0,Yes,0,-0.3,0.0,0.3,4,0,-4,0,0,0,20.0,0.0,-20.0,0.0,0.0,0.0
<a href=/player/fontw001>fontw001</a>,Wilmer Font,Oakland Athletics,ATLTCS,1,1,1,2,2018,2018,0,Yes,0,0.96,0.0,-0.96,21,0,-21,0,0,0,123.0,0.0,-123.0,0.0,0.0,0.0
<a href=/player/fontw001>fontw001</a>,Wilmer Font,Tampa Bay Devil Rays,RAYS,1,1,1,2,2019,2019,0,Yes,0,0.31,0.0,-0.31,29,0,-29,4,0,-4,93.0,0.0,-93.0,560400.0,0.0,-560400.0
<a href=/player/fonvc001>fonvc001</a>,Chad Fonville,Los Angeles Dodgers,DOGRS,1,1,1,2,1997,1997,0,No,0,-0.06,0.61,0.67,9,26,17,11,85,74,0.0,0.0,0.0,240000.0,0.0,-240000.0
<a href=/player/foorj101>foorj101</a>,Jim Foor,Detroit Tigers,TIGRS,2,5,2,7,1972,1975,3,No,0,-0.09,-0.55,-0.46,97,196,99,191,508,317,4.0,0.0,-4.0,88300.0,0.0,-88300.0
<a href=/player/foorj101>foorj101</a>,Jim Foor,Pittsburgh Pirates,PIRATS,4,4,4,8,1974,1983,9,No,0,-0.85,6.88,7.73,131,845,714,293,2739,2446,92.0,0.0,-92.0,0.0,0.0,0.0
<a href=/player/footb101>footb101</a>,Barry Foote,Montreal Expos,NATEX,1,2,2,4,1977,1979,2,No,0,-0.51,-1.74,-1.23,63,126,63,93,101,8,11.0,753.0,742.0,0.0,0.0,0.0
<a href=/player/footb101>footb101</a>,Barry Foote,Philadelphia Phillies,PHILS,7,17,13,30,1979,1999,20,No,0,25.6,38.01,12.41,2807,3562,755,9986,9588,-398,522.0,1259.0,737.0,2950000.0,0.0,-2950000.0
<a href=/player/footb101>footb101</a>,Barry Foote,Chicago Cubs,CUBS,1,1,2,3,1981,1984,3,No,0,-0.42,-0.25,0.17,57,16,-41,187,13,-174,0.0,122.0,122.0,0.0,0.0,0.0
<a href=/player/foppj001>foppj001</a>,Jesse Foppert,San Francisco Giants,GIANTS,1,2,1,3,2005,2009,4,No,0,0.09,12.27,12.18,42,666,624,119,2799,2680,0.0,0.0,0.0,715000.0,0.0,-715000.0
<a href=/player/fordb001>fordb001</a>,Brook Fordyce,Cincinnati Reds,REDS,3,7,4,11,1999,2013,14,No,0,21.42,15.9,-5.52,841,1440,599,3176,3953,777,381.0,721.0,340.0,8282695.0,0.0,-8282695.0
<a href=/player/fordb001>fordb001</a>,Brook Fordyce,Chicago White Sox,WSOX,2,5,4,9,2000,2001,1,No,2,0.13,0.48,0.35,312,100,-212,1036,320,-716,0.0,0.0,0.0,675000.0,0.0,-675000.0
<a href=/player/fordb002>fordb002</a>,Ben Ford,Arizona Diamondbacks,DBACKS,1,2,2,4,1999,2000,1,No,0,-0.22,0.28,0.5,4,102,98,0,2,2,33.0,165.0,132.0,0.0,0.0,0.0
<a href=/player/fordb002>fordb002</a>,Ben Ford,New York Yankees,YANKS,5,7,6,13,2000,2007,7,No,0,-0.77,1.65,2.42,50,219,169,84,143,59,190.0,789.0,599.0,6000000.0,0.0,-6000000.0
<a href=/player/fordc001>fordc001</a>,Curt Ford,St. Louis Cardinals,CARDS,1,2,1,3,1988,1992,4,No,0,-1.2,10.67,11.87,295,514,219,652,1641,989,0.0,0.0,0.0,340000.0,0.0,-340000.0
<a href=/player/fordd001>fordd001</a>,Dan Ford,Oakland Athletics,ATLTCS,1,2,1,3,1974,1974,0,No,0,6.81,0.02,-6.79,570,73,-497,2213,113,-2100,0.0,0.0,0.0,0.0,0.0,0.0
<a href=/player/fordd001>fordd001</a>,Dan Ford,Minnesota Twins,TWINS,2,2,3,5,1978,1982,4,No,0,4.65,1.22,-3.43,335,538,203,1390,1811,421,0.0,0.0,0.0,260000.0,0.0,-260000.0
<a href=/player/fordd001>fordd001</a>,Dan Ford,California Angels,ANGELS,1,1,2,3,1982,1987,5,No,0,1.16,18.92,17.76,279,787,508,1083,3268,2185,0.0,0.0,0.0,0.0,0.0,0.0
<a href=/player/fordd002>fordd002</a>,Darren Ford,Milwaukee Brewers,BREWRS,1,2,1,3,2008,2008,0,No,0,0.19,0.68,0.49,33,41,8,16,122,106,0.0,0.0,0.0,0.0,0.0,0.0
<a href=/player/fordh101>fordh101</a>,Hod Ford,Boston Braves,BRAVES,2,3,2,5,1923,1926,3,No,0,-0.57,0.9,1.47,238,272,34,860,1042,182,0.0,0.0,0.0,6000.0,0.0,-6000.0
<a href=/player/fordh101>fordh101</a>,Hod Ford,Brooklyn Dodgers,DOGRS,3,9,3,12,1926,1934,8,No,0,0.53,8.67,8.14,100,822,722,99,3036,2937,677.0,0.0,-677.0,30000.0,0.0,-30000.0
<a href=/player/fordl001>fordl001</a>,Lew Ford,Boston Red Sox,RSOX,1,1,1,2,2000,2000,0,No,0,8.34,-0.35,-8.69,494,8,-486,1716,0,-1716,0.0,20.0,20.0,0.0,0.0,0.0
<a href=/player/fordm002>fordm002</a>,Mike Ford,New York Yankees,YANKS,1,1,2,3,2021,2021,0,Yes,0,0.0,0.0,0.0,0,0,0,0,0,0,0.0,0.0,0.0,0.0,0.0,0.0
<a href=/player/fordt102>fordt102</a>,Ted Ford,Cleveland Indians,INDINS,4,7,5,12,1972,1974,2,No,0,5.19,0.53,-4.66,551,289,-262,1523,884,-639,0.0,0.0,0.0,19750.0,0.0,-19750.0
<a href=/player/fordt102>fordt102</a>,Ted Ford,Texas Rangers,RNGRS,3,5,3,8,1973,1977,4,No,0,-2.28,-0.02,2.26,64,49,-15,44,0,-44,759.0,568.0,-191.0,0.0,0.0,0.0
<a href=/player/fordt102>fordt102</a>,Ted Ford,Cleveland Indians,INDINS,2,2,2,4,1974,1974,0,No,0,-0.2,0.0,0.2,3,0,-3,0,0,0,17.0,0.0,-17.0,0.0,0.0,0.0
<a href=/player/fornm101>fornm101</a>,Mike Fornieles,Washington Senators,TWINS,1,1,1,2,1952,1958,6,No,0,1.73,6.58,4.85,175,395,220,100,355,255,891.0,2953.0,2062.0,0.0,0.0,0.0
<a href=/player/fornm101>fornm101</a>,Mike Fornieles,Chicago White Sox,WSOX,2,5,3,8,1956,1961,5,No,0,20.82,6.19,-14.63,1000,561,-439,2990,1443,-1547,2136.0,479.0,-1657.0,62000.0,0.0,-62000.0
<a href=/player/fornm101>fornm101</a>,Mike Fornieles,Baltimore Orioles,ORLS,24,45,44,89,1957,1994,37,No,3,77.0,128.75,51.75,5322,7060,1738,10378,16155,5777,18786.0,18781.0,-5.0,880833.0,0.0,-880833.0
<a href=/player/forsb001>forsb001</a>,Bob Forsch,St. Louis Cardinals,CARDS,1,1,1,2,1988,1990,2,No,0,-2.33,-1.07,1.26,86,166,80,38,290,252,408.0,0.0,-408.0,400000.0,0.0,-400000.0
<a href=/player/forsk001>forsk001</a>,Ken Forsch,Houston Astros,ASTROS,1,1,1,2,1981,1987,6,No,0,7.98,16.04,8.06,100,566,466,0,2013,2013,1901.0,0.0,-1901.0,0.0,0.0,0.0
<a href=/player/forsl001>forsl001</a>,Logan Forsythe,San Diego Padres,PADRS,5,10,9,19,2014,2019,5,Yes,0,13.64,2.43,-11.21,896,526,-370,1526,1044,-482,2446.0,524.0,-1922.0,2925000.0,0.0,-2925000.0
<a href=/player/forsl001>forsl001</a>,Logan Forsythe,Tampa Bay Devil Rays,RAYS,2,2,2,4,2017,2019,2,No,0,0.58,-0.14,-0.72,212,5,-207,655,0,-655,73.0,20.0,-53.0,558000.0,0.0,-558000.0
<a href=/player/forsl001>forsl001</a>,Logan Forsythe,Los Angeles Dodgers,DOGRS,1,3,1,4,2018,2018,0,No,0,0.86,0.11,-0.75,69,47,-22,205,170,-35,209.0,0.0,-209.0,9000000.0,0.0,-9000000.0
<a href=/player/forst001>forst001</a>,Terry Forster,Chicago White Sox,WSOX,2,5,3,8,1976,1978,2,No,0,7.3,2.34,-4.96,434,159,-275,257,599,342,2388.0,97.0,-2291.0,0.0,0.0,0.0
<a href=/player/fortb001>fortb001</a>,Bartolome Fortunato,Tampa Bay Devil Rays,RAYS,9,12,17,29,2004,2020,16,Yes,0,1.53,40.6,39.07,1161,1574,413,1626,3513,1887,2118.0,4281.0,2163.0,9958000.0,0.0,-9958000.0
<a href=/player/fortt001>fortt001</a>,Tim Fortugno,Seattle Mariners,MARNRS,5,8,8,16,1987,1993,6,No,0,24.41,5.5,-18.91,1467,818,-649,2406,1901,-505,2994.0,1198.0,-1796.0,7690000.0,0.0,-7690000.0
<a href=/player/fortt001>fortt001</a>,Tim Fortugno,Chicago White Sox,WSOX,6,9,10,19,1995,2008,13,No,0,-3.17,23.46,26.63,359,1502,1143,866,3855,2989,1206.0,2082.0,876.0,3255000.0,0.0,-3255000.0
<a href=/player/fosnj101>fosnj101</a>,Jerry Fosnow,Minnesota Twins,TWINS,1,1,1,2,1967,1967,0,No,0,0.0,0.0,0.0,0,0,0,0,0,0,0.0,0.0,0.0,0.0,0.0,0.0
<a href=/player/fossc001>fossc001</a>,Casey Fossum,Boston Red Sox,RSOX,1,4,1,5,2003,2008,5,No,0,0.73,17.72,16.99,728,123,-605,51,11,-40,1381.0,2025.0,644.0,634000.0,0.0,-634000.0
<a href=/player/fossc001>fossc001</a>,Casey Fossum,Arizona Diamondbacks,DBACKS,2,3,4,7,2005,2005,0,No,0,-1.0,-1.33,-0.33,113,64,-49,18,245,227,1106.0,0.0,-1106.0,4000000.0,0.0,-4000000.0
<a href=/player/fossl101>fossl101</a>,Larry Foss,New York Mets,METS,5,10,6,16,1963,1970,7,No,0,3.02,5.7,2.68,629,656,27,1532,2354,822,1019.0,0.0,-1019.0,88000.0,0.0,-88000.0
<a href=/player/fossr101>fossr101</a>,Ray Fosse,Cleveland Indians,INDINS,20,30,42,72,1973,2011,38,No,4,72.79,84.56,11.77,3663,5000,1337,11714,16048,4334,6999.0,9590.0,2591.0,1767500.0,0.0,-1767500.0
<a href=/player/fossr101>fossr101</a>,Ray Fosse,Cleveland Indians,INDINS,3,3,4,7,1977,1979,2,No,0,-0.25,-1.05,-0.8,53,14,-39,36,0,-36,273.0,138.0,-135.0,75000.0,0.0,-75000.0
<a href=/player/fosta101>fosta101</a>,Alan Foster,Los Angeles Dodgers,DOGRS,1,2,1,3,1970,1972,2,No,0,4.26,1.8,-2.46,259,141,-118,136,432,296,1602.0,0.0,-1602.0,10000.0,0.0,-10000.0
<a href=/player/fosta101>fosta101</a>,Alan Foster,Cleveland Indians,INDINS,8,13,14,27,1971,1984,13,No,0,47.87,7.93,-39.94,2666,2447,-219,9920,8254,-1666,38.0,317.0,279.0,169250.0,0.0,-169250.0
<a href=/player/fosta101>fosta101</a>,Alan Foster,St. Louis Cardinals,CARDS,4,7,5,12,1974,1976,2,No,0,2.63,1.37,-1.26,416,126,-290,619,461,-158,1142.0,0.0,-1142.0,0.0,0.0,0.0
<a href=/player/foste103>foste103</a>,Eddie Foster,Washington Senators,TWINS,3,6,5,11,1919,1926,7,No,0,13.31,20.32,7.01,1029,562,-467,3656,1370,-2286,534.0,3052.0,2518.0,16400.0,0.0,-16400.0
<a href=/player/foste103>foste103</a>,Eddie Foster,Rochester,Rochester,2,4,5,9,1911,1913,2,No,0,29.68,0.0,-29.68,1807,0,-1807,7810,0,-7810,0.0,0.0,0.0,0.0,0.0,0.0
<a href=/player/fostg001>fostg001</a>,George Foster,San Francisco Giants,GIANTS,2,3,3,6,1971,1973,2,No,0,79.67,-1.11,-80.78,2234,113,-2121,7887,106,-7781,3392.0,613.0,-2779.0,84000.0,0.0,-84000.0
<a href=/player/fostg001>fostg001</a>,George Foster,Cincinnati Reds,REDS,3,3,6,9,1982,1988,6,No,0,4.34,2.59,-1.75,680,544,-136,2644,847,-1797,86.0,981.0,895.0,0.0,0.0,0.0
<a href=/player/fostj001>fostj001</a>,John Foster,Atlanta Braves,BRAVES,3,7,4,11,2002,2005,3,No,0,48.76,10.76,-38.0,1789,404,-1385,2230,926,-1304,9304.0,204.0,-9100.0,4218000.0,0.0,-4218000.0
<a href=/player/fostk001>fostk001</a>,Kevin Foster,Montreal Expos,NATEX,1,2,2,4,1992,1993,1,No,0,-0.6,-0.77,-0.17,3,95,92,0,242,242,7.0,0.0,-7.0,0.0,0.0,0.0
<a href=/player/fostk001>fostk001</a>,Kevin Foster,Seattle Mariners,MARNRS,1,1,1,2,1993,1993,0,No,0,-0.42,0.35,0.77,4,14,10,2,0,-2,20.0,59.0,39.0,0.0,0.0,0.0
<a href=/player/fostk001>fostk001</a>,Kevin Foster,Philadelphia Phillies,PHILS,2,2,2,4,1994,1994,0,No,0,3.18,-0.16,-3.34,187,37,-150,193,30,-163,1464.0,253.0,-1211.0,0.0,0.0,0.0
<a href=/player/fostk002>fostk002</a>,Kris Foster,Montreal Expos,NATEX,1,1,1,2,1995,1995,0,No,0,0.0,0.0,0.0,0,0,0,0,0,0,0.0,0.0,0.0,0.0,0.0,0.0
<a href=/player/fostk002>fostk002</a>,Kris Foster,Los Angeles Dodgers,DOGRS,1,2,1,3,2001,2002,1,No,0,1.42,-0.47,-1.89,279,38,-241,871,0,-871,30.0,70.0,40.0,0.0,0.0,0.0
<a href=/player/fostl101>fostl101</a>,Leo Foster,Atlanta Braves,BRAVES,1,1,1,2,1975,1980,5,No,0,-0.05,-0.77,-0.72,60,267,207,148,635,487,0.0,0.0,0.0,0.0,0.0,0.0
<a href=/player/fostl101>fostl101</a>,Leo Foster,New York Mets,METS,1,1,1,2,1978,1978,0,No,0,0.0,0.0,0.0,0,0,0,0,0,0,0.0,0.0,0.0,0.0,0.0,0.0
<a href=/player/fostr101>fostr101</a>,Roy Foster,Milwaukee Brewers,BREWRS,1,3,2,5,1970,1971,1,No,0,1.89,-2.52,-4.41,337,186,-151,1153,421,-732,0.0,0.0,0.0,0.0,0.0,0.0
<a href=/player/fostr101>fostr101</a>,Roy Foster,Cleveland Indians,INDINS,6,11,10,21,1971,1978,7,No,0,26.06,8.28,-17.78,1542,586,-956,3690,1786,-1904,2427.0,1183.0,-1244.0,83000.0,0.0,-83000.0
<a href=/player/fostr101>fostr101</a>,Roy Foster,Texas Rangers,RNGRS,4,7,4,11,1972,1977,5,No,0,0.46,2.24,1.78,334,178,-156,834,481,-353,759.0,568.0,-191.0,0.0,0.0,0.0
<a href=/player/fostr103>fostr103</a>,Rube Foster,Boston Red Sox,RSOX,1,1,1,2,1918,1918,0,No,0,0.0,2.46,2.46,0,115,115,0,504,504,0.0,0.0,0.0,0.0,0.0,0.0
<a href=/player/fothb101>fothb101</a>,Bob Fothergill,Chicago White Sox,WSOX,2,7,3,10,1932,1936,4,No,0,0.81,-0.11,-0.92,234,49,-185,748,93,-655,0.0,39.0,39.0,8600.0,0.0,-8600.0
<a href=/player/foucs101>foucs101</a>,Steve Foucault,Texas Rangers,RNGRS,2,3,3,6,1977,1978,1,No,0,2.75,1.73,-1.02,156,216,60,186,786,600,932.0,0.0,-932.0,0.0,0.0,0.0
<a href=/player/foulk001>foulk001</a>,Keith Foulke,San Francisco Giants,GIANTS,4,11,8,19,1997,2001,4,No,4,22.98,0.1,-22.88,1111,210,-901,1153,268,-885,2846.0,875.0,-1971.0,0.0,0.0,0.0
<a href=/player/foulk001>foulk001</a>,Keith Foulke,Chicago White Sox,WSOX,4,7,9,16,2002,2011,9,No,0,3.51,0.6,-2.91,386,338,-48,35,47,12,766.0,905.0,139.0,11095000.0,0.0,-11095000.0
<a href=/player/fourj101>fourj101</a>,Jack Fournier,St. Louis Cardinals,CARDS,1,1,2,3,1923,1925,2,No,0,18.82,0.02,-18.8,519,141,-378,2176,488,-1688,0.0,0.0,0.0,0.0,0.0,0.0
<a href=/player/fowla101>fowla101</a>,Art Fowler,Cincinnati Reds,REDS,1,4,1,5,1958,1960,2,No,0,0.85,9.64,8.79,265,190,-75,151,233,82,590.0,1314.0,724.0,14000.0,0.0,-14000.0
<a href=/player/fowld001>fowld001</a>,Dexter Fowler,Colorado Rockies,ROCKS,1,2,2,4,2013,2017,4,No,0,1.79,-0.75,-2.54,116,493,377,505,787,282,0.0,843.0,843.0,4250000.0,0.0,-4250000.0
<a href=/player/fowld001>fowld001</a>,Dexter Fowler,Houston Astros,ASTROS,2,2,3,5,2015,2016,1,No,0,6.42,4.27,-2.15,281,241,-40,1241,865,-376,0.0,53.0,53.0,0.0,0.0,0.0
<a href=/player/fowld001>fowld001</a>,Dexter Fowler,St. Louis Cardinals,CARDS,1,1,1,2,2021,2021,0,No,0,-0.18,0.0,0.18,7,0,-7,21,0,-21,0.0,0.0,0.0,0.0,0.0,0.0
<a href=/player/fowld002>fowld002</a>,Dustin Fowler,New York Yankees,YANKS,4,8,7,15,2017,2021,4,No,0,10.37,1.61,-8.76,335,144,-191,733,363,-370,1504.0,587.0,-917.0,0.0,0.0,0.0
<a href=/player/fowlj101>fowlj101</a>,Jesse Fowler,St. Louis Cardinals,CARDS,1,5,1,6,1924,1925,1,No,0,0.0,0.0,0.0,0,0,0,0,0,0,0.0,0.0,0.0,0.0,0.0,0.0
<a href=/player/fox-a001>fox-a001</a>,Andy Fox,New York Yankees,YANKS,1,1,2,3,1998,2000,2,No,0,1.58,0.19,-1.39,269,23,-246,974,1,-973,0.0,102.0,102.0,0.0,0.0,0.0
<a href=/player/fox-a001>fox-a001</a>,Andy Fox,Arizona Diamondbacks,DBACKS,1,1,1,2,2000,2004,4,No,0,-0.72,-0.42,0.3,326,456,130,905,1595,690,0.0,0.0,0.0,750000.0,0.0,-750000.0
<a href=/player/fox-c001>fox-c001</a>,Chad Fox,Cincinnati Reds,REDS,2,3,2,5,1996,1997,1,No,0,0.1,0.89,0.79,322,92,-230,303,211,-92,259.0,0.0,-259.0,175000.0,0.0,-175000.0
<a href=/player/fox-c001>fox-c001</a>,Chad Fox,Atlanta Braves,BRAVES,6,8,7,15,1997,2013,16,No,3,7.34,5.15,-2.19,833,397,-436,1023,756,-267,2016.0,173.0,-1843.0,468500.0,0.0,-468500.0
<a href=/player/fox-h101>fox-h101</a>,Howie Fox,Cincinnati Reds,REDS,8,16,22,38,1951,1965,14,No,0,82.9,22.04,-60.86,4576,2061,-2515,14654,4760,-9894,2749.0,1025.0,-1724.0,63000.0,0.0,-63000.0
<a href=/player/fox-j001>fox-j001</a>,Jake Fox,Chicago Cubs,CUBS,1,2,3,5,2009,2010,1,No,0,-0.2,-0.27,-0.07,39,14,-25,106,0,-106,0.0,28.0,28.0,2601500.0,0.0,-2601500.0
<a href=/player/fox-j001>fox-j001</a>,Jake Fox,Oakland Athletics,ATLTCS,1,1,1,2,2010,2010,0,No,0,-0.09,0.02,0.11,65,11,-54,172,0,-172,0.0,38.0,38.0,405000.0,0.0,-405000.0
<a href=/player/fox-n101>fox-n101</a>,Nellie Fox,Philadelphia Athletics,ATLTCS,1,1,1,2,1949,1952,3,No,0,47.44,2.72,-44.72,2115,159,-1956,9493,556,-8937,0.0,0.0,0.0,0.0,0.0,0.0
<a href=/player/fox-n101>fox-n101</a>,Nellie Fox,Chicago White Sox,WSOX,6,8,9,17,1963,1976,13,No,0,-0.96,0.85,1.81,821,928,107,1588,1829,241,489.0,1217.0,728.0,27000.0,0.0,-27000.0
<a href=/player/fox-p101>fox-p101</a>,George Fox,Pittsburgh Pirates,PIRATS,4,11,16,27,1899,1914,15,No,0,23.91,73.99,50.08,1271,3182,1911,4723,12859,8136,1693.0,797.0,-896.0,5000.0,0.0,-5000.0
<a href=/player/fox-t101>fox-t101</a>,Terry Fox,Milwaukee Braves,BRAVES,1,4,2,6,1960,1966,6,No,0,17.87,5.81,-12.06,1212,765,-447,3111,2935,-176,1033.0,0.0,-1033.0,0.0,0.0,0.0
<a href=/player/foxeb101>foxeb101</a>,Bill Foxen,Philadelphia Phillies,PHILS,1,1,1,2,1910,1920,10,No,0,-0.13,19.94,20.07,10,1311,1301,7,5308,5301,53.0,0.0,-53.0,0.0,0.0,0.0
<a href=/player/foxxj101>foxxj101</a>,Jimmie Foxx,Philadelphia Athletics,ATLTCS,1,2,3,5,1935,1936,1,No,0,40.03,-0.08,-40.11,1089,70,-1019,4170,77,-4093,1354.0,649.0,-705.0,5500.0,0.0,-5500.0
<a href=/player/foy-j101>foy-j101</a>,Joe Foy,Kansas City Royals,ROYALS,4,8,8,16,1969,1983,14,No,1,4.64,75.25,70.61,681,3547,2866,1069,13423,12354,1583.0,2330.0,747.0,59500.0,0.0,-59500.0
<a href=/player/foytp101>foytp101</a>,Paul Foytack,Detroit Tigers,TIGRS,2,5,3,8,1963,1967,4,No,0,-0.97,-0.32,0.65,448,297,-151,1059,675,-384,218.0,314.0,96.0,32800.0,0.0,-32800.0
<a href=/player/fraik101>fraik101</a>,Ken Frailing,Chicago White Sox,WSOX,1,4,1,5,1973,1973,0,No,0,6.5,0.0,-6.5,800,0,-800,1477,0,-1477,2061.0,0.0,-2061.0,32700.0,0.0,-32700.0
<a href=/player/fralj001>fralj001</a>,Jake Fraley,Tampa Bay Devil Rays,RAYS,2,3,5,8,2018,2021,3,Yes,0,0.34,0.28,-0.06,245,235,-10,948,604,-344,0.0,88.0,88.0,0.0,0.0,0.0
<a href=/player/franb001>franb001</a>,Ben Francisco,Cleveland Indians,INDINS,6,12,19,31,2009,2021,12,Yes,0,33.76,50.43,16.67,987,1821,834,2686,3190,504,3042.0,8206.0,5164.0,29385300.0,0.0,-29385300.0
<a href=/player/franb001>franb001</a>,Ben Francisco,Philadelphia Phillies,PHILS,1,1,1,2,2011,2011,0,No,0,-0.13,0.0,0.13,27,0,-27,54,0,-54,0.0,0.0,0.0,1175000.0,0.0,-1175000.0
<a href=/player/franb001>franb001</a>,Ben Francisco,Toronto Blue Jays,BJAYS,4,12,6,18,2012,2016,4,No,0,10.83,2.99,-7.84,1068,309,-759,3494,605,-2889,904.0,1431.0,527.0,11237500.0,0.0,-11237500.0
<a href=/player/franb001>franb001</a>,Ben Francisco,Houston Astros,ASTROS,1,1,1,2,2012,2012,0,No,0,-0.14,0.0,0.14,24,0,-24,63,0,-63,0.0,0.0,0.0,0.0,0.0,0.0
<a href=/player/frane001>frane001</a>,Enderson Franco,Tampa Bay Devil Rays,RAYS,1,1,1,2,2015,2015,0,No,0,0.0,0.0,0.0,0,0,0,0,0,0,0.0,0.0,0.0,0.0,0.0,0.0
<a href=/player/frane101>frane101</a>,Earl Francis,Pittsburgh Pirates,PIRATS,6,10,11,21,1964,1973,9,No,0,-1.2,0.41,1.61,81,41,-40,182,35,-147,16.0,36.0,20.0,17500.0,0.0,-17500.0
<a href=/player/franf001>franf001</a>,Frank Francisco,Boston Red Sox,RSOX,1,2,1,3,2002,2003,1,No,0,-0.26,-0.75,-0.49,4,24,20,0,0,0,11.0,67.0,56.0,0.0,0.0,0.0
<a href=/player/franf001>franf001</a>,Frank Francisco,Chicago White Sox,WSOX,1,3,1,4,2003,2003,0,No,0,5.54,2.04,-3.5,375,73,-302,0,289,289,1248.0,0.0,-1248.0,0.0,0.0,0.0
<a href=/player/franf001>franf001</a>,Frank Francisco,Texas Rangers,RNGRS,1,1,1,2,2011,2012,1,No,0,1.11,7.29,6.18,58,221,163,0,849,849,152.0,0.0,-152.0,0.0,0.0,0.0
<a href=/player/franf101>franf101</a>,Fred Frankhouse,St. Louis Cardinals,CARDS,3,4,5,9,1930,1932,2,No,0,17.17,7.22,-9.95,980,103,-877,1735,151,-1584,4684.0,1094.0,-3590.0,38000.0,0.0,-38000.0
<a href=/player/franf101>franf101</a>,Fred Frankhouse,Boston Braves,BRAVES,9,23,15,38,1936,1952,16,No,0,28.65,83.49,54.84,2053,3727,1674,6696,14179,7483,1839.0,2467.0,628.0,20000.0,0.0,-20000.0
<a href=/player/franf101>franf101</a>,Fred Frankhouse,Brooklyn Dodgers,DOGRS,1,1,1,2,1938,1939,1,No,0,0.42,0.0,-0.42,46,0,-46,8,0,-8,114.0,0.0,-114.0,0.0,0.0,0.0
<a href=/player/franj001>franj001</a>,John Franco,Los Angeles Dodgers,DOGRS,1,2,1,3,1983,1984,1,No,0,12.91,-0.97,-13.88,786,117,-669,22,124,102,1584.0,0.0,-1584.0,0.0,0.0,0.0
<a href=/player/franj001>franj001</a>,John Franco,Cincinnati Reds,REDS,9,13,18,31,1989,2006,17,No,0,19.53,23.14,3.61,2921,2149,-772,1877,4164,2287,4092.0,3999.0,-93.0,22668833.0,0.0,-22668833.0
<a href=/player/franj002>franj002</a>,Julio Franco,Philadelphia Phillies,PHILS,5,11,8,19,1982,1999,17,No,0,22.81,28.42,5.61,2142,1948,-194,7615,5685,-1930,390.0,1257.0,867.0,2950000.0,0.0,-2950000.0
<a href=/player/franj002>franj002</a>,Julio Franco,Cleveland Indians,INDINS,3,3,5,8,1988,1992,4,No,1,22.13,7.66,-14.47,821,782,-39,3317,3096,-221,0.0,0.0,0.0,1350000.0,0.0,-1350000.0
<a href=/player/franj003>franj003</a>,Jeff Francis,Oakland Athletics,ATLTCS,1,2,1,3,2014,2014,0,No,0,-0.03,0.0,0.03,2,0,-2,0,0,0,5.0,0.0,-5.0,0.0,0.0,0.0
<a href=/player/franj004>franj004</a>,Jeff Francoeur,Atlanta Braves,BRAVES,1,1,1,2,2009,2009,0,No,0,2.7,0.95,-1.75,199,44,-155,755,144,-611,0.0,0.0,0.0,3375000.0,0.0,-3375000.0
<a href=/player/franj004>franj004</a>,Jeff Francoeur,New York Mets,METS,1,2,1,3,2010,2010,0,No,0,0.25,-0.15,-0.4,15,22,7,56,33,-23,0.0,0.0,0.0,5000000.0,0.0,-5000000.0
<a href=/player/franj004>franj004</a>,Jeff Francoeur,Atlanta Braves,BRAVES,1,2,2,4,2016,2018,2,Yes,0,-0.25,0.0,0.25,26,0,-26,55,0,-55,0.0,0.0,0.0,0.0,0.0,0.0
<a href=/player/franj005>franj005</a>,Juan Francisco,Cincinnati Reds,REDS,1,1,1,2,2012,2016,4,No,0,0.47,0.73,0.26,128,453,325,320,1,-319,0.0,727.0,727.0,0.0,0.0,0.0
<a href=/player/franj005>franj005</a>,Juan Francisco,Atlanta Braves,BRAVES,1,1,1,2,2013,2013,0,Yes,0,-0.74,0.0,0.74,89,0,-89,270,0,-270,0.0,0.0,0.0,496250.0,0.0,-496250.0
<a href=/player/franm001>franm001</a>,Matt Franco,Chicago Cubs,CUBS,1,1,1,2,1996,1996,0,No,0,-0.56,0.0,0.56,454,0,-454,715,0,-715,4.0,0.0,-4.0,0.0,0.0,0.0
<a href=/player/franm002>franm002</a>,Micah Franklin,Cincinnati Reds,REDS,1,1,1,2,1994,1996,2,No,0,0.0,0.64,0.64,0,49,49,0,119,119,0.0,0.0,0.0,0.0,0.0,0.0
<a href=/player/franm002>franm002</a>,Micah Franklin,Detroit Tigers,TIGRS,1,2,2,4,1996,1996,0,No,0,0.33,-0.3,-0.63,17,16,-1,37,0,-37,0.0,71.0,71.0,0.0,0.0,0.0
<a href=/player/franm003>franm003</a>,Mike Frank,Cincinnati Reds,REDS,3,5,7,12,2000,2013,13,No,0,-0.66,18.6,19.26,193,851,658,524,1522,998,274.0,5192.0,4918.0,4750000.0,0.0,-4750000.0
<a href=/player/frann001>frann001</a>,Nick Franklin,Seattle Mariners,MARNRS,2,3,2,5,2014,2015,1,No,0,-0.74,1.5,2.24,145,161,16,417,684,267,3.0,0.0,-3.0,8210200.0,0.0,-8210200.0
<a href=/player/frann001>frann001</a>,Nick Franklin,Milwaukee Brewers,BREWRS,1,1,1,2,2017,2017,0,No,0,0.02,0.0,-0.02,13,0,-13,30,0,-30,0.0,0.0,0.0,0.0,0.0,0.0
<a href=/player/franr001>franr001</a>,Ryan Franklin,Philadelphia Phillies,PHILS,1,2,1,3,2006,2006,0,No,0,0.14,0.0,-0.14,40,0,-40,2,0,-2,73.0,0.0,-73.0,2600000.0,0.0,-2600000.0
<a href=/player/franr101>franr101</a>,Ray Francis,Washington Senators,TWINS,2,4,2,6,1922,1927,5,No,0,-0.61,-0.04,0.57,70,4,-66,21,5,-16,238.0,0.0,-238.0,2800.0,0.0,-2800.0
<a href=/player/franr101>franr101</a>,Ray Francis,Atlanta,Atlanta,1,1,1,2,1924,1924,0,No,0,-0.03,0.0,0.03,8,0,-8,0,0,0,15.0,0.0,-15.0,0.0,0.0,0.0
<a href=/player/franr101>franr101</a>,Ray Francis,New York Yankees,YANKS,1,2,2,4,1925,1925,0,No,0,-0.59,-1.49,-0.9,12,98,86,10,146,136,84.0,166.0,82.0,4000.0,0.0,-4000.0
<a href=/player/frant002>frant002</a>,Ty France,San Diego Padres,PADRS,1,4,3,7,2020,2021,1,Yes,0,5.43,0.42,-5.01,353,36,-317,1365,75,-1290,2.0,42.0,40.0,0.0,0.0,0.0
<a href=/player/frant101>frant101</a>,Tito Francona,Baltimore Orioles,ORLS,23,44,43,87,1957,1994,37,No,3,72.27,127.67,55.4,4749,6987,2238,10212,15857,5645,16859.0,18781.0,1922.0,880833.0,0.0,-880833.0
<a href=/player/frant101>frant101</a>,Tito Francona,Chicago White Sox,WSOX,14,22,25,47,1958,1969,11,No,0,14.88,32.86,17.98,2012,2738,726,3483,4385,902,3780.0,6927.0,3147.0,112250.0,0.0,-112250.0
<a href=/player/frant101>frant101</a>,Tito Francona,Detroit Tigers,TIGRS,1,1,1,2,1959,1959,0,No,0,11.39,-0.62,-12.01,835,18,-817,3298,64,-3234,0.0,0.0,0.0,0.0,0.0,0.0
<a href=/player/frant101>frant101</a>,Tito Francona,Oakland Athletics,ATLTCS,1,2,1,3,1970,1971,1,No,0,0.4,-0.79,-1.19,86,96,10,104,141,37,283.0,0.0,-283.0,62000.0,0.0,-62000.0
<a href=/player/franw001>franw001</a>,Wayne Franklin,Houston Astros,ASTROS,1,2,2,4,2002,2002,0,No,0,3.17,0.71,-2.46,341,21,-320,1022,77,-945,656.0,0.0,-656.0,0.0,0.0,0.0
<a href=/player/franw001>franw001</a>,Wayne Franklin,Milwaukee Brewers,BREWRS,1,2,2,4,2004,2010,6,No,0,-0.79,2.11,2.9,88,447,359,5,72,67,156.0,1275.0,1119.0,0.0,0.0,0.0
<a href=/player/frarc001>frarc001</a>,Caleb Frare,New York Yankees,YANKS,1,1,1,2,2018,2018,0,No,0,-0.07,0.0,0.07,16,0,-16,0,0,0,29.0,0.0,-29.0,0.0,0.0,0.0
<a href=/player/frasc101>frasc101</a>,Chick Fraser,Philadelphia Phillies,PHILS,1,2,1,3,1904,1904,0,No,0,3.87,0.0,-3.87,209,0,-209,665,0,-665,1001.0,0.0,-1001.0,0.0,0.0,0.0
<a href=/player/frasc101>frasc101</a>,Chick Fraser,Boston Braves,BRAVES,1,1,1,2,1906,1909,3,No,0,3.06,-3.49,-6.55,62,226,164,87,289,202,704.0,2354.0,1650.0,0.0,0.0,0.0
<a href=/player/frasc101>frasc101</a>,Chick Fraser,Cincinnati Reds,REDS,1,1,3,4,1906,1912,6,No,0,-1.15,0.0,1.15,98,0,-98,109,0,-109,911.0,0.0,-911.0,0.0,0.0,0.0
<a href=/player/frasj001>frasj001</a>,John Frascatore,St. Louis Cardinals,CARDS,1,1,1,2,1999,1999,0,No,0,0.25,-0.56,-0.81,51,6,-45,0,1,1,99.0,19.0,-80.0,0.0,0.0,0.0
<a href=/player/frasj001>frasj001</a>,John Frascatore,Arizona Diamondbacks,DBACKS,1,2,1,3,1999,2000,1,No,0,6.98,0.84,-6.14,434,187,-247,1364,1,-1363,379.0,185.0,-194.0,720000.0,0.0,-720000.0
<a href=/player/frasj002>frasj002</a>,Jason Frasor,Detroit Tigers,TIGRS,1,2,1,3,2002,2003,1,No,0,0.0,-0.66,-0.66,0,40,40,0,131,131,0.0,0.0,0.0,0.0,0.0,0.0
<a href=/player/frasj002>frasj002</a>,Jason Frasor,Los Angeles Dodgers,DOGRS,1,1,1,2,2004,2006,2,No,0,6.54,4.3,-2.24,539,191,-348,0,721,721,1514.0,0.0,-1514.0,0.0,0.0,0.0
<a href=/player/frasj002>frasj002</a>,Jason Frasor,Toronto Blue Jays,BJAYS,2,6,6,12,2011,2014,3,No,0,-0.73,6.64,7.37,396,443,47,89,1646,1557,842.0,15.0,-827.0,7829600.0,0.0,-7829600.0
<a href=/player/frasj002>frasj002</a>,Jason Frasor,Chicago White Sox,WSOX,2,2,3,5,2012,2016,4,Yes,0,0.35,-0.18,-0.53,54,100,46,0,0,0,131.0,330.0,199.0,0.0,0.0,0.0
<a href=/player/frasj002>frasj002</a>,Jason Frasor,Texas Rangers,RNGRS,2,2,2,4,2014,2015,1,Yes,0,0.87,-0.59,-1.46,85,38,-47,2,0,-2,187.0,100.0,-87.0,1750000.0,0.0,-1750000.0
<a href=/player/frasv101>frasv101</a>,Vic Frazier,Chicago White Sox,WSOX,1,1,1,2,1933,1936,3,No,0,-1.98,-0.72,1.26,56,164,108,52,74,22,381.0,631.0,250.0,0.0,0.0,0.0
<a href=/player/frasw001>frasw001</a>,Willie Fraser,California Angels,ANGELS,2,4,5,9,1990,1993,3,No,0,21.39,3.93,-17.46,688,442,-246,3033,1668,-1365,79.0,0.0,-79.0,1180000.0,0.0,-1180000.0
<a href=/player/fraza001>fraza001</a>,Adam Frazier,Pittsburgh Pirates,PIRATS,1,2,3,5,2021,2021,0,Yes,0,0.98,0.0,-0.98,57,0,-57,211,0,-211,0.0,0.0,0.0,4300000.0,0.0,-4300000.0
<a href=/player/frazc001>frazc001</a>,Clint Frazier,Cleveland Indians,INDINS,1,4,1,5,2016,2018,2,No,0,0.85,4.57,3.72,262,129,-133,807,2,-805,102.0,377.0,275.0,0.0,0.0,0.0
<a href=/player/frazg001>frazg001</a>,George Frazier,Milwaukee Brewers,BREWRS,2,2,2,4,1977,1981,4,No,0,3.1,0.61,-2.49,576,235,-341,1265,738,-527,232.0,3.0,-229.0,0.0,0.0,0.0
<a href=/player/frazg001>frazg001</a>,George Frazier,St. Louis Cardinals,CARDS,1,1,1,2,1981,1984,3,No,0,4.42,-0.35,-4.77,140,30,-110,0,17,17,764.0,0.0,-764.0,0.0,0.0,0.0
<a href=/player/frazg001>frazg001</a>,George Frazier,New York Yankees,YANKS,3,5,5,10,1984,1985,1,No,0,4.69,0.8,-3.89,612,147,-465,1490,453,-1037,133.0,0.0,-133.0,435000.0,0.0,-435000.0
<a href=/player/frazg001>frazg001</a>,George Frazier,Cleveland Indians,INDINS,14,24,30,54,1984,2001,17,No,1,109.74,66.95,-42.79,6226,4765,-1461,18678,17797,-881,7708.0,2241.0,-5467.0,19613332.0,0.0,-19613332.0
<a href=/player/frazg001>frazg001</a>,George Frazier,Chicago Cubs,CUBS,1,3,2,5,1986,1987,1,No,0,-0.8,-0.88,-0.08,87,76,-11,1,2,1,373.0,157.0,-216.0,873333.0,0.0,-873333.0
<a href=/player/frazj001>frazj001</a>,Jeff Frazier,Detroit Tigers,TIGRS,1,1,1,2,2007,2008,1,No,0,0.0,0.37,0.37,0,15,15,0,0,0,0.0,80.0,80.0,0.0,0.0,0.0
<a href=/player/frazj101>frazj101</a>,Joe Frazier,Cleveland Indians,INDINS,1,4,2,6,1947,1949,2,No,0,3.17,0.88,-2.29,606,121,-485,1943,303,-1640,368.0,217.0,-151.0,0.0,0.0,0.0
<a href=/player/frazj101>frazj101</a>,Joe Frazier,OklahomaCity,OklahomaCity,1,1,2,3,1953,1953,0,No,0,0.63,0.0,-0.63,153,0,-153,205,0,-205,0.0,0.0,0.0,0.0,0.0,0.0
<a href=/player/frazj101>frazj101</a>,Joe Frazier,St. Louis Cardinals,CARDS,2,3,2,5,1956,1957,1,No,0,0.94,-0.25,-1.19,322,29,-293,645,20,-625,0.0,0.0,0.0,0.0,0.0,0.0
<a href=/player/frazj101>frazj101</a>,Joe Frazier,Baltimore Orioles,ORLS,1,2,3,5,1959,1959,0,No,0,0.0,0.0,0.0,0,0,0,0,0,0,0.0,0.0,0.0,0.0,0.0,0.0
<a href=/player/frazl001>frazl001</a>,Lou Frazier,Houston Astros,ASTROS,1,1,1,2,1990,1990,0,No,0,0.0,0.0,0.0,0,0,0,0,0,0,0.0,0.0,0.0,0.0,0.0,0.0
<a href=/player/frazl001>frazl001</a>,Lou Frazier,Montreal Expos,NATEX,1,1,1,2,1995,1995,0,No,0,-0.09,0.0,0.09,79,0,-79,171,0,-171,0.0,0.0,0.0,165000.0,0.0,-165000.0
<a href=/player/frazt001>frazt001</a>,Todd Frazier,Cincinnati Reds,REDS,1,1,3,4,2015,2020,5,No,0,5.25,2.19,-3.06,239,951,712,1001,3322,2321,0.0,8.0,8.0,4500000.0,0.0,-4500000.0
<a href=/player/frazt001>frazt001</a>,Todd Frazier,Chicago White Sox,WSOX,2,4,5,9,2017,2017,0,Yes,0,4.16,0.5,-3.66,327,12,-315,241,0,-241,693.0,30.0,-663.0,12535000.0,0.0,-12535000.0
<a href=/player/frazt001>frazt001</a>,Todd Frazier,Texas Rangers,RNGRS,1,1,1,2,2020,2020,0,Yes,0,0.14,0.0,-0.14,15,0,-15,51,0,-51,3.0,0.0,-3.0,3500000.0,0.0,-3500000.0
<a href=/player/fredj101>fredj101</a>,Johnny Frederick,Brooklyn Dodgers,DOGRS,2,6,2,8,1934,1938,4,No,0,0.05,1.5,1.45,177,398,221,491,1389,898,0.0,3.0,3.0,0.0,0.0,0.0
<a href=/player/freed001>freed001</a>,David Freese,San Diego Padres,PADRS,1,1,1,2,2007,2008,1,No,0,6.71,-0.96,-7.67,466,26,-440,1755,103,-1652,0.0,0.0,0.0,0.0,0.0,0.0
<a href=/player/freed001>freed001</a>,David Freese,St. Louis Cardinals,CARDS,2,3,4,7,2013,2019,6,No,0,9.31,6.71,-2.6,948,777,-171,2847,1905,-942,577.0,194.0,-383.0,3662000.0,0.0,-3662000.0
<a href=/player/freed001>freed001</a>,David Freese,Pittsburgh Pirates,PIRATS,1,1,1,2,2018,2018,0,Yes,0,2.07,0.0,-2.07,98,0,-98,233,0,-233,0.0,0.0,0.0,4250000.0,0.0,-4250000.0
<a href=/player/freeg101>freeg101</a>,George Freese,Chicago Cubs,CUBS,7,18,16,34,1953,1965,12,No,0,5.64,21.93,16.29,1405,1825,420,3839,2173,-1666,1451.0,4951.0,3500.0,82000.0,0.0,-82000.0
<a href=/player/freeg101>freeg101</a>,George Freese,Portland,Portland,1,1,1,2,1960,1960,0,No,0,0.0,0.0,0.0,0,0,0,0,0,0,0.0,0.0,0.0,0.0,0.0,0.0
<a href=/player/freeg102>freeg102</a>,Gene Freese,Pittsburgh Pirates,PIRATS,2,3,3,6,1958,1972,14,No,0,-0.99,11.73,12.72,187,1201,1014,644,3448,2804,6.0,0.0,-6.0,0.0,0.0,0.0
<a href=/player/freeg102>freeg102</a>,Gene Freese,St. Louis Cardinals,CARDS,1,1,1,2,1958,1958,0,No,0,1.94,0.0,-1.94,132,0,-132,457,0,-457,0.0,0.0,0.0,0.0,0.0,0.0
<a href=/player/freeg102>freeg102</a>,Gene Freese,Philadelphia Phillies,PHILS,5,9,9,18,1959,1984,25,No,0,31.72,53.95,22.23,1846,3261,1415,6839,7928,1089,0.0,2963.0,2963.0,0.0,0.0,0.0
<a href=/player/freeg102>freeg102</a>,Gene Freese,Chicago White Sox,WSOX,2,2,3,5,1960,1978,18,No,0,1.62,65.42,63.8,375,1414,1039,930,803,-127,426.0,11173.0,10747.0,26000.0,0.0,-26000.0
<a href=/player/freeg102>freeg102</a>,Gene Freese,Chicago White Sox,WSOX,1,1,2,3,1966,1966,0,No,0,-0.43,0.0,0.43,21,0,-21,38,0,-38,0.0,0.0,0.0,20000.0,0.0,-20000.0
<a href=/player/freeh101>freeh101</a>,Hersh Freeman,Cincinnati Reds,REDS,1,1,1,2,1958,1958,0,No,0,-0.72,-0.14,0.58,18,22,4,1,1,0,39.0,35.0,-4.0,0.0,0.0,0.0
<a href=/player/freeh102>freeh102</a>,Harvey Freeman,Philadelphia Athletics,ATLTCS,1,3,1,4,1922,1925,3,No,0,0.0,-0.89,-0.89,0,157,157,0,354,354,0.0,0.0,0.0,2500.0,0.0,-2500.0
<a href=/player/freej104>freej104</a>,Jimmy Freeman,Atlanta Braves,BRAVES,1,1,2,3,1975,1976,1,No,0,0.0,-1.98,-1.98,0,172,172,0,632,632,0.0,0.0,0.0,0.0,0.0,0.0
<a href=/player/freej104>freej104</a>,Jimmy Freeman,Baltimore Orioles,ORLS,10,21,19,40,1976,1994,18,No,3,48.77,85.06,36.29,2260,4349,2089,4427,10615,6188,10756.0,13691.0,2935.0,713333.0,0.0,-713333.0
<a href=/player/freel001>freel001</a>,LaVel Freeman,Milwaukee Brewers,BREWRS,1,2,2,4,1989,1990,1,No,0,0.0,0.0,0.0,0,0,0,0,0,0,0.0,0.0,0.0,0.0,0.0,0.0
<a href=/player/freem001>freem001</a>,Marvin Freeman,Philadelphia Phillies,PHILS,1,1,1,2,1990,1991,1,No,0,1.35,1.77,0.42,244,204,-40,13,4,-9,455.0,433.0,-22.0,0.0,0.0,0.0
<a href=/player/freem101>freem101</a>,Mark Freeman,New York Yankees,YANKS,1,1,1,2,1959,1959,0,No,0,-0.22,0.0,0.22,6,0,-6,0,0,0,11.0,0.0,-11.0,0.0,0.0,0.0
<a href=/player/freem101>freem101</a>,Mark Freeman,New York Yankees,YANKS,1,1,1,2,1960,1960,0,No,0,-0.85,0.0,0.85,60,0,-60,22,0,-22,230.0,0.0,-230.0,0.0,0.0,0.0
<a href=/player/freer001>freer001</a>,Ryan Freel,Cincinnati Reds,REDS,2,4,3,7,2008,2012,4,No,1,-0.23,1.51,1.74,26,269,243,51,1011,960,0.0,0.0,0.0,3000000.0,0.0,-3000000.0
<a href=/player/freer001>freer001</a>,Ryan Freel,Baltimore Orioles,ORLS,1,1,1,2,2009,2009,0,No,0,-0.31,0.0,0.31,14,0,-14,32,0,-32,0.0,0.0,0.0,4000000.0,0.0,-4000000.0
<a href=/player/freer101>freer101</a>,Roger Freed,Baltimore Orioles,ORLS,11,22,22,44,1970,1994,24,No,3,48.71,90.18,41.47,2451,4619,2168,4984,10643,5659,10756.0,14691.0,3935.0,713333.0,0.0,-713333.0
<a href=/player/freer101>freer101</a>,Roger Freed,Philadelphia Phillies,PHILS,3,6,6,12,1972,1984,12,No,0,30.16,12.61,-17.55,1404,1289,-115,5310,1182,-4128,0.0,2166.0,2166.0,0.0,0.0,0.0
<a href=/player/freer101>freer101</a>,Roger Freed,Cleveland Indians,INDINS,2,2,2,4,1973,1975,2,No,0,0.09,-0.13,-0.22,6,6,0,7,18,11,0.0,0.0,0.0,0.0,0.0,0.0
<a href=/player/fregj101>fregj101</a>,Jim Fregosi,California Angels,ANGELS,7,11,12,23,1971,1990,19,No,1,48.58,107.3,58.72,1337,3106,1769,3229,10138,6909,9348.0,10559.0,1211.0,255000.0,0.0,-255000.0
<a href=/player/fregj101>fregj101</a>,Jim Fregosi,Texas Rangers,RNGRS,2,2,2,4,1977,1978,1,No,0,0.69,-0.24,-0.93,85,20,-65,185,52,-133,0.0,0.0,0.0,0.0,0.0,0.0
<a href=/player/freid001>freid001</a>,David Freitas,Washington Nationals,NATEX,2,2,3,5,2012,2021,9,No,0,0.33,-0.07,-0.4,15,133,118,35,445,410,0.0,34.0,34.0,0.0,0.0,0.0
<a href=/player/freid001>freid001</a>,David Freitas,Oakland Athletics,ATLTCS,1,2,1,3,2013,2014,1,No,0,-0.03,-1.33,-1.3,3,41,38,13,1,-12,0.0,121.0,121.0,0.0,0.0,0.0
<a href=/player/freid001>freid001</a>,David Freitas,Seattle Mariners,MARNRS,1,1,1,2,2019,2019,0,Yes,0,0.0,0.0,0.0,16,0,-16,16,0,-16,0.0,0.0,0.0,558500.0,0.0,-558500.0
<a href=/player/freid101>freid101</a>,Dave Freisleben,San Diego Padres,PADRS,1,1,1,2,1978,1978,0,No,0,-1.03,0.0,1.03,12,0,-12,0,0,0,133.0,0.0,-133.0,0.0,0.0,0.0
<a href=/player/freid101>freid101</a>,Dave Freisleben,Cleveland Indians,INDINS,1,1,1,2,1978,1979,1,No,0,-0.32,0.0,0.32,42,0,-42,0,0,0,273.0,0.0,-273.0,0.0,0.0,0.0
<a href=/player/freih101>freih101</a>,Howard Freigau,St. Louis Cardinals,CARDS,2,3,2,5,1925,1928,3,No,0,5.63,8.11,2.48,980,417,-563,3189,1539,-1650,0.0,0.0,0.0,30500.0,0.0,-30500.0
<a href=/player/frein001>frein001</a>,Nate Freiman,Atlanta Braves,BRAVES,1,1,1,2,2016,2016,0,No,0,0.0,0.0,0.0,0,0,0,0,0,0,0.0,0.0,0.0,0.0,0.0,0.0
<a href=/player/freit101>freit101</a>,Tony Freitas,Sacramento,Sacramento,1,1,2,3,1932,1933,1,No,0,1.78,0.0,-1.78,84,0,-84,89,0,-89,644.0,0.0,-644.0,0.0,0.0,0.0
<a href=/player/freit101>freit101</a>,Tony Freitas,Philadelphia Athletics,ATLTCS,2,5,2,7,1933,1934,1,No,0,0.0,0.0,0.0,0,0,0,0,0,0,0.0,0.0,0.0,7600.0,0.0,-7600.0
<a href=/player/freit101>freit101</a>,Tony Freitas,StPaul,StPaul,1,1,3,4,1934,1934,0,No,0,1.84,0.0,-1.84,131,0,-131,110,0,-110,910.0,0.0,-910.0,0.0,0.0,0.0
<a href=/player/frenl001>frenl001</a>,Lucas French,Detroit Tigers,TIGRS,1,2,1,3,2009,2009,0,No,0,-0.44,-0.68,-0.24,25,8,-17,1,0,-1,377.0,129.0,-248.0,0.0,0.0,0.0
<a href=/player/frenl101>frenl101</a>,Larry French,Pittsburgh Pirates,PIRATS,1,2,3,5,1934,1938,4,No,0,22.26,3.72,-18.54,634,346,-288,941,358,-583,4458.0,2252.0,-2206.0,0.0,0.0,0.0
<a href=/player/frenw101>frenw101</a>,Walt French,Philadelphia Athletics,ATLTCS,1,4,2,6,1929,1936,7,No,0,0.0,5.27,5.27,0,394,394,0,395,395,0.0,2946.0,2946.0,7500.0,0.0,-7500.0
<a href=/player/freyb101>freyb101</a>,Benny Frey,Cincinnati Reds,REDS,1,3,1,4,1932,1932,0,No,0,-0.61,2.05,2.66,32,83,51,78,279,201,9.0,0.0,-9.0,0.0,0.0,0.0
<a href=/player/freyj801>freyj801</a>,Jim Frey,St. Louis Cardinals,CARDS,2,7,3,10,1960,1963,3,No,0,1.56,-0.35,-1.91,364,164,-200,1157,310,-847,0.0,0.0,0.0,0.0,0.0,0.0
<a href=/player/freyl101>freyl101</a>,Lonny Frey,Brooklyn Dodgers,DOGRS,2,5,3,8,1936,1944,8,No,0,2.72,0.36,-2.36,227,591,364,615,1769,1154,390.0,469.0,79.0,10000.0,0.0,-10000.0
<a href=/player/freyl101>freyl101</a>,Lonny Frey,Nashville,Nashville,1,1,2,3,1932,1932,0,No,0,8.79,0.0,-8.79,438,0,-438,1901,0,-1901,0.0,0.0,0.0,0.0,0.0,0.0
<a href=/player/freys001>freys001</a>,Steve Frey,New York Yankees,YANKS,1,3,2,5,1987,1989,2,No,0,0.13,-0.61,-0.74,44,148,104,95,521,426,0.0,0.0,0.0,0.0,0.0,0.0
<a href=/player/freys001>freys001</a>,Steve Frey,New York Mets,METS,1,1,2,3,1989,1990,1,No,0,-0.1,0.25,0.35,204,91,-113,4,144,140,350.0,0.0,-350.0,0.0,0.0,0.0
<a href=/player/friac001>friac001</a>,Carlos Frias,Los Angeles Dodgers,DOGRS,1,1,1,2,2017,2017,0,No,0,0.0,0.0,0.0,0,0,0,0,0,0,0.0,0.0,0.0,0.0,0.0,0.0
<a href=/player/friah001>friah001</a>,Hanley Frias,Arizona Diamondbacks,DBACKS,4,11,8,19,2001,2008,7,No,2,15.65,3.83,-11.82,2019,365,-1654,5161,868,-4293,3052.0,809.0,-2243.0,3950667.0,0.0,-3950667.0
<a href=/player/friah001>friah001</a>,Hanley Frias,Minnesota Twins,TWINS,1,1,1,2,2001,2001,0,No,0,0.0,0.0,0.0,0,0,0,0,0,0,0.0,0.0,0.0,0.0,0.0,0.0
<a href=/player/friap101>friap101</a>,Pepe Frias,Montreal Expos,NATEX,1,1,1,2,1979,1979,0,No,0,-0.93,0.0,0.93,140,0,-140,510,0,-510,0.0,0.0,0.0,0.0,0.0,0.0
<a href=/player/friap101>friap101</a>,Pepe Frias,Atlanta Braves,BRAVES,2,3,5,8,1979,1981,2,No,0,1.23,1.75,0.52,177,210,33,304,347,43,541.0,927.0,386.0,150000.0,0.0,-150000.0
<a href=/player/friap101>friap101</a>,Pepe Frias,Texas Rangers,RNGRS,1,1,2,3,1980,1981,1,No,0,-0.19,-0.26,-0.07,39,4,-35,48,0,-48,0.0,17.0,17.0,0.0,0.0,0.0
<a href=/player/fricm101>fricm101</a>,Marion Fricano,Kansas City Athletics,ATLTCS,41,88,89,177,1955,1976,21,No,0,134.11,72.93,-61.18,13270,9521,-3749,30102,25294,-4808,19786.0,12958.0,-6828.0,506100.0,0.0,-506100.0
<a href=/player/fridj101>fridj101</a>,Jim Fridley,Baltimore Orioles,ORLS,21,46,43,89,1954,1994,40,No,3,83.66,150.67,67.01,4979,8510,3531,10385,24729,14344,18519.0,15968.0,-2551.0,970833.0,0.0,-970833.0
<a href=/player/fridj101>fridj101</a>,Jim Fridley,New York Yankees,YANKS,1,1,1,2,1957,1957,0,No,0,0.0,0.0,0.0,0,0,0,0,0,0,0.0,0.0,0.0,0.0,0.0,0.0
<a href=/player/frieb102>frieb102</a>,Bob Friend,Pittsburgh Pirates,PIRATS,1,1,2,3,1965,1967,2,No,0,-0.56,1.61,2.17,24,206,182,14,30,16,134.0,547.0,413.0,37500.0,0.0,-37500.0
<a href=/player/fried101>fried101</a>,Danny Friend,Chicago Cubs,CUBS,1,2,2,4,1898,1901,3,No,0,0.0,6.83,6.83,0,327,327,0,1338,1338,0.0,0.0,0.0,0.0,0.0,0.0
<a href=/player/friee001>friee001</a>,Ernesto Frieri,San Diego Padres,PADRS,1,1,2,3,2012,2016,4,No,0,1.06,0.89,-0.17,173,616,443,0,1673,1673,462.0,93.0,-369.0,489100.0,0.0,-489100.0
<a href=/player/friee001>friee001</a>,Ernesto Frieri,Anaheim Angels,ANGELS,1,1,1,2,2014,2014,0,No,0,-0.62,0.1,0.72,28,41,13,0,0,0,32.0,101.0,69.0,0.0,0.0,0.0
<a href=/player/friem001>friem001</a>,Max Fried,San Diego Padres,PADRS,1,4,2,6,2014,2016,2,No,0,14.14,4.21,-9.93,618,150,-468,1586,620,-966,1341.0,0.0,-1341.0,0.0,0.0,0.0
<a href=/player/frieo101>frieo101</a>,Owen Friend,St.Louis Browns,ORLS,29,63,61,124,1952,1994,42,No,3,108.88,170.74,61.86,6500,10285,3785,14305,30002,15697,22658.0,18329.0,-4329.0,980833.0,0.0,-980833.0
<a href=/player/frieo101>frieo101</a>,Owen Friend,Detroit Tigers,TIGRS,3,7,7,14,1953,1959,6,No,0,19.59,21.85,2.26,1560,1406,-154,4177,3381,-796,3244.0,3436.0,192.0,42000.0,0.0,-42000.0
<a href=/player/frisd101>frisd101</a>,Danny Frisella,New York Mets,METS,2,3,3,6,1972,1976,4,No,0,-0.45,1.09,1.54,209,111,-98,45,100,55,600.0,846.0,246.0,0.0,0.0,0.0
<a href=/player/frisd101>frisd101</a>,Danny Frisella,Atlanta Braves,BRAVES,1,1,1,2,1974,1978,4,No,0,1.66,-1.41,-3.07,130,249,119,5,523,518,293.0,0.0,-293.0,0.0,0.0,0.0
<a href=/player/frisd101>frisd101</a>,Danny Frisella,San Diego Padres,PADRS,1,1,2,3,1976,1977,1,No,0,0.16,-1.24,-1.4,36,38,2,1,5,4,68.0,97.0,29.0,0.0,0.0,0.0
<a href=/player/frisd101>frisd101</a>,Danny Frisella,St. Louis Cardinals,CARDS,8,11,12,23,1976,1992,16,No,0,19.3,16.76,-2.54,1487,1395,-92,2974,3195,221,3536.0,4921.0,1385.0,1943333.0,0.0,-1943333.0
<a href=/player/frisf101>frisf101</a>,Frankie Frisch,New York Giants,GIANTS,4,6,5,11,1926,1932,6,No,0,44.88,18.94,-25.94,1758,1119,-639,7309,4215,-3094,99.0,0.0,-99.0,24000.0,0.0,-24000.0
<a href=/player/frobd001>frobd001</a>,Doug Frobel,Montreal Expos,NATEX,1,1,2,3,1986,1986,0,No,0,0.0,0.0,0.0,0,0,0,0,0,0,0.0,0.0,0.0,0.0,0.0,0.0
<a href=/player/frocs101>frocs101</a>,Sam Frock,Pittsburgh Pirates,PIRATS,1,2,1,3,1910,1910,0,No,0,-1.88,1.0,2.88,213,60,-153,568,54,-514,814.0,458.0,-356.0,0.0,0.0,0.0
<a href=/player/froma101>froma101</a>,Art Fromme,St. Louis Cardinals,CARDS,2,5,2,7,1908,1912,4,No,0,24.55,10.02,-14.53,1473,290,-1183,4275,993,-3282,4114.0,10.0,-4104.0,0.0,0.0,0.0
<a href=/player/froma101>froma101</a>,Art Fromme,Cincinnati Reds,REDS,2,2,7,9,1913,1925,12,No,0,7.71,48.29,40.58,556,1870,1314,1859,7404,5545,786.0,1664.0,878.0,14391.0,0.0,-14391.0
<a href=/player/frosd101>frosd101</a>,Dave Frost,Chicago White Sox,WSOX,8,12,15,27,1977,1997,20,No,0,45.63,32.75,-12.88,2200,2303,103,7990,6201,-1789,3475.0,5246.0,1771.0,1390000.0,0.0,-1390000.0
<a href=/player/frute001>frute001</a>,Emiliano Fruto,Seattle Mariners,MARNRS,1,2,2,4,2006,2008,2,No,0,-0.42,0.87,1.29,24,232,208,61,955,894,0.0,0.0,0.0,328500.0,0.0,-328500.0
<a href=/player/frute001>frute001</a>,Emiliano Fruto,Washington Nationals,NATEX,2,2,3,5,2007,2009,2,No,0,-0.13,-0.35,-0.22,13,101,88,26,351,325,0.0,0.0,0.0,0.0,0.0,0.0
<a href=/player/fry-p001>fry-p001</a>,Paul Fry,Seattle Mariners,MARNRS,1,1,1,2,2017,2017,0,No,0,0.58,0.0,-0.58,180,0,-180,0,0,0,493.0,0.0,-493.0,0.0,0.0,0.0
<a href=/player/fryee001>fryee001</a>,Eric Fryer,Milwaukee Brewers,BREWRS,1,1,1,2,2009,2011,2,No,0,0.0,0.0,0.0,0,0,0,0,0,0,0.0,0.0,0.0,0.0,0.0,0.0
<a href=/player/fryee001>fryee001</a>,Eric Fryer,New York Yankees,YANKS,1,2,2,4,2009,2009,0,No,0,-0.08,0.01,0.09,52,39,-13,126,98,-28,0.0,0.0,0.0,0.0,0.0,0.0
<a href=/player/fryej001>fryej001</a>,Jeff Frye,Boston Red Sox,RSOX,2,5,5,10,2000,2002,2,No,0,0.87,1.83,0.96,125,248,123,134,537,403,371.0,782.0,411.0,3375000.0,0.0,-3375000.0
<a href=/player/frymt001>frymt001</a>,Travis Fryman,Detroit Tigers,TIGRS,3,3,5,8,1997,2000,3,No,0,-0.25,1.14,1.39,11,331,320,14,816,802,0.0,872.0,872.0,6775000.0,0.0,-6775000.0
<a href=/player/frymt001>frymt001</a>,Travis Fryman,Arizona Diamondbacks,DBACKS,1,3,1,4,1997,2003,6,No,0,6.04,8.29,2.25,656,595,-61,2425,2462,37,172.0,0.0,-172.0,0.0,0.0,0.0
<a href=/player/frymw101>frymw101</a>,Woodie Fryman,Pittsburgh Pirates,PIRATS,2,5,4,9,1967,1973,6,No,0,15.42,-1.44,-16.86,860,110,-750,2406,119,-2287,2691.0,948.0,-1743.0,75000.0,0.0,-75000.0
<a href=/player/frymw101>frymw101</a>,Woodie Fryman,Detroit Tigers,TIGRS,2,5,5,10,1974,1979,5,No,0,11.88,5.51,-6.37,1025,344,-681,672,906,234,4024.0,1490.0,-2534.0,69500.0,0.0,-69500.0
<a href=/player/frymw101>frymw101</a>,Woodie Fryman,Montreal Expos,NATEX,3,4,4,8,1976,1990,14,No,1,-2.11,10.28,12.39,198,921,723,45,1873,1828,656.0,1567.0,911.0,0.0,0.0,0.0
<a href=/player/frymw101>frymw101</a>,Woodie Fryman,Cincinnati Reds,REDS,1,2,1,3,1977,1981,4,No,0,2.78,3.66,0.88,288,112,-176,68,126,58,1033.0,1005.0,-28.0,85000.0,0.0,-85000.0
<a href=/player/frymw101>frymw101</a>,Woodie Fryman,Chicago Cubs,CUBS,2,3,2,5,1978,1979,1,No,0,5.84,0.14,-5.7,1248,90,-1158,2530,176,-2354,1045.0,0.0,-1045.0,0.0,0.0,0.0
<a href=/player/fuenb001>fuenb001</a>,Brian Fuentes,Seattle Mariners,MARNRS,3,7,6,13,2001,2008,7,No,0,8.61,1.58,-7.03,1096,337,-759,200,984,784,2142.0,123.0,-2019.0,1587500.0,0.0,-1587500.0
<a href=/player/fuenb001>fuenb001</a>,Brian Fuentes,Anaheim Angels,ANGELS,1,1,1,2,2010,2010,0,No,0,0.64,0.0,-0.64,9,0,-9,0,0,0,29.0,0.0,-29.0,9000000.0,0.0,-9000000.0
<a href=/player/fuenm001>fuenm001</a>,Mike Fuentes,Montreal Expos,NATEX,1,1,1,2,1986,1987,1,No,0,0.0,-0.06,-0.06,0,7,7,0,3,3,0.0,0.0,0.0,0.0,0.0,0.0
<a href=/player/fuenr001>fuenr001</a>,Reymond Fuentes,Boston Red Sox,RSOX,8,26,15,41,2010,2019,9,Yes,0,35.43,29.06,-6.37,2876,1721,-1155,5076,5808,732,4841.0,1908.0,-2933.0,4708000.0,0.0,-4708000.0
<a href=/player/fuenr001>fuenr001</a>,Reymond Fuentes,San Diego Padres,PADRS,1,1,1,2,2014,2014,0,Yes,0,-0.23,0.0,0.23,13,0,-13,44,0,-44,0.0,0.0,0.0,0.0,0.0,0.0
<a href=/player/fuent101>fuent101</a>,Tito Fuentes,San Francisco Giants,GIANTS,10,13,17,30,1974,1998,24,No,0,12.0,28.62,16.62,1215,2851,1636,2939,9682,6743,2410.0,443.0,-1967.0,7402778.0,0.0,-7402778.0
<a href=/player/fuhro101>fuhro101</a>,Ollie Fuhrman,Philadelphia Athletics,ATLTCS,1,3,1,4,1922,1925,3,No,0,0.0,-0.89,-0.89,0,157,157,0,354,354,0.0,0.0,0.0,2500.0,0.0,-2500.0
<a href=/player/fuhro102>fuhro102</a>,Oscar Fuhr,Boston Red Sox,RSOX,1,1,1,2,1924,1924,0,No,0,0.0,-0.83,-0.83,0,8,8,0,3,3,0.0,21.0,21.0,3600.0,0.0,-3600.0
<a href=/player/fuhro102>fuhro102</a>,Oscar Fuhr,Chicago Cubs,CUBS,1,1,1,2,1921,1921,0,No,0,0.0,0.0,0.0,0,0,0,0,0,0,0.0,0.0,0.0,2833.0,0.0,-2833.0
<a href=/player/fukuk001>fukuk001</a>,Kosuke Fukudome,Chicago Cubs,CUBS,1,2,2,4,2011,2011,0,No,0,-0.5,0.0,0.5,59,0,-59,258,0,-258,0.0,0.0,0.0,14500000.0,0.0,-14500000.0
<a href=/player/fulds001>fulds001</a>,Sam Fuld,Chicago Cubs,CUBS,4,8,9,17,2011,2019,8,Yes,0,18.8,9.35,-9.45,836,1392,556,1720,408,-1312,3536.0,2716.0,-820.0,1500000.0,0.0,-1500000.0
<a href=/player/fulds001>fulds001</a>,Sam Fuld,Minnesota Twins,TWINS,1,1,1,2,2014,2016,2,No,0,1.8,0.26,-1.54,180,51,-129,532,4,-528,0.0,659.0,659.0,0.0,0.0,0.0
<a href=/player/fullb001>fullb001</a>,Brad Fullmer,Montreal Expos,NATEX,3,7,7,14,2000,2004,4,No,0,51.36,-3.19,-54.55,1602,668,-934,5820,1530,-4290,4264.0,874.0,-3390.0,4000000.0,0.0,-4000000.0
<a href=/player/fullb001>fullb001</a>,Brad Fullmer,Toronto Blue Jays,BJAYS,1,1,1,2,2002,2002,0,No,0,4.23,-0.5,-4.73,193,2,-191,714,0,-714,0.0,25.0,25.0,0.0,0.0,0.0
<a href=/player/fullc101>fullc101</a>,Chick Fullis,New York Giants,GIANTS,6,16,9,25,1932,1949,17,No,0,9.38,67.57,58.19,1463,2679,1216,5350,10428,5078,296.0,142.0,-154.0,0.0,0.0,0.0
<a href=/player/fullc101>fullc101</a>,Chick Fullis,Philadelphia Phillies,PHILS,3,3,3,6,1934,1938,4,No,0,2.72,4.53,1.81,602,392,-210,901,1021,120,1889.0,1053.0,-836.0,0.0,0.0,0.0
<a href=/player/fullc102>fullc102</a>,Curt Fullerton,New York Yankees,YANKS,1,4,1,5,1926,1937,11,No,0,0.0,46.39,46.39,0,1659,1659,0,7068,7068,0.0,0.0,0.0,0.0,0.0,0.0
<a href=/player/fullf101>fullf101</a>,Frank Fuller,SanAntonio,SanAntonio,2,6,2,8,1922,1923,1,No,0,9.54,0.0,-9.54,1176,0,-1176,4721,0,-4721,0.0,0.0,0.0,0.0,0.0,0.0
<a href=/player/fullf101>fullf101</a>,Frank Fuller,SanAntonio,SanAntonio,1,5,1,6,1923,1923,0,No,0,9.54,0.0,-9.54,1176,0,-1176,4721,0,-4721,0.0,0.0,0.0,0.0,0.0,0.0
<a href=/player/fullj102>fullj102</a>,Jim Fuller,Houston Astros,ASTROS,1,1,1,2,1978,1978,0,No,0,0.0,0.0,0.0,0,0,0,0,0,0,0.0,0.0,0.0,0.0,0.0,0.0
<a href=/player/fulmm001>fulmm001</a>,Michael Fulmer,New York Mets,METS,1,2,1,3,2015,2020,5,No,0,10.66,7.65,-3.01,148,316,168,14,1304,1290,1660.0,0.0,-1660.0,0.0,0.0,0.0
<a href=/player/fulta001>fulta001</a>,Aaron Fultz,San Francisco Giants,GIANTS,1,3,1,4,1993,1993,0,No,0,0.3,-0.08,-0.38,64,10,-54,0,6,6,230.0,51.0,-179.0,109000.0,0.0,-109000.0
<a href=/player/fultd101>fultd101</a>,Dave Fultz,New York Yankees,YANKS,4,7,7,14,1906,1911,5,No,0,37.76,9.34,-28.42,2601,727,-1874,10473,2947,-7526,0.0,0.0,0.0,0.0,0.0,0.0
<a href=/player/funkf101>funkf101</a>,Frank Funk,Cleveland Indians,INDINS,10,19,17,36,1962,1978,16,No,0,30.29,13.22,-17.07,2722,1767,-955,6203,6060,-143,3067.0,1183.0,-1884.0,115500.0,0.0,-115500.0
<a href=/player/funkl101>funkl101</a>,Liz Funk,Louisville,Louisville,1,1,1,2,1932,1932,0,No,0,0.91,0.0,-0.91,132,0,-132,505,0,-505,0.0,0.0,0.0,0.0,0.0,0.0
<a href=/player/funkl101>funkl101</a>,Liz Funk,Chicago White Sox,WSOX,1,3,1,4,1934,1936,2,No,0,0.0,-0.14,-0.14,0,10,10,0,2,2,0.0,39.0,39.0,0.0,0.0,0.0
<a href=/player/furbc001>furbc001</a>,Charlie Furbush,Detroit Tigers,TIGRS,7,12,11,23,2011,2021,10,Yes,0,17.56,10.21,-7.35,1262,701,-561,1311,661,-650,4444.0,2831.0,-1613.0,16933000.0,0.0,-16933000.0
<a href=/player/furcr001>furcr001</a>,Rafael Furcal,Los Angeles Dodgers,DOGRS,2,3,3,6,2011,2015,4,No,0,2.05,-0.64,-2.69,171,24,-147,748,43,-705,0.0,0.0,0.0,13490500.0,0.0,-13490500.0
<a href=/player/furmj001>furmj001</a>,J.J. Furmaniak,San Diego Padres,PADRS,2,2,2,4,2005,2006,1,No,0,2.49,0.15,-2.34,267,11,-256,847,19,-828,0.0,0.0,0.0,0.0,0.0,0.0
<a href=/player/fussc001>fussc001</a>,Chris Fussell,Baltimore Orioles,ORLS,3,3,4,7,1999,2005,6,No,0,1.41,6.11,4.7,354,704,350,1064,2573,1509,673.0,181.0,-492.0,4250000.0,0.0,-4250000.0
<a href=/player/fussf101>fussf101</a>,Fred Fussell,WichitaFalls,WichitaFalls,1,1,2,3,1927,1928,1,No,0,0.75,0.0,-0.75,98,0,-98,78,0,-78,598.0,0.0,-598.0,0.0,0.0,0.0
<a href=/player/fussl101>fussl101</a>,Les Fusselman,St. Louis Cardinals,CARDS,3,5,3,8,1953,1957,4,No,0,0.94,0.38,-0.56,322,182,-140,645,225,-420,0.0,0.0,0.0,0.0,0.0,0.0
<a href=/player/fyhrm001>fyhrm001</a>,Mike Fyhrie,Anaheim Angels,ANGELS,1,2,1,3,2001,2002,1,No,0,0.08,-0.18,-0.26,30,74,44,2,159,157,45.0,0.0,-45.0,0.0,0.0,0.0
<a href=/player/fyhrm001>fyhrm001</a>,Mike Fyhrie,Chicago Cubs,CUBS,1,1,1,2,2001,2001,0,No,0,0.75,0.0,-0.75,20,0,-20,0,0,0,161.0,0.0,-161.0,240000.0,0.0,-240000.0
<a href=/player/fyhrm001>fyhrm001</a>,Mike Fyhrie,Philadelphia Phillies,PHILS,1,1,1,2,2003,2003,0,No,0,0.0,0.0,0.0,0,0,0,0,0,0,0.0,0.0,0.0,0.0,0.0,0.0
<a href=/player/fyhrm001>fyhrm001</a>,Mike Fyhrie,Cleveland Indians,INDINS,1,1,1,2,2003,2003,0,No,0,0.0,0.0,0.0,0,0,0,0,0,0,0.0,0.0,0.0,0.0,0.0,0.0
<a href=/player/gabbk001>gabbk001</a>,Kason Gabbard,Boston Red Sox,RSOX,4,8,6,14,2007,2017,10,No,3,18.18,4.77,-13.41,1196,220,-976,3031,777,-2254,3507.0,311.0,-3196.0,415500.0,0.0,-415500.0
<a href=/player/gablf101>gablf101</a>,Frank Gabler,New York Giants,GIANTS,5,13,8,21,1937,1954,17,No,0,2.85,10.95,8.1,238,996,758,838,3422,2584,229.0,172.0,-57.0,6000.0,0.0,-6000.0
<a href=/player/gablk101>gablk101</a>,Ken Gables,Pittsburgh Pirates,PIRATS,1,5,1,6,1947,1947,0,No,0,0.0,0.0,0.0,0,0,0,0,0,0,0.0,0.0,0.0,5000.0,0.0,-5000.0
<a href=/player/gabrl101>gabrl101</a>,Len Gabrielson,New York Yankees,YANKS,1,1,2,3,1939,1939,0,No,0,0.06,0.0,-0.06,5,0,-5,20,0,-20,0.0,0.0,0.0,0.0,0.0,0.0
<a href=/player/gabrl102>gabrl102</a>,Len Gabrielson,Milwaukee Braves,BRAVES,1,1,2,3,1964,1965,1,No,0,-0.3,-0.03,0.27,117,9,-108,348,17,-331,0.0,0.0,0.0,0.0,0.0,0.0
<a href=/player/gabrl102>gabrl102</a>,Len Gabrielson,Chicago Cubs,CUBS,3,4,6,10,1965,1968,3,No,0,-0.02,-1.61,-1.59,244,333,89,648,438,-210,220.0,627.0,407.0,0.0,0.0,0.0
<a href=/player/gabrl102>gabrl102</a>,Len Gabrielson,San Francisco Giants,GIANTS,1,1,1,2,1966,1967,1,No,0,-0.18,-0.01,0.17,11,46,35,14,72,58,0.0,0.0,0.0,0.0,0.0,0.0
<a href=/player/gabrl102>gabrl102</a>,Len Gabrielson,California Angels,ANGELS,1,1,1,2,1967,1967,0,No,0,2.09,0.13,-1.96,324,49,-275,838,89,-749,0.0,0.0,0.0,16000.0,0.0,-16000.0
<a href=/player/gaglp101>gaglp101</a>,Phil Gagliano,St. Louis Cardinals,CARDS,3,3,3,6,1970,1971,1,No,0,5.17,-0.31,-5.48,364,69,-295,86,36,-50,700.0,324.0,-376.0,25000.0,0.0,-25000.0
<a href=/player/gaglp101>gaglp101</a>,Phil Gagliano,Chicago Cubs,CUBS,1,1,1,2,1970,1974,4,No,0,0.69,-0.63,-1.32,99,227,128,175,661,486,0.0,0.0,0.0,0.0,0.0,0.0
<a href=/player/gaglp101>gaglp101</a>,Phil Gagliano,Boston Red Sox,RSOX,1,2,1,3,1973,1973,0,No,0,0.47,0.0,-0.47,189,0,-189,309,0,-309,0.0,0.0,0.0,0.0,0.0,0.0
<a href=/player/gagnc101>gagnc101</a>,Chick Gagnon,Detroit Tigers,TIGRS,1,1,1,2,1922,1925,3,No,0,-0.04,-0.61,-0.57,4,70,66,5,21,16,0.0,238.0,238.0,0.0,0.0,0.0
<a href=/player/gagnc101>gagnc101</a>,Chick Gagnon,Washington Senators,TWINS,1,3,1,4,1924,1927,3,No,0,0.0,0.0,0.0,0,0,0,0,0,0,0.0,0.0,0.0,2800.0,0.0,-2800.0
<a href=/player/gagnd001>gagnd001</a>,Drew Gagnon,Milwaukee Brewers,BREWRS,1,2,1,3,2016,2018,2,No,0,1.97,-1.05,-3.02,216,84,-132,761,259,-502,0.0,0.0,0.0,1125000.0,0.0,-1125000.0
<a href=/player/gagne001>gagne001</a>,Eric Gagne,Texas Rangers,RNGRS,1,2,3,5,2007,2014,7,No,0,-0.24,10.71,10.95,20,871,851,0,3012,3012,56.0,292.0,236.0,6000000.0,0.0,-6000000.0
<a href=/player/gagng001>gagng001</a>,Greg Gagne,New York Yankees,YANKS,12,22,19,41,1982,2001,19,No,1,71.79,28.19,-43.6,3910,1960,-1950,9749,5314,-4435,10685.0,4016.0,-6669.0,4250000.0,0.0,-4250000.0
<a href=/player/gainj001>gainj001</a>,Jay Gainer,San Diego Padres,PADRS,2,2,3,5,1993,1993,0,No,0,0.25,0.0,-0.25,53,0,-53,57,0,-57,141.0,0.0,-141.0,0.0,0.0,0.0
<a href=/player/gainj101>gainj101</a>,Joe Gaines,Cincinnati Reds,REDS,1,1,2,3,1962,1962,0,No,0,0.64,0.0,-0.64,82,0,-82,176,0,-176,0.0,0.0,0.0,0.0,0.0,0.0
<a href=/player/gainj101>gainj101</a>,Joe Gaines,Baltimore Orioles,ORLS,1,1,2,3,1964,1966,2,No,0,0.15,0.0,-0.15,200,0,-200,614,0,-614,0.0,0.0,0.0,8500.0,0.0,-8500.0
<a href=/player/gaked001>gaked001</a>,Dan Gakeler,Boston Red Sox,RSOX,1,2,2,4,1988,1993,5,No,0,6.42,6.16,-0.26,552,597,45,1976,1669,-307,0.0,1455.0,1455.0,525000.0,0.0,-525000.0
<a href=/player/galaa001>galaa001</a>,Andres Galarraga,Montreal Expos,NATEX,3,4,7,11,1991,1999,8,No,0,1.01,9.86,8.85,330,668,338,1208,996,-212,331.0,2236.0,1905.0,0.0,0.0,0.0
<a href=/player/galaa001>galaa001</a>,Andres Galarraga,Texas Rangers,RNGRS,2,2,4,6,2001,2006,5,No,0,1.1,1.58,0.48,255,103,-152,775,31,-744,0.0,323.0,323.0,6000000.0,0.0,-6000000.0
<a href=/player/galaa002>galaa002</a>,Armando Galarraga,Washington Nationals,NATEX,2,4,3,7,2005,2015,10,No,2,0.68,26.37,25.69,217,505,288,754,1103,349,26.0,3282.0,3256.0,3395000.0,0.0,-3395000.0
<a href=/player/galaa002>galaa002</a>,Armando Galarraga,Texas Rangers,RNGRS,1,1,1,2,2008,2008,0,No,0,4.58,0.0,-4.58,89,0,-89,12,0,-12,1400.0,0.0,-1400.0,0.0,0.0,0.0
<a href=/player/galaa002>galaa002</a>,Armando Galarraga,Detroit Tigers,TIGRS,1,1,2,3,2011,2011,0,No,0,-1.5,0.0,1.5,16,0,-16,16,0,-16,128.0,0.0,-128.0,0.0,0.0,0.0
<a href=/player/galaa002>galaa002</a>,Armando Galarraga,Cincinnati Reds,REDS,1,1,1,2,2013,2013,0,Yes,0,0.0,0.0,0.0,0,0,0,0,0,0,0.0,0.0,0.0,0.0,0.0,0.0
<a href=/player/galaa101>galaa101</a>,Augie Galan,Chicago Cubs,CUBS,1,1,2,3,1941,1946,5,No,0,22.35,0.0,-22.35,627,0,-627,2568,0,-2568,0.0,0.0,0.0,0.0,0.0,0.0
<a href=/player/galaa101>galaa101</a>,Augie Galan,Brooklyn Dodgers,DOGRS,1,1,1,2,1946,1948,2,No,0,4.66,0.0,-4.66,178,0,-178,598,0,-598,0.0,0.0,0.0,0.0,0.0,0.0
<a href=/player/galaa101>galaa101</a>,Augie Galan,SanFrancisco,SanFrancisco,1,1,7,8,1933,1934,1,No,0,18.34,0.0,-18.34,903,0,-903,3781,0,-3781,0.0,0.0,0.0,0.0,0.0,0.0
<a href=/player/galed101>galed101</a>,Denny Galehouse,Cleveland Indians,INDINS,2,3,2,5,1938,1940,2,No,0,3.73,5.73,2.0,238,292,54,340,1286,946,1666.0,0.0,-1666.0,21500.0,0.0,-21500.0
<a href=/player/galer001>galer001</a>,Rich Gale,Kansas City Royals,ROYALS,1,2,1,3,1981,1983,2,No,0,7.18,1.45,-5.73,329,160,-169,289,613,324,2571.0,0.0,-2571.0,0.0,0.0,0.0
<a href=/player/galer001>galer001</a>,Rich Gale,San Francisco Giants,GIANTS,2,2,2,4,1983,1984,1,No,0,-1.01,-0.37,0.64,100,25,-75,86,35,-51,269.0,0.0,-269.0,0.0,0.0,0.0
<a href=/player/galla101>galla101</a>,Al Gallagher,San Francisco Giants,GIANTS,1,1,1,2,1973,1973,0,No,0,0.85,-0.22,-1.07,110,12,-98,352,23,-329,0.0,0.0,0.0,0.0,0.0,0.0
<a href=/player/gallb101>gallb101</a>,Bob Gallagher,Houston Astros,ASTROS,1,1,1,2,1974,1977,3,No,0,-0.2,-0.02,0.18,33,249,216,16,457,441,0.0,0.0,0.0,0.0,0.0,0.0
<a href=/player/gallb101>gallb101</a>,Bob Gallagher,New York Mets,METS,2,3,2,5,1976,1976,0,No,0,0.0,-0.35,-0.35,0,64,64,0,74,74,0.0,0.0,0.0,0.0,0.0,0.0
<a href=/player/gallb103>gallb103</a>,Bert Gallia,KansasCity,KansasCity,3,4,7,11,1912,1915,3,No,0,56.9,0.0,-56.9,1282,0,-1282,2403,0,-2403,9207.0,0.0,-9207.0,0.0,0.0,0.0
<a href=/player/gallb103>gallb103</a>,Bert Gallia,Washington Senators,TWINS,1,2,2,4,1917,1919,2,No,0,0.15,3.97,3.82,110,243,133,129,1072,943,1048.0,0.0,-1048.0,3200.0,0.0,-3200.0
<a href=/player/gallc101>gallc101</a>,Chick Galloway,Philadelphia Athletics,ATLTCS,2,4,2,6,1927,1930,3,No,0,0.0,0.9,0.9,0,133,133,0,244,244,0.0,407.0,407.0,8000.0,0.0,-8000.0
<a href=/player/gallc101>gallc101</a>,Chick Galloway,St.Louis Browns,ORLS,22,44,51,95,1927,1952,25,No,0,139.77,131.99,-7.78,6854,9855,3001,22708,32907,10199,12609.0,15510.0,2901.0,213500.0,0.0,-213500.0
<a href=/player/gallc101>gallc101</a>,Chick Galloway,Milwaukee,Milwaukee,1,1,2,3,1927,1929,2,No,0,0.0,0.0,0.0,0,0,0,0,0,0,0.0,0.0,0.0,0.0,0.0,0.0
<a href=/player/galld001>galld001</a>,Dave Gallagher,Cleveland Indians,INDINS,1,1,1,2,1987,1988,1,No,0,0.0,-0.01,-0.01,0,20,20,0,0,0,0.0,106.0,106.0,0.0,0.0,0.0
<a href=/player/galld001>galld001</a>,Dave Gallagher,Baltimore Orioles,ORLS,1,1,2,3,1990,1990,0,No,0,1.51,0.0,-1.51,101,0,-101,324,0,-324,0.0,0.0,0.0,0.0,0.0,0.0
<a href=/player/galld001>galld001</a>,Dave Gallagher,California Angels,ANGELS,1,1,1,2,1991,1992,1,No,0,0.89,-1.31,-2.2,197,82,-115,434,320,-114,0.0,0.0,0.0,357500.0,0.0,-357500.0
<a href=/player/galld001>galld001</a>,Dave Gallagher,New York Mets,METS,1,1,1,2,1993,1994,1,No,0,-0.1,0.01,0.11,89,42,-47,177,47,-130,0.0,394.0,394.0,500000.0,0.0,-500000.0
<a href=/player/galld001>galld001</a>,Dave Gallagher,Philadelphia Phillies,PHILS,1,1,2,3,1995,1996,1,No,0,-0.19,-0.59,-0.4,11,154,143,18,102,84,0.0,370.0,370.0,250000.0,0.0,-250000.0
<a href=/player/gallg001>gallg001</a>,Giovanny Gallegos,New York Yankees,YANKS,1,2,2,4,2018,2018,0,Yes,0,3.47,1.31,-2.16,336,39,-297,5,148,143,562.0,0.0,-562.0,825000.0,0.0,-825000.0
<a href=/player/gallj002>gallj002</a>,Joey Gallo,Texas Rangers,RNGRS,1,3,4,7,2021,2021,0,Yes,0,0.78,-0.87,-1.65,82,6,-76,228,0,-228,57.0,70.0,13.0,8700000.0,0.0,-8700000.0
<a href=/player/gallj103>gallj103</a>,Joe Gallagher,New York Yankees,YANKS,2,2,3,5,1939,1939,0,No,0,-0.88,0.0,0.88,249,0,-249,934,0,-934,0.0,0.0,0.0,3000.0,0.0,-3000.0
<a href=/player/gallj103>gallj103</a>,Joe Gallagher,St.Louis Browns,ORLS,2,3,3,6,1940,1947,7,No,0,0.67,12.2,11.53,155,603,448,409,1958,1549,122.0,1025.0,903.0,12500.0,0.0,-12500.0
<a href=/player/gallp101>gallp101</a>,Phil Gallivan,Chicago White Sox,WSOX,1,3,1,4,1934,1934,0,No,0,0.0,0.0,0.0,0,0,0,0,0,0,0.0,0.0,0.0,2700.0,0.0,-2700.0
<a href=/player/galls001>galls001</a>,Sean Gallagher,Chicago Cubs,CUBS,1,4,2,6,2008,2009,1,No,0,13.08,4.54,-8.54,545,124,-421,2047,74,-1973,213.0,718.0,505.0,0.0,0.0,0.0
<a href=/player/galls001>galls001</a>,Sean Gallagher,Oakland Athletics,ATLTCS,2,5,3,8,2009,2016,7,No,0,1.67,5.28,3.61,416,684,268,588,2314,1726,340.0,0.0,-340.0,410000.0,0.0,-410000.0
<a href=/player/gallw102>gallw102</a>,William Gallagher,Wilmington,Wilmington,1,1,2,3,1896,1904,8,No,0,0.46,0.0,-0.46,14,0,-14,61,0,-61,0.0,0.0,0.0,0.0,0.0,0.0
<a href=/player/gally001>gally001</a>,Yovani Gallardo,Milwaukee Brewers,BREWRS,3,4,5,9,2015,2020,5,Yes,0,4.62,2.83,-1.79,140,575,435,85,394,309,909.0,683.0,-226.0,5125000.0,0.0,-5125000.0
<a href=/player/gally001>gally001</a>,Yovani Gallardo,Baltimore Orioles,ORLS,1,2,1,3,2017,2017,0,No,0,-0.25,0.55,0.8,29,111,82,2,373,371,392.0,0.0,-392.0,0.0,0.0,0.0
<a href=/player/gallz001>gallz001</a>,Zac Gallen,St. Louis Cardinals,CARDS,1,4,1,5,2017,2019,2,No,0,8.96,4.59,-4.37,386,278,-108,632,1177,545,1696.0,0.0,-1696.0,0.0,0.0,0.0
<a href=/player/gallz001>gallz001</a>,Zac Gallen,Miami Marlins,MARLNS,1,1,1,2,2019,2019,0,Yes,0,6.02,0.0,-6.02,73,0,-73,55,0,-55,711.0,0.0,-711.0,0.0,0.0,0.0
<a href=/player/galvb001>galvb001</a>,Balvino Galvez,Los Angeles Dodgers,DOGRS,1,1,1,2,1987,1987,0,No,0,0.0,0.2,0.2,0,7,7,0,6,6,0.0,0.0,0.0,0.0,0.0,0.0
<a href=/player/galvb001>galvb001</a>,Balvino Galvez,Detroit Tigers,TIGRS,1,1,1,2,1988,1988,0,No,0,0.0,0.01,0.01,0,6,6,0,6,6,0.0,0.0,0.0,0.0,0.0,0.0
<a href=/player/galvb001>galvb001</a>,Balvino Galvez,Minnesota Twins,TWINS,1,1,1,2,1989,1989,0,No,0,0.0,-0.69,-0.69,0,11,11,0,0,0,0.0,52.0,52.0,0.0,0.0,0.0
<a href=/player/galvf001>galvf001</a>,Freddy Galvis,Philadelphia Phillies,PHILS,1,1,1,2,2017,2021,4,No,0,1.85,-0.8,-2.65,162,74,-88,656,6,-650,0.0,174.0,174.0,4350000.0,0.0,-4350000.0
<a href=/player/galvf001>galvf001</a>,Freddy Galvis,Baltimore Orioles,ORLS,1,1,1,2,2021,2021,0,Yes,0,0.32,0.0,-0.32,32,0,-32,120,0,-120,0.0,0.0,0.0,1500000.0,0.0,-1500000.0
<a href=/player/galvj103>galvj103</a>,Pud Galvin,Pittsburgh Pirates,PIRATS,2,2,2,4,1892,1897,5,No,0,2.06,5.48,3.42,99,115,16,342,185,-157,276.0,1232.0,956.0,0.0,0.0,0.0
<a href=/player/gambe001>gambe001</a>,Eddie Gamboa,Tampa Bay Devil Rays,RAYS,1,1,1,2,2017,2017,0,No,0,0.0,0.0,0.0,0,0,0,0,0,0,0.0,0.0,0.0,0.0,0.0,0.0
<a href=/player/gambo001>gambo001</a>,Oscar Gamble,Chicago Cubs,CUBS,2,3,3,6,1969,1974,5,No,0,1.23,0.0,-1.23,677,440,-237,1258,890,-368,797.0,392.0,-405.0,0.0,0.0,0.0
<a href=/player/gambo001>gambo001</a>,Oscar Gamble,Philadelphia Phillies,PHILS,3,6,6,12,1972,1984,12,No,0,30.16,12.61,-17.55,1404,1289,-115,5310,1182,-4128,0.0,2166.0,2166.0,0.0,0.0,0.0
<a href=/player/gambo001>gambo001</a>,Oscar Gamble,Cleveland Indians,INDINS,1,1,1,2,1975,1978,3,No,0,11.27,0.86,-10.41,540,68,-472,1707,0,-1707,0.0,1052.0,1052.0,0.0,0.0,0.0
<a href=/player/gambo001>gambo001</a>,Oscar Gamble,New York Yankees,YANKS,4,7,7,14,1977,1983,6,No,0,29.7,12.76,-16.94,1788,732,-1056,2195,2573,378,4627.0,0.0,-4627.0,0.0,0.0,0.0
<a href=/player/gambo001>gambo001</a>,Oscar Gamble,San Diego Padres,PADRS,5,12,10,22,1978,1989,11,No,0,40.51,8.43,-32.08,3264,1226,-2038,10982,3533,-7449,2009.0,1127.0,-882.0,475000.0,0.0,-475000.0
<a href=/player/gambo001>gambo001</a>,Oscar Gamble,Texas Rangers,RNGRS,1,4,4,8,1979,1985,6,No,0,12.8,8.35,-4.45,488,521,33,1323,2076,753,918.0,0.0,-918.0,475000.0,0.0,-475000.0
<a href=/player/gameb001>gameb001</a>,Ben Gamel,New York Yankees,YANKS,2,3,4,7,2016,2018,2,Yes,0,1.26,0.93,-0.33,272,25,-247,909,114,-795,0.0,0.0,0.0,0.0,0.0,0.0
<a href=/player/gameb001>gameb001</a>,Ben Gamel,Seattle Mariners,MARNRS,1,2,1,3,2018,2019,1,No,0,0.26,0.49,0.23,174,121,-53,483,507,24,0.0,0.0,0.0,0.0,0.0,0.0
<a href=/player/gandc101>gandc101</a>,Chick Gandil,Montreal,Montreal,1,1,3,4,1912,1912,0,No,0,13.55,0.0,-13.55,546,0,-546,2246,0,-2246,0.0,0.0,0.0,0.0,0.0,0.0
<a href=/player/gantj002>gantj002</a>,John Gant,New York Mets,METS,1,2,2,4,2015,2015,0,No,0,-0.77,0.79,1.56,50,93,43,21,281,260,224.0,0.0,-224.0,0.0,0.0,0.0
<a href=/player/gantj002>gantj002</a>,John Gant,Atlanta Braves,BRAVES,2,6,2,8,2016,2017,1,Yes,0,2.2,1.46,-0.74,256,33,-223,58,35,-23,887.0,339.0,-548.0,13307500.0,0.0,-13307500.0
<a href=/player/gantj002>gantj002</a>,John Gant,St. Louis Cardinals,CARDS,1,2,2,4,2021,2021,0,No,0,-0.36,0.27,0.63,16,21,5,0,15,15,101.0,162.0,61.0,2100000.0,0.0,-2100000.0
<a href=/player/gantr001>gantr001</a>,Ron Gant,St. Louis Cardinals,CARDS,1,3,2,5,1998,1999,1,No,0,3.97,-0.62,-4.59,475,133,-342,1012,3,-1009,549.0,220.0,-329.0,8470000.0,0.0,-8470000.0
<a href=/player/gantr001>gantr001</a>,Ron Gant,Philadelphia Phillies,PHILS,1,1,1,2,2000,2000,0,No,0,0.73,0.56,-0.17,34,16,-18,103,17,-86,0.0,132.0,132.0,5066667.0,0.0,-5066667.0
<a href=/player/gantr001>gantr001</a>,Ron Gant,Colorado Rockies,ROCKS,3,6,5,11,2001,2002,1,No,0,2.95,-0.58,-3.53,384,252,-132,1433,925,-508,0.0,3.0,3.0,2800000.0,0.0,-2800000.0
<a href=/player/ganzj101>ganzj101</a>,John Ganzel,KansasCity,KansasCity,2,2,5,7,1900,1908,8,No,0,0.85,0.0,-0.85,100,0,-100,387,0,-387,0.0,0.0,0.0,0.0,0.0,0.0
<a href=/player/ganzj101>ganzj101</a>,John Ganzel,Chicago Cubs,CUBS,1,3,1,4,1901,1902,1,No,0,10.49,-0.18,-10.67,648,75,-573,2353,299,-2054,0.0,0.0,0.0,0.0,0.0,0.0
<a href=/player/garaj101>garaj101</a>,Joe Garagiola,St. Louis Cardinals,CARDS,3,10,5,15,1951,1954,3,No,0,10.75,2.71,-8.04,1144,382,-762,2713,1234,-1479,1601.0,388.0,-1213.0,41500.0,0.0,-41500.0
<a href=/player/garaj101>garaj101</a>,Joe Garagiola,Pittsburgh Pirates,PIRATS,7,12,15,27,1953,1962,9,No,0,9.43,3.47,-5.96,1075,1271,196,3095,3842,747,1449.0,56.0,-1393.0,86000.0,0.0,-86000.0
<a href=/player/garav001>garav001</a>,Victor Garate,Los Angeles Dodgers,DOGRS,1,2,1,3,2009,2010,1,No,0,-0.17,0.65,0.82,8,106,98,0,268,268,6.0,0.0,-6.0,0.0,0.0,0.0
<a href=/player/garba101>garba101</a>,Alex Garbowski,Seattle,Seattle,1,2,1,3,1954,1954,0,No,0,0.0,0.0,0.0,0,0,0,0,0,0,0.0,0.0,0.0,0.0,0.0,0.0
<a href=/player/garbb001>garbb001</a>,Barbaro Garbey,Detroit Tigers,TIGRS,1,1,1,2,1985,1986,1,No,0,0.0,1.38,1.38,0,124,124,0,476,476,0.0,0.0,0.0,0.0,0.0,0.0
<a href=/player/garbg001>garbg001</a>,Gene Garber,Pittsburgh Pirates,PIRATS,1,1,1,2,1972,1980,8,No,0,1.51,17.06,15.55,109,434,325,0,496,496,683.0,3953.0,3270.0,0.0,0.0,0.0
<a href=/player/garbg001>garbg001</a>,Gene Garber,Philadelphia Phillies,PHILS,5,9,8,17,1978,1989,11,No,0,32.41,16.82,-15.59,3161,1285,-1876,3775,3516,-259,6504.0,2945.0,-3559.0,1629900.0,0.0,-1629900.0
<a href=/player/garbg001>garbg001</a>,Gene Garber,Atlanta Braves,BRAVES,1,1,1,2,1987,1987,0,No,0,0.69,0.0,-0.69,39,1,-38,0,1,1,141.0,0.0,-141.0,786667.0,0.0,-786667.0
<a href=/player/garca001>garca001</a>,Amaury Garcia,Florida Marlins,MARLNS,1,1,1,2,2000,2000,0,No,0,0.0,0.0,0.0,0,0,0,0,0,0,0.0,0.0,0.0,0.0,0.0,0.0
<a href=/player/garca002>garca002</a>,Anderson Garcia,New York Yankees,YANKS,2,4,2,6,2003,2003,0,No,0,0.35,0.36,0.01,27,33,6,0,0,0,75.0,81.0,6.0,300000.0,0.0,-300000.0
<a href=/player/garca003>garca003</a>,Avisail Garcia,Detroit Tigers,TIGRS,1,2,1,3,2013,2018,5,No,0,6.35,7.04,0.69,585,558,-27,2358,2068,-290,0.0,0.0,0.0,0.0,0.0,0.0
<a href=/player/garca006>garca006</a>,Aramis Garcia,Texas Rangers,RNGRS,1,3,3,6,2021,2021,0,Yes,0,0.18,-0.26,-0.44,178,104,-74,635,346,-289,0.0,0.0,0.0,0.0,0.0,0.0
<a href=/player/garcc001>garcc001</a>,Carlos Garcia,Pittsburgh Pirates,PIRATS,3,5,8,13,1996,2007,11,No,0,2.44,5.98,3.54,539,1682,1143,911,3950,3039,615.0,1633.0,1018.0,9245000.0,0.0,-9245000.0
<a href=/player/garcc101>garcc101</a>,Chico Garcia,Baltimore Orioles,ORLS,24,45,44,89,1954,1994,40,No,3,72.27,133.17,60.9,4749,7211,2462,10212,16068,5856,16859.0,20473.0,3614.0,880833.0,0.0,-880833.0
<a href=/player/garcd001>garcd001</a>,Damaso Garcia,New York Yankees,YANKS,15,29,25,54,1979,2001,22,No,1,62.96,24.19,-38.77,3819,2347,-1472,10447,5998,-4449,11315.0,5150.0,-6165.0,4715000.0,0.0,-4715000.0
<a href=/player/garcd001>garcd001</a>,Damaso Garcia,Toronto Blue Jays,BJAYS,1,2,1,3,1987,1987,0,No,0,-0.66,0.0,0.66,21,0,-21,64,0,-64,0.0,0.0,0.0,0.0,0.0,0.0
<a href=/player/garce001>garce001</a>,Edgar Garcia,Philadelphia Phillies,PHILS,1,1,1,2,2020,2020,0,Yes,0,-0.28,0.0,0.28,4,0,-4,0,0,0,10.0,0.0,-10.0,0.0,0.0,0.0
<a href=/player/garcf001>garcf001</a>,Freddy Garcia,Pittsburgh Pirates,PIRATS,1,1,1,2,1999,1999,0,No,0,0.11,0.0,-0.11,2,0,-2,3,0,-3,0.0,0.0,0.0,265000.0,0.0,-265000.0
<a href=/player/garcf001>garcf001</a>,Freddy Garcia,Atlanta Braves,BRAVES,1,1,1,2,2000,2000,0,No,0,0.0,0.0,0.0,0,0,0,0,0,0,0.0,0.0,0.0,0.0,0.0,0.0
<a href=/player/garcf002>garcf002</a>,Freddy Garcia,Houston Astros,ASTROS,2,4,3,7,1998,1998,0,No,2,33.49,3.98,-29.51,809,22,-787,1941,35,-1906,4960.0,253.0,-4707.0,170000.0,0.0,-170000.0
<a href=/player/garcf002>garcf002</a>,Freddy Garcia,Seattle Mariners,MARNRS,11,20,22,42,2004,2015,11,No,0,19.53,35.16,15.63,1825,2443,618,3973,7974,4001,3326.0,2794.0,-532.0,27402500.0,0.0,-27402500.0
<a href=/player/garcf002>garcf002</a>,Freddy Garcia,Chicago White Sox,WSOX,3,6,6,12,2006,2013,7,No,0,24.75,15.54,-9.21,1198,365,-833,4129,658,-3471,1892.0,3148.0,1256.0,12600000.0,0.0,-12600000.0
<a href=/player/garcg001>garcg001</a>,Guillermo Garcia,Cincinnati Reds,REDS,1,1,1,2,1998,1998,0,No,0,-0.03,0.0,0.03,4,0,-4,4,0,-4,0.0,0.0,0.0,0.0,0.0,0.0
<a href=/player/garch001>garch001</a>,Harvey Garcia,Boston Red Sox,RSOX,14,38,25,63,2005,2019,14,Yes,0,93.01,61.11,-31.9,5581,3052,-2529,12204,8864,-3340,8381.0,6378.0,-2003.0,13099733.0,0.0,-13099733.0
<a href=/player/garch001>garch001</a>,Harvey Garcia,Pittsburgh Pirates,PIRATS,1,2,1,3,2009,2010,1,No,0,0.0,-0.88,-0.88,0,234,234,0,595,595,0.0,0.0,0.0,0.0,0.0,0.0
<a href=/player/garcj001>garcj001</a>,Jesse Garcia,Baltimore Orioles,ORLS,1,1,1,2,2000,2000,0,No,0,-0.88,0.0,0.88,124,0,-124,195,0,-195,0.0,0.0,0.0,201000.0,0.0,-201000.0
<a href=/player/garcj004>garcj004</a>,Jaime Garcia,St. Louis Cardinals,CARDS,2,3,5,8,2016,2021,5,Yes,0,1.1,2.38,1.28,49,276,227,35,73,38,440.0,1029.0,589.0,13600000.0,0.0,-13600000.0
<a href=/player/garcj004>garcj004</a>,Jaime Garcia,Atlanta Braves,BRAVES,1,3,1,4,2017,2017,0,Yes,0,0.09,0.0,-0.09,1,0,-1,0,0,0,20.0,0.0,-20.0,12800000.0,0.0,-12800000.0
<a href=/player/garcj004>garcj004</a>,Jaime Garcia,Minnesota Twins,TWINS,1,1,2,3,2017,2020,3,No,0,-0.11,0.02,0.13,9,48,39,2,2,0,112.0,203.0,91.0,0.0,0.0,0.0
<a href=/player/garck001>garck001</a>,Kiko Garcia,Baltimore Orioles,ORLS,1,1,2,3,1981,1981,0,No,0,0.83,0.0,-0.83,82,0,-82,230,0,-230,0.0,0.0,0.0,0.0,0.0,0.0
<a href=/player/garck002>garck002</a>,Karim Garcia,Arizona Diamondbacks,DBACKS,1,1,1,2,1998,2006,8,No,0,0.12,30.02,29.9,104,1194,1090,327,5246,4919,0.0,0.0,0.0,187500.0,0.0,-187500.0
<a href=/player/garck002>garck002</a>,Karim Garcia,New York Mets,METS,1,1,1,2,2004,2005,1,No,0,-0.72,0.3,1.02,23,88,65,73,0,-73,0.0,141.0,141.0,800000.0,0.0,-800000.0
<a href=/player/garcl001>garcl001</a>,Leo Garcia,Chicago White Sox,WSOX,1,2,1,3,1982,1984,2,No,0,-0.41,-0.13,0.28,101,14,-87,177,0,-177,0.0,86.0,86.0,0.0,0.0,0.0
<a href=/player/garcl004>garcl004</a>,Leury Garcia,Texas Rangers,RNGRS,1,1,1,2,2013,2014,1,No,0,5.21,1.24,-3.97,581,178,-403,2030,718,-1312,6.0,0.0,-6.0,490000.0,0.0,-490000.0
<a href=/player/garcl005>garcl005</a>,Luis Garcia,Los Angeles Dodgers,DOGRS,1,2,1,3,2009,2010,1,No,0,-0.17,0.65,0.82,8,106,98,0,268,268,6.0,0.0,-6.0,0.0,0.0,0.0
<a href=/player/garcl005>garcl005</a>,Luis Garcia,Philadelphia Phillies,PHILS,1,1,1,2,2018,2020,2,No,0,0.16,1.13,0.97,69,137,68,0,0,0,186.0,196.0,10.0,1200000.0,0.0,-1200000.0
<a href=/player/garcm001>garcm001</a>,Miguel Garcia,California Angels,ANGELS,1,2,1,3,1987,1990,3,No,0,-0.7,4.86,5.56,26,422,396,1,1802,1801,56.0,0.0,-56.0,0.0,0.0,0.0
<a href=/player/garcn001>garcn001</a>,Nomar Garciaparra,Boston Red Sox,RSOX,5,11,8,19,2004,2019,15,No,2,17.0,33.45,16.45,1239,1746,507,2378,6714,4336,960.0,157.0,-803.0,12471000.0,0.0,-12471000.0
<a href=/player/garcp101>garcp101</a>,Pedro Garcia,Milwaukee Brewers,BREWRS,1,1,1,2,1976,1977,1,No,0,-1.04,-0.89,0.15,77,59,-18,245,130,-115,0.0,0.0,0.0,0.0,0.0,0.0
<a href=/player/garcr004>garcr004</a>,Rosman Garcia,New York Yankees,YANKS,1,2,1,3,2001,2001,0,No,0,-0.24,0.36,0.6,75,15,-60,0,55,55,195.0,0.0,-195.0,0.0,0.0,0.0
<a href=/player/garcy001>garcy001</a>,Yimi Garcia,Miami Marlins,MARLNS,1,1,2,3,2021,2021,0,Yes,0,-0.33,1.08,1.41,26,66,40,0,219,219,64.0,14.0,-50.0,1900000.0,0.0,-1900000.0
<a href=/player/gardb101>gardb101</a>,Billy Gardner,Baltimore Orioles,ORLS,5,12,9,21,1960,1973,13,No,0,20.1,30.87,10.77,1792,1902,110,6348,6382,34,845.0,306.0,-539.0,72000.0,0.0,-72000.0
<a href=/player/gardb101>gardb101</a>,Billy Gardner,Minnesota Twins,TWINS,1,1,1,2,1961,1962,1,No,0,-0.04,0.5,0.54,45,32,-13,110,3,-107,0.0,80.0,80.0,0.0,0.0,0.0
<a href=/player/gardb101>gardb101</a>,Billy Gardner,New York Yankees,YANKS,1,1,2,3,1962,1962,0,No,0,-0.22,0.0,0.22,89,0,-89,301,0,-301,0.0,0.0,0.0,0.0,0.0,0.0
<a href=/player/gardg102>gardg102</a>,Gid Gardner,Indianapolis Hoosiers,IN3,1,2,1,3,1887,1890,3,No,0,0.0,0.0,0.0,0,0,0,0,0,0,0.0,0.0,0.0,0.0,0.0,0.0
<a href=/player/gardg102>gardg102</a>,Gid Gardner,Washington Senators,WS8,1,1,2,3,1888,1901,13,No,0,0.08,0.0,-0.08,1,0,-1,3,0,-3,0.0,0.0,0.0,0.0,0.0,0.0
<a href=/player/gardj001>gardj001</a>,Jeff Gardner,New York Mets,METS,1,1,1,2,1991,1991,0,No,0,-0.75,0.0,0.75,155,0,-155,472,0,-472,0.0,0.0,0.0,0.0,0.0,0.0
<a href=/player/gardl101>gardl101</a>,Larry Gardner,Boston Red Sox,RSOX,8,19,22,41,1918,1935,17,No,0,51.77,23.6,-28.17,3792,2718,-1074,15081,10291,-4790,0.0,1203.0,1203.0,45050.0,0.0,-45050.0
<a href=/player/gardl101>gardl101</a>,Larry Gardner,Philadelphia Athletics,ATLTCS,2,5,4,9,1919,1920,1,No,0,39.26,1.89,-37.37,2383,166,-2217,9666,676,-8990,678.0,0.0,-678.0,2400.0,0.0,-2400.0
<a href=/player/gardm001>gardm001</a>,Mark Gardner,Montreal Expos,NATEX,2,3,3,6,1992,1996,4,No,0,-0.47,0.96,1.43,26,525,499,0,267,267,304.0,701.0,397.0,625000.0,0.0,-625000.0
<a href=/player/gardm002>gardm002</a>,Mike Gardiner,Seattle Mariners,MARNRS,1,1,1,2,1991,1991,0,No,0,0.38,1.25,0.87,50,58,8,0,0,0,782.0,144.0,-638.0,0.0,0.0,0.0
<a href=/player/gardm002>gardm002</a>,Mike Gardiner,Boston Red Sox,RSOX,1,2,1,3,1992,1993,1,No,0,-0.63,-0.29,0.34,48,73,25,5,239,234,114.0,0.0,-114.0,177000.0,0.0,-177000.0
<a href=/player/gardr001>gardr001</a>,Ron Gardenhire,New York Mets,METS,1,1,1,2,1986,1987,1,No,0,0.0,0.0,0.0,0,0,0,0,0,0,0.0,0.0,0.0,0.0,0.0,0.0
<a href=/player/gardr101>gardr101</a>,Rob Gardner,New York Mets,METS,1,2,1,3,1967,1967,0,No,0,0.17,0.17,0.0,56,30,-26,61,24,-37,95.0,212.0,117.0,0.0,0.0,0.0
<a href=/player/gardr101>gardr101</a>,Rob Gardner,Chicago Cubs,CUBS,1,1,1,2,1968,1968,0,No,0,-0.19,-0.55,-0.36,10,18,8,0,1,1,8.0,40.0,32.0,0.0,0.0,0.0
<a href=/player/gardr101>gardr101</a>,Rob Gardner,Cleveland Indians,INDINS,1,1,1,2,1969,1969,0,No,0,-0.16,0.0,0.16,46,0,-46,36,0,-36,322.0,0.0,-322.0,0.0,0.0,0.0
<a href=/player/gardr101>gardr101</a>,Rob Gardner,New York Yankees,YANKS,1,2,1,3,1971,1973,2,No,0,0.33,1.03,0.7,63,344,281,8,1145,1137,181.0,0.0,-181.0,0.0,0.0,0.0
<a href=/player/gardr101>gardr101</a>,Rob Gardner,New York Yankees,YANKS,1,2,1,3,1972,1973,1,No,0,-1.68,1.39,3.07,150,123,-27,306,538,232,22.0,0.0,-22.0,35500.0,0.0,-35500.0
<a href=/player/gardr101>gardr101</a>,Rob Gardner,Oakland Athletics,ATLTCS,2,5,2,7,1971,1972,1,No,0,-0.2,0.7,0.9,128,78,-50,155,190,35,313.0,0.0,-313.0,33250.0,0.0,-33250.0
<a href=/player/gardw001>gardw001</a>,Wes Gardner,New York Mets,METS,6,12,11,23,1985,1994,9,No,0,8.23,9.35,1.12,636,686,50,644,1209,565,3320.0,3063.0,-257.0,4116666.0,0.0,-4116666.0
<a href=/player/gardw001>gardw001</a>,Wes Gardner,Boston Red Sox,RSOX,1,1,2,3,1990,1990,0,No,0,-0.74,0.0,0.74,28,0,-28,2,0,-2,61.0,0.0,-61.0,360000.0,0.0,-360000.0
<a href=/player/garib101>garib101</a>,Bob Garibaldi,San Francisco Giants,GIANTS,2,2,2,4,1970,1987,17,No,0,4.8,13.07,8.27,298,1198,900,1060,343,-717,0.0,2611.0,2611.0,0.0,0.0,0.0
<a href=/player/garib101>garib101</a>,Bob Garibaldi,Kansas City Royals,ROYALS,1,1,1,2,1971,1971,0,No,0,0.0,0.0,0.0,0,0,0,0,0,0,0.0,0.0,0.0,0.0,0.0,0.0
<a href=/player/garkr001>garkr001</a>,Ryan Garko,Cleveland Indians,INDINS,1,1,1,2,2009,2014,5,No,0,-0.79,0.05,0.84,40,24,-16,127,0,-127,0.0,83.0,83.0,446100.0,0.0,-446100.0
<a href=/player/garlj001>garlj001</a>,Jon Garland,Chicago Cubs,CUBS,1,1,1,2,1998,2000,2,No,0,18.56,0.2,-18.36,261,114,-147,25,2,-23,4286.0,182.0,-4104.0,0.0,0.0,0.0
<a href=/player/garlj001>garlj001</a>,Jon Garland,Chicago White Sox,WSOX,6,13,11,24,2007,2018,11,Yes,2,37.28,10.23,-27.05,1653,612,-1041,4804,2119,-2685,2863.0,849.0,-2014.0,23035000.0,0.0,-23035000.0
<a href=/player/garlj001>garlj001</a>,Jon Garland,Arizona Diamondbacks,DBACKS,1,1,1,2,2009,2011,2,No,0,0.31,-1.3,-1.61,29,81,52,29,201,172,271.0,0.0,-271.0,6250000.0,0.0,-6250000.0
<a href=/player/garlk001>garlk001</a>,Kyle Garlick,Los Angeles Dodgers,DOGRS,1,1,1,2,2020,2020,0,No,0,-0.39,0.0,0.39,12,0,-12,23,0,-23,0.0,0.0,0.0,0.0,0.0,0.0
<a href=/player/garmm101>garmm101</a>,Mike Garman,Boston Red Sox,RSOX,1,3,3,6,1973,1978,5,No,0,14.84,4.69,-10.15,678,283,-395,435,79,-356,3953.0,2795.0,-1158.0,53000.0,0.0,-53000.0
<a href=/player/garmm101>garmm101</a>,Mike Garman,St. Louis Cardinals,CARDS,2,3,2,5,1975,1977,2,No,0,-2.23,0.7,2.93,320,204,-116,745,727,-18,229.0,0.0,-229.0,0.0,0.0,0.0
<a href=/player/garmm101>garmm101</a>,Mike Garman,Chicago Cubs,CUBS,6,9,14,23,1977,1996,19,No,0,23.01,95.54,72.53,2449,4520,2071,6237,18161,11924,2336.0,1723.0,-613.0,0.0,0.0,0.0
<a href=/player/garmm101>garmm101</a>,Mike Garman,Los Angeles Dodgers,DOGRS,1,1,2,3,1978,1978,0,No,0,-1.34,-0.05,1.29,94,2,-92,5,0,-5,184.0,6.0,-178.0,0.0,0.0,0.0
<a href=/player/garnp001>garnp001</a>,Phil Garner,Oakland Athletics,ATLTCS,5,10,14,24,1977,1991,14,No,0,17.32,67.59,50.27,1802,3570,1768,5305,11715,6410,956.0,6372.0,5416.0,0.0,0.0,0.0
<a href=/player/garnp001>garnp001</a>,Phil Garner,Pittsburgh Pirates,PIRATS,4,4,8,12,1981,1988,7,No,0,17.32,18.67,1.35,1180,996,-184,4623,3865,-758,16.0,149.0,133.0,807000.0,0.0,-807000.0
<a href=/player/garnp001>garnp001</a>,Phil Garner,Houston Astros,ASTROS,1,1,1,2,1987,1987,0,No,0,-0.39,0.0,0.39,70,0,-70,151,0,-151,0.0,0.0,0.0,450000.0,0.0,-450000.0
<a href=/player/garra101>garra101</a>,Adrian Garrett,New York Mets,METS,1,2,1,3,1964,1966,2,No,0,-0.08,0.23,0.31,4,346,342,3,1225,1222,0.0,0.0,0.0,14000.0,0.0,-14000.0
<a href=/player/garra101>garra101</a>,Adrian Garrett,Chicago Cubs,CUBS,1,1,1,2,1971,1971,0,No,0,-0.2,1.0,1.2,28,17,-11,38,58,20,0.0,0.0,0.0,0.0,0.0,0.0
<a href=/player/garrf101>garrf101</a>,Ford Garrison,Boston Red Sox,RSOX,2,2,2,4,1944,1950,6,No,0,1.57,5.48,3.91,261,623,362,911,2379,1468,0.0,0.0,0.0,5000.0,0.0,-5000.0
<a href=/player/garrg101>garrg101</a>,Gil Garrido,San Francisco Giants,GIANTS,1,1,2,3,1966,1967,1,No,0,0.76,0.0,-0.76,320,0,-320,927,0,-927,0.0,0.0,0.0,0.0,0.0,0.0
<a href=/player/garrg101>garrg101</a>,Gil Garrido,Atlanta Braves,BRAVES,2,2,2,4,1973,1980,7,No,0,0.0,-0.36,-0.36,3,145,142,3,282,279,0.0,0.0,0.0,0.0,0.0,0.0
<a href=/player/garrg102>garrg102</a>,Greg Garrett,California Angels,ANGELS,1,1,1,2,1970,1972,2,No,0,0.38,-0.3,-0.68,4,26,22,3,5,2,26.0,91.0,65.0,0.0,0.0,0.0
<a href=/player/garrr101>garrr101</a>,Ralph Garr,Atlanta Braves,BRAVES,6,12,8,20,1975,1987,12,No,0,13.66,24.44,10.78,1298,1964,666,3286,2845,-441,3707.0,4072.0,365.0,999667.0,0.0,-999667.0
<a href=/player/garrs002>garrs002</a>,Steve Garrison,Milwaukee Brewers,BREWRS,2,4,2,6,2007,2007,0,No,1,2.56,0.04,-2.52,559,54,-505,1,1,0,595.0,76.0,-519.0,0.0,0.0,0.0
<a href=/player/garrw101>garrw101</a>,Wayne Garrett,New York Mets,METS,3,4,4,8,1976,1978,2,No,0,2.45,0.15,-2.3,488,71,-417,1259,171,-1088,0.0,0.0,0.0,0.0,0.0,0.0
<a href=/player/gartr001>gartr001</a>,Ryan Garton,Tampa Bay Devil Rays,RAYS,3,4,5,9,2017,2018,1,Yes,0,1.01,2.33,1.32,315,140,-175,740,560,-180,268.0,0.0,-268.0,0.0,0.0,0.0
<a href=/player/garvn101>garvn101</a>,Ned Garvin,Chicago Cubs,CUBS,1,3,1,4,1901,1902,1,No,0,10.49,-0.18,-10.67,648,75,-573,2353,299,-2054,0.0,0.0,0.0,0.0,0.0,0.0
<a href=/player/garvn101>garvn101</a>,Ned Garvin,Philadelphia Phillies,PHILS,1,2,1,3,1896,1896,0,No,0,0.0,0.46,0.46,0,14,14,0,61,61,0.0,0.0,0.0,0.0,0.0,0.0
<a href=/player/garvn101>garvn101</a>,Ned Garvin,St.Louis Browns,ORLS,1,1,1,2,1902,1906,4,No,0,3.2,4.95,1.75,46,343,297,62,1204,1142,526.0,3.0,-523.0,0.0,0.0,0.0
<a href=/player/garvn102>garvn102</a>,Ned Garver,St.Louis Browns,ORLS,8,14,16,30,1952,1960,8,No,0,32.49,23.42,-9.07,2082,1835,-247,5453,4904,-549,5614.0,2626.0,-2988.0,41000.0,0.0,-41000.0
<a href=/player/garvn102>garvn102</a>,Ned Garver,Detroit Tigers,TIGRS,4,10,9,19,1956,1961,5,No,0,13.15,0.77,-12.38,602,579,-23,394,1616,1222,3228.0,40.0,-3188.0,13200.0,0.0,-13200.0
<a href=/player/garzm001>garzm001</a>,Matt Garza,Minnesota Twins,TWINS,3,6,7,13,2007,2015,8,No,0,34.0,-0.38,-34.38,1580,849,-731,6027,3046,-2981,1777.0,138.0,-1639.0,12330000.0,0.0,-12330000.0
<a href=/player/garzm001>garzm001</a>,Matt Garza,Tampa Bay Devil Rays,RAYS,3,5,10,15,2011,2018,7,Yes,0,7.14,19.57,12.43,511,809,298,692,1746,1054,1779.0,3357.0,1578.0,0.0,0.0,0.0
<a href=/player/garzm001>garzm001</a>,Matt Garza,Chicago Cubs,CUBS,2,2,5,7,2013,2019,6,Yes,0,-0.32,4.54,4.86,17,1157,1140,0,283,283,258.0,1456.0,1198.0,1500000.0,0.0,-1500000.0
<a href=/player/gaspr101>gaspr101</a>,Rod Gaspar,New York Mets,METS,2,2,2,4,1970,1971,1,No,0,-0.25,-0.75,-0.5,99,128,29,49,377,328,155.0,39.0,-116.0,0.0,0.0,0.0
<a href=/player/gassc101>gassc101</a>,Charlie Gassaway,Philadelphia Athletics,ATLTCS,2,7,2,9,1945,1954,9,No,0,0.34,26.52,26.18,48,961,913,112,4308,4196,0.0,0.0,0.0,15000.0,0.0,-15000.0
<a href=/player/gassd001>gassd001</a>,Dave Gassner,Toronto Blue Jays,BJAYS,1,2,1,3,2003,2011,8,No,0,4.68,-0.21,-4.89,335,62,-273,1523,225,-1298,23.0,0.0,-23.0,6200000.0,0.0,-6200000.0
<a href=/player/gasta101>gasta101</a>,Alex Gaston,StPaul,StPaul,1,2,2,4,1928,1929,1,No,0,0.83,0.0,-0.83,329,0,-329,1236,0,-1236,0.0,0.0,0.0,0.0,0.0,0.0
<a href=/player/gasta101>gasta101</a>,Alex Gaston,Boston Red Sox,RSOX,1,4,2,6,1926,1926,0,No,0,0.0,0.0,0.0,0,0,0,0,0,0,0.0,0.0,0.0,15750.0,0.0,-15750.0
<a href=/player/gasta101>gasta101</a>,Alex Gaston,Toledo,Toledo,1,1,2,3,1925,1927,2,No,0,-0.91,0.0,0.91,153,0,-153,464,0,-464,0.0,0.0,0.0,0.0,0.0,0.0
<a href=/player/gasta101>gasta101</a>,Alex Gaston,New York Giants,GIANTS,1,2,1,3,1924,1924,0,No,0,0.0,0.0,0.0,0,0,0,0,0,0,0.0,0.0,0.0,0.0,0.0,0.0
<a href=/player/gastc101>gastc101</a>,Cito Gaston,San Diego Padres,PADRS,2,2,3,5,1974,1977,3,No,0,-1.25,0.42,1.67,285,168,-117,524,10,-514,68.0,390.0,322.0,42000.0,0.0,-42000.0
<a href=/player/gastm101>gastm101</a>,Milt Gaston,St.Louis Browns,ORLS,3,4,4,8,1927,1935,8,No,0,11.48,6.16,-5.32,387,744,357,418,523,105,3166.0,4550.0,1384.0,22500.0,0.0,-22500.0
<a href=/player/gastm101>gastm101</a>,Milt Gaston,Washington Senators,TWINS,1,5,1,6,1928,1941,13,No,0,14.54,41.49,26.95,801,1492,691,1696,6460,4764,3390.0,0.0,-3390.0,20500.0,0.0,-20500.0
<a href=/player/gastm101>gastm101</a>,Milt Gaston,Boston Red Sox,RSOX,5,11,8,19,1931,1940,9,No,0,26.55,40.35,13.8,1900,1273,-627,6427,3463,-2964,4146.0,5460.0,1314.0,52000.0,0.0,-52000.0
<a href=/player/gastm101>gastm101</a>,Milt Gaston,New York Yankees,YANKS,1,3,1,4,1924,1924,0,No,0,7.92,0.0,-7.92,312,0,-312,382,0,-382,2741.0,0.0,-2741.0,16500.0,0.0,-16500.0
<a href=/player/gatej101>gatej101</a>,Joe Gates,Kansas City Royals,ROYALS,1,1,1,2,1978,1978,0,No,0,0.07,0.0,-0.07,24,0,-24,48,0,-48,0.0,0.0,0.0,0.0,0.0,0.0
<a href=/player/gathj001>gathj001</a>,Joey Gathright,Tampa Bay Devil Rays,RAYS,1,2,1,3,2006,2012,6,No,0,0.65,3.83,3.18,266,274,8,855,7,-848,0.0,991.0,991.0,337200.0,0.0,-337200.0
<a href=/player/gathj001>gathj001</a>,Joey Gathright,Chicago Cubs,CUBS,1,1,1,2,2009,2009,0,No,0,0.0,-0.31,-0.31,0,14,14,0,32,32,0.0,0.0,0.0,800000.0,0.0,-800000.0
<a href=/player/gatte001>gatte001</a>,Evan Gattis,Atlanta Braves,BRAVES,1,2,3,5,2015,2020,5,Yes,0,5.33,4.65,-0.68,563,307,-256,1880,420,-1460,215.0,2002.0,1787.0,0.0,0.0,0.0
<a href=/player/gaubj001>gaubj001</a>,John Gaub,Cleveland Indians,INDINS,2,4,3,7,2008,2013,5,No,0,-0.38,5.27,5.65,140,382,242,264,314,50,120.0,883.0,763.0,5500000.0,0.0,-5500000.0
<a href=/player/gaudc001>gaudc001</a>,Chad Gaudin,Tampa Bay Devil Rays,RAYS,1,1,1,2,2004,2006,2,No,0,-0.87,0.04,0.91,5,13,8,0,33,33,39.0,0.0,-39.0,302500.0,0.0,-302500.0
<a href=/player/gaudc001>gaudc001</a>,Chad Gaudin,Toronto Blue Jays,BJAYS,1,1,1,2,2005,2005,0,No,0,2.39,0.0,-2.39,139,0,-139,5,0,-5,1030.0,0.0,-1030.0,0.0,0.0,0.0
<a href=/player/gaudc001>gaudc001</a>,Chad Gaudin,Oakland Athletics,ATLTCS,12,17,20,37,2008,2021,13,Yes,0,30.54,32.16,1.62,1528,2032,504,3830,6153,2323,1492.0,2561.0,1069.0,13440000.0,0.0,-13440000.0
<a href=/player/gausk001>gausk001</a>,Kevin Gausman,Baltimore Orioles,ORLS,1,2,5,7,2018,2021,3,Yes,0,0.72,-0.48,-1.2,86,45,-41,50,0,-50,484.0,143.0,-341.0,5600000.0,0.0,-5600000.0
<a href=/player/gavis001>gavis001</a>,Sam Gaviglio,St. Louis Cardinals,CARDS,1,1,1,2,2014,2015,1,No,0,0.24,0.0,-0.24,14,0,-14,5,0,-5,187.0,0.0,-187.0,0.0,0.0,0.0
<a href=/player/gavis001>gavis001</a>,Sam Gaviglio,Kansas City Royals,ROYALS,1,1,1,2,2018,2018,0,No,0,1.36,0.0,-1.36,86,0,-86,3,0,-3,667.0,0.0,-667.0,0.0,0.0,0.0
<a href=/player/gearb101>gearb101</a>,Bob Geary,Philadelphia Athletics,ATLTCS,1,3,1,4,1919,1921,2,No,0,0.0,-1.44,-1.44,0,50,50,0,86,86,0.0,133.0,133.0,0.0,0.0,0.0
<a href=/player/gearc001>gearc001</a>,Cory Gearrin,San Francisco Giants,GIANTS,1,3,1,4,2018,2018,0,No,0,0.75,0.0,-0.75,24,0,-24,0,0,0,64.0,0.0,-64.0,1675000.0,0.0,-1675000.0
<a href=/player/gearc001>gearc001</a>,Cory Gearrin,Texas Rangers,RNGRS,1,1,2,3,2018,2018,0,Yes,0,-0.06,0.0,0.06,6,0,-6,0,0,0,18.0,0.0,-18.0,0.0,0.0,0.0
<a href=/player/gearg001>gearg001</a>,Geoff Geary,Philadelphia Phillies,PHILS,1,3,2,5,2007,2011,4,No,0,12.75,0.63,-12.12,681,613,-68,2271,356,-1915,252.0,579.0,327.0,1217500.0,0.0,-1217500.0
<a href=/player/gearg101>gearg101</a>,Gary Gearhart,New York Giants,GIANTS,1,3,1,4,1948,1955,7,No,0,0.0,5.49,5.49,0,517,517,0,1993,1993,0.0,0.0,0.0,0.0,0.0,0.0
<a href=/player/gedej101>gedej101</a>,Joe Gedeon,New York Yankees,YANKS,5,14,12,26,1918,1931,13,No,0,64.97,61.9,-3.07,2396,2093,-303,7435,5797,-1638,6303.0,6917.0,614.0,44500.0,0.0,-44500.0
<a href=/player/geigg101>geigg101</a>,Gary Geiger,Cleveland Indians,INDINS,3,4,5,9,1958,1965,7,No,0,9.07,15.07,6.0,1121,727,-394,4065,1984,-2081,0.0,1913.0,1913.0,0.0,0.0,0.0
<a href=/player/geisd001>geisd001</a>,Dave Geisel,Chicago Cubs,CUBS,2,4,2,6,1982,1982,0,No,0,0.45,0.93,0.48,103,128,25,0,477,477,404.0,0.0,-404.0,0.0,0.0,0.0
<a href=/player/geisv101>geisv101</a>,Vern Geishert,California Angels,ANGELS,3,6,7,13,1969,1974,5,No,0,8.36,4.59,-3.77,1680,510,-1170,1673,1948,275,4531.0,88.0,-4443.0,15000.0,0.0,-15000.0
<a href=/player/geisv101>geisv101</a>,Vern Geishert,Cincinnati Reds,REDS,4,5,7,12,1971,1988,17,No,0,3.96,42.07,38.11,701,1797,1096,2673,5857,3184,86.0,981.0,895.0,0.0,0.0,0.0
<a href=/player/gelnj101>gelnj101</a>,John Gelnar,Kansas City Royals,ROYALS,2,4,2,6,1969,1977,8,No,0,11.49,4.04,-7.45,1298,779,-519,3743,2778,-965,624.0,554.0,-70.0,65000.0,0.0,-65000.0
<a href=/player/gelnj101>gelnj101</a>,John Gelnar,Milwaukee Brewers,BREWRS,1,2,1,3,1971,1971,0,No,0,0.0,-0.75,-0.75,0,42,42,0,3,3,0.0,97.0,97.0,17500.0,0.0,-17500.0
<a href=/player/gelts001>gelts001</a>,Steve Geltz,Anaheim Angels,ANGELS,1,1,1,2,2013,2014,1,No,0,0.17,1.24,1.07,113,84,-29,0,0,0,307.0,224.0,-83.0,0.0,0.0,0.0
<a href=/player/genej101>genej101</a>,Joe Genewich,Boston Braves,BRAVES,1,1,4,5,1928,1937,9,No,0,0.54,12.56,12.02,137,725,588,122,671,549,913.0,4679.0,3766.0,7000.0,0.0,-7000.0
<a href=/player/genns001>genns001</a>,Scooter Gennett,Cincinnati Reds,REDS,1,2,1,3,2019,2019,0,No,0,-0.06,0.0,0.06,21,0,-21,67,0,-67,0.0,0.0,0.0,9775000.0,0.0,-9775000.0
<a href=/player/gentc001>gentc001</a>,Craig Gentry,Texas Rangers,RNGRS,2,4,3,7,2013,2015,2,No,0,1.42,-3.21,-4.63,125,105,-20,314,281,-33,19.0,129.0,110.0,1001100.0,0.0,-1001100.0
<a href=/player/gentg101>gentg101</a>,Gary Gentry,New York Mets,METS,2,3,3,6,1972,1976,4,No,0,-0.45,1.09,1.54,209,111,-98,45,100,55,600.0,846.0,246.0,0.0,0.0,0.0
<a href=/player/gentj101>gentj101</a>,Jim Gentile,Los Angeles Dodgers,DOGRS,3,4,7,11,1959,1962,3,No,0,14.42,0.0,-14.42,618,0,-618,2360,0,-2360,0.0,0.0,0.0,0.0,0.0,0.0
<a href=/player/gentj101>gentj101</a>,Jim Gentile,Baltimore Orioles,ORLS,14,29,26,55,1963,1994,31,No,3,59.45,124.05,64.6,3220,5648,2428,6254,15146,8892,12746.0,15470.0,2724.0,942833.0,0.0,-942833.0
<a href=/player/gentj101>gentj101</a>,Jim Gentile,Kansas City Athletics,ATLTCS,1,1,2,3,1965,1965,0,No,0,0.98,-0.25,-1.23,130,26,-104,439,0,-439,0.0,46.0,46.0,0.0,0.0,0.0
<a href=/player/gentj101>gentj101</a>,Jim Gentile,Houston Astros,ASTROS,2,2,2,4,1966,1969,3,No,0,-0.53,0.09,0.62,33,8,-25,52,4,-48,0.0,55.0,55.0,0.0,0.0,0.0
<a href=/player/georg101>georg101</a>,Greek George,Cleveland Indians,INDINS,1,1,2,3,1938,1938,0,No,0,-0.15,0.0,0.15,7,0,-7,20,0,-20,0.0,0.0,0.0,0.0,0.0,0.0
<a href=/player/georg101>georg101</a>,Greek George,Brooklyn Dodgers,DOGRS,1,1,2,3,1940,1940,0,No,0,-0.62,0.0,0.62,35,0,-35,67,0,-67,0.0,0.0,0.0,0.0,0.0,0.0
<a href=/player/georl101>georl101</a>,Lefty George,St.Louis Browns,ORLS,1,1,1,2,1912,1914,2,No,0,-0.67,1.15,1.82,22,205,183,14,743,729,133.0,0.0,-133.0,0.0,0.0,0.0
<a href=/player/gerab101>gerab101</a>,Ben Geraghty,Brooklyn Dodgers,DOGRS,1,2,1,3,1937,1941,4,No,0,0.0,0.0,0.0,0,0,0,0,0,0,0.0,0.0,0.0,0.0,0.0,0.0
<a href=/player/gerab101>gerab101</a>,Ben Geraghty,Boston Braves,BRAVES,1,2,1,3,1945,1945,0,No,0,0.0,2.8,2.8,0,68,68,0,69,69,0.0,561.0,561.0,0.0,0.0,0.0
<a href=/player/gerad101>gerad101</a>,Dave Gerard,Chicago Cubs,CUBS,6,9,11,20,1963,1968,5,No,0,-0.05,-1.18,-1.13,253,592,339,665,1006,341,220.0,727.0,507.0,0.0,0.0,0.0
<a href=/player/gerad101>gerad101</a>,Dave Gerard,Houston Astros,ASTROS,1,1,1,2,1964,1965,1,No,0,0.0,0.0,0.0,0,0,0,0,0,0,0.0,0.0,0.0,0.0,0.0,0.0
<a href=/player/gerbw101>gerbw101</a>,Wally Gerber,St.Louis Browns,ORLS,1,1,1,2,1928,1928,0,No,0,-0.55,0.17,0.72,165,52,-113,447,23,-424,0.0,216.0,216.0,8000.0,0.0,-8000.0
<a href=/player/gereb001>gereb001</a>,Bob Geren,San Diego Padres,PADRS,12,21,25,46,1980,1993,13,No,1,78.65,50.21,-28.44,3246,4423,1177,10088,11380,1292,4862.0,3507.0,-1355.0,3006667.0,0.0,-3006667.0
<a href=/player/gerha101>gerha101</a>,Al Gerheauser,Philadelphia Phillies,PHILS,3,3,3,6,1945,1948,3,No,0,2.39,4.16,1.77,202,481,279,250,1788,1538,666.0,0.0,-666.0,0.0,0.0,0.0
<a href=/player/gerha101>gerha101</a>,Al Gerheauser,Pittsburgh Pirates,PIRATS,1,1,1,2,1946,1946,0,No,0,0.0,0.0,0.0,0,0,0,0,0,0,0.0,0.0,0.0,0.0,0.0,0.0
<a href=/player/gerhk001>gerhk001</a>,Ken Gerhart,Baltimore Orioles,ORLS,1,1,1,2,1989,1989,0,No,0,0.0,-0.06,-0.06,0,9,9,0,13,13,0.0,0.0,0.0,0.0,0.0,0.0
<a href=/player/gerks101>gerks101</a>,Steve Gerkin,Philadelphia Athletics,ATLTCS,1,2,1,3,1945,1945,0,No,0,0.0,0.0,0.0,0,0,0,0,0,0,0.0,0.0,0.0,17200.0,0.0,-17200.0
<a href=/player/gerlj101>gerlj101</a>,Johnny Gerlach,Chicago White Sox,WSOX,2,3,2,5,1940,1946,6,No,0,-0.96,-2.59,-1.63,232,359,127,719,1342,623,0.0,0.0,0.0,6000.0,0.0,-6000.0
<a href=/player/germd001>germd001</a>,Domingo German,Miami Marlins,MARLNS,2,4,7,11,2014,2019,5,Yes,0,6.27,8.73,2.46,210,736,526,177,1879,1702,1889.0,737.0,-1152.0,7867000.0,0.0,-7867000.0
<a href=/player/germe001>germe001</a>,Esteban German,Texas Rangers,RNGRS,2,2,3,5,2005,2006,1,No,0,2.6,-0.01,-2.61,367,4,-363,981,0,-981,106.0,25.0,-81.0,327000.0,0.0,-327000.0
<a href=/player/germf001>germf001</a>,Franklyn German,Oakland Athletics,ATLTCS,6,8,9,17,2002,2009,7,No,0,16.13,13.6,-2.53,956,906,-50,1909,3247,1338,5469.0,605.0,-4864.0,947000.0,0.0,-947000.0
<a href=/player/germj001>germj001</a>,Justin Germano,San Diego Padres,PADRS,1,2,1,3,2005,2005,0,No,0,-0.01,0.54,0.55,4,58,54,3,241,238,20.0,0.0,-20.0,0.0,0.0,0.0
<a href=/player/germj001>germj001</a>,Justin Germano,Cincinnati Reds,REDS,1,1,1,2,2006,2007,1,No,0,0.0,0.06,0.06,0,54,54,0,0,0,0.0,51.0,51.0,0.0,0.0,0.0
<a href=/player/germj001>germj001</a>,Justin Germano,Texas Rangers,RNGRS,1,1,1,2,2014,2014,0,No,0,0.0,0.0,0.0,0,0,0,0,0,0,0.0,0.0,0.0,0.0,0.0,0.0
<a href=/player/gernd101>gernd101</a>,Dick Gernert,Boston Red Sox,RSOX,4,8,6,14,1959,1966,7,No,0,-0.67,0.47,1.14,177,638,461,406,1416,1010,0.0,681.0,681.0,18500.0,0.0,-18500.0
<a href=/player/gernd101>gernd101</a>,Dick Gernert,Detroit Tigers,TIGRS,1,1,1,2,1961,1961,0,No,0,0.25,0.0,-0.25,40,0,-40,72,0,-72,0.0,0.0,0.0,0.0,0.0,0.0
<a href=/player/geroc101>geroc101</a>,Cesar Geronimo,Houston Astros,ASTROS,8,15,14,29,1971,1989,18,No,0,76.39,55.08,-21.31,4763,4769,6,15346,14810,-536,3810.0,5622.0,1812.0,705000.0,0.0,-705000.0
<a href=/player/geroc101>geroc101</a>,Cesar Geronimo,Cincinnati Reds,REDS,1,1,1,2,1981,1982,1,No,0,0.76,0.03,-0.73,150,55,-95,355,60,-295,0.0,0.0,0.0,0.0,0.0,0.0
<a href=/player/geruj001>geruj001</a>,Jody Gerut,Colorado Rockies,ROCKS,1,2,1,3,2001,2001,0,No,0,4.57,-0.85,-5.42,461,44,-417,1773,90,-1683,0.0,0.0,0.0,0.0,0.0,0.0
<a href=/player/geruj001>geruj001</a>,Jody Gerut,Cleveland Indians,INDINS,1,1,1,2,2005,2006,1,No,0,-0.05,-0.12,-0.07,11,14,3,16,50,34,0.0,0.0,0.0,356200.0,0.0,-356200.0
<a href=/player/geruj001>geruj001</a>,Jody Gerut,Chicago Cubs,CUBS,2,3,2,5,2005,2012,7,No,0,-0.53,-0.21,0.32,25,138,113,75,85,10,0.0,192.0,192.0,0.0,0.0,0.0
<a href=/player/geruj001>geruj001</a>,Jody Gerut,San Diego Padres,PADRS,1,1,1,2,2009,2010,1,No,0,0.07,5.13,5.06,117,236,119,251,790,539,0.0,0.0,0.0,1775000.0,0.0,-1775000.0
<a href=/player/gessd101>gessd101</a>,Doc Gessler,Brooklyn Dodgers,DOGRS,1,1,1,2,1906,1906,0,No,0,0.09,-0.02,-0.11,34,4,-30,95,2,-93,0.0,20.0,20.0,0.0,0.0,0.0
<a href=/player/gessd101>gessd101</a>,Doc Gessler,Chicago Cubs,CUBS,1,3,1,4,1907,1907,0,No,0,0.0,-0.01,-0.01,0,44,44,0,51,51,0.0,415.0,415.0,0.0,0.0,0.0
<a href=/player/gessd101>gessd101</a>,Doc Gessler,Boston Red Sox,RSOX,1,1,1,2,1909,1911,2,No,0,5.78,2.19,-3.59,290,56,-234,1206,66,-1140,0.0,550.0,550.0,0.0,0.0,0.0
<a href=/player/getta101>getta101</a>,Al Gettel,New York Yankees,YANKS,1,3,1,4,1943,1947,4,No,0,0.0,11.41,11.41,0,568,568,0,2373,2373,0.0,0.0,0.0,0.0,0.0,0.0
<a href=/player/getta101>getta101</a>,Al Gettel,New York Yankees,YANKS,3,10,5,15,1946,1954,8,No,0,30.84,1.34,-29.5,1405,374,-1031,2470,260,-2210,6379.0,1746.0,-4633.0,11500.0,0.0,-11500.0
<a href=/player/getta101>getta101</a>,Al Gettel,Cleveland Indians,INDINS,2,3,2,5,1948,1955,7,No,0,0.72,3.02,2.3,315,566,251,926,1749,823,633.0,0.0,-633.0,0.0,0.0,0.0
<a href=/player/getta101>getta101</a>,Al Gettel,Oakland,Oakland,1,3,5,8,1950,1951,1,No,0,-0.44,0.0,0.44,186,0,-186,308,0,-308,172.0,0.0,-172.0,0.0,0.0,0.0
<a href=/player/getzc001>getzc001</a>,Chris Getz,Chicago White Sox,WSOX,5,8,8,16,2009,2016,7,Yes,0,-0.62,-1.54,-0.92,448,360,-88,1240,736,-504,233.0,625.0,392.0,14311000.0,0.0,-14311000.0
<a href=/player/getzg101>getzg101</a>,Gus Getz,Pittsburgh Pirates,PIRATS,1,1,1,2,1918,1918,0,No,0,0.0,-0.09,-0.09,0,26,26,0,105,105,0.0,0.0,0.0,0.0,0.0,0.0
<a href=/player/giamj002>giamj002</a>,Jeremy Giambi,Kansas City Royals,ROYALS,1,1,1,2,2000,2000,0,No,0,1.75,-0.19,-1.94,270,6,-264,932,0,-932,0.0,50.0,50.0,0.0,0.0,0.0
<a href=/player/giamj002>giamj002</a>,Jeremy Giambi,Oakland Athletics,ATLTCS,1,1,1,2,2002,2002,0,No,0,1.85,1.84,-0.01,82,89,7,211,211,0,0.0,0.0,0.0,1065000.0,0.0,-1065000.0
<a href=/player/giamj002>giamj002</a>,Jeremy Giambi,Philadelphia Phillies,PHILS,2,3,3,6,2002,2004,2,No,0,0.19,-0.25,-0.44,115,65,-50,243,3,-240,206.0,112.0,-94.0,0.0,0.0,0.0
<a href=/player/gianj101>gianj101</a>,Joe Giannini,Boston Red Sox,RSOX,10,29,25,54,1911,1935,24,No,0,51.77,27.79,-23.98,3792,3076,-716,15081,11324,-3757,0.0,1203.0,1203.0,45050.0,0.0,-45050.0
<a href=/player/giarj101>giarj101</a>,Joe Giard,St.Louis Browns,ORLS,4,6,5,11,1927,1935,8,No,0,9.57,7.29,-2.28,658,806,148,956,588,-368,3247.0,5119.0,1872.0,22500.0,0.0,-22500.0
<a href=/player/giarj101>giarj101</a>,Joe Giard,Toledo,Toledo,1,1,4,5,1924,1928,4,No,0,-0.8,0.0,0.8,104,0,-104,93,0,-93,752.0,0.0,-752.0,0.0,0.0,0.0
<a href=/player/giavj001>giavj001</a>,Johnny Giavotella,Kansas City Royals,ROYALS,1,1,1,2,2014,2015,1,No,0,1.39,0.0,-1.39,228,0,-228,869,0,-869,0.0,0.0,0.0,508575.0,0.0,-508575.0
<a href=/player/gibai001>gibai001</a>,Ian Gibaut,Tampa Bay Devil Rays,RAYS,1,1,1,2,2019,2019,0,No,0,-0.05,0.0,0.05,23,0,-23,0,0,0,74.0,0.0,-74.0,0.0,0.0,0.0
<a href=/player/gibbj001>gibbj001</a>,John Gibbons,New York Mets,METS,1,1,1,2,1988,1990,2,No,0,0.0,0.03,0.03,0,4,4,0,7,7,0.0,0.0,0.0,0.0,0.0,0.0
<a href=/player/gibbj102>gibbj102</a>,Joe Gibbon,Pittsburgh Pirates,PIRATS,5,8,9,17,1965,1978,13,No,0,5.88,26.82,20.94,656,1597,941,1421,5058,3637,1342.0,1651.0,309.0,94500.0,0.0,-94500.0
<a href=/player/gibbj102>gibbj102</a>,Joe Gibbon,San Francisco Giants,GIANTS,1,1,1,2,1969,1969,0,No,0,0.85,-0.01,-0.86,152,14,-138,10,0,-10,277.0,33.0,-244.0,0.0,0.0,0.0
<a href=/player/gibsk001>gibsk001</a>,Kirk Gibson,Kansas City Royals,ROYALS,1,1,1,2,1992,1992,0,No,0,0.19,0.15,-0.04,16,31,15,60,0,-60,0.0,123.0,123.0,0.0,0.0,0.0
<a href=/player/gibsk002>gibsk002</a>,Kyle Gibson,Texas Rangers,RNGRS,1,4,3,7,2021,2021,0,Yes,0,0.8,-1.21,-2.01,74,9,-65,29,0,-29,300.0,64.0,-236.0,9766666.0,0.0,-9766666.0
<a href=/player/gibsp001>gibsp001</a>,Paul Gibson,Detroit Tigers,TIGRS,1,2,2,4,1992,1992,0,No,0,-0.71,-1.21,-0.5,102,101,-1,8,364,356,212.0,0.0,-212.0,0.0,0.0,0.0
<a href=/player/gibss101>gibss101</a>,Sam Gibson,New York Giants,GIANTS,1,2,1,3,1932,1934,2,No,0,0.0,-0.01,-0.01,0,16,16,0,12,12,0.0,110.0,110.0,0.0,0.0,0.0
<a href=/player/gibss101>gibss101</a>,Sam Gibson,Chicago Cubs,CUBS,2,8,3,11,1933,1946,13,No,0,22.35,18.34,-4.01,627,903,276,2568,3781,1213,0.0,0.0,0.0,0.0,0.0,0.0
<a href=/player/gibss101>gibss101</a>,Sam Gibson,Detroit Tigers,TIGRS,2,5,3,8,1928,1933,5,No,0,12.96,10.92,-2.04,710,561,-149,2975,2358,-617,0.0,0.0,0.0,21000.0,0.0,-21000.0
<a href=/player/gideb001>gideb001</a>,Brett Gideon,Pittsburgh Pirates,PIRATS,2,2,2,4,1989,1992,3,No,0,0.27,2.24,1.97,41,250,209,0,169,169,140.0,1086.0,946.0,0.0,0.0,0.0
<a href=/player/gidej101>gidej101</a>,Jim Gideon,Texas Rangers,RNGRS,5,14,9,23,1976,1988,12,No,0,43.04,39.52,-3.52,2266,2145,-121,8188,7408,-780,2609.0,4285.0,1676.0,330000.0,0.0,-330000.0
<a href=/player/gielp101>gielp101</a>,Paul Giel,Minnesota Twins,TWINS,1,3,1,4,1961,1963,2,No,0,-0.34,-0.87,-0.53,41,239,198,137,577,440,5.0,0.0,-5.0,0.0,0.0,0.0
<a href=/player/giesd001>giesd001</a>,Dan Giese,Boston Red Sox,RSOX,1,2,2,4,2002,2005,3,No,0,0.0,1.41,1.41,0,227,227,0,0,0,0.0,535.0,535.0,0.0,0.0,0.0
<a href=/player/giggb101>giggb101</a>,Bob Giggie,Milwaukee Braves,BRAVES,2,2,2,4,1960,1962,2,No,0,-0.67,-0.66,0.01,72,44,-28,28,11,-17,299.0,164.0,-135.0,0.0,0.0,0.0
<a href=/player/gigon101>gigon101</a>,Norm Gigon,Philadelphia Phillies,PHILS,1,1,1,2,1966,1968,2,No,0,-0.27,-0.17,0.1,34,34,0,77,66,-11,0.0,0.0,0.0,0.0,0.0,0.0
<a href=/player/gil-b001>gil-b001</a>,Benji Gil,Texas Rangers,RNGRS,1,1,2,3,1997,1999,2,No,0,0.0,0.48,0.48,0,32,32,0,0,0,0.0,174.0,174.0,200000.0,0.0,-200000.0
<a href=/player/gil-g001>gil-g001</a>,Geronimo Gil,Los Angeles Dodgers,DOGRS,1,2,1,3,2001,2002,1,No,0,1.42,-0.47,-1.89,279,38,-241,871,0,-871,30.0,70.0,40.0,0.0,0.0,0.0
<a href=/player/gil-g101>gil-g101</a>,Gus Gil,Cleveland Indians,INDINS,1,1,2,3,1968,1968,0,No,0,-0.7,0.0,0.7,170,0,-170,431,0,-431,0.0,0.0,0.0,0.0,0.0,0.0
<a href=/player/gil-j001>gil-j001</a>,Jerry Gil,Arizona Diamondbacks,DBACKS,1,1,1,2,2006,2006,0,No,0,0.0,0.0,0.0,1,0,-1,0,0,0,0.0,0.0,0.0,0.0,0.0,0.0
<a href=/player/gil-l001>gil-l001</a>,Luis Gil,Minnesota Twins,TWINS,1,1,1,2,2018,2018,0,Yes,0,0.75,1.65,0.9,6,91,85,0,309,309,88.0,0.0,-88.0,0.0,0.0,0.0
<a href=/player/gilbb101>gilbb101</a>,Bill Gilbreth,California Angels,ANGELS,1,1,1,2,1974,1974,0,No,0,0.0,0.0,0.0,0,0,0,0,0,0,0.0,0.0,0.0,0.0,0.0,0.0
<a href=/player/gilbc101>gilbc101</a>,Charlie Gilbert,Brooklyn Dodgers,DOGRS,2,4,2,6,1941,1946,5,No,0,1.09,12.92,11.83,261,488,227,749,2125,1376,0.0,0.0,0.0,20000.0,0.0,-20000.0
<a href=/player/gilbm001>gilbm001</a>,Mark Gilbert,Chicago Cubs,CUBS,2,2,2,4,1979,1983,4,No,0,0.0,2.97,2.97,0,245,245,0,65,65,0.0,842.0,842.0,0.0,0.0,0.0
<a href=/player/gilbs001>gilbs001</a>,Shawn Gilbert,New York Mets,METS,1,1,1,2,1998,1998,0,No,0,0.03,-0.39,-0.42,4,26,22,2,33,31,0.0,0.0,0.0,0.0,0.0,0.0
<a href=/player/gilbt001>gilbt001</a>,Tyler Gilbert,Philadelphia Phillies,PHILS,1,1,1,2,2020,2021,1,No,0,0.0,-0.39,-0.39,0,12,12,0,23,23,0.0,0.0,0.0,0.0,0.0,0.0
<a href=/player/gilbw101>gilbw101</a>,Wally Gilbert,Brooklyn Dodgers,DOGRS,7,17,12,29,1932,1948,16,No,0,60.59,33.44,-27.15,3224,2810,-414,11104,10257,-847,2159.0,791.0,-1368.0,10000.0,0.0,-10000.0
<a href=/player/gileb002>gileb002</a>,Brian Giles,Cleveland Indians,INDINS,2,2,2,4,1998,2002,4,No,0,28.83,2.94,-25.89,948,217,-731,3114,1,-3113,471.0,463.0,-8.0,1800000.0,0.0,-1800000.0
<a href=/player/gileb002>gileb002</a>,Brian Giles,Pittsburgh Pirates,PIRATS,6,8,15,23,2003,2016,13,No,0,29.08,28.07,-1.01,1674,2962,1288,4994,8086,3092,2134.0,4751.0,2617.0,29494833.0,0.0,-29494833.0
<a href=/player/gilek001>gilek001</a>,Ken Giles,Philadelphia Phillies,PHILS,2,3,6,9,2015,2021,6,Yes,0,1.74,5.44,3.7,212,305,93,3,183,180,772.0,1899.0,1127.0,519000.0,0.0,-519000.0
<a href=/player/gilek001>gilek001</a>,Ken Giles,Houston Astros,ASTROS,1,3,1,4,2018,2020,2,No,0,2.45,2.96,0.51,92,98,6,0,0,0,254.0,276.0,22.0,4600000.0,0.0,-4600000.0
<a href=/player/gilhf101>gilhf101</a>,Frank Gilhooley,New York Yankees,YANKS,5,19,8,27,1918,1928,10,No,0,9.22,7.55,-1.67,1051,1233,182,2808,4705,1897,3476.0,418.0,-3058.0,39950.0,0.0,-39950.0
<a href=/player/gilkb001>gilkb001</a>,Bernard Gilkey,St. Louis Cardinals,CARDS,2,4,4,8,1996,1997,1,No,0,9.87,1.27,-8.6,636,73,-563,1576,226,-1350,1161.0,50.0,-1111.0,395000.0,0.0,-395000.0
<a href=/player/gilkb001>gilkb001</a>,Bernard Gilkey,New York Mets,METS,4,6,6,12,1998,1999,1,No,0,13.09,0.3,-12.79,1229,42,-1187,4418,40,-4378,991.0,86.0,-905.0,5050000.0,0.0,-5050000.0
<a href=/player/gillc001>gillc001</a>,Conor Gillaspie,San Francisco Giants,GIANTS,1,1,1,2,2013,2013,0,Yes,0,2.35,0.0,-2.35,322,0,-322,1143,0,-1143,0.0,0.0,0.0,0.0,0.0,0.0
<a href=/player/gillc002>gillc002</a>,Cole Gillespie,Milwaukee Brewers,BREWRS,1,2,1,3,2009,2009,0,No,0,-0.62,2.01,2.63,50,66,16,120,297,177,0.0,0.0,0.0,0.0,0.0,0.0
<a href=/player/gillc102>gillc102</a>,Carden Gillenwater,Washington Senators,TWINS,2,2,3,5,1948,1950,2,No,0,2.98,1.13,-1.85,263,176,-87,929,658,-271,0.0,0.0,0.0,0.0,0.0,0.0
<a href=/player/gillg102>gillg102</a>,Grant Gillis,Washington Senators,TWINS,1,5,1,6,1928,1941,13,No,0,14.54,41.49,26.95,801,1492,691,1696,6460,4764,3390.0,0.0,-3390.0,20500.0,0.0,-20500.0
<a href=/player/gillg103>gillg103</a>,George Gill,Detroit Tigers,TIGRS,3,9,7,16,1939,1948,9,No,0,19.29,21.11,1.82,2183,1686,-497,6579,6030,-549,3951.0,2317.0,-1634.0,44300.0,0.0,-44300.0
<a href=/player/gillj105>gillj105</a>,Johnny Gill,Chicago Cubs,CUBS,2,7,2,9,1936,1947,11,No,0,6.07,33.87,27.8,546,772,226,1567,1415,-152,1708.0,5741.0,4033.0,9500.0,0.0,-9500.0
<a href=/player/gilms001>gilms001</a>,Sean Gilmartin,Atlanta Braves,BRAVES,1,1,1,2,2013,2014,1,No,0,0.0,-0.66,-0.66,0,100,100,0,166,166,0.0,0.0,0.0,0.0,0.0,0.0
<a href=/player/gilsh101>gilsh101</a>,Hal Gilson,Chicago Cubs,CUBS,2,3,2,5,1965,1966,1,No,0,2.3,1.05,-1.25,454,82,-372,65,4,-61,1253.0,197.0,-1056.0,0.0,0.0,0.0
<a href=/player/gilsh101>gilsh101</a>,Hal Gilson,St. Louis Cardinals,CARDS,4,10,7,17,1968,1972,4,No,0,10.58,2.29,-8.29,1246,276,-970,1450,608,-842,1865.0,299.0,-1566.0,32500.0,0.0,-32500.0
<a href=/player/gimea001>gimea001</a>,Andres Gimenez,New York Mets,METS,1,4,2,6,2021,2021,0,Yes,0,2.78,2.19,-0.59,209,149,-60,798,543,-255,0.0,161.0,161.0,0.0,0.0,0.0
<a href=/player/gimec001>gimec001</a>,Chris Gimenez,Texas Rangers,RNGRS,1,1,1,2,2014,2014,0,No,0,-0.86,0.0,0.86,77,0,-77,165,0,-165,9.0,0.0,-9.0,510000.0,0.0,-510000.0
<a href=/player/gimec001>gimec001</a>,Chris Gimenez,Chicago Cubs,CUBS,1,2,1,3,2018,2018,0,No,0,-0.01,0.0,0.01,14,0,-14,34,0,-34,3.0,0.0,-3.0,0.0,0.0,0.0
<a href=/player/ginsj101>ginsj101</a>,Joe Ginsberg,Detroit Tigers,TIGRS,3,7,7,14,1953,1959,6,No,0,19.59,21.85,2.26,1560,1406,-154,4177,3381,-796,3244.0,3436.0,192.0,42000.0,0.0,-42000.0
<a href=/player/ginsj101>ginsj101</a>,Joe Ginsberg,Kansas City Athletics,ATLTCS,6,8,9,17,1956,1963,7,No,0,11.56,-1.9,-13.46,1347,971,-376,1827,2604,777,2603.0,1481.0,-1122.0,28000.0,0.0,-28000.0
<a href=/player/gintk001>gintk001</a>,Keith Ginter,Houston Astros,ASTROS,1,2,2,4,2002,2002,0,No,0,3.17,0.71,-2.46,341,21,-320,1022,77,-945,656.0,0.0,-656.0,0.0,0.0,0.0
<a href=/player/gintk001>gintk001</a>,Keith Ginter,Milwaukee Brewers,BREWRS,11,20,23,43,2004,2020,16,Yes,1,45.41,26.04,-19.37,3678,1749,-1929,14011,4509,-9502,777.0,3369.0,2592.0,29288833.0,0.0,-29288833.0
<a href=/player/gintm001>gintm001</a>,Matt Ginter,Chicago White Sox,WSOX,1,1,1,2,2004,2005,1,No,0,0.76,-1.32,-2.08,28,179,151,19,517,498,208.0,0.0,-208.0,0.0,0.0,0.0
<a href=/player/gintm001>gintm001</a>,Matt Ginter,New York Mets,METS,1,1,1,2,2005,2005,0,No,0,-0.39,0.0,0.39,14,0,-14,0,0,0,105.0,0.0,-105.0,0.0,0.0,0.0
<a href=/player/gioll001>gioll001</a>,Lucas Giolito,Washington Nationals,NATEX,1,3,1,4,2016,2020,4,No,0,16.01,2.64,-13.37,233,310,77,19,1309,1290,3554.0,0.0,-3554.0,0.0,0.0,0.0
<a href=/player/giona101>giona101</a>,Al Gionfriddo,Pittsburgh Pirates,PIRATS,26,51,64,115,1947,1973,26,No,0,53.52,64.51,10.99,4885,5814,929,13312,15757,2445,8388.0,7117.0,-1271.0,216500.0,0.0,-216500.0
<a href=/player/giraj001>giraj001</a>,Joe Girardi,Colorado Rockies,ROCKS,4,6,6,12,1995,2002,7,No,0,5.12,3.09,-2.03,903,626,-277,1475,18,-1457,907.0,1070.0,163.0,1850000.0,0.0,-1850000.0
<a href=/player/giult101>giult101</a>,Tony Giuliani,Brooklyn Dodgers,DOGRS,4,8,8,16,1941,1958,17,No,0,4.28,10.97,6.69,1667,1086,-581,5534,2416,-3118,435.0,3148.0,2713.0,50000.0,0.0,-50000.0
<a href=/player/giult101>giult101</a>,Tony Giuliani,Washington Senators,TWINS,1,2,1,3,1944,1947,3,No,0,0.0,4.02,4.02,0,227,227,0,837,837,0.0,0.0,0.0,0.0,0.0,0.0
<a href=/player/giusd101>giusd101</a>,Dave Giusti,Houston Astros,ASTROS,2,5,3,8,1968,1968,0,No,0,1.27,0.0,-1.27,405,0,-405,1102,0,-1102,299.0,0.0,-299.0,0.0,0.0,0.0
<a href=/player/giusd101>giusd101</a>,Dave Giusti,San Diego Padres,PADRS,5,6,10,16,1968,1972,4,No,0,-0.42,6.04,6.46,285,800,515,635,2318,1683,399.0,445.0,46.0,0.0,0.0,0.0
<a href=/player/giusd101>giusd101</a>,Dave Giusti,St. Louis Cardinals,CARDS,2,4,5,9,1969,1972,3,No,0,8.31,1.34,-6.97,834,199,-635,108,492,384,1854.0,0.0,-1854.0,17500.0,0.0,-17500.0
<a href=/player/giusd101>giusd101</a>,Dave Giusti,Pittsburgh Pirates,PIRATS,5,10,11,21,1977,1988,11,No,0,53.71,31.99,-21.72,2929,1675,-1254,9660,6568,-3092,5429.0,149.0,-5280.0,807000.0,0.0,-807000.0
<a href=/player/giveb001>giveb001</a>,Brian Givens,New York Mets,METS,1,1,1,2,1990,1990,0,No,0,0.0,-0.07,-0.07,0,16,16,0,23,23,0.0,0.0,0.0,0.0,0.0,0.0
<a href=/player/givem001>givem001</a>,Mychal Givens,Baltimore Orioles,ORLS,1,1,3,4,2020,2020,0,Yes,0,0.91,0.0,-0.91,72,0,-72,0,0,0,117.0,0.0,-117.0,3225000.0,0.0,-3225000.0
<a href=/player/givem001>givem001</a>,Mychal Givens,Colorado Rockies,ROCKS,1,1,2,3,2021,2021,0,Yes,0,0.31,0.0,-0.31,46,0,-46,0,0,0,64.0,0.0,-64.0,4050000.0,0.0,-4050000.0
<a href=/player/gladd001>gladd001</a>,Dan Gladden,San Francisco Giants,GIANTS,1,2,3,5,1987,1994,7,No,0,5.69,0.91,-4.78,646,306,-340,2698,81,-2617,6.0,1068.0,1062.0,0.0,0.0,0.0
<a href=/player/gladf101>gladf101</a>,Fred Glade,St.Louis Browns,ORLS,1,3,3,6,1907,1907,0,No,0,6.22,0.0,-6.22,491,0,-491,1891,0,-1891,92.0,0.0,-92.0,0.0,0.0,0.0
<a href=/player/gladf102>gladf102</a>,Fred Gladding,Detroit Tigers,TIGRS,1,2,1,3,1967,1968,1,No,0,1.07,1.09,0.02,466,67,-399,26,185,159,791.0,0.0,-791.0,18000.0,0.0,-18000.0
<a href=/player/gland001>gland001</a>,Doug Glanville,Chicago Cubs,CUBS,1,1,1,2,1997,1999,2,No,0,8.7,2.76,-5.94,840,298,-542,3425,1190,-2235,0.0,0.0,0.0,155000.0,0.0,-155000.0
<a href=/player/gland001>gland001</a>,Doug Glanville,Texas Rangers,RNGRS,1,1,2,3,2003,2003,0,No,0,-0.37,0.0,0.37,28,0,-28,55,0,-55,0.0,0.0,0.0,1000000.0,0.0,-1000000.0
<a href=/player/glasj101>glasj101</a>,Jack Glasscock,St. Louis Cardinals,CARDS,2,2,3,5,1893,1895,2,No,0,2.73,-0.72,-3.45,266,276,10,1209,1267,58,0.0,0.0,0.0,0.0,0.0,0.0
<a href=/player/glast001>glast001</a>,Tyler Glasnow,Pittsburgh Pirates,PIRATS,1,3,1,4,2018,2020,2,No,0,12.58,1.43,-11.15,379,64,-315,1364,58,-1306,825.0,516.0,-309.0,556500.0,0.0,-556500.0
<a href=/player/glast101>glast101</a>,Tom Glass,Philadelphia Athletics,ATLTCS,1,4,1,5,1925,1925,0,No,0,0.0,0.15,0.15,0,133,133,0,522,522,0.0,0.0,0.0,4850.0,0.0,-4850.0
<a href=/player/glaut001>glaut001</a>,Troy Glaus,Arizona Diamondbacks,DBACKS,5,6,8,14,2005,2019,14,Yes,3,11.95,12.76,0.81,863,764,-99,2032,1902,-130,590.0,1295.0,705.0,13875000.0,0.0,-13875000.0
<a href=/player/glaut001>glaut001</a>,Troy Glaus,Toronto Blue Jays,BJAYS,4,8,10,18,2008,2014,6,No,0,11.09,15.81,4.72,891,818,-73,2056,3028,972,842.0,175.0,-667.0,19454600.0,0.0,-19454600.0
<a href=/player/glazw101>glazw101</a>,Whitey Glazner,Pittsburgh Pirates,PIRATS,1,3,2,5,1923,1926,3,No,0,3.4,4.98,1.58,247,281,34,625,924,299,954.0,681.0,-273.0,4200.0,0.0,-4200.0
<a href=/player/gleab101>gleab101</a>,Billy Gleason,Pittsburgh Pirates,PIRATS,1,2,1,3,1917,1917,0,No,0,0.0,-0.95,-0.95,0,109,109,0,437,437,0.0,0.0,0.0,1200.0,0.0,-1200.0
<a href=/player/gleab101>gleab101</a>,Billy Gleason,St.Louis Browns,ORLS,1,6,1,7,1921,1921,0,No,0,0.0,0.0,0.0,0,0,0,0,0,0,0.0,0.0,0.0,6600.0,0.0,-6600.0
<a href=/player/gleab102>gleab102</a>,Bill Gleason,St.Louis Cardinals,CARDS,1,2,4,6,1887,1897,10,No,0,9.58,4.43,-5.15,488,169,-319,2210,668,-1542,3.0,0.0,-3.0,0.0,0.0,0.0
<a href=/player/gleaj001>gleaj001</a>,Jerry Gleaton,Texas Rangers,RNGRS,4,10,10,20,1980,1987,7,No,0,9.35,8.94,-0.41,686,425,-261,1581,631,-950,2721.0,2684.0,-37.0,817500.0,0.0,-817500.0
<a href=/player/gleaj001>gleaj001</a>,Jerry Gleaton,Seattle Mariners,MARNRS,1,2,1,3,1984,1985,1,No,0,2.78,0.75,-2.03,163,36,-127,1,0,-1,1149.0,444.0,-705.0,0.0,0.0,0.0
<a href=/player/gleaj001>gleaj001</a>,Jerry Gleaton,Kansas City Royals,ROYALS,1,1,1,2,1990,1990,0,No,0,2.28,0.0,-2.28,104,0,-104,0,0,0,474.0,0.0,-474.0,0.0,0.0,0.0
<a href=/player/gleak101>gleak101</a>,Kid Gleason,Baltimore Orioles,BLN,3,6,5,11,1895,1899,4,No,0,5.76,25.14,19.38,944,678,-266,3948,2726,-1222,148.0,1122.0,974.0,0.0,0.0,0.0
<a href=/player/gleak101>gleak101</a>,Kid Gleason,Detroit Tigers,TIGRS,1,1,1,2,1903,1903,0,No,0,0.0,-0.14,-0.14,0,93,93,0,376,376,0.0,0.0,0.0,0.0,0.0,0.0
<a href=/player/gleej101>gleej101</a>,Jim Gleeson,Chicago Cubs,CUBS,1,2,1,3,1940,1940,0,No,0,0.59,0.0,-0.59,137,0,-137,458,0,-458,0.0,0.0,0.0,0.0,0.0,0.0
<a href=/player/gleej101>gleej101</a>,Jim Gleeson,Cincinnati Reds,REDS,1,1,1,2,1942,1942,0,No,0,0.0,0.11,0.11,0,131,131,0,576,576,0.0,0.0,0.0,0.0,0.0,0.0
<a href=/player/gleej101>gleej101</a>,Jim Gleeson,St. Louis Cardinals,CARDS,4,11,7,18,1946,1954,8,No,0,10.75,4.84,-5.91,1144,525,-619,2713,1686,-1027,1601.0,388.0,-1213.0,41500.0,0.0,-41500.0
<a href=/player/glenj101>glenj101</a>,Joe Glenn,New York Yankees,YANKS,2,3,3,6,1938,1944,6,No,0,-0.13,2.92,3.05,384,138,-246,1290,241,-1049,3.0,438.0,435.0,17000.0,0.0,-17000.0
<a href=/player/glenj103>glenj103</a>,John Glenn,Los Angeles Dodgers,DOGRS,1,1,2,3,1960,1960,0,No,0,-0.2,0.0,0.2,32,0,-32,32,0,-32,0.0,0.0,0.0,0.0,0.0,0.0
<a href=/player/gloar001>gloar001</a>,Ross Gload,Florida Marlins,MARLNS,1,2,1,3,2000,2000,0,No,0,-0.32,-0.12,0.2,18,36,18,35,123,88,0.0,0.0,0.0,0.0,0.0,0.0
<a href=/player/gloar001>gloar001</a>,Ross Gload,Colorado Rockies,ROCKS,1,3,3,6,2002,2002,0,No,0,0.0,0.1,0.1,0,193,193,0,708,708,0.0,3.0,3.0,0.0,0.0,0.0
<a href=/player/gloar001>gloar001</a>,Ross Gload,Colorado Rockies,ROCKS,1,1,1,2,2003,2003,0,No,0,-0.65,0.0,0.65,215,0,-215,471,0,-471,0.0,0.0,0.0,0.0,0.0,0.0
<a href=/player/gloar001>gloar001</a>,Ross Gload,Chicago White Sox,WSOX,1,1,1,2,2006,2008,2,No,0,0.28,-0.38,-0.66,224,20,-204,764,0,-764,0.0,42.0,42.0,350000.0,0.0,-350000.0
<a href=/player/gloar001>gloar001</a>,Ross Gload,Kansas City Royals,ROYALS,1,2,1,3,2009,2009,0,No,0,0.5,0.0,-0.5,126,0,-126,259,0,-259,3.0,0.0,-3.0,0.0,0.0,0.0
<a href=/player/glosa101>glosa101</a>,Al Glossop,New York Giants,GIANTS,1,2,1,3,1940,1945,5,No,0,4.14,-0.49,-4.63,264,88,-176,377,324,-53,1753.0,0.0,-1753.0,0.0,0.0,0.0
<a href=/player/glosa101>glosa101</a>,Al Glossop,Philadelphia Phillies,PHILS,2,3,3,6,1943,1943,0,No,0,0.73,1.46,0.73,404,136,-268,1520,565,-955,0.0,0.0,0.0,0.0,0.0,0.0
<a href=/player/glovg001>glovg001</a>,Gary Glover,Toronto Blue Jays,BJAYS,1,1,1,2,2000,2002,2,No,0,0.76,0.79,0.03,117,71,-46,1,0,-1,823.0,237.0,-586.0,0.0,0.0,0.0
<a href=/player/glovg001>glovg001</a>,Gary Glover,Chicago White Sox,WSOX,1,3,2,5,2003,2004,1,No,0,0.04,0.32,0.28,21,41,20,0,2,2,90.0,416.0,326.0,330000.0,0.0,-330000.0
<a href=/player/glynb101>glynb101</a>,Bill Glynn,Sacramento,Sacramento,1,1,2,3,1952,1952,0,No,0,0.42,0.0,-0.42,302,0,-302,758,0,-758,0.0,0.0,0.0,0.0,0.0,0.0
<a href=/player/glynb101>glynb101</a>,Bill Glynn,Philadelphia Phillies,PHILS,1,1,1,2,1951,1951,0,No,0,0.0,0.0,0.0,0,0,0,0,0,0,0.0,0.0,0.0,0.0,0.0,0.0
<a href=/player/glyne001>glyne001</a>,Ed Glynn,Detroit Tigers,TIGRS,1,1,1,2,1979,1979,0,No,0,1.0,0.0,-1.0,168,0,-168,12,0,-12,337.0,0.0,-337.0,0.0,0.0,0.0
<a href=/player/glyne001>glyne001</a>,Ed Glynn,New York Mets,METS,2,4,2,6,1981,1987,6,No,0,3.46,-0.12,-3.58,161,72,-89,111,61,-50,1165.0,505.0,-660.0,0.0,0.0,0.0
<a href=/player/godbd101>godbd101</a>,Danny Godby,Cincinnati Reds,REDS,1,1,1,2,1971,1971,0,No,0,-0.15,0.0,0.15,13,0,-13,17,0,-17,0.0,0.0,0.0,0.0,0.0,0.0
<a href=/player/godbd101>godbd101</a>,Danny Godby,St. Louis Cardinals,CARDS,1,1,1,2,1975,1975,0,No,0,0.0,-0.29,-0.29,0,22,22,0,36,36,0.0,0.0,0.0,0.0,0.0,0.0
<a href=/player/godfg001>godfg001</a>,Graham Godfrey,Toronto Blue Jays,BJAYS,7,22,17,39,2007,2021,14,Yes,2,23.56,39.55,15.99,2136,1586,-550,5749,4593,-1156,4919.0,6292.0,1373.0,13532900.0,0.0,-13532900.0
<a href=/player/godfg001>godfg001</a>,Graham Godfrey,Oakland Athletics,ATLTCS,1,1,1,2,2012,2012,0,No,0,0.0,0.0,0.0,0,0,0,0,0,0,0.0,0.0,0.0,480000.0,0.0,-480000.0
<a href=/player/godlz001>godlz001</a>,Zack Godley,Chicago Cubs,CUBS,2,4,2,6,2014,2017,3,No,0,0.75,1.66,0.91,266,245,-21,270,799,529,1562.0,7.0,-1555.0,14000000.0,0.0,-14000000.0
<a href=/player/godwt001>godwt001</a>,Tyrell Godwin,Toronto Blue Jays,BJAYS,1,1,1,2,2005,2005,0,No,0,0.0,0.0,0.0,3,0,-3,3,0,-3,0.0,0.0,0.0,0.0,0.0,0.0
<a href=/player/goebe101>goebe101</a>,Ed Goebel,Washington Senators,TWINS,1,3,2,5,1923,1930,7,No,0,1.13,22.03,20.9,449,1009,560,1547,3473,1926,0.0,543.0,543.0,0.0,0.0,0.0
<a href=/player/goebe101>goebe101</a>,Ed Goebel,Boston Red Sox,RSOX,1,1,1,2,1923,1929,6,No,0,0.0,14.79,14.79,0,789,789,0,3399,3399,0.0,0.0,0.0,0.0,0.0,0.0
<a href=/player/goebj001>goebj001</a>,Jake Goebbert,Houston Astros,ASTROS,2,2,2,4,2013,2013,0,No,0,-0.03,0.12,0.15,4,45,41,0,0,0,46.0,105.0,59.0,0.0,0.0,0.0
<a href=/player/goebj001>goebj001</a>,Jake Goebbert,Oakland Athletics,ATLTCS,1,2,1,3,2014,2014,0,No,0,-0.14,0.59,0.73,51,21,-30,115,56,-59,0.0,0.0,0.0,0.0,0.0,0.0
<a href=/player/goffj001>goffj001</a>,Jerry Goff,Seattle Mariners,MARNRS,1,1,1,2,1990,1990,0,No,0,-0.62,0.0,0.62,55,0,-55,144,0,-144,0.0,0.0,0.0,0.0,0.0,0.0
<a href=/player/goggc101>goggc101</a>,Chuck Goggin,Los Angeles Dodgers,DOGRS,1,3,1,4,1969,1969,0,No,0,0.16,0.15,-0.01,6,18,12,9,21,12,0.0,169.0,169.0,0.0,0.0,0.0
<a href=/player/goggc101>goggc101</a>,Chuck Goggin,Atlanta Braves,BRAVES,1,1,1,2,1974,1978,4,No,0,0.02,-0.68,-0.7,2,299,297,1,1000,999,0.0,0.0,0.0,0.0,0.0,0.0
<a href=/player/gogob101>gogob101</a>,Bill Gogolewski,Texas Rangers,RNGRS,1,1,1,2,1974,1976,2,No,0,-0.02,2.16,2.18,5,105,100,0,0,0,41.0,1501.0,1460.0,0.0,0.0,0.0
<a href=/player/gohal001>gohal001</a>,Luiz Gohara,Seattle Mariners,MARNRS,2,5,3,8,2017,2017,0,No,0,6.57,-0.14,-6.71,362,9,-353,845,0,-845,1646.0,23.0,-1623.0,0.0,0.0,0.0
<a href=/player/gohrg001>gohrg001</a>,Greg Gohr,Detroit Tigers,TIGRS,1,1,1,2,1996,2003,7,No,0,-0.3,17.79,18.09,15,841,826,0,3512,3512,72.0,0.0,-72.0,200000.0,0.0,-200000.0
<a href=/player/goldg101>goldg101</a>,Gordon Goldsberry,Chicago White Sox,WSOX,2,6,4,10,1951,1963,12,No,0,1.43,25.02,23.59,363,1422,1059,910,5079,4169,614.0,0.0,-614.0,0.0,0.0,0.0
<a href=/player/goldg101>goldg101</a>,Gordon Goldsberry,Seattle,Seattle,1,1,1,2,1953,1954,1,No,0,0.0,0.0,0.0,0,0,0,0,0,0,0.0,0.0,0.0,0.0,0.0,0.0
<a href=/player/goldj102>goldj102</a>,Jim Golden,Philadelphia Phillies,PHILS,1,3,1,4,1958,1958,0,No,0,-0.86,0.0,0.86,137,0,-137,129,0,-129,226.0,0.0,-226.0,0.0,0.0,0.0
<a href=/player/goldj102>goldj102</a>,Jim Golden,Houston Astros,ASTROS,1,3,1,4,1963,1964,1,No,0,0.82,1.37,0.55,136,133,-3,10,502,492,336.0,0.0,-336.0,0.0,0.0,0.0
<a href=/player/goldp001>goldp001</a>,Paul Goldschmidt,Arizona Diamondbacks,DBACKS,1,1,4,5,2018,2018,0,Yes,0,10.75,0.0,-10.75,377,0,-377,1592,0,-1592,0.0,0.0,0.0,11100000.0,0.0,-11100000.0
<a href=/player/golsg001>golsg001</a>,Greg Golson,Philadelphia Phillies,PHILS,2,2,2,4,2008,2014,6,Yes,0,-0.05,1.98,2.03,16,500,484,31,1370,1339,0.0,0.0,0.0,1587500.0,0.0,-1587500.0
<a href=/player/golsg001>golsg001</a>,Greg Golson,Texas Rangers,RNGRS,1,1,2,3,2010,2010,0,No,0,-0.32,0.0,0.32,33,0,-33,35,0,-35,0.0,0.0,0.0,0.0,0.0,0.0
<a href=/player/golvw101>golvw101</a>,Walt Golvin,Mobile,Mobile,1,1,1,2,1921,1924,3,No,0,-0.05,0.0,0.05,2,0,-2,2,0,-2,0.0,0.0,0.0,0.0,0.0,0.0
<a href=/player/gomba001>gomba001</a>,Austin Gomber,St. Louis Cardinals,CARDS,1,5,1,6,2021,2021,0,Yes,0,0.69,4.14,3.45,45,157,112,42,653,611,346.0,0.0,-346.0,0.0,0.0,0.0
<a href=/player/gomeb001>gomeb001</a>,Brandon Gomes,San Diego Padres,PADRS,1,4,1,5,2010,2012,2,No,0,1.36,-1.01,-2.37,435,168,-267,53,716,663,1270.0,0.0,-1270.0,401300.0,0.0,-401300.0
<a href=/player/gomec001>gomec001</a>,Chris Gomez,Detroit Tigers,TIGRS,7,15,18,33,1996,2010,14,No,1,12.92,23.75,10.83,4861,1561,-3300,12744,2643,-10101,4562.0,6757.0,2195.0,12079000.0,0.0,-12079000.0
<a href=/player/gomec002>gomec002</a>,Carlos Gomez,New York Mets,METS,1,4,1,5,2008,2013,5,No,0,2.31,15.63,13.32,305,210,-95,963,247,-716,66.0,2151.0,2085.0,0.0,0.0,0.0
<a href=/player/gomec002>gomec002</a>,Carlos Gomez,Minnesota Twins,TWINS,2,3,3,6,2009,2011,2,No,0,34.66,0.71,-33.95,1586,128,-1458,6212,375,-5837,0.0,74.0,74.0,6987500.0,0.0,-6987500.0
<a href=/player/gomec002>gomec002</a>,Carlos Gomez,Milwaukee Brewers,BREWRS,3,6,7,13,2015,2020,5,Yes,0,-0.06,8.37,8.43,453,778,325,1232,2675,1443,1628.0,6.0,-1622.0,1084900.0,0.0,-1084900.0
<a href=/player/gomej001>gomej001</a>,Jonny Gomes,Cincinnati Reds,REDS,1,2,2,4,2011,2011,0,No,0,-0.17,0.0,0.17,43,0,-43,107,0,-107,0.0,0.0,0.0,1750000.0,0.0,-1750000.0
<a href=/player/gomej001>gomej001</a>,Jonny Gomes,Boston Red Sox,RSOX,2,6,3,9,2014,2019,5,No,0,10.72,10.88,0.16,412,221,-191,504,237,-267,1024.0,2892.0,1868.0,15500000.0,0.0,-15500000.0
<a href=/player/gomej001>gomej001</a>,Jonny Gomes,Atlanta Braves,BRAVES,1,2,1,3,2015,2015,0,Yes,0,-0.44,0.0,0.44,12,0,-12,34,0,-34,0.0,0.0,0.0,4000000.0,0.0,-4000000.0
<a href=/player/gomej002>gomej002</a>,Jeanmar Gomez,Cleveland Indians,INDINS,1,1,1,2,2013,2013,0,Yes,0,0.72,0.0,-0.72,150,0,-150,15,0,-15,428.0,0.0,-428.0,0.0,0.0,0.0
<a href=/player/gomel101>gomel101</a>,Luis Gomez,Toronto Blue Jays,BJAYS,2,3,4,7,1979,1985,6,No,0,4.77,5.46,0.69,1218,673,-545,3925,1647,-2278,3.0,1160.0,1157.0,0.0,0.0,0.0
<a href=/player/gomep001>gomep001</a>,Pat Gomez,Chicago Cubs,CUBS,2,3,2,5,1989,1995,6,No,0,0.08,5.77,5.69,44,681,637,53,415,362,52.0,994.0,942.0,2665333.0,0.0,-2665333.0
<a href=/player/gomep001>gomep001</a>,Pat Gomez,Atlanta Braves,BRAVES,3,4,3,7,1992,1999,7,No,0,0.31,0.4,0.09,48,230,182,82,473,391,451.0,0.0,-451.0,3294833.0,0.0,-3294833.0
<a href=/player/gomep001>gomep001</a>,Pat Gomez,Texas Rangers,RNGRS,1,1,1,2,1992,1993,1,No,0,0.01,0.0,-0.01,55,0,-55,5,0,-5,95.0,0.0,-95.0,0.0,0.0,0.0
<a href=/player/gomer101>gomer101</a>,Ruben Gomez,San Francisco Giants,GIANTS,1,2,1,3,1958,1965,7,No,0,-2.23,13.08,15.31,168,471,303,186,541,355,408.0,4217.0,3809.0,0.0,0.0,0.0
<a href=/player/gomer101>gomer101</a>,Ruben Gomez,Cleveland Indians,INDINS,1,1,3,4,1962,1962,0,No,0,-0.13,-0.08,0.05,12,2,-10,6,0,-6,58.0,4.0,-54.0,0.0,0.0,0.0
<a href=/player/gomew001>gomew001</a>,Wayne Gomes,Philadelphia Phillies,PHILS,1,1,1,2,2001,2002,1,No,0,-0.56,-0.27,0.29,26,33,7,0,47,47,45.0,0.0,-45.0,925000.0,0.0,-925000.0
<a href=/player/gomey001>gomey001</a>,Yan Gomes,Toronto Blue Jays,BJAYS,1,2,1,3,2012,2014,2,No,0,11.57,-0.01,-11.58,944,66,-878,3396,7,-3389,0.0,475.0,475.0,0.0,0.0,0.0
<a href=/player/gomey001>gomey001</a>,Yan Gomes,Cleveland Indians,INDINS,1,1,3,4,2018,2020,2,Yes,0,4.3,0.15,-4.15,190,11,-179,712,0,-712,0.0,140.0,140.0,6033333.0,0.0,-6033333.0
<a href=/player/gomey001>gomey001</a>,Yan Gomes,Washington Nationals,NATEX,1,3,3,6,2021,2021,0,Yes,0,-0.1,0.0,0.1,88,0,-88,339,0,-339,0.0,0.0,0.0,7000000.0,0.0,-7000000.0
<a href=/player/gondj101>gondj101</a>,Jesse Gonder,New York Yankees,YANKS,1,1,1,2,1961,1963,2,No,0,0.32,0.19,-0.13,35,150,115,37,15,-22,0.0,314.0,314.0,0.0,0.0,0.0
<a href=/player/gondj101>gondj101</a>,Jesse Gonder,Cincinnati Reds,REDS,2,2,3,5,1963,1964,1,No,0,1.97,-1.44,-3.41,230,52,-178,635,108,-527,0.0,0.0,0.0,0.0,0.0,0.0
<a href=/player/gondj101>gondj101</a>,Jesse Gonder,New York Mets,METS,2,3,3,6,1965,1970,5,No,0,1.3,1.09,-0.21,219,338,119,292,479,187,516.0,1427.0,911.0,0.0,0.0,0.0
<a href=/player/gondj101>gondj101</a>,Jesse Gonder,Cincinnati Reds,REDS,1,3,2,5,1960,1960,0,No,0,3.11,0.0,-3.11,276,0,-276,63,0,-63,598.0,0.0,-598.0,0.0,0.0,0.0
<a href=/player/gonza001>gonza001</a>,Alex Gonzalez,Toronto Blue Jays,BJAYS,1,1,2,3,2001,2002,1,No,0,1.3,0.37,-0.93,331,55,-276,1304,0,-1304,0.0,157.0,157.0,4250000.0,0.0,-4250000.0
<a href=/player/gonza001>gonza001</a>,Alex Gonzalez,Chicago Cubs,CUBS,2,8,4,12,2004,2009,5,No,0,11.71,9.74,-1.97,643,537,-106,2292,1477,-815,256.0,718.0,462.0,5750000.0,0.0,-5750000.0
<a href=/player/gonza002>gonza002</a>,Alex Gonzalez,Cincinnati Reds,REDS,1,2,1,3,2009,2015,6,No,0,0.3,1.65,1.35,44,96,52,159,270,111,0.0,0.0,0.0,5375000.0,0.0,-5375000.0
<a href=/player/gonza002>gonza002</a>,Alex Gonzalez,Toronto Blue Jays,BJAYS,4,18,13,31,2010,2018,8,No,0,25.98,29.42,3.44,2444,1447,-997,6892,4630,-2262,4668.0,4909.0,241.0,11482900.0,0.0,-11482900.0
<a href=/player/gonza002>gonza002</a>,Alex Gonzalez,Baltimore Orioles,ORLS,1,1,1,2,2014,2015,1,No,0,-0.53,-0.68,-0.15,9,20,11,32,74,42,0.0,0.0,0.0,0.0,0.0,0.0
<a href=/player/gonza003>gonza003</a>,Adrian Gonzalez,Florida Marlins,MARLNS,1,3,1,4,2003,2003,0,No,0,-0.88,2.14,3.02,60,66,6,206,2,-204,10.0,115.0,105.0,0.0,0.0,0.0
<a href=/player/gonza003>gonza003</a>,Adrian Gonzalez,Texas Rangers,RNGRS,1,3,3,6,2006,2007,1,No,0,28.55,3.75,-24.8,1126,114,-1012,3924,0,-3924,1652.0,471.0,-1181.0,0.0,0.0,0.0
<a href=/player/gonza003>gonza003</a>,Adrian Gonzalez,San Diego Padres,PADRS,8,18,17,35,2010,2021,11,Yes,0,47.37,0.77,-46.6,2178,704,-1474,7839,1088,-6751,1041.0,2539.0,1498.0,15535200.0,0.0,-15535200.0
<a href=/player/gonza003>gonza003</a>,Adrian Gonzalez,Boston Red Sox,RSOX,7,22,14,36,2012,2019,7,Yes,0,37.54,19.18,-18.36,2738,1439,-1299,4768,4566,-202,4720.0,1908.0,-2812.0,4708000.0,0.0,-4708000.0
<a href=/player/gonza003>gonza003</a>,Adrian Gonzalez,Los Angeles Dodgers,DOGRS,4,17,9,26,2017,2021,4,Yes,0,6.07,9.48,3.41,927,279,-648,2727,1007,-1720,545.0,229.0,-316.0,71371000.0,0.0,-71371000.0
<a href=/player/gonza005>gonza005</a>,Alberto Gonzalez,Arizona Diamondbacks,DBACKS,1,4,2,6,2007,2008,1,No,0,-0.71,4.28,4.99,171,78,-93,110,78,-32,366.0,722.0,356.0,0.0,0.0,0.0
<a href=/player/gonza005>gonza005</a>,Alberto Gonzalez,New York Yankees,YANKS,3,5,4,9,2008,2013,5,Yes,1,-0.45,11.97,12.42,264,599,335,618,2501,1883,20.0,3.0,-17.0,1165000.0,0.0,-1165000.0
<a href=/player/gonza005>gonza005</a>,Alberto Gonzalez,Washington Nationals,NATEX,1,1,2,3,2011,2016,5,No,0,-0.13,0.1,0.23,102,20,-82,267,0,-267,0.0,26.0,26.0,0.0,0.0,0.0
<a href=/player/gonzc001>gonzc001</a>,Carlos Gonzalez,Arizona Diamondbacks,DBACKS,6,14,16,30,2007,2018,11,Yes,0,24.99,30.17,5.18,855,1190,335,1319,2038,719,6760.0,6326.0,-434.0,14741000.0,0.0,-14741000.0
<a href=/player/gonzc001>gonzc001</a>,Carlos Gonzalez,Oakland Athletics,ATLTCS,6,8,8,16,2008,2014,6,Yes,0,50.06,1.09,-48.97,2622,167,-2455,9256,628,-8628,794.0,101.0,-693.0,16800000.0,0.0,-16800000.0
<a href=/player/gonzd001>gonzd001</a>,Denny Gonzalez,Pittsburgh Pirates,PIRATS,2,4,5,9,1988,2000,12,No,0,14.38,27.85,13.47,1120,1409,289,4205,5288,1083,0.0,260.0,260.0,7267500.0,0.0,-7267500.0
<a href=/player/gonzd002>gonzd002</a>,Dicky Gonzalez,New York Mets,METS,1,4,3,7,2002,2005,3,No,0,2.12,1.12,-1.0,505,185,-320,25,27,2,939.0,263.0,-676.0,300000.0,0.0,-300000.0
<a href=/player/gonzd101>gonzd101</a>,Dan Gonzales,Detroit Tigers,TIGRS,1,2,3,5,1980,1980,0,No,0,0.0,0.0,0.0,0,0,0,0,0,0,0.0,0.0,0.0,0.0,0.0,0.0
<a href=/player/gonze004>gonze004</a>,Erik Gonzalez,Cleveland Indians,INDINS,2,5,3,8,2018,2021,3,Yes,0,0.47,1.8,1.33,203,170,-33,650,509,-141,11.0,0.0,-11.0,547800.0,0.0,-547800.0
<a href=/player/gonzf101>gonzf101</a>,Fernando Gonzalez,Pittsburgh Pirates,PIRATS,3,4,6,10,1973,1978,5,No,0,0.57,-0.14,-0.71,111,383,272,173,830,657,645.0,0.0,-645.0,94500.0,0.0,-94500.0
<a href=/player/gonzg003>gonzg003</a>,Gio Gonzalez,Chicago White Sox,WSOX,2,5,3,8,2005,2009,4,No,0,5.6,12.08,6.48,287,529,242,1146,2165,1019,0.0,0.0,0.0,15000000.0,0.0,-15000000.0
<a href=/player/gonzg003>gonzg003</a>,Gio Gonzalez,Philadelphia Phillies,PHILS,1,2,1,3,2006,2007,1,No,0,16.18,-0.17,-16.35,196,21,-175,20,22,2,3223.0,174.0,-3049.0,330000.0,0.0,-330000.0
<a href=/player/gonzg003>gonzg003</a>,Gio Gonzalez,Chicago White Sox,WSOX,2,5,4,9,2008,2011,3,No,0,24.92,-0.88,-25.8,1177,181,-996,4107,638,-3469,1718.0,20.0,-1698.0,3600000.0,0.0,-3600000.0
<a href=/player/gonzg003>gonzg003</a>,Gio Gonzalez,Oakland Athletics,ATLTCS,13,26,22,48,2011,2019,8,Yes,0,41.81,19.43,-22.38,2657,1492,-1165,5603,3820,-1783,7622.0,2917.0,-4705.0,9735001.0,0.0,-9735001.0
<a href=/player/gonzg003>gonzg003</a>,Gio Gonzalez,Washington Nationals,NATEX,1,2,2,4,2018,2018,0,Yes,0,2.42,0.0,-2.42,47,0,-47,36,0,-36,338.0,0.0,-338.0,12000000.0,0.0,-12000000.0
<a href=/player/gonzj001>gonzj001</a>,Jose Gonzalez,Los Angeles Dodgers,DOGRS,1,1,1,2,1991,1995,4,No,0,-0.17,0.19,0.36,16,417,401,23,736,713,0.0,0.0,0.0,0.0,0.0,0.0
<a href=/player/gonzj002>gonzj002</a>,Juan Gonzalez,Texas Rangers,RNGRS,6,16,16,32,1999,2013,14,No,4,10.07,37.12,27.05,1336,2425,1089,3189,7223,4034,1798.0,1911.0,113.0,18360260.0,0.0,-18360260.0
<a href=/player/gonzj003>gonzj003</a>,Geremi Gonzalez,New York Mets,METS,1,1,1,2,2006,2006,0,No,0,-0.65,0.0,0.65,40,0,-40,5,0,-5,126.0,0.0,-126.0,0.0,0.0,0.0
<a href=/player/gonzj101>gonzj101</a>,Julio Gonzalez,Chicago Cubs,CUBS,10,18,20,38,1976,1990,14,No,0,19.28,13.33,-5.95,2985,1542,-1443,7849,3350,-4499,1072.0,3217.0,2145.0,890000.0,0.0,-890000.0
<a href=/player/gonzl001>gonzl001</a>,Luis Gonzalez,Houston Astros,ASTROS,2,4,2,6,1995,1996,1,No,0,9.88,0.54,-9.34,757,136,-621,2742,446,-2296,0.0,0.0,0.0,3390000.0,0.0,-3390000.0
<a href=/player/gonzl001>gonzl001</a>,Luis Gonzalez,Detroit Tigers,TIGRS,1,1,1,2,1998,2000,2,No,0,30.02,0.12,-29.9,1194,104,-1090,5246,327,-4919,0.0,0.0,0.0,2000000.0,0.0,-2000000.0
<a href=/player/gonzl003>gonzl003</a>,Lariel Gonzalez,Colorado Rockies,ROCKS,1,2,1,3,2000,2001,1,No,0,0.11,1.15,1.04,43,56,13,4,64,60,116.0,502.0,386.0,0.0,0.0,0.0
<a href=/player/gonzm001>gonzm001</a>,Mike Gonzalez,Pittsburgh Pirates,PIRATS,7,13,14,27,2003,2013,10,No,0,4.43,39.52,35.09,675,2405,1730,958,7168,6210,1221.0,934.0,-287.0,15866667.0,0.0,-15866667.0
<a href=/player/gonzm001>gonzm001</a>,Mike Gonzalez,Boston Red Sox,RSOX,2,7,4,11,2003,2008,5,No,0,19.22,18.0,-1.22,1732,200,-1532,2840,14,-2826,1848.0,2423.0,575.0,634000.0,0.0,-634000.0
<a href=/player/gonzm001>gonzm001</a>,Mike Gonzalez,Pittsburgh Pirates,PIRATS,2,3,4,7,2007,2013,6,No,0,1.29,2.54,1.25,298,397,99,105,1590,1485,375.0,0.0,-375.0,7050000.0,0.0,-7050000.0
<a href=/player/gonzm001>gonzm001</a>,Mike Gonzalez,Baltimore Orioles,ORLS,3,5,5,10,2011,2019,8,No,0,26.48,4.9,-21.58,1123,609,-514,389,1879,1490,3814.0,575.0,-3239.0,6514000.0,0.0,-6514000.0
<a href=/player/gonzm002>gonzm002</a>,Marwin Gonzalez,Boston Red Sox,RSOX,1,1,1,2,2011,2011,0,No,0,11.7,0.0,-11.7,809,0,-809,2742,0,-2742,0.0,0.0,0.0,0.0,0.0,0.0
<a href=/player/gonzm003>gonzm003</a>,Miguel Gonzalez,Chicago White Sox,WSOX,1,1,1,2,2017,2017,0,Yes,0,-0.03,0.0,0.03,6,0,-6,1,0,-1,67.0,0.0,-67.0,5900000.0,0.0,-5900000.0
<a href=/player/gonzm005>gonzm005</a>,Marco Gonzales,St. Louis Cardinals,CARDS,1,1,1,2,2017,2017,0,Yes,0,9.86,0.0,-9.86,115,0,-115,15,0,-15,1858.0,0.0,-1858.0,0.0,0.0,0.0
<a href=/player/gonzm007>gonzm007</a>,Merandy Gonzalez,New York Mets,METS,1,2,1,3,2017,2018,1,No,0,-0.15,-0.36,-0.21,15,96,81,4,0,-4,66.0,116.0,50.0,0.0,0.0,0.0
<a href=/player/gonzm101>gonzm101</a>,Mike Gonzalez,Cincinnati Reds,REDS,1,1,1,2,1915,1915,0,No,0,8.22,0.25,-7.97,566,119,-447,1748,365,-1383,0.0,0.0,0.0,0.0,0.0,0.0
<a href=/player/gonzm101>gonzm101</a>,Mike Gonzalez,New York Giants,GIANTS,1,3,1,4,1921,1926,5,No,0,3.43,7.56,4.13,403,420,17,1818,1780,-38,0.0,0.0,0.0,15208.0,0.0,-15208.0
<a href=/player/gonzm101>gonzm101</a>,Mike Gonzalez,Brooklyn Dodgers,DOGRS,1,1,1,2,1924,1924,0,No,0,1.66,-2.72,-4.38,174,142,-32,547,607,60,0.0,0.0,0.0,0.0,0.0,0.0
<a href=/player/gonzm101>gonzm101</a>,Mike Gonzalez,St. Louis Cardinals,CARDS,2,3,2,5,1925,1928,3,No,0,5.63,8.11,2.48,980,417,-563,3189,1539,-1650,0.0,0.0,0.0,30500.0,0.0,-30500.0
<a href=/player/gonzp101>gonzp101</a>,Pedro Gonzalez,New York Yankees,YANKS,2,5,2,7,1965,1968,3,No,0,1.54,0.06,-1.48,306,250,-56,1014,421,-593,0.0,678.0,678.0,10500.0,0.0,-10500.0
<a href=/player/gonzr001>gonzr001</a>,Rene Gonzales,Montreal Expos,NATEX,2,2,4,6,1986,2001,15,No,2,1.13,28.9,27.77,267,680,413,631,805,174,0.0,6209.0,6209.0,0.0,0.0,0.0
<a href=/player/gonzr001>gonzr001</a>,Rene Gonzales,Baltimore Orioles,ORLS,1,1,1,2,1991,1991,0,No,0,0.1,0.0,-0.1,71,0,-71,141,0,-141,0.0,0.0,0.0,0.0,0.0,0.0
<a href=/player/gonzr002>gonzr002</a>,Raul Gonzalez,Cincinnati Reds,REDS,1,4,2,6,2002,2002,0,No,0,6.19,-0.7,-6.89,1101,12,-1089,365,10,-355,1151.0,84.0,-1067.0,233000.0,0.0,-233000.0
<a href=/player/gonzs001>gonzs001</a>,Severino Gonzalez,Philadelphia Phillies,PHILS,1,1,1,2,2017,2017,0,No,0,0.0,0.0,0.0,0,0,0,0,0,0,0.0,0.0,0.0,0.0,0.0,0.0
<a href=/player/gonzt101>gonzt101</a>,Tony Gonzalez,Cincinnati Reds,REDS,1,2,3,5,1960,1963,3,No,0,24.2,5.52,-18.68,1274,332,-942,4678,994,-3684,0.0,0.0,0.0,0.0,0.0,0.0
<a href=/player/gonzt101>gonzt101</a>,Tony Gonzalez,San Diego Padres,PADRS,2,2,4,6,1969,1971,2,No,0,2.26,-0.76,-3.02,212,104,-108,844,298,-546,0.0,0.0,0.0,0.0,0.0,0.0
<a href=/player/gonzw001>gonzw001</a>,Wiki Gonzalez,San Diego Padres,PADRS,1,4,3,7,2004,2004,0,No,0,0.63,-0.51,-1.14,139,46,-93,232,85,-147,39.0,43.0,4.0,0.0,0.0,0.0
<a href=/player/goocj101>goocj101</a>,Johnny Gooch,Pittsburgh Pirates,PIRATS,1,2,1,3,1928,1933,5,No,0,-0.02,-0.43,-0.41,98,192,94,214,667,453,0.0,0.0,0.0,16000.0,0.0,-16000.0
<a href=/player/goocj101>goocj101</a>,Johnny Gooch,Brooklyn Dodgers,DOGRS,1,2,1,3,1929,1933,4,No,0,1.02,-0.43,-1.45,222,187,-35,631,496,-135,148.0,0.0,-148.0,0.0,0.0,0.0
<a href=/player/goocj101>goocj101</a>,Johnny Gooch,Cincinnati Reds,REDS,1,1,1,2,1932,1945,13,No,0,0.0,0.0,0.0,0,0,0,0,0,0,0.0,0.0,0.0,0.0,0.0,0.0
<a href=/player/goodb001>goodb001</a>,Brian Goodwin,Washington Nationals,NATEX,1,1,1,2,2018,2018,0,Yes,0,0.13,0.0,-0.13,27,0,-27,101,0,-101,0.0,0.0,0.0,553900.0,0.0,-553900.0
<a href=/player/goodb001>goodb001</a>,Brian Goodwin,Anaheim Angels,ANGELS,1,1,2,3,2020,2020,0,Yes,0,-0.49,0.0,0.49,20,0,-20,55,0,-55,0.0,0.0,0.0,2200000.0,0.0,-2200000.0
<a href=/player/goodb101>goodb101</a>,Billy Goodman,Boston Red Sox,RSOX,1,1,1,2,1957,1963,6,No,0,1.08,4.73,3.65,73,573,500,298,166,-132,0.0,1927.0,1927.0,0.0,0.0,0.0
<a href=/player/goodb101>goodb101</a>,Billy Goodman,Baltimore Orioles,ORLS,23,44,43,87,1957,1994,37,No,3,72.27,127.67,55.4,4749,6987,2238,10212,15857,5645,16859.0,18781.0,1922.0,880833.0,0.0,-880833.0
<a href=/player/goodc001>goodc001</a>,Curtis Goodwin,Baltimore Orioles,ORLS,2,3,3,6,1995,2004,9,No,2,-0.58,2.94,3.52,134,51,-83,453,34,-419,0.0,673.0,673.0,109000.0,0.0,-109000.0
<a href=/player/goodc001>goodc001</a>,Curtis Goodwin,Cincinnati Reds,REDS,1,1,1,2,1997,1998,1,No,0,-0.37,-0.26,0.11,119,20,-99,186,1,-185,0.0,51.0,51.0,0.0,0.0,0.0
<a href=/player/goodd101>goodd101</a>,Danny Goodwin,California Angels,ANGELS,2,3,3,6,1978,1987,9,No,0,2.69,22.79,20.1,795,1091,296,2836,4554,1718,0.0,0.0,0.0,0.0,0.0,0.0
<a href=/player/goode101>goode101</a>,Ed Goodson,San Francisco Giants,GIANTS,6,11,9,20,1975,1995,20,No,1,13.52,26.29,12.77,1414,2086,672,3636,6703,3067,4215.0,726.0,-3489.0,1545000.0,0.0,-1545000.0
<a href=/player/goode101>goode101</a>,Ed Goodson,Atlanta Braves,BRAVES,2,4,5,9,1975,1984,9,No,0,23.22,0.43,-22.79,1629,1492,-137,5388,5061,-327,292.0,128.0,-164.0,0.0,0.0,0.0
<a href=/player/goodm102>goodm102</a>,Marv Goodwin,Milwaukee,Milwaukee,1,1,5,6,1917,1926,9,No,0,0.0,0.0,0.0,191,0,-191,147,0,-147,1261.0,0.0,-1261.0,0.0,0.0,0.0
<a href=/player/goodn001>goodn001</a>,Nick Goody,New York Yankees,YANKS,1,1,1,2,2016,2017,1,Yes,0,0.97,0.0,-0.97,113,0,-113,0,0,0,321.0,0.0,-321.0,0.0,0.0,0.0
<a href=/player/goodt001>goodt001</a>,Tom Goodwin,Kansas City Royals,ROYALS,3,4,4,8,1997,2009,12,No,2,3.01,4.88,1.87,316,470,154,1298,933,-365,0.0,1271.0,1271.0,1050000.0,0.0,-1050000.0
<a href=/player/goodt001>goodt001</a>,Tom Goodwin,Colorado Rockies,ROCKS,3,5,7,12,2000,2003,3,No,0,-0.66,4.31,4.97,252,283,31,727,878,151,127.0,0.0,-127.0,7066667.0,0.0,-7066667.0
<a href=/player/goodw101>goodw101</a>,Wilbur Good,Cleveland Indians,INDINS,1,1,1,2,1909,1909,0,No,0,0.0,0.0,0.0,0,0,0,0,0,0,0.0,0.0,0.0,0.0,0.0,0.0
<a href=/player/goodw101>goodw101</a>,Wilbur Good,Boston Braves,BRAVES,2,5,6,11,1911,1914,3,No,0,3.16,-2.55,-5.71,559,378,-181,1829,1028,-801,21.0,614.0,593.0,0.0,0.0,0.0
<a href=/player/goosg101>goosg101</a>,Greg Goossen,New York Mets,METS,4,7,5,12,1969,1977,8,No,0,1.61,9.34,7.73,228,850,622,453,1628,1175,89.0,1792.0,1703.0,0.0,0.0,0.0
<a href=/player/goosg101>goosg101</a>,Greg Goossen,Washington Senators,RNGRS,8,16,13,29,1970,1982,12,No,0,21.36,8.18,-13.18,1080,728,-352,2708,1819,-889,4391.0,989.0,-3402.0,326500.0,0.0,-326500.0
<a href=/player/gorbg101>gorbg101</a>,Glen Gorbous,Cincinnati Reds,REDS,5,10,14,24,1955,1965,10,No,0,64.57,18.03,-46.54,3586,1613,-1973,11340,3264,-8076,2563.0,1025.0,-1538.0,13500.0,0.0,-13500.0
<a href=/player/gorbg101>gorbg101</a>,Glen Gorbous,Philadelphia Phillies,PHILS,1,1,1,2,1957,1957,0,No,0,0.0,-0.12,-0.12,0,57,57,0,87,87,0.0,0.0,0.0,0.0,0.0,0.0
<a href=/player/gordd001>gordd001</a>,Don Gordon,Toronto Blue Jays,BJAYS,1,2,1,3,1987,1987,0,No,0,-0.44,-0.32,0.12,59,3,-56,0,0,0,297.0,36.0,-261.0,71500.0,0.0,-71500.0
<a href=/player/gordd002>gordd002</a>,Dee Gordon,Los Angeles Dodgers,DOGRS,4,7,8,15,2014,2020,6,Yes,0,27.35,10.53,-16.82,1361,1127,-234,4322,2916,-1406,2273.0,350.0,-1923.0,21765000.0,0.0,-21765000.0
<a href=/player/gordd002>gordd002</a>,Dee Gordon,Miami Marlins,MARLNS,1,2,3,5,2017,2020,3,Yes,0,1.81,-1.14,-2.95,291,18,-273,1091,11,-1080,0.0,135.0,135.0,7800000.0,0.0,-7800000.0
<a href=/player/gordj101>gordj101</a>,Joe Gordon,New York Yankees,YANKS,1,1,1,2,1946,1946,0,No,0,19.02,0.0,-19.02,566,0,-566,2321,0,-2321,0.0,0.0,0.0,0.0,0.0,0.0
<a href=/player/gordj101>gordj101</a>,Joe Gordon,Cleveland Indians,INDINS,1,1,1,2,1960,1960,0,No,0,0.0,0.0,0.0,0,0,0,0,0,0,0.0,0.0,0.0,0.0,0.0,0.0
<a href=/player/gords101>gords101</a>,Sid Gordon,New York Giants,GIANTS,14,31,27,58,1949,1968,19,No,0,59.86,70.44,10.58,4286,4168,-118,14522,10114,-4408,1384.0,8678.0,7294.0,127500.0,0.0,-127500.0
<a href=/player/gords101>gords101</a>,Sid Gordon,Milwaukee Braves,BRAVES,2,10,2,12,1953,1960,7,No,0,8.19,12.74,4.55,794,729,-65,1824,3040,1216,2135.0,0.0,-2135.0,0.0,0.0,0.0
<a href=/player/gordt001>gordt001</a>,Tom Gordon,Chicago Cubs,CUBS,3,4,7,11,2002,2010,8,No,0,2.77,22.6,19.83,164,924,760,492,4021,3529,57.0,0.0,-57.0,16355000.0,0.0,-16355000.0
<a href=/player/gormt001>gormt001</a>,Tom Gorman,Montreal Expos,NATEX,7,9,9,18,1982,2004,22,No,3,51.14,22.75,-28.39,1247,967,-280,481,3267,2786,8925.0,1281.0,-7644.0,4247000.0,0.0,-4247000.0
<a href=/player/gormt001>gormt001</a>,Tom Gorman,San Diego Padres,PADRS,1,1,1,2,1987,1987,0,No,0,0.0,0.0,0.0,0,0,0,0,0,0,0.0,0.0,0.0,0.0,0.0,0.0
<a href=/player/goryj101>goryj101</a>,Johnny Goryl,Chicago Cubs,CUBS,1,4,1,5,1960,1961,1,No,0,14.78,2.04,-12.74,914,260,-654,121,914,793,2300.0,0.0,-2300.0,0.0,0.0,0.0
<a href=/player/gorzt001>gorzt001</a>,Tom Gorzelanny,Pittsburgh Pirates,PIRATS,1,2,3,5,2009,2018,9,No,0,0.73,13.21,12.48,310,883,573,59,3032,2973,863.0,188.0,-675.0,2300000.0,0.0,-2300000.0
<a href=/player/gorzt001>gorzt001</a>,Tom Gorzelanny,Chicago Cubs,CUBS,1,1,3,4,2011,2013,2,No,0,1.64,0.0,-1.64,148,0,-148,40,0,-40,531.0,0.0,-531.0,0.0,0.0,0.0
<a href=/player/gosea001>gosea001</a>,Anthony Gose,Philadelphia Phillies,PHILS,1,3,1,4,2010,2011,1,No,0,1.12,5.11,3.99,320,74,-246,775,83,-692,998.0,665.0,-333.0,470000.0,0.0,-470000.0
<a href=/player/gosea001>gosea001</a>,Anthony Gose,Houston Astros,ASTROS,1,1,1,2,2010,2014,4,No,0,1.55,-0.15,-1.7,202,311,109,616,1077,461,0.0,0.0,0.0,0.0,0.0,0.0
<a href=/player/gosea001>gosea001</a>,Anthony Gose,Toronto Blue Jays,BJAYS,1,1,1,2,2014,2019,5,No,0,0.44,5.83,5.39,170,316,146,636,1246,610,0.0,0.0,0.0,0.0,0.0,0.0
<a href=/player/gosgj101>gosgj101</a>,Jim Gosger,Boston Red Sox,RSOX,2,6,4,10,1966,1969,3,No,0,1.66,1.54,-0.12,432,533,101,910,683,-227,275.0,859.0,584.0,24500.0,0.0,-24500.0
<a href=/player/gosgj101>gosgj101</a>,Jim Gosger,Seattle Pilots,BREWRS,1,1,2,3,1969,1970,1,No,0,-1.74,2.1,3.84,74,73,-1,155,216,61,0.0,0.0,0.0,0.0,0.0,0.0
<a href=/player/gosgj101>gosgj101</a>,Jim Gosger,New York Mets,METS,3,5,4,9,1969,1977,8,No,0,-0.49,9.42,9.91,155,840,685,237,1612,1375,89.0,1792.0,1703.0,0.0,0.0,0.0
<a href=/player/gosgj101>gosgj101</a>,Jim Gosger,Montreal Expos,NATEX,2,2,5,7,1971,1975,4,No,0,-1.66,-0.13,1.53,64,1,-63,139,4,-135,0.0,0.0,0.0,0.0,0.0,0.0
<a href=/player/goslg101>goslg101</a>,Goose Goslin,Washington Senators,TWINS,4,7,7,14,1930,1940,10,No,0,17.13,37.56,20.43,839,1747,908,2673,5418,2745,2260.0,5469.0,3209.0,22000.0,0.0,-22000.0
<a href=/player/goslg101>goslg101</a>,Goose Goslin,St.Louis Browns,ORLS,20,38,48,86,1932,1952,20,No,0,96.01,96.11,0.1,5218,8686,3468,17109,27646,10537,8613.0,15510.0,6897.0,185500.0,0.0,-185500.0
<a href=/player/goslg101>goslg101</a>,Goose Goslin,Washington Senators,TWINS,1,1,1,2,1933,1933,0,No,0,9.25,0.0,-9.25,524,0,-524,2216,0,-2216,0.0,0.0,0.0,11000.0,0.0,-11000.0
<a href=/player/gossh101>gossh101</a>,Howie Goss,Pittsburgh Pirates,PIRATS,1,2,1,3,1963,1968,5,No,0,0.36,6.61,6.25,133,642,509,448,1858,1410,0.0,0.0,0.0,0.0,0.0,0.0
<a href=/player/gossp001>gossp001</a>,Phil Gosselin,Atlanta Braves,BRAVES,4,8,13,21,2015,2020,5,Yes,0,5.94,-1.29,-7.23,734,465,-269,1003,1320,317,1642.0,246.0,-1396.0,24907500.0,0.0,-24907500.0
<a href=/player/gossp001>gossp001</a>,Phil Gosselin,Arizona Diamondbacks,DBACKS,1,1,1,2,2017,2017,0,Yes,0,-0.58,0.0,0.58,28,0,-28,42,0,-42,0.0,0.0,0.0,0.0,0.0,0.0
<a href=/player/gossr001>gossr001</a>,Rich Gossage,Chicago White Sox,WSOX,2,5,3,8,1976,1978,2,No,0,7.3,2.34,-4.96,434,159,-275,257,599,342,2388.0,97.0,-2291.0,0.0,0.0,0.0
<a href=/player/gossr001>gossr001</a>,Rich Gossage,San Diego Padres,PADRS,22,42,43,85,1988,2010,22,No,6,15.58,62.4,46.82,4503,5790,1287,14891,19463,4572,1624.0,2614.0,990.0,28423133.0,0.0,-28423133.0
<a href=/player/gotaj101>gotaj101</a>,Julio Gotay,St. Louis Cardinals,CARDS,12,25,21,46,1962,1972,10,No,0,34.37,14.04,-20.33,3456,1142,-2314,8634,3489,-5145,3590.0,703.0,-2887.0,32500.0,0.0,-32500.0
<a href=/player/gotaj101>gotaj101</a>,Julio Gotay,Pittsburgh Pirates,PIRATS,1,1,1,2,1965,1965,0,No,0,0.72,0.0,-0.72,40,0,-40,82,0,-82,0.0,0.0,0.0,0.0,0.0,0.0
<a href=/player/gotaj101>gotaj101</a>,Julio Gotay,California Angels,ANGELS,3,4,3,7,1966,1968,2,No,0,0.31,0.22,-0.09,412,95,-317,701,230,-471,443.0,0.0,-443.0,0.0,0.0,0.0
<a href=/player/gotar001>gotar001</a>,Ruben Gotay,Kansas City Royals,ROYALS,2,2,2,4,2006,2007,1,No,0,-0.08,0.13,0.21,286,22,-264,989,67,-922,0.0,0.0,0.0,0.0,0.0,0.0
<a href=/player/gottj001>gottj001</a>,Jim Gott,Toronto Blue Jays,BJAYS,1,3,1,4,1985,1987,2,No,0,0.9,0.56,-0.34,130,92,-38,70,0,-70,652.0,301.0,-351.0,0.0,0.0,0.0
<a href=/player/gottt001>gottt001</a>,Trevor Gott,San Diego Padres,PADRS,3,5,8,13,2014,2019,5,Yes,0,2.1,2.53,0.43,243,302,59,4,1043,1039,1186.0,40.0,-1146.0,9925000.0,0.0,-9925000.0
<a href=/player/gottt001>gottt001</a>,Trevor Gott,Anaheim Angels,ANGELS,1,2,2,4,2015,2017,2,No,0,-0.45,1.55,2.0,66,221,155,0,948,948,84.0,0.0,-84.0,0.0,0.0,0.0
<a href=/player/goult101>goult101</a>,Ted Goulait,Indianapolis,Indianapolis,1,1,2,3,1912,1921,9,No,0,0.0,0.0,0.0,0,0,0,0,0,0,0.0,0.0,0.0,0.0,0.0,0.0
<a href=/player/gowdh101>gowdh101</a>,Hank Gowdy,New York Giants,GIANTS,3,6,3,9,1911,1921,10,No,0,34.55,14.86,-19.69,1629,779,-850,5823,2071,-3752,0.0,2915.0,2915.0,6400.0,0.0,-6400.0
<a href=/player/gowdh101>gowdh101</a>,Hank Gowdy,Boston Braves,BRAVES,9,18,16,34,1923,1938,15,No,0,22.25,29.52,7.27,1842,2916,1074,4975,10263,5288,4661.0,3399.0,-1262.0,56400.0,0.0,-56400.0
<a href=/player/gozzm001>gozzm001</a>,Mauro Gozzo,New York Mets,METS,11,23,20,43,1987,2005,18,No,0,11.67,39.4,27.73,1493,3560,2067,1978,7962,5984,3113.0,6312.0,3199.0,27998333.0,0.0,-27998333.0
<a href=/player/gozzm001>gozzm001</a>,Mauro Gozzo,Toronto Blue Jays,BJAYS,1,3,1,4,1990,1990,0,No,0,-0.34,0.18,0.52,4,3,-1,0,0,0,23.0,47.0,24.0,102500.0,0.0,-102500.0
<a href=/player/grabb101>grabb101</a>,Billy Grabarkewitz,Los Angeles Dodgers,DOGRS,1,5,2,7,1972,1976,4,No,0,16.6,19.03,2.43,596,356,-240,1923,542,-1381,1810.0,2591.0,781.0,251500.0,0.0,-251500.0
<a href=/player/grabb101>grabb101</a>,Billy Grabarkewitz,California Angels,ANGELS,2,4,3,7,1973,1976,3,No,0,2.26,3.34,1.08,402,155,-247,1412,564,-848,0.0,0.0,0.0,38500.0,0.0,-38500.0
<a href=/player/grabj002>grabj002</a>,John Grabow,Pittsburgh Pirates,PIRATS,1,2,3,5,2009,2018,9,No,0,0.73,13.21,12.48,310,883,573,59,3032,2973,863.0,188.0,-675.0,2300000.0,0.0,-2300000.0
<a href=/player/grabj101>grabj101</a>,Johnny Grabowski,Minneapolis,Minneapolis,1,2,2,4,1924,1930,6,No,0,-1.39,0.0,1.39,129,0,-129,265,0,-265,183.0,0.0,-183.0,0.0,0.0,0.0
<a href=/player/grabj101>grabj101</a>,Johnny Grabowski,Chicago White Sox,WSOX,1,2,1,3,1927,1928,1,No,0,-0.49,2.12,2.61,240,145,-95,730,550,-180,0.0,0.0,0.0,0.0,0.0,0.0
<a href=/player/grabj101>grabj101</a>,Johnny Grabowski,New York Yankees,YANKS,1,3,1,4,1929,1930,1,No,0,0.0,0.05,0.05,0,45,45,0,121,121,0.0,0.0,0.0,15000.0,0.0,-15000.0
<a href=/player/grace101>grace101</a>,Earl Grace,Chicago Cubs,CUBS,3,9,4,13,1931,1941,10,No,0,6.49,28.82,22.33,1048,1022,-26,2697,2403,-294,2473.0,4458.0,1985.0,0.0,0.0,0.0
<a href=/player/grace101>grace101</a>,Earl Grace,Pittsburgh Pirates,PIRATS,2,5,2,7,1935,1941,6,No,0,11.48,3.57,-7.91,470,432,-38,813,1543,730,2406.0,0.0,-2406.0,0.0,0.0,0.0
<a href=/player/grace101>grace101</a>,Earl Grace,Philadelphia Phillies,PHILS,1,1,1,2,1937,1937,0,No,0,0.0,0.0,0.0,0,0,0,0,0,0,0.0,0.0,0.0,0.0,0.0,0.0
<a href=/player/gracj101>gracj101</a>,Joe Grace,St.Louis Browns,ORLS,1,2,1,3,1946,1947,1,No,0,1.06,5.22,4.16,159,227,68,625,935,310,8.0,0.0,-8.0,3000.0,0.0,-3000.0
<a href=/player/gracm101>gracm101</a>,Mike Grace,Cincinnati Reds,REDS,1,2,2,4,1981,1981,0,No,0,0.0,0.0,0.0,0,0,0,0,0,0,0.0,0.0,0.0,0.0,0.0,0.0
<a href=/player/gradm101>gradm101</a>,Mike Grady,Philadelphia Phillies,PHILS,1,2,1,3,1897,1902,5,No,0,5.09,11.56,6.47,465,423,-42,1577,1709,132,668.0,0.0,-668.0,0.0,0.0,0.0
<a href=/player/gradm101>gradm101</a>,Mike Grady,St. Louis Cardinals,CARDS,2,4,5,9,1897,1899,2,No,0,11.69,1.81,-9.88,688,269,-419,2803,1136,-1667,0.0,0.0,0.0,0.0,0.0,0.0
<a href=/player/grafm101>grafm101</a>,Milt Graff,New York Yankees,YANKS,6,15,13,28,1957,1970,13,No,0,5.72,32.98,27.26,1633,2423,790,4235,5558,1323,2553.0,4978.0,2425.0,115500.0,0.0,-115500.0
<a href=/player/graft001>graft001</a>,Tony Graffanino,Tampa Bay Devil Rays,RAYS,1,1,1,2,2000,2002,2,No,0,5.66,5.72,0.06,291,98,-193,881,13,-868,0.0,1416.0,1416.0,270000.0,0.0,-270000.0
<a href=/player/graft001>graft001</a>,Tony Graffanino,Kansas City Royals,ROYALS,1,1,2,3,2005,2006,1,No,0,1.26,-0.16,-1.42,51,53,2,200,167,-33,0.0,0.0,0.0,1100000.0,0.0,-1100000.0
<a href=/player/graft001>graft001</a>,Tony Graffanino,Kansas City Royals,ROYALS,3,3,3,6,2006,2009,3,No,0,18.86,3.95,-14.91,675,164,-511,920,220,-700,3760.0,751.0,-3009.0,2447000.0,0.0,-2447000.0
<a href=/player/grahd101>grahd101</a>,Dan Graham,Minnesota Twins,TWINS,1,1,1,2,1979,1979,0,No,0,1.1,0.0,-1.1,141,0,-141,442,0,-442,0.0,0.0,0.0,0.0,0.0,0.0
<a href=/player/grahj101>grahj101</a>,Jack Graham,New York Yankees,YANKS,1,1,1,2,1940,1940,0,No,0,-0.05,0.0,0.05,2,0,-2,5,0,-5,0.0,0.0,0.0,0.0,0.0,0.0
<a href=/player/grahj101>grahj101</a>,Jack Graham,New York Giants,GIANTS,1,4,1,5,1947,1953,6,No,0,0.0,-0.83,-0.83,0,19,19,0,46,46,0.0,19.0,19.0,0.0,0.0,0.0
<a href=/player/grahp101>grahp101</a>,Peaches Graham,Boston Braves,BRAVES,2,5,6,11,1911,1914,3,No,0,3.16,-2.55,-5.71,559,378,-181,1829,1028,-801,21.0,614.0,593.0,0.0,0.0,0.0
<a href=/player/grahp101>grahp101</a>,Peaches Graham,Chicago Cubs,CUBS,1,1,2,3,1912,1912,0,No,0,-0.4,-0.17,0.23,24,26,2,67,61,-6,0.0,0.0,0.0,0.0,0.0,0.0
<a href=/player/grahw101>grahw101</a>,Wayne Graham,Philadelphia Phillies,PHILS,1,3,1,4,1964,1965,1,No,0,-0.3,1.17,1.47,100,74,-26,65,237,172,326.0,0.0,-326.0,0.0,0.0,0.0
<a href=/player/grahw101>grahw101</a>,Wayne Graham,New York Mets,METS,1,3,1,4,1966,1966,0,No,0,-0.11,-0.09,0.02,10,31,21,19,96,77,0.0,0.0,0.0,0.0,0.0,0.0
<a href=/player/grama101>grama101</a>,Alex Grammas,Cincinnati Reds,REDS,1,1,2,3,1953,1954,1,No,0,6.2,0.0,-6.2,619,0,-619,1722,0,-1722,0.0,0.0,0.0,0.0,0.0,0.0
<a href=/player/grama101>grama101</a>,Alex Grammas,St. Louis Cardinals,CARDS,2,3,2,5,1956,1957,1,No,0,0.94,-0.25,-1.19,322,29,-293,645,20,-625,0.0,0.0,0.0,0.0,0.0,0.0
<a href=/player/grama101>grama101</a>,Alex Grammas,Cincinnati Reds,REDS,3,5,8,13,1958,1966,8,No,0,5.3,5.9,0.6,751,639,-112,1876,2223,347,111.0,126.0,15.0,0.0,0.0,0.0
<a href=/player/grama101>grama101</a>,Alex Grammas,St. Louis Cardinals,CARDS,1,2,2,4,1962,1963,1,No,0,2.09,-0.45,-2.54,348,91,-257,1098,139,-959,0.0,0.0,0.0,0.0,0.0,0.0
<a href=/player/granc001>granc001</a>,Curtis Granderson,Detroit Tigers,TIGRS,4,7,9,16,2009,2021,12,Yes,0,18.59,52.84,34.25,720,1430,710,2838,3032,194,284.0,6457.0,6173.0,35445000.0,0.0,-35445000.0
<a href=/player/granc001>granc001</a>,Curtis Granderson,New York Mets,METS,1,2,1,3,2017,2020,3,No,0,-0.24,-0.54,-0.3,36,86,50,132,1,-131,0.0,143.0,143.0,15000000.0,0.0,-15000000.0
<a href=/player/granc001>granc001</a>,Curtis Granderson,Toronto Blue Jays,BJAYS,1,1,1,2,2018,2018,0,Yes,0,0.28,0.0,-0.28,19,0,-19,54,0,-54,0.0,0.0,0.0,5000000.0,0.0,-5000000.0
<a href=/player/grane101>grane101</a>,Eddie Grant,Philadelphia Phillies,PHILS,12,24,28,52,1910,1931,21,No,0,100.95,91.27,-9.68,4848,5202,354,15981,18765,2784,10753.0,6282.0,-4471.0,25000.0,0.0,-25000.0
<a href=/player/grang102>grang102</a>,George Grantham,Chicago Cubs,CUBS,1,3,3,6,1924,1926,2,No,0,29.39,2.01,-27.38,1120,155,-965,4097,410,-3687,1929.0,802.0,-1127.0,13500.0,0.0,-13500.0
<a href=/player/grang102>grang102</a>,George Grantham,Cincinnati Reds,REDS,4,6,7,13,1933,1937,4,No,0,22.87,0.4,-22.47,943,284,-659,2307,797,-1510,2379.0,341.0,-2038.0,0.0,0.0,0.0
<a href=/player/granj001>granj001</a>,Jeff Granger,Kansas City Royals,ROYALS,2,5,4,9,1996,2005,9,No,2,2.49,4.96,2.47,410,202,-208,728,666,-62,275.0,712.0,437.0,120000.0,0.0,-120000.0
<a href=/player/granj101>granj101</a>,Mudcat Grant,Cleveland Indians,INDINS,7,10,9,19,1964,1972,8,No,0,11.01,5.1,-5.91,1417,786,-631,1596,1203,-393,5496.0,913.0,-4583.0,36500.0,0.0,-36500.0
<a href=/player/granj101>granj101</a>,Mudcat Grant,Minnesota Twins,TWINS,3,7,7,14,1967,1971,4,No,0,19.69,11.71,-7.98,1089,1188,99,3536,1015,-2521,872.0,2508.0,1636.0,193000.0,0.0,-193000.0
<a href=/player/granj101>granj101</a>,Mudcat Grant,Montreal Expos,NATEX,3,3,3,6,1969,1974,5,No,0,1.62,13.7,12.08,161,581,420,33,2179,2146,462.0,402.0,-60.0,37000.0,0.0,-37000.0
<a href=/player/granj101>granj101</a>,Mudcat Grant,Oakland Athletics,ATLTCS,1,1,1,2,1970,1970,0,No,0,0.61,0.0,-0.61,100,0,-100,11,0,-11,261.0,0.0,-261.0,37000.0,0.0,-37000.0
<a href=/player/granm001>granm001</a>,Mark Grant,San Francisco Giants,GIANTS,7,13,17,30,1987,1998,11,No,2,21.03,37.78,16.75,1321,2343,1022,1429,4032,2603,4080.0,4148.0,68.0,9879278.0,0.0,-9879278.0
<a href=/player/granm001>granm001</a>,Mark Grant,San Diego Padres,PADRS,1,1,1,2,1990,1991,1,No,0,0.02,-0.08,-0.1,66,44,-22,6,25,19,157.0,224.0,67.0,400000.0,0.0,-400000.0
<a href=/player/granm001>granm001</a>,Mark Grant,Houston Astros,ASTROS,1,1,1,2,1993,1993,0,No,0,-0.99,0.0,0.99,28,0,-28,0,0,0,43.0,0.0,-43.0,0.0,0.0,0.0
<a href=/player/grant101>grant101</a>,Tom Grant,Chicago Cubs,CUBS,1,1,1,2,1985,1985,0,No,0,0.0,-0.09,-0.09,0,18,18,0,0,0,0.0,38.0,38.0,0.0,0.0,0.0
<a href=/player/granw101>granw101</a>,Wayne Granger,St. Louis Cardinals,CARDS,4,7,5,12,1968,1971,3,No,0,20.24,2.27,-17.97,1458,401,-1057,4171,1565,-2606,1006.0,0.0,-1006.0,87500.0,0.0,-87500.0
<a href=/player/granw101>granw101</a>,Wayne Granger,Cincinnati Reds,REDS,2,2,2,4,1971,1977,6,No,0,-1.75,0.51,2.26,205,287,82,16,65,49,465.0,882.0,417.0,40000.0,0.0,-40000.0
<a href=/player/granw101>granw101</a>,Wayne Granger,Minnesota Twins,TWINS,1,1,2,3,1972,1977,5,No,0,-1.23,17.25,18.48,66,662,596,4,2764,2760,140.0,0.0,-140.0,42500.0,0.0,-42500.0
<a href=/player/granw101>granw101</a>,Wayne Granger,St. Louis Cardinals,CARDS,3,3,4,7,1973,1977,4,No,0,3.74,-0.38,-4.12,213,52,-161,136,5,-131,1249.0,111.0,-1138.0,47500.0,0.0,-47500.0
<a href=/player/grany001>grany001</a>,Yasmani Grandal,Cincinnati Reds,REDS,2,5,3,8,2011,2020,9,No,0,8.75,14.41,5.66,882,376,-506,2596,411,-2185,1389.0,3437.0,2048.0,9475000.0,0.0,-9475000.0
<a href=/player/grany001>grany001</a>,Yasmani Grandal,San Diego Padres,PADRS,2,5,4,9,2014,2016,2,No,0,8.85,0.65,-8.2,684,254,-430,2593,1079,-1514,26.0,0.0,-26.0,1293600.0,0.0,-1293600.0
<a href=/player/granz001>granz001</a>,Zack Granite,Minnesota Twins,TWINS,1,1,2,3,2019,2019,0,Yes,0,0.0,0.0,0.0,0,0,0,0,0,0,0.0,0.0,0.0,0.0,0.0,0.0
<a href=/player/grasm101>grasm101</a>,Mickey Grasso,Washington Senators,TWINS,1,1,1,2,1954,1955,1,No,0,0.08,0.59,0.51,4,54,50,8,193,185,0.0,0.0,0.0,0.0,0.0,0.0
<a href=/player/gratb001>gratb001</a>,Beiker Graterol,Toronto Blue Jays,BJAYS,1,1,1,2,1998,1999,1,No,0,-0.26,-0.11,0.15,1,1,0,0,0,0,12.0,3.0,-9.0,0.0,0.0,0.0
<a href=/player/gratb002>gratb002</a>,Brusdar Graterol,Minnesota Twins,TWINS,1,3,3,6,2020,2020,0,Yes,0,-0.29,1.55,1.84,124,11,-113,74,0,-74,170.0,200.0,30.0,0.0,0.0,0.0
<a href=/player/gratj001>gratj001</a>,Juan Graterol,Toronto Blue Jays,BJAYS,1,1,1,2,2017,2017,0,No,0,0.13,0.0,-0.13,49,0,-49,88,0,-88,0.0,0.0,0.0,0.0,0.0,0.0
<a href=/player/gravd001>gravd001</a>,Danny Graves,Cleveland Indians,INDINS,1,4,2,6,1997,1998,1,No,0,5.24,-0.51,-5.75,1014,98,-916,190,187,-3,2567.0,112.0,-2455.0,0.0,0.0,0.0
<a href=/player/gravk001>gravk001</a>,Kendall Graveman,Toronto Blue Jays,BJAYS,2,6,2,8,2014,2018,4,Yes,0,6.54,19.48,12.94,350,462,112,887,2066,1179,1411.0,0.0,-1411.0,23516100.0,0.0,-23516100.0
<a href=/player/gravk001>gravk001</a>,Kendall Graveman,Seattle Mariners,MARNRS,1,2,2,4,2021,2021,0,Yes,0,0.78,1.64,0.86,33,83,50,0,253,253,87.0,54.0,-33.0,3500000.0,0.0,-3500000.0
<a href=/player/grayd101>grayd101</a>,Dolly Gray,Washington Senators,TWINS,5,11,10,21,1911,1926,15,No,0,13.21,49.63,36.42,1111,2437,1326,3734,9513,5779,894.0,3052.0,2158.0,21400.0,0.0,-21400.0
<a href=/player/grayd102>grayd102</a>,Dick Gray,Los Angeles Dodgers,DOGRS,2,4,4,8,1959,1961,2,No,0,0.06,0.34,0.28,45,76,31,67,138,71,0.0,0.0,0.0,0.0,0.0,0.0
<a href=/player/grayd102>grayd102</a>,Dick Gray,St. Louis Cardinals,CARDS,16,30,25,55,1960,1972,12,No,0,32.35,16.26,-16.09,3499,2551,-948,8719,7845,-874,2795.0,1167.0,-1628.0,32500.0,0.0,-32500.0
<a href=/player/grayg101>grayg101</a>,Gary Gray,Texas Rangers,RNGRS,1,3,2,5,1980,1980,0,No,0,-0.55,-1.43,-0.88,28,119,91,57,205,148,0.0,0.0,0.0,0.0,0.0,0.0
<a href=/player/grayj001>grayj001</a>,Jeff Gray,Philadelphia Phillies,PHILS,2,3,4,7,1985,1987,2,No,0,4.94,1.72,-3.22,271,272,1,922,426,-496,542.0,530.0,-12.0,1109333.0,0.0,-1109333.0
<a href=/player/grayj001>grayj001</a>,Jeff Gray,Cincinnati Reds,REDS,2,3,3,6,1989,1992,3,No,0,2.39,2.59,0.2,42,287,245,0,823,823,597.0,63.0,-534.0,500000.0,0.0,-500000.0
<a href=/player/grayj002>grayj002</a>,Jeff Gray,Oakland Athletics,ATLTCS,3,6,5,11,2009,2013,4,No,0,-0.36,1.6,1.96,79,247,168,172,718,546,28.0,38.0,10.0,805000.0,0.0,-805000.0
<a href=/player/grayj004>grayj004</a>,Josiah Gray,Cincinnati Reds,REDS,2,6,6,12,2018,2020,2,Yes,0,0.33,2.24,1.91,53,294,241,210,761,551,24.0,499.0,475.0,30700000.0,0.0,-30700000.0
<a href=/player/grayj004>grayj004</a>,Josiah Gray,Los Angeles Dodgers,DOGRS,1,4,2,6,2021,2021,0,Yes,0,0.24,4.89,4.65,47,74,27,110,252,142,188.0,205.0,17.0,0.0,0.0,0.0
<a href=/player/grayj101>grayj101</a>,Johnny Gray,New York Yankees,YANKS,16,45,38,83,1953,1970,17,No,0,48.62,78.17,29.55,7017,4726,-2291,22732,11340,-11392,3607.0,11554.0,7947.0,313000.0,0.0,-313000.0
<a href=/player/grays001>grays001</a>,Sonny Gray,Oakland Athletics,ATLTCS,2,3,4,7,2017,2021,4,Yes,0,1.1,-0.97,-2.07,121,69,-52,123,203,80,587.0,0.0,-587.0,3575000.0,0.0,-3575000.0
<a href=/player/grays001>grays001</a>,Sonny Gray,New York Yankees,YANKS,3,5,5,10,2019,2021,2,No,0,10.03,0.33,-9.7,238,102,-136,526,361,-165,1135.0,0.0,-1135.0,0.0,0.0,0.0
<a href=/player/grays102>grays102</a>,Sam Gray,Philadelphia Athletics,ATLTCS,1,1,1,2,1927,1935,8,No,0,15.15,12.57,-2.58,476,820,344,478,3078,2600,3927.0,0.0,-3927.0,7500.0,0.0,-7500.0
<a href=/player/grayt101>grayt101</a>,Ted Gray,Detroit Tigers,TIGRS,6,11,11,22,1954,1964,10,No,0,2.44,17.09,14.65,689,625,-64,1873,996,-877,460.0,3101.0,2641.0,37500.0,0.0,-37500.0
<a href=/player/grbae101>grbae101</a>,Eli Grba,Boston Red Sox,RSOX,1,2,1,3,1957,1957,0,No,0,-2.46,0.0,2.46,96,0,-96,53,0,-53,393.0,0.0,-393.0,0.0,0.0,0.0
<a href=/player/greab101>greab101</a>,Bill Greason,OklahomaCity,OklahomaCity,1,1,3,4,1953,1953,0,No,0,-0.45,0.0,0.45,6,0,-6,1,0,-1,12.0,0.0,-12.0,0.0,0.0,0.0
<a href=/player/greea101>greea101</a>,Al Greene,Detroit Tigers,TIGRS,1,2,1,3,1980,1981,1,No,0,1.37,0.54,-0.83,153,67,-86,89,195,106,831.0,0.0,-831.0,0.0,0.0,0.0
<a href=/player/greec001>greec001</a>,Chris Green,Pittsburgh Pirates,PIRATS,1,1,1,2,1986,1986,0,No,0,0.0,0.0,0.0,0,0,0,0,0,0,0.0,0.0,0.0,0.0,0.0,0.0
<a href=/player/greec003>greec003</a>,Chad Green,Detroit Tigers,TIGRS,2,4,4,8,2015,2017,2,Yes,0,11.2,2.36,-8.84,625,142,-483,120,106,-14,2199.0,297.0,-1902.0,4700000.0,0.0,-4700000.0
<a href=/player/greec004>greec004</a>,Conner Greene,Toronto Blue Jays,BJAYS,1,2,1,3,2018,2018,0,Yes,0,-0.49,2.45,2.94,137,124,-13,0,462,462,194.0,0.0,-194.0,0.0,0.0,0.0
<a href=/player/greed001>greed001</a>,David Green,Milwaukee Brewers,BREWRS,3,6,7,13,1980,1986,6,No,1,6.59,20.26,13.67,970,997,27,2159,3010,851,2112.0,2376.0,264.0,0.0,0.0,0.0
<a href=/player/greed001>greed001</a>,David Green,St. Louis Cardinals,CARDS,3,6,5,11,1985,1998,13,No,4,10.04,29.74,19.7,1204,965,-239,3785,3877,92,620.0,0.0,-620.0,0.0,0.0,0.0
<a href=/player/greed001>greed001</a>,David Green,San Francisco Giants,GIANTS,1,1,1,2,1985,1985,0,No,0,0.0,0.0,0.0,0,0,0,0,0,0,0.0,0.0,0.0,275000.0,0.0,-275000.0
<a href=/player/greeg002>greeg002</a>,Grant Green,Oakland Athletics,ATLTCS,1,1,1,2,2013,2014,1,No,0,-0.66,-0.57,0.09,104,177,73,284,631,347,0.0,0.0,0.0,0.0,0.0,0.0
<a href=/player/greeg101>greeg101</a>,Gene Green,St. Louis Cardinals,CARDS,2,3,4,7,1959,1962,3,No,0,0.6,1.14,0.54,42,87,45,78,232,154,0.0,0.0,0.0,0.0,0.0,0.0
<a href=/player/greeg101>greeg101</a>,Gene Green,Washington Senators,RNGRS,4,7,5,12,1961,1970,9,No,0,4.25,0.29,-3.96,404,337,-67,701,1154,453,1913.0,6.0,-1907.0,0.0,0.0,0.0
<a href=/player/greeg101>greeg101</a>,Gene Green,Cleveland Indians,INDINS,1,1,1,2,1963,1963,0,No,0,-0.27,0.12,0.39,15,4,-11,32,10,-22,0.0,0.0,0.0,0.0,0.0,0.0
<a href=/player/greej102>greej102</a>,Jim Greengrass,New York Yankees,YANKS,1,5,1,6,1952,1955,3,No,0,5.35,0.52,-4.83,390,26,-364,1419,10,-1409,46.0,107.0,61.0,0.0,0.0,0.0
<a href=/player/greej102>greej102</a>,Jim Greengrass,Cincinnati Reds,REDS,5,10,14,24,1955,1965,10,No,0,64.57,18.03,-46.54,3586,1613,-1973,11340,3264,-8076,2563.0,1025.0,-1538.0,13500.0,0.0,-13500.0
<a href=/player/greek001>greek001</a>,Kenny Greer,New York Yankees,YANKS,1,1,1,2,1993,1993,0,No,0,0.09,0.21,0.12,2,3,1,0,0,0,3.0,59.0,56.0,0.0,0.0,0.0
<a href=/player/greek002>greek002</a>,Khalil Greene,San Diego Padres,PADRS,4,6,8,14,2008,2017,9,Yes,0,1.65,6.5,4.85,532,1193,661,1084,541,-543,521.0,1678.0,1157.0,16394700.0,0.0,-16394700.0
<a href=/player/greek101>greek101</a>,Kent Greenfield,New York Giants,GIANTS,2,4,4,8,1927,1930,3,No,0,-1.4,7.13,8.53,721,460,-261,1415,1177,-238,3501.0,2253.0,-1248.0,8500.0,0.0,-8500.0
<a href=/player/greek101>greek101</a>,Kent Greenfield,Portsmouth,Portsmouth,1,2,1,3,1923,1923,0,No,0,2.21,0.0,-2.21,334,0,-334,792,0,-792,1269.0,0.0,-1269.0,0.0,0.0,0.0
<a href=/player/greel101>greel101</a>,Lenny Green,Baltimore Orioles,ORLS,1,1,1,2,1959,1960,1,No,0,6.84,0.08,-6.76,700,128,-572,2356,253,-2103,0.0,0.0,0.0,0.0,0.0,0.0
<a href=/player/greel101>greel101</a>,Lenny Green,Minnesota Twins,TWINS,1,2,2,4,1964,1966,2,No,0,-1.17,-1.3,-0.13,231,246,15,550,644,94,0.0,0.0,0.0,15000.0,0.0,-15000.0
<a href=/player/green001>green001</a>,Nick Green,Atlanta Braves,BRAVES,2,2,2,4,2005,2006,1,No,0,0.02,3.13,3.11,166,137,-29,424,63,-361,92.0,664.0,572.0,2200000.0,0.0,-2200000.0
<a href=/player/green001>green001</a>,Nick Green,Baltimore Orioles,ORLS,1,2,1,3,2011,2012,1,No,0,0.0,0.4,0.4,0,16,16,0,0,0,0.0,42.0,42.0,0.0,0.0,0.0
<a href=/player/green002>green002</a>,Nick Greenwood,San Diego Padres,PADRS,1,2,1,3,2010,2011,1,No,0,-0.23,-0.64,-0.41,39,160,121,6,664,658,108.0,0.0,-108.0,0.0,0.0,0.0
<a href=/player/green101>green101</a>,Nelson Greene,Brooklyn Dodgers,DOGRS,1,2,1,3,1924,1924,0,No,0,0.0,-1.0,-1.0,0,22,22,0,8,8,0.0,76.0,76.0,2100.0,0.0,-2100.0
<a href=/player/green101>green101</a>,Nelson Greene,Brooklyn Dodgers,DOGRS,2,4,2,6,1925,1931,6,No,0,-1.16,1.81,2.97,36,399,363,37,1222,1185,282.0,591.0,309.0,7500.0,0.0,-7500.0
<a href=/player/greep101>greep101</a>,Paddy Greene,New York Yankees,YANKS,1,1,1,2,1903,1903,0,No,0,-0.15,0.23,0.38,1,18,17,3,23,20,0.0,180.0,180.0,0.0,0.0,0.0
<a href=/player/greep102>greep102</a>,Pumpsie Green,Boston Red Sox,RSOX,2,4,2,6,1962,1966,4,No,0,1.63,7.14,5.51,379,407,28,759,1449,690,1141.0,0.0,-1141.0,0.0,0.0,0.0
<a href=/player/greer002>greer002</a>,Rick Greene,Detroit Tigers,TIGRS,3,5,3,8,1997,2009,12,No,0,-1.75,6.44,8.19,380,244,-136,75,32,-43,652.0,3275.0,2623.0,4485000.0,0.0,-4485000.0
<a href=/player/grees001>grees001</a>,Shawn Green,Toronto Blue Jays,BJAYS,2,3,3,6,1999,2003,4,No,0,23.05,6.03,-17.02,967,477,-490,4167,1414,-2753,0.0,331.0,331.0,14125000.0,0.0,-14125000.0
<a href=/player/grees001>grees001</a>,Shawn Green,Los Angeles Dodgers,DOGRS,2,4,7,11,2005,2007,2,No,0,2.23,0.73,-1.5,859,205,-654,2999,398,-2601,426.0,593.0,167.0,682000.0,0.0,-682000.0
<a href=/player/grees001>grees001</a>,Shawn Green,Arizona Diamondbacks,DBACKS,1,2,1,3,2006,2009,3,No,0,0.23,0.0,-0.23,164,0,-164,617,0,-617,0.0,0.0,0.0,10213898.0,0.0,-10213898.0
<a href=/player/grees004>grees004</a>,Sean Green,Colorado Rockies,ROCKS,1,1,1,2,2004,2005,1,No,0,0.62,0.0,-0.62,171,0,-171,1,0,-1,537.0,0.0,-537.0,0.0,0.0,0.0
<a href=/player/grees004>grees004</a>,Sean Green,Seattle Mariners,MARNRS,8,16,16,32,2008,2015,7,No,0,0.83,32.43,31.6,1230,1763,533,2304,5784,3480,1045.0,2794.0,1749.0,18727500.0,0.0,-18727500.0
<a href=/player/grees005>grees005</a>,Shane Greene,New York Yankees,YANKS,1,1,1,2,2014,2019,5,No,0,1.37,15.06,13.69,259,660,401,7,2658,2651,939.0,0.0,-939.0,0.0,0.0,0.0
<a href=/player/grees005>grees005</a>,Shane Greene,Detroit Tigers,TIGRS,1,1,2,3,2019,2021,2,Yes,0,0.82,-1.28,-2.1,117,67,-50,0,219,219,208.0,3.0,-205.0,4000000.0,0.0,-4000000.0
<a href=/player/greet001>greet001</a>,Tommy Greene,Atlanta Braves,BRAVES,3,4,5,9,1990,1991,1,No,0,7.07,0.22,-6.85,460,126,-334,1122,43,-1079,1808.0,218.0,-1590.0,2100000.0,0.0,-2100000.0
<a href=/player/greet004>greet004</a>,Tyler Greene,Atlanta Braves,BRAVES,1,1,1,2,2014,2014,0,No,0,0.0,0.0,0.0,0,0,0,0,0,0,0.0,0.0,0.0,0.0,0.0,0.0
<a href=/player/greew001>greew001</a>,Willie Greene,Pittsburgh Pirates,PIRATS,1,3,1,4,1990,1994,4,No,0,13.0,10.16,-2.84,782,221,-561,2388,261,-2127,274.0,2055.0,1781.0,200000.0,0.0,-200000.0
<a href=/player/greew001>greew001</a>,Willie Greene,Montreal Expos,NATEX,2,4,4,8,1991,2001,10,No,0,7.84,6.46,-1.38,825,557,-268,1993,412,-1581,539.0,721.0,182.0,287500.0,0.0,-287500.0
<a href=/player/greew001>greew001</a>,Willie Greene,Cincinnati Reds,REDS,4,5,7,12,1998,2006,8,No,0,1.72,4.6,2.88,743,525,-218,1103,1018,-85,650.0,1259.0,609.0,12068333.0,0.0,-12068333.0
<a href=/player/gregd001>gregd001</a>,Didi Gregorius,Cincinnati Reds,REDS,1,2,3,5,2012,2013,1,No,0,2.65,4.63,1.98,183,154,-29,703,712,9,0.0,0.0,0.0,527500.0,0.0,-527500.0
<a href=/player/gregd001>gregd001</a>,Didi Gregorius,Arizona Diamondbacks,DBACKS,2,3,3,6,2014,2021,7,No,0,21.95,8.64,-13.31,699,318,-381,2663,315,-2348,642.0,2399.0,1757.0,9936500.0,0.0,-9936500.0
<a href=/player/gregd101>gregd101</a>,Dave Gregg,Toledo,Toledo,1,1,1,2,1913,1913,0,No,0,-0.14,0.0,0.14,2,0,-2,0,0,0,3.0,0.0,-3.0,0.0,0.0,0.0
<a href=/player/gregh102>gregh102</a>,Hal Gregg,Brooklyn Dodgers,DOGRS,3,7,9,16,1947,1954,7,No,0,6.69,26.56,19.87,628,1156,528,1259,3340,2081,1417.0,3832.0,2415.0,38000.0,0.0,-38000.0
<a href=/player/gregh102>gregh102</a>,Hal Gregg,Oakland,Oakland,1,1,2,3,1952,1956,4,No,0,-0.43,0.0,0.43,34,0,-34,8,0,-8,109.0,0.0,-109.0,0.0,0.0,0.0
<a href=/player/gregk001>gregk001</a>,Kevin Gregg,Anaheim Angels,ANGELS,1,1,1,2,2006,2007,1,No,0,2.03,0.06,-1.97,308,4,-304,3,0,-3,485.0,13.0,-472.0,0.0,0.0,0.0
<a href=/player/gregk001>gregk001</a>,Kevin Gregg,Florida Marlins,MARLNS,1,1,1,2,2008,2013,5,No,0,0.59,0.05,-0.54,262,49,-213,0,2,2,392.0,87.0,-305.0,2500000.0,0.0,-2500000.0
<a href=/player/gregl001>gregl001</a>,Luke Gregerson,St. Louis Cardinals,CARDS,1,2,1,3,2009,2009,0,No,0,4.04,-0.85,-4.89,717,77,-640,3,193,190,1041.0,0.0,-1041.0,0.0,0.0,0.0
<a href=/player/gregl001>gregl001</a>,Luke Gregerson,San Diego Padres,PADRS,3,5,6,11,2013,2017,4,Yes,0,2.5,2.46,-0.04,455,476,21,891,538,-353,521.0,637.0,116.0,11894700.0,0.0,-11894700.0
<a href=/player/gregl101>gregl101</a>,Lee Gregory,St. Louis Cardinals,CARDS,1,1,1,2,1964,1964,0,No,0,0.17,0.0,-0.17,30,0,-30,16,0,-16,54.0,0.0,-54.0,0.0,0.0,0.0
<a href=/player/gregt001>gregt001</a>,Tommy Gregg,Pittsburgh Pirates,PIRATS,2,2,3,5,1988,1989,1,No,0,0.52,-0.99,-1.51,423,44,-379,879,104,-775,0.0,11.0,11.0,725000.0,0.0,-725000.0
<a href=/player/gregt002>gregt002</a>,Tom Gregorio,Anaheim Angels,ANGELS,1,1,1,2,2005,2005,0,No,0,0.0,0.0,0.0,0,0,0,0,0,0,0.0,0.0,0.0,0.0,0.0,0.0
<a href=/player/gregv101>gregv101</a>,Vean Gregg,Cleveland Indians,INDINS,3,5,6,11,1914,1922,8,No,0,0.11,10.79,10.68,102,505,403,66,456,390,663.0,3001.0,2338.0,0.0,0.0,0.0
<a href=/player/gregv101>gregv101</a>,Vean Gregg,Boston Red Sox,RSOX,22,48,61,109,1917,1937,20,No,0,205.66,131.1,-74.56,9653,6423,-3230,27902,20755,-7147,27230.0,14799.0,-12431.0,136800.0,0.0,-136800.0
<a href=/player/greib101>greib101</a>,Bill Greif,Houston Astros,ASTROS,7,14,10,24,1971,1989,18,No,0,9.86,19.8,9.94,2403,1970,-433,5583,4832,-751,5444.0,4390.0,-1054.0,22500.0,0.0,-22500.0
<a href=/player/greib101>greib101</a>,Bill Greif,San Diego Padres,PADRS,1,1,1,2,1976,1977,1,No,0,-0.24,-0.42,-0.18,94,80,-14,6,127,121,164.0,0.0,-164.0,0.0,0.0,0.0
<a href=/player/greib101>greib101</a>,Bill Greif,St. Louis Cardinals,CARDS,7,10,11,21,1976,1992,16,No,0,18.25,16.78,-1.47,1455,1377,-78,2974,3172,198,3388.0,4921.0,1533.0,1943333.0,0.0,-1943333.0
<a href=/player/greiz001>greiz001</a>,Zack Greinke,Kansas City Royals,ROYALS,4,9,9,18,2010,2021,11,Yes,0,13.5,49.72,36.22,866,2766,1900,2084,9673,7589,3154.0,2429.0,-725.0,26600000.0,0.0,-26600000.0
<a href=/player/greiz001>greiz001</a>,Zack Greinke,Milwaukee Brewers,BREWRS,7,12,13,25,2012,2020,8,Yes,0,1.1,20.23,19.13,785,1060,275,2514,3316,802,669.0,2064.0,1395.0,20000000.0,0.0,-20000000.0
<a href=/player/greiz001>greiz001</a>,Zack Greinke,Arizona Diamondbacks,DBACKS,1,2,4,6,2019,2019,0,Yes,0,3.35,-0.09,-3.44,54,41,-13,4,157,153,902.0,0.0,-902.0,34500000.0,0.0,-34500000.0
<a href=/player/greyb101>greyb101</a>,Bill Gray,Cincinnati Reds,REDS,1,5,3,8,1897,1900,3,No,0,8.1,12.35,4.25,718,395,-323,2747,1335,-1412,936.0,1747.0,811.0,0.0,0.0,0.0
<a href=/player/greyb101>greyb101</a>,Bill Gray,Pittsburgh Pirates,PIRATS,2,5,2,7,1898,1910,12,No,0,14.38,28.41,14.03,866,1321,455,3143,5735,2592,1417.0,0.0,-1417.0,0.0,0.0,0.0
<a href=/player/gricr001>gricr001</a>,Randal Grichuk,Anaheim Angels,ANGELS,2,3,3,6,2013,2016,3,Yes,0,6.81,4.69,-2.12,768,456,-312,1907,981,-926,187.0,536.0,349.0,0.0,0.0,0.0
<a href=/player/gricr001>gricr001</a>,Randal Grichuk,St. Louis Cardinals,CARDS,1,1,2,3,2018,2019,1,No,0,4.32,-0.49,-4.81,479,137,-342,1866,0,-1866,0.0,194.0,194.0,0.0,0.0,0.0
<a href=/player/grieb001>grieb001</a>,Ben Grieve,Oakland Athletics,ATLTCS,22,40,42,82,2001,2019,18,Yes,2,57.9,95.01,37.11,4320,4541,221,11137,14854,3717,10255.0,6599.0,-3656.0,20632501.0,0.0,-20632501.0
<a href=/player/grieb001>grieb001</a>,Ben Grieve,Milwaukee Brewers,BREWRS,1,1,2,3,2004,2006,2,No,0,0.08,0.0,-0.08,38,0,-38,44,0,-44,0.0,0.0,0.0,700000.0,0.0,-700000.0
<a href=/player/griet101>griet101</a>,Tom Grieve,Texas Rangers,RNGRS,4,9,7,16,1977,1988,11,No,0,6.15,29.07,22.92,381,2027,1646,1490,7192,5702,0.0,2974.0,2974.0,330000.0,0.0,-330000.0
<a href=/player/griet101>griet101</a>,Tom Grieve,New York Mets,METS,22,47,40,87,1978,2019,41,No,4,42.77,110.13,67.36,3719,6479,2760,7583,14933,7350,8114.0,10449.0,2335.0,32500923.0,0.0,-32500923.0
<a href=/player/grifa001>grifa001</a>,Alfredo Griffin,Cleveland Indians,INDINS,7,13,13,26,1978,2011,33,No,2,33.86,57.49,23.63,2512,2806,294,9309,9199,-110,2682.0,4864.0,2182.0,1767500.0,0.0,-1767500.0
<a href=/player/grifa001>grifa001</a>,Alfredo Griffin,Toronto Blue Jays,BJAYS,1,3,1,4,1984,1987,3,No,0,7.47,0.63,-6.84,580,109,-471,2252,0,-2252,0.0,317.0,317.0,650000.0,0.0,-650000.0
<a href=/player/grifa001>grifa001</a>,Alfredo Griffin,Oakland Athletics,ATLTCS,1,4,2,6,1987,1994,7,No,0,8.57,10.76,2.19,979,216,-763,1815,1,-1814,1096.0,3814.0,2718.0,1137653.0,0.0,-1137653.0
<a href=/player/grifb101>grifb101</a>,Bert Griffith,Brooklyn Dodgers,DOGRS,4,10,4,14,1923,1934,11,No,0,0.38,8.57,8.19,106,828,722,108,3039,2931,677.0,26.0,-651.0,36000.0,0.0,-36000.0
<a href=/player/grifb101>grifb101</a>,Bert Griffith,Washington Senators,TWINS,1,3,1,4,1924,1927,3,No,0,0.0,0.0,0.0,0,0,0,0,0,0,0.0,0.0,0.0,2800.0,0.0,-2800.0
<a href=/player/grifd101>grifd101</a>,Doug Griffin,California Angels,ANGELS,3,6,8,14,1970,1974,4,No,0,2.03,2.21,0.18,1109,432,-677,3640,1513,-2127,261.0,88.0,-173.0,44000.0,0.0,-44000.0
<a href=/player/grifd102>grifd102</a>,Derrell Griffith,Los Angeles Dodgers,DOGRS,6,9,10,19,1966,1972,6,No,0,27.49,11.4,-16.09,1888,711,-1177,5026,2330,-2696,1193.0,6.0,-1187.0,136500.0,0.0,-136500.0
<a href=/player/grifd102>grifd102</a>,Derrell Griffith,New York Mets,METS,3,4,4,8,1967,1970,3,No,0,-1.49,0.23,1.72,346,159,-187,991,489,-502,0.0,0.0,0.0,55000.0,0.0,-55000.0
<a href=/player/grifd102>grifd102</a>,Derrell Griffith,Houston Astros,ASTROS,1,2,2,4,1967,1972,5,No,0,0.31,-3.37,-3.68,194,234,40,17,135,118,428.0,1228.0,800.0,0.0,0.0,0.0
<a href=/player/grifh101>grifh101</a>,Hank Griffin,Chicago Cubs,CUBS,3,6,7,13,1911,1916,5,No,0,-3.91,1.45,5.36,376,507,131,960,1665,705,899.0,27.0,-872.0,4500.0,0.0,-4500.0
<a href=/player/grifi101>grifi101</a>,Ivy Griffin,Philadelphia Athletics,ATLTCS,1,5,1,6,1922,1929,7,No,0,0.0,12.22,12.22,0,592,592,0,2318,2318,0.0,0.0,0.0,0.0,0.0,0.0
<a href=/player/grifj001>grifj001</a>,Jeremy Griffiths,New York Mets,METS,1,2,1,3,2004,2004,0,No,0,-0.5,0.91,1.41,53,86,33,2,359,357,109.0,0.0,-109.0,3933333.0,0.0,-3933333.0
<a href=/player/grifj002>grifj002</a>,John-Ford Griffin,New York Yankees,YANKS,2,7,2,9,2002,2005,3,No,0,6.71,3.6,-3.11,546,85,-461,184,2,-182,2652.0,1328.0,-1324.0,4387150.0,0.0,-4387150.0
<a href=/player/grifj002>grifj002</a>,John-Ford Griffin,Oakland Athletics,ATLTCS,3,3,3,6,2003,2009,6,No,0,0.84,3.82,2.98,64,236,172,194,804,610,0.0,0.0,0.0,410000.0,0.0,-410000.0
<a href=/player/grifk001>grifk001</a>,Ken Griffey,Cincinnati Reds,REDS,2,4,4,8,1981,1989,8,No,0,6.72,5.28,-1.44,695,466,-229,2438,1697,-741,243.0,30.0,-213.0,817500.0,0.0,-817500.0
<a href=/player/grifk001>grifk001</a>,Ken Griffey,New York Yankees,YANKS,1,2,2,4,1986,1988,2,No,0,1.46,3.1,1.64,271,317,46,976,1061,85,0.0,0.0,0.0,1050000.0,0.0,-1050000.0
<a href=/player/grifk002>grifk002</a>,Ken Griffey Jr.,Seattle Mariners,MARNRS,17,30,34,64,2000,2015,15,No,0,51.65,63.75,12.1,4345,3730,-615,13706,12979,-727,4049.0,3175.0,-874.0,33352500.0,0.0,-33352500.0
<a href=/player/grifk002>grifk002</a>,Ken Griffey Jr.,Cincinnati Reds,REDS,1,2,2,4,2008,2013,5,No,0,0.44,3.05,2.61,41,495,454,150,49,-101,0.0,721.0,721.0,8282695.0,0.0,-8282695.0
<a href=/player/grifm001>grifm001</a>,Mike Griffin,Texas Rangers,RNGRS,9,19,16,35,1978,1992,14,No,2,37.88,13.17,-24.71,1966,942,-1024,3128,2227,-901,8593.0,2130.0,-6463.0,0.0,0.0,0.0
<a href=/player/grifm001>grifm001</a>,Mike Griffin,New York Yankees,YANKS,1,3,1,4,1981,1983,2,No,0,0.87,1.55,0.68,126,12,-114,98,0,-98,955.0,212.0,-743.0,0.0,0.0,0.0
<a href=/player/grifm001>grifm001</a>,Mike Griffin,Chicago Cubs,CUBS,1,1,1,2,1982,1982,0,No,0,0.0,-0.55,-0.55,0,48,48,0,50,50,0.0,0.0,0.0,0.0,0.0,0.0
<a href=/player/grifm001>grifm001</a>,Mike Griffin,Montreal Expos,NATEX,2,2,2,4,1982,1983,1,No,0,0.04,0.0,-0.04,14,0,-14,1,0,-1,31.0,0.0,-31.0,0.0,0.0,0.0
<a href=/player/grifp101>grifp101</a>,Pug Griffin,Philadelphia Athletics,ATLTCS,2,7,4,11,1917,1920,3,No,0,0.98,1.52,0.54,143,229,86,582,916,334,0.0,0.0,0.0,2400.0,0.0,-2400.0
<a href=/player/grift101>grift101</a>,Tom Griffin,San Francisco Giants,GIANTS,1,1,1,2,1981,1981,0,No,0,-0.96,0.0,0.96,12,0,-12,9,0,-9,67.0,0.0,-67.0,0.0,0.0,0.0
<a href=/player/grift102>grift102</a>,Tommy Griffith,Cincinnati Reds,REDS,1,1,1,2,1919,1919,0,No,0,3.75,1.68,-2.07,724,140,-584,2836,613,-2223,0.0,0.0,0.0,0.0,0.0,0.0
<a href=/player/grift102>grift102</a>,Tommy Griffith,Brooklyn Dodgers,DOGRS,2,3,2,5,1925,1927,2,No,0,0.17,-0.34,-0.51,76,100,24,262,384,122,0.0,0.0,0.0,17500.0,0.0,-17500.0
<a href=/player/griga101>griga101</a>,Art Griggs,St.Louis Browns,ORLS,1,1,1,2,1910,1919,9,No,0,2.06,-0.66,-2.72,116,82,-34,397,292,-105,0.0,0.0,0.0,0.0,0.0,0.0
<a href=/player/grilg101>grilg101</a>,Guido Grilli,Boston Red Sox,RSOX,2,6,4,10,1966,1969,3,No,0,1.66,1.54,-0.12,432,533,101,910,683,-227,275.0,859.0,584.0,24500.0,0.0,-24500.0
<a href=/player/grilj001>grilj001</a>,Jason Grilli,San Francisco Giants,GIANTS,2,5,3,8,1999,2005,6,No,0,17.71,7.22,-10.49,680,557,-123,659,309,-350,4495.0,2909.0,-1586.0,0.0,0.0,0.0
<a href=/player/grilj001>grilj001</a>,Jason Grilli,Detroit Tigers,TIGRS,1,1,1,2,2008,2008,0,No,0,1.2,0.0,-1.2,141,0,-141,6,0,-6,242.0,0.0,-242.0,420000.0,0.0,-420000.0
<a href=/player/grilj001>grilj001</a>,Jason Grilli,Pittsburgh Pirates,PIRATS,1,1,1,2,2014,2014,0,No,0,0.1,-0.62,-0.72,41,28,-13,0,0,0,101.0,32.0,-69.0,0.0,0.0,0.0
<a href=/player/grilj001>grilj001</a>,Jason Grilli,Atlanta Braves,BRAVES,1,2,1,3,2016,2016,0,Yes,0,0.03,0.0,-0.03,78,0,-78,0,0,0,188.0,0.0,-188.0,0.0,0.0,0.0
<a href=/player/grilj001>grilj001</a>,Jason Grilli,Toronto Blue Jays,BJAYS,1,2,1,3,2017,2017,0,Yes,0,-0.02,0.0,0.02,22,0,-22,0,0,0,58.0,0.0,-58.0,0.0,0.0,0.0
<a href=/player/grimb101>grimb101</a>,Burleigh Grimes,Pittsburgh Pirates,PIRATS,2,4,3,7,1918,1922,4,No,0,39.97,14.96,-25.01,1164,899,-265,2135,3669,1534,8893.0,0.0,-8893.0,4200.0,0.0,-4200.0
<a href=/player/grimb101>grimb101</a>,Burleigh Grimes,Brooklyn Dodgers,DOGRS,1,1,1,2,1927,1929,2,No,0,2.81,-0.59,-3.4,78,149,71,106,431,325,779.0,0.0,-779.0,0.0,0.0,0.0
<a href=/player/grimb101>grimb101</a>,Burleigh Grimes,New York Giants,GIANTS,1,1,1,2,1928,1928,0,No,0,12.49,0.02,-12.47,178,44,-134,244,42,-202,1772.0,358.0,-1414.0,0.0,0.0,0.0
<a href=/player/grimb101>grimb101</a>,Burleigh Grimes,Pittsburgh Pirates,PIRATS,1,1,2,3,1930,1930,0,No,0,-1.31,-0.46,0.85,22,18,-4,19,2,-17,147.0,56.0,-91.0,0.0,0.0,0.0
<a href=/player/grimb101>grimb101</a>,Burleigh Grimes,Boston Braves,BRAVES,10,24,17,41,1930,1952,22,No,0,35.57,94.87,59.3,2172,4248,2076,6853,14670,7817,2997.0,6404.0,3407.0,20000.0,0.0,-20000.0
<a href=/player/grimb101>grimb101</a>,Burleigh Grimes,St. Louis Cardinals,CARDS,2,2,4,6,1931,1932,1,No,0,5.37,0.0,-5.37,413,0,-413,1236,0,-1236,633.0,0.0,-633.0,20000.0,0.0,-20000.0
<a href=/player/grimb101>grimb101</a>,Burleigh Grimes,Birmingham,Birmingham,1,1,4,5,1916,1922,6,No,0,12.32,0.0,-12.32,269,0,-269,337,0,-337,2483.0,0.0,-2483.0,0.0,0.0,0.0
<a href=/player/grimb102>grimb102</a>,Bob Grim,New York Yankees,YANKS,1,2,2,4,1958,1960,2,No,0,2.31,-2.84,-5.15,242,240,-2,336,102,-234,756.0,1048.0,292.0,12500.0,0.0,-12500.0
<a href=/player/grimb102>grimb102</a>,Bob Grim,Kansas City Athletics,ATLTCS,1,1,1,2,1960,1960,0,No,0,-0.36,1.48,1.84,6,40,34,0,3,3,7.0,62.0,55.0,0.0,0.0,0.0
<a href=/player/grimc101>grimc101</a>,Charlie Grimm,Pittsburgh Pirates,PIRATS,4,6,7,13,1924,1932,8,No,0,11.08,42.87,31.79,1606,1347,-259,6101,4357,-1744,1307.0,3847.0,2540.0,22300.0,0.0,-22300.0
<a href=/player/grime101>grime101</a>,Ed Grimes,St.Louis Browns,ORLS,2,4,3,7,1932,1938,6,No,0,5.05,3.68,-1.37,140,456,316,175,291,116,1317.0,2656.0,1339.0,9500.0,0.0,-9500.0
<a href=/player/grimj001>grimj001</a>,Jason Grimsley,Philadelphia Phillies,PHILS,4,4,8,12,1992,2006,14,No,0,30.94,46.36,15.42,397,1304,907,351,2404,2053,4627.0,8300.0,3673.0,11600000.0,0.0,-11600000.0
<a href=/player/grimj001>grimj001</a>,Jason Grimsley,Cleveland Indians,INDINS,1,2,1,3,1996,1997,1,No,0,1.47,1.07,-0.4,162,18,-144,0,0,0,907.0,298.0,-609.0,0.0,0.0,0.0
<a href=/player/grimj001>grimj001</a>,Jason Grimsley,Milwaukee Brewers,BREWRS,1,1,1,2,1997,1998,1,No,0,4.34,0.0,-4.34,264,0,-264,0,0,0,760.0,0.0,-760.0,0.0,0.0,0.0
<a href=/player/grimj001>grimj001</a>,Jason Grimsley,Kansas City Royals,ROYALS,2,3,3,6,2004,2009,5,No,0,-1.41,0.68,2.09,292,164,-128,3,478,475,480.0,366.0,-114.0,2335500.0,0.0,-2335500.0
<a href=/player/grimj002>grimj002</a>,Justin Grimm,Texas Rangers,RNGRS,1,4,1,5,2013,2013,0,No,0,4.33,-0.09,-4.42,1129,13,-1116,283,0,-283,1426.0,253.0,-1173.0,0.0,0.0,0.0
<a href=/player/grimm101>grimm101</a>,Moose Grimshaw,Boston Red Sox,RSOX,10,27,24,51,1907,1935,28,No,0,51.77,27.79,-23.98,3792,3187,-605,15081,11693,-3388,0.0,1203.0,1203.0,48850.0,0.0,-48850.0
<a href=/player/grimo101>grimo101</a>,Oscar Grimes,Cleveland Indians,INDINS,5,7,7,14,1942,1948,6,No,0,26.71,21.32,-5.39,1251,1052,-199,4956,4042,-914,0.0,0.0,0.0,29000.0,0.0,-29000.0
<a href=/player/grimr101>grimr101</a>,Ross Grimsley,Cincinnati Reds,REDS,2,3,4,7,1973,1977,4,No,0,7.62,0.16,-7.46,351,195,-156,338,503,165,2723.0,0.0,-2723.0,29000.0,0.0,-29000.0
<a href=/player/grimr101>grimr101</a>,Ross Grimsley,Montreal Expos,NATEX,1,1,1,2,1980,1980,0,No,0,-1.41,0.0,1.41,14,0,-14,0,0,0,224.0,0.0,-224.0,229167.0,0.0,-229167.0
<a href=/player/grisl101>grisl101</a>,Lee Grissom,Cincinnati Reds,REDS,3,3,3,6,1940,1948,8,No,0,0.07,11.26,11.19,117,558,441,142,748,606,213.0,1829.0,1616.0,0.0,0.0,0.0
<a href=/player/grisl101>grisl101</a>,Lee Grissom,Brooklyn Dodgers,DOGRS,2,2,3,5,1941,1947,6,No,0,1.33,-0.05,-1.38,58,57,-1,40,29,-11,394.0,140.0,-254.0,0.0,0.0,0.0
<a href=/player/grism001>grism001</a>,Marquis Grissom,Montreal Expos,NATEX,5,6,8,14,1995,2000,5,No,0,7.84,1.6,-6.24,980,825,-155,3324,2152,-1172,362.0,850.0,488.0,2625000.0,0.0,-2625000.0
<a href=/player/grism001>grism001</a>,Marquis Grissom,Atlanta Braves,BRAVES,5,9,8,17,1997,2005,8,No,2,61.71,16.74,-44.97,2122,677,-1445,3848,1491,-2357,9346.0,423.0,-8923.0,4543000.0,0.0,-4543000.0
<a href=/player/grism001>grism001</a>,Marquis Grissom,Cleveland Indians,INDINS,5,7,8,15,1997,2003,6,No,0,-0.44,6.0,6.44,740,264,-476,1919,1,-1918,857.0,949.0,92.0,9150000.0,0.0,-9150000.0
<a href=/player/grism001>grism001</a>,Marquis Grissom,Milwaukee Brewers,BREWRS,1,2,1,3,2001,2001,0,No,0,1.1,0.82,-0.28,246,126,-120,839,432,-407,0.0,0.0,0.0,0.0,0.0,0.0
<a href=/player/grism101>grism101</a>,Marv Grissom,Detroit Tigers,TIGRS,1,2,1,3,1951,1951,0,No,0,0.0,-0.4,-0.4,0,12,12,0,2,2,0.0,32.0,32.0,0.0,0.0,0.0
<a href=/player/grism101>grism101</a>,Marv Grissom,Seattle,Seattle,1,2,4,6,1951,1954,3,No,0,0.74,0.0,-0.74,138,0,-138,86,0,-86,741.0,0.0,-741.0,0.0,0.0,0.0
<a href=/player/grism101>grism101</a>,Marv Grissom,Chicago White Sox,WSOX,1,3,1,4,1953,1953,0,No,0,1.18,-0.21,-1.39,202,44,-158,118,143,25,1116.0,0.0,-1116.0,0.0,0.0,0.0
<a href=/player/grism101>grism101</a>,Marv Grissom,San Francisco Giants,GIANTS,2,4,4,8,1958,1961,3,No,0,20.2,2.2,-18.0,530,255,-275,497,641,144,4103.0,59.0,-4044.0,0.0,0.0,0.0
<a href=/player/grist001>grist001</a>,Trent Grisham,Milwaukee Brewers,BREWRS,1,2,3,5,2019,2019,0,Yes,0,7.39,0.0,-7.39,203,0,-203,779,0,-779,208.0,0.0,-208.0,2600000.0,0.0,-2600000.0
<a href=/player/groad101>groad101</a>,Dick Groat,Pittsburgh Pirates,PIRATS,4,6,6,12,1962,1968,6,No,0,15.1,3.94,-11.16,878,326,-552,2528,282,-2246,1540.0,2303.0,763.0,46000.0,0.0,-46000.0
<a href=/player/groad101>groad101</a>,Dick Groat,St. Louis Cardinals,CARDS,11,23,19,42,1965,1972,7,No,0,31.6,1.61,-29.99,3237,670,-2567,8420,1434,-6986,1865.0,703.0,-1162.0,32500.0,0.0,-32500.0
<a href=/player/grobc101>grobc101</a>,Connie Grob,Milwaukee Braves,BRAVES,1,3,1,4,1962,1963,1,No,0,3.88,-0.09,-3.97,176,64,-112,179,177,-2,1524.0,0.0,-1524.0,0.0,0.0,0.0
<a href=/player/grohh101>grohh101</a>,Heinie Groh,New York Giants,GIANTS,1,4,1,5,1913,1913,0,No,0,44.86,-0.25,-45.11,1467,52,-1415,5586,39,-5547,1664.0,335.0,-1329.0,8100.0,0.0,-8100.0
<a href=/player/grohh101>grohh101</a>,Heinie Groh,Cincinnati Reds,REDS,1,1,3,4,1921,1925,4,No,0,7.56,3.43,-4.13,420,403,-17,1780,1818,38,0.0,0.0,0.0,10591.0,0.0,-10591.0
<a href=/player/groms101>groms101</a>,Steve Gromek,Cleveland Indians,INDINS,4,8,7,15,1953,1960,7,No,0,29.6,3.08,-26.52,1527,466,-1061,3515,525,-2990,4632.0,1595.0,-3037.0,15900.0,0.0,-15900.0
<a href=/player/groob001>groob001</a>,Buddy Groom,Detroit Tigers,TIGRS,4,6,4,10,1995,2009,14,No,0,-2.11,6.35,8.46,408,430,22,75,32,-43,697.0,3649.0,2952.0,4675000.0,0.0,-4675000.0
<a href=/player/grosd101>grosd101</a>,Don Gross,Cincinnati Reds,REDS,2,2,3,5,1957,1966,9,No,0,-2.01,22.27,24.28,196,568,372,66,607,541,713.0,4957.0,4244.0,0.0,0.0,0.0
<a href=/player/grosg001>grosg001</a>,Greg Gross,Houston Astros,ASTROS,1,1,1,2,1976,1981,5,No,0,0.43,-1.49,-1.92,239,296,57,670,901,231,0.0,0.0,0.0,0.0,0.0,0.0
<a href=/player/grosg001>grosg001</a>,Greg Gross,Chicago Cubs,CUBS,9,17,19,36,1979,1990,11,No,0,20.77,12.9,-7.87,2689,1303,-1386,6948,2680,-4268,1072.0,3217.0,2145.0,890000.0,0.0,-890000.0
<a href=/player/grosg002>grosg002</a>,Gabe Gross,Toronto Blue Jays,BJAYS,1,3,2,5,2005,2010,5,No,0,4.16,12.24,8.08,549,739,190,828,2857,2029,2736.0,120.0,-2616.0,627000.0,0.0,-627000.0
<a href=/player/grosg002>grosg002</a>,Gabe Gross,Milwaukee Brewers,BREWRS,1,1,1,2,2008,2012,4,No,0,2.02,-0.11,-2.13,242,6,-236,671,0,-671,0.0,12.0,12.0,414000.0,0.0,-414000.0
<a href=/player/grosk001>grosk001</a>,Kevin Gross,Philadelphia Phillies,PHILS,2,4,4,8,1988,1996,8,No,0,2.03,7.62,5.59,231,685,454,173,1139,966,1239.0,2303.0,1064.0,1200000.0,0.0,-1200000.0
<a href=/player/grosk002>grosk002</a>,Kip Gross,New York Mets,METS,1,2,2,4,1989,2004,15,No,0,4.69,11.0,6.31,316,1372,1056,62,15,-47,932.0,2108.0,1176.0,300000.0,0.0,-300000.0
<a href=/player/grosk002>grosk002</a>,Kip Gross,Cincinnati Reds,REDS,7,10,14,24,1991,2006,15,No,0,9.83,13.67,3.84,1375,1603,228,1854,3165,1311,1702.0,3067.0,1365.0,19601333.0,0.0,-19601333.0
<a href=/player/grosr001>grosr001</a>,Robbie Grossman,Pittsburgh Pirates,PIRATS,1,3,1,4,2012,2014,2,No,0,1.62,0.18,-1.44,191,63,-128,764,59,-705,17.0,493.0,476.0,0.0,0.0,0.0
<a href=/player/grost101>grost101</a>,Turkey Gross,SanAntonio,SanAntonio,1,1,1,2,1924,1924,0,No,0,-0.26,0.0,0.26,9,0,-9,34,0,-34,0.0,0.0,0.0,0.0,0.0,0.0
<a href=/player/grost101>grost101</a>,Turkey Gross,SanAntonio,SanAntonio,1,5,1,6,1923,1923,0,No,0,9.54,0.0,-9.54,1176,0,-1176,4721,0,-4721,0.0,0.0,0.0,0.0,0.0,0.0
<a href=/player/grosw001>grosw001</a>,Wayne Gross,Oakland Athletics,ATLTCS,2,2,3,5,1983,1984,1,No,0,4.95,0.0,-4.95,346,0,-346,690,0,-690,276.0,0.0,-276.0,0.0,0.0,0.0
<a href=/player/grote101>grote101</a>,Ernest Groth,Cleveland Indians,INDINS,1,2,1,3,1948,1949,1,No,0,0.65,0.86,0.21,84,50,-34,82,13,-69,618.0,186.0,-432.0,0.0,0.0,0.0
<a href=/player/grote101>grote101</a>,Ernest Groth,New York Yankees,YANKS,1,3,1,4,1949,1949,0,No,0,0.0,0.1,0.1,0,28,28,0,3,3,0.0,80.0,80.0,0.0,0.0,0.0
<a href=/player/grotj001>grotj001</a>,Jeff Grotewold,Philadelphia Phillies,PHILS,1,1,1,2,1993,1993,0,No,0,0.0,0.0,0.0,0,0,0,0,0,0,0.0,0.0,0.0,0.0,0.0,0.0
<a href=/player/grotj101>grotj101</a>,Jerry Grote,Houston Astros,ASTROS,1,1,2,3,1965,1965,0,No,0,15.65,0.0,-15.65,1235,0,-1235,4335,0,-4335,0.0,0.0,0.0,0.0,0.0,0.0
<a href=/player/grotj101>grotj101</a>,Jerry Grote,New York Mets,METS,2,3,3,6,1977,1983,6,No,0,-0.2,0.72,0.92,61,17,-44,115,53,-62,0.0,0.0,0.0,0.0,0.0,0.0
<a href=/player/grotj102>grotj102</a>,Johnny Groth,Detroit Tigers,TIGRS,13,25,26,51,1952,1968,16,No,0,25.92,52.07,26.15,2610,3104,494,6934,6097,-837,4331.0,10073.0,5742.0,79500.0,0.0,-79500.0
<a href=/player/grotj102>grotj102</a>,Johnny Groth,Baltimore Orioles,ORLS,6,12,12,24,1954,1960,6,No,0,16.12,9.55,-6.57,902,1031,129,2238,2995,757,2291.0,1208.0,-1083.0,10000.0,0.0,-10000.0
<a href=/player/grotj102>grotj102</a>,Johnny Groth,Chicago White Sox,WSOX,17,31,30,61,1955,1969,14,No,0,22.96,44.36,21.4,3375,3578,203,7415,6981,-434,5139.0,7668.0,2529.0,156750.0,0.0,-156750.0
<a href=/player/grotm001>grotm001</a>,Matt Grott,Oakland Athletics,ATLTCS,1,2,1,3,1991,1995,4,No,0,0.0,3.31,3.31,0,127,127,0,1,1,0.0,2170.0,2170.0,0.0,0.0,0.0
<a href=/player/grovl101>grovl101</a>,Lefty Grove,Philadelphia Athletics,ATLTCS,1,3,3,6,1933,1936,3,No,0,51.32,1.87,-49.45,848,361,-487,1283,1356,73,5977.0,119.0,-5858.0,31000.0,0.0,-31000.0
<a href=/player/grovr101>grovr101</a>,Roy Grover,Philadelphia Athletics,ATLTCS,1,1,1,2,1919,1919,0,No,0,-0.87,-0.24,0.63,24,8,-16,84,6,-78,0.0,36.0,36.0,2400.0,0.0,-2400.0
<a href=/player/grubf101>grubf101</a>,Frank Grube,Chicago White Sox,WSOX,4,9,4,13,1936,1950,14,No,0,-0.26,3.15,3.41,394,894,500,1460,3508,2048,0.0,0.0,0.0,20900.0,0.0,-20900.0
<a href=/player/grubf101>grubf101</a>,Frank Grube,Chicago White Sox,WSOX,1,1,1,2,1933,1945,12,No,0,-0.22,-1.6,-1.38,86,147,61,245,473,228,0.0,0.0,0.0,6500.0,0.0,-6500.0
<a href=/player/grubj001>grubj001</a>,Johnny Grubb,San Diego Padres,PADRS,2,4,2,6,1976,1981,5,No,0,20.22,7.28,-12.94,1143,413,-730,4572,857,-3715,0.0,1243.0,1243.0,0.0,0.0,0.0
<a href=/player/grubj001>grubj001</a>,Johnny Grubb,Cleveland Indians,INDINS,1,1,2,3,1978,1978,0,No,0,1.95,0.0,-1.95,403,0,-403,1279,0,-1279,0.0,0.0,0.0,0.0,0.0,0.0
<a href=/player/grubj001>grubj001</a>,Johnny Grubb,Texas Rangers,RNGRS,1,1,1,2,1983,1984,1,No,0,4.64,1.06,-3.58,361,51,-310,939,0,-939,0.0,259.0,259.0,0.0,0.0,0.0
<a href=/player/grubk001>grubk001</a>,Kelly Gruber,Toronto Blue Jays,BJAYS,1,2,1,3,1992,1993,1,No,0,0.32,-0.45,-0.77,18,19,1,70,54,-16,0.0,0.0,0.0,3633333.0,0.0,-3633333.0
<a href=/player/grudm001>grudm001</a>,Mark Grudzielanek,Montreal Expos,NATEX,3,8,7,15,1998,2004,6,No,0,7.97,-4.29,-12.26,909,664,-245,2909,2173,-736,1579.0,285.0,-1294.0,2150000.0,0.0,-2150000.0
<a href=/player/grudm001>grudm001</a>,Mark Grudzielanek,Los Angeles Dodgers,DOGRS,1,2,2,4,2002,2004,2,No,0,2.3,-0.13,-2.43,316,32,-284,1174,68,-1106,0.0,0.0,0.0,11875000.0,0.0,-11875000.0
<a href=/player/grybk001>grybk001</a>,Kevin Gryboski,Seattle Mariners,MARNRS,1,1,1,2,2002,2002,0,No,0,1.23,0.0,-1.23,430,0,-430,1,0,-1,504.0,0.0,-504.0,0.0,0.0,0.0
<a href=/player/grybk001>grybk001</a>,Kevin Gryboski,Atlanta Braves,BRAVES,1,1,1,2,2005,2005,0,No,0,-0.94,0.0,0.94,11,0,-11,0,0,0,29.0,0.0,-29.0,877500.0,0.0,-877500.0
<a href=/player/grzej101>grzej101</a>,Joe Grzenda,Minnesota Twins,TWINS,1,2,1,3,1970,1971,1,No,0,0.8,0.53,-0.27,190,173,-17,21,478,457,465.0,0.0,-465.0,0.0,0.0,0.0
<a href=/player/grzej101>grzej101</a>,Joe Grzenda,Texas Rangers,RNGRS,13,25,24,49,1971,1992,21,No,2,54.58,25.18,-29.4,2920,1756,-1164,5733,4734,-999,9904.0,4191.0,-5713.0,229000.0,0.0,-229000.0
<a href=/player/guanc001>guanc001</a>,Cecilio Guante,Pittsburgh Pirates,PIRATS,3,5,6,11,1986,2001,15,No,2,5.63,20.71,15.08,232,836,604,93,1605,1512,1758.0,5213.0,3455.0,1290000.0,0.0,-1290000.0
<a href=/player/guanc001>guanc001</a>,Cecilio Guante,New York Yankees,YANKS,1,1,1,2,1988,1989,1,No,0,0.31,-0.46,-0.77,58,47,-11,0,0,0,221.0,241.0,20.0,380000.0,0.0,-380000.0
<a href=/player/guare001>guare001</a>,Eddie Guardado,Seattle Mariners,MARNRS,1,2,1,3,2006,2008,2,No,0,0.23,-0.22,-0.45,60,3,-57,0,0,0,83.0,15.0,-68.0,6250000.0,0.0,-6250000.0
<a href=/player/guare001>guare001</a>,Eddie Guardado,Texas Rangers,RNGRS,1,1,1,2,2008,2012,4,No,0,-0.22,0.04,0.26,9,5,-4,0,0,0,21.0,24.0,3.0,2000000.0,0.0,-2000000.0
<a href=/player/gubac001>gubac001</a>,Creighton Gubanich,Milwaukee Brewers,BREWRS,1,1,1,2,1997,1997,0,No,0,0.0,-1.29,-1.29,0,84,84,0,154,154,0.0,0.0,0.0,0.0,0.0,0.0
<a href=/player/gubac001>gubac001</a>,Creighton Gubanich,Oakland Athletics,ATLTCS,1,1,1,2,1997,1997,0,No,0,0.0,0.0,0.0,0,0,0,0,0,0,0.0,0.0,0.0,0.0,0.0,0.0
<a href=/player/gubim001>gubim001</a>,Mark Gubicza,Kansas City Royals,ROYALS,1,2,1,3,1996,1997,1,No,0,-0.59,2.4,2.99,5,140,135,0,567,567,24.0,0.0,-24.0,1600000.0,0.0,-1600000.0
<a href=/player/gudam101>gudam101</a>,Marv Gudat,Chicago Cubs,CUBS,2,7,2,9,1933,1938,5,No,0,10.27,0.77,-9.5,576,293,-283,361,754,393,2894.0,224.0,-2670.0,0.0,0.0,0.0
<a href=/player/guerd001>guerd001</a>,Deolis Guerra,New York Mets,METS,1,4,1,5,2008,2013,5,No,0,2.31,15.63,13.32,305,210,-95,963,247,-716,66.0,2151.0,2085.0,0.0,0.0,0.0
<a href=/player/guerg001>guerg001</a>,Gabriel Guerrero,Seattle Mariners,MARNRS,3,7,4,11,2015,2017,2,Yes,0,4.57,3.33,-1.24,655,244,-411,2424,508,-1916,92.0,403.0,311.0,9532900.0,0.0,-9532900.0
<a href=/player/guerj004>guerj004</a>,Javy Guerra,Boston Red Sox,RSOX,1,4,1,5,2015,2018,3,No,0,5.44,6.73,1.29,670,203,-467,2136,0,-2136,153.0,553.0,400.0,0.0,0.0,0.0
<a href=/player/guerm001>guerm001</a>,Matt Guerrier,Chicago White Sox,WSOX,4,5,5,10,2002,2011,9,No,0,1.48,8.44,6.96,460,809,349,101,2004,1903,823.0,777.0,-46.0,4000000.0,0.0,-4000000.0
<a href=/player/guerm001>guerm001</a>,Matt Guerrier,Los Angeles Dodgers,DOGRS,1,1,2,3,2013,2013,0,No,0,0.34,0.26,-0.08,29,41,12,0,1,1,38.0,64.0,26.0,0.0,0.0,0.0
<a href=/player/guerm101>guerm101</a>,Mario Guerrero,New York Yankees,YANKS,26,58,46,104,1972,2001,29,No,2,106.81,82.12,-24.69,7254,4598,-2656,18342,10064,-8278,21429.0,11941.0,-9488.0,5628333.0,0.0,-5628333.0
<a href=/player/guerm101>guerm101</a>,Mario Guerrero,Boston Red Sox,RSOX,1,1,1,2,1975,1978,3,No,0,0.21,1.45,1.24,64,110,46,200,1,-199,0.0,606.0,606.0,0.0,0.0,0.0
<a href=/player/guerm101>guerm101</a>,Mario Guerrero,St. Louis Cardinals,CARDS,2,2,4,6,1976,1976,0,No,0,0.18,0.0,-0.18,169,0,-169,540,0,-540,0.0,0.0,0.0,0.0,0.0,0.0
<a href=/player/guerm101>guerm101</a>,Mario Guerrero,San Francisco Giants,GIANTS,4,14,8,22,1978,1992,14,No,0,8.18,23.62,15.44,767,1277,510,1656,1600,-56,2714.0,7759.0,5045.0,0.0,0.0,0.0
<a href=/player/guerm102>guerm102</a>,Mike Guerra,Boston Red Sox,RSOX,1,1,2,3,1951,1951,0,No,0,-1.31,0.0,1.31,72,0,-72,231,0,-231,0.0,0.0,0.0,0.0,0.0,0.0
<a href=/player/guerp001>guerp001</a>,Pedro Guerrero,Cleveland Indians,INDINS,1,1,1,2,1974,1974,0,No,0,32.72,-0.11,-32.83,1036,16,-1020,4089,0,-4089,0.0,126.0,126.0,0.0,0.0,0.0
<a href=/player/guerp001>guerp001</a>,Pedro Guerrero,Los Angeles Dodgers,DOGRS,2,2,2,4,1988,1989,1,No,1,1.7,1.28,-0.42,500,30,-470,2026,18,-2008,0.0,200.0,200.0,1720000.0,0.0,-1720000.0
<a href=/player/guert001>guert001</a>,Tayron Guerrero,San Diego Padres,PADRS,4,12,9,21,2016,2021,5,Yes,0,1.39,-0.63,-2.02,553,209,-344,911,376,-535,973.0,576.0,-397.0,10660200.0,0.0,-10660200.0
<a href=/player/guerw001>guerw001</a>,Wilton Guerrero,Los Angeles Dodgers,DOGRS,4,8,8,16,1998,2006,8,No,0,3.75,12.46,8.71,1576,982,-594,3524,3610,86,1585.0,233.0,-1352.0,12365000.0,0.0,-12365000.0
<a href=/player/guerw001>guerw001</a>,Wilton Guerrero,Cincinnati Reds,REDS,1,3,1,4,2002,2003,1,No,0,1.48,-2.8,-4.28,415,76,-339,1688,70,-1618,0.0,613.0,613.0,2400000.0,0.0,-2400000.0
<a href=/player/guerw001>guerw001</a>,Wilton Guerrero,Florida Marlins,MARLNS,3,7,8,15,2002,2012,10,No,2,-0.85,8.19,9.04,199,784,585,190,1558,1368,741.0,2057.0,1316.0,6500000.0,0.0,-6500000.0
<a href=/player/guetl001>guetl001</a>,Lee Guetterman,Seattle Mariners,MARNRS,4,7,6,13,1987,1995,8,No,0,7.57,0.25,-7.32,518,728,210,671,2089,1418,1950.0,271.0,-1679.0,982500.0,0.0,-982500.0
<a href=/player/guetl001>guetl001</a>,Lee Guetterman,New York Yankees,YANKS,1,1,1,2,1992,1992,0,No,0,-0.93,0.06,0.99,86,23,-63,2,0,-2,130.0,83.0,-47.0,1600000.0,0.0,-1600000.0
<a href=/player/guiea001>guiea001</a>,Aaron Guiel,Anaheim Angels,ANGELS,1,1,1,2,1997,1997,0,No,0,0.0,-0.06,-0.06,0,11,11,0,17,17,0.0,0.0,0.0,0.0,0.0,0.0
<a href=/player/guilc001>guilc001</a>,Carlos Guillen,Houston Astros,ASTROS,2,4,3,7,1998,1998,0,No,2,33.49,3.98,-29.51,809,22,-787,1941,35,-1906,4960.0,253.0,-4707.0,170000.0,0.0,-170000.0
<a href=/player/guilc001>guilc001</a>,Carlos Guillen,Seattle Mariners,MARNRS,1,1,2,3,2004,2005,1,No,0,18.63,-0.28,-18.91,817,27,-790,3384,58,-3326,0.0,0.0,0.0,0.0,0.0,0.0
<a href=/player/guilj001>guilj001</a>,Jose Guillen,Pittsburgh Pirates,PIRATS,1,2,2,4,1999,2007,8,No,0,1.13,-1.06,-2.19,216,241,25,680,708,28,91.0,0.0,-91.0,375000.0,0.0,-375000.0
<a href=/player/guilj001>guilj001</a>,Jose Guillen,Cincinnati Reds,REDS,1,1,3,4,2003,2010,7,No,0,0.2,14.51,14.31,45,509,464,186,479,293,0.0,4166.0,4166.0,0.0,0.0,0.0
<a href=/player/guilj001>guilj001</a>,Jose Guillen,Anaheim Angels,ANGELS,3,4,5,9,2004,2013,9,Yes,0,2.39,19.69,17.3,417,1562,1145,1612,5804,4192,0.0,0.0,0.0,2200000.0,0.0,-2200000.0
<a href=/player/guilj001>guilj001</a>,Jose Guillen,Kansas City Royals,ROYALS,1,1,2,3,2010,2010,0,No,0,-0.57,0.0,0.57,42,0,-42,139,0,-139,0.0,0.0,0.0,12000000.0,0.0,-12000000.0
<a href=/player/guilo001>guilo001</a>,Ozzie Guillen,San Diego Padres,PADRS,2,6,4,10,1984,1989,5,No,0,23.33,0.76,-22.57,2084,146,-1938,6812,127,-6685,1933.0,1127.0,-806.0,0.0,0.0,0.0
<a href=/player/guilo001>guilo001</a>,Ozzie Guillen,Chicago White Sox,WSOX,1,2,2,4,2011,2013,2,No,0,0.0,0.17,0.17,0,2,2,0,0,0,0.0,8.0,8.0,0.0,0.0,0.0
<a href=/player/guilp001>guilp001</a>,Preston Guilmet,Cleveland Indians,INDINS,1,1,1,2,2014,2014,0,Yes,0,-0.1,0.0,0.1,11,0,-11,0,0,0,31.0,0.0,-31.0,0.0,0.0,0.0
<a href=/player/guilt001>guilt001</a>,Taylor Guilbeau,Washington Nationals,NATEX,1,3,2,5,2019,2020,1,No,0,0.05,-0.26,-0.31,39,55,16,0,1,1,84.0,72.0,-12.0,0.0,0.0,0.0
<a href=/player/guldb001>guldb001</a>,Brad Gulden,Los Angeles Dodgers,DOGRS,1,1,1,2,1979,1980,1,No,0,-0.06,0.31,0.37,42,195,153,108,491,383,0.0,0.0,0.0,0.0,0.0,0.0
<a href=/player/guldb001>guldb001</a>,Brad Gulden,New York Yankees,YANKS,6,11,11,22,1980,1992,12,No,0,8.07,13.87,5.8,1174,646,-528,2497,1931,-566,2564.0,669.0,-1895.0,913333.0,0.0,-913333.0
<a href=/player/guldb001>guldb001</a>,Brad Gulden,Seattle Mariners,MARNRS,1,2,2,4,1981,1986,5,No,0,0.72,-0.08,-0.8,106,8,-98,281,16,-265,0.0,0.0,0.0,0.0,0.0,0.0
<a href=/player/guldb001>guldb001</a>,Brad Gulden,New York Yankees,YANKS,1,1,1,2,1982,1982,0,No,0,-0.12,-0.07,0.05,5,4,-1,7,11,4,0.0,0.0,0.0,0.0,0.0,0.0
<a href=/player/gullb001>gullb001</a>,Bill Gullickson,Montreal Expos,NATEX,6,9,12,21,1985,1996,11,No,0,4.45,9.14,4.69,274,1231,957,297,636,339,2341.0,2913.0,572.0,1325000.0,0.0,-1325000.0
<a href=/player/gullb001>gullb001</a>,Bill Gullickson,Cincinnati Reds,REDS,2,2,2,4,1987,1988,1,No,0,4.86,-0.21,-5.07,228,38,-190,252,39,-213,2143.0,317.0,-1826.0,1357500.0,0.0,-1357500.0
<a href=/player/gullt101>gullt101</a>,Ted Gullic,Milwaukee,Milwaukee,1,2,3,5,1932,1932,0,No,0,3.6,0.0,-3.6,514,0,-514,595,0,-595,2467.0,0.0,-2467.0,0.0,0.0,0.0
<a href=/player/gumba101>gumba101</a>,Ad Gumbert,Chicago Cubs,CUBS,1,1,1,2,1893,1893,0,No,0,1.89,-0.11,-2.0,128,14,-114,228,28,-200,1301.0,168.0,-1133.0,0.0,0.0,0.0
<a href=/player/gumba101>gumba101</a>,Ad Gumbert,Pittsburgh Pirates,PIRATS,1,1,1,2,1895,1898,3,No,0,1.4,-0.52,-1.92,77,19,-58,117,67,-50,795.0,0.0,-795.0,0.0,0.0,0.0
<a href=/player/gumbh101>gumbh101</a>,Harry Gumbert,New York Giants,GIANTS,1,3,1,4,1941,1941,0,No,0,6.28,-0.7,-6.98,205,44,-161,186,32,-154,1502.0,319.0,-1183.0,0.0,0.0,0.0
<a href=/player/gumpd001>gumpd001</a>,Dave Gumpert,Chicago Cubs,CUBS,1,2,1,3,1987,1988,1,No,0,-0.74,0.52,1.26,103,85,-18,176,227,51,58.0,0.0,-58.0,0.0,0.0,0.0
<a href=/player/gumpr101>gumpr101</a>,Randy Gumpert,Chicago White Sox,WSOX,26,50,43,93,1951,1969,18,No,0,84.01,61.56,-22.45,6907,5207,-1700,17328,11506,-5822,13187.0,9922.0,-3265.0,288750.0,0.0,-288750.0
<a href=/player/gumpr101>gumpr101</a>,Randy Gumpert,Boston Red Sox,RSOX,1,2,1,3,1952,1955,3,No,0,3.27,3.29,0.02,146,168,22,161,116,-45,1293.0,1085.0,-208.0,12000.0,0.0,-12000.0
<a href=/player/gural001>gural001</a>,Larry Gura,Chicago Cubs,CUBS,1,1,1,2,1973,1974,1,No,0,0.0,-0.03,-0.03,0,26,26,0,4,4,0.0,59.0,59.0,15000.0,0.0,-15000.0
<a href=/player/gural001>gural001</a>,Larry Gura,Texas Rangers,RNGRS,1,2,1,3,1974,1975,1,No,0,2.91,-0.38,-3.29,34,39,5,0,118,118,622.0,0.0,-622.0,0.0,0.0,0.0
<a href=/player/gural001>gural001</a>,Larry Gura,New York Yankees,YANKS,1,1,1,2,1976,1978,2,No,0,18.75,0.86,-17.89,312,74,-238,0,205,205,5104.0,0.0,-5104.0,0.0,0.0,0.0
<a href=/player/gusht001>gusht001</a>,Taylor Gushue,Pittsburgh Pirates,PIRATS,1,1,1,2,2016,2018,2,No,0,0.0,0.02,0.02,0,22,22,0,34,34,0.0,0.0,0.0,0.0,0.0,0.0
<a href=/player/gustf101>gustf101</a>,Frankie Gustine,Pittsburgh Pirates,PIRATS,22,40,53,93,1948,1973,25,No,0,26.59,60.08,33.49,3582,5165,1583,9869,14610,4741,4211.0,5429.0,1218.0,216500.0,0.0,-216500.0
<a href=/player/gustf101>gustf101</a>,Frankie Gustine,Philadelphia Athletics,ATLTCS,36,79,78,157,1949,1976,27,No,0,93.22,74.94,-18.28,10595,9460,-1135,25786,29262,3476,12563.0,7417.0,-5146.0,500300.0,0.0,-500300.0
<a href=/player/gustj001>gustj001</a>,Jandel Gustave,Pittsburgh Pirates,PIRATS,1,2,1,3,2021,2021,0,Yes,0,0.06,0.0,-0.06,26,0,-26,2,0,-2,55.0,0.0,-55.0,0.0,0.0,0.0
<a href=/player/guthj001>guthj001</a>,Jeremy Guthrie,Baltimore Orioles,ORLS,2,3,4,7,2012,2013,1,No,0,-0.36,3.87,4.23,65,90,25,30,11,-19,304.0,1015.0,711.0,3600000.0,0.0,-3600000.0
<a href=/player/guthj001>guthj001</a>,Jeremy Guthrie,Colorado Rockies,ROCKS,1,1,1,2,2012,2012,0,No,0,3.59,-0.39,-3.98,116,6,-110,17,3,-14,1961.0,34.0,-1927.0,8200000.0,0.0,-8200000.0
<a href=/player/guthm001>guthm001</a>,Mark Guthrie,Minnesota Twins,TWINS,2,3,5,8,1995,2000,5,No,0,1.39,-0.49,-1.88,429,829,400,30,2713,2683,819.0,618.0,-201.0,4612500.0,0.0,-4612500.0
<a href=/player/guthm001>guthm001</a>,Mark Guthrie,Boston Red Sox,RSOX,1,2,1,3,1999,2001,2,No,0,0.54,2.66,2.12,201,119,-82,36,1,-35,221.0,406.0,185.0,1600000.0,0.0,-1600000.0
<a href=/player/guthm001>guthm001</a>,Mark Guthrie,Chicago Cubs,CUBS,2,3,2,5,2000,2000,0,No,0,0.66,-0.95,-1.61,78,72,-6,134,158,24,96.0,0.0,-96.0,1600000.0,0.0,-1600000.0
<a href=/player/guthm001>guthm001</a>,Mark Guthrie,Tampa Bay Devil Rays,RAYS,1,2,1,3,2000,2003,3,No,0,1.0,0.98,-0.02,34,198,164,0,846,846,251.0,0.0,-251.0,1000000.0,0.0,-1000000.0
<a href=/player/guthm001>guthm001</a>,Mark Guthrie,Oakland Athletics,ATLTCS,1,2,1,3,2001,2001,0,No,0,0.66,0.0,-0.66,175,0,-175,14,0,-14,284.0,0.0,-284.0,1800000.0,0.0,-1800000.0
<a href=/player/gutic101>gutic101</a>,Cesar Gutierrez,San Francisco Giants,GIANTS,1,1,1,2,1969,1972,3,No,0,-1.81,3.65,5.46,190,358,168,548,34,-514,0.0,789.0,789.0,9000.0,0.0,-9000.0
<a href=/player/gutif001>gutif001</a>,Franklin Gutierrez,Los Angeles Dodgers,DOGRS,2,4,2,6,2004,2017,13,No,0,6.58,25.96,19.38,465,1671,1206,1473,6338,4865,30.0,0.0,-30.0,2830000.0,0.0,-2830000.0
<a href=/player/gutif001>gutif001</a>,Franklin Gutierrez,Cleveland Indians,INDINS,1,1,2,3,2008,2013,5,No,0,12.81,6.75,-6.06,635,534,-101,2388,752,-1636,0.0,813.0,813.0,404400.0,0.0,-404400.0
<a href=/player/gutij001>gutij001</a>,Jackie Gutierrez,Boston Red Sox,RSOX,1,1,1,2,1985,1986,1,No,0,-1.8,0.3,2.1,64,27,-37,153,0,-153,0.0,191.0,191.0,130000.0,0.0,-130000.0
<a href=/player/gutij002>gutij002</a>,Juan Gutierrez,Houston Astros,ASTROS,4,8,6,14,2007,2018,11,Yes,2,3.86,8.15,4.29,1017,824,-193,623,1881,1258,2956.0,649.0,-2307.0,856000.0,0.0,-856000.0
<a href=/player/gutik001>gutik001</a>,Kelvin Gutierrez,Washington Nationals,NATEX,1,3,1,4,2018,2018,0,No,0,-0.73,0.15,0.88,62,41,-21,233,0,-233,0.0,56.0,56.0,0.0,0.0,0.0
<a href=/player/gutir001>gutir001</a>,Ricky Gutierrez,Baltimore Orioles,ORLS,1,2,1,3,1992,1992,0,No,0,-1.14,-0.08,1.06,223,5,-218,809,0,-809,0.0,99.0,99.0,0.0,0.0,0.0
<a href=/player/gutir001>gutir001</a>,Ricky Gutierrez,San Diego Padres,PADRS,16,32,32,64,1994,2010,16,No,6,18.63,52.35,33.72,3699,4432,733,12670,15324,2654,1244.0,1789.0,545.0,25389800.0,0.0,-25389800.0
<a href=/player/guyeb001>guyeb001</a>,Brandon Guyer,Chicago Cubs,CUBS,4,8,9,17,2011,2019,8,Yes,0,18.8,9.35,-9.45,836,1392,556,1720,408,-1312,3536.0,2716.0,-820.0,1500000.0,0.0,-1500000.0
<a href=/player/guyeb001>guyeb001</a>,Brandon Guyer,Tampa Bay Devil Rays,RAYS,1,1,2,3,2016,2016,0,Yes,0,0.9,0.0,-0.9,212,0,-212,509,0,-509,3.0,0.0,-3.0,0.0,0.0,0.0
<a href=/player/guzmc001>guzmc001</a>,Cristian Guzman,New York Yankees,YANKS,1,5,1,6,1998,2001,3,No,0,22.8,7.48,-15.32,1163,539,-624,4014,2478,-1536,2978.0,0.0,-2978.0,0.0,0.0,0.0
<a href=/player/guzmc001>guzmc001</a>,Cristian Guzman,Washington Nationals,NATEX,2,2,3,5,2010,2018,8,Yes,0,1.08,17.02,15.94,55,353,298,84,317,233,331.0,2805.0,2474.0,14475000.0,0.0,-14475000.0
<a href=/player/guzme001>guzme001</a>,Edwards Guzman,San Francisco Giants,GIANTS,1,3,2,5,2003,2005,2,No,0,18.34,1.53,-16.81,443,337,-106,636,24,-612,3951.0,670.0,-3281.0,0.0,0.0,0.0
<a href=/player/guzmf001>guzmf001</a>,Freddy Guzman,San Diego Padres,PADRS,1,2,2,4,2006,2006,0,No,0,0.07,0.0,-0.07,17,0,-17,15,0,-15,0.0,0.0,0.0,0.0,0.0,0.0
<a href=/player/guzmf001>guzmf001</a>,Freddy Guzman,Texas Rangers,RNGRS,1,1,1,2,2007,2008,1,No,0,0.0,0.38,0.38,0,41,41,0,117,117,0.0,0.0,0.0,0.0,0.0,0.0
<a href=/player/guzmj003>guzmj003</a>,Juan Guzman,Los Angeles Dodgers,DOGRS,1,1,1,2,1987,1994,7,No,0,20.96,5.92,-15.04,196,518,322,2,1271,1269,3647.0,0.0,-3647.0,0.0,0.0,0.0
<a href=/player/guzmj003>guzmj003</a>,Juan Guzman,Toronto Blue Jays,BJAYS,1,1,2,3,1998,2000,2,No,0,2.8,-0.52,-3.32,34,9,-25,6,0,-6,566.0,31.0,-535.0,5000000.0,0.0,-5000000.0
<a href=/player/guzmj003>guzmj003</a>,Juan Guzman,Baltimore Orioles,ORLS,2,3,4,7,1999,2012,13,No,2,0.88,7.37,6.49,24,456,432,30,98,68,232.0,1138.0,906.0,5250000.0,0.0,-5250000.0
<a href=/player/guzmj004>guzmj004</a>,Joel Guzman,Los Angeles Dodgers,DOGRS,3,5,7,12,2006,2016,10,Yes,2,0.98,0.0,-0.98,150,215,65,206,308,102,113.0,222.0,109.0,0.0,0.0,0.0
<a href=/player/guzmj005>guzmj005</a>,Jesus Guzman,San Diego Padres,PADRS,1,1,1,2,2013,2014,1,No,0,-0.74,0.0,0.74,69,0,-69,184,0,-184,0.0,0.0,0.0,503200.0,0.0,-503200.0
<a href=/player/guzmj006>guzmj006</a>,Jorge Guzman,Houston Astros,ASTROS,1,2,2,4,2016,2018,2,No,0,-0.24,1.81,2.05,33,160,127,0,615,615,114.0,0.0,-114.0,0.0,0.0,0.0
<a href=/player/guzmj006>guzmj006</a>,Jorge Guzman,New York Yankees,YANKS,1,3,1,4,2017,2017,0,Yes,0,2.19,0.0,-2.19,342,0,-342,1369,0,-1369,8.0,0.0,-8.0,9857143.0,0.0,-9857143.0
<a href=/player/guzms101>guzms101</a>,Santiago Guzman,St. Louis Cardinals,CARDS,1,1,1,2,1972,1972,0,No,0,0.0,0.08,0.08,0,33,33,0,5,5,0.0,104.0,104.0,0.0,0.0,0.0
<a href=/player/gwosd001>gwosd001</a>,Doug Gwosdz,New York Mets,METS,2,2,2,4,1986,1987,1,No,0,0.0,-0.25,-0.25,0,10,10,0,5,5,0.0,65.0,65.0,0.0,0.0,0.0
<a href=/player/gwync001>gwync001</a>,Chris Gwynn,Los Angeles Dodgers,DOGRS,1,2,1,3,1991,1992,1,No,0,0.26,-0.93,-1.19,137,121,-16,406,313,-93,0.0,0.0,0.0,260000.0,0.0,-260000.0
<a href=/player/gwynt002>gwynt002</a>,Tony Gwynn,Milwaukee Brewers,BREWRS,1,1,1,2,2009,2010,1,No,0,5.13,0.07,-5.06,236,117,-119,790,251,-539,0.0,0.0,0.0,0.0,0.0,0.0
<a href=/player/gyorj001>gyorj001</a>,Jedd Gyorko,San Diego Padres,PADRS,1,2,1,3,2015,2016,1,No,0,6.31,1.2,-5.11,418,90,-328,1383,374,-1009,4.0,0.0,-4.0,2000000.0,0.0,-2000000.0
<a href=/player/gyorj001>gyorj001</a>,Jedd Gyorko,St. Louis Cardinals,CARDS,1,2,2,4,2019,2019,0,Yes,0,-0.4,0.0,0.4,24,0,-24,39,0,-39,0.0,0.0,0.0,13000000.0,0.0,-13000000.0
<a href=/player/gysed101>gysed101</a>,Dick Gyselman,Mission,Mission,1,2,2,4,1932,1933,1,No,0,-0.29,0.0,0.29,86,0,-86,205,0,-205,0.0,0.0,0.0,0.0,0.0,0.0
<a href=/player/gysed101>gysed101</a>,Dick Gyselman,Boston Braves,BRAVES,2,5,2,7,1934,1940,6,No,0,0.0,6.69,6.69,0,395,395,0,958,958,0.0,2031.0,2031.0,0.0,0.0,0.0
<a href=/player/haasb102>haasb102</a>,Bert Haas,Brooklyn Dodgers,DOGRS,1,5,2,7,1940,1946,6,No,0,2.24,22.24,20.0,200,770,570,485,2187,1702,487.0,3020.0,2533.0,0.0,0.0,0.0
<a href=/player/haasb102>haasb102</a>,Bert Haas,Cincinnati Reds,REDS,1,1,1,2,1947,1947,0,No,0,0.76,0.0,-0.76,97,0,-97,372,0,-372,0.0,0.0,0.0,0.0,0.0,0.0
<a href=/player/haasb102>haasb102</a>,Bert Haas,New York Giants,GIANTS,1,5,3,8,1950,1954,4,No,0,0.0,-0.44,-0.44,0,186,186,0,308,308,0.0,172.0,172.0,0.0,0.0,0.0
<a href=/player/haase101>haase101</a>,Eddie Haas,Chicago Cubs,CUBS,11,20,17,37,1957,1977,20,No,0,15.71,44.12,28.41,1386,3941,2555,1236,10815,9579,4659.0,6233.0,1574.0,122500.0,0.0,-122500.0
<a href=/player/haasm001>haasm001</a>,Moose Haas,Milwaukee Brewers,BREWRS,2,3,6,9,1986,1992,6,No,0,3.87,3.54,-0.33,253,225,-28,659,688,29,339.0,293.0,-46.0,150000.0,0.0,-150000.0
<a href=/player/habyj001>habyj001</a>,John Habyan,Baltimore Orioles,ORLS,1,1,1,2,1989,1990,1,No,0,4.31,0.29,-4.02,165,45,-120,0,155,155,641.0,0.0,-641.0,0.0,0.0,0.0
<a href=/player/habyj001>habyj001</a>,John Habyan,New York Yankees,YANKS,2,2,2,4,1993,1997,4,No,0,0.97,1.35,0.38,56,84,28,0,0,0,141.0,388.0,247.0,600000.0,0.0,-600000.0
<a href=/player/habyj001>habyj001</a>,John Habyan,St. Louis Cardinals,CARDS,2,4,4,8,1995,1997,2,No,0,0.15,-1.34,-1.49,453,272,-181,688,552,-136,283.0,68.0,-215.0,5542500.0,0.0,-5542500.0
<a href=/player/hacke001>hacke001</a>,Eric Hacker,New York Yankees,YANKS,1,1,1,2,2009,2011,2,No,0,-0.02,0.17,0.19,6,2,-4,0,0,0,9.0,13.0,4.0,0.0,0.0,0.0
<a href=/player/hackl001>hackl001</a>,Luther Hackman,Colorado Rockies,ROCKS,13,23,24,47,1999,2003,4,No,0,20.8,11.07,-9.73,2188,1626,-562,1402,1034,-368,5980.0,2442.0,-3538.0,24071314.0,0.0,-24071314.0
<a href=/player/hackl001>hackl001</a>,Luther Hackman,St. Louis Cardinals,CARDS,1,2,1,3,2002,2003,1,No,0,-1.26,0.08,1.34,128,65,-63,2,78,76,230.0,608.0,378.0,245000.0,0.0,-245000.0
<a href=/player/hackr101>hackr101</a>,Rich Hacker,New York Mets,METS,7,11,11,22,1971,1984,13,No,0,10.8,20.91,10.11,1517,1503,-14,1460,5043,3583,2280.0,196.0,-2084.0,90000.0,0.0,-90000.0
<a href=/player/hackw102>hackw102</a>,Warren Hacker,Chicago Cubs,CUBS,2,5,4,9,1956,1958,2,No,0,7.54,-1.1,-8.64,773,105,-668,2296,34,-2262,130.0,197.0,67.0,0.0,0.0,0.0
<a href=/player/haddh101>haddh101</a>,Harvey Haddix,St. Louis Cardinals,CARDS,1,3,2,5,1956,1958,2,No,0,5.63,6.28,0.65,262,246,-16,209,231,22,1575.0,1837.0,262.0,0.0,0.0,0.0
<a href=/player/haddh101>haddh101</a>,Harvey Haddix,Philadelphia Phillies,PHILS,2,4,3,7,1957,1968,11,No,0,9.25,26.83,17.58,407,1550,1143,1073,5702,4629,552.0,0.0,-552.0,0.0,0.0,0.0
<a href=/player/haddh101>haddh101</a>,Harvey Haddix,Cincinnati Reds,REDS,4,7,11,18,1959,1965,6,No,0,63.65,9.6,-54.05,3136,1073,-2063,9911,1717,-8194,2563.0,935.0,-1628.0,0.0,0.0,0.0
<a href=/player/haddh101>haddh101</a>,Harvey Haddix,Pittsburgh Pirates,PIRATS,1,1,2,3,1963,1963,0,No,0,0.5,0.0,-0.5,146,0,-146,23,0,-23,370.0,0.0,-370.0,0.0,0.0,0.0
<a href=/player/hadej001>hadej001</a>,Josh Hader,Baltimore Orioles,ORLS,1,3,1,4,2013,2015,2,No,0,0.01,0.61,0.6,109,65,-44,333,11,-322,0.0,847.0,847.0,0.0,0.0,0.0
<a href=/player/hadej001>hadej001</a>,Josh Hader,Houston Astros,ASTROS,1,4,3,7,2015,2017,2,No,0,18.89,0.28,-18.61,984,198,-786,1471,487,-984,1823.0,1153.0,-670.0,0.0,0.0,0.0
<a href=/player/hadlb101>hadlb101</a>,Bump Hadley,Washington Senators,TWINS,4,9,7,16,1931,1936,5,No,0,40.86,14.39,-26.47,2483,840,-1643,9607,2965,-6642,2547.0,1249.0,-1298.0,62500.0,0.0,-62500.0
<a href=/player/hadlb101>hadlb101</a>,Bump Hadley,Chicago White Sox,WSOX,2,3,2,5,1932,1940,8,No,0,17.91,-0.15,-18.06,925,353,-572,3007,1416,-1591,2296.0,0.0,-2296.0,17600.0,0.0,-17600.0
<a href=/player/hadlb101>hadlb101</a>,Bump Hadley,St.Louis Browns,ORLS,1,1,2,3,1935,1935,0,No,0,1.5,0.0,-1.5,70,0,-70,94,0,-94,691.0,0.0,-691.0,0.0,0.0,0.0
<a href=/player/hadlb101>hadlb101</a>,Bump Hadley,Washington Senators,TWINS,1,2,2,4,1936,1939,3,No,0,4.55,1.79,-2.76,355,337,-18,541,641,100,2260.0,1980.0,-280.0,0.0,0.0,0.0
<a href=/player/hadlk101>hadlk101</a>,Kent Hadley,Detroit Tigers,TIGRS,4,12,12,24,1957,1964,7,No,0,6.47,14.38,7.91,1197,947,-250,3186,1303,-1883,1459.0,3692.0,2233.0,20000.0,0.0,-20000.0
<a href=/player/hadlk101>hadlk101</a>,Kent Hadley,Kansas City Athletics,ATLTCS,23,46,43,89,1959,1976,17,No,0,99.11,44.56,-54.55,8270,5153,-3117,21179,15408,-5771,8728.0,3756.0,-4972.0,440600.0,0.0,-440600.0
<a href=/player/haefm101>haefm101</a>,Mickey Haefner,Minneapolis,Minneapolis,1,1,2,3,1943,1943,0,No,0,16.6,0.0,-16.6,431,0,-431,473,0,-473,3875.0,0.0,-3875.0,0.0,0.0,0.0
<a href=/player/haefm101>haefm101</a>,Mickey Haefner,Boston Braves,BRAVES,1,3,1,4,1950,1955,5,No,0,0.0,4.71,4.71,0,200,200,0,221,221,0.0,1757.0,1757.0,0.0,0.0,0.0
<a href=/player/hafeb101>hafeb101</a>,Bud Hafey,Chicago White Sox,WSOX,2,2,2,4,1935,1947,12,No,0,-0.37,31.03,31.4,97,563,466,329,753,424,0.0,5864.0,5864.0,2400.0,0.0,-2400.0
<a href=/player/hafeb101>hafeb101</a>,Bud Hafey,Pittsburgh Pirates,PIRATS,4,7,4,11,1937,1946,9,No,0,3.24,18.29,15.05,164,1051,887,641,3703,3062,0.0,666.0,666.0,0.0,0.0,0.0
<a href=/player/hafeb101>hafeb101</a>,Bud Hafey,Pittsburgh Pirates,PIRATS,1,1,3,4,1939,1948,9,No,0,-0.1,0.0,0.1,6,0,-6,14,0,-14,0.0,0.0,0.0,0.0,0.0,0.0
<a href=/player/hafec101>hafec101</a>,Chick Hafey,St. Louis Cardinals,CARDS,1,1,3,4,1932,1932,0,No,0,9.46,-0.61,-10.07,471,32,-439,1837,78,-1759,0.0,9.0,9.0,0.0,0.0,0.0
<a href=/player/hafnt001>hafnt001</a>,Travis Hafner,Texas Rangers,RNGRS,3,7,7,14,2002,2007,5,No,0,52.47,11.45,-41.02,2261,315,-1946,8496,371,-8125,1660.0,2044.0,384.0,0.0,0.0,0.0
<a href=/player/hagan001>hagan001</a>,Nick Hagadone,Boston Red Sox,RSOX,2,4,3,7,2009,2017,8,No,2,7.47,5.01,-2.46,325,200,-125,19,777,758,3215.0,255.0,-2960.0,415500.0,0.0,-415500.0
<a href=/player/haggs001>haggs001</a>,Sam Haggerty,Cleveland Indians,INDINS,1,2,1,3,2019,2019,0,No,0,-0.48,-0.04,0.44,31,61,30,11,174,163,92.0,6.0,-86.0,0.0,0.0,0.0
<a href=/player/haguj101>haguj101</a>,Joe Hague,St. Louis Cardinals,CARDS,11,16,17,33,1972,1978,6,No,0,44.3,11.43,-32.87,2021,766,-1255,6191,2476,-3715,2099.0,259.0,-1840.0,96000.0,0.0,-96000.0
<a href=/player/hahnd102>hahnd102</a>,Don Hahn,Montreal Expos,NATEX,2,2,3,5,1971,1971,0,No,0,-1.24,1.84,3.08,470,106,-364,1252,285,-967,0.0,0.0,0.0,0.0,0.0,0.0
<a href=/player/hahnd102>hahnd102</a>,Don Hahn,New York Mets,METS,6,9,10,19,1974,1984,10,No,0,10.05,22.43,12.38,1462,1185,-277,1334,4141,2807,2280.0,196.0,-2084.0,90000.0,0.0,-90000.0
<a href=/player/hahnj001>hahnj001</a>,Jesse Hahn,Tampa Bay Devil Rays,RAYS,6,8,11,19,2014,2020,6,Yes,0,-0.42,14.29,14.71,628,826,198,687,1868,1181,884.0,1581.0,697.0,2158000.0,0.0,-2158000.0
<a href=/player/hahnj001>hahnj001</a>,Jesse Hahn,San Diego Padres,PADRS,2,3,4,7,2014,2019,5,Yes,0,-0.29,3.01,3.3,62,274,212,4,1017,1013,698.0,16.0,-682.0,2925000.0,0.0,-2925000.0
<a href=/player/hahnj001>hahnj001</a>,Jesse Hahn,Oakland Athletics,ATLTCS,1,2,3,5,2018,2019,1,No,0,0.62,1.28,0.66,62,124,62,5,0,-5,390.0,254.0,-136.0,0.0,0.0,0.0
<a href=/player/haidh101>haidh101</a>,Hal Haid,Boston Braves,BRAVES,4,6,5,11,1931,1938,7,No,0,5.87,8.49,2.62,599,1115,516,2168,4417,2249,0.0,0.0,0.0,0.0,0.0,0.0
<a href=/player/haidh101>haidh101</a>,Hal Haid,Chicago White Sox,WSOX,1,2,1,3,1933,1933,0,No,0,0.0,0.0,0.0,0,0,0,0,0,0,0.0,0.0,0.0,4500.0,0.0,-4500.0
<a href=/player/haidh101>haidh101</a>,Hal Haid,St.Louis Browns,ORLS,2,7,2,9,1921,1921,0,No,0,0.0,0.0,0.0,0,0,0,0,0,0,0.0,0.0,0.0,6600.0,0.0,-6600.0
<a href=/player/hairj002>hairj002</a>,Jerry Hairston,Baltimore Orioles,ORLS,1,3,2,5,2005,2005,0,No,0,4.2,-1.01,-5.21,574,102,-472,1675,424,-1251,0.0,0.0,0.0,0.0,0.0,0.0
<a href=/player/hairj002>hairj002</a>,Jerry Hairston,Chicago Cubs,CUBS,2,3,3,6,2006,2006,0,No,0,-0.33,0.09,0.42,152,67,-85,338,197,-141,0.0,0.0,0.0,2300000.0,0.0,-2300000.0
<a href=/player/hairj002>hairj002</a>,Jerry Hairston,Cincinnati Reds,REDS,1,1,1,2,2009,2009,0,No,0,0.6,0.0,-0.6,45,0,-45,93,0,-93,0.0,0.0,0.0,2000000.0,0.0,-2000000.0
<a href=/player/hairj002>hairj002</a>,Jerry Hairston,Washington Nationals,NATEX,1,1,1,2,2011,2011,0,No,0,0.99,0.0,-0.99,45,0,-45,138,0,-138,0.0,0.0,0.0,2000000.0,0.0,-2000000.0
<a href=/player/hairs001>hairs001</a>,Scott Hairston,Arizona Diamondbacks,DBACKS,1,1,1,2,2007,2010,3,No,0,6.82,-0.04,-6.86,303,151,-152,1009,5,-1004,0.0,275.0,275.0,389000.0,0.0,-389000.0
<a href=/player/hairs001>hairs001</a>,Scott Hairston,San Diego Padres,PADRS,8,20,16,36,2009,2021,12,Yes,0,21.56,18.07,-3.49,1943,1571,-372,3964,4257,293,2638.0,702.0,-1936.0,11240300.0,0.0,-11240300.0
<a href=/player/hairs001>hairs001</a>,Scott Hairston,Oakland Athletics,ATLTCS,1,2,2,4,2010,2016,6,No,0,1.29,5.52,4.23,209,624,415,584,2066,1482,0.0,0.0,0.0,0.0,0.0,0.0
<a href=/player/hairs001>hairs001</a>,Scott Hairston,Chicago Cubs,CUBS,2,4,4,8,2013,2015,2,No,0,-0.95,0.17,1.12,94,21,-73,149,23,-126,0.0,175.0,175.0,0.0,0.0,0.0
<a href=/player/hajed001>hajed001</a>,Dave Hajek,Detroit Tigers,TIGRS,1,1,1,2,1997,1997,0,No,0,0.0,0.0,0.0,0,0,0,0,0,0,0.0,0.0,0.0,0.0,0.0,0.0
<a href=/player/halaj001>halaj001</a>,John Halama,Houston Astros,ASTROS,2,4,3,7,1998,1998,0,No,2,33.49,3.98,-29.51,809,22,-787,1941,35,-1906,4960.0,253.0,-4707.0,170000.0,0.0,-170000.0
<a href=/player/halec001>halec001</a>,Chip Hale,Anaheim Angels,ANGELS,1,1,1,2,1998,1998,0,No,0,0.0,0.19,0.19,0,77,77,0,162,162,0.0,0.0,0.0,0.0,0.0,0.0
<a href=/player/haled001>haled001</a>,David Hale,Atlanta Braves,BRAVES,5,11,10,21,2015,2017,2,Yes,0,22.57,1.32,-21.25,930,130,-800,2591,403,-2188,1128.0,339.0,-789.0,16307500.0,0.0,-16307500.0
<a href=/player/haled001>haled001</a>,David Hale,New York Yankees,YANKS,1,1,1,2,2020,2020,0,Yes,0,0.07,0.0,-0.07,39,0,-39,0,0,0,113.0,0.0,-113.0,0.0,0.0,0.0
<a href=/player/halej001>halej001</a>,Justin Haley,San Diego Padres,PADRS,1,1,1,2,2016,2021,5,No,0,-0.14,-0.81,-0.67,11,142,131,0,8,8,54.0,326.0,272.0,0.0,0.0,0.0
<a href=/player/halej101>halej101</a>,John Hale,Cincinnati Reds,REDS,1,2,2,4,1981,1981,0,No,0,0.0,0.0,0.0,0,0,0,0,0,0,0.0,0.0,0.0,0.0,0.0,0.0
<a href=/player/haleo101>haleo101</a>,Odell Hale,Cleveland Indians,INDINS,2,4,5,9,1940,1945,5,No,0,20.77,6.72,-14.05,691,626,-65,1095,1460,365,4952.0,2948.0,-2004.0,22322.0,0.0,-22322.0
<a href=/player/haler101>haler101</a>,Raymond Haley,Boston Red Sox,RSOX,1,1,1,2,1916,1916,0,No,0,1.11,0.01,-1.1,75,14,-61,221,23,-198,0.0,0.0,0.0,0.0,0.0,0.0
<a href=/player/hales101>hales101</a>,Sammy Hale,Detroit Tigers,TIGRS,1,9,2,11,1921,1941,20,No,0,0.0,3.03,3.03,0,202,202,0,144,144,0.0,1168.0,1168.0,3000.0,0.0,-3000.0
<a href=/player/hales101>hales101</a>,Sammy Hale,Philadelphia Athletics,ATLTCS,1,2,1,3,1929,1930,1,No,0,-0.04,-0.56,-0.52,62,45,-17,204,116,-88,0.0,0.0,0.0,6000.0,0.0,-6000.0
<a href=/player/hales101>hales101</a>,Sammy Hale,Portland,Portland,1,1,2,3,1922,1922,0,No,0,12.5,0.0,-12.5,736,0,-736,2864,0,-2864,0.0,0.0,0.0,0.0,0.0,0.0
<a href=/player/hallb001>hallb001</a>,Bill Hall,Milwaukee Brewers,BREWRS,1,1,1,2,2009,2009,0,No,0,-0.06,0.0,0.06,34,0,-34,131,0,-131,0.0,0.0,0.0,6925000.0,0.0,-6925000.0
<a href=/player/hallb001>hallb001</a>,Bill Hall,Seattle Mariners,MARNRS,1,2,1,3,2010,2010,0,No,0,1.78,-0.77,-2.55,120,125,5,382,457,75,3.0,0.0,-3.0,0.0,0.0,0.0
<a href=/player/hallb101>hallb101</a>,Bill Hallman,Philadelphia Phillies,PHILS,2,8,4,12,1897,1902,5,No,0,7.8,14.46,6.66,959,936,-23,3811,3203,-608,1192.0,3296.0,2104.0,0.0,0.0,0.0
<a href=/player/hallb101>hallb101</a>,Bill Hallman,St. Louis Cardinals,CARDS,1,1,2,3,1897,1897,0,No,0,0.58,0.0,-0.58,134,0,-134,554,0,-554,0.0,0.0,0.0,0.0,0.0,0.0
<a href=/player/hallb103>hallb103</a>,Bob Hall,Seattle,Seattle,1,1,3,4,1948,1948,0,No,0,-0.21,0.0,0.21,104,0,-104,35,0,-35,376.0,0.0,-376.0,0.0,0.0,0.0
<a href=/player/hallc001>hallc001</a>,Cody Hall,San Francisco Giants,GIANTS,1,1,1,2,2016,2016,0,No,0,0.0,0.0,0.0,0,0,0,0,0,0,0.0,0.0,0.0,0.0,0.0,0.0
<a href=/player/hallc103>hallc103</a>,Charley Hall,StPaul,StPaul,1,2,3,5,1909,1910,1,No,0,12.24,0.0,-12.24,441,0,-441,478,0,-478,3240.0,0.0,-3240.0,0.0,0.0,0.0
<a href=/player/hallc103>hallc103</a>,Charley Hall,St. Louis Cardinals,CARDS,1,2,1,3,1916,1916,0,No,0,0.0,0.0,0.0,0,0,0,0,0,0,0.0,0.0,0.0,3700.0,0.0,-3700.0
<a href=/player/halld001>halld001</a>,Drew Hall,Chicago Cubs,CUBS,6,8,15,23,1988,1995,7,No,0,50.51,3.13,-47.38,2529,1449,-1080,6791,543,-6248,2650.0,3110.0,460.0,1193000.0,0.0,-1193000.0
<a href=/player/halld001>halld001</a>,Drew Hall,Texas Rangers,RNGRS,1,1,1,2,1990,1994,4,No,0,-0.89,3.93,4.82,84,410,326,5,1191,1186,175.0,0.0,-175.0,0.0,0.0,0.0
<a href=/player/halld002>halld002</a>,Darren Hall,Los Angeles Dodgers,DOGRS,1,1,1,2,1999,1999,0,No,0,0.0,0.0,0.0,0,0,0,0,0,0,0.0,0.0,0.0,0.0,0.0,0.0
<a href=/player/halld101>halld101</a>,Dick Hall,Pittsburgh Pirates,PIRATS,1,3,1,4,1959,1961,2,No,0,-1.03,1.61,2.64,207,144,-63,561,494,-67,547.0,0.0,-547.0,0.0,0.0,0.0
<a href=/player/halld101>halld101</a>,Dick Hall,Kansas City Athletics,ATLTCS,2,3,3,6,1961,1963,2,No,0,10.64,-2.14,-12.78,963,354,-609,748,642,-106,2603.0,934.0,-1669.0,0.0,0.0,0.0
<a href=/player/halld101>halld101</a>,Dick Hall,Baltimore Orioles,ORLS,1,1,1,2,1966,1968,2,No,0,1.58,0.06,-1.52,160,38,-122,20,6,-14,396.0,95.0,-301.0,21750.0,0.0,-21750.0
<a href=/player/hallj001>hallj001</a>,Joe Hall,St. Louis Cardinals,CARDS,1,1,1,2,1991,1991,0,No,0,0.3,0.0,-0.3,17,0,-17,31,0,-31,0.0,0.0,0.0,0.0,0.0,0.0
<a href=/player/hallj105>hallj105</a>,Jack Hallett,Chicago White Sox,WSOX,1,2,1,3,1941,1946,5,No,0,0.52,12.57,12.05,116,628,512,494,2724,2230,0.0,0.0,0.0,13900.0,0.0,-13900.0
<a href=/player/hallj105>hallj105</a>,Jack Hallett,Toronto,Toronto,1,2,1,3,1942,1942,0,No,0,4.35,0.0,-4.35,338,0,-338,630,0,-630,555.0,0.0,-555.0,0.0,0.0,0.0
<a href=/player/hallj107>hallj107</a>,Jimmie Hall,Minnesota Twins,TWINS,3,8,6,14,1966,1971,5,No,0,25.4,14.58,-10.82,1429,584,-845,4690,560,-4130,873.0,2844.0,1971.0,153000.0,0.0,-153000.0
<a href=/player/hallj107>hallj107</a>,Jimmie Hall,California Angels,ANGELS,2,2,2,4,1968,1969,1,No,0,0.23,2.91,2.68,233,163,-70,437,499,62,0.0,0.0,0.0,0.0,0.0,0.0
<a href=/player/hallj107>hallj107</a>,Jimmie Hall,New York Yankees,YANKS,2,3,4,7,1969,1979,10,No,0,0.0,-0.25,-0.25,88,212,124,189,457,268,0.0,0.0,0.0,0.0,0.0,0.0
<a href=/player/hallm001>hallm001</a>,Mel Hall,Chicago Cubs,CUBS,4,14,9,23,1984,1991,7,No,0,18.76,21.66,2.9,1968,1112,-856,6227,902,-5325,1933.0,5322.0,3389.0,1746666.0,0.0,-1746666.0
<a href=/player/hallm001>hallm001</a>,Mel Hall,Cleveland Indians,INDINS,5,6,11,17,1989,1996,7,No,0,15.75,7.61,-8.14,1320,715,-605,4279,2175,-2104,1452.0,1275.0,-177.0,3575000.0,0.0,-3575000.0
<a href=/player/hallm002>hallm002</a>,Matt Hall,Detroit Tigers,TIGRS,1,1,1,2,2020,2020,0,Yes,0,-0.9,0.0,0.9,4,0,-4,0,0,0,26.0,0.0,-26.0,0.0,0.0,0.0
<a href=/player/hallr001>hallr001</a>,Roy Halladay,Toronto Blue Jays,BJAYS,5,9,9,18,2009,2019,10,No,0,34.02,12.11,-21.91,1451,870,-581,4210,2357,-1853,4262.0,2990.0,-1272.0,14250000.0,0.0,-14250000.0
<a href=/player/hallt001>hallt001</a>,Toby Hall,Tampa Bay Devil Rays,RAYS,1,3,3,6,2006,2012,6,No,0,-0.07,1.99,2.06,130,586,456,113,1881,1768,593.0,426.0,-167.0,4200000.0,0.0,-4200000.0
<a href=/player/hallt101>hallt101</a>,Tom Hall,Minnesota Twins,TWINS,2,2,3,5,1971,1977,6,No,0,-0.72,16.38,17.1,353,788,435,69,2774,2705,1022.0,269.0,-753.0,58500.0,0.0,-58500.0
<a href=/player/hallt101>hallt101</a>,Tom Hall,Cincinnati Reds,REDS,1,1,1,2,1975,1977,2,No,0,-0.88,0.0,0.88,79,0,-79,6,0,-6,196.0,0.0,-196.0,0.0,0.0,0.0
<a href=/player/hallt101>hallt101</a>,Tom Hall,New York Mets,METS,1,1,2,3,1976,1976,0,No,0,-0.55,0.0,0.55,39,0,-39,0,0,0,114.0,0.0,-114.0,0.0,0.0,0.0
<a href=/player/hallt102>hallt102</a>,Tom Haller,San Francisco Giants,GIANTS,3,4,4,8,1968,1971,3,No,0,22.81,9.1,-13.71,984,429,-555,3778,1737,-2041,0.0,0.0,0.0,16000.0,0.0,-16000.0
<a href=/player/hallt102>hallt102</a>,Tom Haller,Los Angeles Dodgers,DOGRS,1,1,2,3,1971,1972,1,No,0,0.18,0.0,-0.18,59,0,-59,139,0,-139,0.0,0.0,0.0,55000.0,0.0,-55000.0
<a href=/player/halsb001>halsb001</a>,Brad Halsey,New York Yankees,YANKS,7,16,12,28,2005,2014,9,Yes,2,13.28,19.25,5.97,1549,974,-575,2912,2867,-45,5079.0,1808.0,-3271.0,1556425.0,0.0,-1556425.0
<a href=/player/halsb001>halsb001</a>,Brad Halsey,Arizona Diamondbacks,DBACKS,2,2,3,5,2006,2018,12,No,2,0.44,6.63,6.19,54,856,802,0,2134,2134,283.0,622.0,339.0,0.0,0.0,0.0
<a href=/player/halts001>halts001</a>,Shane Halter,Kansas City Royals,ROYALS,1,1,1,2,1999,1999,0,No,0,0.0,0.0,0.0,7,0,-7,0,0,0,0.0,0.0,0.0,0.0,0.0,0.0
<a href=/player/hambm001>hambm001</a>,Mark Hamburger,Minnesota Twins,TWINS,1,1,1,2,2008,2008,0,No,0,0.04,-0.22,-0.26,5,9,4,0,0,0,24.0,21.0,-3.0,0.0,0.0,0.0
<a href=/player/hamec001>hamec001</a>,Cole Hamels,Philadelphia Phillies,PHILS,3,8,8,16,2015,2021,6,Yes,0,15.67,15.69,0.02,537,994,457,893,2918,2025,2310.0,1839.0,-471.0,535500.0,0.0,-535500.0
<a href=/player/hamec001>hamec001</a>,Cole Hamels,Texas Rangers,RNGRS,3,7,11,18,2018,2021,3,Yes,0,5.6,-0.52,-6.12,74,38,-36,71,0,-71,654.0,134.0,-520.0,1050000.0,0.0,-1050000.0
<a href=/player/hamib001>hamib001</a>,Billy Hamilton,San Francisco Giants,GIANTS,1,1,1,2,2020,2020,0,Yes,0,-0.14,0.0,0.14,17,0,-17,25,0,-25,0.0,0.0,0.0,0.0,0.0,0.0
<a href=/player/hamib101>hamib101</a>,Billy Hamilton,Philadelphia Phillies,PHILS,1,1,1,2,1895,1895,0,No,0,23.74,0.0,-23.74,690,0,-690,3208,0,-3208,0.0,0.0,0.0,0.0,0.0,0.0
<a href=/player/hamid001>hamid001</a>,Darryl Hamilton,San Francisco Giants,GIANTS,2,4,3,7,1998,2008,10,No,2,0.87,9.81,8.94,148,766,618,604,1616,1012,12.0,1082.0,1070.0,2750000.0,0.0,-2750000.0
<a href=/player/hamid001>hamid001</a>,Darryl Hamilton,Colorado Rockies,ROCKS,2,3,4,7,1999,2000,1,No,0,0.73,-0.11,-0.84,211,33,-178,561,29,-532,40.0,37.0,-3.0,4663333.0,0.0,-4663333.0
<a href=/player/hamid101>hamid101</a>,Dave Hamilton,Oakland Athletics,ATLTCS,4,6,5,11,1975,1987,12,No,1,27.96,4.15,-23.81,1459,277,-1182,3568,237,-3331,2461.0,2375.0,-86.0,425000.0,0.0,-425000.0
<a href=/player/hamid101>hamid101</a>,Dave Hamilton,Chicago White Sox,WSOX,1,3,1,4,1977,1978,1,No,0,1.03,-0.14,-1.17,221,8,-213,205,0,-205,1727.0,34.0,-1693.0,0.0,0.0,0.0
<a href=/player/hamij002>hamij002</a>,Joey Hamilton,San Diego Padres,PADRS,3,3,6,9,1998,2002,4,No,0,12.29,7.38,-4.91,248,543,295,226,597,371,2558.0,2031.0,-527.0,8333333.0,0.0,-8333333.0
<a href=/player/hamij003>hamij003</a>,Josh Hamilton,Cincinnati Reds,REDS,3,6,5,11,2007,2020,13,No,0,31.75,18.42,-13.33,1579,739,-840,5592,559,-5033,1389.0,4964.0,3575.0,9855000.0,0.0,-9855000.0
<a href=/player/hamij003>hamij003</a>,Josh Hamilton,Anaheim Angels,ANGELS,1,2,1,3,2015,2015,0,No,0,0.46,0.0,-0.46,50,0,-50,182,0,-182,0.0,0.0,0.0,0.0,0.0,0.0
<a href=/player/hamij101>hamij101</a>,Jack Hamilton,Philadelphia Phillies,PHILS,5,10,12,22,1963,1979,16,No,0,31.38,66.18,34.8,2079,2296,217,6720,6242,-478,3363.0,10159.0,6796.0,74500.0,0.0,-74500.0
<a href=/player/hamij101>hamij101</a>,Jack Hamilton,New York Mets,METS,1,1,1,2,1967,1967,0,No,0,0.87,-0.32,-1.19,94,8,-86,47,2,-45,472.0,25.0,-447.0,14000.0,0.0,-14000.0
<a href=/player/hamij101>hamij101</a>,Jack Hamilton,California Angels,ANGELS,4,4,5,9,1968,1973,5,No,0,0.94,3.23,2.29,351,552,201,802,424,-378,491.0,1282.0,791.0,0.0,0.0,0.0
<a href=/player/hamij101>hamij101</a>,Jack Hamilton,Cleveland Indians,INDINS,1,1,1,2,1969,1969,0,No,0,-1.06,0.0,1.06,16,0,-16,0,0,0,37.0,0.0,-37.0,19000.0,0.0,-19000.0
<a href=/player/hamis101>hamis101</a>,Steve Hamilton,Cleveland Indians,INDINS,1,2,1,3,1962,1962,0,No,0,3.15,-0.76,-3.91,294,75,-219,163,225,62,1590.0,0.0,-1590.0,0.0,0.0,0.0
<a href=/player/hamis101>hamis101</a>,Steve Hamilton,Washington Senators,RNGRS,2,2,2,4,1963,1966,3,No,0,9.24,1.33,-7.91,642,449,-193,98,1511,1413,1507.0,133.0,-1374.0,0.0,0.0,0.0
<a href=/player/hamis101>hamis101</a>,Steve Hamilton,Chicago White Sox,WSOX,4,6,5,11,1971,1979,8,No,0,21.77,19.92,-1.85,843,603,-240,1640,2128,488,4181.0,189.0,-3992.0,258750.0,0.0,-258750.0
<a href=/player/hamit101>hamit101</a>,Tom Hamilton,Philadelphia Athletics,ATLTCS,46,109,116,225,1953,1976,23,No,0,189.08,109.39,-79.69,16486,13560,-2926,40867,38903,-1964,20759.0,16429.0,-4330.0,546100.0,0.0,-546100.0
<a href=/player/hamlk101>hamlk101</a>,Ken Hamlin,Pittsburgh Pirates,PIRATS,1,3,1,4,1959,1961,2,No,0,-1.03,1.61,2.64,207,144,-63,561,494,-67,547.0,0.0,-547.0,0.0,0.0,0.0
<a href=/player/hamlk101>hamlk101</a>,Ken Hamlin,Washington Senators,RNGRS,1,1,1,2,1960,1962,2,No,0,-0.15,-1.16,-1.01,42,118,76,105,393,288,0.0,0.0,0.0,0.0,0.0,0.0
<a href=/player/hamlk101>hamlk101</a>,Ken Hamlin,Los Angeles Angels,ANGELS,5,8,7,15,1961,1968,7,No,0,-0.68,8.55,9.23,319,809,490,434,2503,2069,443.0,1270.0,827.0,44000.0,0.0,-44000.0
<a href=/player/hamll101>hamll101</a>,Luke Hamlin,Brooklyn Dodgers,DOGRS,1,4,1,5,1941,1948,7,No,0,4.25,10.42,6.17,798,406,-392,2943,1540,-1403,336.0,0.0,-336.0,0.0,0.0,0.0
<a href=/player/hamll101>hamll101</a>,Luke Hamlin,Pittsburgh Pirates,PIRATS,1,1,1,2,1943,1943,0,No,0,1.16,0.0,-1.16,58,0,-58,69,0,-69,570.0,0.0,-570.0,0.0,0.0,0.0
<a href=/player/hamll101>hamll101</a>,Luke Hamlin,Philadelphia Athletics,ATLTCS,39,85,81,166,1944,1976,32,No,0,92.78,71.7,-21.08,10628,9764,-864,25815,30019,4204,12609.0,8252.0,-4357.0,507800.0,0.0,-507800.0
<a href=/player/hamma001>hamma001</a>,Atlee Hammaker,Kansas City Royals,ROYALS,3,7,5,12,1982,1990,8,No,0,15.6,24.69,9.09,1105,393,-712,1343,512,-831,5715.0,4650.0,-1065.0,1318000.0,0.0,-1318000.0
<a href=/player/hammc001>hammc001</a>,Chris Hammond,Cincinnati Reds,REDS,8,10,13,23,1993,2013,20,No,0,5.83,28.57,22.74,788,1780,992,1301,3221,1920,2189.0,5879.0,3690.0,600000.0,0.0,-600000.0
<a href=/player/hammc001>hammc001</a>,Chris Hammond,New York Yankees,YANKS,3,5,4,9,2003,2006,3,No,0,3.3,1.29,-2.01,348,72,-276,33,112,79,842.0,426.0,-416.0,5800000.0,0.0,-5800000.0
<a href=/player/hammj001>hammj001</a>,Jeffrey Hammonds,Baltimore Orioles,ORLS,1,1,1,2,1998,1998,0,No,0,2.64,-0.02,-2.66,149,24,-125,396,53,-343,0.0,0.0,0.0,1333333.0,0.0,-1333333.0
<a href=/player/hammj001>hammj001</a>,Jeffrey Hammonds,Cincinnati Reds,REDS,3,4,6,10,1999,2006,7,No,0,1.74,1.96,0.22,719,376,-343,1050,622,-428,650.0,1259.0,609.0,10318333.0,0.0,-10318333.0
<a href=/player/hammj002>hammj002</a>,Jason Hammel,Tampa Bay Devil Rays,RAYS,1,1,1,2,2009,2010,1,No,0,3.79,0.0,-3.79,189,0,-189,184,0,-184,1574.0,0.0,-1574.0,0.0,0.0,0.0
<a href=/player/hammj002>hammj002</a>,Jason Hammel,Colorado Rockies,ROCKS,2,3,2,5,2012,2012,0,No,0,6.7,-1.0,-7.7,199,47,-152,28,33,5,2842.0,306.0,-2536.0,8200000.0,0.0,-8200000.0
<a href=/player/hammj002>hammj002</a>,Jason Hammel,Chicago Cubs,CUBS,3,8,6,14,2014,2019,5,No,0,16.29,18.03,1.74,803,963,160,2607,3455,848,941.0,121.0,-820.0,0.0,0.0,0.0
<a href=/player/hammj003>hammj003</a>,JD Hammer,Colorado Rockies,ROCKS,1,3,1,4,2017,2017,0,No,0,0.33,0.69,0.36,79,53,-26,2,0,-2,117.0,66.0,-51.0,0.0,0.0,0.0
<a href=/player/hammr001>hammr001</a>,Robby Hammock,Colorado Rockies,ROCKS,1,1,1,2,2010,2010,0,No,0,0.0,0.0,0.0,0,0,0,0,0,0,0.0,0.0,0.0,0.0,0.0,0.0
<a href=/player/hamng102>hamng102</a>,Granny Hamner,Philadelphia Phillies,PHILS,1,1,1,2,1959,1959,0,No,0,-0.35,1.07,1.42,27,62,35,69,17,-52,0.0,219.0,219.0,0.0,0.0,0.0
<a href=/player/hampi101>hampi101</a>,Ike Hampton,New York Mets,METS,1,1,1,2,1975,1976,1,No,0,0.39,1.5,1.11,109,122,13,147,4,-143,0.0,270.0,270.0,0.0,0.0,0.0
<a href=/player/hampm001>hampm001</a>,Mike Hampton,Seattle Mariners,MARNRS,1,2,1,3,1993,1994,1,No,0,17.17,-0.83,-18.0,486,79,-407,529,288,-241,3414.0,0.0,-3414.0,959000.0,0.0,-959000.0
<a href=/player/hampm001>hampm001</a>,Mike Hampton,Houston Astros,ASTROS,5,10,10,20,1999,2011,12,No,2,8.59,16.0,7.41,484,2055,1571,1331,4586,3255,1469.0,1829.0,360.0,15440000.0,0.0,-15440000.0
<a href=/player/hampm001>hampm001</a>,Mike Hampton,Colorado Rockies,ROCKS,4,7,10,17,2002,2007,5,No,0,7.86,3.55,-4.31,711,790,79,2863,2114,-749,329.0,1166.0,837.0,25103543.0,0.0,-25103543.0
<a href=/player/hampm001>hampm001</a>,Mike Hampton,Florida Marlins,MARLNS,1,2,2,4,2002,2005,3,No,0,5.9,0.15,-5.75,176,66,-110,203,3,-200,1529.0,126.0,-1403.0,0.0,0.0,0.0
<a href=/player/hamut001>hamut001</a>,Tim Hamulack,New York Mets,METS,1,2,2,4,2006,2009,3,No,0,-1.08,1.54,2.62,102,224,122,21,3,-18,303.0,341.0,38.0,0.0,0.0,0.0
<a href=/player/hancg001>hancg001</a>,Garry Hancock,Cleveland Indians,INDINS,1,1,1,2,1977,1977,0,No,0,-1.51,0.0,1.51,121,0,-121,268,0,-268,0.0,0.0,0.0,0.0,0.0,0.0
<a href=/player/hancg001>hancg001</a>,Garry Hancock,Boston Red Sox,RSOX,1,3,2,5,1982,1986,4,No,0,26.9,1.92,-24.98,1356,609,-747,5373,2373,-3000,4.0,0.0,-4.0,440000.0,0.0,-440000.0
<a href=/player/hancj001>hancj001</a>,Josh Hancock,Boston Red Sox,RSOX,1,1,1,2,2002,2003,1,No,0,-0.22,-0.27,-0.05,12,50,38,2,156,154,36.0,0.0,-36.0,0.0,0.0,0.0
<a href=/player/hancj001>hancj001</a>,Josh Hancock,Philadelphia Phillies,PHILS,1,2,2,4,2004,2004,0,No,0,0.46,-0.03,-0.49,65,53,-12,87,1,-86,206.0,76.0,-130.0,0.0,0.0,0.0
<a href=/player/hancj002>hancj002</a>,Justin Hancock,San Diego Padres,PADRS,1,1,1,2,2017,2018,1,No,0,0.32,0.03,-0.29,20,161,141,2,298,296,37.0,0.0,-37.0,0.0,0.0,0.0
<a href=/player/hancl001>hancl001</a>,Lee Hancock,Seattle Mariners,MARNRS,1,1,1,2,1990,1990,0,No,0,-0.19,-0.11,0.08,48,5,-43,0,0,0,97.0,13.0,-84.0,0.0,0.0,0.0
<a href=/player/hancr001>hancr001</a>,Ryan Hancock,Anaheim Angels,ANGELS,1,3,1,4,1997,1997,0,No,0,-0.12,-0.13,-0.01,86,32,-54,233,144,-89,0.0,0.0,0.0,0.0,0.0,0.0
<a href=/player/handb001>handb001</a>,Brad Hand,San Diego Padres,PADRS,2,6,2,8,2018,2020,2,Yes,0,4.43,0.25,-4.18,334,116,-218,277,344,67,823.0,0.0,-823.0,0.0,0.0,0.0
<a href=/player/handb001>handb001</a>,Brad Hand,Washington Nationals,NATEX,1,1,1,2,2021,2021,0,Yes,0,-0.62,0.89,1.51,12,35,23,0,90,90,26.0,0.0,-26.0,10500000.0,0.0,-10500000.0
<a href=/player/handb101>handb101</a>,Bill Hands,San Francisco Giants,GIANTS,2,3,3,6,1965,1968,3,No,0,45.93,0.43,-45.5,1983,248,-1735,4122,39,-4083,6327.0,677.0,-5650.0,0.0,0.0,0.0
<a href=/player/handb101>handb101</a>,Bill Hands,Chicago Cubs,CUBS,2,5,2,7,1972,1976,4,No,0,12.2,0.19,-12.01,299,239,-60,0,36,36,2874.0,554.0,-2320.0,72500.0,0.0,-72500.0
<a href=/player/handb101>handb101</a>,Bill Hands,Texas Rangers,RNGRS,1,1,1,2,1976,1976,0,No,0,0.0,0.0,0.0,0,0,0,0,0,0,0.0,0.0,0.0,0.0,0.0,0.0
<a href=/player/handr101>handr101</a>,Rich Hand,Cleveland Indians,INDINS,6,11,10,21,1971,1978,7,No,0,26.06,8.28,-17.78,1542,586,-956,3690,1786,-1904,2427.0,1183.0,-1244.0,83000.0,0.0,-83000.0
<a href=/player/handr101>handr101</a>,Rich Hand,Texas Rangers,RNGRS,7,19,12,31,1973,1988,15,No,0,43.57,39.21,-4.36,2413,2544,131,8647,8625,-22,2773.0,4668.0,1895.0,457000.0,0.0,-457000.0
<a href=/player/handr101>handr101</a>,Rich Hand,California Angels,ANGELS,1,1,1,2,1974,1975,1,No,0,0.0,1.0,1.0,0,11,11,0,0,0,0.0,62.0,62.0,0.0,0.0,0.0
<a href=/player/hanec001>hanec001</a>,Chris Haney,Montreal Expos,NATEX,4,6,7,13,1992,1999,7,No,0,12.1,6.46,-5.64,755,737,-18,1155,1582,427,2451.0,419.0,-2032.0,1303000.0,0.0,-1303000.0
<a href=/player/hanef101>hanef101</a>,Fred Haney,Detroit Tigers,TIGRS,5,10,10,20,1925,1934,9,No,0,27.51,16.34,-11.17,1367,979,-388,4332,3617,-715,3712.0,0.0,-3712.0,19500.0,0.0,-19500.0
<a href=/player/hanef101>hanef101</a>,Fred Haney,Chicago Cubs,CUBS,1,2,1,3,1927,1927,0,No,0,0.0,0.14,0.14,0,13,13,0,31,31,0.0,0.0,0.0,0.0,0.0,0.0
<a href=/player/haneh101>haneh101</a>,Harry Hanebrink,Milwaukee Braves,BRAVES,2,4,4,8,1959,1964,5,No,0,9.25,-0.88,-10.13,355,69,-286,908,184,-724,1090.0,0.0,-1090.0,0.0,0.0,0.0
<a href=/player/hanel101>hanel101</a>,Larry Haney,Seattle Pilots,BREWRS,2,2,2,4,1969,1970,1,No,0,0.17,-1.21,-1.38,324,216,-108,569,831,262,0.0,0.0,0.0,13000.0,0.0,-13000.0
<a href=/player/hanet001>hanet001</a>,Todd Haney,Seattle Mariners,MARNRS,1,1,1,2,1991,1991,0,No,0,0.0,0.0,0.0,0,0,0,0,0,0,0.0,0.0,0.0,0.0,0.0,0.0
<a href=/player/hanhe001>hanhe001</a>,Eric Hanhold,Milwaukee Brewers,BREWRS,1,1,2,3,2017,2017,0,No,0,-0.06,0.43,0.49,6,38,32,0,149,149,7.0,0.0,-7.0,0.0,0.0,0.0
<a href=/player/hanim001>hanim001</a>,Mitch Haniger,Milwaukee Brewers,BREWRS,3,5,5,10,2014,2019,5,Yes,0,6.43,9.84,3.41,307,369,62,1146,703,-443,285.0,1843.0,1558.0,8837500.0,0.0,-8837500.0
<a href=/player/hanim001>hanim001</a>,Mitch Haniger,Arizona Diamondbacks,DBACKS,1,3,2,5,2016,2019,3,Yes,0,21.55,3.22,-18.33,745,61,-684,3265,58,-3207,14.0,514.0,500.0,2600000.0,0.0,-2600000.0
<a href=/player/hanir001>hanir001</a>,Ryan Hanigan,Cincinnati Reds,REDS,1,1,1,2,2013,2015,2,No,0,1.37,-0.83,-2.2,84,25,-59,263,19,-244,0.0,175.0,175.0,2050000.0,0.0,-2050000.0
<a href=/player/hanir001>hanir001</a>,Ryan Hanigan,Tampa Bay Devil Rays,RAYS,4,8,12,20,2014,2020,6,Yes,0,10.52,4.14,-6.38,1388,617,-771,4818,2218,-2600,195.0,136.0,-59.0,3254200.0,0.0,-3254200.0
<a href=/player/hanir001>hanir001</a>,Ryan Hanigan,San Diego Padres,PADRS,1,1,1,2,2014,2015,1,No,0,-0.09,-0.81,-0.72,89,83,-6,314,270,-44,0.0,0.0,0.0,0.0,0.0,0.0
<a href=/player/hanng101>hanng101</a>,Gerry Hannahs,Montreal Expos,NATEX,1,2,1,3,1978,1979,1,No,0,0.0,-1.34,-1.34,10,94,84,4,5,1,54.0,184.0,130.0,0.0,0.0,0.0
<a href=/player/hannj001>hannj001</a>,Jack Hannahan,Detroit Tigers,TIGRS,1,1,1,2,2007,2008,1,No,0,3.82,0.0,-3.82,236,0,-236,804,0,-804,0.0,0.0,0.0,0.0,0.0,0.0
<a href=/player/hannj001>hannj001</a>,Jack Hannahan,Oakland Athletics,ATLTCS,1,1,1,2,2009,2009,0,No,0,0.6,0.0,-0.6,51,0,-51,167,0,-167,0.0,0.0,0.0,410000.0,0.0,-410000.0
<a href=/player/hannj102>hannj102</a>,Jim Hannan,Washington Senators,RNGRS,6,10,11,21,1970,1976,6,No,0,30.0,-0.41,-30.41,2790,834,-1956,8622,1724,-6898,5481.0,1612.0,-3869.0,75900.0,0.0,-75900.0
<a href=/player/hannj102>hannj102</a>,Jim Hannan,Detroit Tigers,TIGRS,1,1,2,3,1971,1971,0,No,0,-0.75,0.0,0.75,42,0,-42,3,0,-3,97.0,0.0,-97.0,26500.0,0.0,-26500.0
<a href=/player/hannt101>hannt101</a>,Truck Hannah,New York Yankees,YANKS,3,12,4,16,1921,1928,7,No,0,-3.56,9.03,12.59,367,917,550,1242,3654,2412,159.0,0.0,-159.0,15750.0,0.0,-15750.0
<a href=/player/hanrj001>hanrj001</a>,Joel Hanrahan,Washington Nationals,NATEX,2,3,4,7,2009,2012,3,No,0,9.27,5.6,-3.67,881,663,-218,1403,793,-610,688.0,605.0,-83.0,872000.0,0.0,-872000.0
<a href=/player/hanrj001>hanrj001</a>,Joel Hanrahan,Pittsburgh Pirates,PIRATS,3,5,7,12,2012,2020,8,Yes,0,8.64,9.38,0.74,750,717,-33,2244,6,-2238,477.0,1130.0,653.0,4100000.0,0.0,-4100000.0
<a href=/player/hansa001>hansa001</a>,Alen Hanson,San Francisco Giants,GIANTS,1,3,1,4,2019,2019,0,No,0,-0.38,0.77,1.15,80,156,76,48,628,580,182.0,0.0,-182.0,0.0,0.0,0.0
<a href=/player/hansa101>hansa101</a>,Andy Hansen,Philadelphia Phillies,PHILS,5,10,8,18,1954,1968,14,No,0,28.54,39.33,10.79,1270,2132,862,1527,6127,4600,4802.0,3446.0,-1356.0,0.0,0.0,0.0
<a href=/player/hansc001>hansc001</a>,Craig Hansen,Boston Red Sox,RSOX,4,7,6,13,2008,2020,12,Yes,2,-3.37,12.23,15.6,269,548,279,630,858,228,190.0,1387.0,1197.0,24042923.0,0.0,-24042923.0
<a href=/player/hansd001>hansd001</a>,Dave Hansen,San Diego Padres,PADRS,1,4,3,7,2004,2004,0,No,0,0.63,-0.51,-1.14,139,46,-93,232,85,-147,39.0,43.0,4.0,0.0,0.0,0.0
<a href=/player/hansd001>hansd001</a>,Dave Hansen,Seattle Mariners,MARNRS,1,1,1,2,2004,2008,4,No,0,-0.59,0.86,1.45,29,25,-4,31,0,-31,0.0,84.0,84.0,750000.0,0.0,-750000.0
<a href=/player/hanse001>hanse001</a>,Erik Hanson,Seattle Mariners,MARNRS,2,3,3,6,1993,2005,12,No,0,5.9,13.17,7.27,829,1554,725,2754,4500,1746,566.0,1101.0,535.0,1250000.0,0.0,-1250000.0
<a href=/player/hansg001>hansg001</a>,Greg Hansell,Boston Red Sox,RSOX,1,3,1,4,1990,1991,1,No,0,0.0,0.54,0.54,0,52,52,0,179,179,0.0,0.0,0.0,0.0,0.0,0.0
<a href=/player/hansg001>hansg001</a>,Greg Hansell,New York Mets,METS,3,4,3,7,1990,1994,4,No,0,2.55,1.07,-1.48,331,342,11,618,888,270,1125.0,394.0,-731.0,4116666.0,0.0,-4116666.0
<a href=/player/hansg001>hansg001</a>,Greg Hansell,Los Angeles Dodgers,DOGRS,1,4,2,6,1995,1998,3,No,0,-0.49,1.39,1.88,829,429,-400,2713,30,-2683,618.0,819.0,201.0,218000.0,0.0,-218000.0
<a href=/player/hansg001>hansg001</a>,Greg Hansell,Oakland Athletics,ATLTCS,1,2,1,3,1998,1999,1,No,0,0.37,0.52,0.15,66,159,93,229,474,245,0.0,0.0,0.0,450000.0,0.0,-450000.0
<a href=/player/hansr102>hansr102</a>,Ron Hansen,Baltimore Orioles,ORLS,4,10,7,17,1963,1973,10,No,0,64.06,37.52,-26.54,3307,1677,-1630,9685,6745,-2940,2176.0,306.0,-1870.0,108500.0,0.0,-108500.0
<a href=/player/hansr102>hansr102</a>,Ron Hansen,Chicago White Sox,WSOX,4,7,7,14,1968,1971,3,No,0,11.44,1.3,-10.14,1683,516,-1167,5097,1341,-3756,666.0,366.0,-300.0,31000.0,0.0,-31000.0
<a href=/player/hansr102>hansr102</a>,Ron Hansen,Washington Senators,RNGRS,1,1,1,2,1968,1972,4,No,0,0.33,1.36,1.03,125,414,289,306,1147,841,0.0,0.0,0.0,33000.0,0.0,-33000.0
<a href=/player/hanss101>hanss101</a>,Snipe Hansen,Philadelphia Phillies,PHILS,2,2,4,6,1935,1938,3,No,0,0.0,-1.17,-1.17,0,336,336,0,1082,1082,0.0,256.0,256.0,0.0,0.0,0.0
<a href=/player/hanst001>hanst001</a>,Tommy Hanson,Atlanta Braves,BRAVES,4,7,7,14,2012,2021,9,Yes,0,5.79,12.35,6.56,251,1095,844,658,2525,1867,667.0,1556.0,889.0,7060000.0,0.0,-7060000.0
<a href=/player/happj001>happj001</a>,J.A. Happ,Philadelphia Phillies,PHILS,1,3,1,4,2010,2011,1,No,0,1.12,5.11,3.99,320,74,-246,775,83,-692,998.0,665.0,-333.0,470000.0,0.0,-470000.0
<a href=/player/happj001>happj001</a>,J.A. Happ,Houston Astros,ASTROS,4,10,10,20,2012,2019,7,No,0,17.22,11.07,-6.15,1238,246,-992,2359,341,-2018,4222.0,1816.0,-2406.0,8335000.0,0.0,-8335000.0
<a href=/player/happj001>happj001</a>,J.A. Happ,Toronto Blue Jays,BJAYS,1,1,1,2,2014,2016,2,No,0,0.7,1.3,0.6,22,149,127,2,594,592,326.0,0.0,-326.0,5200000.0,0.0,-5200000.0
<a href=/player/happj001>happj001</a>,J.A. Happ,Seattle Mariners,MARNRS,1,1,1,2,2015,2016,1,No,0,2.39,-0.02,-2.41,22,1,-21,25,0,-25,190.0,14.0,-176.0,6700000.0,0.0,-6700000.0
<a href=/player/happj001>happj001</a>,J.A. Happ,Toronto Blue Jays,BJAYS,1,1,2,3,2018,2020,2,No,0,4.31,-1.13,-5.44,53,271,218,4,932,928,823.0,0.0,-823.0,13000000.0,0.0,-13000000.0
<a href=/player/happj001>happj001</a>,J.A. Happ,Minnesota Twins,TWINS,1,2,2,4,2021,2021,0,Yes,0,0.27,-0.36,-0.63,21,16,-5,15,0,-15,162.0,101.0,-61.0,8000000.0,0.0,-8000000.0
<a href=/player/haraa001>haraa001</a>,Aaron Harang,Texas Rangers,RNGRS,2,3,3,6,2000,2005,5,No,0,0.93,1.27,0.34,41,153,112,59,334,275,326.0,195.0,-131.0,3150000.0,0.0,-3150000.0
<a href=/player/haraa001>haraa001</a>,Aaron Harang,Oakland Athletics,ATLTCS,1,3,1,4,2003,2003,0,No,0,14.51,0.2,-14.31,509,45,-464,479,186,-293,4166.0,0.0,-4166.0,0.0,0.0,0.0
<a href=/player/haraa001>haraa001</a>,Aaron Harang,Los Angeles Dodgers,DOGRS,1,2,1,3,2013,2013,0,No,0,0.0,0.19,0.19,0,17,17,0,55,55,0.0,0.0,0.0,0.0,0.0,0.0
<a href=/player/haraa001>haraa001</a>,Aaron Harang,Colorado Rockies,ROCKS,1,2,1,3,2013,2013,0,Yes,0,-0.94,0.0,0.94,24,0,-24,4,0,-4,361.0,0.0,-361.0,0.0,0.0,0.0
<a href=/player/hardc101>hardc101</a>,Carroll Hardy,Cleveland Indians,INDINS,1,2,2,4,1960,1960,0,No,0,-2.2,-1.2,1.0,772,87,-685,2350,176,-2174,0.0,122.0,122.0,0.0,0.0,0.0
<a href=/player/hardc101>hardc101</a>,Carroll Hardy,Boston Red Sox,RSOX,1,1,1,2,1962,1964,2,No,0,-0.97,0.32,1.29,61,140,79,215,229,14,0.0,0.0,0.0,0.0,0.0,0.0
<a href=/player/hardc101>hardc101</a>,Carroll Hardy,Houston Astros,ASTROS,1,1,1,2,1965,1965,0,No,0,0.23,0.0,-0.23,11,0,-11,9,0,-9,0.0,0.0,0.0,0.0,0.0,0.0
<a href=/player/hardj002>hardj002</a>,Jason Hardtke,Cleveland Indians,INDINS,4,5,4,9,1992,1994,2,No,0,0.28,1.85,1.57,412,216,-196,1134,642,-492,15.0,40.0,25.0,325000.0,0.0,-325000.0
<a href=/player/hardj003>hardj003</a>,J.J. Hardy,Milwaukee Brewers,BREWRS,4,7,8,15,2009,2020,11,Yes,0,1.27,27.3,26.03,554,1475,921,1607,5251,3644,1628.0,6.0,-1622.0,5734900.0,0.0,-5734900.0
<a href=/player/hardj003>hardj003</a>,J.J. Hardy,Minnesota Twins,TWINS,1,2,2,4,2010,2011,1,No,0,15.73,-0.62,-16.35,889,27,-862,3636,0,-3636,0.0,74.0,74.0,6550000.0,0.0,-6550000.0
<a href=/player/hardj101>hardj101</a>,Jim Hardin,Baltimore Orioles,ORLS,2,2,2,4,1971,1972,1,No,0,-0.56,0.0,0.56,24,0,-24,4,0,-4,85.0,0.0,-85.0,27000.0,0.0,-27000.0
<a href=/player/hardl101>hardl101</a>,Larry Hardy,San Diego Padres,PADRS,1,2,1,3,1975,1977,2,No,0,-0.91,4.82,5.73,30,191,161,2,745,743,65.0,0.0,-65.0,0.0,0.0,0.0
<a href=/player/hardr001>hardr001</a>,Rich Harden,Oakland Athletics,ATLTCS,12,17,20,37,2008,2021,13,Yes,0,30.54,32.16,1.62,1528,2032,504,3830,6153,2323,1492.0,2561.0,1069.0,13440000.0,0.0,-13440000.0
<a href=/player/hardr101>hardr101</a>,Red Hardy,New York Giants,GIANTS,1,2,1,3,1951,1951,0,No,0,0.0,0.0,0.0,0,13,13,0,13,13,0.0,0.0,0.0,0.0,0.0,0.0
<a href=/player/hared001>hared001</a>,Dan Haren,St. Louis Cardinals,CARDS,1,3,1,4,2004,2008,4,No,0,22.03,0.48,-21.55,848,107,-741,2102,105,-1997,2465.0,933.0,-1532.0,305000.0,0.0,-305000.0
<a href=/player/hared001>hared001</a>,Dan Haren,Oakland Athletics,ATLTCS,15,28,26,54,2007,2018,11,Yes,0,108.14,27.37,-80.77,6020,2116,-3904,18233,6199,-12034,5643.0,3558.0,-2085.0,32617500.0,0.0,-32617500.0
<a href=/player/hared001>hared001</a>,Dan Haren,Arizona Diamondbacks,DBACKS,4,7,13,20,2010,2018,8,Yes,0,13.03,15.69,2.66,400,914,514,450,1808,1358,3432.0,4474.0,1042.0,14741000.0,0.0,-14741000.0
<a href=/player/hared001>hared001</a>,Dan Haren,Los Angeles Dodgers,DOGRS,4,7,8,15,2014,2020,6,Yes,0,27.35,10.53,-16.82,1361,1127,-234,4322,2916,-1406,2273.0,350.0,-1923.0,21765000.0,0.0,-21765000.0
<a href=/player/hared001>hared001</a>,Dan Haren,Miami Marlins,MARLNS,1,2,2,4,2015,2016,1,Yes,0,0.17,0.0,-0.17,21,0,-21,23,0,-23,175.0,0.0,-175.0,10000000.0,0.0,-10000000.0
<a href=/player/harga001>harga001</a>,Alan Hargesheimer,San Francisco Giants,GIANTS,1,1,1,2,1982,1982,0,No,0,-0.12,0.0,0.12,10,0,-10,0,0,0,12.0,0.0,-12.0,0.0,0.0,0.0
<a href=/player/harga001>harga001</a>,Alan Hargesheimer,Chicago Cubs,CUBS,1,1,2,3,1984,1985,1,No,0,-0.09,-0.02,0.07,5,22,17,0,15,15,39.0,132.0,93.0,0.0,0.0,0.0
<a href=/player/hargb101>hargb101</a>,Bubbles Hargrave,Cincinnati Reds,REDS,1,1,1,2,1928,1928,0,No,0,0.0,0.0,0.0,0,0,0,0,0,0,0.0,0.0,0.0,10000.0,0.0,-10000.0
<a href=/player/hargb101>hargb101</a>,Bubbles Hargrave,StPaul,StPaul,1,1,3,4,1929,1930,1,No,0,0.05,0.0,-0.05,45,0,-45,121,0,-121,0.0,0.0,0.0,0.0,0.0,0.0
<a href=/player/hargc101>hargc101</a>,Charlie Hargreaves,Brooklyn Dodgers,DOGRS,2,3,3,6,1928,1933,5,No,0,0.59,-0.45,-1.04,414,285,-129,1298,710,-588,148.0,0.0,-148.0,7500.0,0.0,-7500.0
<a href=/player/hargc101>hargc101</a>,Charlie Hargreaves,New York Yankees,YANKS,3,7,3,10,1933,1948,15,No,0,-3.37,1.52,4.89,613,291,-322,2436,971,-1465,0.0,0.0,0.0,9000.0,0.0,-9000.0
<a href=/player/hargm001>hargm001</a>,Mike Hargrove,Texas Rangers,RNGRS,3,8,8,16,1978,1985,7,No,1,13.84,11.07,-2.77,1150,730,-420,2985,2621,-364,918.0,0.0,-918.0,475000.0,0.0,-475000.0
<a href=/player/hargm001>hargm001</a>,Mike Hargrove,San Diego Padres,PADRS,1,1,1,2,1979,1980,1,No,0,13.96,0.22,-13.74,888,144,-744,3538,375,-3163,0.0,0.0,0.0,0.0,0.0,0.0
<a href=/player/hargp101>hargp101</a>,Pinky Hargrave,Washington Senators,TWINS,1,3,1,4,1924,1927,3,No,0,0.0,0.0,0.0,0,0,0,0,0,0,0.0,0.0,0.0,2800.0,0.0,-2800.0
<a href=/player/hargp101>hargp101</a>,Pinky Hargrave,Washington Senators,TWINS,1,2,1,3,1925,1926,1,No,0,2.26,0.7,-1.56,163,72,-91,505,162,-343,46.0,0.0,-46.0,3200.0,0.0,-3200.0
<a href=/player/hargp101>hargp101</a>,Pinky Hargrave,St.Louis Browns,ORLS,25,52,60,112,1927,1952,25,No,0,169.13,172.17,3.04,8392,11292,2900,28367,37730,9363,13765.0,19339.0,5574.0,243500.0,0.0,-243500.0
<a href=/player/hargp101>hargp101</a>,Pinky Hargrave,Washington Senators,TWINS,1,5,1,6,1931,1939,8,No,0,0.0,8.51,8.51,0,385,385,0,407,407,0.0,3095.0,3095.0,6500.0,0.0,-6500.0
<a href=/player/hargs101>hargs101</a>,Steve Hargan,Cleveland Indians,INDINS,1,1,1,2,1973,1975,2,No,0,1.63,-0.02,-1.65,111,5,-106,0,0,0,1538.0,41.0,-1497.0,0.0,0.0,0.0
<a href=/player/hargs101>hargs101</a>,Steve Hargan,Toronto Blue Jays,BJAYS,2,4,2,6,1977,1990,13,No,1,-0.59,16.43,17.02,97,707,610,181,2168,1987,37.0,2317.0,2280.0,0.0,0.0,0.0
<a href=/player/harkt101>harkt101</a>,Tim Harkness,Philadelphia Phillies,PHILS,2,8,4,12,1957,1962,5,No,0,1.07,-3.22,-4.29,707,621,-86,1985,2063,78,115.0,0.0,-115.0,9000.0,0.0,-9000.0
<a href=/player/harkt101>harkt101</a>,Tim Harkness,Los Angeles Dodgers,DOGRS,2,5,3,8,1962,1968,6,No,0,8.72,5.17,-3.55,1130,752,-378,1613,597,-1016,1656.0,2078.0,422.0,122000.0,0.0,-122000.0
<a href=/player/harkt101>harkt101</a>,Tim Harkness,New York Mets,METS,2,4,2,6,1964,1966,2,No,0,-0.11,0.72,0.83,10,206,196,19,669,650,0.0,0.0,0.0,0.0,0.0,0.0
<a href=/player/harld101>harld101</a>,Dick Harley,Philadelphia Phillies,PHILS,2,8,4,12,1897,1902,5,No,0,7.8,14.46,6.66,959,936,-23,3811,3203,-608,1192.0,3296.0,2104.0,0.0,0.0,0.0
<a href=/player/harld101>harld101</a>,Dick Harley,Chicago Cubs,CUBS,2,9,2,11,1903,1913,10,No,0,5.14,24.13,18.99,814,1109,295,3290,4566,1276,0.0,1329.0,1329.0,0.0,0.0,0.0
<a href=/player/harll101>harll101</a>,Larry Harlow,Baltimore Orioles,ORLS,3,3,4,7,1979,1984,5,No,0,1.23,-0.24,-1.47,586,68,-518,1414,121,-1293,0.0,0.0,0.0,0.0,0.0,0.0
<a href=/player/harmb101>harmb101</a>,Bob Harmon,St. Louis Cardinals,CARDS,1,3,5,8,1913,1920,7,No,0,9.94,10.5,0.56,493,813,320,1225,2891,1666,2306.0,795.0,-1511.0,13500.0,0.0,-13500.0
<a href=/player/harmc101>harmc101</a>,Chuck Harmon,Cincinnati Reds,REDS,4,6,10,16,1956,1966,10,No,0,5.05,6.96,1.91,780,904,124,1896,2781,885,111.0,126.0,15.0,0.0,0.0,0.0
<a href=/player/harmc101>harmc101</a>,Chuck Harmon,St. Louis Cardinals,CARDS,1,1,1,2,1957,1957,0,No,0,-0.12,0.0,0.12,57,0,-57,87,0,-87,0.0,0.0,0.0,0.0,0.0,0.0
<a href=/player/harnp001>harnp001</a>,Pete Harnisch,Baltimore Orioles,ORLS,1,3,1,4,1991,1993,2,No,0,24.17,0.73,-23.44,904,185,-719,2612,764,-1848,2435.0,0.0,-2435.0,0.0,0.0,0.0
<a href=/player/harnp001>harnp001</a>,Pete Harnisch,Houston Astros,ASTROS,1,1,2,3,1994,1995,1,No,0,-0.19,0.0,0.19,111,0,-111,113,0,-113,991.0,0.0,-991.0,3205000.0,0.0,-3205000.0
<a href=/player/harnp001>harnp001</a>,Pete Harnisch,New York Mets,METS,1,1,1,2,1997,1997,0,No,0,0.02,0.0,-0.02,4,0,-4,0,0,0,42.0,0.0,-42.0,3213400.0,0.0,-3213400.0
<a href=/player/harpb001>harpb001</a>,Brian Harper,California Angels,ANGELS,2,2,3,5,1981,1983,2,No,0,-0.1,-0.06,0.04,188,238,50,464,877,413,0.0,0.0,0.0,0.0,0.0,0.0
<a href=/player/harpb001>harpb001</a>,Brian Harper,Pittsburgh Pirates,PIRATS,5,10,11,21,1984,2001,17,No,2,29.07,20.82,-8.25,851,1724,873,1168,2507,1339,5314.0,7059.0,1745.0,1290000.0,0.0,-1290000.0
<a href=/player/harpg101>harpg101</a>,George Harper,Cincinnati Reds,REDS,1,1,1,2,1924,1931,7,No,0,6.55,18.82,12.27,297,953,656,1221,3945,2724,0.0,0.0,0.0,5000.0,0.0,-5000.0
<a href=/player/harpg101>harpg101</a>,George Harper,Philadelphia Phillies,PHILS,6,14,12,26,1927,1941,14,No,0,22.91,29.99,7.08,1578,2406,828,6069,6892,823,324.0,5521.0,5197.0,17000.0,0.0,-17000.0
<a href=/player/harpg101>harpg101</a>,George Harper,New York Giants,GIANTS,4,12,7,19,1928,1949,21,No,0,17.78,57.5,39.72,1402,2923,1521,4027,10802,6775,2269.0,40.0,-2229.0,10500.0,0.0,-10500.0
<a href=/player/harpg101>harpg101</a>,George Harper,Boston Braves,BRAVES,2,4,3,7,1929,1938,9,No,0,1.82,35.74,33.92,75,1097,1022,255,4575,4320,0.0,229.0,229.0,27000.0,0.0,-27000.0
<a href=/player/harph101>harph101</a>,Harry Harper,Washington Senators,TWINS,3,6,5,11,1919,1926,7,No,0,13.31,20.32,7.01,1029,562,-467,3656,1370,-2286,534.0,3052.0,2518.0,16400.0,0.0,-16400.0
<a href=/player/harph101>harph101</a>,Harry Harper,Boston Red Sox,RSOX,11,21,24,45,1920,1937,17,No,0,85.68,51.32,-34.36,3377,2671,-706,8411,9094,683,11819.0,4939.0,-6880.0,73300.0,0.0,-73300.0
<a href=/player/harpj102>harpj102</a>,Jack Harper,Chicago Cubs,CUBS,1,3,1,4,1906,1907,1,No,0,-0.07,-0.01,0.06,10,44,34,15,51,36,108.0,415.0,307.0,0.0,0.0,0.0
<a href=/player/harpr001>harpr001</a>,Ryne Harper,Atlanta Braves,BRAVES,1,1,1,2,2015,2018,3,No,0,0.0,0.33,0.33,0,212,212,0,0,0,0.0,303.0,303.0,0.0,0.0,0.0
<a href=/player/harpr001>harpr001</a>,Ryne Harper,Minnesota Twins,TWINS,1,1,1,2,2020,2020,0,Yes,0,-0.01,0.0,0.01,89,0,-89,2,0,-2,178.0,0.0,-178.0,0.0,0.0,0.0
<a href=/player/harpt001>harpt001</a>,Terry Harper,Atlanta Braves,BRAVES,3,4,4,8,1987,1993,6,No,0,1.55,1.95,0.4,257,575,318,99,38,-61,607.0,1203.0,596.0,215000.0,0.0,-215000.0
<a href=/player/harpt001>harpt001</a>,Terry Harper,Detroit Tigers,TIGRS,1,1,2,3,1987,1987,0,No,0,-0.14,0.0,0.14,36,0,-36,73,0,-73,0.0,0.0,0.0,425000.0,0.0,-425000.0
<a href=/player/harpt101>harpt101</a>,Tommy Harper,Cincinnati Reds,REDS,2,2,4,6,1967,1971,4,No,0,1.65,-0.91,-2.56,152,386,234,285,403,118,170.0,1181.0,1011.0,25000.0,0.0,-25000.0
<a href=/player/harpt101>harpt101</a>,Tommy Harper,Milwaukee Brewers,BREWRS,9,23,22,45,1971,1984,13,No,0,35.91,84.88,48.97,2475,4171,1696,6161,14852,8691,10247.0,5331.0,-4916.0,466901.0,0.0,-466901.0
<a href=/player/harpt101>harpt101</a>,Tommy Harper,Boston Red Sox,RSOX,1,1,1,2,1974,1976,2,No,0,0.24,-0.35,-0.59,89,95,6,332,199,-133,0.0,0.0,0.0,90000.0,0.0,-90000.0
<a href=/player/harrb001>harrb001</a>,Brendan Harris,Chicago Cubs,CUBS,2,8,4,12,2004,2009,5,No,0,11.71,9.74,-1.97,643,537,-106,2292,1477,-815,256.0,718.0,462.0,5750000.0,0.0,-5750000.0
<a href=/player/harrb001>harrb001</a>,Brendan Harris,Washington Nationals,NATEX,1,5,3,8,2006,2009,3,No,0,-0.61,0.43,1.04,705,795,90,181,2860,2679,809.0,139.0,-670.0,1352000.0,0.0,-1352000.0
<a href=/player/harrb001>harrb001</a>,Brendan Harris,Tampa Bay Devil Rays,RAYS,6,10,18,28,2007,2018,11,Yes,0,7.31,39.77,32.46,1554,1744,190,4454,3404,-1050,1936.0,6404.0,4468.0,6476100.0,0.0,-6476100.0
<a href=/player/harrb001>harrb001</a>,Brendan Harris,Minnesota Twins,TWINS,1,2,2,4,2010,2011,1,No,0,15.73,-0.62,-16.35,889,27,-862,3636,0,-3636,0.0,74.0,74.0,6550000.0,0.0,-6550000.0
<a href=/player/harrb101>harrb101</a>,Bud Harrelson,New York Mets,METS,1,1,2,3,1978,1978,0,No,0,0.97,0.0,-0.97,124,0,-124,214,0,-214,0.0,0.0,0.0,0.0,0.0,0.0
<a href=/player/harrb102>harrb102</a>,Bill Harrington,Kansas City Athletics,ATLTCS,40,86,88,174,1956,1976,20,No,0,134.11,73.29,-60.82,13270,9412,-3858,30102,25264,-4838,19786.0,12575.0,-7211.0,506100.0,0.0,-506100.0
<a href=/player/harrb103>harrb103</a>,Billy Harrell,St. Louis Cardinals,CARDS,2,7,3,10,1960,1963,3,No,0,1.56,-0.35,-1.91,364,164,-200,1157,310,-847,0.0,0.0,0.0,0.0,0.0,0.0
<a href=/player/harrb104>harrb104</a>,Bubba Harris,Philadelphia Athletics,ATLTCS,1,1,2,3,1951,1951,0,No,0,0.0,0.0,0.0,4,0,-4,0,0,0,12.0,0.0,-12.0,0.0,0.0,0.0
<a href=/player/harrb105>harrb105</a>,Bill Harris,Buffalo,Buffalo,1,1,1,2,1938,1938,0,No,0,1.52,0.0,-1.52,26,0,-26,31,0,-31,241.0,0.0,-241.0,0.0,0.0,0.0
<a href=/player/harrb106>harrb106</a>,Bucky Harris,Buffalo,Buffalo,1,1,2,3,1919,1919,0,No,0,16.16,0.0,-16.16,1252,0,-1252,5536,0,-5536,0.0,0.0,0.0,0.0,0.0,0.0
<a href=/player/harrb106>harrb106</a>,Bucky Harris,Washington Senators,TWINS,1,1,1,2,1928,1933,5,No,0,-0.15,0.0,0.15,11,0,-11,23,0,-23,0.0,0.0,0.0,30000.0,0.0,-30000.0
<a href=/player/harrb107>harrb107</a>,Buddy Harris,Houston Astros,ASTROS,2,3,3,6,1972,1973,1,No,0,0.39,0.74,0.35,34,93,59,92,236,144,0.0,0.0,0.0,0.0,0.0,0.0
<a href=/player/harrb109>harrb109</a>,Bob Harris,Detroit Tigers,TIGRS,3,9,7,16,1939,1948,9,No,0,19.29,21.11,1.82,2183,1686,-497,6579,6030,-549,3951.0,2317.0,-1634.0,44300.0,0.0,-44300.0
<a href=/player/harrb109>harrb109</a>,Bob Harris,St.Louis Browns,ORLS,3,4,5,9,1942,1952,10,No,0,5.24,7.57,2.33,522,583,61,1337,761,-576,901.0,2542.0,1641.0,21000.0,0.0,-21000.0
<a href=/player/harrb110>harrb110</a>,Bill Harrelson,California Angels,ANGELS,1,2,1,3,1970,1970,0,No,0,0.0,0.0,0.0,0,0,0,0,0,0,0.0,0.0,0.0,0.0,0.0,0.0
<a href=/player/harrc101>harrc101</a>,Chuck Harrison,Houston Astros,ASTROS,9,17,16,33,1967,1989,22,No,0,77.09,75.22,-1.87,5400,5677,277,17448,17542,94,3810.0,7694.0,3884.0,705000.0,0.0,-705000.0
<a href=/player/harrd101>harrd101</a>,Dave Harris,Chicago White Sox,WSOX,1,1,1,2,1930,1930,0,No,0,5.84,-0.32,-6.16,410,85,-325,1185,299,-886,0.0,0.0,0.0,5000.0,0.0,-5000.0
<a href=/player/harrd101>harrd101</a>,Dave Harris,Washington Senators,TWINS,2,4,3,7,1934,1939,5,No,0,1.0,0.43,-0.57,49,132,83,167,445,278,0.0,0.0,0.0,6000.0,0.0,-6000.0
<a href=/player/harre101>harre101</a>,Earl Harrist,Chicago White Sox,WSOX,1,1,1,2,1948,1950,2,No,0,0.33,-1.13,-1.46,46,140,94,18,85,67,182.0,708.0,526.0,0.0,0.0,0.0
<a href=/player/harre101>harre101</a>,Earl Harrist,Detroit Tigers,TIGRS,1,2,1,3,1954,1954,0,No,0,0.0,0.0,0.0,0,0,0,0,0,0,0.0,0.0,0.0,0.0,0.0,0.0
<a href=/player/harrg001>harrg001</a>,Greg Harris,New York Mets,METS,1,3,1,4,1982,1986,4,No,0,1.8,4.68,2.88,378,655,277,630,2610,1980,505.0,0.0,-505.0,0.0,0.0,0.0
<a href=/player/harrg001>harrg001</a>,Greg Harris,Montreal Expos,NATEX,2,2,2,4,1984,1987,3,No,0,2.5,-0.67,-3.17,656,120,-536,1884,244,-1640,110.0,0.0,-110.0,0.0,0.0,0.0
<a href=/player/harrg002>harrg002</a>,Greg Harris,San Diego Padres,PADRS,19,36,39,75,1993,2021,28,Yes,1,53.28,80.99,27.71,3600,5089,1489,12022,13376,1354,2601.0,11891.0,9290.0,37678200.0,0.0,-37678200.0
<a href=/player/harrg003>harrg003</a>,Gene Harris,Montreal Expos,NATEX,5,7,7,14,1989,2004,15,No,2,50.88,22.34,-28.54,1051,869,-182,465,3122,2657,8418.0,885.0,-7533.0,4247000.0,0.0,-4247000.0
<a href=/player/harrg003>harrg003</a>,Gene Harris,Seattle Mariners,MARNRS,1,1,1,2,1992,1992,0,No,0,0.92,0.0,-0.92,173,0,-173,5,0,-5,279.0,0.0,-279.0,130000.0,0.0,-130000.0
<a href=/player/harrg003>harrg003</a>,Gene Harris,San Diego Padres,PADRS,9,16,18,34,1994,2006,12,No,1,5.41,22.13,16.72,988,2162,1174,2783,7186,4403,251.0,238.0,-13.0,12344680.0,0.0,-12344680.0
<a href=/player/harrg003>harrg003</a>,Gene Harris,Philadelphia Phillies,PHILS,1,1,1,2,1995,1995,0,No,0,0.05,0.25,0.2,3,63,60,0,247,247,12.0,0.0,-12.0,0.0,0.0,0.0
<a href=/player/harrg101>harrg101</a>,Gail Harris,San Francisco Giants,GIANTS,2,3,4,7,1958,1958,0,No,0,0.51,0.0,-0.51,435,23,-412,1397,29,-1368,0.0,0.0,0.0,0.0,0.0,0.0
<a href=/player/harrg101>harrg101</a>,Gail Harris,Detroit Tigers,TIGRS,1,1,1,2,1960,1960,0,No,0,0.0,-0.38,-0.38,0,65,65,0,81,81,0.0,0.0,0.0,0.0,0.0,0.0
<a href=/player/harrj002>harrj002</a>,Josh Harrison,Chicago Cubs,CUBS,2,4,5,9,2009,2013,4,No,0,14.85,0.73,-14.12,1031,310,-721,3072,59,-3013,719.0,863.0,144.0,405000.0,0.0,-405000.0
<a href=/player/harrj002>harrj002</a>,Josh Harrison,Washington Nationals,NATEX,1,3,3,6,2021,2021,0,Yes,0,-0.1,0.0,0.1,88,0,-88,339,0,-339,0.0,0.0,0.0,7000000.0,0.0,-7000000.0
<a href=/player/harrj101>harrj101</a>,John Harris,California Angels,ANGELS,1,1,1,2,1983,1983,0,No,0,0.0,-0.21,-0.21,0,26,26,0,65,65,0.0,0.0,0.0,0.0,0.0,0.0
<a href=/player/harrj103>harrj103</a>,Joe Harris,Cleveland Indians,INDINS,1,3,1,4,1921,1923,2,No,0,18.85,0.33,-18.52,768,142,-626,3109,582,-2527,0.0,0.0,0.0,10000.0,0.0,-10000.0
<a href=/player/harrj103>harrj103</a>,Joe Harris,Boston Red Sox,RSOX,2,5,4,9,1925,1926,1,No,0,5.81,1.68,-4.13,192,272,80,672,587,-85,0.0,1044.0,1044.0,23750.0,0.0,-23750.0
<a href=/player/harrj103>harrj103</a>,Joe Harris,Pittsburgh Pirates,PIRATS,1,2,1,3,1928,1933,5,No,0,-0.02,-0.43,-0.41,98,192,94,214,667,453,0.0,0.0,0.0,16000.0,0.0,-16000.0
<a href=/player/harrk101>harrk101</a>,Ken Harrelson,Kansas City Athletics,ATLTCS,2,2,2,4,1966,1968,2,No,0,-0.16,0.64,0.8,107,192,85,373,20,-353,43.0,496.0,453.0,0.0,0.0,0.0
<a href=/player/harrk101>harrk101</a>,Ken Harrelson,Boston Red Sox,RSOX,3,6,6,12,1969,1973,4,No,0,5.38,12.96,7.58,1093,699,-394,2374,1115,-1259,1155.0,3166.0,2011.0,26500.0,0.0,-26500.0
<a href=/player/harrl001>harrl001</a>,Lenny Harris,Cincinnati Reds,REDS,3,5,5,10,1989,1997,8,No,1,8.78,16.08,7.3,969,1208,239,2884,4618,1734,1277.0,269.0,-1008.0,325000.0,0.0,-325000.0
<a href=/player/harrl001>harrl001</a>,Lenny Harris,Cincinnati Reds,REDS,3,3,4,7,1998,2001,3,No,0,-0.51,0.6,1.11,324,163,-161,485,4,-481,157.0,294.0,137.0,2075000.0,0.0,-2075000.0
<a href=/player/harrl001>harrl001</a>,Lenny Harris,Colorado Rockies,ROCKS,1,1,1,2,1999,1999,0,No,0,-0.85,0.0,0.85,55,0,-55,121,0,-121,0.0,0.0,0.0,1125000.0,0.0,-1125000.0
<a href=/player/harrl001>harrl001</a>,Lenny Harris,Arizona Diamondbacks,DBACKS,1,1,1,2,2000,2000,0,No,0,-0.02,0.0,0.02,186,0,-186,300,0,-300,0.0,0.0,0.0,1100000.0,0.0,-1100000.0
<a href=/player/harrl001>harrl001</a>,Lenny Harris,New York Mets,METS,11,24,26,50,2002,2021,19,Yes,0,23.92,23.68,-0.24,974,1702,728,1624,4506,2882,6006.0,3554.0,-2452.0,30731467.0,0.0,-30731467.0
<a href=/player/harrl002>harrl002</a>,Lucas Harrell,Houston Astros,ASTROS,1,1,1,2,2014,2014,0,No,0,0.0,0.0,0.0,0,0,0,0,0,0,0.0,0.0,0.0,509700.0,0.0,-509700.0
<a href=/player/harrl002>harrl002</a>,Lucas Harrell,Atlanta Braves,BRAVES,2,4,2,6,2016,2021,5,No,0,-1.23,0.82,2.05,102,117,15,219,0,-219,140.0,208.0,68.0,0.0,0.0,0.0
<a href=/player/harrl101>harrl101</a>,Lum Harris,Atlanta,Atlanta,1,1,1,2,1940,1941,1,No,0,4.15,0.0,-4.15,296,0,-296,290,0,-290,2441.0,0.0,-2441.0,0.0,0.0,0.0
<a href=/player/harrl101>harrl101</a>,Lum Harris,Philadelphia Athletics,ATLTCS,38,83,80,163,1947,1976,29,No,0,92.78,73.92,-18.86,10628,9649,-979,25815,29918,4103,12609.0,7417.0,-5192.0,507800.0,0.0,-507800.0
<a href=/player/harrl101>harrl101</a>,Lum Harris,Detroit Tigers,TIGRS,1,3,1,4,1949,1950,1,No,0,0.0,0.0,0.0,0,0,0,0,0,0,0.0,0.0,0.0,0.0,0.0,0.0
<a href=/player/harrm001>harrm001</a>,Matt Harrison,Atlanta Braves,BRAVES,4,8,6,14,2007,2009,2,No,1,51.72,9.48,-42.24,2314,404,-1910,8153,1445,-6708,2789.0,84.0,-2705.0,15385000.0,0.0,-15385000.0
<a href=/player/harrm001>harrm001</a>,Matt Harrison,Texas Rangers,RNGRS,5,14,16,30,2015,2021,6,Yes,0,11.03,13.28,2.25,790,293,-497,1664,16,-1648,2536.0,2164.0,-372.0,3762500.0,0.0,-3762500.0
<a href=/player/harrm003>harrm003</a>,Monte Harrison,Milwaukee Brewers,BREWRS,1,4,1,5,2018,2018,0,Yes,0,-6.06,7.26,13.32,541,147,-394,1645,651,-994,270.0,0.0,-270.0,0.0,0.0,0.0
<a href=/player/harrm101>harrm101</a>,Mickey Harris,Boston Red Sox,RSOX,2,4,2,6,1949,1955,6,No,0,5.69,3.6,-2.09,738,340,-398,1644,197,-1447,2239.0,1844.0,-395.0,22000.0,0.0,-22000.0
<a href=/player/harrp001>harrp001</a>,Pep Harris,Cleveland Indians,INDINS,1,2,1,3,1996,1997,1,No,0,1.47,1.07,-0.4,162,18,-144,0,0,0,907.0,298.0,-609.0,0.0,0.0,0.0
<a href=/player/harrr102>harrr102</a>,Roric Harrison,Houston Astros,ASTROS,1,2,1,3,1969,1970,1,No,0,0.39,-0.47,-0.86,18,90,72,1,24,23,43.0,312.0,269.0,23500.0,0.0,-23500.0
<a href=/player/harrr102>harrr102</a>,Roric Harrison,Milwaukee Brewers,BREWRS,1,2,1,3,1971,1972,1,No,0,2.12,-1.77,-3.89,78,65,-13,19,18,-1,282.0,203.0,-79.0,0.0,0.0,0.0
<a href=/player/harrr102>harrr102</a>,Roric Harrison,Baltimore Orioles,ORLS,12,27,22,49,1972,1994,22,No,3,53.13,90.0,36.87,3098,4599,1501,7090,11622,4532,12003.0,13691.0,1688.0,846833.0,0.0,-846833.0
<a href=/player/harrr102>harrr102</a>,Roric Harrison,Atlanta Braves,BRAVES,2,2,3,5,1975,1976,1,No,0,-0.16,-2.92,-2.76,27,78,51,0,142,142,462.0,168.0,-294.0,0.0,0.0,0.0
<a href=/player/harrr102>harrr102</a>,Roric Harrison,Cleveland Indians,INDINS,1,1,1,2,1976,1976,0,No,0,0.0,0.27,0.27,0,3,3,0,0,0,0.0,21.0,21.0,0.0,0.0,0.0
<a href=/player/harrr103>harrr103</a>,Ray Harrell,Chicago Cubs,CUBS,1,3,1,4,1939,1947,8,No,0,6.07,34.45,28.38,546,585,39,1567,751,-816,1708.0,5741.0,4033.0,9500.0,0.0,-9500.0
<a href=/player/harrr103>harrr103</a>,Ray Harrell,Pittsburgh Pirates,PIRATS,1,2,1,3,1940,1941,1,No,0,0.0,-0.29,-0.29,0,28,28,0,41,41,0.0,0.0,0.0,0.0,0.0,0.0
<a href=/player/harrs101>harrs101</a>,Slim Harriss,Philadelphia Athletics,ATLTCS,1,3,1,4,1926,1930,4,No,0,3.68,8.68,5.0,373,175,-198,792,208,-584,1683.0,1623.0,-60.0,10500.0,0.0,-10500.0
<a href=/player/harrs101>harrs101</a>,Slim Harriss,Boston Red Sox,RSOX,1,2,2,4,1928,1928,0,No,0,0.0,0.0,0.0,0,0,0,0,0,0,0.0,0.0,0.0,3000.0,0.0,-3000.0
<a href=/player/harrs102>harrs102</a>,Spence Harris,Boston Red Sox,RSOX,1,4,1,5,1937,1937,0,No,0,0.0,0.0,0.0,0,0,0,0,0,0,0.0,0.0,0.0,3000.0,0.0,-3000.0
<a href=/player/harrt001>harrt001</a>,Toby Harrah,Texas Rangers,RNGRS,4,7,6,13,1978,1996,18,No,0,32.3,48.6,16.3,1736,1710,-26,7101,5718,-1383,1191.0,1995.0,804.0,15083333.0,0.0,-15083333.0
<a href=/player/harrt001>harrt001</a>,Toby Harrah,Cleveland Indians,INDINS,15,26,33,59,1984,2001,17,No,1,110.22,66.9,-43.32,6314,5064,-1250,18977,18204,-773,7708.0,2374.0,-5334.0,19613332.0,0.0,-19613332.0
<a href=/player/harrt001>harrt001</a>,Toby Harrah,New York Yankees,YANKS,2,2,3,5,1985,1985,0,No,0,4.74,0.32,-4.42,313,59,-254,1083,154,-929,0.0,0.0,0.0,435000.0,0.0,-435000.0
<a href=/player/harrv101>harrv101</a>,Vic Harris,Oakland Athletics,ATLTCS,2,4,3,7,1972,1975,3,No,0,-3.14,2.17,5.31,448,341,-107,1329,643,-686,48.0,183.0,135.0,42500.0,0.0,-42500.0
<a href=/player/harrv101>harrv101</a>,Vic Harris,Texas Rangers,RNGRS,11,22,20,42,1973,1992,19,No,2,53.55,27.73,-25.82,2537,1445,-1092,5090,3743,-1347,9799.0,4143.0,-5656.0,214000.0,0.0,-214000.0
<a href=/player/harrv101>harrv101</a>,Vic Harris,Chicago Cubs,CUBS,1,1,1,2,1975,1981,6,No,0,-0.62,-1.28,-0.66,97,433,336,282,869,587,0.0,0.0,0.0,0.0,0.0,0.0
<a href=/player/harrv101>harrv101</a>,Vic Harris,St. Louis Cardinals,CARDS,21,44,41,85,1976,1998,22,No,7,91.08,159.62,68.54,8485,7341,-1144,23608,25445,1837,10540.0,4019.0,-6521.0,3088333.0,0.0,-3088333.0
<a href=/player/harrw001>harrw001</a>,Willie Harris,Baltimore Orioles,ORLS,1,1,1,2,2002,2002,0,No,0,1.61,1.84,0.23,313,136,-177,938,502,-436,0.0,0.0,0.0,0.0,0.0,0.0
<a href=/player/harsj101>harsj101</a>,Jack Harshman,SanDiego,SanDiego,1,1,4,5,1947,1947,0,No,0,-0.83,0.0,0.83,19,0,-19,46,0,-46,19.0,0.0,-19.0,0.0,0.0,0.0
<a href=/player/harsj101>harsj101</a>,Jack Harshman,Chicago White Sox,WSOX,15,26,28,54,1957,1969,12,No,0,18.37,37.27,18.9,2207,3220,1013,3806,5515,1709,4631.0,7668.0,3037.0,148250.0,0.0,-148250.0
<a href=/player/harsj101>harsj101</a>,Jack Harshman,Baltimore Orioles,ORLS,18,35,33,68,1959,1994,35,No,3,53.53,113.01,59.48,3587,6053,2466,7530,13021,5491,13834.0,17316.0,3482.0,880833.0,0.0,-880833.0
<a href=/player/hartb102>hartb102</a>,Bruce Hartford,Cleveland Indians,INDINS,1,2,1,3,1914,1914,0,No,0,0.0,0.0,0.0,0,1,1,0,1,1,0.0,0.0,0.0,0.0,0.0,0.0
<a href=/player/hartb106>hartb106</a>,Bill Hart,Pittsburgh Pirates,PIRATS,1,3,1,4,1896,1901,5,No,0,1.66,8.07,6.41,433,743,310,1375,3049,1674,1892.0,0.0,-1892.0,0.0,0.0,0.0
<a href=/player/hartb106>hartb106</a>,Bill Hart,St. Louis Cardinals,CARDS,1,1,2,3,1897,1899,2,No,0,0.14,3.26,3.12,32,70,38,51,111,60,375.0,851.0,476.0,0.0,0.0,0.0
<a href=/player/hartb106>hartb106</a>,Bill Hart,Pittsburgh Pirates,PIRATS,2,5,2,7,1898,1910,12,No,0,14.38,28.41,14.03,866,1321,455,3143,5735,2592,1417.0,0.0,-1417.0,0.0,0.0,0.0
<a href=/player/hartc102>hartc102</a>,Clint Hartung,Cincinnati Reds,REDS,1,2,1,3,1955,1955,0,No,0,0.0,0.0,0.0,0,21,21,0,20,20,0.0,0.0,0.0,0.0,0.0,0.0
<a href=/player/hartc105>hartc105</a>,Chuck Hartenstein,Chicago Cubs,CUBS,1,2,1,3,1969,1969,0,No,0,0.26,0.0,-0.26,146,6,-140,17,6,-11,358.0,0.0,-358.0,0.0,0.0,0.0
<a href=/player/hartc105>hartc105</a>,Chuck Hartenstein,Chicago White Sox,WSOX,6,11,7,18,1973,1989,16,No,1,34.86,33.13,-1.73,1510,1241,-269,4901,4106,-795,2621.0,1776.0,-845.0,0.0,0.0,0.0
<a href=/player/hartf101>hartf101</a>,Fred Hartman,Milwaukee,Milwaukee,1,1,1,2,1897,1897,0,No,0,0.55,0.0,-0.55,239,0,-239,1002,0,-1002,0.0,0.0,0.0,0.0,0.0,0.0
<a href=/player/hartf101>hartf101</a>,Fred Hartman,St. Louis Cardinals,CARDS,2,4,5,9,1897,1899,2,No,0,11.69,1.81,-9.88,688,269,-419,2803,1136,-1667,0.0,0.0,0.0,0.0,0.0,0.0
<a href=/player/hartf101>hartf101</a>,Fred Hartman,St. Louis Cardinals,CARDS,3,4,3,7,1903,1907,4,No,0,1.71,1.38,-0.33,85,483,398,334,1895,1561,0.0,0.0,0.0,0.0,0.0,0.0
<a href=/player/hartg102>hartg102</a>,Grover Hartley,New York Giants,GIANTS,2,4,2,6,1913,1921,8,No,0,15.0,8.81,-6.19,695,474,-221,2854,907,-1947,0.0,2915.0,2915.0,6400.0,0.0,-6400.0
<a href=/player/hartj001>hartj001</a>,Jeff Hartsock,Los Angeles Dodgers,DOGRS,1,1,1,2,1991,1991,0,No,0,-0.23,0.83,1.06,8,22,14,2,1,-1,28.0,25.0,-3.0,0.0,0.0,0.0
<a href=/player/hartj002>hartj002</a>,Jason Hart,Oakland Athletics,ATLTCS,7,12,11,23,2002,2009,7,No,0,21.2,14.17,-7.03,1375,998,-377,3394,3388,-6,5508.0,716.0,-4792.0,947000.0,0.0,-947000.0
<a href=/player/hartk001>hartk001</a>,Kevin Hart,Baltimore Orioles,ORLS,1,1,1,2,2006,2008,2,No,0,0.76,-0.84,-1.6,72,110,38,14,222,208,199.0,0.0,-199.0,0.0,0.0,0.0
<a href=/player/hartk001>hartk001</a>,Kevin Hart,Chicago Cubs,CUBS,2,4,5,9,2009,2013,4,No,0,14.85,0.73,-14.12,1031,310,-721,3072,59,-3013,719.0,863.0,144.0,405000.0,0.0,-405000.0
<a href=/player/hartm001>hartm001</a>,Mike Hart,Minnesota Twins,TWINS,1,1,3,4,1986,1986,0,No,0,-0.57,0.0,0.57,34,0,-34,85,0,-85,0.0,0.0,0.0,0.0,0.0,0.0
<a href=/player/hartm002>hartm002</a>,Mike Hartley,Los Angeles Dodgers,DOGRS,1,2,1,3,1991,1994,3,No,0,-0.35,1.49,1.84,185,369,184,139,10,-129,244.0,706.0,462.0,165000.0,0.0,-165000.0
<a href=/player/hartm002>hartm002</a>,Mike Hartley,Philadelphia Phillies,PHILS,1,1,1,2,1992,1996,4,No,0,1.22,3.78,2.56,53,244,191,0,60,60,243.0,755.0,512.0,225000.0,0.0,-225000.0
<a href=/player/hartm101>hartm101</a>,Mike Hart,Montreal Expos,NATEX,1,1,1,2,1978,1980,2,No,0,-0.11,-0.43,-0.32,5,40,35,5,78,73,0.0,0.0,0.0,0.0,0.0,0.0
<a href=/player/hartp001>hartp001</a>,Paul Hartzell,California Angels,ANGELS,1,4,1,5,1979,1985,6,No,0,6.38,17.39,11.01,810,834,24,2648,3570,922,1590.0,0.0,-1590.0,0.0,0.0,0.0
<a href=/player/hartr101>hartr101</a>,Roy Hartsfield,Milwaukee Braves,BRAVES,1,2,1,3,1953,1959,6,No,0,0.0,4.62,4.62,0,658,658,0,2087,2087,0.0,0.0,0.0,0.0,0.0,0.0
<a href=/player/hartr102>hartr102</a>,Roy Hartzell,St.Louis Browns,ORLS,1,2,2,4,1911,1912,1,No,0,7.07,8.48,1.41,699,364,-335,2814,1518,-1296,0.0,0.0,0.0,0.0,0.0,0.0
<a href=/player/harvc001>harvc001</a>,Chad Harville,Oakland Athletics,ATLTCS,2,3,3,6,2004,2007,3,No,0,-1.58,3.41,4.99,249,72,-177,8,1,-7,402.0,916.0,514.0,307000.0,0.0,-307000.0
<a href=/player/harvj001>harvj001</a>,Joe Harvey,New York Yankees,YANKS,1,1,1,2,2019,2019,0,Yes,0,0.17,0.0,-0.17,22,0,-22,0,0,0,34.0,0.0,-34.0,555000.0,0.0,-555000.0
<a href=/player/harvm001>harvm001</a>,Matt Harvey,New York Mets,METS,1,1,2,3,2018,2019,1,Yes,0,0.95,0.75,-0.2,48,66,18,50,229,179,384.0,0.0,-384.0,0.0,0.0,0.0
<a href=/player/haseb001>haseb001</a>,Bill Haselman,Boston Red Sox,RSOX,4,7,7,14,1997,2000,3,No,0,8.97,2.55,-6.42,585,374,-211,1634,946,-688,1253.0,139.0,-1114.0,5063500.0,0.0,-5063500.0
<a href=/player/haseb001>haseb001</a>,Bill Haselman,Detroit Tigers,TIGRS,3,8,6,14,1999,2006,7,No,2,20.76,5.57,-15.19,1380,450,-930,3548,496,-3052,1196.0,1028.0,-168.0,1937500.0,0.0,-1937500.0
<a href=/player/hashh101>hashh101</a>,Herb Hash,Minneapolis,Minneapolis,1,3,2,5,1939,1940,1,No,0,2.73,0.0,-2.73,141,0,-141,95,0,-95,836.0,0.0,-836.0,0.0,0.0,0.0
<a href=/player/haslm101>haslm101</a>,Mickey Haslin,Philadelphia Phillies,PHILS,1,1,1,2,1936,1939,3,No,0,0.24,4.19,3.95,36,388,352,109,1425,1316,0.0,0.0,0.0,0.0,0.0,0.0
<a href=/player/haslm101>haslm101</a>,Mickey Haslin,Boston Braves,BRAVES,1,1,1,2,1936,1938,2,No,0,0.95,-0.24,-1.19,58,73,15,162,214,52,0.0,0.0,0.0,0.0,0.0,0.0
<a href=/player/haslm101>haslm101</a>,Mickey Haslin,New York Giants,GIANTS,2,4,2,6,1938,1945,7,No,0,4.14,-1.16,-5.3,264,152,-112,377,366,-11,1753.0,409.0,-1344.0,0.0,0.0,0.0
<a href=/player/hassb101>hassb101</a>,Buddy Hassett,New York Yankees,YANKS,1,1,3,4,1936,1936,0,No,0,5.02,0.0,-5.02,408,0,-408,1654,0,-1654,0.0,0.0,0.0,0.0,0.0,0.0
<a href=/player/hassb101>hassb101</a>,Buddy Hassett,Brooklyn Dodgers,DOGRS,1,2,2,4,1938,1940,2,No,0,2.67,-0.72,-3.39,454,199,-255,1715,406,-1309,0.0,317.0,317.0,0.0,0.0,0.0
<a href=/player/hassb101>hassb101</a>,Buddy Hassett,Boston Braves,BRAVES,1,2,1,3,1941,1952,11,No,0,1.7,36.09,34.39,132,1289,1157,581,5523,4942,0.0,0.0,0.0,7500.0,0.0,-7500.0
<a href=/player/hassg101>hassg101</a>,Gene Hasson,Philadelphia Athletics,ATLTCS,2,4,2,6,1938,1947,9,No,0,0.0,6.93,6.93,0,1140,1140,0,4751,4751,0.0,0.0,0.0,12000.0,0.0,-12000.0
<a href=/player/hassj101>hassj101</a>,Joe Hassler,Philadelphia Athletics,ATLTCS,2,6,3,9,1929,1936,7,No,0,0.0,5.31,5.31,0,419,419,0,458,458,0.0,2946.0,2946.0,7500.0,0.0,-7500.0
<a href=/player/hassj101>hassj101</a>,Joe Hassler,Philadelphia Athletics,ATLTCS,1,1,2,3,1927,1930,3,No,0,0.0,0.16,0.16,0,12,12,0,22,22,0.0,0.0,0.0,0.0,0.0,0.0
<a href=/player/hassj101>hassj101</a>,Joe Hassler,Toledo,Toledo,1,1,1,2,1928,1928,0,No,0,-0.42,0.0,0.42,32,0,-32,44,0,-44,0.0,0.0,0.0,0.0,0.0,0.0
<a href=/player/hassr001>hassr001</a>,Ron Hassey,Cleveland Indians,INDINS,14,24,30,54,1984,2001,17,No,1,109.74,66.95,-42.79,6226,4765,-1461,18678,17797,-881,7708.0,2241.0,-5467.0,19613332.0,0.0,-19613332.0
<a href=/player/hassr001>hassr001</a>,Ron Hassey,Chicago Cubs,CUBS,2,7,4,11,1984,1987,3,No,0,2.88,0.38,-2.5,447,379,-68,818,354,-464,766.0,789.0,23.0,873333.0,0.0,-873333.0
<a href=/player/hassr001>hassr001</a>,Ron Hassey,New York Yankees,YANKS,8,20,16,36,1985,2001,16,No,1,26.31,24.47,-1.84,1960,2459,499,6255,8654,2399,4152.0,66.0,-4086.0,945873.0,0.0,-945873.0
<a href=/player/hassr001>hassr001</a>,Ron Hassey,Chicago White Sox,WSOX,4,8,9,17,1986,1996,10,No,0,8.12,26.46,18.34,1204,1239,35,3582,5184,1602,266.0,488.0,222.0,4896500.0,0.0,-4896500.0
<a href=/player/hassr001>hassr001</a>,Ron Hassey,New York Yankees,YANKS,2,5,4,9,1986,1992,6,No,0,1.11,3.87,2.76,606,1169,563,1878,3720,1842,0.0,0.0,0.0,400873.0,0.0,-400873.0
<a href=/player/hastb101>hastb101</a>,Bob Hasty,Philadelphia Athletics,ATLTCS,3,9,5,14,1924,1935,11,No,0,15.67,38.22,22.55,391,1328,937,1453,5363,3910,735.0,0.0,-735.0,39667.0,0.0,-39667.0
<a href=/player/hatcb001>hatcb001</a>,Billy Hatcher,Chicago Cubs,CUBS,1,2,1,3,1985,1988,3,No,0,5.63,1.35,-4.28,521,292,-229,2104,758,-1346,0.0,0.0,0.0,0.0,0.0,0.0
<a href=/player/hatcb001>hatcb001</a>,Billy Hatcher,Houston Astros,ASTROS,1,1,1,2,1989,1990,1,No,0,-0.02,0.38,0.4,27,146,119,87,508,421,0.0,0.0,0.0,0.0,0.0,0.0
<a href=/player/hatcb001>hatcb001</a>,Billy Hatcher,Pittsburgh Pirates,PIRATS,2,2,3,5,1990,1993,3,No,0,0.84,0.05,-0.79,335,16,-319,1156,5,-1151,0.0,18.0,18.0,0.0,0.0,0.0
<a href=/player/hatcb001>hatcb001</a>,Billy Hatcher,Cincinnati Reds,REDS,1,1,1,2,1992,1992,0,No,0,-1.13,-0.45,0.68,255,32,-223,1085,15,-1070,0.0,139.0,139.0,1600000.0,0.0,-1600000.0
<a href=/player/hatcb001>hatcb001</a>,Billy Hatcher,Boston Red Sox,RSOX,2,3,3,6,1994,1995,1,No,0,-0.06,-1.0,-0.94,145,86,-59,216,248,32,628.0,0.0,-628.0,885000.0,0.0,-885000.0
<a href=/player/hatcc001>hatcc001</a>,Chris Hatcher,Chicago Cubs,CUBS,1,3,2,5,2000,2000,0,No,0,0.0,0.0,0.0,0,0,0,0,0,0,0.0,0.0,0.0,0.0,0.0,0.0
<a href=/player/hatcc002>hatcc002</a>,Chris Hatcher,Miami Marlins,MARLNS,3,8,9,17,2014,2020,6,Yes,0,14.59,9.27,-5.32,1600,441,-1159,4137,1747,-2390,525.0,522.0,-3.0,17800000.0,0.0,-17800000.0
<a href=/player/hatcc002>hatcc002</a>,Chris Hatcher,Los Angeles Dodgers,DOGRS,1,1,1,2,2017,2017,0,No,0,0.17,0.0,-0.17,61,0,-61,0,0,0,178.0,0.0,-178.0,1250000.0,0.0,-1250000.0
<a href=/player/hatcm001>hatcm001</a>,Mickey Hatcher,Los Angeles Dodgers,DOGRS,1,3,1,4,1981,1987,6,No,0,3.72,8.48,4.76,672,868,196,2514,2981,467,0.0,0.0,0.0,0.0,0.0,0.0
<a href=/player/hatct001>hatct001</a>,Thomas Hatch,Chicago Cubs,CUBS,1,1,2,3,2019,2019,0,No,0,0.53,0.37,-0.16,20,48,28,0,0,0,107.0,51.0,-56.0,0.0,0.0,0.0
<a href=/player/hatff101>hatff101</a>,Fred Hatfield,Boston Red Sox,RSOX,2,6,6,12,1952,1956,4,No,0,8.2,10.1,1.9,1335,867,-468,4777,3045,-1732,507.0,401.0,-106.0,80000.0,0.0,-80000.0
<a href=/player/hatff101>hatff101</a>,Fred Hatfield,Detroit Tigers,TIGRS,1,2,3,5,1956,1957,1,No,0,0.97,-0.45,-1.42,230,140,-90,562,387,-175,0.0,0.0,0.0,0.0,0.0,0.0
<a href=/player/hatff101>hatff101</a>,Fred Hatfield,Chicago White Sox,WSOX,9,15,19,34,1957,1971,14,No,0,41.54,76.26,34.72,3085,4270,1185,10587,11970,1383,740.0,5807.0,5067.0,72500.0,0.0,-72500.0
<a href=/player/hatff101>hatff101</a>,Fred Hatfield,Cleveland Indians,INDINS,1,1,1,2,1958,1958,0,No,0,-0.03,-0.16,-0.13,3,26,23,1,5,4,0.0,83.0,83.0,0.0,0.0,0.0
<a href=/player/hatff101>hatff101</a>,Fred Hatfield,Cleveland Indians,INDINS,1,2,1,3,1959,1960,1,No,0,0.0,0.68,0.68,0,77,77,0,270,270,0.0,0.0,0.0,0.0,0.0,0.0
<a href=/player/hatff101>hatff101</a>,Fred Hatfield,Los Angeles Dodgers,DOGRS,1,3,2,5,1959,1959,0,No,0,0.0,0.0,0.0,0,0,0,0,0,0,0.0,0.0,0.0,0.0,0.0,0.0
<a href=/player/hathh001>hathh001</a>,Hilly Hathaway,California Angels,ANGELS,1,1,1,2,1994,1994,0,No,0,0.0,-0.84,-0.84,0,74,74,0,235,235,0.0,0.0,0.0,0.0,0.0,0.0
<a href=/player/hattg101>hattg101</a>,Grady Hatton,Cincinnati Reds,REDS,1,1,1,2,1954,1954,0,No,0,-0.03,0.0,0.03,13,1,-12,36,1,-35,0.0,0.0,0.0,0.0,0.0,0.0
<a href=/player/hattg101>hattg101</a>,Grady Hatton,Chicago White Sox,WSOX,3,7,4,11,1954,1961,7,No,0,23.88,9.56,-14.32,1230,781,-449,3826,2299,-1527,2136.0,479.0,-1657.0,62000.0,0.0,-62000.0
<a href=/player/hattj001>hattj001</a>,John Hattig,Boston Red Sox,RSOX,1,1,1,2,2004,2004,0,No,0,0.29,-0.09,-0.38,13,19,6,29,0,-29,0.0,81.0,81.0,0.0,0.0,0.0
<a href=/player/hattj101>hattj101</a>,Joe Hatten,Minneapolis,Minneapolis,1,1,2,3,1941,1942,1,No,0,8.85,0.0,-8.85,401,0,-401,354,0,-354,2881.0,0.0,-2881.0,0.0,0.0,0.0
<a href=/player/hattj101>hattj101</a>,Joe Hatten,Brooklyn Dodgers,DOGRS,3,6,7,13,1951,1958,7,No,0,4.28,2.12,-2.16,1667,685,-982,5534,2062,-3472,435.0,267.0,-168.0,50000.0,0.0,-50000.0
<a href=/player/hatts001>hatts001</a>,Scott Hatteberg,Boston Red Sox,RSOX,1,1,1,2,2001,2001,0,No,0,0.0,0.0,0.0,0,0,0,0,0,0,0.0,0.0,0.0,1050000.0,0.0,-1050000.0
<a href=/player/hausc101>hausc101</a>,Clem Hausmann,Boston Red Sox,RSOX,1,2,1,3,1945,1945,0,No,0,0.0,0.0,0.0,0,0,0,0,0,0,0.0,0.0,0.0,5000.0,0.0,-5000.0
<a href=/player/hausj101>hausj101</a>,Joe Hauser,Milwaukee,Milwaukee,2,2,10,12,1921,1938,17,No,0,18.15,0.0,-18.15,1442,0,-1442,4922,0,-4922,0.0,0.0,0.0,0.0,0.0,0.0
<a href=/player/haust101>haust101</a>,Tom Hausman,New York Mets,METS,6,10,9,19,1982,2002,20,No,2,9.94,35.51,25.57,1218,1060,-158,3663,1902,-1761,484.0,5406.0,4922.0,876667.0,0.0,-876667.0
<a href=/player/haveb001>haveb001</a>,Brad Havens,California Angels,ANGELS,1,4,1,5,1979,1985,6,No,0,6.38,17.39,11.01,810,834,24,2648,3570,922,1590.0,0.0,-1590.0,0.0,0.0,0.0
<a href=/player/haveb001>haveb001</a>,Brad Havens,Minnesota Twins,TWINS,1,1,1,2,1985,1985,0,No,0,-0.24,-0.21,0.03,54,6,-48,0,0,0,256.0,47.0,-209.0,0.0,0.0,0.0
<a href=/player/haveb001>haveb001</a>,Brad Havens,Baltimore Orioles,ORLS,2,3,2,5,1987,1988,1,No,1,3.02,0.79,-2.23,473,97,-376,1461,0,-1461,135.0,334.0,199.0,300000.0,0.0,-300000.0
<a href=/player/hawer101>hawer101</a>,Roy Hawes,Detroit Tigers,TIGRS,1,1,1,2,1957,1958,1,No,0,0.0,0.98,0.98,0,90,90,0,24,24,0.0,224.0,224.0,0.0,0.0,0.0
<a href=/player/hawer101>hawer101</a>,Roy Hawes,Washington Senators,TWINS,1,4,4,8,1956,1956,0,No,0,0.0,0.0,0.0,0,0,0,0,0,0,0.0,0.0,0.0,0.0,0.0,0.0
<a href=/player/hawkb001>hawkb001</a>,Blake Hawksworth,St. Louis Cardinals,CARDS,1,1,1,2,2010,2011,1,No,0,-0.37,0.34,0.71,96,132,36,1,483,482,159.0,0.0,-159.0,402000.0,0.0,-402000.0
<a href=/player/hawkc101>hawkc101</a>,Chicken Hawks,Nashville,Nashville,1,1,2,3,1924,1924,0,No,0,0.51,0.0,-0.51,105,0,-105,366,0,-366,0.0,0.0,0.0,0.0,0.0,0.0
<a href=/player/hawkl001>hawkl001</a>,LaTroy Hawkins,Chicago Cubs,CUBS,2,4,3,7,2005,2009,4,No,0,0.0,1.94,1.94,117,297,180,0,42,42,209.0,704.0,495.0,4500000.0,0.0,-4500000.0
<a href=/player/hawkl001>hawkl001</a>,LaTroy Hawkins,San Francisco Giants,GIANTS,1,1,1,2,2005,2008,3,No,0,0.59,0.71,0.12,63,279,216,0,1,1,181.0,293.0,112.0,0.0,0.0,0.0
<a href=/player/hawkl001>hawkl001</a>,LaTroy Hawkins,New York Yankees,YANKS,2,3,3,6,2008,2010,2,No,0,2.94,1.48,-1.46,175,24,-151,0,0,0,253.0,78.0,-175.0,3750000.0,0.0,-3750000.0
<a href=/player/hawkl001>hawkl001</a>,LaTroy Hawkins,Colorado Rockies,ROCKS,4,6,8,14,2015,2020,5,Yes,0,9.83,-2.06,-11.89,514,266,-248,1003,284,-719,1008.0,871.0,-137.0,0.0,0.0,0.0
<a href=/player/hawlp101>hawlp101</a>,Pink Hawley,St. Louis Cardinals,CARDS,6,9,15,24,1895,1899,4,No,0,67.35,0.04,-67.31,2365,833,-1532,8232,2977,-5255,4823.0,1363.0,-3460.0,0.0,0.0,0.0
<a href=/player/hawlp101>hawlp101</a>,Pink Hawley,Pittsburgh Pirates,PIRATS,3,8,7,15,1897,1910,13,No,0,26.73,36.51,9.78,1261,2039,778,4478,8482,4004,3164.0,936.0,-2228.0,0.0,0.0,0.0
<a href=/player/haydh101>haydh101</a>,Hal Haydel,Houston Astros,ASTROS,3,7,4,11,1963,1965,2,No,0,1.38,1.37,-0.01,248,133,-115,214,502,288,382.0,0.0,-382.0,0.0,0.0,0.0
<a href=/player/haydj101>haydj101</a>,Jack Hayden,Baltimore,Baltimore,1,1,4,5,1903,1906,3,No,0,0.0,0.0,0.0,0,0,0,0,0,0,0.0,0.0,0.0,0.0,0.0,0.0
<a href=/player/hayec001>hayec001</a>,Charlie Hayes,San Francisco Giants,GIANTS,2,4,4,8,1989,1995,6,No,0,14.97,0.18,-14.79,1080,283,-797,2467,146,-2321,4215.0,391.0,-3824.0,1545000.0,0.0,-1545000.0
<a href=/player/hayec001>hayec001</a>,Charlie Hayes,Philadelphia Phillies,PHILS,1,1,1,2,1992,1992,0,No,0,3.09,-0.07,-3.16,262,2,-260,1016,0,-1016,0.0,6.0,6.0,0.0,0.0,0.0
<a href=/player/hayec001>hayec001</a>,Charlie Hayes,Pittsburgh Pirates,PIRATS,1,1,1,2,1996,1996,0,No,0,0.9,0.0,-0.9,120,0,-120,467,0,-467,0.0,0.0,0.0,1750000.0,0.0,-1750000.0
<a href=/player/hayec001>hayec001</a>,Charlie Hayes,New York Yankees,YANKS,2,3,3,6,1997,1999,2,No,0,8.82,0.0,-8.82,626,0,-626,2195,0,-2195,0.0,0.0,0.0,1700000.0,0.0,-1700000.0
<a href=/player/hayef101>hayef101</a>,Frankie Hayes,Philadelphia Athletics,ATLTCS,2,3,3,6,1942,1946,4,No,0,-0.7,0.29,0.99,792,169,-623,2462,494,-1968,0.0,234.0,234.0,13000.0,0.0,-13000.0
<a href=/player/hayef101>hayef101</a>,Frankie Hayes,St.Louis Browns,ORLS,2,2,4,6,1944,1952,8,No,0,4.95,8.46,3.51,353,439,86,843,281,-562,667.0,2542.0,1875.0,10500.0,0.0,-10500.0
<a href=/player/hayef101>hayef101</a>,Frankie Hayes,Philadelphia Athletics,ATLTCS,3,3,3,6,1945,1953,8,No,0,1.6,6.02,4.42,277,750,473,954,2818,1864,0.0,0.0,0.0,24000.0,0.0,-24000.0
<a href=/player/hayef101>hayef101</a>,Frankie Hayes,Cleveland Indians,INDINS,1,1,1,2,1946,1946,0,No,0,-0.41,-0.14,0.27,53,14,-39,211,38,-173,0.0,0.0,0.0,13000.0,0.0,-13000.0
<a href=/player/hayej101>hayej101</a>,Jackie Hayes,Washington Senators,TWINS,4,9,7,16,1931,1936,5,No,0,40.86,14.39,-26.47,2483,840,-1643,9607,2965,-6642,2547.0,1249.0,-1298.0,62500.0,0.0,-62500.0
<a href=/player/hayev001>hayev001</a>,Von Hayes,Cleveland Indians,INDINS,6,6,13,19,1982,1992,10,No,1,49.35,26.03,-23.32,2218,2372,154,8457,9243,786,405.0,0.0,-405.0,1725000.0,0.0,-1725000.0
<a href=/player/hayev001>hayev001</a>,Von Hayes,Philadelphia Phillies,PHILS,4,6,7,13,1991,1999,8,No,0,0.82,1.21,0.39,368,740,372,652,697,45,390.0,1257.0,867.0,2575000.0,0.0,-2575000.0
<a href=/player/haynj001>haynj001</a>,Jimmy Haynes,Baltimore Orioles,ORLS,1,2,1,3,1997,1997,0,No,0,2.08,0.05,-2.03,82,83,1,11,349,338,1229.0,0.0,-1229.0,0.0,0.0,0.0
<a href=/player/haynj001>haynj001</a>,Jimmy Haynes,Oakland Athletics,ATLTCS,6,11,11,22,1999,2012,13,No,2,22.72,5.23,-17.49,1629,359,-1270,3170,656,-2514,6649.0,556.0,-6093.0,2713333.0,0.0,-2713333.0
<a href=/player/haynj101>haynj101</a>,Joe Haynes,Chicago White Sox,WSOX,8,10,11,21,1948,1976,28,No,0,1.76,48.29,46.53,980,3110,2130,2144,11541,9397,489.0,1217.0,728.0,27000.0,0.0,-27000.0
<a href=/player/haynj101>haynj101</a>,Joe Haynes,Cleveland Indians,INDINS,14,26,24,50,1948,1968,20,No,0,162.56,72.5,-90.06,7462,3103,-4359,23911,8852,-15059,13186.0,8500.0,-4686.0,30900.0,0.0,-30900.0
<a href=/player/haynn001>haynn001</a>,Nathan Haynes,Oakland Athletics,ATLTCS,3,7,5,12,1999,2003,4,No,0,20.51,6.2,-14.31,1029,288,-741,2006,1023,-983,4166.0,874.0,-3292.0,3050000.0,0.0,-3050000.0
<a href=/player/haywr001>haywr001</a>,Ray Hayward,San Diego Padres,PADRS,22,42,43,85,1988,2010,22,No,6,15.58,62.4,46.82,4503,5790,1287,14891,19463,4572,1624.0,2614.0,990.0,28423133.0,0.0,-28423133.0
<a href=/player/haywr001>haywr001</a>,Ray Hayward,Chicago Cubs,CUBS,1,1,2,3,1988,1988,0,No,0,-0.74,-0.02,0.72,12,2,-10,0,5,5,188.0,0.0,-188.0,0.0,0.0,0.0
<a href=/player/haywr101>haywr101</a>,Ray Hayworth,Brooklyn Dodgers,DOGRS,1,1,1,2,1939,1940,1,No,0,-0.08,0.6,0.68,5,35,30,14,135,121,0.0,0.0,0.0,6000.0,0.0,-6000.0
<a href=/player/hazej001>hazej001</a>,Jeremy Hazelbaker,Boston Red Sox,RSOX,1,2,1,3,2013,2013,0,No,0,0.0,0.0,0.0,0,0,0,0,0,0,0.0,0.0,0.0,0.0,0.0,0.0
<a href=/player/hazlb101>hazlb101</a>,Bob Hazle,Cincinnati Reds,REDS,4,7,9,16,1956,1966,10,No,0,6.9,8.42,1.52,812,960,148,2097,3305,1208,111.0,126.0,15.0,0.0,0.0,0.0
<a href=/player/headc001>headc001</a>,Chase Headley,San Diego Padres,PADRS,3,5,5,10,2014,2020,6,Yes,0,7.54,6.82,-0.72,685,468,-217,2663,1808,-855,19.0,30.0,11.0,0.0,0.0,0.0
<a href=/player/headc001>headc001</a>,Chase Headley,New York Yankees,YANKS,2,4,2,6,2017,2018,1,No,0,-1.8,0.0,1.8,81,0,-81,124,0,-124,219.0,0.0,-219.0,13550625.0,0.0,-13550625.0
<a href=/player/headl001>headl001</a>,Louis Head,Tampa Bay Devil Rays,RAYS,1,1,1,2,2021,2021,0,No,0,0.0,0.0,0.0,0,0,0,0,0,0,0.0,0.0,0.0,0.0,0.0,0.0
<a href=/player/heale101>heale101</a>,Egyptian Healy,Indianapolis Hoosiers,IN3,1,1,1,2,1889,1889,0,No,0,0.0,0.0,0.0,0,0,0,0,0,0,0.0,0.0,0.0,0.0,0.0,0.0
<a href=/player/healf102>healf102</a>,Fran Healy,Kansas City Royals,ROYALS,2,2,2,4,1970,1971,1,No,0,0.76,0.0,-0.76,92,0,-92,221,0,-221,0.0,0.0,0.0,0.0,0.0,0.0
<a href=/player/healf102>healf102</a>,Fran Healy,San Francisco Giants,GIANTS,1,1,1,2,1973,1987,14,No,0,4.8,12.31,7.51,298,1106,808,1060,122,-938,0.0,2611.0,2611.0,0.0,0.0,0.0
<a href=/player/healf102>healf102</a>,Fran Healy,Kansas City Royals,ROYALS,1,1,1,2,1976,1985,9,No,0,0.86,18.75,17.89,74,312,238,205,0,-205,0.0,5104.0,5104.0,0.0,0.0,0.0
<a href=/player/healr001>healr001</a>,Ryon Healy,Oakland Athletics,ATLTCS,3,5,5,10,2017,2019,2,Yes,0,3.09,0.09,-3.0,444,198,-246,1326,518,-808,210.0,186.0,-24.0,4685000.0,0.0,-4685000.0
<a href=/player/heana001>heana001</a>,Andrew Heaney,Miami Marlins,MARLNS,3,8,9,17,2014,2020,6,Yes,0,14.59,9.27,-5.32,1600,441,-1159,4137,1747,-2390,525.0,522.0,-3.0,17800000.0,0.0,-17800000.0
<a href=/player/heana001>heana001</a>,Andrew Heaney,Los Angeles Dodgers,DOGRS,2,2,3,5,2014,2017,3,No,0,7.35,2.19,-5.16,147,263,116,173,1038,865,1708.0,0.0,-1708.0,10000000.0,0.0,-10000000.0
<a href=/player/heana001>heana001</a>,Andrew Heaney,Anaheim Angels,ANGELS,1,2,2,4,2021,2021,0,Yes,0,-0.59,-0.41,0.18,14,7,-7,1,0,-1,107.0,56.0,-51.0,6750000.0,0.0,-6750000.0
<a href=/player/heare001>heare001</a>,Ed Hearn,New York Mets,METS,11,23,20,43,1987,2005,18,No,0,11.67,39.4,27.73,1493,3560,2067,1978,7962,5984,3113.0,6312.0,3199.0,27998333.0,0.0,-27998333.0
<a href=/player/hearh101>hearh101</a>,Hughie Hearne,Brooklyn Dodgers,DOGRS,1,4,1,5,1903,1908,5,No,0,0.0,0.0,0.0,0,0,0,0,0,0,0.0,0.0,0.0,0.0,0.0,0.0
<a href=/player/hearj101>hearj101</a>,Jay Heard,Baltimore Orioles,ORLS,1,1,1,2,1954,1955,1,No,0,0.0,-0.58,-0.58,0,8,8,0,0,0,0.0,12.0,12.0,0.0,0.0,0.0
<a href=/player/hearj102>hearj102</a>,Jim Hearn,New York Giants,GIANTS,11,19,17,36,1956,1972,16,No,0,36.88,23.67,-13.21,2797,2062,-735,6356,1997,-4359,3610.0,7650.0,4040.0,50000.0,0.0,-50000.0
<a href=/player/heart001>heart001</a>,Taylor Hearn,Washington Nationals,NATEX,1,2,1,3,2016,2016,0,No,0,7.25,1.19,-6.06,436,60,-376,3,0,-3,698.0,89.0,-609.0,0.0,0.0,0.0
<a href=/player/heart001>heart001</a>,Taylor Hearn,Pittsburgh Pirates,PIRATS,1,2,1,3,2018,2020,2,No,0,-0.62,1.6,2.22,66,95,29,21,0,-21,366.0,141.0,-225.0,0.0,0.0,0.0
<a href=/player/heatb101>heatb101</a>,Bill Heath,Philadelphia Phillies,PHILS,2,4,2,6,1964,1966,2,No,0,4.55,-0.7,-5.25,451,79,-372,428,37,-391,3416.0,375.0,-3041.0,5400.0,0.0,-5400.0
<a href=/player/heatb101>heatb101</a>,Bill Heath,Chicago White Sox,WSOX,1,2,3,5,1965,1967,2,No,0,2.05,-0.33,-2.38,164,74,-90,481,40,-441,0.0,379.0,379.0,13000.0,0.0,-13000.0
<a href=/player/heatc101>heatc101</a>,Cliff Heathcote,St. Louis Cardinals,CARDS,1,1,1,2,1922,1922,0,No,0,6.65,0.18,-6.47,856,66,-790,3009,302,-2707,0.0,0.0,0.0,4000.0,0.0,-4000.0
<a href=/player/heatj101>heatj101</a>,Jeff Heath,Cleveland Indians,INDINS,2,2,2,4,1945,1947,2,No,0,0.39,-0.84,-1.23,84,132,48,292,533,241,0.0,48.0,48.0,0.0,0.0,0.0
<a href=/player/heatj101>heatj101</a>,Jeff Heath,Washington Senators,TWINS,1,1,2,3,1946,1947,1,No,0,5.22,1.06,-4.16,227,159,-68,935,625,-310,0.0,8.0,8.0,0.0,0.0,0.0
<a href=/player/heatm001>heatm001</a>,Mike Heath,New York Yankees,YANKS,25,56,45,101,1978,2001,23,No,2,104.42,67.09,-37.33,6884,4113,-2771,17114,10039,-7075,21429.0,9704.0,-11725.0,5628333.0,0.0,-5628333.0
<a href=/player/heatm001>heatm001</a>,Mike Heath,Texas Rangers,RNGRS,4,8,5,13,1979,1992,13,No,2,15.39,12.05,-3.34,1067,540,-527,2903,1729,-1174,4307.0,1272.0,-3035.0,0.0,0.0,0.0
<a href=/player/heatm001>heatm001</a>,Mike Heath,Oakland Athletics,ATLTCS,1,2,1,3,1985,1987,2,No,0,-1.98,1.12,3.1,136,41,-95,273,0,-273,468.0,648.0,180.0,425000.0,0.0,-425000.0
<a href=/player/heatm001>heatm001</a>,Mike Heath,St. Louis Cardinals,CARDS,2,2,3,5,1986,1992,6,No,0,16.8,0.23,-16.57,623,339,-284,1685,693,-992,1669.0,1412.0,-257.0,688333.0,0.0,-688333.0
<a href=/player/heatm002>heatm002</a>,Mike Heathcott,Chicago Cubs,CUBS,1,3,2,5,2000,2000,0,No,0,0.0,0.0,0.0,0,0,0,0,0,0,0.0,0.0,0.0,0.0,0.0,0.0
<a href=/player/heatm101>heatm101</a>,Mickey Heath,Hollywood,Hollywood,1,1,3,4,1930,1930,0,No,0,-0.4,0.0,0.4,46,0,-46,187,0,-187,0.0,0.0,0.0,0.0,0.0,0.0
<a href=/player/heatm101>heatm101</a>,Mickey Heath,Cincinnati Reds,REDS,2,4,2,6,1931,1932,1,No,0,-0.61,6.01,6.62,32,314,282,78,1300,1222,9.0,0.0,-9.0,0.0,0.0,0.0
<a href=/player/heatn001>heatn001</a>,Neal Heaton,Cleveland Indians,INDINS,1,1,1,2,1986,1986,0,No,0,1.85,-0.96,-2.81,21,13,-8,0,0,0,373.0,152.0,-221.0,310000.0,0.0,-310000.0
<a href=/player/heatn001>heatn001</a>,Neal Heaton,Minnesota Twins,TWINS,6,12,11,23,1987,2007,20,No,6,9.32,35.62,26.3,1101,1557,456,2383,5077,2694,2963.0,1837.0,-1126.0,103500.0,0.0,-103500.0
<a href=/player/heatn001>heatn001</a>,Neal Heaton,Montreal Expos,NATEX,1,1,1,2,1989,1989,0,No,0,2.05,0.17,-1.88,234,8,-226,109,0,-109,1086.0,14.0,-1072.0,0.0,0.0,0.0
<a href=/player/heatn001>heatn001</a>,Neal Heaton,Pittsburgh Pirates,PIRATS,1,1,1,2,1992,1992,0,No,0,0.15,0.19,0.04,31,16,-15,0,60,60,123.0,0.0,-123.0,0.0,0.0,0.0
<a href=/player/heatn002>heatn002</a>,Nick Heath,Kansas City Royals,ROYALS,1,1,1,2,2021,2021,0,Yes,0,-0.35,0.0,0.35,20,0,-20,39,0,-39,0.0,0.0,0.0,0.0,0.0,0.0
<a href=/player/heavd101>heavd101</a>,Dave Heaverlo,San Francisco Giants,GIANTS,4,14,8,22,1978,1992,14,No,0,8.18,23.62,15.44,767,1277,510,1656,1600,-56,2714.0,7759.0,5045.0,0.0,0.0,0.0
<a href=/player/hebew101>hebew101</a>,Wally Hebert,St.Louis Browns,ORLS,14,27,34,61,1933,1952,19,No,0,55.71,57.94,2.23,2756,6888,4132,8050,21355,13305,6789.0,12669.0,5880.0,138000.0,0.0,-138000.0
<a href=/player/hebnr001>hebnr001</a>,Richie Hebner,Philadelphia Phillies,PHILS,1,2,1,3,1979,1981,2,No,0,1.99,1.3,-0.69,173,122,-51,601,132,-469,0.0,1086.0,1086.0,0.0,0.0,0.0
<a href=/player/hebnr001>hebnr001</a>,Richie Hebner,New York Mets,METS,1,1,2,3,1979,1980,1,No,0,3.18,-0.2,-3.38,250,94,-156,851,216,-635,0.0,0.0,0.0,200000.0,0.0,-200000.0
<a href=/player/hecha001>hecha001</a>,Adeiny Hechavarria,Toronto Blue Jays,BJAYS,3,15,11,26,2012,2018,6,No,0,24.75,21.38,-3.37,2099,1087,-1012,5739,3162,-2577,4668.0,4579.0,-89.0,8732900.0,0.0,-8732900.0
<a href=/player/hecha001>hecha001</a>,Adeiny Hechavarria,Miami Marlins,MARLNS,1,1,2,3,2017,2018,1,Yes,0,0.91,0.0,-0.91,138,8,-130,518,18,-500,0.0,0.0,0.0,0.0,0.0,0.0
<a href=/player/hecha001>hecha001</a>,Adeiny Hechavarria,Tampa Bay Devil Rays,RAYS,1,2,1,3,2018,2018,0,Yes,0,0.0,0.0,0.0,15,0,-15,47,0,-47,0.0,0.0,0.0,5900000.0,0.0,-5900000.0
<a href=/player/hedga001>hedga001</a>,Austin Hedges,San Diego Padres,PADRS,2,7,4,11,2020,2021,1,Yes,0,3.34,0.62,-2.72,311,5,-306,892,4,-888,493.0,57.0,-436.0,3000000.0,0.0,-3000000.0
<a href=/player/hedlm101>hedlm101</a>,Mike Hedlund,Kansas City Royals,ROYALS,3,5,4,9,1972,1978,6,No,0,2.68,1.57,-1.11,438,256,-182,817,556,-261,955.0,645.0,-310.0,76000.0,0.0,-76000.0
<a href=/player/hedlm101>hedlm101</a>,Mike Hedlund,Cleveland Indians,INDINS,1,1,1,2,1974,1974,0,No,0,0.0,0.0,0.0,0,0,0,0,0,0,0.0,0.0,0.0,0.0,0.0,0.0
<a href=/player/hedlm101>hedlm101</a>,Mike Hedlund,Chicago White Sox,WSOX,6,9,8,17,1974,1985,11,No,1,12.65,6.39,-6.26,638,697,59,1614,2532,918,1538.0,190.0,-1348.0,0.0,0.0,0.0
<a href=/player/heepd001>heepd001</a>,Danny Heep,Houston Astros,ASTROS,1,1,1,2,1982,1982,0,No,0,0.98,0.0,-0.98,395,0,-395,1054,0,-1054,0.0,0.0,0.0,0.0,0.0,0.0
<a href=/player/heepd001>heepd001</a>,Danny Heep,Chicago White Sox,WSOX,1,1,1,2,1991,1991,0,No,0,0.14,0.0,-0.14,14,0,-14,13,0,-13,0.0,0.0,0.0,0.0,0.0,0.0
<a href=/player/heffb001>heffb001</a>,Bert Heffernan,Milwaukee Brewers,BREWRS,1,1,1,2,1990,1992,2,No,0,0.0,0.9,0.9,0,81,81,0,0,0,0.0,356.0,356.0,0.0,0.0,0.0
<a href=/player/heffd101>heffd101</a>,Don Heffner,New York Yankees,YANKS,2,3,2,5,1938,1948,10,No,0,-3.37,0.64,4.01,613,130,-483,2436,385,-2051,0.0,0.0,0.0,9000.0,0.0,-9000.0
<a href=/player/heffd101>heffd101</a>,Don Heffner,Philadelphia Athletics,ATLTCS,1,2,1,3,1943,1946,3,No,0,0.19,0.0,-0.19,648,0,-648,1982,0,-1982,0.0,0.0,0.0,6000.0,0.0,-6000.0
<a href=/player/heffd101>heffd101</a>,Don Heffner,Baltimore,Baltimore,1,1,4,5,1933,1946,13,No,0,0.88,0.0,-0.88,161,0,-161,586,0,-586,0.0,0.0,0.0,0.0,0.0,0.0
<a href=/player/hegaj101>hegaj101</a>,Jim Hegan,Cleveland Indians,INDINS,7,13,11,24,1958,1965,7,No,0,29.75,2.89,-26.86,2675,596,-2079,5199,1979,-3220,7620.0,347.0,-7273.0,7500.0,0.0,-7500.0
<a href=/player/hegaj101>hegaj101</a>,Jim Hegan,Detroit Tigers,TIGRS,1,1,2,3,1958,1958,0,No,0,-0.11,0.0,0.11,50,0,-50,120,0,-120,0.0,0.0,0.0,0.0,0.0,0.0
<a href=/player/heidj101>heidj101</a>,Jack Heidemann,Cleveland Indians,INDINS,20,30,42,72,1973,2011,38,No,4,72.79,84.56,11.77,3663,5000,1337,11714,16048,4334,6999.0,9590.0,2591.0,1767500.0,0.0,-1767500.0
<a href=/player/heidj101>heidj101</a>,Jack Heidemann,Cleveland Indians,INDINS,3,4,4,8,1974,1978,4,No,0,1.56,-1.53,-3.09,268,236,-32,879,466,-413,0.0,442.0,442.0,0.0,0.0,0.0
<a href=/player/heidj101>heidj101</a>,Jack Heidemann,St. Louis Cardinals,CARDS,4,5,5,10,1974,1977,3,No,0,-1.77,-0.4,1.37,404,34,-370,964,23,-941,66.0,23.0,-43.0,0.0,0.0,0.0
<a href=/player/heidj101>heidj101</a>,Jack Heidemann,New York Mets,METS,1,1,1,2,1976,1976,0,No,0,-1.01,0.0,1.01,74,0,-74,165,0,-165,0.0,0.0,0.0,0.0,0.0,0.0
<a href=/player/heila001>heila001</a>,Aaron Heilman,New York Mets,METS,1,7,3,10,2008,2010,2,No,0,8.89,-1.25,-10.14,554,358,-196,1346,179,-1167,2162.0,325.0,-1837.0,3398000.0,0.0,-3398000.0
<a href=/player/heila001>heila001</a>,Aaron Heilman,Seattle Mariners,MARNRS,3,7,5,12,2009,2011,2,No,0,0.86,0.54,-0.32,585,308,-277,1427,724,-703,217.0,686.0,469.0,5822500.0,0.0,-5822500.0
<a href=/player/heila001>heila001</a>,Aaron Heilman,Chicago Cubs,CUBS,1,1,2,3,2009,2012,3,No,0,-1.17,-0.04,1.13,197,79,-118,2,2,0,322.0,122.0,-200.0,1625000.0,0.0,-1625000.0
<a href=/player/heimf101>heimf101</a>,Fred Heimach,Philadelphia Athletics,ATLTCS,1,3,1,4,1926,1930,4,No,0,3.68,8.68,5.0,373,175,-198,792,208,-584,1683.0,1623.0,-60.0,10500.0,0.0,-10500.0
<a href=/player/heimf101>heimf101</a>,Fred Heimach,StPaul,StPaul,1,1,1,2,1928,1928,0,No,0,1.04,0.0,-1.04,102,0,-102,86,0,-86,608.0,0.0,-608.0,0.0,0.0,0.0
<a href=/player/heimf101>heimf101</a>,Fred Heimach,Boston Red Sox,RSOX,1,4,2,6,1926,1926,0,No,0,0.0,0.0,0.0,0,0,0,0,0,0,0.0,0.0,0.0,15750.0,0.0,-15750.0
<a href=/player/heimf101>heimf101</a>,Fred Heimach,Toledo,Toledo,1,1,2,3,1930,1930,0,No,0,0.99,0.0,-0.99,185,0,-185,141,0,-141,1021.0,0.0,-1021.0,0.0,0.0,0.0
<a href=/player/heimj001>heimj001</a>,Jonah Heim,Baltimore Orioles,ORLS,1,1,1,2,2016,2016,0,No,0,0.0,-0.03,-0.03,0,25,25,0,70,70,0.0,0.0,0.0,0.0,0.0,0.0
<a href=/player/heimj001>heimj001</a>,Jonah Heim,Tampa Bay Devil Rays,RAYS,1,1,1,2,2017,2017,0,Yes,0,0.07,0.0,-0.07,13,0,-13,41,0,-41,0.0,0.0,0.0,0.0,0.0,0.0
<a href=/player/heimj001>heimj001</a>,Jonah Heim,Oakland Athletics,ATLTCS,1,3,3,6,2021,2021,0,Yes,0,-0.26,0.18,0.44,104,178,74,346,635,289,0.0,0.0,0.0,0.0,0.0,0.0
<a href=/player/heinb101>heinb101</a>,Bud Heine,New York Giants,GIANTS,1,5,1,6,1922,1924,2,No,0,0.0,-0.65,-0.65,0,89,89,0,166,166,0.0,0.0,0.0,4200.0,0.0,-4200.0
<a href=/player/heins001>heins001</a>,Scott Heineman,Texas Rangers,RNGRS,1,1,1,2,2020,2020,0,Yes,0,-0.23,0.0,0.23,19,0,-19,34,0,-34,0.0,0.0,0.0,0.0,0.0,0.0
<a href=/player/heint101>heint101</a>,Tom Heintzelman,St. Louis Cardinals,CARDS,4,4,6,10,1974,1976,2,No,0,1.99,0.21,-1.78,308,64,-244,580,200,-380,606.0,0.0,-606.0,0.0,0.0,0.0
<a href=/player/heisa101>heisa101</a>,Al Heist,Milwaukee Braves,BRAVES,2,2,4,6,1960,1960,0,No,0,2.1,0.0,-2.1,160,0,-160,497,0,-497,0.0,0.0,0.0,0.0,0.0,0.0
<a href=/player/heisb101>heisb101</a>,Bob Heise,New York Mets,METS,3,5,4,9,1969,1977,8,No,0,-0.49,9.42,9.91,155,840,685,237,1612,1375,89.0,1792.0,1703.0,0.0,0.0,0.0
<a href=/player/heisb101>heisb101</a>,Bob Heise,San Francisco Giants,GIANTS,1,1,1,2,1971,1971,0,No,0,1.33,-0.19,-1.52,212,9,-203,598,24,-574,0.0,0.0,0.0,0.0,0.0,0.0
<a href=/player/heisb101>heisb101</a>,Bob Heise,Milwaukee Brewers,BREWRS,3,5,3,8,1973,1976,3,No,0,3.54,3.53,-0.01,545,209,-336,1815,221,-1594,335.0,641.0,306.0,150000.0,0.0,-150000.0
<a href=/player/heisb101>heisb101</a>,Bob Heise,St. Louis Cardinals,CARDS,2,2,2,4,1974,1976,2,No,0,0.01,-0.08,-0.09,68,33,-35,182,74,-108,0.0,0.0,0.0,0.0,0.0,0.0
<a href=/player/heisb101>heisb101</a>,Bob Heise,California Angels,ANGELS,1,1,1,2,1974,1975,1,No,0,-0.35,0.24,0.59,95,89,-6,199,332,133,0.0,0.0,0.0,0.0,0.0,0.0
<a href=/player/heisc001>heisc001</a>,Chris Heisey,Cincinnati Reds,REDS,1,1,1,2,2014,2015,1,No,0,0.21,0.0,-0.21,33,0,-33,72,0,-72,0.0,0.0,0.0,1760000.0,0.0,-1760000.0
<a href=/player/heisc001>heisc001</a>,Chris Heisey,Toronto Blue Jays,BJAYS,1,1,1,2,2015,2015,0,No,0,0.21,0.0,-0.21,33,0,-33,72,0,-72,0.0,0.0,0.0,0.0,0.0,0.0
<a href=/player/heisr001>heisr001</a>,Rick Heiserman,Cleveland Indians,INDINS,1,3,1,4,1995,1995,0,No,0,-1.28,1.44,2.72,177,12,-165,474,0,-474,13.0,224.0,211.0,0.0,0.0,0.0
<a href=/player/heldw101>heldw101</a>,Woodie Held,New York Yankees,YANKS,3,9,7,16,1957,1962,5,No,0,10.27,3.25,-7.02,1508,714,-794,3698,610,-3088,2854.0,1762.0,-1092.0,12500.0,0.0,-12500.0
<a href=/player/heldw101>heldw101</a>,Woodie Held,Kansas City Athletics,ATLTCS,24,48,46,94,1958,1976,18,No,0,124.94,48.67,-76.27,9659,5527,-4132,26702,16658,-10044,8728.0,3973.0,-4755.0,440600.0,0.0,-440600.0
<a href=/player/heldw101>heldw101</a>,Woodie Held,Cleveland Indians,INDINS,11,17,17,34,1964,1984,20,No,0,50.19,18.25,-31.94,3277,3447,170,11873,12142,269,38.0,317.0,279.0,210250.0,0.0,-210250.0
<a href=/player/heldw101>heldw101</a>,Woodie Held,Washington Senators,RNGRS,1,1,1,2,1965,1969,4,No,0,0.38,-0.18,-0.56,82,15,-67,145,24,-121,0.0,0.0,0.0,20000.0,0.0,-20000.0
<a href=/player/heldw101>heldw101</a>,Woodie Held,Baltimore Orioles,ORLS,14,29,26,55,1967,1994,27,No,3,51.88,93.32,41.44,3254,4791,1537,7327,11682,4355,12206.0,14416.0,2210.0,846833.0,0.0,-846833.0
<a href=/player/heldw101>heldw101</a>,Woodie Held,California Angels,ANGELS,1,1,1,2,1968,1968,0,No,0,-1.02,-0.3,0.72,96,4,-92,141,11,-130,0.0,0.0,0.0,0.0,0.0,0.0
<a href=/player/helfe001>helfe001</a>,Eric Helfand,Florida Marlins,MARLNS,3,4,3,7,1992,2001,9,No,1,-0.58,0.34,0.92,97,427,330,164,711,547,385.0,1278.0,893.0,265000.0,0.0,-265000.0
<a href=/player/hellb001>hellb001</a>,Ben Heller,Cleveland Indians,INDINS,1,4,1,5,2016,2018,2,No,0,0.85,4.57,3.72,262,129,-133,807,2,-805,102.0,377.0,275.0,0.0,0.0,0.0
<a href=/player/hellj001>hellj001</a>,Jeremy Hellickson,Tampa Bay Devil Rays,RAYS,4,7,8,15,2014,2020,6,Yes,0,6.74,6.5,-0.24,692,250,-442,1729,992,-737,781.0,0.0,-781.0,7725000.0,0.0,-7725000.0
<a href=/player/hellj001>hellj001</a>,Jeremy Hellickson,Arizona Diamondbacks,DBACKS,2,5,3,8,2015,2019,4,Yes,0,3.76,-0.4,-4.16,168,72,-96,105,272,167,1136.0,0.0,-1136.0,4275000.0,0.0,-4275000.0
<a href=/player/hellj001>hellj001</a>,Jeremy Hellickson,Philadelphia Phillies,PHILS,2,2,4,6,2017,2020,3,Yes,0,-0.71,-0.92,-0.21,53,41,-12,3,97,94,209.0,2.0,-207.0,17200000.0,0.0,-17200000.0
<a href=/player/hellj002>hellj002</a>,Johnny Hellweg,Anaheim Angels,ANGELS,1,3,1,4,2012,2012,0,No,0,4.26,1.47,-2.79,508,13,-495,1945,0,-1945,179.0,268.0,89.0,0.0,0.0,0.0
<a href=/player/hellr001>hellr001</a>,Rick Helling,Texas Rangers,RNGRS,1,2,1,3,1996,1999,3,No,0,5.47,5.31,-0.16,331,108,-223,288,10,-278,2639.0,1801.0,-838.0,0.0,0.0,0.0
<a href=/player/hellr001>hellr001</a>,Rick Helling,Florida Marlins,MARLNS,2,2,2,4,1997,1997,0,No,0,12.86,-0.08,-12.94,185,33,-152,20,0,-20,2795.0,36.0,-2759.0,0.0,0.0,0.0
<a href=/player/helmt101>helmt101</a>,Tommy Helms,Cincinnati Reds,REDS,7,9,14,23,1971,1982,11,No,1,32.36,75.99,43.63,1555,3237,1682,4173,10169,5996,5915.0,4444.0,-1471.0,0.0,0.0,0.0
<a href=/player/helmt101>helmt101</a>,Tommy Helms,Houston Astros,ASTROS,1,1,1,2,1975,1983,8,No,0,0.23,13.73,13.5,77,706,629,116,2543,2427,0.0,0.0,0.0,0.0,0.0,0.0
<a href=/player/helmt101>helmt101</a>,Tommy Helms,Oakland Athletics,ATLTCS,5,10,14,24,1977,1991,14,No,0,17.32,67.59,50.27,1802,3570,1768,5305,11715,6410,956.0,6372.0,5416.0,0.0,0.0,0.0
<a href=/player/helmw001>helmw001</a>,Wes Helms,Atlanta Braves,BRAVES,3,7,4,11,2002,2005,3,No,0,48.76,10.76,-38.0,1789,404,-1385,2230,926,-1304,9304.0,204.0,-9100.0,4218000.0,0.0,-4218000.0
<a href=/player/hemar101>hemar101</a>,Russ Heman,Chicago White Sox,WSOX,15,26,28,54,1957,1969,12,No,0,18.37,37.27,18.9,2207,3220,1013,3806,5515,1709,4631.0,7668.0,3037.0,148250.0,0.0,-148250.0
<a href=/player/hemar101>hemar101</a>,Russ Heman,Baltimore Orioles,ORLS,1,2,1,3,1958,1959,1,No,0,0.11,-0.65,-0.76,12,20,8,1,51,50,30.0,0.0,-30.0,0.0,0.0,0.0
<a href=/player/hemar101>hemar101</a>,Russ Heman,Los Angeles Angels,ANGELS,5,8,7,15,1961,1968,7,No,0,-0.68,8.55,9.23,319,809,490,434,2503,2069,443.0,1270.0,827.0,44000.0,0.0,-44000.0
<a href=/player/hembh001>hembh001</a>,Heath Hembree,San Francisco Giants,GIANTS,1,2,2,4,2014,2016,2,No,0,2.1,2.59,0.49,267,120,-147,1,96,95,779.0,924.0,145.0,0.0,0.0,0.0
<a href=/player/hembh001>hembh001</a>,Heath Hembree,Boston Red Sox,RSOX,1,2,2,4,2020,2020,0,Yes,0,-0.87,0.58,1.45,25,2,-23,0,0,0,67.0,30.0,-37.0,5113000.0,0.0,-5113000.0
<a href=/player/hemmg101>hemmg101</a>,George Hemming,Louisville Colonels,LS3,2,2,3,5,1894,1896,2,No,0,9.1,-1.54,-10.64,142,98,-44,251,162,-89,1560.0,960.0,-600.0,0.0,0.0,0.0
<a href=/player/hempc101>hempc101</a>,Charlie Hemphill,St.Louis Browns,ORLS,1,3,3,6,1907,1907,0,No,0,6.22,0.0,-6.22,491,0,-491,1891,0,-1891,92.0,0.0,-92.0,0.0,0.0,0.0
<a href=/player/hemsr101>hemsr101</a>,Rollie Hemsley,Pittsburgh Pirates,PIRATS,3,6,4,10,1931,1941,10,No,0,12.78,6.86,-5.92,596,859,263,1202,3007,1805,2406.0,0.0,-2406.0,0.0,0.0,0.0
<a href=/player/hemsr101>hemsr101</a>,Rollie Hemsley,Chicago Cubs,CUBS,2,7,3,10,1932,1941,9,No,0,3.2,27.52,24.32,621,896,275,1233,2014,781,2473.0,4458.0,1985.0,0.0,0.0,0.0
<a href=/player/hemsr101>hemsr101</a>,Rollie Hemsley,Cincinnati Reds,REDS,1,1,1,2,1933,1933,0,No,0,1.68,-0.03,-1.71,515,10,-505,1932,18,-1914,0.0,0.0,0.0,5500.0,0.0,-5500.0
<a href=/player/hemsr101>hemsr101</a>,Rollie Hemsley,St.Louis Browns,ORLS,5,7,8,15,1938,1947,9,No,0,4.92,12.88,7.96,708,1136,428,2349,3276,927,122.0,1515.0,1393.0,19500.0,0.0,-19500.0
<a href=/player/hemus101>hemus101</a>,Solly Hemus,St. Louis Cardinals,CARDS,4,8,7,15,1956,1963,7,No,0,12.2,1.13,-11.07,1451,761,-690,4917,2013,-2904,89.0,111.0,22.0,0.0,0.0,0.0
<a href=/player/hemus101>hemus101</a>,Solly Hemus,Philadelphia Phillies,PHILS,6,10,10,20,1958,1984,26,No,0,32.08,55.89,23.81,1870,3393,1523,6865,8385,1520,0.0,2963.0,2963.0,0.0,0.0,0.0
<a href=/player/hendb001>hendb001</a>,Ben Hendrickson,Milwaukee Brewers,BREWRS,1,1,1,2,2007,2007,0,No,0,0.0,0.0,0.0,0,0,0,0,0,0,0.0,0.0,0.0,0.0,0.0,0.0
<a href=/player/hendb101>hendb101</a>,Bob Hendley,Milwaukee Braves,BRAVES,10,14,18,32,1963,1973,10,No,0,11.77,26.43,14.66,1218,1711,493,2811,4870,2059,2257.0,2054.0,-203.0,95000.0,0.0,-95000.0
<a href=/player/hendb101>hendb101</a>,Bob Hendley,San Francisco Giants,GIANTS,3,5,4,9,1965,1968,3,No,0,-1.4,-0.01,1.39,272,250,-22,397,696,299,492.0,0.0,-492.0,33000.0,0.0,-33000.0
<a href=/player/hendb101>hendb101</a>,Bob Hendley,Chicago Cubs,CUBS,2,2,3,5,1967,1968,1,No,0,-0.02,-0.38,-0.36,40,74,34,24,62,38,220.0,135.0,-85.0,0.0,0.0,0.0
<a href=/player/hendd001>hendd001</a>,Dave Henderson,Boston Red Sox,RSOX,1,1,1,2,1987,1991,4,No,0,0.22,0.58,0.36,15,159,144,29,277,248,0.0,0.0,0.0,525000.0,0.0,-525000.0
<a href=/player/hendd001>hendd001</a>,Dave Henderson,Seattle Mariners,MARNRS,3,5,8,13,1986,1989,3,No,0,0.54,-0.06,-0.6,445,432,-13,1461,1346,-115,0.0,625.0,625.0,215000.0,0.0,-215000.0
<a href=/player/hendd101>hendd101</a>,Don Hendrickson,Milwaukee,Milwaukee,1,1,2,3,1945,1945,0,No,0,-0.75,0.0,0.75,78,0,-78,20,0,-20,226.0,0.0,-226.0,0.0,0.0,0.0
<a href=/player/hende103>hende103</a>,Elrod Hendricks,Baltimore Orioles,ORLS,1,1,1,2,1972,1976,4,No,0,-0.19,2.39,2.58,17,437,420,56,1839,1783,0.0,0.0,0.0,0.0,0.0,0.0
<a href=/player/hende103>hende103</a>,Elrod Hendricks,Chicago Cubs,CUBS,1,1,1,2,1972,1972,0,No,0,1.22,0.0,-1.22,267,0,-267,762,0,-762,7.0,0.0,-7.0,0.0,0.0,0.0
<a href=/player/hende103>hende103</a>,Elrod Hendricks,Baltimore Orioles,ORLS,10,21,19,40,1976,1994,18,No,3,48.77,85.06,36.29,2260,4349,2089,4427,10615,6188,10756.0,13691.0,2935.0,713333.0,0.0,-713333.0
<a href=/player/hendg001>hendg001</a>,George Hendrick,Oakland Athletics,ATLTCS,1,2,2,4,1973,1975,2,No,0,10.02,2.05,-7.97,777,294,-483,3090,901,-2189,0.0,0.0,0.0,0.0,0.0,0.0
<a href=/player/hendg001>hendg001</a>,George Hendrick,Cleveland Indians,INDINS,16,24,35,59,1976,2011,35,No,4,68.98,66.71,-2.27,3085,3663,578,9946,11572,1626,6797.0,8106.0,1309.0,1767500.0,0.0,-1767500.0
<a href=/player/hendg001>hendg001</a>,George Hendrick,San Diego Padres,PADRS,1,1,1,2,1978,1981,3,No,0,17.95,1.7,-16.25,893,225,-668,3664,126,-3538,0.0,1243.0,1243.0,0.0,0.0,0.0
<a href=/player/hendg001>hendg001</a>,George Hendrick,St. Louis Cardinals,CARDS,2,3,3,6,1984,1992,8,No,0,-0.07,18.07,18.14,99,753,654,295,2368,2073,200.0,2206.0,2006.0,1100000.0,0.0,-1100000.0
<a href=/player/hendg001>hendg001</a>,George Hendrick,Pittsburgh Pirates,PIRATS,4,8,9,17,1985,2001,16,No,2,9.24,22.17,12.93,548,1655,1107,771,2230,1459,2669.0,7059.0,4390.0,1290000.0,0.0,-1290000.0
<a href=/player/hendh101>hendh101</a>,Harvey Hendrick,Boston Red Sox,RSOX,1,2,2,4,1923,1927,4,No,0,9.14,-0.1,-9.24,571,74,-497,688,223,-465,4054.0,0.0,-4054.0,0.0,0.0,0.0
<a href=/player/hendh101>hendh101</a>,Harvey Hendrick,Brooklyn Dodgers,DOGRS,1,1,1,2,1931,1932,1,No,0,3.96,0.0,-3.96,231,0,-231,1021,0,-1021,0.0,0.0,0.0,0.0,0.0,0.0
<a href=/player/hendh101>hendh101</a>,Harvey Hendrick,Cincinnati Reds,REDS,1,3,1,4,1932,1932,0,No,0,-0.61,2.05,2.66,32,83,51,78,279,201,9.0,0.0,-9.0,0.0,0.0,0.0
<a href=/player/hendh101>hendh101</a>,Harvey Hendrick,Chicago Cubs,CUBS,3,10,4,14,1933,1938,5,No,0,12.44,14.42,1.98,1291,484,-807,2611,1630,-981,3141.0,1054.0,-2087.0,10000.0,0.0,-10000.0
<a href=/player/hendj102>hendj102</a>,Joe Henderson,UnionLaguna,UnionLaguna,1,1,1,2,1971,1971,0,No,0,-0.56,0.0,0.56,6,0,-6,1,0,-1,45.0,0.0,-45.0,0.0,0.0,0.0
<a href=/player/hendk001>hendk001</a>,Kyle Hendricks,Texas Rangers,RNGRS,1,2,1,3,2012,2012,0,No,0,22.27,0.17,-22.1,395,12,-383,404,0,-404,3685.0,207.0,-3478.0,0.0,0.0,0.0
<a href=/player/hendk101>hendk101</a>,Ken Henderson,San Francisco Giants,GIANTS,1,2,1,3,1972,1976,4,No,0,13.25,-0.15,-13.4,475,156,-319,1568,147,-1421,1787.0,1201.0,-586.0,0.0,0.0,0.0
<a href=/player/hendk101>hendk101</a>,Ken Henderson,Chicago White Sox,WSOX,5,8,7,15,1975,1985,10,No,1,12.65,5.98,-6.67,638,673,35,1614,2532,918,1538.0,16.0,-1522.0,0.0,0.0,0.0
<a href=/player/hendk101>hendk101</a>,Ken Henderson,Atlanta Braves,BRAVES,3,8,3,11,1976,1983,7,No,0,3.71,6.12,2.41,495,566,71,1015,2078,1063,923.0,87.0,-836.0,33500.0,0.0,-33500.0
<a href=/player/hendk101>hendk101</a>,Ken Henderson,Texas Rangers,RNGRS,4,9,7,16,1978,1988,10,No,0,6.15,29.07,22.92,381,2027,1646,1490,7192,5702,0.0,2974.0,2974.0,0.0,0.0,0.0
<a href=/player/hendk101>hendk101</a>,Ken Henderson,New York Mets,METS,1,1,1,2,1978,1979,1,No,0,-1.12,-0.76,0.36,74,222,148,182,17,-165,0.0,550.0,550.0,0.0,0.0,0.0
<a href=/player/hendl001>hendl001</a>,Liam Hendriks,Toronto Blue Jays,BJAYS,1,2,1,3,2014,2015,1,No,0,-0.13,0.39,0.52,23,108,85,36,338,302,58.0,0.0,-58.0,510200.0,0.0,-510200.0
<a href=/player/hendl001>hendl001</a>,Liam Hendriks,Kansas City Royals,ROYALS,1,1,1,2,2014,2014,0,Yes,0,0.95,0.0,-0.95,67,0,-67,1,0,-1,234.0,0.0,-234.0,0.0,0.0,0.0
<a href=/player/hendl001>hendl001</a>,Liam Hendriks,Toronto Blue Jays,BJAYS,2,2,2,4,2015,2017,2,No,0,5.97,-0.48,-6.45,306,55,-251,0,0,0,866.0,248.0,-618.0,518400.0,0.0,-518400.0
<a href=/player/hendm001>hendm001</a>,Mark Hendrickson,Toronto Blue Jays,BJAYS,2,3,3,6,2003,2016,13,No,2,2.32,10.83,8.51,81,547,466,13,7,-6,1354.0,2529.0,1175.0,302000.0,0.0,-302000.0
<a href=/player/hendm001>hendm001</a>,Mark Hendrickson,Tampa Bay Devil Rays,RAYS,1,3,3,6,2006,2012,6,No,0,-0.07,1.99,2.06,130,586,456,113,1881,1768,593.0,426.0,-167.0,4200000.0,0.0,-4200000.0
<a href=/player/hendr001>hendr001</a>,Rickey Henderson,Oakland Athletics,ATLTCS,9,18,16,34,1984,1998,14,No,2,132.59,51.65,-80.94,4207,2470,-1737,7421,6370,-1051,13842.0,8807.0,-5035.0,6670419.0,0.0,-6670419.0
<a href=/player/hendr001>hendr001</a>,Rickey Henderson,New York Yankees,YANKS,2,2,5,7,1989,1993,4,No,0,40.86,6.16,-34.7,1473,539,-934,6340,354,-5986,0.0,2795.0,2795.0,2320000.0,0.0,-2320000.0
<a href=/player/hendr001>hendr001</a>,Rickey Henderson,Oakland Athletics,ATLTCS,2,2,3,5,1993,1998,5,No,0,6.81,2.33,-4.48,216,232,16,204,423,219,669.0,771.0,102.0,3710000.0,0.0,-3710000.0
<a href=/player/hendr001>hendr001</a>,Rickey Henderson,San Diego Padres,PADRS,1,1,3,4,1997,1999,2,No,0,-0.13,-0.12,0.01,32,86,54,144,233,89,0.0,0.0,0.0,3045000.0,0.0,-3045000.0
<a href=/player/hends001>hends001</a>,Steve Henderson,Cincinnati Reds,REDS,3,6,5,11,1977,1990,13,No,0,13.19,18.54,5.35,1751,636,-1115,5361,1105,-4256,2918.0,3754.0,836.0,450000.0,0.0,-450000.0
<a href=/player/hends001>hends001</a>,Steve Henderson,New York Mets,METS,1,2,1,3,1981,1984,3,No,0,0.81,-0.14,-0.95,174,349,175,620,1292,672,0.0,0.0,0.0,0.0,0.0,0.0
<a href=/player/hends001>hends001</a>,Steve Henderson,Chicago Cubs,CUBS,3,8,5,13,1982,1987,5,No,0,4.49,1.16,-3.33,677,463,-214,1666,378,-1288,766.0,1115.0,349.0,873333.0,0.0,-873333.0
<a href=/player/hendt101>hendt101</a>,Tim Hendryx,Cleveland Indians,INDINS,1,6,1,7,1913,1914,1,No,0,0.0,-0.98,-0.98,0,48,48,0,37,37,0.0,303.0,303.0,0.0,0.0,0.0
<a href=/player/hendt101>hendt101</a>,Tim Hendryx,New York Yankees,YANKS,1,1,1,2,1918,1918,0,No,0,1.37,0.0,-1.37,88,0,-88,268,0,-268,0.0,0.0,0.0,0.0,0.0,0.0
<a href=/player/hendt101>hendt101</a>,Tim Hendryx,Louisville,Louisville,1,1,2,3,1920,1920,0,No,0,1.94,0.0,-1.94,148,0,-148,589,0,-589,0.0,0.0,0.0,0.0,0.0,0.0
<a href=/player/hengd001>hengd001</a>,Dave Hengel,Seattle Mariners,MARNRS,1,1,1,2,1989,1989,0,No,0,-0.55,0.0,0.55,12,0,-12,29,0,-29,0.0,0.0,0.0,0.0,0.0,0.0
<a href=/player/henlb101>henlb101</a>,Butch Henline,New York Giants,GIANTS,1,3,1,4,1921,1926,5,No,0,11.79,12.89,1.1,909,765,-144,3326,3232,-94,0.0,0.0,0.0,5400.0,0.0,-5400.0
<a href=/player/henlb101>henlb101</a>,Butch Henline,Philadelphia Phillies,PHILS,6,14,12,26,1927,1941,14,No,0,16.64,29.99,13.35,1563,2406,843,5836,6892,1056,324.0,5521.0,5197.0,17000.0,0.0,-17000.0
<a href=/player/henlb101>henlb101</a>,Butch Henline,Indianapolis,Indianapolis,1,1,3,4,1920,1920,0,No,0,0.0,0.0,0.0,1,0,-1,1,0,-1,0.0,0.0,0.0,0.0,0.0,0.0
<a href=/player/henlg101>henlg101</a>,Gail Henley,New York Giants,GIANTS,2,5,2,7,1952,1957,5,No,0,0.0,2.01,2.01,0,290,290,0,53,53,0.0,810.0,810.0,0.0,0.0,0.0
<a href=/player/henlg101>henlg101</a>,Gail Henley,Cincinnati Reds,REDS,1,3,1,4,1952,1961,9,No,0,1.64,13.15,11.51,150,1235,1085,601,5109,4508,0.0,0.0,0.0,0.0,0.0,0.0
<a href=/player/hennm001>hennm001</a>,Mike Henneman,Detroit Tigers,TIGRS,2,3,2,5,1995,1997,2,No,0,-0.45,0.07,0.52,379,160,-219,1117,518,-599,63.0,0.0,-63.0,5561334.0,0.0,-5561334.0
<a href=/player/hennp102>hennp102</a>,Phil Hennigan,Cleveland Indians,INDINS,2,3,3,6,1972,1974,2,No,0,0.38,-0.69,-1.07,186,38,-148,124,0,-124,1173.0,500.0,-673.0,19000.0,0.0,-19000.0
<a href=/player/henrb001>henrb001</a>,Butch Henry,Cincinnati Reds,REDS,1,3,1,4,1990,1993,3,No,0,-0.24,2.7,2.94,60,260,200,65,933,868,497.0,0.0,-497.0,104000.0,0.0,-104000.0
<a href=/player/henrb001>henrb001</a>,Butch Henry,Colorado Rockies,ROCKS,1,1,1,2,1993,1994,1,No,0,6.83,0.25,-6.58,110,58,-52,89,30,-59,757.0,304.0,-453.0,152000.0,0.0,-152000.0
<a href=/player/henrb101>henrb101</a>,Bill Henry,Boston Red Sox,RSOX,1,1,2,3,1957,1959,2,No,0,6.99,0.0,-6.99,218,0,-218,52,0,-52,646.0,0.0,-646.0,0.0,0.0,0.0
<a href=/player/henrb101>henrb101</a>,Bill Henry,Chicago Cubs,CUBS,3,5,4,9,1959,1961,2,No,0,8.16,-0.89,-9.05,620,173,-447,633,602,-31,802.0,0.0,-802.0,0.0,0.0,0.0
<a href=/player/henrb101>henrb101</a>,Bill Henry,Cincinnati Reds,REDS,1,1,1,2,1965,1965,0,No,0,1.98,0.23,-1.75,210,44,-166,8,8,0,272.0,133.0,-139.0,0.0,0.0,0.0
<a href=/player/henrb102>henrb102</a>,Bill Henry,New York Yankees,YANKS,1,1,1,2,1967,1967,0,No,0,0.0,0.0,0.0,0,0,0,0,0,0,0.0,0.0,0.0,0.0,0.0,0.0
<a href=/player/henrd001>henrd001</a>,Dwayne Henry,Texas Rangers,RNGRS,1,1,2,3,1989,1989,0,No,0,-0.48,0.0,0.48,92,0,-92,0,0,0,153.0,0.0,-153.0,0.0,0.0,0.0
<a href=/player/henrd002>henrd002</a>,Doug Henry,Milwaukee Brewers,BREWRS,4,6,10,16,1994,2004,10,No,0,6.52,10.48,3.96,931,1120,189,2233,2248,15,782.0,1056.0,274.0,3880000.0,0.0,-3880000.0
<a href=/player/henrd002>henrd002</a>,Doug Henry,Houston Astros,ASTROS,1,1,1,2,2000,2003,3,No,0,0.32,0.17,-0.15,54,96,42,0,10,10,76.0,228.0,152.0,800000.0,0.0,-800000.0
<a href=/player/henrd101>henrd101</a>,Dutch Henry,St.Louis Browns,ORLS,30,57,63,120,1923,1952,29,No,0,152.74,143.26,-9.48,7550,11363,3813,22650,31782,9132,19168.0,30694.0,11526.0,281100.0,0.0,-281100.0
<a href=/player/henrd101>henrd101</a>,Dutch Henry,Cincinnati Reds,REDS,4,7,8,15,1933,1943,10,No,0,2.09,48.62,46.53,936,2007,1071,3163,5265,2102,264.0,8479.0,8215.0,23000.0,0.0,-23000.0
<a href=/player/henro001>henro001</a>,Oscar Henriquez,Houston Astros,ASTROS,1,3,1,4,1997,2001,4,No,0,-0.79,11.75,12.54,34,421,387,1,1777,1776,68.0,0.0,-68.0,0.0,0.0,0.0
<a href=/player/henro001>henro001</a>,Oscar Henriquez,Florida Marlins,MARLNS,1,1,1,2,1998,1999,1,No,0,0.0,0.41,0.41,0,82,82,0,260,260,0.0,0.0,0.0,170000.0,0.0,-170000.0
<a href=/player/henro101>henro101</a>,Olaf Henriksen,Brockton,Brockton,1,2,4,6,1911,1911,0,No,0,1.67,0.0,-1.67,331,0,-331,645,0,-645,0.0,0.0,0.0,0.0,0.0,0.0
<a href=/player/henrp001>henrp001</a>,Payton Henry,Milwaukee Brewers,BREWRS,1,1,1,2,2021,2021,0,Yes,0,0.02,-0.78,-0.8,5,12,7,16,0,-16,0.0,13.0,13.0,0.0,0.0,0.0
<a href=/player/henrs101>henrs101</a>,Snake Henry,Philadelphia Phillies,PHILS,5,11,9,20,1921,1936,15,No,0,25.37,1.11,-24.26,1352,2193,841,5364,9288,3924,77.0,0.0,-77.0,43100.0,0.0,-43100.0
<a href=/player/hensc002>hensc002</a>,Clay Hensley,San Francisco Giants,GIANTS,2,4,2,6,2003,2005,2,No,0,1.57,0.05,-1.52,224,233,9,81,2,-79,995.0,364.0,-631.0,1600000.0,0.0,-1600000.0
<a href=/player/hensd001>hensd001</a>,Drew Henson,New York Yankees,YANKS,4,12,6,18,2000,2007,7,No,2,5.36,3.85,-1.51,689,111,-578,203,14,-189,3035.0,1602.0,-1433.0,4387150.0,0.0,-4387150.0
<a href=/player/hensd001>hensd001</a>,Drew Henson,Cincinnati Reds,REDS,2,3,3,6,2001,2013,12,No,0,-0.92,19.24,20.16,177,833,656,524,1510,986,0.0,5071.0,5071.0,0.0,0.0,0.0
<a href=/player/hensr101>hensr101</a>,Roy Henshaw,Chicago Cubs,CUBS,1,2,1,3,1936,1938,2,No,0,-0.75,0.91,1.66,248,78,-170,579,238,-341,469.0,0.0,-469.0,0.0,0.0,0.0
<a href=/player/hensr101>hensr101</a>,Roy Henshaw,Brooklyn Dodgers,DOGRS,1,4,1,5,1937,1944,7,No,0,1.9,1.11,-0.79,125,343,218,330,1190,860,390.0,0.0,-390.0,10000.0,0.0,-10000.0
<a href=/player/hentp001>hentp001</a>,Pat Hentgen,Toronto Blue Jays,BJAYS,3,5,8,13,1999,2001,2,No,0,2.96,-0.34,-3.3,81,293,212,74,474,400,885.0,431.0,-454.0,8600000.0,0.0,-8600000.0
<a href=/player/herbf101>herbf101</a>,Fred Herbert,Chicago Cubs,CUBS,1,1,2,3,1913,1913,0,No,0,0.0,0.34,0.34,0,4,4,0,7,7,0.0,15.0,15.0,0.0,0.0,0.0
<a href=/player/herbr101>herbr101</a>,Ray Herbert,Kansas City Athletics,ATLTCS,19,40,34,74,1961,1976,15,No,0,67.84,34.29,-33.55,6835,3922,-2913,16048,11060,-4988,8728.0,3414.0,-5314.0,393100.0,0.0,-393100.0
<a href=/player/herbr101>herbr101</a>,Ray Herbert,Chicago White Sox,WSOX,3,4,4,8,1964,1969,5,No,0,5.43,1.58,-3.85,657,600,-57,2273,1624,-649,543.0,0.0,-543.0,26500.0,0.0,-26500.0
<a href=/player/herbr102>herbr102</a>,Ron Herbel,San Francisco Giants,GIANTS,1,3,1,4,1969,1969,0,No,0,1.07,0.0,-1.07,369,0,-369,821,0,-821,333.0,0.0,-333.0,0.0,0.0,0.0
<a href=/player/herbr102>herbr102</a>,Ron Herbel,San Diego Padres,PADRS,1,1,1,2,1970,1970,0,No,0,0.52,0.0,-0.52,24,0,-24,0,0,0,39.0,0.0,-39.0,0.0,0.0,0.0
<a href=/player/herbr102>herbr102</a>,Ron Herbel,New York Mets,METS,1,1,1,2,1970,1971,1,No,0,-0.11,-1.27,-1.16,50,104,54,11,377,366,155.0,0.0,-155.0,0.0,0.0,0.0
<a href=/player/heref001>heref001</a>,Felix Heredia,Florida Marlins,MARLNS,10,20,24,44,1998,2019,21,Yes,0,61.27,65.42,4.15,2318,3439,1121,4579,11330,6751,9272.0,5140.0,-4132.0,30092000.0,0.0,-30092000.0
<a href=/player/heref001>heref001</a>,Felix Heredia,Chicago Cubs,CUBS,3,10,5,15,2001,2009,8,No,0,12.08,11.04,-1.04,698,868,170,2292,2781,489,413.0,718.0,305.0,6900000.0,0.0,-6900000.0
<a href=/player/heref001>heref001</a>,Felix Heredia,New York Yankees,YANKS,1,1,1,2,2004,2005,1,No,0,0.11,-0.09,-0.2,6,33,27,0,0,0,8.0,42.0,34.0,1800000.0,0.0,-1800000.0
<a href=/player/hereg001>hereg001</a>,Gil Heredia,San Francisco Giants,GIANTS,1,1,1,2,1992,1992,0,No,0,3.14,0.0,-3.14,212,0,-212,75,0,-75,799.0,0.0,-799.0,115000.0,0.0,-115000.0
<a href=/player/hereg001>hereg001</a>,Gil Heredia,Montreal Expos,NATEX,1,1,2,3,1997,1997,0,No,0,0.0,0.0,0.0,0,0,0,0,0,0,0.0,0.0,0.0,0.0,0.0,0.0
<a href=/player/hereg002>hereg002</a>,Guillermo Heredia,Seattle Mariners,MARNRS,1,3,2,5,2018,2020,2,Yes,0,3.75,-0.48,-4.23,316,148,-168,979,613,-366,0.0,0.0,0.0,2975000.0,0.0,-2975000.0
<a href=/player/herew001>herew001</a>,Wilson Heredia,Texas Rangers,RNGRS,1,2,1,3,1995,1998,3,No,0,0.0,3.86,3.86,0,95,95,0,7,7,0.0,1618.0,1618.0,109000.0,0.0,-109000.0
<a href=/player/hergm001>hergm001</a>,Matt Herges,Los Angeles Dodgers,DOGRS,3,8,7,15,2002,2008,6,No,0,2.91,17.96,15.05,743,864,121,1634,1120,-514,515.0,2722.0,2207.0,9106667.0,0.0,-9106667.0
<a href=/player/hergm001>hergm001</a>,Matt Herges,Montreal Expos,NATEX,2,3,4,7,2002,2004,2,No,0,3.6,-0.83,-4.43,40,55,15,5,159,154,603.0,0.0,-603.0,370000.0,0.0,-370000.0
<a href=/player/hergm001>hergm001</a>,Matt Herges,San Diego Padres,PADRS,1,1,2,3,2003,2008,5,No,0,0.05,2.04,1.99,233,211,-22,2,81,79,364.0,971.0,607.0,0.0,0.0,0.0
<a href=/player/hergm001>hergm001</a>,Matt Herges,San Francisco Giants,GIANTS,1,2,1,3,2005,2005,0,No,0,-0.47,0.0,0.47,13,0,-13,0,0,0,24.0,0.0,-24.0,1600000.0,0.0,-1600000.0
<a href=/player/hermb101>hermb101</a>,Billy Herman,Chicago Cubs,CUBS,1,1,3,4,1941,1946,5,No,0,12.92,-1.47,-14.39,488,186,-302,2125,448,-1677,0.0,0.0,0.0,0.0,0.0,0.0
<a href=/player/hermb101>hermb101</a>,Billy Herman,Brooklyn Dodgers,DOGRS,1,1,1,2,1946,1946,0,No,0,2.56,0.0,-2.56,75,0,-75,301,0,-301,0.0,0.0,0.0,20000.0,0.0,-20000.0
<a href=/player/hermb101>hermb101</a>,Billy Herman,Boston Braves,BRAVES,4,7,6,13,1946,1952,6,No,0,-0.23,24.56,24.79,358,848,490,547,3228,2681,596.0,210.0,-386.0,0.0,0.0,0.0
<a href=/player/hermb102>hermb102</a>,Babe Herman,Detroit Tigers,TIGRS,2,6,3,9,1922,1928,6,No,0,20.71,4.6,-16.11,377,336,-41,782,333,-449,2967.0,2739.0,-228.0,8000.0,0.0,-8000.0
<a href=/player/hermb102>hermb102</a>,Babe Herman,Brooklyn Dodgers,DOGRS,7,17,12,29,1932,1948,16,No,0,60.59,33.44,-27.15,3224,2810,-414,11104,10257,-847,2159.0,791.0,-1368.0,10000.0,0.0,-10000.0
<a href=/player/hermb102>hermb102</a>,Babe Herman,Cincinnati Reds,REDS,4,6,9,15,1932,1937,5,No,0,29.61,0.55,-29.06,1688,485,-1203,5275,1430,-3845,2379.0,542.0,-1837.0,5500.0,0.0,-5500.0
<a href=/player/hermb102>hermb102</a>,Babe Herman,Chicago Cubs,CUBS,1,3,2,5,1934,1941,7,No,0,3.72,22.26,18.54,346,634,288,358,941,583,2252.0,4458.0,2206.0,0.0,0.0,0.0
<a href=/player/hermc001>hermc001</a>,Chad Hermansen,Pittsburgh Pirates,PIRATS,1,1,1,2,2002,2002,0,No,0,-0.58,0.0,0.58,35,0,-35,49,0,-49,0.0,0.0,0.0,223000.0,0.0,-223000.0
<a href=/player/hermc001>hermc001</a>,Chad Hermansen,Chicago Cubs,CUBS,1,2,2,4,2002,2004,2,No,0,-0.13,2.3,2.43,32,316,284,68,1174,1106,0.0,0.0,0.0,6500000.0,0.0,-6500000.0
<a href=/player/hermd001>hermd001</a>,Dustin Hermanson,San Diego Padres,PADRS,3,5,5,10,1996,2006,10,No,1,3.54,21.49,17.95,377,1376,999,1296,5646,4350,0.0,4.0,4.0,8651680.0,0.0,-8651680.0
<a href=/player/hermd001>hermd001</a>,Dustin Hermanson,Florida Marlins,MARLNS,4,9,9,18,1997,2012,15,No,2,8.19,25.06,16.87,569,1421,852,623,4127,3504,3020.0,2057.0,-963.0,6500000.0,0.0,-6500000.0
<a href=/player/hermd001>hermd001</a>,Dustin Hermanson,Montreal Expos,NATEX,1,2,2,4,2000,2003,3,No,0,5.18,-3.67,-8.85,698,376,-322,77,830,753,1408.0,493.0,-915.0,3988333.0,0.0,-3988333.0
<a href=/player/hermd001>hermd001</a>,Dustin Hermanson,St. Louis Cardinals,CARDS,3,4,5,9,2001,2003,2,No,0,8.47,-0.03,-8.5,447,102,-345,1848,34,-1814,66.0,386.0,320.0,5333333.0,0.0,-5333333.0
<a href=/player/hermg101>hermg101</a>,Gene Hermanski,Brooklyn Dodgers,DOGRS,3,6,7,13,1951,1958,7,No,0,4.28,2.12,-2.16,1667,685,-982,5534,2062,-3472,435.0,267.0,-168.0,50000.0,0.0,-50000.0
<a href=/player/hermg101>hermg101</a>,Gene Hermanski,Chicago Cubs,CUBS,7,18,16,34,1953,1965,12,No,0,5.64,21.93,16.29,1405,1825,420,3839,2173,-1666,1451.0,4951.0,3500.0,82000.0,0.0,-82000.0
<a href=/player/hermj001>hermj001</a>,Jeremy Hermida,Florida Marlins,MARLNS,1,1,2,3,2009,2012,3,No,0,-0.48,0.08,0.56,52,6,-46,171,0,-171,0.0,5.0,5.0,2250000.0,0.0,-2250000.0
<a href=/player/hermr101>hermr101</a>,Remy Hermoso,Montreal Expos,NATEX,1,1,1,2,1972,1972,0,No,0,0.24,0.0,-0.24,48,0,-48,135,0,-135,0.0,0.0,0.0,0.0,0.0,0.0
<a href=/player/herna003>herna003</a>,Anderson Hernandez,Detroit Tigers,TIGRS,1,1,1,2,2005,2008,3,No,0,-0.88,1.11,1.99,81,117,36,238,341,103,0.0,0.0,0.0,0.0,0.0,0.0
<a href=/player/herna003>herna003</a>,Anderson Hernandez,New York Mets,METS,1,1,1,2,2008,2008,0,No,0,0.89,-0.3,-1.19,105,38,-67,346,0,-346,0.0,54.0,54.0,0.0,0.0,0.0
<a href=/player/herna003>herna003</a>,Anderson Hernandez,Washington Nationals,NATEX,1,1,1,2,2009,2009,0,No,0,-0.09,0.0,0.09,46,0,-46,149,0,-149,0.0,0.0,0.0,400000.0,0.0,-400000.0
<a href=/player/herna004>herna004</a>,Ariel Hernandez,Cincinnati Reds,REDS,2,4,4,8,2018,2018,0,Yes,0,1.09,0.0,-1.09,176,0,-176,2,0,-2,299.0,0.0,-299.0,0.0,0.0,0.0
<a href=/player/hernc001>hernc001</a>,Carlos Hernandez,San Diego Padres,PADRS,6,11,12,23,2000,2016,16,No,2,7.76,9.29,1.53,815,1178,363,2681,1318,-1363,111.0,1430.0,1319.0,3371100.0,0.0,-3371100.0
<a href=/player/hernc003>hernc003</a>,Carlos Hernandez,Houston Astros,ASTROS,1,1,1,2,2000,2002,2,No,0,-0.12,0.0,0.12,2,0,-2,1,0,-1,0.0,0.0,0.0,0.0,0.0,0.0
<a href=/player/hernc005>hernc005</a>,Cesar Hernandez,Cleveland Indians,INDINS,1,1,1,2,2021,2021,0,Yes,0,-0.67,0.0,0.67,53,0,-53,217,0,-217,0.0,0.0,0.0,5000000.0,0.0,-5000000.0
<a href=/player/hernc101>hernc101</a>,Chico Hernandez,Chicago Cubs,CUBS,1,2,1,3,1943,1949,6,No,0,0.0,5.51,5.51,0,511,511,0,2102,2102,0.0,0.0,0.0,0.0,0.0,0.0
<a href=/player/hernd002>hernd002</a>,David Hernandez,Baltimore Orioles,ORLS,1,2,2,4,2010,2012,2,No,0,1.15,1.04,-0.11,541,290,-251,2,1158,1156,777.0,0.0,-777.0,402500.0,0.0,-402500.0
<a href=/player/hernd002>hernd002</a>,David Hernandez,Anaheim Angels,ANGELS,1,1,1,2,2017,2020,3,No,0,0.04,0.0,-0.04,48,0,-48,0,0,0,56.0,0.0,-56.0,535000.0,0.0,-535000.0
<a href=/player/herne001>herne001</a>,Enrique Hernandez,Houston Astros,ASTROS,3,8,7,15,2014,2019,5,Yes,0,5.86,22.81,16.95,902,718,-184,1801,1734,-67,1776.0,1238.0,-538.0,2712000.0,0.0,-2712000.0
<a href=/player/herne001>herne001</a>,Enrique Hernandez,Miami Marlins,MARLNS,3,8,9,17,2014,2020,6,Yes,0,14.59,9.27,-5.32,1600,441,-1159,4137,1747,-2390,525.0,522.0,-3.0,17800000.0,0.0,-17800000.0
<a href=/player/herne102>herne102</a>,Enzo Hernandez,Houston Astros,ASTROS,2,4,3,7,1968,1970,2,No,0,13.55,1.65,-11.9,563,230,-333,804,931,127,6085.0,0.0,-6085.0,0.0,0.0,0.0
<a href=/player/herne102>herne102</a>,Enzo Hernandez,Baltimore Orioles,ORLS,16,38,31,69,1970,1994,24,No,3,54.62,146.79,92.17,4179,7236,3057,9813,16664,6851,14313.0,25489.0,11176.0,888833.0,0.0,-888833.0
<a href=/player/hernf001>hernf001</a>,Fernando Hernandez,Cleveland Indians,INDINS,2,3,2,5,1993,1994,1,No,0,-0.03,1.59,1.62,56,58,2,2,0,-2,91.0,270.0,179.0,0.0,0.0,0.0
<a href=/player/herng001>herng001</a>,Gorkys Hernandez,Detroit Tigers,TIGRS,1,2,1,3,2007,2008,1,No,0,10.42,1.11,-9.31,243,138,-105,269,547,278,2160.0,0.0,-2160.0,0.0,0.0,0.0
<a href=/player/herng001>herng001</a>,Gorkys Hernandez,Atlanta Braves,BRAVES,1,3,1,4,2009,2011,2,No,0,-2.0,-0.61,1.39,553,250,-303,514,1005,491,4336.0,0.0,-4336.0,0.0,0.0,0.0
<a href=/player/herng001>herng001</a>,Gorkys Hernandez,Pittsburgh Pirates,PIRATS,2,2,3,5,2012,2014,2,No,0,-0.75,0.79,1.54,45,309,264,147,740,593,0.0,0.0,0.0,0.0,0.0,0.0
<a href=/player/herng001>herng001</a>,Gorkys Hernandez,Miami Marlins,MARLNS,1,1,1,2,2013,2013,0,Yes,0,0.0,0.0,0.0,0,0,0,0,0,0,0.0,0.0,0.0,0.0,0.0,0.0
<a href=/player/hernj001>hernj001</a>,Jose Hernandez,Cleveland Indians,INDINS,2,2,2,4,1993,1995,2,No,0,8.05,-0.12,-8.17,898,74,-824,1975,93,-1882,413.0,82.0,-331.0,165000.0,0.0,-165000.0
<a href=/player/hernj001>hernj001</a>,Jose Hernandez,Chicago Cubs,CUBS,3,5,7,12,1999,2001,2,No,2,0.04,-3.17,-3.21,294,120,-174,362,46,-316,1366.0,490.0,-876.0,5325000.0,0.0,-5325000.0
<a href=/player/hernj001>hernj001</a>,Jose Hernandez,Colorado Rockies,ROCKS,1,1,1,2,2003,2003,0,No,0,-0.2,-0.16,0.04,23,48,25,72,134,62,0.0,0.0,0.0,1000000.0,0.0,-1000000.0
<a href=/player/hernj001>hernj001</a>,Jose Hernandez,Chicago Cubs,CUBS,2,4,4,8,2003,2017,14,No,1,0.04,25.72,25.68,310,1182,872,721,4941,4220,0.0,3.0,3.0,0.0,0.0,0.0
<a href=/player/hernj002>hernj002</a>,Jeremy Hernandez,St. Louis Cardinals,CARDS,1,1,1,2,1989,1989,0,No,0,0.57,0.0,-0.57,112,0,-112,5,0,-5,256.0,0.0,-256.0,0.0,0.0,0.0
<a href=/player/hernj002>hernj002</a>,Jeremy Hernandez,San Diego Padres,PADRS,3,5,5,10,1993,2000,7,No,0,0.96,-0.7,-1.66,77,54,-23,3,11,8,299.0,168.0,-131.0,448500.0,0.0,-448500.0
<a href=/player/hernj002>hernj002</a>,Jeremy Hernandez,Cleveland Indians,INDINS,1,1,1,2,1994,1994,0,No,0,-0.03,0.21,0.24,56,9,-47,2,0,-2,91.0,38.0,-53.0,0.0,0.0,0.0
<a href=/player/hernj102>hernj102</a>,Jackie Hernandez,California Angels,ANGELS,3,4,5,9,1966,1969,3,No,0,10.95,8.69,-2.26,553,605,52,930,2108,1178,1992.0,0.0,-1992.0,0.0,0.0,0.0
<a href=/player/hernj102>hernj102</a>,Jackie Hernandez,Kansas City Royals,ROYALS,3,7,6,13,1970,1979,9,No,1,2.78,26.16,23.38,582,1576,994,670,5382,4712,1583.0,1688.0,105.0,34500.0,0.0,-34500.0
<a href=/player/hernj102>hernj102</a>,Jackie Hernandez,Pittsburgh Pirates,PIRATS,1,1,1,2,1974,1974,0,No,0,0.0,-0.29,-0.29,0,15,15,0,34,34,0.0,0.0,0.0,0.0,0.0,0.0
<a href=/player/hernk001>hernk001</a>,Keith Hernandez,St. Louis Cardinals,CARDS,1,1,2,3,1983,1986,3,No,0,26.61,-0.78,-27.39,880,253,-627,3684,88,-3596,0.0,994.0,994.0,0.0,0.0,0.0
<a href=/player/hernl001>hernl001</a>,Larry Herndon,St. Louis Cardinals,CARDS,1,2,1,3,1975,1975,0,No,0,3.9,-0.88,-4.78,682,20,-662,2305,1,-2304,0.0,26.0,26.0,0.0,0.0,0.0
<a href=/player/hernl001>hernl001</a>,Larry Herndon,San Francisco Giants,GIANTS,1,1,2,3,1981,1983,2,No,0,11.25,-1.99,-13.24,843,58,-785,3013,18,-2995,0.0,218.0,218.0,0.0,0.0,0.0
<a href=/player/hernl002>hernl002</a>,Leo Hernandez,Los Angeles Dodgers,DOGRS,1,1,1,2,1982,1984,2,No,0,-1.38,0.21,1.59,78,104,26,239,108,-131,0.0,0.0,0.0,0.0,0.0,0.0
<a href=/player/hernl002>hernl002</a>,Leo Hernandez,Baltimore Orioles,ORLS,1,2,2,4,1985,1987,2,No,0,-0.33,0.34,0.67,76,66,-10,188,1,-187,0.0,321.0,321.0,558333.0,0.0,-558333.0
<a href=/player/hernl003>hernl003</a>,Livan Hernandez,Florida Marlins,MARLNS,1,1,2,3,1999,2006,7,No,0,5.69,-0.63,-6.32,220,237,17,285,23,-262,2239.0,544.0,-1695.0,1875000.0,0.0,-1875000.0
<a href=/player/hernl003>hernl003</a>,Livan Hernandez,San Francisco Giants,GIANTS,1,3,2,5,2003,2005,2,No,0,18.34,1.53,-16.81,443,337,-106,636,24,-612,3951.0,670.0,-3281.0,0.0,0.0,0.0
<a href=/player/hernl003>hernl003</a>,Livan Hernandez,Washington Nationals,NATEX,1,2,2,4,2006,2011,5,No,0,3.1,-0.03,-3.13,87,194,107,106,108,2,821.0,1067.0,246.0,8000000.0,0.0,-8000000.0
<a href=/player/hernm003>hernm003</a>,Marco Hernandez,Chicago Cubs,CUBS,1,1,1,2,2014,2015,1,No,0,-0.14,0.42,0.56,122,8,-114,271,8,-263,0.0,61.0,61.0,0.0,0.0,0.0
<a href=/player/herno001>herno001</a>,Orlando Hernandez,New York Yankees,YANKS,1,1,2,3,2003,2003,0,No,0,0.41,0.84,0.43,25,51,26,3,0,-3,385.0,152.0,-233.0,0.0,0.0,0.0
<a href=/player/herno001>herno001</a>,Orlando Hernandez,Chicago White Sox,WSOX,3,7,5,12,2003,2010,7,No,2,-4.18,5.27,9.45,270,142,-128,107,7,-100,449.0,996.0,547.0,0.0,0.0,0.0
<a href=/player/herno001>herno001</a>,Orlando Hernandez,Chicago White Sox,WSOX,3,7,7,14,2005,2015,10,No,0,21.04,18.91,-2.13,1161,870,-291,3709,2249,-1460,1060.0,1883.0,823.0,16705000.0,0.0,-16705000.0
<a href=/player/herno001>herno001</a>,Orlando Hernandez,Arizona Diamondbacks,DBACKS,2,3,2,5,2006,2009,3,No,0,3.04,0.94,-2.1,112,197,85,95,61,-34,821.0,743.0,-78.0,4625000.0,0.0,-4625000.0
<a href=/player/hernp001>hernp001</a>,Pedro Hernandez,San Diego Padres,PADRS,7,19,13,32,2011,2021,10,Yes,0,17.4,14.23,-3.17,1323,1189,-134,3711,3610,-101,1751.0,362.0,-1389.0,9570500.0,0.0,-9570500.0
<a href=/player/hernp001>hernp001</a>,Pedro Hernandez,Chicago White Sox,WSOX,1,2,1,3,2012,2012,0,No,0,5.04,0.22,-4.82,686,12,-674,2423,0,-2423,173.0,170.0,-3.0,480000.0,0.0,-480000.0
<a href=/player/hernp101>hernp101</a>,Pedro Hernandez,Houston Astros,ASTROS,1,3,1,4,1978,1989,11,No,0,-3.72,7.9,11.62,160,965,805,206,3318,3112,249.0,0.0,-249.0,22500.0,0.0,-22500.0
<a href=/player/hernr001>hernr001</a>,Roberto Hernandez,California Angels,ANGELS,1,2,1,3,1989,1989,0,No,0,10.8,0.0,-10.8,349,0,-349,0,0,0,1214.0,0.0,-1214.0,0.0,0.0,0.0
<a href=/player/hernr001>hernr001</a>,Roberto Hernandez,Chicago White Sox,WSOX,7,14,18,32,1997,2011,14,No,0,8.23,24.04,15.81,946,1419,473,129,1458,1329,2956.0,3428.0,472.0,22052500.0,0.0,-22052500.0
<a href=/player/hernr001>hernr001</a>,Roberto Hernandez,Tampa Bay Devil Rays,RAYS,1,2,1,3,2001,2003,2,No,0,1.27,3.18,1.91,123,345,222,0,1405,1405,359.0,0.0,-359.0,0.0,0.0,0.0
<a href=/player/hernr001>hernr001</a>,Roberto Hernandez,Pittsburgh Pirates,PIRATS,3,5,7,12,2006,2016,10,No,0,1.97,9.91,7.94,388,1408,1020,455,3224,2769,1770.0,3210.0,1440.0,14150000.0,0.0,-14150000.0
<a href=/player/hernr002>hernr002</a>,Ramon Hernandez,Oakland Athletics,ATLTCS,2,3,3,6,2003,2012,9,No,0,7.5,9.83,2.33,434,545,111,1482,2087,605,0.0,206.0,206.0,4062500.0,0.0,-4062500.0
<a href=/player/hernr002>hernr002</a>,Ramon Hernandez,Baltimore Orioles,ORLS,2,3,4,7,2008,2010,2,No,0,1.2,-0.23,-1.43,283,26,-257,1043,51,-992,0.0,0.0,0.0,11500000.0,0.0,-11500000.0
<a href=/player/hernr002>hernr002</a>,Ramon Hernandez,Colorado Rockies,ROCKS,2,3,3,6,2013,2013,0,Yes,0,-0.75,0.0,0.75,41,0,-41,59,0,-59,361.0,0.0,-361.0,0.0,0.0,0.0
<a href=/player/hernr102>hernr102</a>,Ramon Hernandez,MexicoCityReds,MexicoCityReds,1,1,1,2,1971,1971,0,No,0,8.0,0.0,-8.0,526,0,-526,42,0,-42,1043.0,0.0,-1043.0,0.0,0.0,0.0
<a href=/player/hernr102>hernr102</a>,Ramon Hernandez,Chicago Cubs,CUBS,1,1,1,2,1977,1977,0,No,0,-0.27,-0.19,0.08,12,11,-1,0,12,12,38.0,0.0,-38.0,0.0,0.0,0.0
<a href=/player/hernr103>hernr103</a>,Rudy Hernandez,Chicago White Sox,WSOX,1,1,2,3,1973,1981,8,No,0,0.0,8.38,8.38,0,129,129,0,0,0,0.0,2154.0,2154.0,0.0,0.0,0.0
<a href=/player/hernt002>hernt002</a>,Teoscar Hernandez,Houston Astros,ASTROS,1,2,1,3,2017,2017,0,No,0,8.07,-0.16,-8.23,490,21,-469,1918,0,-1918,0.0,43.0,43.0,5500000.0,0.0,-5500000.0
<a href=/player/hernw001>hernw001</a>,Guillermo Hernandez,Chicago Cubs,CUBS,1,1,2,3,1983,1986,3,No,0,1.63,1.67,0.04,126,170,44,13,140,127,287.0,1159.0,872.0,0.0,0.0,0.0
<a href=/player/hernw001>hernw001</a>,Guillermo Hernandez,Philadelphia Phillies,PHILS,3,6,6,12,1984,1989,5,No,0,21.01,8.65,-12.36,1868,885,-983,3542,3171,-371,2761.0,15.0,-2746.0,1629900.0,0.0,-1629900.0
<a href=/player/hernx001>hernx001</a>,Xavier Hernandez,Houston Astros,ASTROS,2,2,3,5,1993,1995,2,No,0,-0.35,0.14,0.49,32,80,48,0,134,134,120.0,0.0,-120.0,900000.0,0.0,-900000.0
<a href=/player/herra101>herra101</a>,Art Herring,Brooklyn Dodgers,DOGRS,2,6,2,8,1934,1938,4,No,0,0.05,1.5,1.45,177,398,221,491,1389,898,0.0,3.0,3.0,0.0,0.0,0.0
<a href=/player/herrc001>herrc001</a>,Chris Herrmann,Minnesota Twins,TWINS,1,1,1,2,2015,2017,2,No,0,0.47,0.0,-0.47,162,0,-162,422,0,-422,0.0,0.0,0.0,510000.0,0.0,-510000.0
<a href=/player/herrd001>herrd001</a>,Danny Herrera,Texas Rangers,RNGRS,3,4,4,8,2007,2017,10,No,1,4.01,22.59,18.58,363,682,319,148,2814,2666,1527.0,137.0,-1390.0,0.0,0.0,0.0
<a href=/player/herrd001>herrd001</a>,Danny Herrera,Milwaukee Brewers,BREWRS,2,3,3,6,2011,2015,4,No,0,0.39,1.82,1.43,61,261,200,0,1,1,90.0,377.0,287.0,0.0,0.0,0.0
<a href=/player/herrd002>herrd002</a>,Dilson Herrera,Pittsburgh Pirates,PIRATS,1,2,3,5,2013,2013,0,No,0,0.44,0.95,0.51,159,39,-120,169,139,-30,143.0,0.0,-143.0,0.0,0.0,0.0
<a href=/player/herrd002>herrd002</a>,Dilson Herrera,New York Mets,METS,3,4,3,7,2016,2021,5,Yes,0,0.07,2.8,2.73,96,168,72,266,686,420,0.0,3.0,3.0,13000000.0,0.0,-13000000.0
<a href=/player/herre102>herre102</a>,Ed Herrmann,Chicago White Sox,WSOX,1,1,5,6,1975,1975,0,No,0,0.33,0.0,-0.33,80,0,-80,217,0,-217,0.0,0.0,0.0,0.0,0.0,0.0
<a href=/player/herre102>herre102</a>,Ed Herrmann,California Angels,ANGELS,2,2,3,5,1976,1980,4,No,0,-0.21,0.55,0.76,204,312,108,515,705,190,210.0,441.0,231.0,0.0,0.0,0.0
<a href=/player/herrj001>herrj001</a>,Jose Herrera,Toronto Blue Jays,BJAYS,1,2,1,3,1993,1993,0,No,0,1.73,0.5,-1.23,187,44,-143,423,203,-220,657.0,0.0,-657.0,0.0,0.0,0.0
<a href=/player/herrj002>herrj002</a>,Jonathan Herrera,Colorado Rockies,ROCKS,1,1,2,3,2013,2015,2,No,0,-0.06,-0.53,-0.47,42,103,61,104,39,-65,0.0,474.0,474.0,900000.0,0.0,-900000.0
<a href=/player/herrj101>herrj101</a>,John Herrnstein,Philadelphia Phillies,PHILS,1,3,2,5,1966,1968,2,No,0,66.82,10.77,-56.05,1243,294,-949,2604,327,-2277,8021.0,2661.0,-5360.0,0.0,0.0,0.0
<a href=/player/herrj101>herrj101</a>,John Herrnstein,Chicago Cubs,CUBS,2,2,3,5,1966,1967,1,No,0,-0.3,-0.17,0.13,21,59,38,18,34,16,4.0,53.0,49.0,0.0,0.0,0.0
<a href=/player/herrj101>herrj101</a>,John Herrnstein,Atlanta Braves,BRAVES,1,2,2,4,1966,1966,0,No,0,0.0,0.0,0.0,0,0,0,0,0,0,0.0,0.0,0.0,0.0,0.0,0.0
<a href=/player/herrj102>herrj102</a>,Jose Herrera,Montreal Expos,NATEX,1,1,1,2,1970,1971,1,No,0,0.0,-0.36,-0.36,0,44,44,0,5,5,0.0,119.0,119.0,0.0,0.0,0.0
<a href=/player/herrj102>herrj102</a>,Jose Herrera,Milwaukee Brewers,BREWRS,1,2,1,3,1971,1971,0,No,0,0.0,-0.75,-0.75,0,42,42,0,3,3,0.0,97.0,97.0,17500.0,0.0,-17500.0
<a href=/player/herrk001>herrk001</a>,Kelvin Herrera,Kansas City Royals,ROYALS,1,1,3,4,2018,2021,3,Yes,0,0.15,-0.73,-0.88,41,62,21,0,233,233,56.0,0.0,-56.0,0.0,0.0,0.0
<a href=/player/herrl101>herrl101</a>,Leroy Herrmann,Chicago Cubs,CUBS,2,8,3,11,1933,1946,13,No,0,22.35,18.34,-4.01,627,903,276,2568,3781,1213,0.0,0.0,0.0,0.0,0.0,0.0
<a href=/player/herrp101>herrp101</a>,Pancho Herrera,Philadelphia Phillies,PHILS,1,2,1,3,1962,1964,2,No,0,-0.67,1.44,2.11,85,121,36,167,417,250,0.0,0.0,0.0,0.0,0.0,0.0
<a href=/player/herrr001>herrr001</a>,Ronald Herrera,Oakland Athletics,ATLTCS,1,2,1,3,2014,2014,0,No,0,-0.14,0.59,0.73,51,21,-30,115,56,-59,0.0,0.0,0.0,0.0,0.0,0.0
<a href=/player/herrr001>herrr001</a>,Ronald Herrera,San Diego Padres,PADRS,1,1,1,2,2015,2019,4,No,0,-0.05,0.87,0.92,2,246,244,0,863,863,9.0,0.0,-9.0,0.0,0.0,0.0
<a href=/player/herrr001>herrr001</a>,Ronald Herrera,New York Yankees,YANKS,4,6,6,12,2017,2021,4,No,0,10.03,0.33,-9.7,238,102,-136,526,361,-165,1135.0,0.0,-1135.0,0.0,0.0,0.0
<a href=/player/herrr101>herrr101</a>,Rick Herrscher,Milwaukee Braves,BRAVES,1,2,2,4,1962,1964,2,No,0,3.7,0.59,-3.11,377,85,-292,1356,234,-1122,0.0,0.0,0.0,0.0,0.0,0.0
<a href=/player/herrt001>herrt001</a>,Tom Herr,St. Louis Cardinals,CARDS,4,6,6,12,1988,1997,9,No,0,5.03,5.54,0.51,976,963,-13,2815,1492,-1323,209.0,991.0,782.0,10009167.0,0.0,-10009167.0
<a href=/player/herrt001>herrt001</a>,Tom Herr,Minnesota Twins,TWINS,1,3,2,5,1988,1989,1,No,0,2.78,0.41,-2.37,304,27,-277,1185,0,-1185,0.0,435.0,435.0,103500.0,0.0,-103500.0
<a href=/player/herrt001>herrt001</a>,Tom Herr,Philadelphia Phillies,PHILS,1,1,2,3,1990,1990,0,No,0,-0.36,0.0,0.36,97,0,-97,306,0,-306,0.0,0.0,0.0,825000.0,0.0,-825000.0
<a href=/player/herse101>herse101</a>,Earl Hersh,Milwaukee Braves,BRAVES,1,2,2,4,1959,1961,2,No,0,0.0,0.34,0.34,0,49,49,0,163,163,0.0,0.0,0.0,0.0,0.0,0.0
<a href=/player/hersm101>hersm101</a>,Mike Hershberger,Chicago White Sox,WSOX,19,37,35,72,1965,1985,20,No,1,67.23,101.41,34.18,5604,5055,-549,14828,15211,383,11632.0,9695.0,-1937.0,609700.0,0.0,-609700.0
<a href=/player/hersm101>hersm101</a>,Mike Hershberger,Oakland Athletics,ATLTCS,9,20,12,32,1970,1976,6,No,0,26.16,16.01,-10.15,3775,1399,-2376,8326,3903,-4423,4415.0,1098.0,-3317.0,340600.0,0.0,-340600.0
<a href=/player/hersw101>hersw101</a>,Willard Hershberger,New York Yankees,YANKS,3,3,12,15,1937,1943,6,No,0,12.91,-0.14,-13.05,694,36,-658,2601,81,-2520,0.0,0.0,0.0,0.0,0.0,0.0
<a href=/player/herzb101>herzb101</a>,Buck Herzog,New York Giants,GIANTS,1,2,1,3,1910,1913,3,No,0,4.09,2.02,-2.07,544,293,-251,2338,817,-1521,0.0,0.0,0.0,0.0,0.0,0.0
<a href=/player/herzb101>herzb101</a>,Buck Herzog,Boston Braves,BRAVES,10,19,18,37,1911,1938,27,No,0,31.7,49.03,17.33,2338,3824,1486,6936,13187,6251,4661.0,3399.0,-1262.0,56400.0,0.0,-56400.0
<a href=/player/herzb101>herzb101</a>,Buck Herzog,New York Giants,GIANTS,2,4,2,6,1913,1921,8,No,0,15.0,8.81,-6.19,695,474,-221,2854,907,-1947,0.0,2915.0,2915.0,6400.0,0.0,-6400.0
<a href=/player/herzb101>herzb101</a>,Buck Herzog,Cincinnati Reds,REDS,2,3,5,8,1916,1930,14,No,0,6.12,44.47,38.35,494,1760,1266,2101,7377,5276,0.0,27.0,27.0,0.0,0.0,0.0
<a href=/player/herzb101>herzb101</a>,Buck Herzog,New York Giants,GIANTS,2,3,4,7,1918,1923,5,No,0,10.74,16.59,5.85,496,534,38,1371,952,-419,2035.0,3773.0,1738.0,12500.0,0.0,-12500.0
<a href=/player/herzb101>herzb101</a>,Buck Herzog,Boston Braves,BRAVES,1,1,2,3,1919,1921,2,No,0,-0.19,4.01,4.2,143,284,141,569,1192,623,0.0,0.0,0.0,0.0,0.0,0.0
<a href=/player/herzw101>herzw101</a>,Whitey Herzog,New York Yankees,YANKS,7,20,15,35,1956,1970,14,No,0,3.04,33.17,30.13,2442,2492,50,6615,5619,-996,2999.0,5239.0,2240.0,115500.0,0.0,-115500.0
<a href=/player/herzw101>herzw101</a>,Whitey Herzog,Kansas City Athletics,ATLTCS,24,51,45,96,1961,1976,15,No,0,93.37,59.87,-33.5,8944,6063,-2881,21756,17588,-4168,9976.0,4965.0,-5011.0,504100.0,0.0,-504100.0
<a href=/player/herzw101>herzw101</a>,Whitey Herzog,Baltimore Orioles,ORLS,1,2,1,3,1962,1962,0,No,0,0.46,0.0,-0.46,158,0,-158,435,0,-435,0.0,0.0,0.0,0.0,0.0,0.0
<a href=/player/hessd001>hessd001</a>,David Hess,Tampa Bay Devil Rays,RAYS,1,1,2,3,2021,2021,0,Yes,0,-0.91,0.0,0.91,27,0,-27,4,0,-4,54.0,0.0,-54.0,0.0,0.0,0.0
<a href=/player/hestc001>hestc001</a>,Chris Heston,San Francisco Giants,GIANTS,2,2,2,4,2016,2019,3,Yes,0,-0.55,2.56,3.11,2,107,105,0,411,411,15.0,0.0,-15.0,530000.0,0.0,-530000.0
<a href=/player/hestj001>hestj001</a>,John Hester,Arizona Diamondbacks,DBACKS,1,2,2,4,2011,2015,4,No,0,1.04,1.11,0.07,290,493,203,1158,2,-1156,0.0,721.0,721.0,0.0,0.0,0.0
<a href=/player/heuec001>heuec001</a>,Codi Heuer,Chicago White Sox,WSOX,1,2,1,3,2021,2021,0,Yes,0,0.52,-0.03,-0.55,48,26,-22,0,0,0,86.0,69.0,-17.0,0.0,0.0,0.0
<a href=/player/heuse101>heuse101</a>,Ed Heusser,Philadelphia Athletics,ATLTCS,39,84,81,165,1940,1976,36,No,0,92.78,78.07,-14.71,10628,9945,-683,25815,30208,4393,12609.0,9858.0,-2751.0,510800.0,0.0,-510800.0
<a href=/player/heuse101>heuse101</a>,Ed Heusser,Cincinnati Reds,REDS,1,1,1,2,1946,1948,2,No,0,0.0,4.66,4.66,0,178,178,0,598,598,0.0,0.0,0.0,0.0,0.0,0.0
<a href=/player/hevij101>hevij101</a>,Joe Heving,New York Giants,GIANTS,1,4,1,5,1931,1931,0,No,0,0.0,0.0,0.0,0,0,0,0,0,0,0.0,0.0,0.0,0.0,0.0,0.0
<a href=/player/hevij102>hevij102</a>,Johnnie Heving,Boston Red Sox,RSOX,2,6,3,9,1925,1926,1,No,0,0.0,-1.32,-1.32,0,98,98,0,337,337,0.0,0.0,0.0,21750.0,0.0,-21750.0
<a href=/player/heydm101>heydm101</a>,Mike Heydon,Brooklyn Dodgers,DOGRS,1,4,2,6,1899,1903,4,No,0,0.67,6.33,5.66,113,445,332,291,1743,1452,635.0,0.0,-635.0,0.0,0.0,0.0
<a href=/player/heydm101>heydm101</a>,Mike Heydon,Indianapolis,Indianapolis,1,1,1,2,1904,1904,0,No,0,-0.01,0.0,0.01,4,0,-4,12,0,-12,0.0,0.0,0.0,0.0,0.0,0.0
<a href=/player/heywj001>heywj001</a>,Jason Heyward,Atlanta Braves,BRAVES,3,6,6,12,2014,2021,7,Yes,0,6.17,11.17,5.0,236,884,648,658,2525,1867,448.0,1265.0,817.0,6525000.0,0.0,-6525000.0
<a href=/player/hiatj101>hiatj101</a>,Jack Hiatt,California Angels,ANGELS,3,3,3,6,1964,1969,5,No,0,11.83,4.86,-6.97,882,579,-303,2571,2006,-565,0.0,0.0,0.0,26000.0,0.0,-26000.0
<a href=/player/hiatj101>hiatj101</a>,Jack Hiatt,Montreal Expos,NATEX,1,1,1,2,1970,1970,0,No,0,0.48,0.6,0.12,66,41,-25,215,118,-97,0.0,0.0,0.0,0.0,0.0,0.0
<a href=/player/hiatp001>hiatp001</a>,Phil Hiatt,Kansas City Royals,ROYALS,1,1,1,2,1995,1995,0,No,0,0.02,-0.11,-0.13,7,15,8,23,39,16,0.0,0.0,0.0,150000.0,0.0,-150000.0
<a href=/player/hibbg001>hibbg001</a>,Greg Hibbard,Kansas City Royals,ROYALS,2,5,3,8,1987,1989,2,No,0,6.71,1.86,-4.85,503,45,-458,494,0,-494,4503.0,794.0,-3709.0,62500.0,0.0,-62500.0
<a href=/player/hibbg001>hibbg001</a>,Greg Hibbard,Florida Marlins,MARLNS,2,3,3,6,1992,1997,5,No,0,2.75,6.53,3.78,468,640,172,88,1194,1106,1381.0,1519.0,138.0,0.0,0.0,0.0
<a href=/player/hicka001>hicka001</a>,Aaron Hicks,Minnesota Twins,TWINS,2,2,2,4,2015,2019,4,No,0,9.28,-0.39,-9.67,612,69,-543,2194,90,-2104,9.0,128.0,119.0,0.0,0.0,0.0
<a href=/player/hickb001>hickb001</a>,Bryan Hickerson,Minnesota Twins,TWINS,2,4,3,7,1987,1991,4,No,1,0.91,5.69,4.78,306,646,340,81,2698,2617,1068.0,6.0,-1062.0,0.0,0.0,0.0
<a href=/player/hickc101>hickc101</a>,Charlie Hickman,Cleveland Indians,INDINS,1,1,1,2,1904,1905,1,No,0,0.7,0.57,-0.13,101,121,20,399,464,65,0.0,0.0,0.0,0.0,0.0,0.0
<a href=/player/hickc101>hickc101</a>,Charlie Hickman,Cleveland Indians,INDINS,1,2,1,3,1908,1914,6,No,0,0.0,-1.58,-1.58,0,95,95,0,309,309,0.0,0.0,0.0,0.0,0.0,0.0
<a href=/player/hickj101>hickj101</a>,Joe Hicks,Los Angeles Angels,ANGELS,4,5,6,11,1960,1969,9,No,0,10.52,26.6,16.08,667,1051,384,1150,2550,1400,1992.0,3710.0,1718.0,45000.0,0.0,-45000.0
<a href=/player/hickj103>hickj103</a>,Jim Hickman,New York Mets,METS,6,11,10,21,1966,1974,8,No,0,2.87,14.84,11.97,879,1261,382,2379,4536,2157,1072.0,0.0,-1072.0,182000.0,0.0,-182000.0
<a href=/player/hickj103>hickj103</a>,Jim Hickman,Los Angeles Dodgers,DOGRS,3,4,4,8,1968,1970,2,No,0,15.48,-0.58,-16.06,1246,61,-1185,2529,137,-2392,1193.0,0.0,-1193.0,36500.0,0.0,-36500.0
<a href=/player/hickj103>hickj103</a>,Jim Hickman,Chicago Cubs,CUBS,1,1,1,2,1974,1974,0,No,0,0.5,0.0,-0.5,50,0,-50,68,0,-68,0.0,0.0,0.0,0.0,0.0,0.0
<a href=/player/hickj104>hickj104</a>,Jesse Hickman,Houston Astros,ASTROS,3,4,3,7,1965,1969,4,No,0,-0.71,1.07,1.78,88,138,50,90,443,353,49.0,55.0,6.0,0.0,0.0,0.0
<a href=/player/hickj105>hickj105</a>,Jim Hicks,St. Louis Cardinals,CARDS,4,5,6,11,1969,1972,3,No,0,10.28,4.7,-5.58,544,458,-86,1206,1416,210,1651.0,28.0,-1623.0,11000.0,0.0,-11000.0
<a href=/player/hickk001>hickk001</a>,Kevin Hickey,Chicago White Sox,WSOX,2,3,3,6,1984,1985,1,No,0,3.61,-0.06,-3.67,409,47,-362,1330,158,-1172,395.0,0.0,-395.0,0.0,0.0,0.0
<a href=/player/hidar001>hidar001</a>,Richard Hidalgo,Houston Astros,ASTROS,1,1,2,3,2004,2005,1,No,0,0.91,-0.5,-1.41,86,53,-33,359,2,-357,0.0,109.0,109.0,12500000.0,0.0,-12500000.0
<a href=/player/higbk101>higbk101</a>,Kirby Higbe,Chicago Cubs,CUBS,1,3,1,4,1939,1947,8,No,0,6.07,34.45,28.38,546,585,39,1567,751,-816,1708.0,5741.0,4033.0,9500.0,0.0,-9500.0
<a href=/player/higbk101>higbk101</a>,Kirby Higbe,Philadelphia Phillies,PHILS,3,3,6,9,1940,1945,5,No,0,9.73,2.95,-6.78,550,492,-58,984,965,-19,2859.0,1645.0,-1214.0,0.0,0.0,0.0
<a href=/player/higbk101>higbk101</a>,Kirby Higbe,Brooklyn Dodgers,DOGRS,1,5,2,7,1947,1947,0,No,0,3.3,-0.19,-3.49,337,37,-300,419,81,-338,1285.0,0.0,-1285.0,17500.0,0.0,-17500.0
<a href=/player/higbk101>higbk101</a>,Kirby Higbe,Pittsburgh Pirates,PIRATS,1,1,2,3,1949,1949,0,No,0,0.56,-0.71,-1.27,110,25,-85,22,18,-4,345.0,108.0,-237.0,0.0,0.0,0.0
<a href=/player/higgd101>higgd101</a>,Dennis Higgins,Chicago White Sox,WSOX,4,7,7,14,1968,1971,3,No,0,11.44,1.3,-10.14,1683,516,-1167,5097,1341,-3756,666.0,366.0,-300.0,31000.0,0.0,-31000.0
<a href=/player/higgd101>higgd101</a>,Dennis Higgins,Washington Senators,RNGRS,10,23,17,40,1969,1988,19,No,0,45.59,49.51,3.92,2709,3553,844,8910,11036,2126,3519.0,6237.0,2718.0,494000.0,0.0,-494000.0
<a href=/player/higgd101>higgd101</a>,Dennis Higgins,Oakland Athletics,ATLTCS,2,2,2,4,1971,1977,6,No,0,-0.18,0.57,0.75,36,124,88,2,378,376,89.0,0.0,-89.0,0.0,0.0,0.0
<a href=/player/higgm101>higgm101</a>,Pinky Higgins,Philadelphia Athletics,ATLTCS,1,1,1,2,1936,1939,3,No,0,3.19,4.95,1.76,356,262,-94,1486,1175,-311,0.0,0.0,0.0,10000.0,0.0,-10000.0
<a href=/player/higgm101>higgm101</a>,Pinky Higgins,Boston Red Sox,RSOX,1,2,3,5,1938,1940,2,No,0,15.76,-0.33,-16.09,1005,102,-903,3681,69,-3612,671.0,596.0,-75.0,16000.0,0.0,-16000.0
<a href=/player/higha101>higha101</a>,Andy High,Boston Braves,BRAVES,1,2,1,3,1928,1929,1,No,0,2.41,2.79,0.38,392,292,-100,1482,1208,-274,0.0,0.0,0.0,0.0,0.0,0.0
<a href=/player/higha101>higha101</a>,Andy High,St. Louis Cardinals,CARDS,1,1,2,3,1931,1931,0,No,0,-0.65,0.0,0.65,108,0,-108,270,0,-270,0.0,0.0,0.0,0.0,0.0,0.0
<a href=/player/highc101>highc101</a>,Charlie High,Detroit Tigers,TIGRS,1,9,2,11,1921,1941,20,No,0,0.0,3.03,3.03,0,202,202,0,144,144,0.0,1168.0,1168.0,0.0,0.0,0.0
<a href=/player/hilcw101>hilcw101</a>,Whitey Hilcher,Cincinnati Reds,REDS,1,1,1,2,1936,1946,10,No,0,0.0,0.0,0.0,0,0,0,0,0,0,0.0,0.0,0.0,0.0,0.0,0.0
<a href=/player/hildo101>hildo101</a>,Oral Hildebrand,Indianapolis,Indianapolis,1,1,3,4,1930,1941,11,No,0,12.34,0.0,-12.34,342,0,-342,365,0,-365,2760.0,0.0,-2760.0,0.0,0.0,0.0
<a href=/player/hildo101>hildo101</a>,Oral Hildebrand,Cleveland Indians,INDINS,1,3,3,6,1937,1939,2,No,0,6.18,8.46,2.28,372,600,228,1331,2387,1056,1093.0,179.0,-914.0,0.0,0.0,0.0
<a href=/player/hildo101>hildo101</a>,Oral Hildebrand,St.Louis Browns,ORLS,1,2,2,4,1938,1941,3,No,0,3.15,-0.79,-3.94,102,295,193,121,1044,923,438.0,3.0,-435.0,6000.0,0.0,-6000.0
<a href=/player/hildo101>hildo101</a>,Oral Hildebrand,StPaul,StPaul,1,1,1,2,1941,1946,5,No,0,0.0,0.0,0.0,0,0,0,0,0,0,0.0,0.0,0.0,0.0,0.0,0.0
<a href=/player/hilgt101>hilgt101</a>,Tom Hilgendorf,St. Louis Cardinals,CARDS,2,2,2,4,1970,1974,4,No,0,0.03,0.0,-0.03,3,0,-3,0,0,0,31.0,0.0,-31.0,0.0,0.0,0.0
<a href=/player/hilgt101>hilgt101</a>,Tom Hilgendorf,Kansas City Royals,ROYALS,1,1,1,2,1972,1972,0,No,0,1.74,0.0,-1.74,121,0,-121,14,0,-14,570.0,0.0,-570.0,0.0,0.0,0.0
<a href=/player/hilgt101>hilgt101</a>,Tom Hilgendorf,Cleveland Indians,INDINS,3,3,3,6,1975,1984,9,No,0,1.73,1.63,-0.1,106,204,98,15,722,707,290.0,28.0,-262.0,0.0,0.0,0.0
<a href=/player/hilje001>hilje001</a>,Erik Hiljus,New York Mets,METS,5,9,7,16,1996,1999,3,No,0,12.32,10.55,-1.77,1251,422,-829,4420,1607,-2813,1041.0,86.0,-955.0,5050000.0,0.0,-5050000.0
<a href=/player/hilla001>hilla001</a>,Aaron Hill,Toronto Blue Jays,BJAYS,1,2,1,3,2011,2012,1,No,0,8.13,2.83,-5.3,614,175,-439,2342,713,-1629,0.0,0.0,0.0,6500000.0,0.0,-6500000.0
<a href=/player/hilla001>hilla001</a>,Aaron Hill,Arizona Diamondbacks,DBACKS,2,7,4,11,2016,2019,3,Yes,0,30.63,10.0,-20.63,1052,220,-832,3757,754,-3003,1784.0,544.0,-1240.0,2600000.0,0.0,-2600000.0
<a href=/player/hilla001>hilla001</a>,Aaron Hill,Milwaukee Brewers,BREWRS,3,4,4,8,2016,2020,4,Yes,0,-0.65,-0.37,0.28,62,98,36,173,228,55,0.0,115.0,115.0,0.0,0.0,0.0
<a href=/player/hillb001>hillb001</a>,Bobby Hill,Chicago Cubs,CUBS,2,4,4,8,2003,2017,14,No,1,0.04,25.72,25.68,310,1182,872,721,4941,4220,0.0,3.0,3.0,0.0,0.0,0.0
<a href=/player/hillb001>hillb001</a>,Bobby Hill,Pittsburgh Pirates,PIRATS,1,1,1,2,2005,2005,0,No,0,0.0,0.0,0.0,0,0,0,0,0,0,0.0,0.0,0.0,326000.0,0.0,-326000.0
<a href=/player/hillb102>hillb102</a>,Bill Hill,Louisville Colonels,LS3,2,13,8,21,1898,1902,4,No,0,269.31,7.73,-261.58,7454,627,-6827,29109,2681,-26428,8354.0,267.0,-8087.0,4350.0,0.0,-4350.0
<a href=/player/hillb102>hillb102</a>,Bill Hill,Cincinnati Reds,REDS,1,2,1,3,1898,1898,0,No,0,0.0,0.0,0.0,0,0,0,0,0,0,0.0,0.0,0.0,0.0,0.0,0.0
<a href=/player/hillc101>hillc101</a>,Chuck Hiller,New York Mets,METS,1,1,1,2,1967,1968,1,No,0,0.01,-1.41,-1.42,31,102,71,45,340,295,0.0,0.0,0.0,19000.0,0.0,-19000.0
<a href=/player/hillc102>hillc102</a>,Carmen Hill,Pittsburgh Pirates,PIRATS,3,8,4,12,1917,1922,5,No,0,39.97,14.47,-25.5,1164,978,-186,2135,3744,1609,8893.0,574.0,-8319.0,4200.0,0.0,-4200.0
<a href=/player/hilld001>hilld001</a>,Donnie Hill,Oakland Athletics,ATLTCS,1,1,2,3,1986,1992,6,No,0,0.37,3.34,2.97,194,291,97,702,0,-702,0.0,1471.0,1471.0,218200.0,0.0,-218200.0
<a href=/player/hilld102>hilld102</a>,Dave Hillman,Chicago Cubs,CUBS,1,2,1,3,1959,1960,1,No,0,1.72,-0.14,-1.86,88,52,-36,29,107,78,345.0,0.0,-345.0,0.0,0.0,0.0
<a href=/player/hillf101>hillf101</a>,Frank Hiller,Chicago Cubs,CUBS,1,1,1,2,1952,1952,0,No,0,0.41,1.71,1.3,57,38,-19,42,19,-23,373.0,201.0,-172.0,0.0,0.0,0.0
<a href=/player/hillf101>hillf101</a>,Frank Hiller,Cincinnati Reds,REDS,2,4,2,6,1952,1961,9,No,0,1.04,13.15,12.11,188,1235,1047,605,5109,4504,101.0,0.0,-101.0,11000.0,0.0,-11000.0
<a href=/player/hillf101>hillf101</a>,Frank Hiller,New York Giants,GIANTS,1,4,1,5,1953,1957,4,No,0,0.0,2.61,2.61,0,252,252,0,49,49,0.0,709.0,709.0,0.0,0.0,0.0
<a href=/player/hillg001>hillg001</a>,Glenallen Hill,Toronto Blue Jays,BJAYS,8,18,13,31,1991,2013,22,No,3,16.79,37.75,20.96,2901,2301,-600,8386,7682,-704,1653.0,2653.0,1000.0,7815000.0,0.0,-7815000.0
<a href=/player/hillg001>hillg001</a>,Glenallen Hill,Cleveland Indians,INDINS,1,1,1,2,1993,1994,1,No,0,4.66,-0.34,-5.0,331,70,-261,993,205,-788,0.0,0.0,0.0,975000.0,0.0,-975000.0
<a href=/player/hillg001>hillg001</a>,Glenallen Hill,Chicago Cubs,CUBS,3,4,4,8,2000,2002,2,No,0,0.69,2.96,2.27,125,233,108,216,800,584,101.0,74.0,-27.0,2165000.0,0.0,-2165000.0
<a href=/player/hillg001>hillg001</a>,Glenallen Hill,New York Yankees,YANKS,4,5,5,10,2001,2007,6,No,0,-0.66,0.27,0.93,46,179,133,84,0,-84,184.0,789.0,605.0,6000000.0,0.0,-6000000.0
<a href=/player/hillh101>hillh101</a>,Hunter Hill,St.Louis Browns,ORLS,1,2,1,3,1904,1904,0,No,0,2.03,0.03,-2.0,386,82,-304,1572,310,-1262,0.0,0.0,0.0,0.0,0.0,0.0
<a href=/player/hillh102>hillh102</a>,Herman Hill,Minnesota Twins,TWINS,1,2,2,4,1970,1970,0,No,0,0.0,0.0,0.0,0,0,0,0,0,0,0.0,0.0,0.0,8000.0,0.0,-8000.0
<a href=/player/hillj001>hillj001</a>,Jeremy Hill,Kansas City Royals,ROYALS,1,1,1,2,2003,2003,0,No,0,0.0,-0.68,-0.68,0,16,16,0,0,0,0.0,37.0,37.0,0.0,0.0,0.0
<a href=/player/hillj102>hillj102</a>,Jesse Hill,Hollywood,Hollywood,1,1,3,4,1932,1932,0,No,0,1.79,0.0,-1.79,107,0,-107,445,0,-445,0.0,0.0,0.0,0.0,0.0,0.0
<a href=/player/hillj102>hillj102</a>,Jesse Hill,New York Yankees,YANKS,1,2,2,4,1936,1940,4,No,0,1.79,4.55,2.76,337,355,18,641,541,-100,1980.0,2260.0,280.0,0.0,0.0,0.0
<a href=/player/hillj102>hillj102</a>,Jesse Hill,Philadelphia Athletics,ATLTCS,2,4,2,6,1937,1946,9,No,0,1.34,-1.59,-2.93,190,315,125,733,931,198,0.0,888.0,888.0,5300.0,0.0,-5300.0
<a href=/player/hillk001>hillk001</a>,Ken Hill,Detroit Tigers,TIGRS,8,16,17,33,1986,2010,24,No,2,13.67,30.35,16.68,4407,1892,-2515,10437,3664,-6773,6305.0,6807.0,502.0,11601500.0,0.0,-11601500.0
<a href=/player/hillk001>hillk001</a>,Ken Hill,St. Louis Cardinals,CARDS,1,1,1,2,1991,1992,1,No,0,10.49,-0.32,-10.81,170,95,-75,217,347,130,1669.0,0.0,-1669.0,155000.0,0.0,-155000.0
<a href=/player/hillk001>hillk001</a>,Ken Hill,Montreal Expos,NATEX,2,3,6,9,1995,1999,4,No,0,1.33,-0.63,-1.96,235,498,263,861,779,-82,331.0,567.0,236.0,0.0,0.0,0.0
<a href=/player/hillk001>hillk001</a>,Ken Hill,St. Louis Cardinals,CARDS,1,1,3,4,1995,1998,3,No,0,1.44,-1.12,-2.56,12,171,159,0,473,473,224.0,0.0,-224.0,4525000.0,0.0,-4525000.0
<a href=/player/hillk001>hillk001</a>,Ken Hill,Texas Rangers,RNGRS,3,4,7,11,1997,2007,10,No,2,7.16,7.66,0.5,307,148,-159,732,235,-497,1167.0,1253.0,86.0,5075000.0,0.0,-5075000.0
<a href=/player/hillk002>hillk002</a>,Koyie Hill,Los Angeles Dodgers,DOGRS,1,3,2,5,2004,2004,0,No,0,-0.45,1.02,1.47,67,105,38,129,363,234,19.0,0.0,-19.0,0.0,0.0,0.0
<a href=/player/hillk002>hillk002</a>,Koyie Hill,Washington Nationals,NATEX,1,1,1,2,2014,2014,0,No,0,-0.07,0.0,0.07,10,0,-10,22,0,-22,0.0,0.0,0.0,0.0,0.0,0.0
<a href=/player/hillm001>hillm001</a>,Marc Hill,St. Louis Cardinals,CARDS,3,4,5,9,1974,1978,4,No,0,12.26,2.96,-9.3,1525,327,-1198,1506,603,-903,2919.0,609.0,-2310.0,52000.0,0.0,-52000.0
<a href=/player/hillm101>hillm101</a>,Mack Hillis,New York Yankees,YANKS,1,4,1,5,1926,1937,11,No,0,0.0,46.39,46.39,0,1659,1659,0,7068,7068,0.0,0.0,0.0,0.0,0.0,0.0
<a href=/player/hillr001>hillr001</a>,Rich Hill,Oakland Athletics,ATLTCS,1,2,3,5,2016,2019,3,Yes,0,5.89,0.29,-5.6,179,30,-149,293,2,-291,1084.0,475.0,-609.0,0.0,0.0,0.0
<a href=/player/hillr001>hillr001</a>,Rich Hill,Tampa Bay Devil Rays,RAYS,1,1,2,3,2021,2021,0,Yes,0,0.56,0.0,-0.56,26,0,-26,22,0,-22,190.0,0.0,-190.0,2500000.0,0.0,-2500000.0
<a href=/player/hillr101>hillr101</a>,Red Hill,Philadelphia Athletics,ATLTCS,2,7,4,11,1917,1920,3,No,0,0.98,1.52,0.54,143,229,86,582,916,334,0.0,0.0,0.0,2400.0,0.0,-2400.0
<a href=/player/hills001>hills001</a>,Shawn Hillegas,Los Angeles Dodgers,DOGRS,1,1,1,2,1988,1989,1,No,0,1.33,-0.91,-2.24,63,70,7,0,1,1,513.0,107.0,-406.0,78000.0,0.0,-78000.0
<a href=/player/hills001>hills001</a>,Shawn Hillegas,Chicago White Sox,WSOX,2,3,4,7,1990,1991,1,No,0,1.38,-0.4,-1.78,97,56,-41,54,126,72,701.0,15.0,-686.0,1315000.0,0.0,-1315000.0
<a href=/player/hills002>hills002</a>,Shea Hillenbrand,Boston Red Sox,RSOX,2,3,3,6,2003,2005,2,No,0,1.44,1.36,-0.08,371,60,-311,1062,7,-1055,927.0,290.0,-637.0,407500.0,0.0,-407500.0
<a href=/player/hills002>hills002</a>,Shea Hillenbrand,Arizona Diamondbacks,DBACKS,1,1,1,2,2005,2005,0,No,0,2.57,0.0,-2.57,233,0,-233,964,0,-964,0.0,0.0,0.0,0.0,0.0,0.0
<a href=/player/hills002>hills002</a>,Shea Hillenbrand,Toronto Blue Jays,BJAYS,1,2,1,3,2006,2010,4,No,0,0.24,1.81,1.57,281,144,-137,251,0,-251,321.0,419.0,98.0,6148500.0,0.0,-6148500.0
<a href=/player/hillt002>hillt002</a>,Tim Hill,Kansas City Royals,ROYALS,2,5,4,9,2020,2021,1,Yes,0,-0.85,2.05,2.9,223,152,-71,137,580,443,233.0,11.0,-222.0,0.0,0.0,0.0
<a href=/player/hinca001>hinca001</a>,A.J. Hinch,Oakland Athletics,ATLTCS,22,40,42,82,2001,2019,18,Yes,2,56.7,95.01,38.31,4719,4541,-178,12582,14854,2272,10255.0,6599.0,-3656.0,20632501.0,0.0,-20632501.0
<a href=/player/hincb001>hincb001</a>,Brett Hinchliffe,Anaheim Angels,ANGELS,1,2,3,5,2000,2000,0,No,0,0.0,0.0,0.0,0,0,0,0,0,0,0.0,0.0,0.0,0.0,0.0,0.0
<a href=/player/hinep101>hinep101</a>,Paul Hines,Washington Senators,WS8,2,2,4,6,1887,1901,14,No,0,0.08,0.0,-0.08,1,0,-1,3,0,-3,0.0,0.0,0.0,0.0,0.0,0.0
<a href=/player/hinse001>hinse001</a>,Eric Hinske,Chicago Cubs,CUBS,1,1,1,2,2001,2001,0,No,0,0.0,0.45,0.45,0,66,66,0,147,147,0.0,0.0,0.0,0.0,0.0,0.0
<a href=/player/hinse001>hinse001</a>,Eric Hinske,Oakland Athletics,ATLTCS,5,10,9,19,2001,2012,11,No,2,21.78,5.23,-16.55,1503,359,-1144,3041,656,-2385,5533.0,556.0,-4977.0,2433333.0,0.0,-2433333.0
<a href=/player/hinse001>hinse001</a>,Eric Hinske,Pittsburgh Pirates,PIRATS,1,2,2,4,2009,2012,3,No,0,0.01,0.22,0.21,39,16,-23,98,34,-64,0.0,0.0,0.0,1500000.0,0.0,-1500000.0
<a href=/player/hintc101>hintc101</a>,Chuck Hinton,Washington Senators,RNGRS,2,2,3,5,1964,1969,5,No,0,3.6,0.12,-3.48,774,273,-501,2102,743,-1359,0.0,0.0,0.0,38500.0,0.0,-38500.0
<a href=/player/hintc101>hintc101</a>,Chuck Hinton,Cleveland Indians,INDINS,10,15,16,31,1967,1984,17,No,0,49.89,15.87,-34.02,3019,3044,25,11154,10708,-446,38.0,317.0,279.0,190250.0,0.0,-190250.0
<a href=/player/hintc101>hintc101</a>,Chuck Hinton,California Angels,ANGELS,1,1,1,2,1969,1969,0,No,0,0.84,-0.52,-1.36,289,67,-222,523,148,-375,0.0,0.0,0.0,0.0,0.0,0.0
<a href=/player/hintr101>hintr101</a>,Rich Hinton,Chicago White Sox,WSOX,2,2,2,4,1971,1973,2,No,0,-0.52,-0.55,-0.03,14,49,35,3,85,82,50.0,0.0,-50.0,7500.0,0.0,-7500.0
<a href=/player/hintr101>hintr101</a>,Rich Hinton,Texas Rangers,RNGRS,1,2,1,3,1973,1974,1,No,0,0.0,1.79,1.79,0,272,272,0,1149,1149,0.0,0.0,0.0,0.0,0.0,0.0
<a href=/player/hintr101>hintr101</a>,Rich Hinton,Chicago White Sox,WSOX,2,3,2,5,1975,1979,4,No,0,1.12,4.35,3.23,126,167,41,15,0,-15,323.0,879.0,556.0,0.0,0.0,0.0
<a href=/player/hintr101>hintr101</a>,Rich Hinton,Chicago White Sox,WSOX,1,1,1,2,1979,1979,0,No,0,-0.2,0.0,0.2,14,0,-14,0,0,0,60.0,0.0,-60.0,0.0,0.0,0.0
<a href=/player/hinzt001>hinzt001</a>,Tommy Hinzo,Cleveland Indians,INDINS,1,2,2,4,1990,1990,0,No,0,0.0,0.0,0.0,0,0,0,0,0,0,0.0,0.0,0.0,0.0,0.0,0.0
<a href=/player/hirsj001>hirsj001</a>,Jason Hirsh,Houston Astros,ASTROS,1,3,2,5,2006,2007,1,No,0,4.59,-0.73,-5.32,489,38,-451,1012,30,-982,873.0,297.0,-576.0,727000.0,0.0,-727000.0
<a href=/player/hisll101>hisll101</a>,Larry Hisle,Philadelphia Phillies,PHILS,1,1,1,2,1971,1977,6,No,0,0.0,1.12,1.12,0,651,651,0,1410,1410,0.0,0.0,0.0,0.0,0.0,0.0
<a href=/player/hisll101>hisll101</a>,Larry Hisle,Los Angeles Dodgers,DOGRS,1,1,2,3,1972,1972,0,No,0,0.0,0.0,0.0,0,0,0,0,0,0,0.0,0.0,0.0,0.0,0.0,0.0
<a href=/player/hisll101>hisll101</a>,Larry Hisle,St. Louis Cardinals,CARDS,4,5,5,10,1972,1977,5,No,0,20.99,-1.61,-22.6,875,118,-757,2900,9,-2891,1249.0,251.0,-998.0,47500.0,0.0,-47500.0
<a href=/player/hisnh101>hisnh101</a>,Harley Hisner,Boston Red Sox,RSOX,1,1,1,2,1952,1953,1,No,0,0.0,1.46,1.46,0,48,48,0,11,11,0.0,113.0,113.0,0.0,0.0,0.0
<a href=/player/hitcb101>hitcb101</a>,Billy Hitchcock,New York Yankees,YANKS,1,1,2,3,1941,1946,5,No,0,-1.67,-0.12,1.55,110,211,101,354,687,333,0.0,0.0,0.0,0.0,0.0,0.0
<a href=/player/hitcb101>hitcb101</a>,Billy Hitchcock,St.Louis Browns,ORLS,13,24,31,55,1947,1960,13,No,0,52.08,29.92,-22.16,3700,3192,-508,8156,7991,-165,9955.0,6124.0,-3831.0,59000.0,0.0,-59000.0
<a href=/player/hitcb101>hitcb101</a>,Billy Hitchcock,Boston Red Sox,RSOX,1,1,1,2,1949,1951,2,No,0,0.57,0.02,-0.55,311,85,-226,1156,282,-874,0.0,0.0,0.0,0.0,0.0,0.0
<a href=/player/hitcb101>hitcb101</a>,Billy Hitchcock,Philadelphia Athletics,ATLTCS,1,1,1,2,1953,1953,0,No,0,-0.29,-0.03,0.26,22,2,-20,41,1,-40,0.0,0.0,0.0,0.0,0.0,0.0
<a href=/player/hitcj101>hitcj101</a>,Jim Hitchcock,Washington Senators,TWINS,1,1,1,2,1938,1938,0,No,0,-0.94,0.0,0.94,28,0,-28,79,0,-79,0.0,0.0,0.0,0.0,0.0,0.0
<a href=/player/hitcs001>hitcs001</a>,Sterling Hitchcock,New York Yankees,YANKS,7,17,11,28,1995,2005,10,No,3,11.23,27.71,16.48,1522,1444,-78,2037,4006,1969,5289.0,3046.0,-2243.0,8771150.0,0.0,-8771150.0
<a href=/player/hitcs001>hitcs001</a>,Sterling Hitchcock,Seattle Mariners,MARNRS,2,4,3,7,1996,1998,2,No,0,5.62,-1.45,-7.07,293,63,-230,226,2,-224,2336.0,486.0,-1850.0,1535000.0,0.0,-1535000.0
<a href=/player/hitcs001>hitcs001</a>,Sterling Hitchcock,San Diego Padres,PADRS,1,1,2,3,2001,2002,1,No,0,-0.41,0.08,0.49,62,14,-48,0,4,4,421.0,70.0,-351.0,6000000.0,0.0,-6000000.0
<a href=/player/hitcs001>hitcs001</a>,Sterling Hitchcock,New York Yankees,YANKS,2,2,3,5,2003,2007,4,No,0,0.34,0.68,0.34,16,117,101,14,0,-14,114.0,368.0,254.0,6000000.0,0.0,-6000000.0
<a href=/player/hittl101>hittl101</a>,Lloyd Hittle,Oakland,Oakland,1,1,1,2,1949,1949,0,No,0,0.65,0.0,-0.65,94,0,-94,45,0,-45,457.0,0.0,-457.0,0.0,0.0,0.0
<a href=/player/hoagm101>hoagm101</a>,Myril Hoag,New York Yankees,YANKS,2,3,3,6,1938,1944,6,No,0,-0.13,2.92,3.05,384,138,-246,1290,241,-1049,3.0,438.0,435.0,17000.0,0.0,-17000.0
<a href=/player/hoakd101>hoakd101</a>,Don Hoak,Brooklyn Dodgers,DOGRS,2,4,4,8,1955,1961,6,No,0,18.38,2.09,-16.29,1649,196,-1453,2986,562,-2424,2426.0,26.0,-2400.0,0.0,0.0,0.0
<a href=/player/hoakd101>hoakd101</a>,Don Hoak,Chicago Cubs,CUBS,2,5,4,9,1956,1958,2,No,0,7.54,-1.1,-8.64,773,105,-668,2296,34,-2262,130.0,197.0,67.0,0.0,0.0,0.0
<a href=/player/hoakd101>hoakd101</a>,Don Hoak,Cincinnati Reds,REDS,4,7,11,18,1959,1965,6,No,0,63.65,9.6,-54.05,3136,1073,-2063,9911,1717,-8194,2563.0,935.0,-1628.0,0.0,0.0,0.0
<a href=/player/hoakd101>hoakd101</a>,Don Hoak,Pittsburgh Pirates,PIRATS,7,11,13,24,1962,1973,11,No,0,0.24,-0.26,-0.5,202,126,-76,599,202,-397,16.0,36.0,20.0,17500.0,0.0,-17500.0
<a href=/player/hobae101>hobae101</a>,Ed Hobaugh,Pittsburgh Pirates,PIRATS,1,1,1,2,1969,1969,0,No,0,0.0,0.0,0.0,0,0,0,0,0,0,0.0,0.0,0.0,0.0,0.0,0.0
<a href=/player/hobbg101>hobbg101</a>,Glen Hobbie,St. Louis Cardinals,CARDS,1,2,1,3,1965,1965,0,No,0,0.0,0.0,0.0,0,0,0,0,0,0,0.0,0.0,0.0,0.0,0.0,0.0
<a href=/player/hobbg101>hobbg101</a>,Glen Hobbie,Chicago Cubs,CUBS,1,2,2,4,1964,1965,1,No,0,0.14,0.31,0.17,26,71,45,14,56,42,133.0,454.0,321.0,0.0,0.0,0.0
<a href=/player/hobsb101>hobsb101</a>,Butch Hobson,Boston Red Sox,RSOX,3,6,6,12,1980,1989,9,No,0,34.32,7.26,-27.06,1836,1801,-35,6677,5369,-1308,547.0,1201.0,654.0,1020000.0,0.0,-1020000.0
<a href=/player/hobsb101>hobsb101</a>,Butch Hobson,California Angels,ANGELS,1,1,1,2,1982,1982,0,No,0,-0.81,0.0,0.81,30,0,-30,60,0,-60,0.0,0.0,0.0,0.0,0.0,0.0
<a href=/player/hocke101>hocke101</a>,Ed Hock,Pittsburgh Pirates,PIRATS,2,3,2,5,1924,1927,3,No,0,0.0,3.69,3.69,0,275,275,0,284,284,0.0,1850.0,1850.0,11200.0,0.0,-11200.0
<a href=/player/hocko101>hocko101</a>,Oris Hockett,Cleveland Indians,INDINS,1,1,1,2,1944,1946,2,No,0,1.66,-0.29,-1.95,106,32,-74,449,76,-373,0.0,6.0,6.0,7500.0,0.0,-7500.0
<a href=/player/hodaj101>hodaj101</a>,Johnny Hodapp,Cleveland Indians,INDINS,2,3,3,6,1932,1938,6,No,0,-0.54,9.51,10.05,286,513,227,1117,1176,59,0.0,1369.0,1369.0,22500.0,0.0,-22500.0
<a href=/player/hodaj101>hodaj101</a>,Johnny Hodapp,Chicago White Sox,WSOX,2,7,3,10,1932,1936,4,No,0,0.81,-0.11,-0.92,234,49,-185,748,93,-655,0.0,39.0,39.0,8600.0,0.0,-8600.0
<a href=/player/hodem101>hodem101</a>,Mel Hoderlein,Boston Red Sox,RSOX,4,10,9,19,1951,1956,5,No,0,13.39,14.14,0.75,1557,1085,-472,4986,3287,-1699,2205.0,1545.0,-660.0,102000.0,0.0,-102000.0
<a href=/player/hodem101>hodem101</a>,Mel Hoderlein,Chicago White Sox,WSOX,23,43,38,81,1952,1969,17,No,0,54.0,56.53,2.53,5273,4792,-481,13898,10899,-2999,7275.0,8147.0,872.0,226750.0,0.0,-226750.0
<a href=/player/hodem101>hodem101</a>,Mel Hoderlein,Washington Senators,TWINS,1,1,1,2,1954,1954,0,No,0,0.0,-0.31,-0.31,0,49,49,0,171,171,0.0,0.0,0.0,0.0,0.0,0.0
<a href=/player/hodgg101>hodgg101</a>,Gil Hodges,New York Mets,METS,1,1,1,2,1963,1963,0,No,0,0.0,-1.02,-1.02,0,40,40,0,140,140,0.0,0.0,0.0,0.0,0.0,0.0
<a href=/player/hodgg101>hodgg101</a>,Gil Hodges,Washington Senators,RNGRS,2,3,3,6,1967,1970,3,No,0,0.0,1.46,1.46,0,173,173,0,535,535,0.0,6.0,6.0,0.0,0.0,0.0
<a href=/player/hodgk001>hodgk001</a>,Kevin Hodges,Houston Astros,ASTROS,1,1,1,2,1999,2000,1,No,0,0.05,-0.77,-0.82,13,116,103,0,207,207,52.0,0.0,-52.0,0.0,0.0,0.0
<a href=/player/hodgs101>hodgs101</a>,Shovel Hodge,Chicago White Sox,WSOX,2,5,2,7,1922,1931,9,No,0,8.34,28.43,20.09,522,1292,770,2094,5360,3266,0.0,0.0,0.0,22100.0,0.0,-22100.0
<a href=/player/hoefb101>hoefb101</a>,Billy Hoeft,Detroit Tigers,TIGRS,6,10,9,19,1959,1967,8,No,0,4.03,3.78,-0.25,736,1035,299,2273,1950,-323,175.0,1285.0,1110.0,38000.0,0.0,-38000.0
<a href=/player/hoefb101>hoefb101</a>,Billy Hoeft,Boston Red Sox,RSOX,1,1,1,2,1959,1959,0,No,0,3.64,-0.28,-3.92,254,17,-237,85,11,-74,934.0,74.0,-860.0,0.0,0.0,0.0
<a href=/player/hoefb101>hoefb101</a>,Billy Hoeft,Baltimore Orioles,ORLS,17,34,32,66,1962,1994,32,No,3,53.81,109.37,55.56,3570,5799,2229,7519,12936,5417,13760.0,16382.0,2622.0,880833.0,0.0,-880833.0
<a href=/player/hoefb101>hoefb101</a>,Billy Hoeft,San Francisco Giants,GIANTS,8,14,12,26,1963,1972,9,No,0,20.6,12.56,-8.04,1709,1303,-406,5210,1731,-3479,1169.0,4789.0,3620.0,50000.0,0.0,-50000.0
<a href=/player/hoela101>hoela101</a>,Art Hoelskoetter,Cincinnati Reds,REDS,1,2,1,3,1909,1909,0,No,0,0.0,-0.02,-0.02,0,56,56,0,162,162,0.0,0.0,0.0,0.0,0.0,0.0
<a href=/player/hoerj101>hoerj101</a>,Joe Hoerner,St. Louis Cardinals,CARDS,30,57,53,110,1969,1998,29,No,7,115.3,176.27,60.97,11163,8552,-2611,30164,29400,-764,12224.0,4453.0,-7771.0,3323333.0,0.0,-3323333.0
<a href=/player/hoerj101>hoerj101</a>,Joe Hoerner,Philadelphia Phillies,PHILS,1,2,2,4,1972,1973,1,No,0,-1.32,-1.5,-0.18,90,36,-54,4,15,11,108.0,168.0,60.0,0.0,0.0,0.0
<a href=/player/hoesl001>hoesl001</a>,L.J. Hoes,Baltimore Orioles,ORLS,1,3,1,4,2013,2015,2,No,0,0.01,0.61,0.6,109,65,-44,333,11,-322,0.0,847.0,847.0,0.0,0.0,0.0
<a href=/player/hoeyj001>hoeyj001</a>,Jim Hoey,Baltimore Orioles,ORLS,1,2,2,4,2010,2017,7,No,0,-0.62,15.73,16.35,27,889,862,0,3636,3636,74.0,0.0,-74.0,0.0,0.0,0.0
<a href=/player/hoffd101>hoffd101</a>,Danny Hoffman,Philadelphia Athletics,ATLTCS,1,1,1,2,1906,1906,0,No,0,1.47,0.0,-1.47,236,0,-236,936,0,-936,0.0,0.0,0.0,0.0,0.0,0.0
<a href=/player/hoffd101>hoffd101</a>,Danny Hoffman,New York Yankees,YANKS,3,6,6,12,1907,1911,4,No,0,37.76,7.87,-29.89,2601,491,-2110,10473,2011,-8462,0.0,0.0,0.0,0.0,0.0,0.0
<a href=/player/hoffg001>hoffg001</a>,Glenn Hoffman,Boston Red Sox,RSOX,1,1,1,2,1987,1987,0,No,0,-0.25,0.0,0.25,40,0,-40,146,0,-146,0.0,0.0,0.0,300000.0,0.0,-300000.0
<a href=/player/hoffg002>hoffg002</a>,Guy Hoffman,Chicago Cubs,CUBS,2,2,3,5,1987,1988,1,No,0,0.82,-0.21,-1.03,92,11,-81,78,34,-44,476.0,0.0,-476.0,0.0,0.0,0.0
<a href=/player/hoffj001>hoffj001</a>,Jamie Hoffmann,Washington Nationals,NATEX,1,1,1,2,2009,2010,1,No,0,0.0,-0.85,-0.85,0,38,38,0,0,0,0.0,53.0,53.0,0.0,0.0,0.0
<a href=/player/hoffj003>hoffj003</a>,Jeff Hoffman,Toronto Blue Jays,BJAYS,1,4,2,6,2015,2018,3,No,0,-2.36,5.17,7.53,267,257,-10,284,987,703,875.0,49.0,-826.0,0.0,0.0,0.0
<a href=/player/hoffj003>hoffj003</a>,Jeff Hoffman,Colorado Rockies,ROCKS,1,2,2,4,2020,2020,0,Yes,0,1.03,0.0,-1.03,61,0,-61,16,0,-16,219.0,0.0,-219.0,0.0,0.0,0.0
<a href=/player/hoffj104>hoffj104</a>,John Hoffman,Houston Astros,ASTROS,1,3,3,6,1966,1968,2,No,0,0.0,-0.84,-0.84,0,120,120,0,7,7,0.0,229.0,229.0,0.0,0.0,0.0
<a href=/player/hoffr101>hoffr101</a>,Ray Hoffman,Washington Senators,TWINS,1,2,1,3,1943,1949,6,No,0,0.0,16.6,16.6,0,431,431,0,473,473,0.0,3875.0,3875.0,0.0,0.0,0.0
<a href=/player/hoffs101>hoffs101</a>,Stew Hofferth,Boston Braves,BRAVES,5,8,7,15,1946,1952,6,No,0,-0.23,27.12,27.35,358,923,565,547,3529,2982,596.0,210.0,-386.0,0.0,0.0,0.0
<a href=/player/hofft001>hofft001</a>,Trevor Hoffman,Florida Marlins,MARLNS,16,36,40,76,1993,2019,26,Yes,0,141.98,107.88,-34.1,6566,6100,-466,15461,18577,3116,13532.0,10298.0,-3234.0,68689667.0,0.0,-68689667.0
<a href=/player/hofmf101>hofmf101</a>,Fred Hofmann,New York Yankees,YANKS,2,6,4,10,1925,1931,6,No,0,-1.14,6.67,7.81,271,713,442,761,2895,2134,731.0,97.0,-634.0,31500.0,0.0,-31500.0
<a href=/player/hofmf101>hofmf101</a>,Fred Hofmann,StPaul,StPaul,5,7,11,18,1926,1930,4,No,0,0.96,0.0,-0.96,661,0,-661,1974,0,-1974,611.0,0.0,-611.0,0.0,0.0,0.0
<a href=/player/hofms101>hofms101</a>,Solly Hofman,Chicago Cubs,CUBS,1,2,2,4,1912,1915,3,No,0,-1.23,9.99,11.22,69,392,323,172,1573,1401,147.0,212.0,65.0,7400.0,0.0,-7400.0
<a href=/player/hogas101>hogas101</a>,Shanty Hogan,Boston Braves,BRAVES,14,32,26,58,1928,1952,24,No,0,61.82,116.64,54.82,3287,6047,2760,11058,20048,8990,3053.0,10767.0,7714.0,50600.0,0.0,-50600.0
<a href=/player/hogas101>hogas101</a>,Shanty Hogan,Washington Senators,TWINS,1,1,1,2,1937,1948,11,No,0,0.0,-0.01,-0.01,0,8,8,0,28,28,0.0,0.0,0.0,0.0,0.0,0.0
<a href=/player/hoggb102>hoggb102</a>,Brad Hogg,Boston Braves,BRAVES,3,5,8,13,1912,1927,15,No,0,12.92,47.85,34.93,874,2487,1613,3700,10349,6649,87.0,0.0,-87.0,6600.0,0.0,-6600.0
<a href=/player/hogsc101>hogsc101</a>,Chief Hogsett,Detroit Tigers,TIGRS,1,1,1,2,1936,1936,0,No,0,1.4,0.34,-1.06,159,138,-21,143,648,505,1178.0,0.0,-1178.0,6500.0,0.0,-6500.0
<a href=/player/hogsc101>hogsc101</a>,Chief Hogsett,St.Louis Browns,ORLS,1,1,1,2,1937,1937,0,No,0,-0.62,0.0,0.62,63,0,-63,25,0,-25,273.0,0.0,-273.0,7500.0,0.0,-7500.0
<a href=/player/hogub101>hogub101</a>,Bobby Hogue,St.Louis Browns,ORLS,24,54,49,103,1951,1994,43,No,3,83.31,156.11,72.8,5380,9168,3788,11255,26279,15024,18826.0,17928.0,-898.0,984333.0,0.0,-984333.0
<a href=/player/hohmb101>hohmb101</a>,Bill Hohman,Philadelphia Phillies,PHILS,1,3,1,4,1928,1928,0,No,0,0.0,1.31,1.31,0,96,96,0,292,292,0.0,0.0,0.0,0.0,0.0,0.0
<a href=/player/hoilc001>hoilc001</a>,Chris Hoiles,Detroit Tigers,TIGRS,2,4,2,6,1988,1989,1,No,1,23.49,1.15,-22.34,894,144,-750,3339,504,-2835,0.0,0.0,0.0,0.0,0.0,0.0
<a href=/player/holab001>holab001</a>,Bryan Holaday,Detroit Tigers,TIGRS,2,2,3,5,2016,2018,2,No,0,0.0,-1.52,-1.52,72,42,-30,235,15,-220,4.0,247.0,243.0,0.0,0.0,0.0
<a href=/player/holba001>holba001</a>,Aaron Holbert,Boston Red Sox,RSOX,1,1,1,2,2000,2001,1,No,0,0.0,0.0,0.0,0,0,0,0,0,0,0.0,0.0,0.0,0.0,0.0,0.0
<a href=/player/holbr001>holbr001</a>,Ray Holbert,San Diego Padres,PADRS,2,2,2,4,1995,1996,1,No,0,-0.24,0.0,0.24,10,0,-10,0,0,0,21.0,0.0,-21.0,115000.0,0.0,-115000.0
<a href=/player/holdb101>holdb101</a>,Bill Holden,New York Yankees,YANKS,1,2,1,3,1914,1914,0,No,0,0.0,2.96,2.96,0,77,77,0,321,321,0.0,0.0,0.0,0.0,0.0,0.0
<a href=/player/holdd001>holdd001</a>,David Holdridge,California Angels,ANGELS,1,1,1,2,1988,1992,4,No,0,0.0,7.6,7.6,0,400,400,0,1540,1540,0.0,0.0,0.0,0.0,0.0,0.0
<a href=/player/holdf101>holdf101</a>,Fred Holdsworth,Detroit Tigers,TIGRS,1,1,1,2,1975,1975,0,No,0,0.82,0.06,-0.76,28,21,-7,0,0,0,162.0,104.0,-58.0,0.0,0.0,0.0
<a href=/player/holdf101>holdf101</a>,Fred Holdsworth,Baltimore Orioles,ORLS,2,2,2,4,1977,1979,2,No,0,-0.24,0.0,0.24,50,0,-50,15,0,-15,195.0,0.0,-195.0,0.0,0.0,0.0
<a href=/player/holkw101>holkw101</a>,Walter Holke,New York Giants,GIANTS,1,2,1,3,1919,1919,0,No,0,0.24,1.26,1.02,178,110,-68,609,443,-166,0.0,0.0,0.0,0.0,0.0,0.0
<a href=/player/holkw101>holkw101</a>,Walter Holke,Cincinnati Reds,REDS,1,1,2,3,1919,1921,2,No,0,-0.18,0.38,0.56,536,28,-508,2218,48,-2170,0.0,0.0,0.0,0.0,0.0,0.0
<a href=/player/holla001>holla001</a>,Al Holland,Pittsburgh Pirates,PIRATS,3,5,7,12,1979,1990,11,No,1,17.64,30.66,13.02,910,2106,1196,973,7523,6550,3555.0,123.0,-3432.0,975500.0,0.0,-975500.0
<a href=/player/holla001>holla001</a>,Al Holland,San Francisco Giants,GIANTS,8,15,20,35,1982,1998,16,No,2,28.69,49.55,20.86,1722,3178,1456,1946,4612,2666,4662.0,9275.0,4613.0,10379278.0,0.0,-10379278.0
<a href=/player/holla001>holla001</a>,Al Holland,Philadelphia Phillies,PHILS,1,2,1,3,1985,1988,3,No,0,1.2,7.16,5.96,76,582,506,7,14,7,176.0,1102.0,926.0,0.0,0.0,0.0
<a href=/player/holla001>holla001</a>,Al Holland,Pittsburgh Pirates,PIRATS,4,8,9,17,1985,2001,16,No,2,9.24,22.17,12.93,548,1655,1107,771,2230,1459,2669.0,7059.0,4390.0,1290000.0,0.0,-1290000.0
<a href=/player/holla101>holla101</a>,Al Hollingsworth,Cincinnati Reds,REDS,1,3,1,4,1938,1948,10,No,0,2.9,43.86,40.96,235,653,418,553,968,415,703.0,7065.0,6362.0,0.0,0.0,0.0
<a href=/player/holla101>holla101</a>,Al Hollingsworth,Philadelphia Phillies,PHILS,1,1,1,2,1939,1940,1,No,0,0.0,-0.77,-0.77,0,66,66,0,267,267,0.0,0.0,0.0,5500.0,0.0,-5500.0
<a href=/player/hollb101>hollb101</a>,Bobo Holloman,Syracuse,Syracuse,1,1,2,3,1952,1952,0,No,0,-0.02,0.0,0.02,44,0,-44,22,0,-22,196.0,0.0,-196.0,0.0,0.0,0.0
<a href=/player/hollb102>hollb102</a>,Bonnie Hollingsworth,Washington Senators,TWINS,2,4,2,6,1923,1927,4,No,0,-0.1,-0.15,-0.05,6,6,0,3,9,6,26.0,0.0,-26.0,2800.0,0.0,-2800.0
<a href=/player/hollb102>hollb102</a>,Bonnie Hollingsworth,Brooklyn Dodgers,DOGRS,3,9,3,12,1926,1934,8,No,0,0.53,8.67,8.14,100,822,722,99,3036,2937,677.0,0.0,-677.0,30000.0,0.0,-30000.0
<a href=/player/hollb102>hollb102</a>,Bonnie Hollingsworth,Buffalo,Buffalo,1,1,3,4,1928,1929,1,No,0,-0.51,0.0,0.51,14,0,-14,6,0,-6,65.0,0.0,-65.0,0.0,0.0,0.0
<a href=/player/hollb102>hollb102</a>,Bonnie Hollingsworth,Pittsburgh Pirates,PIRATS,1,2,1,3,1922,1922,0,No,0,0.0,2.68,2.68,0,60,60,0,250,250,0.0,0.0,0.0,3000.0,0.0,-3000.0
<a href=/player/hollc102>hollc102</a>,Carl Holling,Detroit Tigers,TIGRS,2,6,3,9,1922,1928,6,No,0,20.71,4.6,-16.11,377,336,-41,782,333,-449,2967.0,2739.0,-228.0,8000.0,0.0,-8000.0
<a href=/player/holld001>holld001</a>,Dave Hollins,Philadelphia Phillies,PHILS,1,1,1,2,1995,1996,1,No,0,0.03,3.11,3.08,5,120,115,17,461,444,0.0,0.0,0.0,2000000.0,0.0,-2000000.0
<a href=/player/holld001>holld001</a>,Dave Hollins,Minnesota Twins,TWINS,1,1,1,2,1996,2002,6,No,0,1.11,2.59,1.48,28,455,427,113,1693,1580,0.0,0.0,0.0,1350000.0,0.0,-1350000.0
<a href=/player/holld001>holld001</a>,Dave Hollins,Anaheim Angels,ANGELS,1,2,1,3,1999,1999,0,No,0,-0.47,0.0,0.47,27,0,-27,104,0,-104,0.0,0.0,0.0,0.0,0.0,0.0
<a href=/player/holld002>holld002</a>,Damon Hollins,Atlanta Braves,BRAVES,1,1,1,2,1998,1998,0,No,0,-0.14,0.0,0.14,5,0,-5,9,0,-9,0.0,0.0,0.0,0.0,0.0,0.0
<a href=/player/holld003>holld003</a>,Derek Holland,San Francisco Giants,GIANTS,1,2,1,3,2019,2019,0,No,0,-0.25,0.0,0.25,40,0,-40,3,0,-3,47.0,0.0,-47.0,6500000.0,0.0,-6500000.0
<a href=/player/holld101>holld101</a>,Dutch Holland,Boston Braves,BRAVES,2,5,2,7,1933,1940,7,No,0,0.0,7.42,7.42,0,397,397,0,764,764,0.0,2031.0,2031.0,0.0,0.0,0.0
<a href=/player/hollg101>hollg101</a>,Gary Holle,Milwaukee Brewers,BREWRS,1,3,1,4,1978,1982,4,No,0,-0.15,-1.81,-1.66,16,109,93,7,0,-7,99.0,822.0,723.0,0.0,0.0,0.0
<a href=/player/hollg101>hollg101</a>,Gary Holle,Texas Rangers,RNGRS,2,3,4,7,1979,1979,0,No,0,4.47,0.48,-3.99,245,63,-182,304,166,-138,701.0,0.0,-701.0,35000.0,0.0,-35000.0
<a href=/player/hollg101>hollg101</a>,Gary Holle,Chicago White Sox,WSOX,1,2,1,3,1981,2007,26,No,0,0.0,0.0,0.0,0,0,0,0,0,0,0.0,0.0,0.0,0.0,0.0,0.0
<a href=/player/hollj102>hollj102</a>,Jeff Holly,Minnesota Twins,TWINS,1,1,1,2,1979,1982,3,No,0,0.0,1.41,1.41,0,50,50,0,0,0,0.0,703.0,703.0,0.0,0.0,0.0
<a href=/player/hollk101>hollk101</a>,Ken Holloway,Detroit Tigers,TIGRS,1,2,1,3,1928,1933,5,No,0,1.66,19.39,17.73,166,319,153,343,408,65,447.0,2479.0,2032.0,0.0,0.0,0.0
<a href=/player/hollk101>hollk101</a>,Ken Holloway,New York Yankees,YANKS,1,3,2,5,1930,1943,13,No,0,0.0,-0.48,-0.48,0,34,34,0,24,24,0.0,173.0,173.0,6500.0,0.0,-6500.0
<a href=/player/hollm001>hollm001</a>,Matt Holliday,Colorado Rockies,ROCKS,2,3,4,7,2008,2018,10,No,0,6.78,26.57,19.79,346,1598,1252,400,5087,4687,386.0,619.0,233.0,16800000.0,0.0,-16800000.0
<a href=/player/hollm001>hollm001</a>,Matt Holliday,Oakland Athletics,ATLTCS,5,5,7,12,2009,2014,5,Yes,0,23.49,-1.87,-25.36,1024,74,-950,4169,228,-3941,175.0,101.0,-74.0,13500000.0,0.0,-13500000.0
<a href=/player/hollt001>hollt001</a>,Todd Hollandsworth,Los Angeles Dodgers,DOGRS,1,3,2,5,2000,2002,2,No,0,3.81,0.2,-3.61,184,161,-23,631,541,-90,0.0,0.0,0.0,1450000.0,0.0,-1450000.0
<a href=/player/hollt001>hollt001</a>,Todd Hollandsworth,Colorado Rockies,ROCKS,2,3,4,7,2002,2003,1,No,0,-0.86,0.5,1.36,91,99,8,186,247,61,127.0,0.0,-127.0,3650000.0,0.0,-3650000.0
<a href=/player/hollt001>hollt001</a>,Todd Hollandsworth,Chicago Cubs,CUBS,1,1,2,3,2005,2005,0,No,0,-0.14,0.0,0.14,24,0,-24,40,0,-40,0.0,0.0,0.0,900000.0,0.0,-900000.0
<a href=/player/holmb001>holmb001</a>,Brian Holman,Montreal Expos,NATEX,5,7,7,14,1989,2004,15,No,2,50.88,22.34,-28.54,1051,869,-182,465,3122,2657,8418.0,885.0,-7533.0,4247000.0,0.0,-4247000.0
<a href=/player/holmc001>holmc001</a>,Clay Holmes,Pittsburgh Pirates,PIRATS,1,1,2,3,2021,2021,0,Yes,0,1.27,-0.22,-1.49,30,44,14,0,149,149,84.0,0.0,-84.0,0.0,0.0,0.0
<a href=/player/holmd001>holmd001</a>,Darren Holmes,Los Angeles Dodgers,DOGRS,1,1,1,2,1990,1991,1,No,0,0.9,0.0,-0.9,81,0,-81,0,0,0,356.0,0.0,-356.0,0.0,0.0,0.0
<a href=/player/holmd001>holmd001</a>,Darren Holmes,New York Yankees,YANKS,6,9,8,17,1999,2007,8,No,0,-0.49,1.43,1.92,152,223,71,86,143,57,355.0,822.0,467.0,6000000.0,0.0,-6000000.0
<a href=/player/holmd002>holmd002</a>,David Holmberg,Chicago White Sox,WSOX,5,8,8,16,2010,2016,6,Yes,0,2.25,4.26,2.01,475,264,-211,194,348,154,1677.0,1215.0,-462.0,13500000.0,0.0,-13500000.0
<a href=/player/holmd002>holmd002</a>,David Holmberg,Arizona Diamondbacks,DBACKS,1,3,2,5,2013,2013,0,Yes,0,-0.83,0.0,0.83,25,0,-25,19,0,-19,175.0,0.0,-175.0,9000000.0,0.0,-9000000.0
<a href=/player/holmd101>holmd101</a>,Ducky Holmes,New York Giants,GIANTS,1,3,2,5,1897,1903,6,No,0,-0.53,7.63,8.16,24,437,413,105,1697,1592,0.0,0.0,0.0,0.0,0.0,0.0
<a href=/player/holmd101>holmd101</a>,Ducky Holmes,St. Louis Cardinals,CARDS,1,2,2,4,1898,1899,1,No,0,4.06,2.38,-1.68,251,246,-5,1106,1032,-74,0.0,0.0,0.0,0.0,0.0,0.0
<a href=/player/holmd101>holmd101</a>,Ducky Holmes,Washington Senators,TWINS,1,1,1,2,1903,1904,1,No,0,3.7,-0.88,-4.58,246,53,-193,1041,69,-972,0.0,548.0,548.0,0.0,0.0,0.0
<a href=/player/holmd101>holmd101</a>,Ducky Holmes,Louisville Colonels,LS3,1,1,1,2,1897,1899,2,No,0,-0.53,1.74,2.27,80,162,82,338,693,355,0.0,0.0,0.0,0.0,0.0,0.0
<a href=/player/holms001>holms001</a>,Shawn Holman,Pittsburgh Pirates,PIRATS,1,2,1,3,1987,1987,0,No,0,0.26,-0.14,-0.4,5,36,31,0,73,73,30.0,0.0,-30.0,0.0,0.0,0.0
<a href=/player/holmt101>holmt101</a>,Tommy Holmes,New York Yankees,YANKS,1,1,2,3,1941,1946,5,No,0,36.09,1.7,-34.39,1289,132,-1157,5523,581,-4942,0.0,0.0,0.0,0.0,0.0,0.0
<a href=/player/holsh101>holsh101</a>,Herm Holshouser,Baltimore,Baltimore,1,1,1,2,1929,1937,8,No,0,-1.15,0.0,1.15,50,0,-50,20,0,-20,187.0,0.0,-187.0,0.0,0.0,0.0
<a href=/player/holsh101>holsh101</a>,Herm Holshouser,St.Louis Browns,ORLS,1,4,1,5,1930,1932,2,No,0,0.0,-0.31,-0.31,0,16,16,0,36,36,0.0,0.0,0.0,10000.0,0.0,-10000.0
<a href=/player/holtb001>holtb001</a>,Brian Holton,Los Angeles Dodgers,DOGRS,3,6,4,10,1988,1997,9,No,2,-1.54,8.26,9.8,185,646,461,229,2698,2469,523.0,0.0,-523.0,305000.0,0.0,-305000.0
<a href=/player/holtb002>holtb002</a>,Brock Holt,Pittsburgh Pirates,PIRATS,3,5,7,12,2012,2020,8,Yes,0,8.64,9.38,0.74,750,717,-33,2244,6,-2238,477.0,1130.0,653.0,4100000.0,0.0,-4100000.0
<a href=/player/holtc001>holtc001</a>,Chris Holt,Houston Astros,ASTROS,2,4,4,8,2000,2008,8,No,0,0.51,2.1,1.59,210,1212,1002,625,3536,2911,615.0,482.0,-133.0,4015000.0,0.0,-4015000.0
<a href=/player/holtj101>holtj101</a>,Jim Holt,Minnesota Twins,TWINS,4,4,6,10,1974,1982,8,No,0,3.99,8.12,4.13,544,1131,587,1693,4095,2402,0.0,0.0,0.0,285000.0,0.0,-285000.0
<a href=/player/holtk101>holtk101</a>,Ken Holtzman,Chicago Cubs,CUBS,7,10,15,25,1971,1996,25,No,0,34.49,106.79,72.3,2649,5222,2573,6342,21133,14791,5589.0,1723.0,-3866.0,56500.0,0.0,-56500.0
<a href=/player/holtk101>holtk101</a>,Ken Holtzman,Oakland Athletics,ATLTCS,2,4,6,10,1976,1978,2,No,0,9.34,5.62,-3.72,178,460,282,558,1294,736,944.0,1423.0,479.0,100000.0,0.0,-100000.0
<a href=/player/holtk101>holtk101</a>,Ken Holtzman,Baltimore Orioles,ORLS,10,21,19,40,1976,1994,18,No,3,48.77,85.06,36.29,2260,4349,2089,4427,10615,6188,10756.0,13691.0,2935.0,713333.0,0.0,-713333.0
<a href=/player/holtk101>holtk101</a>,Ken Holtzman,New York Yankees,YANKS,13,23,20,43,1978,2001,23,No,1,71.65,34.06,-37.59,4003,2107,-1896,9806,5316,-4490,11197.0,4891.0,-6306.0,4415000.0,0.0,-4415000.0
<a href=/player/holtr101>holtr101</a>,Roger Holt,New York Yankees,YANKS,1,1,2,3,1980,1982,2,No,0,0.0,-0.01,-0.01,0,3,3,0,0,0,0.0,0.0,0.0,0.0,0.0,0.0
<a href=/player/honer001>honer001</a>,Rick Honeycutt,Pittsburgh Pirates,PIRATS,1,1,1,2,1977,1977,0,No,0,5.34,0.09,-5.25,99,2,-97,0,0,0,1682.0,9.0,-1673.0,0.0,0.0,0.0
<a href=/player/honer001>honer001</a>,Rick Honeycutt,Seattle Mariners,MARNRS,2,7,7,14,1980,1985,5,No,0,8.79,3.61,-5.18,489,434,-55,632,1358,726,2623.0,1017.0,-1606.0,175000.0,0.0,-175000.0
<a href=/player/honer001>honer001</a>,Rick Honeycutt,Texas Rangers,RNGRS,3,4,5,9,1983,1987,4,No,0,5.59,2.54,-3.05,281,142,-139,223,0,-223,2004.0,1285.0,-719.0,505000.0,0.0,-505000.0
<a href=/player/honer001>honer001</a>,Rick Honeycutt,Los Angeles Dodgers,DOGRS,4,5,5,10,1987,1994,7,No,0,8.28,13.2,4.92,571,518,-53,366,1015,649,2339.0,2550.0,211.0,3705000.0,0.0,-3705000.0
<a href=/player/hoodd101>hoodd101</a>,Don Hood,Baltimore Orioles,ORLS,2,3,3,6,1975,1980,5,No,0,6.5,4.24,-2.26,389,566,177,845,1795,950,1484.0,0.0,-1484.0,0.0,0.0,0.0
<a href=/player/hoodd101>hoodd101</a>,Don Hood,Cleveland Indians,INDINS,2,2,3,5,1979,1983,4,No,0,1.25,1.33,0.08,95,171,76,227,541,314,202.0,0.0,-202.0,0.0,0.0,0.0
<a href=/player/hoodw102>hoodw102</a>,Wally Hood,New York Yankees,YANKS,2,6,2,8,1952,1955,3,No,0,5.35,0.58,-4.77,390,36,-354,1419,15,-1404,46.0,152.0,106.0,0.0,0.0,0.0
<a href=/player/hookc001>hookc001</a>,Chris Hook,Cincinnati Reds,REDS,1,2,1,3,1994,1994,0,No,0,-1.17,0.0,1.17,110,0,-110,5,0,-5,197.0,0.0,-197.0,0.0,0.0,0.0
<a href=/player/hookj101>hookj101</a>,Jay Hook,New York Mets,METS,1,2,1,3,1964,1966,2,No,0,-0.08,0.23,0.31,4,346,342,3,1225,1222,0.0,0.0,0.0,14000.0,0.0,-14000.0
<a href=/player/hoopb101>hoopb101</a>,Bob Hooper,Philadelphia Athletics,ATLTCS,52,120,132,252,1952,1976,24,No,0,220.07,117.92,-102.15,18021,16284,-1737,45492,48059,2567,21505.0,17498.0,-4007.0,571100.0,0.0,-571100.0
<a href=/player/hooph101>hooph101</a>,Harry Hooper,Boston Red Sox,RSOX,1,1,2,3,1921,1925,4,No,0,14.84,-2.09,-16.93,662,680,18,2921,2600,-321,0.0,0.0,0.0,0.0,0.0,0.0
<a href=/player/hootb001>hootb001</a>,Burt Hooton,Chicago Cubs,CUBS,2,2,3,5,1975,1977,2,No,0,25.57,-0.43,-26.0,697,68,-629,681,26,-655,5695.0,258.0,-5437.0,0.0,0.0,0.0
<a href=/player/hoovd101>hoovd101</a>,Dick Hoover,New York Giants,GIANTS,1,3,1,4,1948,1955,7,No,0,0.0,5.49,5.49,0,517,517,0,1993,1993,0.0,0.0,0.0,0.0,0.0,0.0
<a href=/player/hoovj001>hoovj001</a>,John Hoover,Baltimore Orioles,ORLS,2,4,3,7,1988,1990,2,No,0,0.11,0.05,-0.06,10,54,44,0,0,0,21.0,802.0,781.0,335000.0,0.0,-335000.0
<a href=/player/hoovj002>hoovj002</a>,J.J. Hoover,Atlanta Braves,BRAVES,2,2,2,4,2012,2013,1,Yes,0,-0.01,0.47,0.48,542,128,-414,271,320,49,727.0,0.0,-727.0,496250.0,0.0,-496250.0
<a href=/player/hopkg101>hopkg101</a>,Gail Hopkins,Chicago White Sox,WSOX,2,3,3,6,1970,1977,7,No,0,5.23,5.15,-0.08,607,692,85,1743,2721,978,0.0,0.0,0.0,15000.0,0.0,-15000.0
<a href=/player/hopkm102>hopkm102</a>,Marty Hopkins,StPaul,StPaul,1,1,3,4,1933,1934,1,No,0,-0.13,0.0,0.13,10,0,-10,32,0,-32,0.0,0.0,0.0,0.0,0.0,0.0
<a href=/player/hoppj102>hoppj102</a>,Johnny Hopp,St. Louis Cardinals,CARDS,2,2,6,8,1946,1946,0,No,0,33.57,0.0,-33.57,1180,0,-1180,5203,0,-5203,0.0,0.0,0.0,0.0,0.0,0.0
<a href=/player/hoppj102>hoppj102</a>,Johnny Hopp,Boston Braves,BRAVES,3,8,5,13,1947,1952,5,No,0,11.92,5.66,-6.26,840,490,-350,2908,1370,-1538,0.0,414.0,414.0,0.0,0.0,0.0
<a href=/player/hoppj102>hoppj102</a>,Johnny Hopp,Pittsburgh Pirates,PIRATS,1,2,1,3,1949,1949,0,No,0,-0.35,0.16,0.51,8,11,3,14,37,23,0.0,0.0,0.0,0.0,0.0,0.0
<a href=/player/hoppn001>hoppn001</a>,Norris Hopper,Cincinnati Reds,REDS,1,1,1,2,2009,2014,5,No,0,0.0,0.57,0.57,0,70,70,0,189,189,0.0,0.0,0.0,0.0,0.0,0.0
<a href=/player/horgj001>horgj001</a>,Joe Horgan,St. Louis Cardinals,CARDS,1,1,1,2,2004,2004,0,No,0,-0.23,0.0,0.23,108,0,-108,4,0,-4,138.0,0.0,-138.0,0.0,0.0,0.0
<a href=/player/hornr101>hornr101</a>,Rogers Hornsby,St. Louis Cardinals,CARDS,2,3,5,8,1926,1928,2,No,0,9.03,-0.55,-9.58,290,26,-264,876,8,-868,529.0,99.0,-430.0,43300.0,0.0,-43300.0
<a href=/player/hornr101>hornr101</a>,Rogers Hornsby,New York Giants,GIANTS,3,4,4,8,1928,1932,4,No,0,11.68,8.72,-2.96,421,964,543,1650,3531,1881,0.0,0.0,0.0,0.0,0.0,0.0
<a href=/player/hornr101>hornr101</a>,Rogers Hornsby,Boston Braves,BRAVES,13,30,25,55,1928,1952,24,No,0,51.23,107.73,56.5,2507,5907,3400,8176,19427,11251,3053.0,10767.0,7714.0,50600.0,0.0,-50600.0
<a href=/player/horsj001>horsj001</a>,Jeremy Horst,Cincinnati Reds,REDS,1,1,1,2,2012,2012,0,No,0,0.43,-1.68,-2.11,118,77,-41,0,208,208,172.0,0.0,-172.0,0.0,0.0,0.0
<a href=/player/horso101>horso101</a>,Oscar Horstmann,LosAngeles,LosAngeles,1,1,2,3,1916,1916,0,No,0,-1.81,0.0,1.81,100,0,-100,58,0,-58,526.0,0.0,-526.0,0.0,0.0,0.0
<a href=/player/horte101>horte101</a>,Elmer Horton,Pittsburgh Pirates,PIRATS,1,4,2,6,1896,1898,2,No,0,3.6,0.48,-3.12,234,186,-48,984,763,-221,0.0,0.0,0.0,0.0,0.0,0.0
<a href=/player/hortr001>hortr001</a>,Ricky Horton,St. Louis Cardinals,CARDS,1,3,1,4,1988,1992,4,No,0,20.88,6.84,-14.04,997,319,-678,3820,320,-3500,328.0,2753.0,2425.0,0.0,0.0,0.0
<a href=/player/hortr001>hortr001</a>,Ricky Horton,Chicago White Sox,WSOX,3,4,5,9,1988,1991,3,No,0,0.47,0.93,0.46,167,119,-48,55,126,71,808.0,528.0,-280.0,1847500.0,0.0,-1847500.0
<a href=/player/hortt101>hortt101</a>,Tony Horton,Boston Red Sox,RSOX,1,2,1,3,1967,1968,1,No,0,7.67,2.77,-4.9,564,128,-436,2155,127,-2028,0.0,1094.0,1094.0,17000.0,0.0,-17000.0
<a href=/player/hortw101>hortw101</a>,Willie Horton,Detroit Tigers,TIGRS,1,1,1,2,1977,1978,1,No,0,0.95,1.94,0.99,139,68,-71,569,0,-569,0.0,335.0,335.0,105000.0,0.0,-105000.0
<a href=/player/hortw101>hortw101</a>,Willie Horton,Texas Rangers,RNGRS,1,2,2,4,1978,1978,0,No,0,0.81,0.78,-0.03,88,77,-11,186,217,31,597.0,0.0,-597.0,0.0,0.0,0.0
<a href=/player/hortw101>hortw101</a>,Willie Horton,Oakland Athletics,ATLTCS,1,2,1,3,1978,1978,0,No,0,-2.52,1.35,3.87,64,41,-23,127,163,36,519.0,0.0,-519.0,0.0,0.0,0.0
<a href=/player/hortw101>hortw101</a>,Willie Horton,Seattle Mariners,MARNRS,2,7,7,14,1980,1985,5,No,0,8.79,3.61,-5.18,489,434,-55,632,1358,726,2623.0,1017.0,-1606.0,175000.0,0.0,-175000.0
<a href=/player/hosed001>hosed001</a>,Dwayne Hosey,Boston Red Sox,RSOX,5,9,9,18,1996,2000,4,No,0,9.7,3.32,-6.38,608,447,-161,1634,946,-688,1320.0,379.0,-941.0,7038500.0,0.0,-7038500.0
<a href=/player/hoses001>hoses001</a>,Steve Hosey,San Francisco Giants,GIANTS,1,1,1,2,1994,1994,0,No,0,0.0,0.0,0.0,0,0,0,0,0,0,0.0,0.0,0.0,0.0,0.0,0.0
<a href=/player/hoslt101>hoslt101</a>,Tim Hosley,Detroit Tigers,TIGRS,1,1,1,2,1973,1973,0,No,0,0.1,0.0,-0.1,131,0,-131,233,0,-233,0.0,0.0,0.0,0.0,0.0,0.0
<a href=/player/hostd001>hostd001</a>,Dave Hostetler,Montreal Expos,NATEX,4,6,6,12,1982,1992,10,No,0,4.42,9.75,5.33,1501,1079,-422,5161,3321,-1840,201.0,164.0,-37.0,415000.0,0.0,-415000.0
<a href=/player/hostd001>hostd001</a>,Dave Hostetler,Texas Rangers,RNGRS,1,1,1,2,1984,1985,1,No,0,0.0,0.73,0.73,0,25,25,0,0,0,0.0,229.0,229.0,0.0,0.0,0.0
<a href=/player/hostg101>hostg101</a>,Gene Host,Detroit Tigers,TIGRS,4,10,9,19,1956,1961,5,No,0,13.15,0.77,-12.38,602,579,-23,394,1616,1222,3228.0,40.0,-3188.0,13200.0,0.0,-13200.0
<a href=/player/hottk101>hottk101</a>,Ken Hottman,Chicago White Sox,WSOX,7,10,9,19,1974,1985,11,No,1,12.65,6.39,-6.26,638,697,59,1614,2532,918,1538.0,190.0,-1348.0,0.0,0.0,0.0
<a href=/player/hottt001>hottt001</a>,Tommy Hottovy,Kansas City Royals,ROYALS,1,1,1,2,2012,2013,1,Yes,0,0.0,0.0,0.0,0,0,0,0,0,0,0.0,0.0,0.0,0.0,0.0,0.0
<a href=/player/housa001>housa001</a>,Adrian Houser,Houston Astros,ASTROS,1,4,3,7,2015,2017,2,No,0,18.89,0.28,-18.61,984,198,-786,1471,487,-984,1823.0,1153.0,-670.0,0.0,0.0,0.0
<a href=/player/housc001>housc001</a>,Craig House,Colorado Rockies,ROCKS,1,3,3,6,2002,2002,0,No,0,0.0,0.1,0.1,0,193,193,0,708,708,0.0,3.0,3.0,0.0,0.0,0.0
<a href=/player/housf103>housf103</a>,Frank House,Detroit Tigers,TIGRS,4,12,12,24,1957,1964,7,No,0,6.47,14.38,7.91,1197,947,-250,3186,1303,-1883,1459.0,3692.0,2233.0,20000.0,0.0,-20000.0
<a href=/player/housf103>housf103</a>,Frank House,Kansas City Athletics,ATLTCS,1,1,1,2,1959,1959,0,No,0,-0.26,0.0,0.26,23,0,-23,28,0,-28,0.0,0.0,0.0,14000.0,0.0,-14000.0
<a href=/player/housf103>housf103</a>,Frank House,Baltimore Orioles,ORLS,2,4,2,6,1961,1962,1,No,0,-0.2,0.84,1.04,28,78,50,36,316,280,0.0,0.0,0.0,0.0,0.0,0.0
<a href=/player/housp001>housp001</a>,Paul Householder,Cincinnati Reds,REDS,4,7,5,12,1984,1988,4,No,0,12.23,4.23,-8.0,905,294,-611,634,363,-271,4251.0,1846.0,-2405.0,1977500.0,0.0,-1977500.0
<a href=/player/housp001>housp001</a>,Paul Householder,St. Louis Cardinals,CARDS,1,2,3,5,1984,1984,0,No,0,0.51,0.0,-0.51,168,0,-168,529,0,-529,0.0,0.0,0.0,0.0,0.0,0.0
<a href=/player/housp101>housp101</a>,Pat House,Houston Astros,ASTROS,2,4,2,6,1969,1973,4,No,0,-0.36,3.98,4.34,121,303,182,243,70,-173,0.0,713.0,713.0,23500.0,0.0,-23500.0
<a href=/player/houst001>houst001</a>,Tyler Houston,Atlanta Braves,BRAVES,1,1,1,2,1996,1996,0,No,0,-0.41,0.0,0.41,313,0,-313,880,0,-880,0.0,0.0,0.0,109000.0,0.0,-109000.0
<a href=/player/houst001>houst001</a>,Tyler Houston,Chicago Cubs,CUBS,2,2,2,4,1999,2003,4,No,0,-0.08,-0.39,-0.31,13,148,135,30,359,329,0.0,0.0,0.0,715000.0,0.0,-715000.0
<a href=/player/houst001>houst001</a>,Tyler Houston,Milwaukee Brewers,BREWRS,8,15,17,32,2002,2012,10,No,2,36.64,23.05,-13.59,2498,2040,-458,9346,4727,-4619,883.0,6494.0,5611.0,10372000.0,0.0,-10372000.0
<a href=/player/houst101>houst101</a>,Tom House,Atlanta Braves,BRAVES,4,9,4,13,1975,1983,8,No,0,3.54,6.25,2.71,540,620,80,1015,2104,1089,1077.0,319.0,-758.0,33500.0,0.0,-33500.0
<a href=/player/housw001>housw001</a>,Wayne Housie,New York Mets,METS,1,1,1,2,1993,1995,2,No,0,0.0,0.66,0.66,0,110,110,0,6,6,0.0,226.0,226.0,0.0,0.0,0.0
<a href=/player/houta101>houta101</a>,Art Houtteman,Detroit Tigers,TIGRS,3,7,7,14,1953,1959,6,No,0,19.59,21.85,2.26,1560,1406,-154,4177,3381,-796,3244.0,3436.0,192.0,42000.0,0.0,-42000.0
<a href=/player/hovls101>hovls101</a>,Steve Hovley,Milwaukee Brewers,BREWRS,3,3,4,7,1970,1972,2,No,0,4.87,1.11,-3.76,485,256,-229,600,535,-65,2693.0,283.0,-2410.0,15000.0,0.0,-15000.0
<a href=/player/howab001>howab001</a>,Ben Howard,San Diego Padres,PADRS,3,3,3,6,2004,2007,3,No,0,-0.35,-0.09,0.26,80,198,118,21,28,7,137.0,291.0,154.0,375000.0,0.0,-375000.0
<a href=/player/howab101>howab101</a>,Bruce Howard,Chicago White Sox,WSOX,6,9,10,19,1967,1977,10,No,0,29.24,13.29,-15.95,1920,1924,4,6795,7037,242,306.0,62.0,-244.0,134800.0,0.0,-134800.0
<a href=/player/howab101>howab101</a>,Bruce Howard,Baltimore Orioles,ORLS,1,1,1,2,1968,1968,0,No,0,-0.83,-0.23,0.6,26,47,21,16,99,83,146.0,0.0,-146.0,17500.0,0.0,-17500.0
<a href=/player/howac002>howac002</a>,Chris Howard,Boston Red Sox,RSOX,1,1,1,2,1995,1995,0,No,0,0.15,0.0,-0.15,4,0,-4,0,0,0,12.0,0.0,-12.0,0.0,0.0,0.0
<a href=/player/howad101>howad101</a>,Doug Howard,California Angels,ANGELS,2,2,2,4,1974,1975,1,No,0,-0.2,1.02,1.22,112,118,6,228,415,187,0.0,0.0,0.0,12500.0,0.0,-12500.0
<a href=/player/howad101>howad101</a>,Doug Howard,St. Louis Cardinals,CARDS,1,1,1,2,1975,1976,1,No,0,-0.77,-0.23,0.54,39,16,-23,99,45,-54,0.0,0.0,0.0,0.0,0.0,0.0
<a href=/player/howad101>howad101</a>,Doug Howard,Cleveland Indians,INDINS,1,2,1,3,1976,1978,2,No,0,1.98,-0.52,-2.5,205,36,-169,757,0,-757,0.0,442.0,442.0,0.0,0.0,0.0
<a href=/player/howad102>howad102</a>,Del Howard,Pittsburgh Pirates,PIRATS,1,3,1,4,1905,1910,5,No,0,9.35,21.13,11.78,731,320,-411,2264,464,-1800,2702.0,3628.0,926.0,0.0,0.0,0.0
<a href=/player/howad102>howad102</a>,Del Howard,Boston Braves,BRAVES,2,3,3,6,1907,1917,10,No,0,1.63,18.44,16.81,350,1294,944,1288,5367,4079,0.0,0.0,0.0,0.0,0.0,0.0
<a href=/player/howad102>howad102</a>,Del Howard,Philadelphia Phillies,PHILS,1,2,3,5,1904,1911,7,No,0,1.77,5.1,3.33,253,872,619,1002,3354,2352,15.0,0.0,-15.0,0.0,0.0,0.0
<a href=/player/howae101>howae101</a>,Elston Howard,New York Yankees,YANKS,2,3,3,6,1967,1973,6,No,0,-0.3,3.2,3.5,176,440,264,366,1171,805,181.0,337.0,156.0,64000.0,0.0,-64000.0
<a href=/player/howaf102>howaf102</a>,Frank Howard,Los Angeles Dodgers,DOGRS,4,12,9,21,1964,1984,20,No,0,57.0,60.48,3.48,4290,2463,-1827,14544,7259,-7285,4034.0,7191.0,3157.0,163000.0,0.0,-163000.0
<a href=/player/howal102>howal102</a>,Larry Howard,Houston Astros,ASTROS,1,1,1,2,1973,1973,0,No,0,-0.15,0.0,0.15,4,0,-4,10,0,-10,0.0,0.0,0.0,0.0,0.0,0.0
<a href=/player/howas003>howas003</a>,Spencer Howard,Philadelphia Phillies,PHILS,1,3,4,7,2021,2021,0,Yes,0,-1.21,0.8,2.01,9,74,65,0,29,29,64.0,300.0,236.0,0.0,0.0,0.0
<a href=/player/howat001>howat001</a>,Thomas Howard,San Diego Padres,PADRS,1,1,2,3,1992,1994,2,No,0,0.89,0.0,-0.89,191,0,-191,581,0,-581,0.0,0.0,0.0,158000.0,0.0,-158000.0
<a href=/player/howat001>howat001</a>,Thomas Howard,Cleveland Indians,INDINS,3,3,3,6,1993,1994,1,No,0,0.28,0.96,0.68,412,25,-387,1134,61,-1073,15.0,40.0,25.0,325000.0,0.0,-325000.0
<a href=/player/howaw101>howaw101</a>,Wilbur Howard,Milwaukee Brewers,BREWRS,1,1,2,3,1974,1974,0,No,0,-0.22,0.0,0.22,450,0,-450,1093,0,-1093,0.0,0.0,0.0,0.0,0.0,0.0
<a href=/player/howea001>howea001</a>,Art Howe,Pittsburgh Pirates,PIRATS,1,1,1,2,1976,1976,0,No,0,13.73,0.23,-13.5,706,62,-644,2543,102,-2441,0.0,0.0,0.0,0.0,0.0,0.0
<a href=/player/howeb101>howeb101</a>,Bill Howerton,Boston Red Sox,RSOX,1,2,1,3,1946,1946,0,No,0,3.72,0.0,-3.72,260,0,-260,831,0,-831,0.0,0.0,0.0,0.0,0.0,0.0
<a href=/player/howeb101>howeb101</a>,Bill Howerton,St. Louis Cardinals,CARDS,3,10,5,15,1951,1954,3,No,0,10.75,2.71,-8.04,1144,382,-762,2713,1234,-1479,1601.0,388.0,-1213.0,41500.0,0.0,-41500.0
<a href=/player/howed102>howed102</a>,Dixie Howell,Baltimore,Baltimore,1,1,4,5,1941,1942,1,No,0,-0.11,0.0,0.11,24,0,-24,62,0,-62,0.0,0.0,0.0,0.0,0.0,0.0
<a href=/player/howed102>howed102</a>,Dixie Howell,Brooklyn Dodgers,DOGRS,1,5,2,7,1947,1947,0,No,0,3.3,-0.19,-3.49,337,37,-300,419,81,-338,1285.0,0.0,-1285.0,17500.0,0.0,-17500.0
<a href=/player/howed102>howed102</a>,Dixie Howell,Pittsburgh Pirates,PIRATS,1,5,1,6,1947,1948,1,No,0,0.0,0.0,0.0,0,0,0,0,0,0,0.0,0.0,0.0,0.0,0.0,0.0
<a href=/player/howed102>howed102</a>,Dixie Howell,Cincinnati Reds,REDS,1,2,1,3,1952,1952,0,No,0,-0.11,0.0,0.11,24,0,-24,62,0,-62,0.0,0.0,0.0,8000.0,0.0,-8000.0
<a href=/player/howeh101>howeh101</a>,Harry Howell,New York Yankees,YANKS,1,2,1,3,1904,1905,1,No,0,24.65,2.89,-21.76,418,168,-250,671,224,-447,4716.0,1776.0,-2940.0,0.0,0.0,0.0
<a href=/player/howej001>howej001</a>,Jay Howell,Cincinnati Reds,REDS,2,2,2,4,1980,1983,3,No,0,-0.12,0.72,0.84,46,76,30,70,183,113,67.0,0.0,-67.0,0.0,0.0,0.0
<a href=/player/howej001>howej001</a>,Jay Howell,Chicago Cubs,CUBS,4,8,7,15,1982,1990,8,No,0,11.89,11.37,-0.52,835,655,-180,2292,401,-1891,1070.0,3028.0,1958.0,890000.0,0.0,-890000.0
<a href=/player/howej001>howej001</a>,Jay Howell,New York Yankees,YANKS,3,7,8,15,1984,1993,9,No,0,53.43,36.99,-16.44,2484,1135,-1349,8455,3089,-5366,3002.0,2795.0,-207.0,2415000.0,0.0,-2415000.0
<a href=/player/howej001>howej001</a>,Jay Howell,Oakland Athletics,ATLTCS,1,4,2,6,1987,1994,7,No,0,8.57,10.76,2.19,979,216,-763,1815,1,-1814,1096.0,3814.0,2718.0,1137653.0,0.0,-1137653.0
<a href=/player/howej002>howej002</a>,Jack Howell,California Angels,ANGELS,1,1,1,2,1991,1992,1,No,0,0.71,-0.68,-1.39,58,41,-17,179,105,-74,0.0,0.0,0.0,652500.0,0.0,-652500.0
<a href=/player/howej003>howej003</a>,J.P. Howell,Kansas City Royals,ROYALS,1,1,2,3,2006,2008,2,No,0,3.83,0.65,-3.18,274,266,-8,7,855,848,991.0,0.0,-991.0,0.0,0.0,0.0
<a href=/player/howek001>howek001</a>,Ken Howell,Los Angeles Dodgers,DOGRS,3,6,4,10,1988,1997,9,No,2,-1.54,8.26,9.8,185,646,461,229,2698,2469,523.0,0.0,-523.0,305000.0,0.0,-305000.0
<a href=/player/howek001>howek001</a>,Ken Howell,Baltimore Orioles,ORLS,2,3,2,5,1988,1990,2,No,0,3.17,2.97,-0.2,157,238,81,279,1027,748,944.0,0.0,-944.0,1150000.0,0.0,-1150000.0
<a href=/player/howep001>howep001</a>,Pat Howell,New York Mets,METS,1,1,1,2,1992,1992,0,No,0,0.0,0.0,0.0,0,0,0,0,0,0,0.0,0.0,0.0,0.0,0.0,0.0
<a href=/player/hower001>hower001</a>,Roy Howell,Texas Rangers,RNGRS,2,2,4,6,1977,1978,1,No,0,8.86,-0.59,-9.45,556,97,-459,2246,181,-2065,0.0,37.0,37.0,0.0,0.0,0.0
<a href=/player/howld101>howld101</a>,Dan Howley,Philadelphia Phillies,PHILS,1,2,1,3,1913,1913,0,No,0,0.0,0.0,0.0,0,17,17,0,37,37,0.0,0.0,0.0,2400.0,0.0,-2400.0
<a href=/player/howrb001>howrb001</a>,Bob Howry,San Francisco Giants,GIANTS,4,11,8,19,1997,2001,4,No,4,22.98,0.1,-22.88,1111,210,-901,1153,268,-885,2846.0,875.0,-1971.0,0.0,0.0,0.0
<a href=/player/howrb001>howrb001</a>,Bob Howry,Chicago White Sox,WSOX,2,4,3,7,2002,2003,1,No,0,4.79,2.04,-2.75,399,73,-326,0,289,289,1315.0,0.0,-1315.0,1200000.0,0.0,-1200000.0
<a href=/player/howsd101>howsd101</a>,Dick Howser,Kansas City Athletics,ATLTCS,12,26,19,45,1963,1976,13,No,0,41.52,16.46,-25.06,5320,2149,-3171,12652,5616,-7036,5181.0,2140.0,-3041.0,368100.0,0.0,-368100.0
<a href=/player/howsd101>howsd101</a>,Dick Howser,Cleveland Indians,INDINS,1,1,2,3,1966,1966,0,No,0,0.83,0.0,-0.83,148,0,-148,368,0,-368,0.0,0.0,0.0,16500.0,0.0,-16500.0
<a href=/player/hoy-d101>hoy-d101</a>,Dummy Hoy,Washington Senators,WSN,1,1,1,2,1893,1894,1,No,0,9.13,-1.19,-10.32,556,40,-516,2583,60,-2523,0.0,353.0,353.0,0.0,0.0,0.0
<a href=/player/hoy-d101>hoy-d101</a>,Dummy Hoy,Cincinnati Reds,REDS,2,5,2,7,1898,1898,0,No,0,7.73,2.21,-5.52,627,66,-561,2681,105,-2576,267.0,786.0,519.0,0.0,0.0,0.0
<a href=/player/hoytj001>hoytj001</a>,James Hoyt,Atlanta Braves,BRAVES,1,2,3,5,2015,2020,5,Yes,0,5.33,4.65,-0.68,563,307,-256,1880,420,-1460,215.0,2002.0,1787.0,0.0,0.0,0.0
<a href=/player/hoytj001>hoytj001</a>,James Hoyt,Houston Astros,ASTROS,1,1,1,2,2018,2018,0,Yes,0,0.22,0.0,-0.22,9,0,-9,0,0,0,25.0,0.0,-25.0,0.0,0.0,0.0
<a href=/player/hoytl001>hoytl001</a>,LaMarr Hoyt,New York Yankees,YANKS,4,7,7,14,1977,1983,6,No,0,29.7,12.76,-16.94,1788,732,-1056,2195,2573,378,4627.0,0.0,-4627.0,0.0,0.0,0.0
<a href=/player/hoytl001>hoytl001</a>,LaMarr Hoyt,Chicago White Sox,WSOX,3,5,6,11,1984,1997,13,No,0,0.78,21.51,20.73,266,2126,1860,135,7098,6963,1605.0,1633.0,28.0,720500.0,0.0,-720500.0
<a href=/player/hoytw101>hoytw101</a>,Waite Hoyt,New York Giants,GIANTS,2,8,3,11,1919,1923,4,No,0,10.49,7.89,-2.6,305,402,97,539,1094,555,2035.0,323.0,-1712.0,12500.0,0.0,-12500.0
<a href=/player/hoytw101>hoytw101</a>,Waite Hoyt,Boston Red Sox,RSOX,11,21,24,45,1920,1937,17,No,0,85.68,51.32,-34.36,3377,2671,-706,8411,9094,683,11819.0,4939.0,-6880.0,73300.0,0.0,-73300.0
<a href=/player/hoytw101>hoytw101</a>,Waite Hoyt,New York Yankees,YANKS,1,2,3,5,1930,1931,1,No,0,-1.14,0.55,1.69,271,146,-125,761,467,-294,731.0,97.0,-634.0,25000.0,0.0,-25000.0
<a href=/player/hraba101>hraba101</a>,Al Hrabosky,St. Louis Cardinals,CARDS,3,3,4,7,1977,1984,7,No,0,7.28,-0.76,-8.04,491,152,-339,738,21,-717,1187.0,232.0,-955.0,0.0,0.0,0.0
<a href=/player/hrinw101>hrinw101</a>,Walt Hriniak,Atlanta Braves,BRAVES,1,3,1,4,1969,1970,1,No,0,-0.8,2.26,3.06,142,212,70,403,844,441,0.0,0.0,0.0,0.0,0.0,0.0
<a href=/player/hrinw101>hrinw101</a>,Walt Hriniak,San Diego Padres,PADRS,1,1,1,2,1971,1971,0,No,0,0.0,0.0,0.0,0,0,0,0,0,0,0.0,0.0,0.0,0.0,0.0,0.0
<a href=/player/hu--c001>hu--c001</a>,Chin-lung Hu,Los Angeles Dodgers,DOGRS,1,1,1,2,2010,2010,0,No,0,-0.43,0.0,0.43,22,0,-22,23,0,-23,0.0,0.0,0.0,0.0,0.0,0.0
<a href=/player/hu--c002>hu--c002</a>,Chih-Wei Hu,Minnesota Twins,TWINS,1,2,1,3,2015,2016,1,No,0,0.22,0.73,0.51,11,63,52,0,0,0,69.0,176.0,107.0,0.0,0.0,0.0
<a href=/player/hu--c002>hu--c002</a>,Chih-Wei Hu,Tampa Bay Devil Rays,RAYS,1,1,1,2,2018,2018,0,Yes,0,0.0,0.0,0.0,0,0,0,0,0,0,0.0,0.0,0.0,0.0,0.0,0.0
<a href=/player/huanw001>huanw001</a>,Wei-Chieh Huang,Arizona Diamondbacks,DBACKS,1,2,1,3,2018,2018,0,No,0,-0.06,-0.87,-0.81,4,48,44,0,0,0,17.0,43.0,26.0,0.0,0.0,0.0
<a href=/player/hubbb101>hubbb101</a>,Bill Hubbell,Philadelphia Phillies,PHILS,6,10,10,20,1925,1940,15,No,0,39.24,40.12,0.88,1970,2808,838,7440,9949,2509,260.0,679.0,419.0,26000.0,0.0,-26000.0
<a href=/player/hubbb101>hubbb101</a>,Bill Hubbell,Brooklyn Dodgers,DOGRS,3,9,3,12,1926,1934,8,No,0,0.53,8.67,8.14,100,822,722,99,3036,2937,677.0,0.0,-677.0,30000.0,0.0,-30000.0
<a href=/player/hubbt001>hubbt001</a>,Trent Hubbard,San Francisco Giants,GIANTS,4,6,9,15,1996,2008,12,No,2,6.64,34.66,28.02,354,1877,1523,690,4566,3876,695.0,1319.0,624.0,6936000.0,0.0,-6936000.0
<a href=/player/hubbt001>hubbt001</a>,Trent Hubbard,Atlanta Braves,BRAVES,1,3,2,5,2000,2002,2,No,0,-0.42,1.16,1.58,107,214,107,224,759,535,2.0,6.0,4.0,800000.0,0.0,-800000.0
<a href=/player/hubec101>hubec101</a>,Clarence Huber,Beaumont,Beaumont,1,1,2,3,1924,1924,0,No,0,-0.97,0.0,0.97,242,0,-242,891,0,-891,0.0,0.0,0.0,0.0,0.0,0.0
<a href=/player/hubej001>hubej001</a>,Justin Huber,New York Mets,METS,5,7,7,14,2004,2010,6,No,0,-2.18,11.14,13.32,693,533,-160,2079,723,-1356,683.0,3210.0,2527.0,2841000.0,0.0,-2841000.0
<a href=/player/hubej002>hubej002</a>,Jon Huber,San Diego Padres,PADRS,1,1,1,2,2004,2004,0,No,0,0.86,-0.59,-1.45,25,29,4,0,31,31,84.0,0.0,-84.0,0.0,0.0,0.0
<a href=/player/hudej001>hudej001</a>,John Hudek,Houston Astros,ASTROS,2,2,3,5,1997,2007,10,No,0,5.91,21.57,15.66,290,905,615,1010,3428,2418,81.0,0.0,-81.0,2912500.0,0.0,-2912500.0
<a href=/player/hudej001>hudej001</a>,John Hudek,New York Mets,METS,1,1,1,2,1998,1998,0,No,0,0.42,-0.44,-0.86,64,75,11,4,184,180,114.0,0.0,-114.0,499000.0,0.0,-499000.0
<a href=/player/hudej001>hudej001</a>,John Hudek,Cincinnati Reds,REDS,2,2,3,5,1999,2001,2,No,0,-0.05,0.18,0.23,63,99,36,1,0,-1,157.0,180.0,23.0,1300000.0,0.0,-1300000.0
<a href=/player/hudlr001>hudlr001</a>,Rex Hudler,New York Yankees,YANKS,1,2,2,4,1985,1986,1,No,0,0.34,-0.33,-0.67,66,76,10,1,188,187,321.0,0.0,-321.0,0.0,0.0,0.0
<a href=/player/hudlr001>hudlr001</a>,Rex Hudler,Montreal Expos,NATEX,2,2,2,4,1990,1990,0,No,0,0.43,-0.22,-0.65,305,8,-297,560,0,-560,105.0,19.0,-86.0,135000.0,0.0,-135000.0
<a href=/player/hudsc001>hudsc001</a>,Charles Hudson,Philadelphia Phillies,PHILS,5,8,8,16,1986,1990,4,No,0,1.67,-0.06,-1.73,297,223,-74,689,513,-176,783.0,49.0,-734.0,1372500.0,0.0,-1372500.0
<a href=/player/hudsc001>hudsc001</a>,Charles Hudson,New York Yankees,YANKS,1,1,1,2,1989,1989,0,No,0,-0.99,-1.23,-0.24,19,66,47,0,183,183,200.0,0.0,-200.0,0.0,0.0,0.0
<a href=/player/hudsc101>hudsc101</a>,Charlie Hudson,New York Mets,METS,1,4,4,8,1971,1975,4,No,0,1.94,1.36,-0.58,244,340,96,49,280,231,763.0,880.0,117.0,0.0,0.0,0.0
<a href=/player/hudsc101>hudsc101</a>,Charlie Hudson,St. Louis Cardinals,CARDS,1,2,1,3,1973,1974,1,No,0,0.06,-0.23,-0.29,25,42,17,0,9,9,187.0,127.0,-60.0,0.0,0.0,0.0
<a href=/player/hudsc101>hudsc101</a>,Charlie Hudson,Texas Rangers,RNGRS,1,1,1,2,1974,1974,0,No,0,0.0,0.0,0.0,0,0,0,0,0,0,0.0,0.0,0.0,0.0,0.0,0.0
<a href=/player/hudsc101>hudsc101</a>,Charlie Hudson,Cleveland Indians,INDINS,1,1,1,2,1974,1974,0,No,0,-0.2,0.0,0.2,3,0,-3,0,0,0,17.0,0.0,-17.0,0.0,0.0,0.0
<a href=/player/hudsd001>hudsd001</a>,Daniel Hudson,Chicago White Sox,WSOX,5,8,8,16,2010,2016,6,Yes,0,2.25,4.26,2.01,475,264,-211,194,348,154,1677.0,1215.0,-462.0,13500000.0,0.0,-13500000.0
<a href=/player/hudsd001>hudsd001</a>,Daniel Hudson,Pittsburgh Pirates,PIRATS,2,4,2,6,2018,2019,1,No,0,0.39,4.09,3.7,34,179,145,137,675,538,0.0,0.0,0.0,8500000.0,0.0,-8500000.0
<a href=/player/hudsd001>hudsd001</a>,Daniel Hudson,Toronto Blue Jays,BJAYS,1,1,1,2,2019,2019,0,Yes,0,1.7,0.0,-1.7,125,0,-125,0,0,0,235.0,0.0,-235.0,1500000.0,0.0,-1500000.0
<a href=/player/hudsd001>hudsd001</a>,Daniel Hudson,Washington Nationals,NATEX,1,1,2,3,2021,2021,0,Yes,0,-0.24,-0.22,0.02,45,54,9,0,0,0,57.0,65.0,8.0,6000000.0,0.0,-6000000.0
<a href=/player/hudsj001>hudsj001</a>,Joe Hudson,Boston Red Sox,RSOX,1,1,1,2,1998,1998,0,No,0,-0.18,0.0,0.18,2,0,-2,0,0,0,1.0,0.0,-1.0,0.0,0.0,0.0
<a href=/player/hudsj101>hudsj101</a>,Johnny Hudson,Brooklyn Dodgers,DOGRS,2,4,2,6,1941,1946,5,No,0,1.09,12.92,11.83,261,488,227,749,2125,1376,0.0,0.0,0.0,20000.0,0.0,-20000.0
<a href=/player/hudsk001>hudsk001</a>,Kyle Hudson,Tampa Bay Devil Rays,RAYS,1,1,1,2,2012,2013,1,No,0,0.0,-0.52,-0.52,0,23,23,0,24,24,0.0,0.0,0.0,0.0,0.0,0.0
<a href=/player/hudsl001>hudsl001</a>,Luke Hudson,Colorado Rockies,ROCKS,4,6,7,13,2001,2003,2,No,0,2.38,1.01,-1.37,515,182,-333,507,247,-260,927.0,121.0,-806.0,4816667.0,0.0,-4816667.0
<a href=/player/hudsn101>hudsn101</a>,Nat Hudson,St.Louis Cardinals,CARDS,1,1,1,2,1889,1890,1,No,0,0.0,4.44,4.44,0,98,98,0,171,171,0.0,1169.0,1169.0,0.0,0.0,0.0
<a href=/player/hudso001>hudso001</a>,Orlando Hudson,Toronto Blue Jays,BJAYS,5,10,12,22,2005,2014,9,No,0,23.63,23.44,-0.19,1360,1086,-274,3834,4118,284,1461.0,175.0,-1286.0,24569600.0,0.0,-24569600.0
<a href=/player/hudsr101>hudsr101</a>,Rex Hudson,Los Angeles Dodgers,DOGRS,1,1,1,2,1977,1977,0,No,0,0.0,0.0,0.0,0,0,0,0,0,0,0.0,0.0,0.0,0.0,0.0,0.0
<a href=/player/hudss101>hudss101</a>,Sid Hudson,Washington Senators,TWINS,1,1,2,3,1952,1956,4,No,0,3.29,3.27,-0.02,168,146,-22,116,161,45,1085.0,1293.0,208.0,0.0,0.0,0.0
<a href=/player/hudst001>hudst001</a>,Tim Hudson,Oakland Athletics,ATLTCS,3,3,5,8,2004,2008,4,No,0,29.13,-2.56,-31.69,752,132,-620,606,55,-551,5341.0,513.0,-4828.0,5000000.0,0.0,-5000000.0
<a href=/player/huelf101>huelf101</a>,Frank Huelsman,St.Louis Browns,ORLS,1,2,1,3,1904,1904,0,No,0,2.03,0.03,-2.0,386,82,-304,1572,310,-1262,0.0,0.0,0.0,0.0,0.0,0.0
<a href=/player/huffa001>huffa001</a>,Aubrey Huff,Tampa Bay Devil Rays,RAYS,5,10,11,21,2006,2020,14,Yes,0,1.34,46.23,44.89,253,2214,1961,664,8335,7671,952.0,246.0,-706.0,7425467.0,0.0,-7425467.0
<a href=/player/huffa001>huffa001</a>,Aubrey Huff,Baltimore Orioles,ORLS,2,3,3,6,2009,2017,8,No,0,-1.38,15.73,17.11,67,889,822,117,3636,3519,74.0,0.0,-74.0,8000000.0,0.0,-8000000.0
<a href=/player/huffm001>huffm001</a>,Mike Huff,Chicago White Sox,WSOX,1,1,1,2,1994,1994,0,No,0,1.37,0.0,-1.37,152,0,-152,435,0,-435,0.0,0.0,0.0,0.0,0.0,0.0
<a href=/player/huffp001>huffp001</a>,Phil Huffman,San Francisco Giants,GIANTS,4,14,8,22,1978,1992,14,No,0,8.18,23.62,15.44,767,1277,510,1656,1600,-56,2714.0,7759.0,5045.0,0.0,0.0,0.0
<a href=/player/huffp001>huffp001</a>,Phil Huffman,Oakland Athletics,ATLTCS,1,2,1,3,1978,1978,0,No,0,-2.52,1.35,3.87,64,41,-23,127,163,36,519.0,0.0,-519.0,0.0,0.0,0.0
<a href=/player/huffp001>huffp001</a>,Phil Huffman,Toronto Blue Jays,BJAYS,1,1,1,2,1982,1992,10,No,0,0.0,15.83,15.83,0,1115,1115,0,3470,3470,0.0,0.0,0.0,0.0,0.0,0.0
<a href=/player/huggm101>huggm101</a>,Miller Huggins,Cincinnati Reds,REDS,3,9,7,16,1910,1914,4,No,0,44.03,8.35,-35.68,2926,785,-2141,11991,2646,-9345,753.0,872.0,119.0,0.0,0.0,0.0
<a href=/player/hughb102>hughb102</a>,Bill Hughes,Pittsburgh Pirates,PIRATS,1,5,1,6,1922,1922,0,No,0,0.0,0.0,0.0,0,0,0,0,0,0,0.0,0.0,0.0,2700.0,0.0,-2700.0
<a href=/player/hughj102>hughj102</a>,Jim Hughey,Pittsburgh Pirates,PIRATS,3,7,3,10,1897,1910,13,No,0,16.77,28.55,11.78,976,1353,377,3303,5786,2483,2606.0,375.0,-2231.0,0.0,0.0,0.0
<a href=/player/hughk001>hughk001</a>,Keith Hughes,Philadelphia Phillies,PHILS,3,5,6,11,1984,1990,6,No,0,0.32,13.19,12.87,143,596,453,310,1528,1218,676.0,2713.0,2037.0,1725000.0,0.0,-1725000.0
<a href=/player/hughk001>hughk001</a>,Keith Hughes,New York Yankees,YANKS,1,2,1,3,1987,1987,0,No,0,-0.56,-0.16,0.4,55,65,10,124,184,60,0.0,0.0,0.0,62500.0,0.0,-62500.0
<a href=/player/hughk001>hughk001</a>,Keith Hughes,Philadelphia Phillies,PHILS,2,4,3,7,1988,1988,0,No,0,-2.46,0.71,3.17,165,85,-80,504,178,-326,0.0,49.0,49.0,395000.0,0.0,-395000.0
<a href=/player/hughk001>hughk001</a>,Keith Hughes,Baltimore Orioles,ORLS,1,2,2,4,1989,1989,0,No,0,-0.15,0.0,0.15,8,0,-8,9,0,-9,0.0,0.0,0.0,0.0,0.0,0.0
<a href=/player/hughp001>hughp001</a>,Phil Hughes,Minnesota Twins,TWINS,1,2,1,3,2018,2018,0,Yes,0,-0.2,0.0,0.2,32,0,-32,1,0,-1,62.0,0.0,-62.0,0.0,0.0,0.0
<a href=/player/hughr001>hughr001</a>,Rhyne Hughes,Tampa Bay Devil Rays,RAYS,5,10,7,17,2009,2018,9,Yes,1,0.36,9.54,9.18,473,754,281,833,2474,1641,577.0,688.0,111.0,508800.0,0.0,-508800.0
<a href=/player/hughr101>hughr101</a>,Roy Hughes,Cleveland Indians,INDINS,1,3,1,4,1938,1941,3,No,0,1.14,1.94,0.8,388,390,2,935,1415,480,285.0,0.0,-285.0,0.0,0.0,0.0
<a href=/player/hughr101>hughr101</a>,Roy Hughes,St.Louis Browns,ORLS,3,5,4,9,1939,1947,8,No,0,0.67,12.25,11.58,155,697,542,409,2324,1915,122.0,1025.0,903.0,19500.0,0.0,-19500.0
<a href=/player/hughr101>hughr101</a>,Roy Hughes,New York Yankees,YANKS,1,1,1,2,1939,1939,0,No,0,-0.93,0.0,0.93,155,0,-155,568,0,-568,0.0,0.0,0.0,0.0,0.0,0.0
<a href=/player/hught101>hught101</a>,Tommy Hughes,Philadelphia Phillies,PHILS,1,1,1,2,1947,1949,2,No,0,-0.91,0.76,1.67,24,97,73,7,372,365,81.0,0.0,-81.0,0.0,0.0,0.0
<a href=/player/hught103>hught103</a>,Tom Hughes,Boston Red Sox,RSOX,2,2,2,4,1903,1908,5,No,0,-0.67,14.33,15.0,96,253,157,144,394,250,687.0,2663.0,1976.0,0.0,0.0,0.0
<a href=/player/hught103>hught103</a>,Tom Hughes,New York Yankees,YANKS,1,2,1,3,1904,1904,0,No,0,10.23,2.28,-7.95,672,44,-628,792,66,-726,6259.0,413.0,-5846.0,0.0,0.0,0.0
<a href=/player/hught106>hught106</a>,Terry Hughes,St. Louis Cardinals,CARDS,27,55,49,104,1973,1998,25,No,8,106.47,182.0,75.53,10190,9338,-852,28502,29048,546,13842.0,9162.0,-4680.0,3130333.0,0.0,-3130333.0
<a href=/player/huisj001>huisj001</a>,Justin Huisman,Colorado Rockies,ROCKS,1,1,3,4,2004,2008,4,No,0,-0.25,-0.1,0.15,15,24,9,0,1,1,75.0,42.0,-33.0,0.0,0.0,0.0
<a href=/player/huism001>huism001</a>,Mark Huismann,Kansas City Royals,ROYALS,2,2,2,4,1986,1988,2,No,0,1.07,0.7,-0.37,43,47,4,1,5,4,284.0,141.0,-143.0,100000.0,0.0,-100000.0
<a href=/player/huism001>huism001</a>,Mark Huismann,Seattle Mariners,MARNRS,1,1,1,2,1987,1987,0,No,0,-0.01,0.0,0.01,20,0,-20,0,0,0,106.0,0.0,-106.0,0.0,0.0,0.0
<a href=/player/huisr001>huisr001</a>,Rick Huisman,Houston Astros,ASTROS,1,1,1,2,1995,1995,0,No,0,0.29,-0.5,-0.79,29,11,-18,0,37,37,117.0,0.0,-117.0,0.0,0.0,0.0
<a href=/player/hulet001>hulet001</a>,Tim Hulett,Chicago White Sox,WSOX,1,1,1,2,1988,1990,2,No,0,0.0,0.0,0.0,0,0,0,0,0,0,0.0,0.0,0.0,0.0,0.0,0.0
<a href=/player/hulet002>hulet002</a>,Tug Hulett,Texas Rangers,RNGRS,1,1,1,2,2007,2008,1,No,0,-0.19,-0.96,-0.77,30,26,-4,56,89,33,0.0,0.0,0.0,0.0,0.0,0.0
<a href=/player/hulih101>hulih101</a>,Harry Hulihan,New York Giants,GIANTS,3,8,5,13,1922,1930,8,No,0,4.92,14.44,9.52,1096,750,-346,1706,1477,-229,6029.0,4662.0,-1367.0,17500.0,0.0,-17500.0
<a href=/player/hulle001>hulle001</a>,Eric Hull,Los Angeles Dodgers,DOGRS,1,1,2,3,2008,2008,0,No,0,0.0,0.0,0.0,0,0,0,0,0,0,0.0,0.0,0.0,0.0,0.0,0.0
<a href=/player/hulsd001>hulsd001</a>,David Hulse,Texas Rangers,RNGRS,1,1,1,2,1995,1995,0,No,0,-1.45,-0.4,1.05,200,3,-197,491,0,-491,0.0,46.0,46.0,0.0,0.0,0.0
<a href=/player/hulsr101>hulsr101</a>,Rudy Hulswitt,Philadelphia Phillies,PHILS,1,1,1,2,1905,1905,0,No,0,0.0,-0.18,-0.18,0,42,42,0,142,142,0.0,0.0,0.0,0.0,0.0,0.0
<a href=/player/hulvh101>hulvh101</a>,Hank Hulvey,Philadelphia Athletics,ATLTCS,2,7,2,9,1923,1927,4,No,0,0.0,2.68,2.68,0,472,472,0,1997,1997,0.0,0.0,0.0,12000.0,0.0,-12000.0
<a href=/player/humbp001>humbp001</a>,Philip Humber,New York Mets,METS,1,4,1,5,2008,2013,5,No,0,2.31,15.63,13.32,305,210,-95,963,247,-716,66.0,2151.0,2085.0,0.0,0.0,0.0
<a href=/player/humet001>humet001</a>,Tom Hume,Cincinnati Reds,REDS,3,5,5,10,1985,1992,7,No,0,5.33,4.06,-1.27,304,351,47,423,887,464,1092.0,605.0,-487.0,1560833.0,0.0,-1560833.0
<a href=/player/hummt001>hummt001</a>,Tim Hummel,Chicago White Sox,WSOX,1,2,1,3,2003,2003,0,No,0,-1.28,0.3,1.58,82,15,-67,219,0,-219,0.0,43.0,43.0,0.0,0.0,0.0
<a href=/player/humpb101>humpb101</a>,Bert Humphries,Philadelphia Phillies,PHILS,1,2,1,3,1911,1911,0,No,0,2.81,0.3,-2.51,88,66,-22,79,238,159,669.0,0.0,-669.0,0.0,0.0,0.0
<a href=/player/humpb101>humpb101</a>,Bert Humphries,Cincinnati Reds,REDS,3,8,5,13,1912,1913,1,No,0,9.38,6.71,-2.67,842,270,-572,2287,704,-1583,1567.0,500.0,-1067.0,11280.0,0.0,-11280.0
<a href=/player/humpb102>humpb102</a>,Bob Humphreys,St. Louis Cardinals,CARDS,5,11,9,20,1965,1972,7,No,0,11.63,1.92,-9.71,1328,302,-1026,1454,613,-841,2062.0,364.0,-1698.0,32500.0,0.0,-32500.0
<a href=/player/humpb102>humpb102</a>,Bob Humphreys,Chicago Cubs,CUBS,1,1,1,2,1966,1966,0,No,0,2.67,0.0,-2.67,428,0,-428,60,0,-60,1188.0,0.0,-1188.0,0.0,0.0,0.0
<a href=/player/humpj101>humpj101</a>,Johnny Humphries,Cleveland Indians,INDINS,1,1,1,2,1941,1942,1,No,0,8.14,0.77,-7.37,244,96,-148,301,20,-281,2436.0,250.0,-2186.0,0.0,0.0,0.0
<a href=/player/humpm001>humpm001</a>,Mike Humphreys,San Diego Padres,PADRS,1,1,1,2,1991,1992,1,No,0,-0.36,-1.09,-0.73,54,137,83,100,242,142,0.0,0.0,0.0,0.0,0.0,0.0
<a href=/player/humpt101>humpt101</a>,Terry Humphrey,Montreal Expos,NATEX,4,6,5,11,1974,1990,16,No,1,-1.98,16.18,18.16,252,1065,813,89,2006,1917,1002.0,2687.0,1685.0,39500.0,0.0,-39500.0
<a href=/player/humpt101>humpt101</a>,Terry Humphrey,Detroit Tigers,TIGRS,1,4,3,7,1975,1979,4,No,0,4.11,5.38,1.27,431,290,-141,467,862,395,1859.0,1144.0,-715.0,16500.0,0.0,-16500.0
<a href=/player/humpt101>humpt101</a>,Terry Humphrey,Houston Astros,ASTROS,1,2,1,3,1976,1978,2,No,0,0.55,-0.16,-0.71,312,151,-161,705,515,-190,441.0,0.0,-441.0,0.0,0.0,0.0
<a href=/player/hundn001>hundn001</a>,Nick Hundley,San Diego Padres,PADRS,1,2,1,3,2014,2014,0,No,0,0.16,0.1,-0.06,50,16,-34,174,0,-174,0.0,22.0,22.0,0.0,0.0,0.0
<a href=/player/hundr101>hundr101</a>,Randy Hundley,San Francisco Giants,GIANTS,2,3,3,6,1965,1968,3,No,0,45.93,0.43,-45.5,1983,248,-1735,4122,39,-4083,6327.0,677.0,-5650.0,0.0,0.0,0.0
<a href=/player/hundr101>hundr101</a>,Randy Hundley,Chicago Cubs,CUBS,1,1,1,2,1973,1977,4,No,0,-0.15,0.12,0.27,32,373,341,93,1169,1076,0.0,0.0,0.0,50000.0,0.0,-50000.0
<a href=/player/hundt001>hundt001</a>,Todd Hundley,New York Mets,METS,6,15,13,28,1998,2019,21,No,2,28.38,67.9,39.52,1670,3569,1899,3344,8340,4996,3537.0,3405.0,-132.0,15948000.0,0.0,-15948000.0
<a href=/player/hundt001>hundt001</a>,Todd Hundley,Chicago Cubs,CUBS,1,2,2,4,2002,2004,2,No,0,-0.13,2.3,2.43,32,316,284,68,1174,1106,0.0,0.0,0.0,6500000.0,0.0,-6500000.0
<a href=/player/hungb101>hungb101</a>,Bernie Hungling,St.Louis Browns,ORLS,1,4,1,5,1930,1932,2,No,0,0.0,-0.31,-0.31,0,16,16,0,36,36,0.0,0.0,0.0,10000.0,0.0,-10000.0
<a href=/player/hunnb101>hunnb101</a>,Bill Hunnefield,Chicago White Sox,WSOX,3,9,4,13,1930,1936,6,No,0,0.81,-0.65,-1.46,234,127,-107,748,417,-331,0.0,39.0,39.0,19600.0,0.0,-19600.0
<a href=/player/hunnb101>hunnb101</a>,Bill Hunnefield,Portland,Portland,1,1,3,4,1926,1927,1,No,0,2.16,0.0,-2.16,415,0,-415,1545,0,-1545,0.0,0.0,0.0,0.0,0.0,0.0
<a href=/player/huntb001>huntb001</a>,Brian Hunter,Atlanta Braves,BRAVES,1,1,1,2,1993,1994,1,No,0,-0.86,0.0,0.86,76,0,-76,252,0,-252,0.0,0.0,0.0,205000.0,0.0,-205000.0
<a href=/player/huntb001>huntb001</a>,Brian Hunter,Pittsburgh Pirates,PIRATS,1,1,1,2,1994,1995,1,No,0,0.64,0.0,-0.64,49,0,-49,119,0,-119,0.0,0.0,0.0,250000.0,0.0,-250000.0
<a href=/player/huntb002>huntb002</a>,Brian Hunter,Houston Astros,ASTROS,6,12,18,30,1996,2004,8,No,0,25.8,6.98,-18.82,2221,1542,-679,3937,2959,-978,4263.0,3434.0,-829.0,7155000.0,0.0,-7155000.0
<a href=/player/huntb002>huntb002</a>,Brian Hunter,Detroit Tigers,TIGRS,1,1,2,3,1999,2004,5,No,0,-1.0,0.81,1.81,121,5,-116,527,0,-527,0.0,90.0,90.0,1750000.0,0.0,-1750000.0
<a href=/player/huntb002>huntb002</a>,Brian Hunter,Colorado Rockies,ROCKS,1,1,1,2,2000,2000,0,No,0,0.31,0.0,-0.31,32,0,-32,48,0,-48,0.0,0.0,0.0,300000.0,0.0,-300000.0
<a href=/player/huntb002>huntb002</a>,Brian Hunter,San Diego Padres,PADRS,1,1,1,2,2004,2004,0,No,0,0.0,-0.31,-0.31,0,80,80,0,101,101,0.0,0.0,0.0,0.0,0.0,0.0
<a href=/player/huntb105>huntb105</a>,Billy Hunter,Brooklyn Dodgers,DOGRS,1,1,4,5,1952,1952,0,No,0,-1.44,0.0,1.44,279,0,-279,1055,0,-1055,0.0,0.0,0.0,0.0,0.0,0.0
<a href=/player/huntb105>huntb105</a>,Billy Hunter,Baltimore Orioles,ORLS,21,46,43,89,1954,1994,40,No,3,83.66,150.67,67.01,4979,8510,3531,10385,24729,14344,18519.0,15968.0,-2551.0,970833.0,0.0,-970833.0
<a href=/player/huntb105>huntb105</a>,Billy Hunter,New York Yankees,YANKS,6,15,13,28,1957,1970,13,No,0,5.72,32.98,27.26,1633,2423,790,4235,5558,1323,2553.0,4978.0,2425.0,115500.0,0.0,-115500.0
<a href=/player/huntb105>huntb105</a>,Billy Hunter,Kansas City Athletics,ATLTCS,4,5,5,10,1958,1963,5,No,0,10.24,1.76,-8.48,1153,670,-483,1352,1828,476,2603.0,934.0,-1669.0,11000.0,0.0,-11000.0
<a href=/player/hunth101>hunth101</a>,Herb Hunter,New York Giants,GIANTS,1,3,1,4,1916,1916,0,No,0,2.13,0.44,-1.69,153,40,-113,610,161,-449,0.0,0.0,0.0,7400.0,0.0,-7400.0
<a href=/player/huntj102>huntj102</a>,Joel Hunt,St. Louis Cardinals,CARDS,1,2,1,3,1932,1932,0,No,0,-0.57,0.0,0.57,56,0,-56,40,0,-40,317.0,0.0,-317.0,0.0,0.0,0.0
<a href=/player/huntk102>huntk102</a>,Ken Hunt,Washington Senators,RNGRS,1,1,1,2,1966,1970,4,No,0,0.0,2.67,2.67,0,428,428,0,60,60,0.0,1188.0,1188.0,0.0,0.0,0.0
<a href=/player/huntn101>huntn101</a>,Newt Hunter,KansasCity,KansasCity,1,1,3,4,1910,1910,0,No,0,0.39,0.0,-0.39,65,0,-65,249,0,-249,0.0,0.0,0.0,0.0,0.0,0.0
<a href=/player/huntr101>huntr101</a>,Ron Hunt,New York Mets,METS,6,11,10,21,1966,1974,8,No,0,2.87,14.84,11.97,879,1261,382,2379,4536,2157,1072.0,0.0,-1072.0,182000.0,0.0,-182000.0
<a href=/player/huntr101>huntr101</a>,Ron Hunt,Los Angeles Dodgers,DOGRS,2,3,4,7,1968,1972,4,No,0,9.28,10.09,0.81,488,474,-14,1876,1637,-239,0.0,0.0,0.0,55000.0,0.0,-55000.0
<a href=/player/huntr101>huntr101</a>,Ron Hunt,San Francisco Giants,GIANTS,1,1,1,2,1970,1971,1,No,0,12.72,0.0,-12.72,509,0,-509,2140,0,-2140,0.0,0.0,0.0,0.0,0.0,0.0
<a href=/player/hunts101>hunts101</a>,Steve Huntz,St. Louis Cardinals,CARDS,2,2,2,4,1970,1970,0,No,0,1.16,-0.28,-1.44,128,36,-92,489,5,-484,0.0,65.0,65.0,0.0,0.0,0.0
<a href=/player/hunts101>hunts101</a>,Steve Huntz,San Diego Padres,PADRS,1,1,2,3,1970,1970,0,No,0,0.0,0.0,0.0,0,0,0,0,0,0,0.0,0.0,0.0,0.0,0.0,0.0
<a href=/player/hunts101>hunts101</a>,Steve Huntz,San Francisco Giants,GIANTS,1,1,1,2,1971,1971,0,No,0,-0.06,0.72,0.78,35,78,43,96,2,-94,0.0,134.0,134.0,0.0,0.0,0.0
<a href=/player/hunts101>hunts101</a>,Steve Huntz,Chicago White Sox,WSOX,3,5,4,9,1971,1979,8,No,0,21.05,19.98,-1.07,765,568,-197,1638,2032,394,4047.0,189.0,-3858.0,258750.0,0.0,-258750.0
<a href=/player/huntt002>huntt002</a>,Tommy Hunter,Texas Rangers,RNGRS,1,2,1,3,2011,2012,1,No,0,15.4,1.58,-13.82,1387,61,-1326,4679,0,-4679,1230.0,162.0,-1068.0,442160.0,0.0,-442160.0
<a href=/player/huntt002>huntt002</a>,Tommy Hunter,Baltimore Orioles,ORLS,1,1,1,2,2015,2015,0,No,0,-0.24,-0.41,-0.17,37,8,-29,0,22,22,47.0,0.0,-47.0,4650000.0,0.0,-4650000.0
<a href=/player/huntt002>huntt002</a>,Tommy Hunter,New York Mets,METS,1,2,1,3,2021,2021,0,No,0,0.0,0.56,0.56,0,26,26,0,22,22,0.0,190.0,190.0,100000.0,0.0,-100000.0
<a href=/player/huntw102>huntw102</a>,Willard Hunter,Los Angeles Dodgers,DOGRS,1,2,2,4,1962,1964,2,No,0,2.26,0.33,-1.93,344,161,-183,877,245,-632,336.0,0.0,-336.0,0.0,0.0,0.0
<a href=/player/hurdc001>hurdc001</a>,Clint Hurdle,Kansas City Royals,ROYALS,1,1,1,2,1981,1981,0,No,0,-0.43,0.0,0.43,19,0,-19,37,0,-37,0.0,0.0,0.0,0.0,0.0,0.0
<a href=/player/hursb001>hursb001</a>,Bruce Hurst,San Diego Padres,PADRS,19,36,39,75,1993,2021,28,Yes,1,53.28,80.99,27.71,3600,5089,1489,12022,13376,1354,2601.0,11891.0,9290.0,37678200.0,0.0,-37678200.0
<a href=/player/hursd101>hursd101</a>,Don Hurst,St. Louis Cardinals,CARDS,2,4,5,9,1928,1936,8,No,0,28.36,11.55,-16.81,2032,988,-1044,7440,3573,-3867,0.0,0.0,0.0,0.0,0.0,0.0
<a href=/player/hursd101>hursd101</a>,Don Hurst,Philadelphia Phillies,PHILS,2,2,3,5,1934,1938,4,No,0,28.84,12.75,-16.09,890,540,-350,3765,2322,-1443,0.0,0.0,0.0,0.0,0.0,0.0
<a href=/player/hursj001>hursj001</a>,Jonathan Hurst,Texas Rangers,RNGRS,1,3,1,4,1991,1991,0,No,0,2.41,-0.71,-3.12,510,12,-498,30,0,-30,668.0,186.0,-482.0,0.0,0.0,0.0
<a href=/player/hurte001>hurte001</a>,Edwin Hurtado,Toronto Blue Jays,BJAYS,2,3,3,6,1995,1996,1,No,0,-1.74,0.08,1.82,122,9,-113,179,30,-149,326.0,0.0,-326.0,218000.0,0.0,-218000.0
<a href=/player/huskb001>huskb001</a>,Butch Huskey,New York Mets,METS,2,5,2,7,1998,2000,2,No,0,29.24,0.16,-29.08,1404,56,-1348,5865,211,-5654,33.0,0.0,-33.0,510000.0,0.0,-510000.0
<a href=/player/huskb001>huskb001</a>,Butch Huskey,Seattle Mariners,MARNRS,1,1,1,2,1999,1999,0,No,0,-0.18,0.04,0.22,45,6,-39,131,0,-131,0.0,55.0,55.0,1500000.0,0.0,-1500000.0
<a href=/player/huskb001>huskb001</a>,Butch Huskey,Minnesota Twins,TWINS,2,3,3,6,2000,2003,3,No,0,3.0,-0.02,-3.02,196,31,-165,636,86,-550,0.0,0.0,0.0,822500.0,0.0,-822500.0
<a href=/player/husoj001>husoj001</a>,Jeff Huson,Montreal Expos,NATEX,1,1,1,2,1990,1991,1,No,0,3.93,-0.89,-4.82,410,84,-326,1191,5,-1186,0.0,175.0,175.0,0.0,0.0,0.0
<a href=/player/husoj001>husoj001</a>,Jeff Huson,Colorado Rockies,ROCKS,1,1,1,2,1997,1997,0,No,0,-1.29,0.0,1.29,84,0,-84,154,0,-154,0.0,0.0,0.0,0.0,0.0,0.0
<a href=/player/hustb101>hustb101</a>,Bert Husting,Milwaukee,Milwaukee,1,1,1,2,1900,1908,8,No,0,-0.04,0.0,0.04,4,0,-4,3,0,-3,24.0,0.0,-24.0,0.0,0.0,0.0
<a href=/player/hustc101>hustc101</a>,Carl Husta,Philadelphia Athletics,ATLTCS,3,7,4,11,1928,1936,8,No,0,0.0,4.89,4.89,0,451,451,0,502,502,0.0,2946.0,2946.0,7500.0,0.0,-7500.0
<a href=/player/hustw101>hustw101</a>,Warren Huston,Boston Braves,BRAVES,1,1,1,2,1944,1944,0,No,0,0.0,0.0,0.0,0,0,0,0,0,0,0.0,0.0,0.0,0.0,0.0,0.0
<a href=/player/hutcd001>hutcd001</a>,Drew Hutchison,Toronto Blue Jays,BJAYS,2,2,5,7,2016,2018,2,Yes,0,-0.2,1.28,1.48,33,66,33,1,129,128,77.0,396.0,319.0,15866667.0,0.0,-15866667.0
<a href=/player/hutcf101>hutcf101</a>,Fred Hutchinson,Seattle,Seattle,2,2,6,8,1938,1943,5,No,0,26.97,0.0,-26.97,820,0,-820,1623,0,-1623,4392.0,0.0,-4392.0,0.0,0.0,0.0
<a href=/player/hutci101>hutci101</a>,Ira Hutchinson,Boston Braves,BRAVES,2,4,3,7,1938,1952,14,No,0,0.98,38.76,37.78,331,1743,1412,987,7238,6251,317.0,0.0,-317.0,7500.0,0.0,-7500.0
<a href=/player/hutci101>hutci101</a>,Ira Hutchinson,Boston Braves,BRAVES,1,2,1,3,1945,1949,4,No,0,0.0,3.35,3.35,0,154,154,0,133,133,0.0,1068.0,1068.0,0.0,0.0,0.0
<a href=/player/hutcj101>hutcj101</a>,Johnny Hutchings,Cincinnati Reds,REDS,1,1,1,2,1941,1941,0,No,0,1.11,-0.65,-1.76,256,55,-201,124,175,51,1218.0,0.0,-1218.0,0.0,0.0,0.0
<a href=/player/hutcj101>hutcj101</a>,Johnny Hutchings,Pittsburgh Pirates,PIRATS,21,39,50,89,1946,1973,27,No,0,26.24,60.98,34.74,3262,5231,1969,9080,15581,6501,3705.0,3970.0,265.0,216500.0,0.0,-216500.0
<a href=/player/hutcj102>hutcj102</a>,Joe Hutcheson,Brooklyn Dodgers,DOGRS,1,4,1,5,1933,1933,0,No,0,0.0,0.0,0.0,0,0,0,0,0,0,0.0,0.0,0.0,0.0,0.0,0.0
<a href=/player/huttj101>huttj101</a>,Jim Hutto,St. Louis Cardinals,CARDS,1,2,1,3,1969,1969,0,No,0,-0.33,0.06,0.39,57,49,-8,101,68,-33,0.0,0.0,0.0,0.0,0.0,0.0
<a href=/player/huttj101>huttj101</a>,Jim Hutto,Philadelphia Phillies,PHILS,4,9,7,16,1970,1984,14,No,0,35.07,12.55,-22.52,1678,1480,-198,5343,1739,-3604,1000.0,2166.0,1166.0,0.0,0.0,0.0
<a href=/player/huttj101>huttj101</a>,Jim Hutto,California Angels,ANGELS,1,1,1,2,1973,1973,0,No,0,-0.21,0.0,0.21,4,0,-4,5,0,-5,0.0,0.0,0.0,0.0,0.0,0.0
<a href=/player/huttm001>huttm001</a>,Mark Hutton,New York Yankees,YANKS,3,3,4,7,1996,2005,9,No,0,1.74,3.25,1.51,243,362,119,531,1162,631,362.0,83.0,-279.0,2554000.0,0.0,-2554000.0
<a href=/player/huttm001>huttm001</a>,Mark Hutton,Florida Marlins,MARLNS,2,2,2,4,1997,1999,2,No,0,0.2,2.5,2.3,66,195,129,125,662,537,38.0,0.0,-38.0,450000.0,0.0,-450000.0
<a href=/player/huttm001>huttm001</a>,Mark Hutton,Colorado Rockies,ROCKS,1,1,1,2,1997,1999,2,No,0,-0.26,-0.37,-0.11,20,119,99,1,186,185,51.0,0.0,-51.0,0.0,0.0,0.0
<a href=/player/huttt101>huttt101</a>,Tom Hutton,Los Angeles Dodgers,DOGRS,2,2,3,5,1971,1972,1,No,0,1.12,0.0,-1.12,651,0,-651,1410,0,-1410,0.0,0.0,0.0,0.0,0.0,0.0
<a href=/player/hyath101>hyath101</a>,Ham Hyatt,New York Yankees,YANKS,3,12,4,16,1921,1928,7,No,0,-3.56,9.03,12.59,367,917,550,1242,3654,2412,159.0,0.0,-159.0,15750.0,0.0,-15750.0
<a href=/player/hyded101>hyded101</a>,Dick Hyde,Washington Senators,TWINS,2,3,3,6,1959,1962,3,No,0,-0.17,-0.01,0.16,13,300,287,12,852,840,0.0,4.0,4.0,13000.0,0.0,-13000.0
<a href=/player/hynec001>hynec001</a>,Colt Hynes,Cleveland Indians,INDINS,1,1,1,2,2014,2014,0,Yes,0,0.0,0.0,0.0,0,0,0,0,0,0,0.0,0.0,0.0,0.0,0.0,0.0
<a href=/player/hynec001>hynec001</a>,Colt Hynes,Cleveland Indians,INDINS,1,1,2,3,2016,2016,0,No,0,0.0,0.12,0.12,0,20,20,0,64,64,0.0,0.0,0.0,0.0,0.0,0.0
<a href=/player/hyzda001>hyzda001</a>,Adam Hyzdu,San Francisco Giants,GIANTS,1,1,2,3,1994,1994,0,No,0,0.0,0.0,0.0,0,0,0,0,0,0,0.0,0.0,0.0,0.0,0.0,0.0
<a href=/player/hyzda001>hyzda001</a>,Adam Hyzdu,Boston Red Sox,RSOX,1,1,1,2,2005,2005,0,No,0,-0.38,-0.24,0.14,17,8,-9,25,0,-25,0.0,24.0,24.0,0.0,0.0,0.0
<a href=/player/hyzda001>hyzda001</a>,Adam Hyzdu,San Diego Padres,PADRS,1,1,1,2,2005,2007,2,No,0,0.24,0.03,-0.21,12,102,90,18,3,-15,0.0,165.0,165.0,375000.0,0.0,-375000.0
<a href=/player/iannc001>iannc001</a>,Chris Iannetta,Colorado Rockies,ROCKS,1,1,1,2,2011,2017,6,No,0,6.02,10.24,4.22,394,216,-178,1342,183,-1159,0.0,1517.0,1517.0,2550000.0,0.0,-2550000.0
<a href=/player/iglej001>iglej001</a>,Jose Iglesias,Boston Red Sox,RSOX,3,8,6,14,2013,2020,7,Yes,0,8.76,3.1,-5.66,703,304,-399,2164,10,-2154,991.0,1375.0,384.0,5113000.0,0.0,-5113000.0
<a href=/player/iglej001>iglej001</a>,Jose Iglesias,Baltimore Orioles,ORLS,1,1,2,3,2020,2020,0,Yes,0,-1.09,0.0,1.09,114,0,-114,447,0,-447,0.0,0.0,0.0,2500000.0,0.0,-2500000.0
<a href=/player/igler001>igler001</a>,Raisel Iglesias,Cincinnati Reds,REDS,1,1,2,3,2020,2021,1,Yes,0,2.81,0.0,-2.81,81,0,-81,0,0,0,210.0,0.0,-210.0,5714285.0,0.0,-5714285.0
<a href=/player/iguct001>iguct001</a>,Tadahito Iguchi,Chicago White Sox,WSOX,2,2,2,4,2007,2009,2,No,0,0.99,0.0,-0.99,49,0,-49,163,0,-163,0.0,0.0,0.0,3250000.0,0.0,-3250000.0
<a href=/player/incap001>incap001</a>,Pete Incaviglia,Montreal Expos,NATEX,2,2,3,5,1985,1988,3,No,0,6.79,2.79,-4.0,712,107,-605,2736,87,-2649,137.0,806.0,669.0,0.0,0.0,0.0
<a href=/player/incap001>incap001</a>,Pete Incaviglia,Philadelphia Phillies,PHILS,4,6,7,13,1996,2002,6,No,0,5.3,4.73,-0.57,557,658,101,602,1100,498,2055.0,1429.0,-626.0,10946667.0,0.0,-10946667.0
<a href=/player/incie001>incie001</a>,Ender Inciarte,Arizona Diamondbacks,DBACKS,2,5,3,8,2015,2018,3,No,0,16.27,-1.52,-17.79,1329,142,-1187,5122,368,-4754,281.0,417.0,136.0,513000.0,0.0,-513000.0
<a href=/player/infao001>infao001</a>,Omar Infante,Detroit Tigers,TIGRS,1,1,1,2,2007,2008,1,No,0,0.0,-1.21,-1.21,0,24,24,0,90,90,0.0,0.0,0.0,1300000.0,0.0,-1300000.0
<a href=/player/infao001>infao001</a>,Omar Infante,Chicago Cubs,CUBS,3,6,6,12,2007,2013,6,No,0,21.27,0.88,-20.39,1494,347,-1147,4156,61,-4095,895.0,926.0,31.0,1305000.0,0.0,-1305000.0
<a href=/player/infao001>infao001</a>,Omar Infante,Atlanta Braves,BRAVES,1,2,1,3,2010,2014,4,No,0,6.58,3.15,-3.43,1022,499,-523,990,1984,994,984.0,0.0,-984.0,2225000.0,0.0,-2225000.0
<a href=/player/infao001>infao001</a>,Omar Infante,Miami Marlins,MARLNS,3,5,6,11,2012,2015,3,Yes,0,12.57,-1.22,-13.79,462,200,-262,752,437,-315,2987.0,792.0,-2195.0,8000000.0,0.0,-8000000.0
<a href=/player/inges101>inges101</a>,Scotty Ingerton,Chicago Cubs,CUBS,1,2,1,3,1911,1912,1,No,0,-1.23,-0.64,0.59,195,54,-141,626,160,-466,292.0,0.0,-292.0,0.0,0.0,0.0
<a href=/player/inksb101>inksb101</a>,Bert Inks,Baltimore Orioles,BLN,1,2,1,3,1894,1897,3,No,0,-0.83,9.45,10.28,72,136,64,119,246,127,795.0,1529.0,734.0,0.0,0.0,0.0
<a href=/player/inksb101>inksb101</a>,Bert Inks,Louisville Colonels,LS3,1,1,1,2,1896,1896,0,No,0,-0.35,-0.71,-0.36,6,26,20,5,43,38,31.0,165.0,134.0,0.0,0.0,0.0
<a href=/player/iorgd001>iorgd001</a>,Dane Iorg,Philadelphia Phillies,PHILS,3,5,4,9,1977,1983,6,No,0,1.29,13.57,12.28,795,776,-19,1705,2597,892,551.0,251.0,-300.0,300000.0,0.0,-300000.0
<a href=/player/irabh001>irabh001</a>,Hideki Irabu,San Diego Padres,PADRS,4,12,9,21,1997,2004,7,No,2,13.56,11.74,-1.82,1190,510,-680,3618,1358,-2260,1498.0,814.0,-684.0,0.0,0.0,0.0
<a href=/player/irabh001>irabh001</a>,Hideki Irabu,New York Yankees,YANKS,9,18,13,31,1999,2013,14,Yes,1,17.78,27.16,9.38,1143,1682,539,646,4704,4058,6675.0,2655.0,-4020.0,22173073.0,0.0,-22173073.0
<a href=/player/irvid001>irvid001</a>,Daryl Irvine,Boston Red Sox,RSOX,1,1,1,2,1993,1993,0,No,0,0.0,0.44,0.44,0,15,15,0,27,27,0.0,0.0,0.0,0.0,0.0,0.0
<a href=/player/irwit101>irwit101</a>,Tommy Irwin,Cleveland Indians,INDINS,2,3,2,5,1938,1940,2,No,0,3.73,5.73,2.0,238,292,54,340,1286,946,1666.0,0.0,-1666.0,21500.0,0.0,-21500.0
<a href=/player/isbef101>isbef101</a>,Frank Isbell,Chicago Cubs,CUBS,3,7,3,10,1898,1902,4,No,0,10.49,0.34,-10.15,648,180,-468,2353,652,-1701,0.0,320.0,320.0,0.0,0.0,0.0
<a href=/player/ishik001>ishik001</a>,Kazuhisa Ishii,Los Angeles Dodgers,DOGRS,1,1,1,2,2005,2005,0,No,0,-0.11,-1.38,-1.27,37,121,84,30,434,404,273.0,0.0,-273.0,0.0,0.0,0.0
<a href=/player/isrij001>isrij001</a>,Jason Isringhausen,New York Mets,METS,1,2,1,3,1999,1999,0,No,0,4.14,-0.38,-4.52,174,36,-138,0,0,0,542.0,40.0,-502.0,1950000.0,0.0,-1950000.0
<a href=/player/iviem101>iviem101</a>,Mike Ivie,San Diego Padres,PADRS,14,23,27,50,1978,1993,15,No,2,84.07,51.1,-32.97,3582,4551,969,11219,11781,562,4862.0,3507.0,-1355.0,3006667.0,0.0,-3006667.0
<a href=/player/iviem101>iviem101</a>,Mike Ivie,San Francisco Giants,GIANTS,8,10,15,25,1981,1998,17,No,0,8.87,20.56,11.69,610,2142,1532,1351,7059,5708,1958.0,443.0,-1515.0,7402778.0,0.0,-7402778.0
<a href=/player/iwama001>iwama001</a>,Akinori Iwamura,Tampa Bay Devil Rays,RAYS,5,5,6,11,2009,2017,8,No,2,0.31,2.44,2.13,473,229,-244,852,511,-341,440.0,187.0,-253.0,3250000.0,0.0,-3250000.0
<a href=/player/iztuc001>iztuc001</a>,Cesar Izturis,Toronto Blue Jays,BJAYS,1,2,2,4,2001,2002,1,No,0,7.04,-0.73,-7.77,933,22,-911,2400,0,-2400,462.0,215.0,-247.0,1800000.0,0.0,-1800000.0
<a href=/player/iztuc001>iztuc001</a>,Cesar Izturis,Los Angeles Dodgers,DOGRS,1,1,1,2,2006,2006,0,No,0,-0.81,1.93,2.74,87,24,-63,286,29,-257,0.0,221.0,221.0,3200000.0,0.0,-3200000.0
<a href=/player/iztum001>iztum001</a>,Maicer Izturis,Cleveland Indians,INDINS,1,2,1,3,2004,2004,0,No,0,5.47,-0.76,-6.23,379,23,-356,1253,0,-1253,0.0,41.0,41.0,0.0,0.0,0.0
<a href=/player/iztum001>iztum001</a>,Maicer Izturis,Washington Nationals,NATEX,3,6,3,9,2004,2012,8,No,1,19.76,4.35,-15.41,1354,365,-989,5013,919,-4094,0.0,531.0,531.0,312000.0,0.0,-312000.0
<a href=/player/jablr101>jablr101</a>,Ray Jablonski,St. Louis Cardinals,CARDS,1,2,1,3,1954,1956,2,No,0,-0.38,0.61,0.99,264,56,-208,738,5,-733,359.0,117.0,-242.0,0.0,0.0,0.0
<a href=/player/jablr101>jablr101</a>,Ray Jablonski,Cincinnati Reds,REDS,5,9,14,23,1956,1965,9,No,0,64.39,16.2,-48.19,3193,1555,-1638,9922,3215,-6707,2746.0,1065.0,-1681.0,0.0,0.0,0.0
<a href=/player/jablr101>jablr101</a>,Ray Jablonski,Chicago Cubs,CUBS,1,2,2,4,1957,1958,1,No,0,0.97,-1.1,-2.07,265,105,-160,781,34,-747,0.0,197.0,197.0,0.0,0.0,0.0
<a href=/player/jablr101>jablr101</a>,Ray Jablonski,San Francisco Giants,GIANTS,1,2,2,4,1959,1961,2,No,0,28.04,6.49,-21.55,1173,252,-921,4711,231,-4480,0.0,1899.0,1899.0,0.0,0.0,0.0
<a href=/player/jacka001>jacka001</a>,Austin Jackson,New York Yankees,YANKS,1,3,1,4,2009,2013,4,No,0,21.17,14.94,-6.23,983,513,-470,2996,2148,-848,971.0,0.0,-971.0,812225.0,0.0,-812225.0
<a href=/player/jacka001>jacka001</a>,Austin Jackson,Detroit Tigers,TIGRS,3,5,5,10,2014,2021,7,Yes,0,3.65,10.17,6.52,207,201,-6,690,19,-671,284.0,2223.0,1939.0,29745000.0,0.0,-29745000.0
<a href=/player/jacka001>jacka001</a>,Austin Jackson,Seattle Mariners,MARNRS,1,2,1,3,2015,2015,0,No,0,0.09,0.0,-0.09,29,0,-29,79,0,-79,0.0,0.0,0.0,7700000.0,0.0,-7700000.0
<a href=/player/jacka001>jacka001</a>,Austin Jackson,San Francisco Giants,GIANTS,1,3,1,4,2018,2018,0,No,0,0.75,0.0,-0.75,24,0,-24,0,0,0,64.0,0.0,-64.0,1675000.0,0.0,-1675000.0
<a href=/player/jacka002>jacka002</a>,Alex Jackson,Seattle Mariners,MARNRS,1,2,2,4,2016,2019,3,No,0,-0.61,0.04,0.65,19,6,-13,50,0,-50,0.0,45.0,45.0,0.0,0.0,0.0
<a href=/player/jacka002>jacka002</a>,Alex Jackson,Atlanta Braves,BRAVES,1,1,1,2,2021,2021,0,Yes,0,-0.24,1.19,1.43,42,55,13,123,216,93,0.0,0.0,0.0,0.0,0.0,0.0
<a href=/player/jacka101>jacka101</a>,Al Jackson,New York Mets,METS,3,5,4,9,1965,1970,5,No,0,3.02,4.23,1.21,629,336,-293,1532,1195,-337,1019.0,0.0,-1019.0,88000.0,0.0,-88000.0
<a href=/player/jacka101>jacka101</a>,Al Jackson,St. Louis Cardinals,CARDS,4,6,7,13,1967,1972,5,No,0,-1.6,1.66,3.26,464,155,-309,71,218,147,1318.0,207.0,-1111.0,17500.0,0.0,-17500.0
<a href=/player/jackb002>jackb002</a>,Brett Jackson,Chicago Cubs,CUBS,1,1,1,2,2014,2014,0,Yes,0,-0.07,0.0,0.07,7,0,-7,5,0,-5,0.0,0.0,0.0,0.0,0.0,0.0
<a href=/player/jackc002>jackc002</a>,Conor Jackson,Arizona Diamondbacks,DBACKS,1,2,1,3,2010,2012,2,No,0,0.36,-1.03,-1.39,120,141,21,437,0,-437,0.0,191.0,191.0,3100000.0,0.0,-3100000.0
<a href=/player/jackc002>jackc002</a>,Conor Jackson,Oakland Athletics,ATLTCS,1,2,1,3,2011,2011,0,No,0,-0.39,0.0,0.39,12,0,-12,22,0,-22,0.0,0.0,0.0,3200000.0,0.0,-3200000.0
<a href=/player/jackd001>jackd001</a>,Danny Jackson,Kansas City Royals,ROYALS,5,7,11,18,1987,2008,21,No,2,34.09,25.38,-8.71,1455,2390,935,5453,8409,2956,1537.0,1236.0,-301.0,900000.0,0.0,-900000.0
<a href=/player/jackd001>jackd001</a>,Danny Jackson,Chicago Cubs,CUBS,1,1,1,2,1992,1995,3,No,0,0.25,3.16,2.91,30,334,304,30,1290,1260,265.0,0.0,-265.0,2625000.0,0.0,-2625000.0
<a href=/player/jackd001>jackd001</a>,Danny Jackson,Florida Marlins,MARLNS,3,3,4,7,1992,2008,16,No,0,7.63,1.65,-5.98,301,301,0,152,832,680,1756.0,41.0,-1715.0,150000.0,0.0,-150000.0
<a href=/player/jackd001>jackd001</a>,Danny Jackson,St. Louis Cardinals,CARDS,1,3,3,6,1997,1997,0,No,0,-0.21,-1.09,-0.88,425,93,-332,688,180,-508,185.0,68.0,-117.0,4942500.0,0.0,-4942500.0
<a href=/player/jackd002>jackd002</a>,Darrin Jackson,Chicago Cubs,CUBS,1,3,2,5,1989,1992,3,No,0,9.01,-0.33,-9.34,632,454,-178,1598,1395,-203,382.0,0.0,-382.0,400000.0,0.0,-400000.0
<a href=/player/jackd002>jackd002</a>,Darrin Jackson,San Diego Padres,PADRS,17,33,34,67,1993,2010,17,No,6,17.72,52.97,35.25,3745,4690,945,12859,16375,3516,1244.0,1789.0,545.0,25389800.0,0.0,-25389800.0
<a href=/player/jackd002>jackd002</a>,Darrin Jackson,Toronto Blue Jays,BJAYS,1,1,1,2,1993,1993,0,No,0,-0.58,3.06,3.64,31,94,63,91,390,299,0.0,0.0,0.0,2100000.0,0.0,-2100000.0
<a href=/player/jackd002>jackd002</a>,Darrin Jackson,Minnesota Twins,TWINS,1,1,1,2,1997,1997,0,No,0,0.18,0.0,-0.18,140,0,-140,299,0,-299,0.0,0.0,0.0,0.0,0.0,0.0
<a href=/player/jackd003>jackd003</a>,Damian Jackson,Cleveland Indians,INDINS,1,4,2,6,1997,1998,1,No,0,5.24,-0.51,-5.75,1014,98,-916,190,187,-3,2567.0,112.0,-2455.0,0.0,0.0,0.0
<a href=/player/jackd003>jackd003</a>,Damian Jackson,Cincinnati Reds,REDS,4,7,7,14,1999,2004,5,No,0,10.74,9.45,-1.29,965,646,-319,3397,2378,-1019,0.0,0.0,0.0,3650000.0,0.0,-3650000.0
<a href=/player/jackd003>jackd003</a>,Damian Jackson,San Diego Padres,PADRS,1,2,2,4,2002,2002,0,No,0,-0.26,-0.46,-0.2,167,15,-152,507,42,-465,0.0,0.0,0.0,0.0,0.0,0.0
<a href=/player/jackd003>jackd003</a>,Damian Jackson,Chicago Cubs,CUBS,1,1,1,2,2004,2004,0,No,0,-0.15,0.0,0.15,14,0,-14,16,0,-16,0.0,0.0,0.0,0.0,0.0,0.0
<a href=/player/jackd004>jackd004</a>,Drew Jackson,Seattle Mariners,MARNRS,2,4,3,7,2017,2018,1,No,0,0.01,-0.36,-0.37,6,35,29,0,0,0,56.0,129.0,73.0,0.0,0.0,0.0
<a href=/player/jackd004>jackd004</a>,Drew Jackson,Philadelphia Phillies,PHILS,1,1,1,2,2018,2018,0,No,0,-0.03,0.0,0.03,3,0,-3,4,0,-4,0.0,0.0,0.0,0.0,0.0,0.0
<a href=/player/jacke001>jacke001</a>,Edwin Jackson,Los Angeles Dodgers,DOGRS,3,6,4,10,2006,2008,2,No,0,2.19,-0.23,-2.42,275,388,113,424,385,-39,1172.0,396.0,-776.0,4405000.0,0.0,-4405000.0
<a href=/player/jacke001>jacke001</a>,Edwin Jackson,Tampa Bay Devil Rays,RAYS,4,4,5,9,2008,2018,10,Yes,0,3.13,11.22,8.09,201,696,495,288,2256,1968,936.0,194.0,-742.0,7137700.0,0.0,-7137700.0
<a href=/player/jacke001>jacke001</a>,Edwin Jackson,Detroit Tigers,TIGRS,4,7,9,16,2009,2021,12,Yes,0,3.78,52.84,49.06,248,1430,1182,733,3032,2299,687.0,6457.0,5770.0,35445000.0,0.0,-35445000.0
<a href=/player/jacke001>jacke001</a>,Edwin Jackson,Arizona Diamondbacks,DBACKS,2,4,4,8,2010,2016,6,Yes,0,3.34,4.24,0.9,57,372,315,23,128,105,765.0,1444.0,679.0,13600000.0,0.0,-13600000.0
<a href=/player/jacke001>jacke001</a>,Edwin Jackson,Chicago White Sox,WSOX,4,6,7,13,2011,2016,5,Yes,0,-1.99,0.09,2.08,103,232,129,66,344,278,233.0,625.0,392.0,13500000.0,0.0,-13500000.0
<a href=/player/jacke001>jacke001</a>,Edwin Jackson,Toronto Blue Jays,BJAYS,1,4,4,8,2011,2014,3,No,0,0.4,6.43,6.03,344,416,72,89,1599,1510,547.0,15.0,-532.0,4329600.0,0.0,-4329600.0
<a href=/player/jackg101>jackg101</a>,Grant Jackson,Philadelphia Phillies,PHILS,4,9,7,16,1970,1984,14,No,0,35.07,12.55,-22.52,1678,1480,-198,5343,1739,-3604,1000.0,2166.0,1166.0,0.0,0.0,0.0
<a href=/player/jackg101>jackg101</a>,Grant Jackson,Baltimore Orioles,ORLS,10,21,19,40,1976,1994,18,No,3,48.77,85.06,36.29,2260,4349,2089,4427,10615,6188,10756.0,13691.0,2935.0,713333.0,0.0,-713333.0
<a href=/player/jackg101>jackg101</a>,Grant Jackson,Seattle Mariners,MARNRS,8,13,14,27,1976,1987,11,No,1,23.3,30.67,7.37,2385,1284,-1101,4614,3930,-684,3798.0,3606.0,-192.0,175000.0,0.0,-175000.0
<a href=/player/jackg101>jackg101</a>,Grant Jackson,Montreal Expos,NATEX,1,1,1,2,1982,1983,1,No,0,-0.75,0.0,0.75,20,10,-10,0,9,9,115.0,0.0,-115.0,0.0,0.0,0.0
<a href=/player/jackg102>jackg102</a>,George Jackson,Memphis,Memphis,1,1,1,2,1911,1911,0,No,0,0.67,0.0,-0.67,152,0,-152,635,0,-635,0.0,0.0,0.0,0.0,0.0,0.0
<a href=/player/jackj001>jackj001</a>,Jay Jackson,San Francisco Giants,GIANTS,1,1,1,2,2021,2021,0,No,0,0.0,0.0,0.0,0,0,0,0,0,0,0.0,0.0,0.0,0.0,0.0,0.0
<a href=/player/jackj101>jackj101</a>,Shoeless Joe Jackson,Philadelphia Athletics,ATLTCS,3,7,4,11,1910,1916,6,No,0,36.05,17.77,-18.28,769,1148,379,3166,4931,1765,0.0,0.0,0.0,0.0,0.0,0.0
<a href=/player/jackj101>jackj101</a>,Shoeless Joe Jackson,Cleveland Indians,INDINS,2,3,7,10,1915,1932,17,No,0,29.68,38.6,8.92,696,2140,1444,3015,8707,5692,0.0,807.0,807.0,0.0,0.0,0.0
<a href=/player/jackj102>jackj102</a>,John Jackson,Philadelphia Phillies,PHILS,1,2,1,3,1933,1934,1,No,0,0.0,0.0,0.0,0,0,0,0,0,0,0.0,0.0,0.0,0.0,0.0,0.0
<a href=/player/jackl001>jackl001</a>,Luke Jackson,Texas Rangers,RNGRS,1,1,2,3,2016,2016,0,Yes,0,2.77,0.0,-2.77,443,0,-443,6,0,-6,762.0,0.0,-762.0,0.0,0.0,0.0
<a href=/player/jackl101>jackl101</a>,Lou Jackson,Chicago Cubs,CUBS,3,5,4,9,1959,1961,2,No,0,8.16,-0.89,-9.05,620,173,-447,633,602,-31,802.0,0.0,-802.0,0.0,0.0,0.0
<a href=/player/jackl102>jackl102</a>,Larry Jackson,St. Louis Cardinals,CARDS,15,32,26,58,1962,1972,10,No,0,54.99,16.45,-38.54,4551,1419,-3132,9818,4107,-5711,7592.0,1574.0,-6018.0,32500.0,0.0,-32500.0
<a href=/player/jackl102>jackl102</a>,Larry Jackson,Chicago Cubs,CUBS,10,15,17,32,1966,1982,16,No,0,38.97,72.32,33.35,1515,3517,2002,3549,10033,6484,7048.0,7391.0,343.0,430000.0,0.0,-430000.0
<a href=/player/jackm001>jackm001</a>,Michael Jackson,Philadelphia Phillies,PHILS,2,4,4,8,1987,1989,2,No,0,8.23,2.23,-6.0,632,164,-468,1265,649,-616,1310.0,12.0,-1298.0,1629900.0,0.0,-1629900.0
<a href=/player/jackm001>jackm001</a>,Michael Jackson,Seattle Mariners,MARNRS,2,4,3,7,1991,1993,2,No,0,19.75,1.34,-18.41,1114,134,-980,1118,402,-716,2994.0,104.0,-2890.0,5400000.0,0.0,-5400000.0
<a href=/player/jackm101>jackm101</a>,Mike Jackson,Boston Red Sox,RSOX,1,1,1,2,1969,1971,2,No,0,0.3,-0.15,-0.45,10,88,78,1,10,9,19.0,170.0,151.0,0.0,0.0,0.0
<a href=/player/jackm101>jackm101</a>,Mike Jackson,San Diego Padres,PADRS,1,1,1,2,1971,1971,0,No,0,-1.03,0.0,1.03,23,0,-23,6,0,-6,126.0,0.0,-126.0,0.0,0.0,0.0
<a href=/player/jackm101>jackm101</a>,Mike Jackson,Kansas City Royals,ROYALS,1,1,1,2,1973,1979,6,No,0,0.02,5.57,5.55,1,271,270,0,1,1,2.0,1317.0,1315.0,12600.0,0.0,-12600.0
<a href=/player/jackr001>jackr001</a>,Reggie Jackson,Oakland Athletics,ATLTCS,2,4,6,10,1976,1978,2,No,0,9.34,5.62,-3.72,178,460,282,558,1294,736,944.0,1423.0,479.0,100000.0,0.0,-100000.0
<a href=/player/jackr002>jackr002</a>,Ron Jackson,California Angels,ANGELS,2,3,3,6,1978,1987,9,No,0,2.69,22.79,20.1,795,1091,296,2836,4554,1718,0.0,0.0,0.0,0.0,0.0,0.0
<a href=/player/jackr002>jackr002</a>,Ron Jackson,Minnesota Twins,TWINS,1,1,1,2,1981,1982,1,No,0,0.78,-0.31,-1.09,31,22,-9,104,58,-46,0.0,0.0,0.0,200000.0,0.0,-200000.0
<a href=/player/jackr003>jackr003</a>,Roy Lee Jackson,New York Mets,METS,6,10,9,19,1980,2002,22,No,2,14.24,37.39,23.15,1403,1223,-180,3663,2762,-901,1484.0,5145.0,3661.0,876667.0,0.0,-876667.0
<a href=/player/jackr003>jackr003</a>,Roy Lee Jackson,Baltimore Orioles,ORLS,1,2,1,3,1985,1987,2,No,0,0.74,-0.72,-1.46,44,232,188,6,947,941,120.0,0.0,-120.0,0.0,0.0,0.0
<a href=/player/jackr005>jackr005</a>,Ryan Jackson,Houston Astros,ASTROS,1,1,1,2,2013,2014,1,No,0,0.0,-0.74,-0.74,0,69,69,0,184,184,0.0,0.0,0.0,0.0,0.0,0.0
<a href=/player/jackr005>jackr005</a>,Ryan Jackson,Kansas City Royals,ROYALS,2,3,2,5,2015,2018,3,No,0,-0.99,-1.21,-0.22,77,234,157,122,575,453,5.0,16.0,11.0,2300000.0,0.0,-2300000.0
<a href=/player/jackr101>jackr101</a>,Ron Jackson,Chicago White Sox,WSOX,3,3,3,6,1959,1965,6,No,0,-1.11,4.24,5.35,42,419,377,70,221,151,11.0,1805.0,1794.0,30500.0,0.0,-30500.0
<a href=/player/jackr101>jackr101</a>,Ron Jackson,Boston Red Sox,RSOX,1,1,1,2,1960,1960,0,No,0,0.0,-0.49,-0.49,0,34,34,0,89,89,0.0,0.0,0.0,0.0,0.0,0.0
<a href=/player/jackr102>jackr102</a>,Randy Jackson,Chicago Cubs,CUBS,5,9,9,18,1955,1964,9,No,0,9.43,6.83,-2.6,1051,943,-108,3111,3013,-98,133.0,368.0,235.0,0.0,0.0,0.0
<a href=/player/jackr102>jackr102</a>,Randy Jackson,Cleveland Indians,INDINS,1,1,1,2,1959,1959,0,No,0,0.16,-0.45,-0.61,41,24,-17,91,6,-85,0.0,88.0,88.0,0.0,0.0,0.0
<a href=/player/jacks001>jacks001</a>,Steven Jackson,Arizona Diamondbacks,DBACKS,1,4,2,6,2007,2008,1,No,0,-0.71,4.28,4.99,171,78,-93,110,78,-32,366.0,722.0,356.0,0.0,0.0,0.0
<a href=/player/jacks102>jacks102</a>,Sonny Jackson,Houston Astros,ASTROS,9,17,16,33,1967,1989,22,No,0,77.09,75.22,-1.87,5400,5677,277,17448,17542,94,3810.0,7694.0,3884.0,705000.0,0.0,-705000.0
<a href=/player/jackz001>jackz001</a>,Zach Jackson,Toronto Blue Jays,BJAYS,1,3,2,5,2005,2010,5,No,0,4.16,12.24,8.08,549,739,190,828,2857,2029,2736.0,120.0,-2616.0,627000.0,0.0,-627000.0
<a href=/player/jackz001>jackz001</a>,Zach Jackson,Milwaukee Brewers,BREWRS,2,5,3,8,2008,2008,0,No,2,22.37,5.2,-17.17,1354,34,-1320,5551,50,-5501,190.0,392.0,202.0,0.0,0.0,0.0
<a href=/player/jacoa101>jacoa101</a>,Art Jacobs,Cleveland Indians,INDINS,1,1,2,3,1939,1939,0,No,0,-0.02,0.0,0.02,2,0,-2,0,0,0,3.0,0.0,-3.0,0.0,0.0,0.0
<a href=/player/jacob001>jacob001</a>,Brook Jacoby,Atlanta Braves,BRAVES,1,4,1,5,1983,1986,3,No,0,32.51,0.13,-32.38,1861,94,-1767,7480,76,-7404,166.0,699.0,533.0,110000.0,0.0,-110000.0
<a href=/player/jacob001>jacob001</a>,Brook Jacoby,Cleveland Indians,INDINS,1,1,2,3,1991,1992,1,No,0,-0.69,0.0,0.69,56,0,-56,204,0,-204,0.0,0.0,0.0,0.0,0.0,0.0
<a href=/player/jacob101>jacob101</a>,Beany Jacobson,Washington Senators,TWINS,1,1,1,2,1905,1905,0,No,0,-0.57,0.0,0.57,62,0,-62,77,0,-77,637.0,0.0,-637.0,0.0,0.0,0.0
<a href=/player/jacob101>jacob101</a>,Beany Jacobson,St.Louis Browns,ORLS,1,2,1,3,1907,1907,0,No,0,-0.2,1.1,1.3,4,48,44,0,54,54,7.0,471.0,464.0,0.0,0.0,0.0
<a href=/player/jacoe101>jacoe101</a>,Elmer Jacobs,Pittsburgh Pirates,PIRATS,1,1,1,2,1918,1919,1,No,0,3.24,0.92,-2.32,70,66,-4,89,81,-8,752.0,635.0,-117.0,0.0,0.0,0.0
<a href=/player/jacoe101>jacoe101</a>,Elmer Jacobs,Philadelphia Phillies,PHILS,3,6,7,13,1919,1925,6,No,0,15.32,16.37,1.05,851,640,-211,1993,1730,-263,4451.0,3043.0,-1408.0,8500.0,0.0,-8500.0
<a href=/player/jacoe101>jacoe101</a>,Elmer Jacobs,Seattle,Seattle,1,2,2,4,1923,1925,2,No,0,12.05,0.0,-12.05,628,0,-628,625,0,-625,5104.0,0.0,-5104.0,0.0,0.0,0.0
<a href=/player/jacoj001>jacoj001</a>,Jason Jacome,New York Mets,METS,3,5,6,11,1995,1999,4,No,0,0.09,-0.09,-0.18,89,38,-51,0,0,0,470.0,74.0,-396.0,125000.0,0.0,-125000.0
<a href=/player/jacom001>jacom001</a>,Mike Jacobs,New York Mets,METS,1,3,2,5,2005,2009,4,No,0,-3.72,4.84,8.56,420,468,48,1504,2023,519,79.0,0.0,-79.0,0.0,0.0,0.0
<a href=/player/jacom001>jacom001</a>,Mike Jacobs,Florida Marlins,MARLNS,1,1,1,2,2008,2012,4,No,0,-0.34,2.33,2.67,128,412,284,478,1,-477,0.0,594.0,594.0,395000.0,0.0,-395000.0
<a href=/player/jacom102>jacom102</a>,Merwin Jacobson,New York Giants,GIANTS,1,3,1,4,1916,1916,0,No,0,2.13,0.44,-1.69,153,40,-113,610,161,-449,0.0,0.0,0.0,7400.0,0.0,-7400.0
<a href=/player/jacom102>jacom102</a>,Merwin Jacobson,Chicago Cubs,CUBS,1,2,1,3,1918,1923,5,No,0,0.0,1.35,1.35,0,436,436,0,1534,1534,0.0,0.0,0.0,0.0,0.0,0.0
<a href=/player/jacos101>jacos101</a>,Spook Jacobs,Kansas City Athletics,ATLTCS,40,87,90,177,1956,1976,20,No,0,168.75,57.36,-111.39,14647,9561,-5086,34265,25664,-8601,22274.0,11407.0,-10867.0,516100.0,0.0,-516100.0
<a href=/player/jacow101>jacow101</a>,Baby Doll Jacobson,Detroit Tigers,TIGRS,1,2,1,3,1915,1919,4,No,0,28.27,2.95,-25.32,1243,192,-1051,5249,198,-5051,0.0,1643.0,1643.0,0.0,0.0,0.0
<a href=/player/jacow101>jacow101</a>,Baby Doll Jacobson,St.Louis Browns,ORLS,2,2,2,4,1926,1933,7,No,0,12.21,19.97,7.76,837,713,-124,3116,1432,-1684,0.0,3927.0,3927.0,15500.0,0.0,-15500.0
<a href=/player/jacow101>jacow101</a>,Baby Doll Jacobson,Philadelphia Athletics,ATLTCS,1,3,1,4,1926,1930,4,No,0,3.68,8.68,5.0,373,175,-198,792,208,-584,1683.0,1623.0,-60.0,10500.0,0.0,-10500.0
<a href=/player/jacqp101>jacqp101</a>,Pat Jacquez,Chicago Cubs,CUBS,1,3,2,5,1970,1973,3,No,0,1.15,0.0,-1.15,69,0,-69,29,0,-29,290.0,0.0,-290.0,0.0,0.0,0.0
<a href=/player/jacqp101>jacqp101</a>,Pat Jacquez,Chicago White Sox,WSOX,1,1,1,2,1971,1972,1,No,0,0.0,-0.21,-0.21,0,11,11,0,11,11,0.0,0.0,0.0,9500.0,0.0,-9500.0
<a href=/player/jacqp101>jacqp101</a>,Pat Jacquez,Cincinnati Reds,REDS,1,1,1,2,1972,1972,0,No,0,0.0,0.0,0.0,0,0,0,0,0,0,0.0,0.0,0.0,0.0,0.0,0.0
<a href=/player/jaimj001>jaimj001</a>,Juan Jaime,Atlanta Braves,BRAVES,6,15,9,24,2015,2021,6,Yes,0,3.56,2.51,-1.05,557,291,-266,805,489,-316,986.0,676.0,-310.0,21307500.0,0.0,-21307500.0
<a href=/player/jameb001>jameb001</a>,Bob James,Montreal Expos,NATEX,2,2,2,4,1984,1987,3,No,1,3.0,5.26,2.26,170,398,228,0,1515,1515,667.0,22.0,-645.0,0.0,0.0,0.0
<a href=/player/jameb103>jameb103</a>,Bill James,St.Louis Browns,ORLS,3,3,4,7,1915,1933,18,No,0,15.16,48.24,33.08,1029,1956,927,3314,6681,3367,1643.0,3927.0,2284.0,15500.0,0.0,-15500.0
<a href=/player/jameb104>jameb104</a>,Bernie James,Dallas,Dallas,1,1,2,3,1932,1932,0,No,0,-0.06,0.0,0.06,60,0,-60,136,0,-136,0.0,0.0,0.0,0.0,0.0,0.0
<a href=/player/jamec001>jamec001</a>,Chris James,Philadelphia Phillies,PHILS,1,1,2,3,1989,1994,5,No,0,-0.78,20.47,21.25,87,993,906,331,3735,3404,0.0,0.0,0.0,230000.0,0.0,-230000.0
<a href=/player/jamec001>jamec001</a>,Chris James,San Diego Padres,PADRS,7,14,16,30,1989,1998,9,No,0,77.02,12.33,-64.69,5607,1502,-4105,22003,4193,-17810,1355.0,1888.0,533.0,8656667.0,0.0,-8656667.0
<a href=/player/jamec001>jamec001</a>,Chris James,Houston Astros,ASTROS,1,1,1,2,1993,1993,0,No,0,1.89,0.0,-1.89,60,0,-60,193,0,-193,0.0,0.0,0.0,500000.0,0.0,-500000.0
<a href=/player/jamec001>jamec001</a>,Chris James,Kansas City Royals,ROYALS,1,1,1,2,1995,1996,1,No,0,-0.13,0.0,0.13,16,0,-16,27,0,-27,0.0,0.0,0.0,310000.0,0.0,-310000.0
<a href=/player/jamec102>jamec102</a>,Charlie James,St. Louis Cardinals,CARDS,1,2,1,3,1964,1966,2,No,0,-0.38,-2.37,-1.99,106,64,-42,54,43,-11,193.0,373.0,180.0,0.0,0.0,0.0
<a href=/player/jamed001>jamed001</a>,Dion James,Milwaukee Brewers,BREWRS,1,1,1,2,1987,1988,1,No,0,3.14,-0.27,-3.41,329,7,-322,1223,17,-1206,0.0,0.0,0.0,0.0,0.0,0.0
<a href=/player/jamed001>jamed001</a>,Dion James,Atlanta Braves,BRAVES,1,1,1,2,1989,1991,2,No,0,0.94,1.89,0.95,158,189,31,551,637,86,0.0,0.0,0.0,400000.0,0.0,-400000.0
<a href=/player/jamej001>jamej001</a>,Justin James,Toronto Blue Jays,BJAYS,1,1,1,2,2007,2009,2,No,0,0.0,0.07,0.07,0,8,8,0,6,6,0.0,0.0,0.0,0.0,0.0,0.0
<a href=/player/jamej101>jamej101</a>,Johnny James,New York Yankees,YANKS,1,3,2,5,1961,1962,1,No,0,3.35,0.73,-2.62,729,113,-616,2005,155,-1850,725.0,95.0,-630.0,0.0,0.0,0.0
<a href=/player/jamem001>jamem001</a>,Mike James,Los Angeles Dodgers,DOGRS,1,1,1,2,1993,1994,1,No,0,4.43,0.0,-4.43,188,0,-188,0,0,0,640.0,0.0,-640.0,0.0,0.0,0.0
<a href=/player/jamic101>jamic101</a>,Charlie Jamieson,Philadelphia Athletics,ATLTCS,2,5,4,9,1919,1920,1,No,0,39.26,1.89,-37.37,2383,166,-2217,9666,676,-8990,678.0,0.0,-678.0,2400.0,0.0,-2400.0
<a href=/player/janej101>janej101</a>,Gerry Janeski,Chicago White Sox,WSOX,1,1,1,2,1971,1973,2,No,0,-0.45,1.62,2.07,54,285,231,19,1036,1017,223.0,0.0,-223.0,0.0,0.0,0.0
<a href=/player/janip001>janip001</a>,Paul Janish,Cincinnati Reds,REDS,1,1,1,2,2012,2013,1,No,0,-0.57,-0.2,0.37,107,2,-105,231,1,-230,0.0,10.0,10.0,0.0,0.0,0.0
<a href=/player/jankt001>jankt001</a>,Travis Jankowski,San Diego Padres,PADRS,1,1,1,2,2019,2019,0,No,0,-0.28,0.0,0.28,16,0,-16,17,0,-17,0.0,0.0,0.0,1165000.0,0.0,-1165000.0
<a href=/player/janvh101>janvh101</a>,Hal Janvrin,Boston Red Sox,RSOX,9,25,23,48,1912,1935,23,No,0,51.77,27.05,-24.72,3792,3039,-753,15081,11185,-3896,0.0,1203.0,1203.0,45050.0,0.0,-45050.0
<a href=/player/janvh101>janvh101</a>,Hal Janvrin,Boston Red Sox,RSOX,2,5,3,8,1919,1919,0,No,0,2.49,1.07,-1.42,628,159,-469,1976,592,-1384,282.0,106.0,-176.0,0.0,0.0,0.0
<a href=/player/janvh101>janvh101</a>,Hal Janvrin,Washington Senators,TWINS,2,3,2,5,1919,1933,14,No,0,-0.15,16.16,16.31,11,1252,1241,23,5536,5513,0.0,0.0,0.0,34200.0,0.0,-34200.0
<a href=/player/janvh101>janvh101</a>,Hal Janvrin,St. Louis Cardinals,CARDS,1,2,1,3,1921,1924,3,No,0,-0.25,4.34,4.59,114,209,95,179,222,43,183.0,1768.0,1585.0,5000.0,0.0,-5000.0
<a href=/player/janzm001>janzm001</a>,Marty Janzen,New York Yankees,YANKS,1,3,1,4,1995,2000,5,No,0,-0.54,20.23,20.77,27,149,122,0,13,13,296.0,2766.0,2470.0,0.0,0.0,0.0
<a href=/player/janzm001>janzm001</a>,Marty Janzen,Arizona Diamondbacks,DBACKS,2,3,2,5,1998,2004,6,No,0,-0.53,1.16,1.69,349,725,376,906,2569,1663,102.0,0.0,-102.0,750000.0,0.0,-750000.0
<a href=/player/jaraj001>jaraj001</a>,Jason Jaramillo,Philadelphia Phillies,PHILS,2,2,2,4,2008,2009,1,No,0,-0.81,-0.18,0.63,119,47,-72,366,2,-364,0.0,88.0,88.0,0.0,0.0,0.0
<a href=/player/jarvk001>jarvk001</a>,Kevin Jarvis,San Diego Padres,PADRS,1,4,3,7,2004,2004,0,No,0,0.63,-0.51,-1.14,139,46,-93,232,85,-147,39.0,43.0,4.0,0.0,0.0,0.0
<a href=/player/jarvp101>jarvp101</a>,Pat Jarvis,Detroit Tigers,TIGRS,1,1,1,2,1963,1965,2,No,0,12.46,0.0,-12.46,442,0,-442,455,0,-455,3734.0,0.0,-3734.0,0.0,0.0,0.0
<a href=/player/jarvp101>jarvp101</a>,Pat Jarvis,Atlanta Braves,BRAVES,4,9,4,13,1973,1983,10,No,0,3.41,21.15,17.74,551,851,300,1018,2443,1425,1041.0,2934.0,1893.0,33500.0,0.0,-33500.0
<a href=/player/jarvp101>jarvp101</a>,Pat Jarvis,Montreal Expos,NATEX,3,4,3,7,1973,1978,5,No,0,19.9,0.29,-19.61,1883,303,-1580,6872,723,-6149,648.0,557.0,-91.0,40000.0,0.0,-40000.0
<a href=/player/jarvr101>jarvr101</a>,Ray Jarvis,Boston Red Sox,RSOX,6,13,11,24,1970,1987,17,No,0,23.72,33.07,9.35,1247,1904,657,3411,5540,2129,3997.0,6601.0,2604.0,192500.0,0.0,-192500.0
<a href=/player/jarvr102>jarvr102</a>,Roy Jarvis,Pittsburgh Pirates,PIRATS,2,4,2,6,1949,1956,7,No,0,-0.28,3.82,4.1,38,374,336,9,242,233,117.0,2170.0,2053.0,0.0,0.0,0.0
<a href=/player/jasoj001>jasoj001</a>,John Jaso,Tampa Bay Devil Rays,RAYS,1,1,2,3,2011,2014,3,No,0,3.35,-0.8,-4.15,108,53,-55,361,0,-361,0.0,165.0,165.0,427200.0,0.0,-427200.0
<a href=/player/jasoj001>jasoj001</a>,John Jaso,Seattle Mariners,MARNRS,2,2,2,4,2013,2014,1,No,0,2.61,-0.98,-3.59,181,76,-105,623,307,-316,0.0,0.0,0.0,0.0,0.0,0.0
<a href=/player/jasoj001>jasoj001</a>,John Jaso,Oakland Athletics,ATLTCS,7,12,9,21,2015,2018,3,Yes,0,7.5,-0.52,-8.02,615,193,-422,2031,464,-1567,103.0,312.0,209.0,8300001.0,0.0,-8300001.0
<a href=/player/jastl101>jastl101</a>,Larry Jaster,Montreal Expos,NATEX,1,1,2,3,1969,1969,0,No,0,-0.48,0.0,0.48,38,0,-38,4,0,-4,104.0,0.0,-104.0,0.0,0.0,0.0
<a href=/player/jatap101>jatap101</a>,Paul Jata,Detroit Tigers,TIGRS,1,1,1,2,1973,1975,2,No,0,0.0,0.28,0.28,0,43,43,0,159,159,0.0,0.0,0.0,0.0,0.0,0.0
<a href=/player/javia101>javia101</a>,Al Javier,Houston Astros,ASTROS,2,2,2,4,1977,1979,2,No,0,0.0,-0.57,-0.57,0,45,45,0,62,62,0.0,67.0,67.0,0.0,0.0,0.0
<a href=/player/javij101>javij101</a>,Julian Javier,Pittsburgh Pirates,PIRATS,2,3,3,6,1960,1962,2,No,0,13.99,2.03,-11.96,1772,159,-1613,6120,213,-5907,474.0,816.0,342.0,0.0,0.0,0.0
<a href=/player/javij101>javij101</a>,Julian Javier,St. Louis Cardinals,CARDS,1,1,1,2,1972,1972,0,No,0,-0.17,-0.47,-0.3,44,34,-10,100,3,-97,0.0,78.0,78.0,0.0,0.0,0.0
<a href=/player/javis001>javis001</a>,Stan Javier,St. Louis Cardinals,CARDS,1,2,3,5,1982,1982,0,No,0,3.76,0.0,-3.76,464,0,-464,1598,0,-1598,0.0,0.0,0.0,0.0,0.0,0.0
<a href=/player/javis001>javis001</a>,Stan Javier,New York Yankees,YANKS,3,7,8,15,1984,1993,9,No,0,53.43,36.99,-16.44,2484,1135,-1349,8455,3089,-5366,3002.0,2795.0,-207.0,2415000.0,0.0,-2415000.0
<a href=/player/javis001>javis001</a>,Stan Javier,Oakland Athletics,ATLTCS,1,1,1,2,1990,1990,0,No,0,3.33,2.33,-1.0,281,93,-188,584,333,-251,0.0,0.0,0.0,310000.0,0.0,-310000.0
<a href=/player/javis001>javis001</a>,Stan Javier,Los Angeles Dodgers,DOGRS,1,1,2,3,1992,1992,0,No,0,1.64,0.0,-1.64,74,0,-74,313,0,-313,0.0,0.0,0.0,715000.0,0.0,-715000.0
<a href=/player/javis001>javis001</a>,Stan Javier,San Francisco Giants,GIANTS,1,1,1,2,1999,1999,0,No,0,0.71,0.0,-0.71,20,0,-20,75,0,-75,0.0,0.0,0.0,1750000.0,0.0,-1750000.0
<a href=/player/jay-j001>jay-j001</a>,Jon Jay,St. Louis Cardinals,CARDS,2,3,4,7,2015,2019,4,Yes,0,0.8,6.31,5.51,114,418,304,413,1383,970,0.0,4.0,4.0,17125000.0,0.0,-17125000.0
<a href=/player/jay-j001>jay-j001</a>,Jon Jay,Kansas City Royals,ROYALS,1,1,2,3,2018,2018,0,Yes,0,-0.72,0.0,0.72,102,0,-102,377,0,-377,0.0,0.0,0.0,0.0,0.0,0.0
<a href=/player/jay-j101>jay-j101</a>,Joey Jay,Milwaukee Braves,BRAVES,2,3,3,6,1960,1969,9,No,0,11.93,7.0,-4.93,718,403,-315,1624,1494,-130,3308.0,0.0,-3308.0,0.0,0.0,0.0
<a href=/player/jay-j101>jay-j101</a>,Joey Jay,Cincinnati Reds,REDS,2,2,4,6,1966,1966,0,No,0,-1.04,-0.77,0.27,48,22,-26,26,11,-15,262.0,114.0,-148.0,0.0,0.0,0.0
<a href=/player/jayem001>jayem001</a>,Myles Jaye,Toronto Blue Jays,BJAYS,1,2,1,3,2012,2012,0,No,0,-0.18,0.35,0.53,100,54,-46,0,0,0,330.0,131.0,-199.0,0.0,0.0,0.0
<a href=/player/jayem001>jayem001</a>,Myles Jaye,Texas Rangers,RNGRS,1,2,1,3,2016,2016,0,No,0,-1.41,0.37,1.78,25,30,5,62,94,32,38.0,4.0,-34.0,0.0,0.0,0.0
<a href=/player/jayem001>jayem001</a>,Myles Jaye,Chicago White Sox,WSOX,1,1,1,2,2015,2015,0,Yes,0,0.0,0.0,0.0,0,0,0,0,0,0,0.0,0.0,0.0,0.0,0.0,0.0
<a href=/player/jeand001>jeand001</a>,Domingo Jean,Chicago White Sox,WSOX,1,3,1,4,1992,1994,2,No,0,12.77,-0.22,-12.99,326,200,-126,0,759,759,3273.0,0.0,-3273.0,0.0,0.0,0.0
<a href=/player/jeand001>jeand001</a>,Domingo Jean,New York Yankees,YANKS,1,2,1,3,1993,1994,1,No,0,0.14,-0.35,-0.49,80,32,-48,134,0,-134,0.0,120.0,120.0,138000.0,0.0,-138000.0
<a href=/player/jeand001>jeand001</a>,Domingo Jean,Houston Astros,ASTROS,1,1,1,2,1995,1995,0,No,0,0.0,0.0,0.0,0,0,0,0,0,0,0.0,0.0,0.0,0.0,0.0,0.0
<a href=/player/jeffg001>jeffg001</a>,Gregg Jefferies,New York Mets,METS,12,26,22,48,1991,2019,28,No,2,36.29,81.8,45.51,2523,4623,2100,5539,10481,4942,4638.0,5281.0,643.0,28212657.0,0.0,-28212657.0
<a href=/player/jeffg001>jeffg001</a>,Gregg Jefferies,Kansas City Royals,ROYALS,1,2,2,4,1993,1995,2,No,0,6.98,0.21,-6.77,245,278,33,1059,1031,-28,0.0,0.0,0.0,0.0,0.0,0.0
<a href=/player/jeffg001>jeffg001</a>,Gregg Jefferies,Philadelphia Phillies,PHILS,3,5,6,11,1998,2005,7,No,0,45.42,10.13,-35.29,1312,566,-746,5628,1576,-4052,0.0,291.0,291.0,19200000.0,0.0,-19200000.0
<a href=/player/jeffh101>jeffh101</a>,Hal Jeffcoat,Chicago Cubs,CUBS,6,11,10,21,1955,1965,10,No,0,12.98,7.53,-5.45,947,1198,251,1563,557,-1006,2818.0,2758.0,-60.0,0.0,0.0,0.0
<a href=/player/jeffh101>jeffh101</a>,Hal Jeffcoat,Cincinnati Reds,REDS,2,2,2,4,1959,1963,4,No,0,0.73,6.23,5.5,113,442,329,16,68,52,272.0,1124.0,852.0,0.0,0.0,0.0
<a href=/player/jeffi101>jeffi101</a>,Irv Jeffries,Cincinnati Reds,REDS,4,6,6,12,1933,1942,9,No,0,0.93,12.9,11.97,309,1107,798,770,4269,3499,264.0,0.0,-264.0,23000.0,0.0,-23000.0
<a href=/player/jeffi101>jeffi101</a>,Irv Jeffries,Philadelphia Phillies,PHILS,1,2,1,3,1934,1935,1,No,0,0.0,1.54,1.54,0,70,70,0,62,62,0.0,500.0,500.0,0.0,0.0,0.0
<a href=/player/jeffj001>jeffj001</a>,Jeremy Jeffress,Milwaukee Brewers,BREWRS,8,16,16,32,2010,2020,10,Yes,0,33.31,23.99,-9.32,2772,1309,-1463,10420,3997,-6423,777.0,2948.0,2171.0,20405500.0,0.0,-20405500.0
<a href=/player/jeffj001>jeffj001</a>,Jeremy Jeffress,Milwaukee Brewers,BREWRS,4,10,6,16,2016,2018,2,Yes,0,-0.21,7.76,7.97,1054,270,-784,3356,840,-2516,449.0,87.0,-362.0,2550000.0,0.0,-2550000.0
<a href=/player/jeffj001>jeffj001</a>,Jeremy Jeffress,Texas Rangers,RNGRS,1,1,1,2,2017,2018,1,No,0,3.37,0.0,-3.37,276,0,-276,3,0,-3,460.0,0.0,-460.0,2100000.0,0.0,-2100000.0
<a href=/player/jeffj101>jeffj101</a>,Jesse Jefferson,Baltimore Orioles,ORLS,1,1,1,2,1975,1978,3,No,0,-2.47,-1.06,1.41,41,336,295,0,581,581,510.0,0.0,-510.0,0.0,0.0,0.0
<a href=/player/jeffm001>jeffm001</a>,Mike Jeffcoat,Cleveland Indians,INDINS,3,4,4,8,1985,1991,6,No,0,-3.07,1.08,4.15,232,262,30,182,266,84,443.0,1475.0,1032.0,0.0,0.0,0.0
<a href=/player/jeffr001>jeffr001</a>,Reggie Jefferson,Cincinnati Reds,REDS,5,7,6,13,1991,1998,7,No,0,0.56,-0.19,-0.75,687,300,-387,1385,823,-562,1638.0,269.0,-1369.0,399000.0,0.0,-399000.0
<a href=/player/jeffr001>jeffr001</a>,Reggie Jefferson,Cleveland Indians,INDINS,2,4,3,7,1993,2011,18,No,2,-0.2,32.44,32.64,237,1648,1411,811,6543,5732,0.0,594.0,594.0,1117500.0,0.0,-1117500.0
<a href=/player/jeffs001>jeffs001</a>,Stan Jefferson,New York Mets,METS,14,32,26,58,1986,2019,33,No,2,34.33,97.35,63.02,3020,5459,2439,6919,13501,6582,4717.0,5432.0,715.0,28384257.0,0.0,-28384257.0
<a href=/player/jeffs001>jeffs001</a>,Stan Jefferson,San Diego Padres,PADRS,2,4,3,7,1988,1992,4,No,1,-2.09,7.62,9.71,105,399,294,12,1044,1032,593.0,270.0,-323.0,375000.0,0.0,-375000.0
<a href=/player/jeffs001>jeffs001</a>,Stan Jefferson,New York Yankees,YANKS,3,3,3,6,1989,1997,8,No,0,1.26,5.66,4.4,101,249,148,155,0,-155,141.0,1029.0,888.0,690000.0,0.0,-690000.0
<a href=/player/jelic001>jelic001</a>,Chris Jelic,Kansas City Royals,ROYALS,1,2,3,5,1987,1988,1,No,0,20.17,-0.31,-20.48,379,19,-360,466,21,-445,3628.0,141.0,-3487.0,0.0,0.0,0.0
<a href=/player/jelts001>jelts001</a>,Steve Jeltz,Philadelphia Phillies,PHILS,1,1,1,2,1990,1993,3,No,0,-0.71,3.18,3.89,74,106,32,114,114,0,0.0,935.0,935.0,0.0,0.0,0.0
<a href=/player/jenkf101>jenkf101</a>,Fergie Jenkins,Philadelphia Phillies,PHILS,1,3,2,5,1966,1968,2,No,0,66.82,10.77,-56.05,1243,294,-949,2604,327,-2277,8021.0,2661.0,-5360.0,0.0,0.0,0.0
<a href=/player/jenkf101>jenkf101</a>,Fergie Jenkins,Chicago Cubs,CUBS,5,8,8,16,1973,1982,9,No,0,27.24,12.62,-14.62,966,1853,887,2596,6406,3810,4383.0,0.0,-4383.0,430000.0,0.0,-430000.0
<a href=/player/jenkf101>jenkf101</a>,Fergie Jenkins,Texas Rangers,RNGRS,10,20,19,39,1975,1992,17,No,2,44.83,16.92,-27.91,2024,1366,-658,3128,3741,613,9799.0,2348.0,-7451.0,190000.0,0.0,-190000.0
<a href=/player/jenkf101>jenkf101</a>,Fergie Jenkins,Boston Red Sox,RSOX,1,1,2,3,1977,1977,0,No,0,11.05,0.0,-11.05,121,0,-121,0,0,0,2436.0,0.0,-2436.0,200000.0,0.0,-200000.0
<a href=/player/jenkt001>jenkt001</a>,Tyrell Jenkins,St. Louis Cardinals,CARDS,1,2,2,4,2014,2016,2,No,0,3.49,7.42,3.93,93,178,85,88,610,522,772.0,31.0,-741.0,521000.0,0.0,-521000.0
<a href=/player/jenkt001>jenkt001</a>,Tyrell Jenkins,Atlanta Braves,BRAVES,1,2,1,3,2016,2018,2,Yes,0,0.0,0.11,0.11,0,152,152,0,6,6,0.0,274.0,274.0,0.0,0.0,0.0
<a href=/player/jenkt101>jenkt101</a>,Tom Jenkins,St.Louis Browns,ORLS,1,1,1,2,1932,1932,0,No,0,0.0,-0.2,-0.2,0,18,18,0,24,24,0.0,0.0,0.0,4000.0,0.0,-4000.0
<a href=/player/jenkt101>jenkt101</a>,Tom Jenkins,Boston Red Sox,RSOX,1,3,1,4,1926,1926,0,No,0,0.0,-0.79,-0.79,0,31,31,0,103,103,0.0,0.0,0.0,7100.0,0.0,-7100.0
<a href=/player/jennd003>jennd003</a>,Dan Jennings,Miami Marlins,MARLNS,1,1,1,2,2014,2016,2,No,0,2.32,-0.31,-2.63,173,27,-146,0,2,2,484.0,59.0,-425.0,501500.0,0.0,-501500.0
<a href=/player/jennd003>jennd003</a>,Dan Jennings,Chicago White Sox,WSOX,1,1,1,2,2017,2017,0,Yes,0,0.28,0.0,-0.28,32,0,-32,0,0,0,55.0,0.0,-55.0,1400000.0,0.0,-1400000.0
<a href=/player/jennh101>jennh101</a>,Hughie Jennings,Louisville Colonels,LS3,1,2,1,3,1893,1894,1,No,0,35.58,1.66,-33.92,755,147,-608,3472,687,-2785,0.0,0.0,0.0,0.0,0.0,0.0
<a href=/player/jennh101>jennh101</a>,Hughie Jennings,Brooklyn Dodgers,DOGRS,1,1,2,3,1899,1901,2,No,0,0.13,-0.36,-0.49,2,87,85,8,281,273,0.0,204.0,204.0,0.0,0.0,0.0
<a href=/player/jennh101>jennh101</a>,Hughie Jennings,Brooklyn Dodgers,DOGRS,1,4,1,5,1903,1908,5,No,0,0.0,0.0,0.0,0,0,0,0,0,0,0.0,0.0,0.0,0.0,0.0,0.0
<a href=/player/jennj001>jennj001</a>,Jason Jennings,Colorado Rockies,ROCKS,1,2,3,5,2006,2010,4,No,0,-0.73,4.59,5.32,38,489,451,30,1012,982,297.0,873.0,576.0,4500000.0,0.0,-4500000.0
<a href=/player/jennr001>jennr001</a>,Robin Jennings,Oakland Athletics,ATLTCS,1,1,1,2,2001,2001,0,No,0,-0.19,-0.02,0.17,1,34,33,3,93,90,0.0,0.0,0.0,290000.0,0.0,-290000.0
<a href=/player/jennr001>jennr001</a>,Robin Jennings,Colorado Rockies,ROCKS,2,5,4,9,2001,2002,1,No,0,3.51,-0.39,-3.9,333,251,-82,1296,922,-374,0.0,3.0,3.0,1050000.0,0.0,-1050000.0
<a href=/player/jensj101>jensj101</a>,Jackie Jensen,Oakland,Oakland,1,2,2,4,1949,1951,2,No,0,6.53,0.0,-6.53,635,0,-635,2176,0,-2176,0.0,0.0,0.0,0.0,0.0,0.0
<a href=/player/jensj101>jensj101</a>,Jackie Jensen,New York Yankees,YANKS,7,19,15,34,1952,1970,18,No,0,13.22,40.85,27.63,2406,2911,505,6464,7208,744,3937.0,4978.0,1041.0,115500.0,0.0,-115500.0
<a href=/player/jensj101>jensj101</a>,Jackie Jensen,Washington Senators,TWINS,14,26,27,53,1953,1963,10,No,0,37.46,-3.27,-40.73,2533,3473,940,8910,8941,31,1213.0,3299.0,2086.0,38500.0,0.0,-38500.0
<a href=/player/jensk001>jensk001</a>,Kyle Jensen,Miami Marlins,MARLNS,1,1,1,2,2014,2014,0,Yes,0,0.0,0.0,0.0,0,0,0,0,0,0,0.0,0.0,0.0,0.0,0.0,0.0
<a href=/player/jensm001>jensm001</a>,Marcus Jensen,San Francisco Giants,GIANTS,1,1,1,2,1997,1998,1,No,0,-0.08,2.15,2.23,8,155,147,12,547,535,0.0,0.0,0.0,151500.0,0.0,-151500.0
<a href=/player/jepsk001>jepsk001</a>,Kevin Jepsen,Anaheim Angels,ANGELS,1,1,1,2,2014,2015,1,No,0,0.38,-0.85,-1.23,79,93,14,0,284,284,182.0,0.0,-182.0,1462500.0,0.0,-1462500.0
<a href=/player/jepsk001>jepsk001</a>,Kevin Jepsen,Tampa Bay Devil Rays,RAYS,2,2,3,5,2015,2018,3,Yes,0,0.73,0.22,-0.51,63,11,-52,0,0,0,176.0,69.0,-107.0,3025000.0,0.0,-3025000.0
<a href=/player/jerew001>jerew001</a>,Williams Jerez,Boston Red Sox,RSOX,1,2,2,4,2018,2018,0,No,0,0.49,-0.14,-0.63,139,37,-102,0,143,143,390.0,0.0,-390.0,0.0,0.0,0.0
<a href=/player/jerew001>jerew001</a>,Williams Jerez,Anaheim Angels,ANGELS,1,1,1,2,2019,2019,0,No,0,0.17,-0.68,-0.85,12,8,-4,0,2,2,20.0,88.0,68.0,0.0,0.0,0.0
<a href=/player/jestg101>jestg101</a>,Garry Jestadt,Montreal Expos,NATEX,2,2,2,4,1970,1971,1,No,0,-0.14,0.08,0.22,3,58,55,3,127,124,0.0,0.0,0.0,0.0,0.0,0.0
<a href=/player/jestg101>jestg101</a>,Garry Jestadt,Chicago Cubs,CUBS,1,1,1,2,1971,1971,0,No,0,0.07,0.1,0.03,167,71,-96,484,234,-250,0.0,0.0,0.0,0.0,0.0,0.0
<a href=/player/jetej101>jetej101</a>,Johnny Jeter,Pittsburgh Pirates,PIRATS,1,2,1,3,1971,1973,2,No,0,1.19,1.07,-0.12,236,104,-132,456,7,-449,405.0,247.0,-158.0,0.0,0.0,0.0
<a href=/player/jetej101>jetej101</a>,Johnny Jeter,San Diego Padres,PADRS,1,1,1,2,1972,1975,3,No,0,-1.06,-1.06,0.0,89,206,117,313,26,-287,0.0,476.0,476.0,17000.0,0.0,-17000.0
<a href=/player/jetej101>jetej101</a>,Johnny Jeter,Chicago White Sox,WSOX,2,3,2,5,1974,1976,2,No,0,-0.47,0.75,1.22,8,206,198,18,720,702,13.0,0.0,-13.0,0.0,0.0,0.0
<a href=/player/jetes001>jetes001</a>,Shawn Jeter,Toronto Blue Jays,BJAYS,1,2,1,3,1991,1991,0,No,0,-0.18,-0.65,-0.47,19,21,2,18,54,36,15.0,0.0,-15.0,0.0,0.0,0.0
<a href=/player/jeths101>jeths101</a>,Sam Jethroe,Brooklyn Dodgers,DOGRS,1,2,3,5,1949,1949,0,No,0,8.82,0.0,-8.82,541,0,-541,2215,0,-2215,0.0,0.0,0.0,0.0,0.0,0.0
<a href=/player/jeths101>jeths101</a>,Sam Jethroe,Milwaukee Braves,BRAVES,2,10,2,12,1953,1960,7,No,0,8.19,12.74,4.55,794,729,-65,1824,3040,1216,2135.0,0.0,-2135.0,0.0,0.0,0.0
<a href=/player/jimed001>jimed001</a>,D'Angelo Jimenez,New York Yankees,YANKS,2,2,2,4,2001,2002,1,No,0,2.93,0.22,-2.71,260,119,-141,711,245,-466,209.0,121.0,-88.0,0.0,0.0,0.0
<a href=/player/jimed001>jimed001</a>,D'Angelo Jimenez,San Diego Padres,PADRS,3,5,5,10,2002,2005,3,No,0,1.02,-1.33,-2.35,447,97,-350,1468,112,-1356,24.0,184.0,160.0,4215000.0,0.0,-4215000.0
<a href=/player/jimed001>jimed001</a>,D'Angelo Jimenez,Chicago White Sox,WSOX,2,4,3,7,2003,2004,1,No,0,5.63,0.32,-5.31,281,41,-240,1102,2,-1100,90.0,416.0,326.0,675000.0,0.0,-675000.0
<a href=/player/jimee001>jimee001</a>,Eloy Jimenez,Chicago Cubs,CUBS,1,4,1,5,2017,2020,3,No,0,6.48,3.51,-2.97,293,156,-137,969,150,-819,891.0,1319.0,428.0,0.0,0.0,0.0
<a href=/player/jimej001>jimej001</a>,Jose Jimenez,St. Louis Cardinals,CARDS,2,6,4,10,1999,2003,4,No,0,3.2,2.78,-0.42,870,638,-232,626,106,-520,1171.0,1638.0,467.0,860000.0,0.0,-860000.0
<a href=/player/jimem101>jimem101</a>,Manny Jimenez,Milwaukee Braves,BRAVES,11,17,20,37,1961,1973,12,No,0,24.16,33.51,9.35,2325,1915,-410,6983,5059,-1924,2257.0,3206.0,949.0,95000.0,0.0,-95000.0
<a href=/player/jimem101>jimem101</a>,Manny Jimenez,Pittsburgh Pirates,PIRATS,1,1,2,3,1969,1970,1,No,0,0.0,0.26,0.26,6,146,140,6,17,11,0.0,358.0,358.0,0.0,0.0,0.0
<a href=/player/jimeu001>jimeu001</a>,Ubaldo Jimenez,Colorado Rockies,ROCKS,3,5,8,13,2011,2015,4,Yes,0,3.72,1.36,-2.36,158,373,215,10,263,253,1739.0,1188.0,-551.0,2800000.0,0.0,-2800000.0
<a href=/player/jodib001>jodib001</a>,Brett Jodie,New York Yankees,YANKS,3,4,4,8,2001,2007,6,No,0,0.42,0.27,-0.15,30,179,149,18,0,-18,184.0,789.0,605.0,6000000.0,0.0,-6000000.0
<a href=/player/joe-c001>joe-c001</a>,Connor Joe,Pittsburgh Pirates,PIRATS,1,1,1,2,2017,2018,1,No,0,0.0,-0.61,-0.61,0,105,105,0,279,279,0.0,0.0,0.0,0.0,0.0,0.0
<a href=/player/joe-c001>joe-c001</a>,Connor Joe,Atlanta Braves,BRAVES,1,1,1,2,2017,2017,0,No,0,0.0,0.0,0.0,0,0,0,0,0,0,0.0,0.0,0.0,0.0,0.0,0.0
<a href=/player/joe-c001>joe-c001</a>,Connor Joe,Cincinnati Reds,REDS,1,1,2,3,2019,2019,0,Yes,0,-0.11,0.0,0.11,8,0,-8,16,0,-16,0.0,0.0,0.0,0.0,0.0,0.0
<a href=/player/johna101>johna101</a>,Augie Johns,FortWorth,FortWorth,1,2,2,4,1925,1925,0,No,0,-0.54,0.0,0.54,83,0,-83,54,0,-54,341.0,0.0,-341.0,0.0,0.0,0.0
<a href=/player/johna104>johna104</a>,Alex Johnson,Philadelphia Phillies,PHILS,9,17,16,33,1965,1984,19,No,0,32.54,23.78,-8.76,2044,2671,627,6114,5833,-281,1729.0,2166.0,437.0,32000.0,0.0,-32000.0
<a href=/player/johna104>johna104</a>,Alex Johnson,St. Louis Cardinals,CARDS,5,11,8,19,1968,1972,4,No,0,17.08,2.08,-15.0,1534,302,-1232,2656,673,-1983,1865.0,299.0,-1566.0,32500.0,0.0,-32500.0
<a href=/player/johna104>johna104</a>,Alex Johnson,Cincinnati Reds,REDS,9,11,14,25,1969,1988,19,No,0,6.47,49.11,42.64,1174,3400,2226,3915,6767,2852,279.0,5781.0,5502.0,18500.0,0.0,-18500.0
<a href=/player/johna104>johna104</a>,Alex Johnson,California Angels,ANGELS,2,3,5,8,1971,1974,3,No,0,-0.38,1.97,2.35,378,289,-89,1313,1028,-285,0.0,88.0,88.0,15000.0,0.0,-15000.0
<a href=/player/johna104>johna104</a>,Alex Johnson,Cleveland Indians,INDINS,1,1,2,3,1973,1974,1,No,0,1.79,0.0,-1.79,272,0,-272,1149,0,-1149,0.0,0.0,0.0,0.0,0.0,0.0
<a href=/player/johnb001>johnb001</a>,Bill Johnson,Philadelphia Phillies,PHILS,4,8,7,15,1983,1989,6,No,0,22.89,10.28,-12.61,2046,1011,-1035,3682,3184,-498,3936.0,302.0,-3634.0,1629900.0,0.0,-1629900.0
<a href=/player/johnb002>johnb002</a>,Brian Johnson,San Diego Padres,PADRS,2,3,3,6,1996,1997,1,No,0,2.37,0.0,-2.37,183,0,-183,158,0,-158,1473.0,0.0,-1473.0,920000.0,0.0,-920000.0
<a href=/player/johnb002>johnb002</a>,Brian Johnson,Detroit Tigers,TIGRS,1,1,1,2,1997,1998,1,No,0,2.15,-0.08,-2.23,155,8,-147,547,12,-535,0.0,0.0,0.0,600000.0,0.0,-600000.0
<a href=/player/johnb003>johnb003</a>,Ben Johnson,St. Louis Cardinals,CARDS,1,2,2,4,2000,2000,0,No,0,0.41,0.16,-0.25,133,17,-116,223,58,-165,57.0,0.0,-57.0,1600000.0,0.0,-1600000.0
<a href=/player/johnb003>johnb003</a>,Ben Johnson,San Diego Padres,PADRS,5,9,10,19,2006,2016,10,No,2,7.6,8.88,1.28,798,1045,247,2623,1095,-1528,111.0,1373.0,1262.0,1621100.0,0.0,-1621100.0
<a href=/player/johnb102>johnb102</a>,Bob Johnson,Philadelphia Athletics,ATLTCS,1,1,3,4,1943,1949,6,No,0,3.2,7.97,4.77,117,391,274,505,1546,1041,0.0,0.0,0.0,0.0,0.0,0.0
<a href=/player/johnb103>johnb103</a>,Bob Johnson,New York Mets,METS,1,2,1,3,1969,1970,1,No,0,49.09,1.86,-47.23,1971,99,-1872,8041,399,-7642,642.0,0.0,-642.0,0.0,0.0,0.0
<a href=/player/johnb103>johnb103</a>,Bob Johnson,Kansas City Royals,ROYALS,3,7,6,13,1970,1979,9,No,1,2.78,26.16,23.38,582,1576,994,670,5382,4712,1583.0,1688.0,105.0,34500.0,0.0,-34500.0
<a href=/player/johnb103>johnb103</a>,Bob Johnson,Pittsburgh Pirates,PIRATS,1,1,1,2,1973,1973,0,No,0,-0.35,0.0,0.35,14,0,-14,0,0,0,216.0,0.0,-216.0,38000.0,0.0,-38000.0
<a href=/player/johnb104>johnb104</a>,Bob Johnson,Washington Senators,RNGRS,2,3,4,7,1962,1964,2,No,0,2.63,0.81,-1.82,369,114,-255,1015,218,-797,22.0,175.0,153.0,0.0,0.0,0.0
<a href=/player/johnb104>johnb104</a>,Bob Johnson,New York Mets,METS,2,5,5,10,1967,1975,8,No,0,1.95,7.19,5.24,260,746,486,66,1625,1559,763.0,880.0,117.0,0.0,0.0,0.0
<a href=/player/johnb104>johnb104</a>,Bob Johnson,Cincinnati Reds,REDS,3,5,6,11,1968,1977,9,No,0,4.56,11.78,7.22,256,1321,1065,307,585,278,1267.0,4200.0,2933.0,0.0,0.0,0.0
<a href=/player/johnb104>johnb104</a>,Bob Johnson,Atlanta Braves,BRAVES,2,2,2,4,1969,1969,0,No,0,-0.21,0.0,0.21,19,0,-19,32,0,-32,0.0,0.0,0.0,0.0,0.0,0.0
<a href=/player/johnb104>johnb104</a>,Bob Johnson,St. Louis Cardinals,CARDS,1,1,1,2,1969,1971,2,No,0,0.47,0.02,-0.45,81,10,-71,123,6,-117,0.0,0.0,0.0,0.0,0.0,0.0
<a href=/player/johnb107>johnb107</a>,Ben Johnson,Milwaukee Braves,BRAVES,2,7,3,10,1957,1961,4,No,0,-1.07,-0.69,0.38,281,102,-179,637,325,-312,138.0,0.0,-138.0,0.0,0.0,0.0
<a href=/player/johnb107>johnb107</a>,Ben Johnson,Houston Astros,ASTROS,1,1,1,2,1962,1963,1,No,0,0.0,-0.49,-0.49,0,44,44,0,22,22,0.0,200.0,200.0,0.0,0.0,0.0
<a href=/player/johnb108>johnb108</a>,Billy Johnson,New York Yankees,YANKS,17,46,40,86,1951,1970,19,No,0,53.19,79.46,26.27,7246,4796,-2450,23560,11518,-12042,3607.0,11554.0,7947.0,331250.0,0.0,-331250.0
<a href=/player/johnc001>johnc001</a>,Cliff Johnson,Houston Astros,ASTROS,5,8,8,16,1977,1987,10,No,0,32.76,10.5,-22.26,2646,1146,-1500,8964,3347,-5617,147.0,300.0,153.0,450000.0,0.0,-450000.0
<a href=/player/johnc001>johnc001</a>,Cliff Johnson,New York Yankees,YANKS,1,1,1,2,1979,1979,0,No,0,1.11,1.33,0.22,126,27,-99,477,0,-477,0.0,202.0,202.0,0.0,0.0,0.0
<a href=/player/johnc001>johnc001</a>,Cliff Johnson,Cleveland Indians,INDINS,1,1,2,3,1980,1983,3,No,0,-0.08,0.22,0.3,68,45,-23,227,64,-163,0.0,0.0,0.0,0.0,0.0,0.0
<a href=/player/johnc001>johnc001</a>,Cliff Johnson,Chicago Cubs,CUBS,2,3,2,5,1980,1982,2,No,0,1.71,0.0,-1.71,188,0,-188,646,0,-646,0.0,0.0,0.0,0.0,0.0,0.0
<a href=/player/johnc001>johnc001</a>,Cliff Johnson,Oakland Athletics,ATLTCS,1,1,1,2,1982,1983,1,No,0,5.46,0.0,-5.46,400,0,-400,1376,0,-1376,0.0,0.0,0.0,0.0,0.0,0.0
<a href=/player/johnc001>johnc001</a>,Cliff Johnson,Texas Rangers,RNGRS,2,2,4,6,1985,1987,2,No,0,0.73,0.93,0.2,131,6,-125,477,0,-477,0.0,78.0,78.0,683333.0,0.0,-683333.0
<a href=/player/johnc002>johnc002</a>,Charles Johnson,Florida Marlins,MARLNS,15,33,38,71,1998,2019,21,Yes,0,116.45,94.42,-22.03,4698,5470,772,15425,16217,792,10496.0,10160.0,-336.0,68580667.0,0.0,-68580667.0
<a href=/player/johnc002>johnc002</a>,Charles Johnson,Los Angeles Dodgers,DOGRS,1,2,2,4,1998,2000,2,No,0,1.05,2.33,1.28,452,204,-248,1614,781,-833,0.0,0.0,0.0,280000.0,0.0,-280000.0
<a href=/player/johnc002>johnc002</a>,Charles Johnson,New York Mets,METS,2,2,4,6,1998,2006,8,No,0,6.33,9.77,3.44,228,661,433,812,7,-805,28.0,1073.0,1045.0,6937500.0,0.0,-6937500.0
<a href=/player/johnc002>johnc002</a>,Charles Johnson,Baltimore Orioles,ORLS,1,2,4,6,2000,2003,3,No,0,0.48,0.13,-0.35,100,312,212,320,1036,716,0.0,0.0,0.0,6600000.0,0.0,-6600000.0
<a href=/player/johnc002>johnc002</a>,Charles Johnson,Florida Marlins,MARLNS,4,9,11,20,2002,2015,13,No,0,11.51,22.72,11.21,893,1533,640,2983,2710,-273,1797.0,5078.0,3281.0,13177000.0,0.0,-13177000.0
<a href=/player/johnc002>johnc002</a>,Charles Johnson,Colorado Rockies,ROCKS,2,3,3,6,2005,2007,2,No,0,-0.15,1.77,1.92,44,250,206,39,105,66,329.0,1085.0,756.0,2500000.0,0.0,-2500000.0
<a href=/player/johnc003>johnc003</a>,Chris Johnson,Houston Astros,ASTROS,1,1,2,3,2012,2014,2,No,0,0.46,-0.6,-1.06,44,119,75,160,354,194,0.0,0.0,0.0,495000.0,0.0,-495000.0
<a href=/player/johnc003>johnc003</a>,Chris Johnson,Arizona Diamondbacks,DBACKS,5,9,11,20,2013,2019,6,Yes,0,9.33,5.76,-3.57,709,1160,451,2798,2556,-242,0.0,1347.0,1347.0,0.0,0.0,0.0
<a href=/player/johnc003>johnc003</a>,Chris Johnson,Atlanta Braves,BRAVES,1,1,3,4,2015,2016,1,No,0,-0.23,-0.91,-0.68,27,92,65,93,305,212,0.0,0.0,0.0,0.0,0.0,0.0
<a href=/player/johnc103>johnc103</a>,Connie Johnson,Chicago White Sox,WSOX,2,5,3,8,1956,1961,5,No,0,20.82,6.19,-14.63,1000,561,-439,2990,1443,-1547,2136.0,479.0,-1657.0,62000.0,0.0,-62000.0
<a href=/player/johnd001>johnd001</a>,Dave Johnson,Houston Astros,ASTROS,1,2,1,3,1989,1991,2,No,0,0.47,-0.34,-0.81,66,60,-6,0,130,130,1060.0,0.0,-1060.0,0.0,0.0,0.0
<a href=/player/johnd005>johnd005</a>,DJ Johnson,Cleveland Indians,INDINS,1,2,1,3,2021,2021,0,Yes,0,0.29,0.0,-0.29,29,0,-29,72,0,-72,11.0,0.0,-11.0,0.0,0.0,0.0
<a href=/player/johnd006>johnd006</a>,Daniel Johnson,Washington Nationals,NATEX,2,6,4,10,2018,2021,3,Yes,0,-0.4,4.3,4.7,134,190,56,433,712,279,140.0,0.0,-140.0,7000000.0,0.0,-7000000.0
<a href=/player/johnd101>johnd101</a>,Don Johnson,Milwaukee,Milwaukee,2,2,7,9,1943,1944,1,No,0,6.7,0.0,-6.7,673,0,-673,2771,0,-2771,0.0,0.0,0.0,0.0,0.0,0.0
<a href=/player/johnd102>johnd102</a>,Don Johnson,New York Yankees,YANKS,2,8,4,12,1950,1954,4,No,0,21.38,0.72,-20.66,1235,437,-798,2252,180,-2072,6559.0,1785.0,-4774.0,29000.0,0.0,-29000.0
<a href=/player/johnd102>johnd102</a>,Don Johnson,Toronto,Toronto,1,1,1,2,1953,1953,0,No,0,1.41,0.0,-1.41,92,0,-92,45,0,-45,432.0,0.0,-432.0,0.0,0.0,0.0
<a href=/player/johnd102>johnd102</a>,Don Johnson,Chicago White Sox,WSOX,29,56,55,111,1954,1971,17,No,0,64.71,122.48,57.77,7633,8254,621,20626,20005,-621,7158.0,13512.0,6354.0,248750.0,0.0,-248750.0
<a href=/player/johnd102>johnd102</a>,Don Johnson,Toronto,Toronto,1,1,1,2,1958,1958,0,No,0,-0.49,0.0,0.49,34,0,-34,3,0,-3,69.0,0.0,-69.0,0.0,0.0,0.0
<a href=/player/johnd103>johnd103</a>,Deron Johnson,New York Yankees,YANKS,3,6,4,10,1961,1966,5,No,0,-0.26,3.2,3.46,405,420,15,1128,119,-1009,748.0,1424.0,676.0,84000.0,0.0,-84000.0
<a href=/player/johnd103>johnd103</a>,Deron Johnson,Cincinnati Reds,REDS,2,2,5,7,1967,1970,3,No,0,-0.9,0.5,1.4,158,233,75,412,406,-6,0.0,170.0,170.0,0.0,0.0,0.0
<a href=/player/johnd103>johnd103</a>,Deron Johnson,Philadelphia Phillies,PHILS,1,1,1,2,1973,1973,0,No,0,0.62,0.0,-0.62,181,0,-181,718,0,-718,0.0,0.0,0.0,0.0,0.0,0.0
<a href=/player/johnd103>johnd103</a>,Deron Johnson,Oakland Athletics,ATLTCS,1,1,2,3,1974,1974,0,No,0,-0.96,0.11,1.07,49,4,-45,174,0,-174,0.0,6.0,6.0,75000.0,0.0,-75000.0
<a href=/player/johnd103>johnd103</a>,Deron Johnson,Chicago White Sox,WSOX,1,1,2,3,1975,1975,0,No,0,-0.13,0.0,0.13,18,0,-18,55,0,-55,0.0,0.0,0.0,0.0,0.0,0.0
<a href=/player/johnd105>johnd105</a>,Davey Johnson,Baltimore Orioles,ORLS,12,27,22,49,1972,1994,22,No,3,53.13,90.0,36.87,3098,4599,1501,7090,11622,4532,12003.0,13691.0,1688.0,846833.0,0.0,-846833.0
<a href=/player/johnd105>johnd105</a>,Davey Johnson,Philadelphia Phillies,PHILS,1,1,1,2,1978,1979,1,No,0,0.52,0.0,-0.52,24,0,-24,56,0,-56,0.0,0.0,0.0,0.0,0.0,0.0
<a href=/player/johnd106>johnd106</a>,Darrell Johnson,St.Louis Browns,ORLS,32,76,74,150,1952,1994,42,No,3,130.65,189.94,59.29,8445,12895,4450,19022,39022,20000,28431.0,18680.0,-9751.0,996333.0,0.0,-996333.0
<a href=/player/johnd106>johnd106</a>,Darrell Johnson,Chicago White Sox,WSOX,7,12,13,25,1953,1969,16,No,0,11.99,30.83,18.84,1538,1586,48,4583,5396,813,1710.0,1860.0,150.0,87250.0,0.0,-87250.0
<a href=/player/johnd106>johnd106</a>,Darrell Johnson,Baltimore Orioles,ORLS,21,46,43,89,1954,1994,40,No,3,83.66,150.67,67.01,4979,8510,3531,10385,24729,14344,18519.0,15968.0,-2551.0,970833.0,0.0,-970833.0
<a href=/player/johnd107>johnd107</a>,Doc Johnston,NewOrleans,NewOrleans,2,2,9,11,1912,1915,3,No,0,1.74,0.0,-1.74,769,0,-769,2920,0,-2920,303.0,0.0,-303.0,0.0,0.0,0.0
<a href=/player/johnd107>johnd107</a>,Doc Johnston,Pittsburgh Pirates,PIRATS,3,8,4,12,1916,1922,6,No,0,39.97,14.79,-25.18,1164,990,-174,2135,3762,1627,8893.0,711.0,-8182.0,9650.0,0.0,-9650.0
<a href=/player/johne002>johne002</a>,Elliot Johnson,Tampa Bay Devil Rays,RAYS,8,14,20,34,2012,2020,8,Yes,0,32.69,16.85,-15.84,1967,1086,-881,5025,2972,-2053,4433.0,3274.0,-1159.0,6379200.0,0.0,-6379200.0
<a href=/player/johne003>johne003</a>,Erik Johnson,Chicago White Sox,WSOX,1,2,2,4,2016,2018,2,No,0,12.87,0.14,-12.73,280,82,-198,1180,11,-1169,59.0,1308.0,1249.0,0.0,0.0,0.0
<a href=/player/johne102>johne102</a>,Ernie Johnson,New York Yankees,YANKS,2,6,4,10,1925,1931,6,No,0,-1.14,6.67,7.81,271,713,442,761,2895,2134,731.0,97.0,-634.0,31500.0,0.0,-31500.0
<a href=/player/johnh001>johnh001</a>,Howard Johnson,Detroit Tigers,TIGRS,3,3,4,7,1984,1990,6,No,0,22.15,8.04,-14.11,1225,259,-966,4746,406,-4340,370.0,2975.0,2605.0,2148333.0,0.0,-2148333.0
<a href=/player/johnh101>johnh101</a>,Hank Johnson,New York Yankees,YANKS,1,3,1,4,1932,1934,2,No,0,4.01,-1.32,-5.33,261,128,-133,217,129,-88,1777.0,923.0,-854.0,12000.0,0.0,-12000.0
<a href=/player/johnh101>johnh101</a>,Hank Johnson,Boston Red Sox,RSOX,7,17,15,32,1936,1956,20,No,0,19.89,33.66,13.77,2712,2773,61,8706,8806,100,4863.0,6247.0,1384.0,147000.0,0.0,-147000.0
<a href=/player/johnh101>johnh101</a>,Hank Johnson,Cincinnati Reds,REDS,1,1,1,2,1941,1941,0,No,0,0.0,0.0,0.0,0,0,0,0,0,0,0.0,0.0,0.0,0.0,0.0,0.0
<a href=/player/johnj001>johnj001</a>,John Henry Johnson,San Francisco Giants,GIANTS,4,14,8,22,1978,1992,14,No,0,8.18,23.62,15.44,767,1277,510,1656,1600,-56,2714.0,7759.0,5045.0,0.0,0.0,0.0
<a href=/player/johnj001>johnj001</a>,John Henry Johnson,Oakland Athletics,ATLTCS,2,3,4,7,1979,1987,8,No,0,-0.45,7.67,8.12,210,832,622,273,2903,2630,902.0,648.0,-254.0,425000.0,0.0,-425000.0
<a href=/player/johnj001>johnj001</a>,John Henry Johnson,Texas Rangers,RNGRS,3,5,4,9,1982,1992,10,No,2,8.84,10.52,1.68,276,466,190,0,1729,1729,4307.0,838.0,-3469.0,0.0,0.0,0.0
<a href=/player/johnj002>johnj002</a>,Jay Johnstone,California Angels,ANGELS,8,17,17,34,1970,1976,6,No,0,13.31,15.37,2.06,1179,1226,47,3267,3750,483,2333.0,345.0,-1988.0,137100.0,0.0,-137100.0
<a href=/player/johnj002>johnj002</a>,Jay Johnstone,Philadelphia Phillies,PHILS,1,2,1,3,1978,1980,2,No,0,1.16,-1.2,-2.36,257,146,-111,709,10,-699,0.0,369.0,369.0,0.0,0.0,0.0
<a href=/player/johnj002>johnj002</a>,Jay Johnstone,New York Yankees,YANKS,1,1,1,2,1979,1980,1,No,0,-0.02,0.0,0.02,75,0,-75,225,0,-225,0.0,0.0,0.0,0.0,0.0,0.0
<a href=/player/johnj003>johnj003</a>,Joe Johnson,Atlanta Braves,BRAVES,3,4,4,8,1986,1993,7,No,0,2.29,5.2,2.91,177,785,608,6,431,425,1160.0,1516.0,356.0,958000.0,0.0,-958000.0
<a href=/player/johnj005>johnj005</a>,Joel Johnston,Kansas City Royals,ROYALS,1,2,1,3,1992,1995,3,No,0,-0.61,-1.65,-1.04,94,250,156,7,880,873,219.0,0.0,-219.0,113500.0,0.0,-113500.0
<a href=/player/johnj007>johnj007</a>,Jason Johnson,Tampa Bay Devil Rays,RAYS,1,1,2,3,1999,1999,0,No,0,4.13,-0.26,-4.39,143,28,-115,20,89,69,2220.0,0.0,-2220.0,0.0,0.0,0.0
<a href=/player/johnj009>johnj009</a>,Josh Johnson,Miami Marlins,MARLNS,12,33,32,65,2012,2020,8,Yes,0,57.99,24.95,-33.04,3997,2605,-1392,9990,7444,-2546,7539.0,4278.0,-3261.0,66200000.0,0.0,-66200000.0
<a href=/player/johnj010>johnj010</a>,Jim Johnson,Baltimore Orioles,ORLS,2,3,4,7,2013,2015,2,Yes,0,-1.09,-0.11,0.98,58,22,-36,42,58,16,121.0,0.0,-121.0,7015000.0,0.0,-7015000.0
<a href=/player/johnj010>johnj010</a>,Jim Johnson,Atlanta Braves,BRAVES,3,7,11,18,2015,2020,5,Yes,0,4.88,-1.29,-6.17,588,465,-123,687,1320,633,1642.0,246.0,-1396.0,24400000.0,0.0,-24400000.0
<a href=/player/johnj010>johnj010</a>,Jim Johnson,Atlanta Braves,BRAVES,1,2,1,3,2017,2017,0,Yes,0,-0.5,0.0,0.5,64,0,-64,0,0,0,190.0,0.0,-190.0,5000000.0,0.0,-5000000.0
<a href=/player/johnj102>johnj102</a>,Jing Johnson,Philadelphia Athletics,ATLTCS,2,4,3,7,1928,1935,7,No,0,3.62,18.26,14.64,76,599,523,105,1064,959,735.0,4060.0,3325.0,13500.0,0.0,-13500.0
<a href=/player/johnj103>johnj103</a>,Johnny Johnson,New York Yankees,YANKS,1,1,1,2,1944,1946,2,No,0,-0.17,0.97,1.14,58,26,-32,18,10,-8,209.0,106.0,-103.0,4000.0,0.0,-4000.0
<a href=/player/johnj104>johnj104</a>,Jerry Johnson,Philadelphia Phillies,PHILS,5,9,11,20,1969,1977,8,No,0,2.27,5.62,3.35,374,740,366,889,1587,698,321.0,625.0,304.0,70000.0,0.0,-70000.0
<a href=/player/johnj104>johnj104</a>,Jerry Johnson,St. Louis Cardinals,CARDS,2,2,2,4,1970,1972,2,No,0,-1.07,3.11,4.18,433,194,-239,50,11,-39,1164.0,362.0,-802.0,0.0,0.0,0.0
<a href=/player/johnj104>johnj104</a>,Jerry Johnson,Cleveland Indians,INDINS,6,11,13,24,1973,1980,7,No,0,19.32,1.28,-18.04,1402,446,-956,4059,397,-3662,2493.0,2986.0,493.0,69000.0,0.0,-69000.0
<a href=/player/johnj104>johnj104</a>,Jerry Johnson,San Diego Padres,PADRS,6,13,11,24,1977,1989,12,No,0,40.45,8.76,-31.69,3307,1362,-1945,10982,3847,-7135,2267.0,1127.0,-1140.0,475000.0,0.0,-475000.0
<a href=/player/johnj106>johnj106</a>,Johnny Johnston,Montgomery,Montgomery,1,3,2,5,1912,1913,1,No,0,-0.14,0.0,0.14,252,0,-252,843,0,-843,0.0,0.0,0.0,0.0,0.0,0.0
<a href=/player/johnj107>johnj107</a>,Jimmy Johnston,Brooklyn Dodgers,DOGRS,2,5,4,9,1925,1927,2,No,0,6.65,0.24,-6.41,787,339,-448,3022,1227,-1795,0.0,0.0,0.0,27500.0,0.0,-27500.0
<a href=/player/johnj107>johnj107</a>,Jimmy Johnston,Oakland,Oakland,1,1,3,4,1915,1916,1,No,0,17.76,0.0,-17.76,1266,0,-1266,5372,0,-5372,0.0,0.0,0.0,0.0,0.0,0.0
<a href=/player/johnk001>johnk001</a>,Keith Johns,St. Louis Cardinals,CARDS,1,1,1,2,1997,1998,1,No,0,0.0,0.0,0.0,0,0,0,0,0,0,0.0,0.0,0.0,0.0,0.0,0.0
<a href=/player/johnk001>johnk001</a>,Keith Johns,Baltimore Orioles,ORLS,1,1,1,2,1998,1998,0,No,0,0.01,0.0,-0.01,2,0,-2,1,0,-1,0.0,0.0,0.0,0.0,0.0,0.0
<a href=/player/johnk003>johnk003</a>,Kelly Johnson,Arizona Diamondbacks,DBACKS,3,8,6,14,2011,2019,8,Yes,0,33.46,18.13,-15.33,1227,834,-393,4470,3096,-1374,1784.0,544.0,-1240.0,8450000.0,0.0,-8450000.0
<a href=/player/johnk003>johnk003</a>,Kelly Johnson,New York Yankees,YANKS,1,1,2,3,2014,2015,1,No,0,-0.18,-0.66,-0.48,10,177,167,25,583,558,0.0,0.0,0.0,3000000.0,0.0,-3000000.0
<a href=/player/johnk003>johnk003</a>,Kelly Johnson,Boston Red Sox,RSOX,1,2,2,4,2014,2015,1,No,0,-0.08,0.24,0.32,19,17,-2,45,41,-4,0.0,0.0,0.0,0.0,0.0,0.0
<a href=/player/johnk003>johnk003</a>,Kelly Johnson,Atlanta Braves,BRAVES,5,11,7,18,2015,2021,6,Yes,0,3.57,1.27,-2.3,479,157,-322,663,322,-341,932.0,563.0,-369.0,21307500.0,0.0,-21307500.0
<a href=/player/johnk003>johnk003</a>,Kelly Johnson,Atlanta Braves,BRAVES,2,3,2,5,2016,2018,2,No,0,0.73,0.3,-0.43,92,16,-76,201,0,-201,42.0,22.0,-20.0,0.0,0.0,0.0
<a href=/player/johnk004>johnk004</a>,Kris Johnson,Pittsburgh Pirates,PIRATS,1,1,1,2,2013,2014,1,No,0,0.24,0.04,-0.2,4,2,-2,1,0,-1,40.0,4.0,-36.0,0.0,0.0,0.0
<a href=/player/johnk101>johnk101</a>,Ken Johnson,St. Louis Cardinals,CARDS,1,1,1,2,1950,1950,0,No,0,0.46,-0.3,-0.76,91,7,-84,57,23,-34,500.0,0.0,-500.0,0.0,0.0,0.0
<a href=/player/johnk102>johnk102</a>,Ken Johnson,Toronto,Toronto,1,1,2,3,1961,1961,0,No,0,1.5,0.0,-1.5,30,0,-30,26,0,-26,249.0,0.0,-249.0,0.0,0.0,0.0
<a href=/player/johnk102>johnk102</a>,Ken Johnson,Houston Astros,ASTROS,5,7,7,14,1965,1978,13,No,0,10.97,1.23,-9.74,645,1545,900,1174,5736,4562,2468.0,122.0,-2346.0,0.0,0.0,0.0
<a href=/player/johnl001>johnl001</a>,Lance Johnson,St. Louis Cardinals,CARDS,1,3,1,4,1988,1992,4,No,0,20.88,6.84,-14.04,997,319,-678,3820,320,-3500,328.0,2753.0,2425.0,0.0,0.0,0.0
<a href=/player/johnl001>johnl001</a>,Lance Johnson,New York Mets,METS,7,15,13,28,1997,2005,8,No,0,5.2,5.1,-0.1,1347,1947,600,1609,2988,1379,2422.0,1675.0,-747.0,19588333.0,0.0,-19588333.0
<a href=/player/johnl103>johnl103</a>,Larry Johnson,Cleveland Indians,INDINS,1,1,1,2,1975,1975,0,No,0,-0.14,0.0,0.14,7,0,-7,18,0,-18,0.0,0.0,0.0,0.0,0.0,0.0
<a href=/player/johnl103>johnl103</a>,Larry Johnson,Baltimore Orioles,ORLS,1,3,2,5,1980,1980,0,No,0,0.0,0.0,0.0,0,0,0,0,0,0,0.0,0.0,0.0,0.0,0.0,0.0
<a href=/player/johnl104>johnl104</a>,Lou Johnson,Chicago Cubs,CUBS,1,1,1,2,1961,1961,0,No,0,-0.49,0.03,0.52,68,11,-57,148,11,-137,0.0,0.0,0.0,0.0,0.0,0.0
<a href=/player/johnl104>johnl104</a>,Lou Johnson,Los Angeles Angels,ANGELS,3,3,5,8,1961,1970,9,No,0,4.21,10.03,5.82,770,881,111,2474,2911,437,542.0,509.0,-33.0,20000.0,0.0,-20000.0
<a href=/player/johnl104>johnl104</a>,Lou Johnson,Milwaukee Braves,BRAVES,2,3,3,6,1963,1963,0,No,0,-1.36,0.0,1.36,58,0,-58,157,0,-157,0.0,0.0,0.0,0.0,0.0,0.0
<a href=/player/johnl104>johnl104</a>,Lou Johnson,Detroit Tigers,TIGRS,2,3,2,5,1964,1967,3,No,0,5.69,-0.02,-5.71,445,329,-116,1466,94,-1372,122.0,751.0,629.0,29000.0,0.0,-29000.0
<a href=/player/johnl104>johnl104</a>,Lou Johnson,Los Angeles Dodgers,DOGRS,2,3,4,7,1967,1979,12,No,0,17.59,19.27,1.68,780,1426,646,2862,4558,1696,0.0,0.0,0.0,0.0,0.0,0.0
<a href=/player/johnl104>johnl104</a>,Lou Johnson,Chicago Cubs,CUBS,2,2,2,4,1968,1973,5,No,0,0.87,-0.38,-1.25,96,271,175,276,641,365,0.0,8.0,8.0,37250.0,0.0,-37250.0
<a href=/player/johnl104>johnl104</a>,Lou Johnson,Cleveland Indians,INDINS,1,1,1,2,1969,1972,3,No,0,-0.52,0.84,1.36,67,289,222,148,523,375,0.0,0.0,0.0,0.0,0.0,0.0
<a href=/player/johnm002>johnm002</a>,Mike Johnson,Baltimore Orioles,ORLS,1,1,1,2,1997,1998,1,No,0,-1.41,0.0,1.41,131,0,-131,49,0,-49,535.0,0.0,-535.0,150000.0,0.0,-150000.0
<a href=/player/johnm002>johnm002</a>,Mike Johnson,Montreal Expos,NATEX,1,1,1,2,2001,2002,1,No,0,0.0,0.24,0.24,0,55,55,0,0,0,0.0,79.0,79.0,220000.0,0.0,-220000.0
<a href=/player/johnm003>johnm003</a>,Mark Johnson,Chicago White Sox,WSOX,4,7,9,16,2002,2011,9,No,0,3.51,0.6,-2.91,386,338,-48,35,47,12,766.0,905.0,139.0,11095000.0,0.0,-11095000.0
<a href=/player/johnm003>johnm003</a>,Mark Johnson,Milwaukee Brewers,BREWRS,1,1,1,2,2005,2005,0,No,0,0.0,0.0,0.0,0,0,0,0,0,0,0.0,0.0,0.0,0.0,0.0,0.0
<a href=/player/johnm004>johnm004</a>,Mark Johnson,Houston Astros,ASTROS,1,3,1,4,1997,2001,4,No,0,-0.79,11.75,12.54,34,421,387,1,1777,1776,68.0,0.0,-68.0,0.0,0.0,0.0
<a href=/player/johnm004>johnm004</a>,Mark Johnson,Florida Marlins,MARLNS,8,17,20,37,1999,2019,20,Yes,0,61.77,64.47,2.7,1848,3278,1430,4569,10868,6299,8696.0,5082.0,-3614.0,29867000.0,0.0,-29867000.0
<a href=/player/johnm006>johnm006</a>,Micah Johnson,Chicago White Sox,WSOX,3,7,6,13,2015,2017,2,Yes,0,4.46,5.75,1.29,441,251,-190,564,1001,437,693.0,30.0,-663.0,12535000.0,0.0,-12535000.0
<a href=/player/johnm006>johnm006</a>,Micah Johnson,Los Angeles Dodgers,DOGRS,1,1,1,2,2017,2017,0,No,0,-0.13,0.0,0.13,18,0,-18,11,0,-11,0.0,0.0,0.0,0.0,0.0,0.0
<a href=/player/johnm101>johnm101</a>,Mike Johnson,Cincinnati Reds,REDS,2,4,2,6,1973,1979,6,No,1,1.85,11.84,9.99,285,462,177,593,484,-109,64.0,3945.0,3881.0,0.0,0.0,0.0
<a href=/player/johnn001>johnn001</a>,Nick Johnson,New York Yankees,YANKS,8,19,13,32,2003,2014,11,Yes,2,26.42,21.86,-4.56,2170,1008,-1162,5379,2872,-2507,5079.0,2402.0,-2677.0,1920525.0,0.0,-1920525.0
<a href=/player/johnn001>johnn001</a>,Nick Johnson,Washington Nationals,NATEX,1,1,1,2,2009,2010,1,No,0,0.35,0.0,-0.35,35,0,-35,150,0,-150,0.0,0.0,0.0,5500000.0,0.0,-5500000.0
<a href=/player/johnp102>johnp102</a>,Paul Johnson,Philadelphia Athletics,ATLTCS,1,5,1,6,1922,1929,7,No,0,0.0,12.22,12.22,0,592,592,0,2318,2318,0.0,0.0,0.0,0.0,0.0,0.0
<a href=/player/johnr001>johnr001</a>,Randy Johnson,New York Mets,METS,1,1,1,2,1980,1980,0,No,0,2.64,0.0,-2.64,204,0,-204,547,0,-547,0.0,0.0,0.0,0.0,0.0,0.0
<a href=/player/johnr002>johnr002</a>,Ron Johnson,Kansas City Royals,ROYALS,1,1,1,2,1983,1983,0,No,0,-0.07,0.0,0.07,5,0,-5,5,0,-5,0.0,0.0,0.0,0.0,0.0,0.0
<a href=/player/johnr005>johnr005</a>,Randy Johnson,Montreal Expos,NATEX,5,7,7,14,1989,2004,15,No,2,50.88,22.34,-28.54,1051,869,-182,465,3122,2657,8418.0,885.0,-7533.0,4247000.0,0.0,-4247000.0
<a href=/player/johnr005>johnr005</a>,Randy Johnson,Seattle Mariners,MARNRS,13,22,27,49,1998,2015,17,No,0,42.14,68.37,26.23,2664,3279,615,7392,9973,2581,3579.0,7754.0,4175.0,33402500.0,0.0,-33402500.0
<a href=/player/johnr005>johnr005</a>,Randy Johnson,Arizona Diamondbacks,DBACKS,13,27,23,50,2005,2018,13,Yes,2,20.41,35.37,14.96,1092,2994,1902,2224,8039,5815,4697.0,3744.0,-953.0,45113898.0,0.0,-45113898.0
<a href=/player/johnr005>johnr005</a>,Randy Johnson,New York Yankees,YANKS,6,12,11,23,2007,2014,7,Yes,2,11.06,11.89,0.83,1430,902,-528,2780,2853,73,3952.0,516.0,-3436.0,1556425.0,0.0,-1556425.0
<a href=/player/johnr006>johnr006</a>,Russ Johnson,Houston Astros,ASTROS,1,1,1,2,2000,2000,0,No,0,2.67,-0.29,-2.96,204,103,-101,633,3,-630,0.0,170.0,170.0,260000.0,0.0,-260000.0
<a href=/player/johnr006>johnr006</a>,Russ Johnson,Tampa Bay Devil Rays,RAYS,1,2,1,3,2002,2003,1,No,0,0.0,0.68,0.68,0,34,34,0,124,124,0.0,0.0,0.0,575000.0,0.0,-575000.0
<a href=/player/johnr008>johnr008</a>,Reed Johnson,Chicago Cubs,CUBS,3,5,4,9,2012,2018,6,Yes,0,5.31,1.57,-3.74,650,341,-309,761,587,-174,1181.0,55.0,-1126.0,2100000.0,0.0,-2100000.0
<a href=/player/johnr101>johnr101</a>,Randy Johnson,Chicago White Sox,WSOX,2,5,2,7,1981,1985,4,No,0,2.62,4.41,1.79,199,140,-59,397,1,-396,970.0,1329.0,359.0,0.0,0.0,0.0
<a href=/player/johnr101>johnr101</a>,Randy Johnson,Minnesota Twins,TWINS,1,2,1,3,1985,1985,0,No,0,0.0,0.99,0.99,0,129,129,0,452,452,0.0,0.0,0.0,0.0,0.0,0.0
<a href=/player/johnr102>johnr102</a>,Roy Johnson,SanFrancisco,SanFrancisco,1,1,2,3,1928,1928,0,No,0,6.88,0.0,-6.88,473,0,-473,2134,0,-2134,0.0,0.0,0.0,0.0,0.0,0.0
<a href=/player/johnr102>johnr102</a>,Roy Johnson,Detroit Tigers,TIGRS,1,2,1,3,1932,1933,1,No,0,12.96,0.98,-11.98,710,94,-616,2975,392,-2583,0.0,0.0,0.0,13000.0,0.0,-13000.0
<a href=/player/johnr102>johnr102</a>,Roy Johnson,Boston Red Sox,RSOX,1,2,1,3,1935,1936,1,No,0,0.2,-0.88,-1.08,89,82,-7,318,334,16,0.0,0.0,0.0,16500.0,0.0,-16500.0
<a href=/player/johnr102>johnr102</a>,Roy Johnson,Washington Senators,TWINS,1,2,2,4,1936,1939,3,No,0,4.55,1.79,-2.76,355,337,-18,541,641,100,2260.0,1980.0,-280.0,0.0,0.0,0.0
<a href=/player/johnr104>johnr104</a>,Rankin Johnson,Boston Red Sox,RSOX,23,51,62,113,1914,1937,23,No,0,210.47,131.21,-79.26,10024,6525,-3499,28339,20821,-7518,29017.0,15462.0,-13555.0,136800.0,0.0,-136800.0
<a href=/player/johnr104>johnr104</a>,Rankin Johnson,Milwaukee,Milwaukee,1,2,2,4,1918,1918,0,No,0,-0.15,0.0,0.15,31,0,-31,60,0,-60,69.0,0.0,-69.0,0.0,0.0,0.0
<a href=/player/johns001>johns001</a>,Steve Johnson,Los Angeles Dodgers,DOGRS,1,2,1,3,2009,2010,1,No,0,0.18,0.62,0.44,106,187,81,226,1,-225,178.0,192.0,14.0,0.0,0.0,0.0
<a href=/player/johns101>johns101</a>,Syl Johnson,Portland,Portland,4,6,14,20,1921,1926,5,No,0,21.37,0.0,-21.37,1173,0,-1173,3235,0,-3235,2921.0,0.0,-2921.0,0.0,0.0,0.0
<a href=/player/johns101>johns101</a>,Syl Johnson,St. Louis Cardinals,CARDS,1,2,1,3,1934,1934,0,No,0,0.4,0.0,-0.4,48,0,-48,141,0,-141,20.0,0.0,-20.0,0.0,0.0,0.0
<a href=/player/johns101>johns101</a>,Syl Johnson,Cincinnati Reds,REDS,2,4,4,8,1934,1937,3,No,0,22.67,0.0,-22.67,911,236,-675,2270,656,-1614,2379.0,321.0,-2058.0,0.0,0.0,0.0
<a href=/player/johns102>johns102</a>,Stan Johnson,Chicago White Sox,WSOX,11,17,21,38,1961,1969,8,No,0,15.81,27.33,11.52,1761,2250,489,3197,3489,292,3384.0,5251.0,1867.0,77750.0,0.0,-77750.0
<a href=/player/johns102>johns102</a>,Stan Johnson,Kansas City Athletics,ATLTCS,2,4,3,7,1961,1962,1,No,0,-0.07,-0.09,-0.02,40,20,-20,51,37,-14,0.0,0.0,0.0,0.0,0.0,0.0
<a href=/player/johns103>johns103</a>,Si Johnson,Cincinnati Reds,REDS,1,1,2,3,1936,1936,0,No,0,2.32,0.0,-2.32,112,0,-112,94,0,-94,807.0,0.0,-807.0,0.0,0.0,0.0
<a href=/player/johnt001>johnt001</a>,Tommy John,Cleveland Indians,INDINS,3,5,5,10,1965,1968,3,No,0,40.72,5.22,-35.5,1111,420,-691,2880,1615,-1265,4479.0,0.0,-4479.0,0.0,0.0,0.0
<a href=/player/johnt001>johnt001</a>,Tommy John,Chicago White Sox,WSOX,3,5,4,9,1971,1979,8,No,0,21.05,19.98,-1.07,765,568,-197,1638,2032,394,4047.0,189.0,-3858.0,258750.0,0.0,-258750.0
<a href=/player/johnt001>johnt001</a>,Tommy John,New York Yankees,YANKS,2,4,2,6,1982,1985,3,No,0,8.6,1.45,-7.15,321,20,-301,270,0,-270,3508.0,301.0,-3207.0,0.0,0.0,0.0
<a href=/player/johnt102>johnt102</a>,Tim Johnson,Los Angeles Dodgers,DOGRS,1,1,1,2,1973,1973,0,No,0,-0.26,0.0,0.26,405,0,-405,1220,0,-1220,0.0,0.0,0.0,0.0,0.0,0.0
<a href=/player/johnt102>johnt102</a>,Tim Johnson,Milwaukee Brewers,BREWRS,1,1,1,2,1978,1978,0,No,0,-0.35,-0.01,0.34,111,2,-109,188,8,-180,0.0,0.0,0.0,92500.0,0.0,-92500.0
<a href=/player/johnv101>johnv101</a>,Vic Johnson,Boston Red Sox,RSOX,1,2,1,3,1945,1947,2,No,0,-0.72,-0.36,0.36,18,42,24,1,44,43,41.0,320.0,279.0,4000.0,0.0,-4000.0
<a href=/player/johnw001>johnw001</a>,Wallace Johnson,Montreal Expos,NATEX,1,1,1,2,1983,1984,1,No,0,-0.17,0.56,0.73,7,34,27,8,62,54,0.0,0.0,0.0,0.0,0.0,0.0
<a href=/player/joinr101>joinr101</a>,Roy Joiner,Oakland,Oakland,1,1,1,2,1934,1934,0,No,0,-1.23,0.0,1.23,44,0,-44,11,0,-11,112.0,0.0,-112.0,0.0,0.0,0.0
<a href=/player/jok-s101>jok-s101</a>,Stan Jok,St. Louis Cardinals,CARDS,1,2,1,3,1956,1956,0,No,0,0.0,0.0,0.0,0,0,0,0,0,0,0.0,0.0,0.0,0.0,0.0,0.0
<a href=/player/jokie001>jokie001</a>,Eric Jokisch,Miami Marlins,MARLNS,1,1,1,2,2016,2016,0,No,0,0.0,0.0,0.0,0,0,0,0,0,0,0.0,0.0,0.0,0.0,0.0,0.0
<a href=/player/jolls101>jolls101</a>,Smead Jolley,Chicago White Sox,WSOX,3,8,5,13,1932,1935,3,No,0,3.4,4.58,1.18,902,283,-619,3430,766,-2664,0.0,735.0,735.0,34500.0,0.0,-34500.0
<a href=/player/jolls101>jolls101</a>,Smead Jolley,Boston Red Sox,RSOX,2,5,2,7,1933,1936,3,No,0,13.03,1.41,-11.62,347,273,-74,502,1053,551,1631.0,0.0,-1631.0,28000.0,0.0,-28000.0
<a href=/player/jolls101>jolls101</a>,Smead Jolley,St.Louis Browns,ORLS,14,27,34,61,1933,1952,19,No,0,55.71,57.94,2.23,2756,6888,4132,8050,21355,13305,6789.0,12669.0,5880.0,138000.0,0.0,-138000.0
<a href=/player/jolls101>jolls101</a>,Smead Jolley,SanFrancisco,SanFrancisco,1,1,2,3,1929,1931,2,No,0,2.5,0.0,-2.5,218,0,-218,816,0,-816,0.0,0.0,0.0,0.0,0.0,0.0
<a href=/player/jonea001>jonea001</a>,Al Jones,Chicago White Sox,WSOX,1,2,1,3,1986,1988,2,No,0,0.0,1.98,1.98,0,87,87,0,0,0,0.0,254.0,254.0,0.0,0.0,0.0
<a href=/player/jonea003>jonea003</a>,Adam Jones,Seattle Mariners,MARNRS,4,9,5,14,2008,2013,5,No,0,43.53,3.71,-39.82,1975,169,-1806,6859,413,-6446,3908.0,766.0,-3142.0,1000000.0,0.0,-1000000.0
<a href=/player/joneb002>joneb002</a>,Barry Jones,Pittsburgh Pirates,PIRATS,2,2,2,4,1988,1996,8,No,1,3.06,-0.32,-3.38,110,64,-46,0,39,39,413.0,377.0,-36.0,90000.0,0.0,-90000.0
<a href=/player/joneb002>joneb002</a>,Barry Jones,Chicago White Sox,WSOX,2,3,4,7,1990,1996,6,No,0,7.45,16.61,9.16,578,648,70,1665,2873,1208,266.0,0.0,-266.0,4830000.0,0.0,-4830000.0
<a href=/player/joneb002>joneb002</a>,Barry Jones,Montreal Expos,NATEX,4,6,7,13,1991,2015,24,No,4,-0.02,40.54,40.56,305,1802,1497,756,5962,5206,189.0,3282.0,3093.0,4270000.0,0.0,-4270000.0
<a href=/player/joneb004>joneb004</a>,Bobby Jones,Colorado Rockies,ROCKS,1,2,1,3,2000,2001,1,No,0,0.11,1.15,1.04,43,56,13,4,64,60,116.0,502.0,386.0,0.0,0.0,0.0
<a href=/player/joneb004>joneb004</a>,Bobby Jones,New York Mets,METS,1,3,2,5,2002,2003,1,No,0,0.08,0.83,0.75,11,64,53,13,7,-6,29.0,147.0,118.0,0.0,0.0,0.0
<a href=/player/joneb103>joneb103</a>,Bob Jones,Detroit Tigers,TIGRS,2,6,2,8,1925,1928,3,No,0,0.0,1.07,1.07,0,324,324,0,1271,1271,0.0,0.0,0.0,0.0,0.0,0.0
<a href=/player/joneb104>joneb104</a>,Binky Jones,Brooklyn Dodgers,DOGRS,3,7,5,12,1924,1927,3,No,0,6.65,3.39,-3.26,787,606,-181,3022,2382,-640,0.0,0.0,0.0,32500.0,0.0,-32500.0
<a href=/player/jonec002>jonec002</a>,Chris Jones,Arizona Diamondbacks,DBACKS,1,1,1,2,1998,1998,0,No,0,-0.44,-0.22,0.22,43,4,-39,100,0,-100,0.0,2.0,2.0,450000.0,0.0,-450000.0
<a href=/player/jonec103>jonec103</a>,Clarence Jones,Chicago Cubs,CUBS,3,5,3,8,1969,1974,5,No,0,-2.15,0.81,2.96,445,387,-58,1077,715,-362,55.0,283.0,228.0,0.0,0.0,0.0
<a href=/player/jonec106>jonec106</a>,Charlie Jones,Washington Senators,TWINS,1,1,1,2,1907,1907,0,No,0,0.21,0.0,-0.21,74,0,-74,280,0,-280,0.0,0.0,0.0,0.0,0.0,0.0
<a href=/player/joned001>joned001</a>,Doug Jones,Houston Astros,ASTROS,1,2,1,3,1993,1994,1,No,0,2.36,-0.93,-3.29,132,50,-82,33,0,-33,433.0,60.0,-373.0,2609000.0,0.0,-2609000.0
<a href=/player/joned001>joned001</a>,Doug Jones,Milwaukee Brewers,BREWRS,1,1,1,2,1998,1999,1,No,0,0.68,0.36,-0.32,23,184,161,0,2,2,94.0,321.0,227.0,2500000.0,0.0,-2500000.0
<a href=/player/joned102>joned102</a>,Dalton Jones,Boston Red Sox,RSOX,3,3,3,6,1969,1972,3,No,0,0.07,-1.67,-1.74,251,147,-104,562,234,-328,0.0,0.0,0.0,22000.0,0.0,-22000.0
<a href=/player/joned102>joned102</a>,Dalton Jones,Detroit Tigers,TIGRS,3,6,3,9,1972,1975,3,No,0,-1.05,-0.55,0.5,169,196,27,357,508,151,4.0,0.0,-4.0,118300.0,0.0,-118300.0
<a href=/player/joneg002>joneg002</a>,Garrett Jones,Miami Marlins,MARLNS,2,4,7,11,2014,2019,5,Yes,0,6.27,8.73,2.46,210,736,526,177,1879,1702,1889.0,737.0,-1152.0,7867000.0,0.0,-7867000.0
<a href=/player/joneg101>joneg101</a>,Gordon Jones,San Francisco Giants,GIANTS,5,9,7,16,1959,1968,9,No,0,13.15,7.42,-5.73,1312,848,-464,3499,1107,-2392,1130.0,3244.0,2114.0,43000.0,0.0,-43000.0
<a href=/player/joneg101>joneg101</a>,Gordon Jones,St. Louis Cardinals,CARDS,19,44,38,82,1956,1972,16,No,0,56.42,67.4,10.98,5645,3260,-2385,13530,9157,-4373,6309.0,6165.0,-144.0,120500.0,0.0,-120500.0
<a href=/player/joneg102>joneg102</a>,Gary Jones,New York Yankees,YANKS,1,2,1,3,1971,1973,2,No,0,0.0,0.67,0.67,0,101,101,0,310,310,0.0,0.0,0.0,4800.0,0.0,-4800.0
<a href=/player/joneg102>joneg102</a>,Gary Jones,Texas Rangers,RNGRS,15,34,23,57,1971,1988,17,No,0,48.57,49.18,0.61,3015,3170,155,9911,9907,-4,4375.0,6620.0,2245.0,528000.0,0.0,-528000.0
<a href=/player/joneh001>joneh001</a>,Hunter Jones,Boston Red Sox,RSOX,1,2,1,3,2009,2010,1,No,0,0.08,-0.48,-0.56,6,52,46,0,171,171,5.0,0.0,-5.0,400000.0,0.0,-400000.0
<a href=/player/jonej002>jonej002</a>,Jimmy Jones,San Diego Padres,PADRS,2,4,3,7,1988,1992,4,No,1,-2.09,7.62,9.71,105,399,294,12,1044,1032,593.0,270.0,-323.0,375000.0,0.0,-375000.0
<a href=/player/jonej003>jonej003</a>,Jacque Jones,Chicago Cubs,CUBS,4,7,7,14,2007,2013,6,No,0,20.06,0.88,-19.18,1518,347,-1171,4246,61,-4185,895.0,926.0,31.0,6938333.0,0.0,-6938333.0
<a href=/player/jonej005>jonej005</a>,James Jones,Seattle Mariners,MARNRS,2,5,3,8,2015,2017,2,No,0,-1.06,0.95,2.01,37,177,140,16,698,682,66.0,0.0,-66.0,6250000.0,0.0,-6250000.0
<a href=/player/jonej006>jonej006</a>,JaCoby Jones,Pittsburgh Pirates,PIRATS,1,1,1,2,2015,2015,0,No,0,1.1,0.73,-0.37,352,58,-294,1195,0,-1195,0.0,80.0,80.0,0.0,0.0,0.0
<a href=/player/jonej007>jonej007</a>,Jahmai Jones,Anaheim Angels,ANGELS,1,1,2,3,2021,2021,0,No,0,-0.62,1.73,2.35,26,19,-7,72,1,-71,0.0,280.0,280.0,0.0,0.0,0.0
<a href=/player/jonej104>jonej104</a>,Johnny Jones,New York Giants,GIANTS,1,5,1,6,1919,1926,7,No,0,8.66,14.34,5.68,964,460,-504,2314,555,-1759,3291.0,4306.0,1015.0,5412.0,0.0,-5412.0
<a href=/player/jonej106>jonej106</a>,Jake Jones,Chicago White Sox,WSOX,1,1,1,2,1947,1948,1,No,0,-0.67,0.58,1.25,145,102,-43,567,438,-129,0.0,0.0,0.0,0.0,0.0,0.0
<a href=/player/jonem102>jonem102</a>,Mack Jones,Atlanta Braves,BRAVES,1,3,1,4,1967,1968,1,No,0,0.5,-0.77,-1.27,233,127,-106,406,383,-23,170.0,0.0,-170.0,0.0,0.0,0.0
<a href=/player/jonen001>jonen001</a>,Nate Jones,Chicago White Sox,WSOX,1,2,2,4,2019,2019,0,Yes,0,0.0,0.0,0.0,0,0,0,0,0,0,0.0,0.0,0.0,4650000.0,0.0,-4650000.0
<a href=/player/joneo001>joneo001</a>,Odell Jones,Pittsburgh Pirates,PIRATS,1,3,3,6,1978,1978,0,No,0,-3.43,0.0,3.43,296,0,-296,706,0,-706,404.0,0.0,-404.0,0.0,0.0,0.0
<a href=/player/joneo001>joneo001</a>,Odell Jones,Seattle Mariners,MARNRS,1,1,2,3,1980,1983,3,No,0,0.88,0.54,-0.34,26,81,55,13,0,-13,163.0,442.0,279.0,0.0,0.0,0.0
<a href=/player/jonep101>jonep101</a>,Percy Jones,Chicago Cubs,CUBS,1,6,1,7,1928,1932,4,No,0,4.13,16.12,11.99,1036,317,-719,2232,1321,-911,4216.0,0.0,-4216.0,13000.0,0.0,-13000.0
<a href=/player/jonep101>jonep101</a>,Percy Jones,Boston Braves,BRAVES,11,26,18,44,1930,1952,22,No,0,35.11,93.56,58.45,2190,4270,2080,6855,14689,7834,3053.0,6551.0,3498.0,20000.0,0.0,-20000.0
<a href=/player/jonep101>jonep101</a>,Percy Jones,Chicago Cubs,CUBS,1,2,2,4,1923,1931,8,No,0,0.0,12.05,12.05,0,628,628,0,625,625,0.0,5104.0,5104.0,3400.0,0.0,-3400.0
<a href=/player/joner001>joner001</a>,Ross Jones,Los Angeles Dodgers,DOGRS,1,2,2,4,1983,1986,3,No,0,29.07,1.25,-27.82,528,343,-185,590,279,-311,4754.0,437.0,-4317.0,0.0,0.0,0.0
<a href=/player/joner001>joner001</a>,Ross Jones,Seattle Mariners,MARNRS,1,1,1,2,1987,1987,0,No,0,0.06,0.0,-0.06,39,0,-39,124,0,-124,0.0,0.0,0.0,0.0,0.0,0.0
<a href=/player/joner002>joner002</a>,Ruppert Jones,Seattle Mariners,MARNRS,6,10,11,21,1979,1995,16,No,1,7.87,12.43,4.56,602,1155,553,1044,2694,1650,1952.0,3686.0,1734.0,982500.0,0.0,-982500.0
<a href=/player/joner002>joner002</a>,Ruppert Jones,New York Yankees,YANKS,6,13,11,24,1981,1992,11,No,0,27.03,19.65,-7.38,2401,1053,-1348,5956,3510,-2446,5438.0,699.0,-4739.0,913333.0,0.0,-913333.0
<a href=/player/joner101>joner101</a>,Randy Jones,San Diego Padres,PADRS,6,11,12,23,1980,1989,9,No,1,29.59,15.28,-14.31,2622,1243,-1379,8550,2493,-6057,2464.0,4252.0,1788.0,0.0,0.0,0.0
<a href=/player/joner102>joner102</a>,Rick Jones,Seattle Mariners,MARNRS,5,14,13,27,1978,1985,7,No,0,13.7,0.35,-13.35,1053,894,-159,693,2333,1640,4377.0,1863.0,-2514.0,175000.0,0.0,-175000.0
<a href=/player/jones101>jones101</a>,Steve Jones,Chicago White Sox,WSOX,4,7,7,14,1968,1971,3,No,0,11.44,1.3,-10.14,1683,516,-1167,5097,1341,-3756,666.0,366.0,-300.0,31000.0,0.0,-31000.0
<a href=/player/jones102>jones102</a>,Sherman Jones,San Francisco Giants,GIANTS,9,17,13,30,1961,1972,11,No,0,22.69,19.49,-3.2,2066,1611,-455,6411,2790,-3621,1334.0,4789.0,3455.0,50000.0,0.0,-50000.0
<a href=/player/jones103>jones103</a>,Sheldon Jones,New York Giants,GIANTS,1,2,1,3,1952,1952,0,No,0,-0.49,0.18,0.67,78,98,20,9,313,304,210.0,0.0,-210.0,0.0,0.0,0.0
<a href=/player/jones103>jones103</a>,Sheldon Jones,Milwaukee Braves,BRAVES,1,1,1,2,1952,1952,0,No,0,0.45,0.0,-0.45,44,0,-44,7,0,-7,118.0,0.0,-118.0,0.0,0.0,0.0
<a href=/player/jones104>jones104</a>,Sad Sam Jones,Cleveland Indians,INDINS,1,3,1,4,1916,1927,11,No,0,11.98,74.79,62.81,369,1519,1150,563,6634,6071,3136.0,0.0,-3136.0,0.0,0.0,0.0
<a href=/player/jones104>jones104</a>,Sad Sam Jones,Boston Red Sox,RSOX,10,21,30,51,1921,1937,16,No,0,73.06,40.4,-32.66,4195,2010,-2185,13395,5364,-8031,9458.0,7949.0,-1509.0,78550.0,0.0,-78550.0
<a href=/player/jones104>jones104</a>,Sad Sam Jones,New York Yankees,YANKS,2,3,3,6,1927,1946,19,No,0,0.65,54.93,54.28,164,1328,1164,395,2127,1732,569.0,9587.0,9018.0,6000.0,0.0,-6000.0
<a href=/player/jones104>jones104</a>,Sad Sam Jones,St.Louis Browns,ORLS,3,4,4,8,1927,1935,8,No,0,11.48,6.16,-5.32,387,744,357,418,523,105,3166.0,4550.0,1384.0,22500.0,0.0,-22500.0
<a href=/player/jones104>jones104</a>,Sad Sam Jones,Washington Senators,TWINS,4,9,7,16,1931,1936,5,No,0,40.86,14.39,-26.47,2483,840,-1643,9607,2965,-6642,2547.0,1249.0,-1298.0,62500.0,0.0,-62500.0
<a href=/player/jones105>jones105</a>,Sam Jones,Cleveland Indians,INDINS,1,3,1,4,1954,1955,1,No,0,4.04,0.12,-3.92,157,113,-44,207,390,183,1291.0,0.0,-1291.0,0.0,0.0,0.0
<a href=/player/jones105>jones105</a>,Sam Jones,Chicago Cubs,CUBS,5,10,9,19,1956,1965,9,No,0,7.39,7.94,0.55,637,1087,450,1408,195,-1213,1395.0,2758.0,1363.0,0.0,0.0,0.0
<a href=/player/jones105>jones105</a>,Sam Jones,St. Louis Cardinals,CARDS,12,25,21,46,1959,1972,13,No,0,38.14,29.59,-8.55,3497,1794,-1703,8651,6077,-2574,3788.0,703.0,-3085.0,32500.0,0.0,-32500.0
<a href=/player/jones105>jones105</a>,Sam Jones,Houston Astros,ASTROS,5,7,10,17,1961,1973,12,No,0,1.0,10.72,9.72,370,1119,749,287,875,588,788.0,4740.0,3952.0,57500.0,0.0,-57500.0
<a href=/player/jonet001>jonet001</a>,Tracy Jones,Cincinnati Reds,REDS,1,2,3,5,1988,1992,4,No,0,0.54,1.86,1.32,53,699,646,157,1778,1621,0.0,41.0,41.0,157500.0,0.0,-157500.0
<a href=/player/jonet001>jonet001</a>,Tracy Jones,Montreal Expos,NATEX,1,1,1,2,1988,1991,3,No,0,-0.71,0.6,1.31,40,172,132,103,359,256,0.0,0.0,0.0,0.0,0.0,0.0
<a href=/player/jonet001>jonet001</a>,Tracy Jones,San Francisco Giants,GIANTS,1,1,1,2,1989,1989,0,No,0,-0.45,0.59,1.04,96,70,-26,307,175,-132,0.0,0.0,0.0,300000.0,0.0,-300000.0
<a href=/player/jonet001>jonet001</a>,Tracy Jones,Detroit Tigers,TIGRS,1,1,1,2,1990,1990,0,No,0,0.55,-0.86,-1.41,104,52,-52,289,122,-167,0.0,0.0,0.0,375000.0,0.0,-375000.0
<a href=/player/jonet003>jonet003</a>,Todd Jones,Houston Astros,ASTROS,6,12,18,30,1996,2004,8,No,0,25.8,6.98,-18.82,2221,1542,-679,3937,2959,-978,4263.0,3434.0,-829.0,7155000.0,0.0,-7155000.0
<a href=/player/jonet003>jonet003</a>,Todd Jones,Detroit Tigers,TIGRS,2,3,4,7,2001,2010,9,No,0,3.25,8.31,5.06,81,301,220,66,28,-38,630.0,4456.0,3826.0,3975000.0,0.0,-3975000.0
<a href=/player/jonet003>jonet003</a>,Todd Jones,Cincinnati Reds,REDS,1,2,2,4,2004,2006,2,No,0,-0.03,0.46,0.49,53,65,12,1,87,86,76.0,206.0,130.0,500000.0,0.0,-500000.0
<a href=/player/jonet004>jonet004</a>,Terry Jones,Colorado Rockies,ROCKS,14,25,26,51,1997,2003,6,No,0,21.69,15.75,-5.94,2403,1893,-510,1976,1038,-938,5980.0,2902.0,-3078.0,24071314.0,0.0,-24071314.0
<a href=/player/jonet101>jonet101</a>,Timothy Jones,Pittsburgh Pirates,PIRATS,1,1,1,2,1978,1978,0,No,0,0.0,-0.68,-0.68,0,12,12,0,0,0,0.0,26.0,26.0,0.0,0.0,0.0
<a href=/player/jonet103>jonet103</a>,Tom Jones,St.Louis Browns,ORLS,1,1,1,2,1909,1909,0,No,0,1.69,-0.1,-1.79,179,2,-177,677,8,-669,0.0,0.0,0.0,0.0,0.0,0.0
<a href=/player/jonew101>jonew101</a>,Willie Jones,Philadelphia Phillies,PHILS,1,1,2,3,1959,1960,1,No,0,0.28,-0.93,-1.21,11,35,24,19,52,33,0.0,0.0,0.0,0.0,0.0,0.0
<a href=/player/jonnb101>jonnb101</a>,Bubber Jonnard,Philadelphia Phillies,PHILS,1,3,2,5,1927,1929,2,No,0,-0.72,-1.19,-0.47,18,135,117,33,192,159,0.0,529.0,529.0,8850.0,0.0,-8850.0
<a href=/player/jonnc101>jonnc101</a>,Claude Jonnard,St.Louis Browns,ORLS,21,42,49,91,1926,1952,26,No,0,96.01,107.81,11.8,5218,9406,4188,17109,30707,13598,8613.0,15510.0,6897.0,200300.0,0.0,-200300.0
<a href=/player/joose101>joose101</a>,Eddie Joost,Cincinnati Reds,REDS,5,8,7,15,1942,1958,16,No,0,10.73,21.22,10.49,1014,1434,420,2886,5138,2252,2587.0,1210.0,-1377.0,0.0,0.0,0.0
<a href=/player/joose101>joose101</a>,Eddie Joost,Boston Braves,BRAVES,4,10,6,16,1946,1952,6,No,0,11.92,12.47,0.55,840,753,-87,2908,2363,-545,0.0,414.0,414.0,0.0,0.0,0.0
<a href=/player/joose101>joose101</a>,Eddie Joost,St. Louis Cardinals,CARDS,1,1,4,5,1946,1946,0,No,0,26.76,0.0,-26.76,917,0,-917,4210,0,-4210,0.0,0.0,0.0,0.0,0.0,0.0
<a href=/player/jordb001>jordb001</a>,Brian Jordan,Atlanta Braves,BRAVES,1,3,1,4,2002,2003,1,No,0,12.57,11.23,-1.34,452,290,-162,1035,1257,222,2316.0,0.0,-2316.0,0.0,0.0,0.0
<a href=/player/jordb101>jordb101</a>,Buck Jordan,Baltimore,Baltimore,1,1,3,4,1932,1934,2,No,0,10.04,0.0,-10.04,601,0,-601,2506,0,-2506,0.0,0.0,0.0,0.0,0.0,0.0
<a href=/player/jordb101>jordb101</a>,Buck Jordan,Cincinnati Reds,REDS,2,2,2,4,1938,1938,0,No,0,0.84,0.72,-0.12,87,46,-41,330,125,-205,0.0,0.0,0.0,0.0,0.0,0.0
<a href=/player/jordb101>jordb101</a>,Buck Jordan,Washington Senators,TWINS,1,5,1,6,1931,1939,8,No,0,0.0,8.51,8.51,0,385,385,0,407,407,0.0,3095.0,3095.0,6500.0,0.0,-6500.0
<a href=/player/jordj101>jordj101</a>,Jimmy Jordan,Brooklyn Dodgers,DOGRS,1,3,1,4,1936,1938,2,No,0,0.05,-0.59,-0.64,177,153,-24,491,535,44,0.0,3.0,3.0,0.0,0.0,0.0
<a href=/player/jordk001>jordk001</a>,Kevin Jordan,New York Yankees,YANKS,1,3,2,5,1994,1995,1,No,0,-1.6,-0.95,0.65,666,27,-639,1569,0,-1569,587.0,372.0,-215.0,0.0,0.0,0.0
<a href=/player/jordn101>jordn101</a>,Niles Jordan,Philadelphia Phillies,PHILS,3,8,7,15,1951,1957,6,No,0,12.59,16.8,4.21,922,1010,88,2813,3409,596,109.0,186.0,77.0,63000.0,0.0,-63000.0
<a href=/player/jordr002>jordr002</a>,Ricardo Jordan,Toronto Blue Jays,BJAYS,2,4,3,7,1995,2002,7,No,0,7.82,10.52,2.7,990,426,-564,2406,2,-2404,537.0,1768.0,1231.0,1909000.0,0.0,-1909000.0
<a href=/player/jordr002>jordr002</a>,Ricardo Jordan,Philadelphia Phillies,PHILS,1,2,1,3,1996,2000,4,No,0,-0.52,-2.87,-2.35,69,496,427,2,2022,2020,121.0,0.0,-121.0,284000.0,0.0,-284000.0
<a href=/player/jordt102>jordt102</a>,Tom Jordan,Chicago White Sox,WSOX,1,1,1,2,1946,1947,1,No,0,-0.14,-0.41,-0.27,14,53,39,38,211,173,0.0,0.0,0.0,4800.0,0.0,-4800.0
<a href=/player/jorgm001>jorgm001</a>,Mike Jorgensen,New York Mets,METS,2,5,3,8,1972,1979,7,No,0,27.3,7.07,-20.23,2407,595,-1812,9387,2358,-7029,284.0,578.0,294.0,110000.0,0.0,-110000.0
<a href=/player/jorgm001>jorgm001</a>,Mike Jorgensen,Montreal Expos,NATEX,1,1,1,2,1977,1982,5,No,0,0.77,0.19,-0.58,66,408,342,236,97,-139,0.0,1311.0,1311.0,0.0,0.0,0.0
<a href=/player/jorgm001>jorgm001</a>,Mike Jorgensen,Texas Rangers,RNGRS,8,16,17,33,1979,1987,8,No,0,13.69,12.82,-0.87,1524,510,-1014,3006,820,-2186,5064.0,3278.0,-1786.0,1017500.0,0.0,-1017500.0
<a href=/player/jorgm001>jorgm001</a>,Mike Jorgensen,Atlanta Braves,BRAVES,2,4,2,6,1984,1992,8,No,0,2.53,5.32,2.79,820,917,97,385,3026,2641,1122.0,0.0,-1122.0,725000.0,0.0,-725000.0
<a href=/player/jorgr001>jorgr001</a>,Ryan Jorgensen,Chicago Cubs,CUBS,2,5,3,8,2002,2004,2,No,1,19.76,10.92,-8.84,396,427,31,455,211,-244,3529.0,2185.0,-1344.0,0.0,0.0,0.0
<a href=/player/jorgr001>jorgr001</a>,Ryan Jorgensen,Florida Marlins,MARLNS,1,1,1,2,2006,2006,0,No,0,0.06,0.0,-0.06,4,0,-4,15,0,-15,0.0,0.0,0.0,0.0,0.0,0.0
<a href=/player/jorgs101>jorgs101</a>,Spider Jorgensen,New York Giants,GIANTS,1,2,1,3,1951,1951,0,No,0,0.0,0.0,0.0,0,13,13,0,13,13,0.0,0.0,0.0,0.0,0.0,0.0
<a href=/player/josed001>josed001</a>,Donnie Joseph,Cincinnati Reds,REDS,2,3,3,6,2012,2018,6,Yes,0,-0.39,1.45,1.84,105,280,175,0,4,4,160.0,420.0,260.0,0.0,0.0,0.0
<a href=/player/josed101>josed101</a>,Duane Josephson,Chicago White Sox,WSOX,5,7,6,13,1971,1976,5,No,0,-2.36,0.03,2.39,667,792,125,1044,1819,775,489.0,881.0,392.0,27000.0,0.0,-27000.0
<a href=/player/josef001>josef001</a>,Felix Jose,Oakland Athletics,ATLTCS,2,4,3,7,1990,1991,1,No,2,4.87,0.81,-4.06,395,29,-366,1429,123,-1306,0.0,0.0,0.0,102500.0,0.0,-102500.0
<a href=/player/josef001>josef001</a>,Felix Jose,St. Louis Cardinals,CARDS,2,3,4,7,1993,1994,1,No,2,0.21,6.98,6.77,278,245,-33,1031,1059,28,0.0,0.0,0.0,0.0,0.0,0.0
<a href=/player/josek001>josek001</a>,Kevin Joseph,San Francisco Giants,GIANTS,2,3,3,6,2001,2005,4,No,0,0.04,0.48,0.44,34,363,329,0,0,0,44.0,378.0,334.0,1050000.0,0.0,-1050000.0
<a href=/player/josek001>josek001</a>,Kevin Joseph,St. Louis Cardinals,CARDS,1,1,1,2,2003,2003,0,No,0,0.0,0.0,0.0,0,0,0,0,0,0,0.0,0.0,0.0,0.0,0.0,0.0
<a href=/player/joser101>joser101</a>,Rick Joseph,Philadelphia Phillies,PHILS,1,1,1,2,1971,1973,2,No,0,0.0,-0.5,-0.5,0,260,260,0,40,40,0.0,731.0,731.0,0.0,0.0,0.0
<a href=/player/joset001>joset001</a>,Tommy Joseph,San Francisco Giants,GIANTS,1,3,1,4,2012,2018,6,No,0,-0.86,10.45,11.31,288,772,484,953,3095,2142,6.0,0.0,-6.0,1300000.0,0.0,-1300000.0
<a href=/player/joycb101>joycb101</a>,Bill Joyce,Brooklyn Dodgers,DOGRS,1,2,1,3,1893,1894,1,No,0,12.66,-0.67,-13.33,307,54,-253,1444,222,-1222,0.0,0.0,0.0,0.0,0.0,0.0
<a href=/player/joycb101>joycb101</a>,Bill Joyce,Washington Senators,WSN,2,3,7,10,1896,1905,9,No,0,20.57,5.74,-14.83,1039,340,-699,4306,1120,-3186,0.0,695.0,695.0,0.0,0.0,0.0
<a href=/player/joycb102>joycb102</a>,Bob Joyce,Oakland,Oakland,2,2,5,7,1938,1949,11,No,0,-0.94,0.0,0.94,88,0,-88,40,0,-40,403.0,0.0,-403.0,0.0,0.0,0.0
<a href=/player/joycb102>joycb102</a>,Bob Joyce,Philadelphia Athletics,ATLTCS,1,4,1,5,1939,1939,0,No,0,0.0,0.0,0.0,0,0,0,0,0,0,0.0,0.0,0.0,3000.0,0.0,-3000.0
<a href=/player/joycm001>joycm001</a>,Matt Joyce,Detroit Tigers,TIGRS,5,8,10,18,2008,2021,13,Yes,0,14.09,56.93,42.84,881,1465,584,2989,3036,47,687.0,7099.0,6412.0,35445000.0,0.0,-35445000.0
<a href=/player/joycm001>joycm001</a>,Matt Joyce,Tampa Bay Devil Rays,RAYS,3,3,4,7,2014,2018,4,Yes,0,-0.12,0.91,1.03,156,63,-93,284,0,-284,176.0,194.0,18.0,6725000.0,0.0,-6725000.0
<a href=/player/joynw001>joynw001</a>,Wally Joyner,Kansas City Royals,ROYALS,2,3,3,6,1995,1997,2,No,0,9.23,2.06,-7.17,520,188,-332,2004,744,-1260,0.0,6.0,6.0,6750000.0,0.0,-6750000.0
<a href=/player/joynw001>joynw001</a>,Wally Joyner,San Diego Padres,PADRS,2,4,4,8,1999,2006,7,No,1,3.54,15.79,12.25,377,961,584,1296,3858,2562,0.0,4.0,4.0,8651680.0,0.0,-8651680.0
<a href=/player/juddm001>juddm001</a>,Mike Judd,New York Yankees,YANKS,1,1,1,2,1996,1996,0,No,0,-0.91,-0.11,0.8,32,4,-28,13,0,-13,138.0,17.0,-121.0,0.0,0.0,0.0
<a href=/player/juddr101>juddr101</a>,Ralph Judd,New York Giants,GIANTS,1,1,1,2,1930,1932,2,No,0,0.0,1.22,1.22,0,118,118,0,137,137,0.0,1047.0,1047.0,0.0,0.0,0.0
<a href=/player/judef101>judef101</a>,Frank Jude,Toledo,Toledo,1,1,2,3,1906,1909,3,No,0,-1.63,0.0,1.63,80,0,-80,329,0,-329,0.0,0.0,0.0,0.0,0.0,0.0
<a href=/player/judej001>judej001</a>,Jeff Juden,Houston Astros,ASTROS,1,2,1,3,1993,1994,1,No,0,2.36,-0.93,-3.29,132,50,-82,33,0,-33,433.0,60.0,-373.0,2609000.0,0.0,-2609000.0
<a href=/player/judej001>judej001</a>,Jeff Juden,Philadelphia Phillies,PHILS,1,2,1,3,1995,1996,1,No,0,-0.14,0.66,0.8,72,35,-37,3,118,115,125.0,0.0,-125.0,109000.0,0.0,-109000.0
<a href=/player/judej001>judej001</a>,Jeff Juden,Montreal Expos,NATEX,2,3,3,6,1997,2003,6,No,0,5.12,0.05,-5.07,706,898,192,77,840,763,1502.0,1243.0,-259.0,4173333.0,0.0,-4173333.0
<a href=/player/judej001>judej001</a>,Jeff Juden,Cleveland Indians,INDINS,5,7,8,15,1997,2003,6,No,0,-0.44,6.0,6.44,740,264,-476,1919,1,-1918,857.0,949.0,92.0,9150000.0,0.0,-9150000.0
<a href=/player/judnw101>judnw101</a>,Wally Judnich,St.Louis Browns,ORLS,6,12,14,26,1947,1960,13,No,0,15.93,14.55,-1.38,866,1429,563,1976,4545,2569,2508.0,1208.0,-1300.0,30000.0,0.0,-30000.0
<a href=/player/judsh101>judsh101</a>,Howie Judson,Chicago White Sox,WSOX,1,1,1,2,1952,1954,2,No,0,0.91,-0.02,-0.93,94,8,-86,38,18,-20,396.0,0.0,-396.0,0.0,0.0,0.0
<a href=/player/julij001>julij001</a>,Jorge Julio,Montreal Expos,NATEX,1,1,1,2,2000,2001,1,No,0,1.36,-1.41,-2.77,297,55,-242,0,107,107,875.0,0.0,-875.0,0.0,0.0,0.0
<a href=/player/julij001>julij001</a>,Jorge Julio,Baltimore Orioles,ORLS,1,2,1,3,2006,2007,1,No,0,4.49,1.83,-2.66,234,33,-201,209,9,-200,1690.0,549.0,-1141.0,0.0,0.0,0.0
<a href=/player/julij001>julij001</a>,Jorge Julio,New York Mets,METS,1,1,1,2,2006,2008,2,No,0,0.73,3.94,3.21,85,92,7,0,94,94,134.0,793.0,659.0,2525000.0,0.0,-2525000.0
<a href=/player/julij001>julij001</a>,Jorge Julio,Arizona Diamondbacks,DBACKS,1,2,1,3,2007,2009,2,No,0,-0.9,0.21,1.11,20,112,92,1,61,60,28.0,609.0,581.0,0.0,0.0,0.0
<a href=/player/julij001>julij001</a>,Jorge Julio,Florida Marlins,MARLNS,1,1,1,2,2007,2007,0,No,0,0.73,-0.15,-0.88,112,44,-68,1,39,38,158.0,329.0,171.0,3600000.0,0.0,-3600000.0
<a href=/player/junge001>junge001</a>,Eric Junge,Los Angeles Dodgers,DOGRS,1,2,1,3,2001,2002,1,No,0,0.34,1.59,1.25,20,77,57,3,48,45,61.0,484.0,423.0,0.0,0.0,0.0
<a href=/player/junkj001>junkj001</a>,Janson Junk,New York Yankees,YANKS,1,2,2,4,2021,2021,0,No,0,-0.41,-0.59,-0.18,7,14,7,0,1,1,56.0,107.0,51.0,0.0,0.0,0.0
<a href=/player/juraa001>juraa001</a>,Ariel Jurado,Texas Rangers,RNGRS,1,1,1,2,2020,2020,0,Yes,0,-0.17,0.0,0.17,1,0,-1,0,0,0,12.0,0.0,-12.0,0.0,0.0,0.0
<a href=/player/jurgb101>jurgb101</a>,Billy Jurges,Chicago Cubs,CUBS,4,7,6,13,1938,1943,5,No,0,18.58,4.9,-13.68,1563,631,-932,5453,2299,-3154,405.0,0.0,-405.0,33000.0,0.0,-33000.0
<a href=/player/jurrj001>jurrj001</a>,Jair Jurrjens,Detroit Tigers,TIGRS,1,2,1,3,2007,2008,1,No,0,10.42,1.11,-9.31,243,138,-105,269,547,278,2160.0,0.0,-2160.0,0.0,0.0,0.0
<a href=/player/jurrj001>jurrj001</a>,Jair Jurrjens,Cincinnati Reds,REDS,1,1,1,2,2014,2014,0,Yes,0,-0.36,0.0,0.36,4,0,-4,2,0,-2,28.0,0.0,-28.0,0.0,0.0,0.0
<a href=/player/justd001>justd001</a>,David Justice,Atlanta Braves,BRAVES,5,9,8,17,1997,2005,8,No,2,61.71,16.74,-44.97,2122,677,-1445,3848,1491,-2357,9346.0,423.0,-8923.0,4543000.0,0.0,-4543000.0
<a href=/player/justd001>justd001</a>,David Justice,Cleveland Indians,INDINS,9,11,15,26,2000,2020,20,Yes,2,28.78,61.83,33.05,1957,1761,-196,6639,3446,-3193,2696.0,8442.0,5746.0,35404400.0,0.0,-35404400.0
<a href=/player/justd001>justd001</a>,David Justice,New York Yankees,YANKS,5,7,7,14,2001,2013,12,Yes,1,-0.94,18.37,19.31,321,1351,1030,352,3939,3587,235.0,682.0,447.0,14420923.0,0.0,-14420923.0
<a href=/player/justd001>justd001</a>,David Justice,New York Mets,METS,1,1,2,3,2001,2005,4,No,0,1.64,0.66,-0.98,118,175,57,471,14,-457,0.0,284.0,284.0,0.0,0.0,0.0
<a href=/player/jutzs101>jutzs101</a>,Skip Jutze,St. Louis Cardinals,CARDS,3,4,4,8,1972,1975,3,No,0,-4.47,-0.62,3.85,305,37,-268,783,86,-697,0.0,0.0,0.0,0.0,0.0,0.0
<a href=/player/jutzs101>jutzs101</a>,Skip Jutze,Houston Astros,ASTROS,1,1,2,3,1977,1977,0,No,0,-0.35,0.0,0.35,42,0,-42,118,0,-118,0.0,0.0,0.0,0.0,0.0,0.0
<a href=/player/juulh102>juulh102</a>,Herb Juul,Cincinnati Reds,REDS,1,2,1,3,1911,1911,0,No,0,0.0,0.0,0.0,0,0,0,0,0,0,0.0,0.0,0.0,0.0,0.0,0.0
<a href=/player/kaaik001>kaaik001</a>,Kila Ka'aihue,Kansas City Royals,ROYALS,1,1,1,2,2011,2011,0,No,0,-0.16,0.0,0.16,39,0,-39,139,0,-139,0.0,0.0,0.0,419000.0,0.0,-419000.0
<a href=/player/kaatj101>kaatj101</a>,Jim Kaat,Chicago White Sox,WSOX,7,11,11,22,1975,1985,10,No,1,16.3,6.76,-9.54,1220,1148,-72,3180,4231,1051,3148.0,16.0,-3132.0,0.0,0.0,0.0
<a href=/player/kahnt001>kahnt001</a>,Tommy Kahnle,Colorado Rockies,ROCKS,1,1,1,2,2015,2021,6,No,0,1.61,-0.06,-1.67,71,201,130,0,9,9,190.0,372.0,182.0,0.0,0.0,0.0
<a href=/player/kahnt001>kahnt001</a>,Tommy Kahnle,Chicago White Sox,WSOX,2,4,5,9,2017,2017,0,Yes,0,4.16,0.5,-3.66,327,12,-315,241,0,-241,693.0,30.0,-663.0,12535000.0,0.0,-12535000.0
<a href=/player/kahom101>kahom101</a>,Mike Kahoe,Indianapolis,Indianapolis,2,2,4,6,1905,1913,8,No,0,0.26,0.0,-0.26,51,0,-51,167,0,-167,0.0,0.0,0.0,0.0,0.0,0.0
<a href=/player/kaisa101>kaisa101</a>,Al Kaiser,Chicago Cubs,CUBS,3,6,7,13,1911,1916,5,No,0,-3.91,1.45,5.36,376,507,131,960,1665,705,899.0,27.0,-872.0,4500.0,0.0,-4500.0
<a href=/player/kaisd101>kaisd101</a>,Don Kaiser,Chicago Cubs,CUBS,11,20,17,37,1957,1977,20,No,0,15.71,44.12,28.41,1386,3941,2555,1236,10815,9579,4659.0,6233.0,1574.0,122500.0,0.0,-122500.0
<a href=/player/kaisd101>kaisd101</a>,Don Kaiser,Milwaukee Braves,BRAVES,1,3,2,5,1959,1961,2,No,0,-0.44,0.34,0.78,224,49,-175,615,163,-452,0.0,0.0,0.0,0.0,0.0,0.0
<a href=/player/kaisj001>kaisj001</a>,Jeff Kaiser,Oakland Athletics,ATLTCS,1,1,1,2,1987,1987,0,No,0,-0.28,0.0,0.28,16,0,-16,0,0,0,67.0,0.0,-67.0,0.0,0.0,0.0
<a href=/player/kallr101>kallr101</a>,Rudy Kallio,SaltLakeCity,SaltLakeCity,1,1,2,3,1924,1924,0,No,0,-0.35,0.0,0.35,14,0,-14,6,0,-6,54.0,0.0,-54.0,0.0,0.0,0.0
<a href=/player/kamir001>kamir001</a>,Rob Kaminsky,St. Louis Cardinals,CARDS,1,1,1,2,2015,2016,1,No,0,0.0,0.63,0.63,0,179,179,0,615,615,0.0,0.0,0.0,0.0,0.0,0.0
<a href=/player/kammw101>kammw101</a>,Willie Kamm,SanFrancisco,SanFrancisco,1,1,4,5,1922,1930,8,No,0,27.12,0.0,-27.12,1171,0,-1171,4851,0,-4851,0.0,0.0,0.0,0.0,0.0,0.0
<a href=/player/kammw101>kammw101</a>,Willie Kamm,Chicago White Sox,WSOX,1,1,1,2,1931,1931,0,No,0,8.34,1.31,-7.03,522,121,-401,2094,509,-1585,0.0,0.0,0.0,11500.0,0.0,-11500.0
<a href=/player/kampa101>kampa101</a>,Alex Kampouris,Sacramento,Sacramento,1,1,1,2,1934,1934,0,No,0,2.63,0.0,-2.63,456,0,-456,1617,0,-1617,0.0,0.0,0.0,0.0,0.0,0.0
<a href=/player/kampa101>kampa101</a>,Alex Kampouris,Cincinnati Reds,REDS,1,1,1,2,1938,1940,2,No,0,2.04,3.71,1.67,156,198,42,536,814,278,0.0,0.0,0.0,0.0,0.0,0.0
<a href=/player/kampa101>kampa101</a>,Alex Kampouris,New York Giants,GIANTS,3,10,6,16,1939,1954,15,No,0,0.0,7.09,7.09,0,765,765,0,2631,2631,0.0,172.0,172.0,6000.0,0.0,-6000.0
<a href=/player/kanej103>kanej103</a>,John Kane,Cincinnati Reds,REDS,2,2,4,6,1909,1911,2,No,0,-0.83,3.31,4.14,53,471,418,129,1598,1469,0.0,0.0,0.0,0.0,0.0,0.0
<a href=/player/kanet101>kanet101</a>,Tom Kane,Boston Braves,BRAVES,1,1,1,2,1938,1938,0,No,0,0.0,-0.94,-0.94,0,28,28,0,79,79,0.0,0.0,0.0,0.0,0.0,0.0
<a href=/player/kaplg001>kaplg001</a>,Gabe Kapler,Detroit Tigers,TIGRS,3,8,6,14,1999,2006,7,No,2,20.76,5.57,-15.19,1380,450,-930,3548,496,-3052,1196.0,1028.0,-168.0,1937500.0,0.0,-1937500.0
<a href=/player/kaplg001>kaplg001</a>,Gabe Kapler,Texas Rangers,RNGRS,1,3,2,5,2002,2002,0,No,0,0.5,-0.12,-0.62,97,54,-43,245,149,-96,0.0,127.0,127.0,1850000.0,0.0,-1850000.0
<a href=/player/kaprj001>kaprj001</a>,James Kaprielian,New York Yankees,YANKS,4,8,7,15,2017,2021,4,No,0,10.37,1.61,-8.76,335,144,-191,733,363,-370,1504.0,587.0,-917.0,0.0,0.0,0.0
<a href=/player/karcm001>karcm001</a>,Matt Karchner,Chicago White Sox,WSOX,7,14,12,26,1998,2018,20,Yes,2,37.48,28.79,-8.69,1767,873,-894,4806,2144,-2662,3045.0,5135.0,2090.0,23335000.0,0.0,-23335000.0
<a href=/player/kardp101>kardp101</a>,Paul Kardow,Cleveland Indians,INDINS,1,3,1,4,1937,1938,1,No,0,0.0,0.0,0.0,0,0,0,0,0,0,0.0,0.0,0.0,0.0,0.0,0.0
<a href=/player/karge101>karge101</a>,Ed Karger,Pittsburgh Pirates,PIRATS,1,1,1,2,1906,1906,0,No,0,7.3,0.33,-6.97,174,12,-162,246,13,-233,1929.0,102.0,-1827.0,0.0,0.0,0.0
<a href=/player/karge101>karge101</a>,Ed Karger,St. Louis Cardinals,CARDS,2,5,2,7,1908,1912,4,No,0,24.55,10.02,-14.53,1473,290,-1183,4275,993,-3282,4114.0,10.0,-4104.0,0.0,0.0,0.0
<a href=/player/karge101>karge101</a>,Ed Karger,StPaul,StPaul,1,2,3,5,1909,1910,1,No,0,12.24,0.0,-12.24,441,0,-441,478,0,-478,3240.0,0.0,-3240.0,0.0,0.0,0.0
<a href=/player/karla101>karla101</a>,Andy Karl,Philadelphia Phillies,PHILS,1,1,1,2,1947,1948,1,No,0,0.26,-0.21,-0.47,54,111,57,6,254,248,105.0,0.0,-105.0,0.0,0.0,0.0
<a href=/player/karla101>karla101</a>,Andy Karl,Philadelphia Phillies,PHILS,2,4,2,6,1943,1949,6,No,0,23.82,3.95,-19.87,519,273,-246,570,454,-116,4467.0,1587.0,-2880.0,0.0,0.0,0.0
<a href=/player/karlb101>karlb101</a>,Bill Karlon,New York Yankees,YANKS,1,2,1,3,1931,1931,0,No,0,0.0,0.0,0.0,0,0,0,0,0,0,0.0,0.0,0.0,0.0,0.0,0.0
<a href=/player/karls001>karls001</a>,Scott Karl,Milwaukee Brewers,BREWRS,4,7,8,15,1999,2003,4,No,0,6.3,0.97,-5.33,590,668,78,2079,1251,-828,242.0,2859.0,2617.0,10900000.0,0.0,-10900000.0
<a href=/player/karnj001>karnj001</a>,Jason Karnuth,St. Louis Cardinals,CARDS,1,2,1,3,2002,2003,1,No,0,0.0,-0.52,-0.52,0,153,153,0,10,10,0.0,287.0,287.0,0.0,0.0,0.0
<a href=/player/karnn001>karnn001</a>,Nathan Karns,Washington Nationals,NATEX,2,3,4,7,2014,2017,3,Yes,0,9.42,1.79,-7.63,467,445,-22,8,658,650,1175.0,383.0,-792.0,0.0,0.0,0.0
<a href=/player/karnn001>karnn001</a>,Nathan Karns,Tampa Bay Devil Rays,RAYS,2,5,4,9,2015,2018,3,Yes,0,-0.11,7.04,7.15,74,689,615,124,2370,2246,283.0,211.0,-72.0,508800.0,0.0,-508800.0
<a href=/player/karnn001>karnn001</a>,Nathan Karns,Seattle Mariners,MARNRS,1,1,1,2,2017,2017,0,No,0,1.04,2.72,1.68,9,111,102,0,390,390,136.0,0.0,-136.0,0.0,0.0,0.0
<a href=/player/karpr001>karpr001</a>,Ryan Karp,New York Yankees,YANKS,1,3,2,5,1994,1995,1,No,0,-1.6,-0.95,0.65,666,27,-639,1569,0,-1569,587.0,372.0,-215.0,0.0,0.0,0.0
<a href=/player/karre001>karre001</a>,Eric Karros,Los Angeles Dodgers,DOGRS,1,2,2,4,2002,2004,2,No,0,2.3,-0.13,-2.43,316,32,-284,1174,68,-1106,0.0,0.0,0.0,11875000.0,0.0,-11875000.0
<a href=/player/karsj001>karsj001</a>,Jeff Karstens,New York Yankees,YANKS,1,4,2,6,2008,2011,3,No,0,7.23,0.52,-6.71,1088,146,-942,2084,276,-1808,3210.0,148.0,-3062.0,391425.0,0.0,-391425.0
<a href=/player/karss001>karss001</a>,Steve Karsay,Toronto Blue Jays,BJAYS,1,2,1,3,1993,1993,0,No,0,1.73,0.5,-1.23,187,44,-143,423,203,-220,657.0,0.0,-657.0,0.0,0.0,0.0
<a href=/player/karss001>karss001</a>,Steve Karsay,Oakland Athletics,ATLTCS,1,1,1,2,1997,1998,1,No,0,6.31,0.56,-5.75,172,54,-118,1,0,-1,669.0,142.0,-527.0,160000.0,0.0,-160000.0
<a href=/player/karss001>karss001</a>,Steve Karsay,Cleveland Indians,INDINS,2,3,3,6,2001,2003,2,No,0,-0.19,-0.02,0.17,198,59,-139,2,0,-2,300.0,180.0,-120.0,4300000.0,0.0,-4300000.0
<a href=/player/kaske101>kaske101</a>,Eddie Kasko,St. Louis Cardinals,CARDS,2,5,5,10,1958,1963,5,No,0,8.1,2.95,-5.15,969,458,-511,3320,993,-2327,89.0,111.0,22.0,0.0,0.0,0.0
<a href=/player/kaske101>kaske101</a>,Eddie Kasko,Cincinnati Reds,REDS,1,1,3,4,1964,1966,2,No,0,1.74,-0.13,-1.87,201,8,-193,727,0,-727,0.0,15.0,15.0,0.0,0.0,0.0
<a href=/player/kaske101>kaske101</a>,Eddie Kasko,Houston Astros,ASTROS,1,1,1,2,1966,1966,0,No,0,1.0,0.02,-0.98,58,77,19,152,167,15,0.0,0.0,0.0,0.0,0.0,0.0
<a href=/player/katam001>katam001</a>,Matt Kata,Arizona Diamondbacks,DBACKS,4,6,7,13,2005,2009,4,No,2,-0.26,0.09,0.35,148,108,-40,119,188,69,459.0,95.0,-364.0,732000.0,0.0,-732000.0
<a href=/player/kattr101>kattr101</a>,Ray Katt,St. Louis Cardinals,CARDS,15,35,30,65,1956,1972,16,No,0,38.58,60.99,22.41,4144,2647,-1497,9926,7589,-2337,4766.0,5429.0,663.0,32500.0,0.0,-32500.0
<a href=/player/kattr101>kattr101</a>,Ray Katt,Chicago Cubs,CUBS,1,2,2,4,1957,1958,1,No,0,0.97,-1.1,-2.07,265,105,-160,781,34,-747,0.0,197.0,197.0,0.0,0.0,0.0
<a href=/player/kattr101>kattr101</a>,Ray Katt,San Francisco Giants,GIANTS,1,1,1,2,1958,1958,0,No,0,-0.09,0.21,0.3,34,34,0,72,66,-6,0.0,0.0,0.0,0.0,0.0,0.0
<a href=/player/kattr101>kattr101</a>,Ray Katt,New York Giants,GIANTS,11,22,22,44,1956,1968,12,No,0,37.88,26.25,-11.63,3162,2563,-599,10326,4535,-5791,1384.0,7539.0,6155.0,95000.0,0.0,-95000.0
<a href=/player/kaufb101>kaufb101</a>,Benny Kauff,New York Giants,GIANTS,2,7,2,9,1920,1924,4,No,0,0.0,-1.2,-1.2,0,134,134,0,318,318,0.0,0.0,0.0,1500.0,0.0,-1500.0
<a href=/player/kaufc001>kaufc001</a>,Curt Kaufman,New York Yankees,YANKS,4,9,6,15,1983,1989,6,No,0,23.12,1.13,-21.99,1636,314,-1322,6240,852,-5388,207.0,0.0,-207.0,2062000.0,0.0,-2062000.0
<a href=/player/kaufd101>kaufd101</a>,Dick Kauffman,St.Louis Browns,ORLS,1,3,1,4,1915,1917,2,No,0,0.0,-0.08,-0.08,0,17,17,0,34,34,0.0,0.0,0.0,1800.0,0.0,-1800.0
<a href=/player/kauft101>kauft101</a>,Tony Kaufmann,Chicago Cubs,CUBS,1,2,1,3,1927,1927,0,No,0,-0.69,2.92,3.61,89,54,-35,289,70,-219,56.0,552.0,496.0,15500.0,0.0,-15500.0
<a href=/player/kavam101>kavam101</a>,Marty Kavanagh,St. Louis Cardinals,CARDS,1,4,1,5,1918,1918,0,No,0,0.0,0.57,0.57,0,80,80,0,312,312,0.0,0.0,0.0,0.0,0.0,0.0
<a href=/player/kay-a001>kay-a001</a>,Anthony Kay,New York Mets,METS,1,2,2,4,2019,2021,2,No,0,0.01,4.89,4.88,27,85,58,0,81,81,206.0,716.0,510.0,0.0,0.0,0.0
<a href=/player/kay-b101>kay-b101</a>,Bill Kay,Newark,Newark,1,2,2,4,1912,1912,0,No,0,-0.4,0.0,0.4,214,0,-214,788,0,-788,0.0,0.0,0.0,0.0,0.0,0.0
<a href=/player/kazae101>kazae101</a>,Eddie Kazak,St. Louis Cardinals,CARDS,2,5,3,8,1952,1954,2,No,0,-0.48,0.45,0.93,72,246,174,232,797,565,0.0,0.0,0.0,0.0,0.0,0.0
<a href=/player/kazat101>kazat101</a>,Ted Kazanski,Philadelphia Phillies,PHILS,9,18,19,37,1959,1979,20,No,0,39.51,86.58,47.07,2824,3643,819,7602,10419,2817,7676.0,11796.0,4120.0,74500.0,0.0,-74500.0
<a href=/player/kazat101>kazat101</a>,Ted Kazanski,Milwaukee Braves,BRAVES,1,1,1,2,1963,1964,1,No,0,0.0,0.0,0.0,0,0,0,0,0,0,0.0,0.0,0.0,0.0,0.0,0.0
<a href=/player/kazms001>kazms001</a>,Scott Kazmir,New York Mets,METS,1,2,2,4,2004,2006,2,No,0,16.49,0.86,-15.63,150,111,-39,8,71,63,2502.0,670.0,-1832.0,0.0,0.0,0.0
<a href=/player/kazms001>kazms001</a>,Scott Kazmir,Tampa Bay Devil Rays,RAYS,8,10,15,25,2009,2020,11,Yes,0,0.67,24.11,23.44,1050,1424,374,1555,3505,1950,1448.0,1779.0,331.0,9633000.0,0.0,-9633000.0
<a href=/player/kazms001>kazms001</a>,Scott Kazmir,Oakland Athletics,ATLTCS,3,6,6,12,2015,2021,6,Yes,0,0.34,9.52,9.18,161,880,719,447,3251,2804,220.0,908.0,688.0,0.0,0.0,0.0
<a href=/player/kazms001>kazms001</a>,Scott Kazmir,Los Angeles Dodgers,DOGRS,4,17,9,26,2017,2021,4,Yes,0,6.07,9.48,3.41,927,279,-648,2727,1007,-1720,545.0,229.0,-316.0,71371000.0,0.0,-71371000.0
<a href=/player/keagg001>keagg001</a>,Greg Keagle,San Diego Padres,PADRS,7,16,15,31,1995,2006,11,No,1,8.74,38.72,29.98,1384,2329,945,3649,8703,5054,1217.0,136.0,-1081.0,12941680.0,0.0,-12941680.0
<a href=/player/keals101>keals101</a>,Steve Kealey,California Angels,ANGELS,4,9,9,18,1971,1976,5,No,0,0.53,5.03,4.5,382,668,286,431,1911,1480,1134.0,244.0,-890.0,35000.0,0.0,-35000.0
<a href=/player/keals101>keals101</a>,Steve Kealey,Chicago White Sox,WSOX,1,1,1,2,1973,1974,1,No,0,0.0,0.33,0.33,0,5,5,0,0,0,0.0,55.0,55.0,0.0,0.0,0.0
<a href=/player/keara001>keara001</a>,Austin Kearns,Cincinnati Reds,REDS,1,3,5,8,2006,2012,6,No,0,0.43,-0.61,-1.04,795,705,-90,2860,181,-2679,139.0,809.0,670.0,4550000.0,0.0,-4550000.0
<a href=/player/keara001>keara001</a>,Austin Kearns,Cleveland Indians,INDINS,1,1,1,2,2010,2018,8,No,0,-0.03,2.96,2.99,36,296,260,119,6,-113,0.0,1765.0,1765.0,750000.0,0.0,-750000.0
<a href=/player/kearb001>kearb001</a>,Bob Kearney,Oakland Athletics,ATLTCS,5,10,9,19,1983,1994,11,No,0,10.8,21.09,10.29,1624,930,-694,3370,2503,-867,1865.0,4119.0,2254.0,1837653.0,0.0,-1837653.0
<a href=/player/keatc101>keatc101</a>,Chick Keating,Brooklyn Dodgers,DOGRS,1,2,1,3,1913,1913,0,No,0,1.78,0.0,-1.78,159,0,-159,149,0,-149,886.0,0.0,-886.0,0.0,0.0,0.0
<a href=/player/keatg101>keatg101</a>,Greg Keatley,Chicago Cubs,CUBS,1,1,1,2,1981,1981,0,No,0,0.0,0.0,0.0,2,0,-2,0,0,0,0.0,0.0,0.0,0.0,0.0,0.0
<a href=/player/keefd101>keefd101</a>,Dave Keefe,Philadelphia Athletics,ATLTCS,1,5,1,6,1922,1929,7,No,0,0.0,12.22,12.22,0,592,592,0,2318,2318,0.0,0.0,0.0,0.0,0.0,0.0
<a href=/player/keelw101>keelw101</a>,Willie Keeler,Brooklyn Dodgers,DOGRS,1,2,2,4,1894,1896,2,No,0,29.72,4.69,-25.03,772,328,-444,3764,1481,-2283,0.0,0.0,0.0,0.0,0.0,0.0
<a href=/player/keenv101>keenv101</a>,Vic Keen,Chicago Cubs,CUBS,2,3,2,5,1925,1927,2,No,0,-1.87,4.93,6.8,183,228,45,350,777,427,614.0,552.0,-62.0,22500.0,0.0,-22500.0
<a href=/player/keesj101>keesj101</a>,Jim Keesey,Portland,Portland,1,1,1,2,1929,1929,0,No,0,-0.03,0.0,0.03,11,0,-11,13,0,-13,0.0,0.0,0.0,0.0,0.0,0.0
<a href=/player/keetr101>keetr101</a>,Rickey Keeton,Milwaukee Brewers,BREWRS,1,1,1,2,1981,1985,4,No,0,0.0,0.18,0.18,0,144,144,0,0,0,0.0,612.0,612.0,0.0,0.0,0.0
<a href=/player/keisb101>keisb101</a>,Bill Keister,Philadelphia Phillies,PHILS,1,1,1,2,1904,1904,0,No,0,0.0,0.0,0.0,0,0,0,0,0,0,0.0,0.0,0.0,0.0,0.0,0.0
<a href=/player/kekim101>kekim101</a>,Mike Kekich,Los Angeles Dodgers,DOGRS,2,2,2,4,1968,1977,9,No,0,-1.33,4.8,6.13,343,534,191,483,989,506,1691.0,2693.0,1002.0,0.0,0.0,0.0
<a href=/player/kekim101>kekim101</a>,Mike Kekich,New York Yankees,YANKS,1,1,1,2,1973,1974,1,No,0,-1.15,0.0,1.15,19,0,-19,0,0,0,150.0,0.0,-150.0,0.0,0.0,0.0
<a href=/player/kelak001>kelak001</a>,Keone Kela,Texas Rangers,RNGRS,1,1,2,3,2018,2018,0,Yes,0,1.6,0.0,-1.6,95,0,-95,0,0,0,141.0,0.0,-141.0,1200000.0,0.0,-1200000.0
<a href=/player/kelej001>kelej001</a>,Jarred Kelenic,New York Mets,METS,1,5,3,8,2018,2018,0,Yes,0,-0.49,0.0,0.49,191,0,-191,565,0,-565,376.0,0.0,-376.0,16500000.0,0.0,-16500000.0
<a href=/player/kella103>kella103</a>,Alex Kellner,Cincinnati Reds,REDS,3,5,8,13,1958,1966,8,No,0,5.3,5.9,0.6,751,639,-112,1876,2223,347,111.0,126.0,15.0,0.0,0.0,0.0
<a href=/player/kellb001>kellb001</a>,Bryan Kelly,Detroit Tigers,TIGRS,2,2,2,4,1987,1988,1,No,0,-0.18,0.0,0.18,11,0,-11,0,0,0,36.0,0.0,-36.0,0.0,0.0,0.0
<a href=/player/kellb002>kellb002</a>,Roberto Kelly,New York Yankees,YANKS,1,1,2,3,1992,2001,9,No,0,2.46,26.68,24.22,125,1254,1129,538,5368,4830,0.0,0.0,0.0,2150000.0,0.0,-2150000.0
<a href=/player/kellb002>kellb002</a>,Roberto Kelly,Cincinnati Reds,REDS,6,13,8,21,1994,2010,16,No,0,11.82,27.11,15.29,501,1515,1014,1009,5387,4378,2595.0,2089.0,-506.0,16400000.0,0.0,-16400000.0
<a href=/player/kellb002>kellb002</a>,Roberto Kelly,Atlanta Braves,BRAVES,6,12,9,21,1995,2005,10,No,2,61.82,22.45,-39.37,2272,974,-1298,4447,2820,-1627,9346.0,423.0,-8923.0,4543000.0,0.0,-4543000.0
<a href=/player/kellb002>kellb002</a>,Roberto Kelly,Montreal Expos,NATEX,3,4,4,8,1995,2000,5,No,0,2.32,1.96,-0.36,552,545,-7,1710,1297,-413,362.0,850.0,488.0,2625000.0,0.0,-2625000.0
<a href=/player/kellb002>kellb002</a>,Roberto Kelly,Minnesota Twins,TWINS,1,1,2,3,1997,2005,8,No,0,1.1,10.83,9.73,30,203,173,129,21,-108,0.0,2839.0,2839.0,750000.0,0.0,-750000.0
<a href=/player/kellb003>kellb003</a>,Brad Keller,Cincinnati Reds,REDS,1,1,1,2,2017,2017,0,No,0,8.15,0.0,-8.15,113,0,-113,20,0,-20,1482.0,0.0,-1482.0,0.0,0.0,0.0
<a href=/player/kellb102>kellb102</a>,Bill Kelly,Philadelphia Phillies,PHILS,5,9,9,18,1928,1940,12,No,0,39.18,41.3,2.12,1904,2696,792,7415,9869,2454,0.0,0.0,0.0,21000.0,0.0,-21000.0
<a href=/player/kellb103>kellb103</a>,Bob Kelly,Chicago Cubs,CUBS,4,9,6,15,1953,1961,8,No,0,2.91,2.3,-0.61,226,408,182,136,878,742,1159.0,691.0,-468.0,0.0,0.0,0.0
<a href=/player/kellb103>kellb103</a>,Bob Kelly,Cincinnati Reds,REDS,1,1,1,2,1958,1958,0,No,0,-0.16,-0.03,0.13,26,3,-23,5,1,-4,83.0,0.0,-83.0,0.0,0.0,0.0
<a href=/player/kellc001>kellc001</a>,Casey Kelly,Boston Red Sox,RSOX,8,26,15,41,2010,2019,9,Yes,0,35.43,29.06,-6.37,2876,1721,-1155,5076,5808,732,4841.0,1908.0,-2933.0,4708000.0,0.0,-4708000.0
<a href=/player/kellc001>kellc001</a>,Casey Kelly,San Diego Padres,PADRS,1,2,1,3,2015,2017,2,No,0,-0.36,-0.48,-0.12,20,87,67,3,211,208,65.0,16.0,-49.0,0.0,0.0,0.0
<a href=/player/kellc002>kellc002</a>,Carson Kelly,St. Louis Cardinals,CARDS,1,4,1,5,2018,2018,0,Yes,0,4.82,0.0,-4.82,382,0,-382,1034,0,-1034,549.0,0.0,-549.0,550800.0,0.0,-550800.0
<a href=/player/kellf102>kellf102</a>,Frank Kellert,Baltimore Orioles,ORLS,2,4,2,6,1955,1961,6,No,0,0.69,2.14,1.45,39,125,86,91,93,2,0.0,858.0,858.0,0.0,0.0,0.0
<a href=/player/kellf102>kellf102</a>,Frank Kellert,Chicago Cubs,CUBS,4,7,5,12,1957,1961,4,No,0,8.16,6.1,-2.06,620,391,-229,633,654,21,802.0,646.0,-156.0,0.0,0.0,0.0
<a href=/player/kellf102>kellf102</a>,Frank Kellert,Baltimore Orioles,ORLS,1,2,3,5,1959,1959,0,No,0,0.0,0.0,0.0,0,0,0,0,0,0,0.0,0.0,0.0,0.0,0.0,0.0
<a href=/player/kellf103>kellf103</a>,Frankie Kelleher,New York Yankees,YANKS,1,1,3,4,1942,1942,0,No,0,-0.16,0.25,0.41,47,10,-37,140,1,-139,0.0,21.0,21.0,0.0,0.0,0.0
<a href=/player/kellg101>kellg101</a>,High Pockets Kelly,New York Giants,GIANTS,1,2,1,3,1927,1931,4,No,0,3.25,2.72,-0.53,375,301,-74,1523,1302,-221,0.0,0.0,0.0,0.0,0.0,0.0
<a href=/player/kellg101>kellg101</a>,High Pockets Kelly,Minneapolis,Minneapolis,1,1,2,3,1930,1930,0,No,0,0.38,0.0,-0.38,39,0,-39,178,0,-178,0.0,0.0,0.0,0.0,0.0,0.0
<a href=/player/kellg101>kellg101</a>,High Pockets Kelly,Minneapolis,Minneapolis,1,1,1,2,1932,1932,0,No,0,-0.36,0.0,0.36,64,0,-64,226,0,-226,0.0,0.0,0.0,0.0,0.0,0.0
<a href=/player/kellg102>kellg102</a>,George Kell,Philadelphia Athletics,ATLTCS,1,1,1,2,1946,1951,5,No,0,23.18,8.66,-14.52,826,442,-384,3735,1820,-1915,0.0,0.0,0.0,8500.0,0.0,-8500.0
<a href=/player/kellg102>kellg102</a>,George Kell,Detroit Tigers,TIGRS,18,41,43,84,1952,1964,12,No,0,49.33,53.4,4.07,4601,4657,56,11266,12496,1230,8483.0,9258.0,775.0,157700.0,0.0,-157700.0
<a href=/player/kellg102>kellg102</a>,George Kell,Boston Red Sox,RSOX,1,1,2,3,1954,1956,2,No,0,3.37,3.06,-0.31,220,230,10,856,836,-20,0.0,0.0,0.0,40000.0,0.0,-40000.0
<a href=/player/kellg102>kellg102</a>,George Kell,Chicago White Sox,WSOX,2,5,3,8,1956,1961,5,No,0,20.82,6.19,-14.63,1000,561,-439,2990,1443,-1547,2136.0,479.0,-1657.0,62000.0,0.0,-62000.0
<a href=/player/kellh101>kellh101</a>,Harry Kelley,Memphis,Memphis,1,2,2,4,1924,1924,0,No,0,0.97,0.0,-0.97,178,0,-178,257,0,-257,684.0,0.0,-684.0,0.0,0.0,0.0
<a href=/player/kellh101>kellh101</a>,Harry Kelley,Washington Senators,TWINS,2,8,2,10,1926,1941,15,No,0,14.54,44.02,29.48,801,1602,801,1696,6582,4886,3390.0,957.0,-2433.0,24000.0,0.0,-24000.0
<a href=/player/kellh101>kellh101</a>,Harry Kelley,Washington Senators,TWINS,2,7,2,9,1940,1943,3,No,0,7.97,0.58,-7.39,391,342,-49,1546,1354,-192,0.0,0.0,0.0,0.0,0.0,0.0
<a href=/player/kellj001>kellj001</a>,Joe Kelly,St. Louis Cardinals,CARDS,1,2,3,5,2014,2015,1,Yes,0,1.43,5.3,3.87,264,83,-181,204,89,-115,1078.0,836.0,-242.0,0.0,0.0,0.0
<a href=/player/kellj102>kellj102</a>,Joe Kelly,St.Joseph,St.Joseph,1,1,1,2,1913,1913,0,No,0,-0.51,0.0,0.51,141,0,-141,567,0,-567,0.0,0.0,0.0,0.0,0.0,0.0
<a href=/player/kellj102>kellj102</a>,Joe Kelly,Chicago Cubs,CUBS,1,2,2,4,1916,1917,1,No,0,-1.02,0.0,1.02,181,2,-179,722,2,-720,0.0,0.0,0.0,0.0,0.0,0.0
<a href=/player/kellj106>kellj106</a>,Joe Kelley,Pittsburgh Pirates,PIRATS,1,2,1,3,1892,1893,1,No,0,31.31,3.2,-28.11,781,137,-644,3624,667,-2957,0.0,0.0,0.0,0.0,0.0,0.0
<a href=/player/kellk001>kellk001</a>,Kenny Kelly,Seattle Mariners,MARNRS,1,1,2,3,2003,2003,0,No,0,0.0,1.06,1.06,0,46,46,0,186,186,0.0,0.0,0.0,0.0,0.0,0.0
<a href=/player/kellk002>kellk002</a>,Kris Keller,Detroit Tigers,TIGRS,1,1,1,2,2002,2003,1,No,0,0.0,-0.3,-0.3,0,72,72,0,270,270,0.0,0.0,0.0,0.0,0.0,0.0
<a href=/player/kellk003>kellk003</a>,Kyle Keller,Miami Marlins,MARLNS,1,1,1,2,2020,2020,0,Yes,0,-0.03,0.0,0.03,2,0,-2,0,0,0,7.0,0.0,-7.0,0.0,0.0,0.0
<a href=/player/kellm001>kellm001</a>,Mike Kelly,Atlanta Braves,BRAVES,8,10,10,20,1996,2013,17,No,3,8.05,5.31,-2.74,944,456,-488,1235,756,-479,2048.0,255.0,-1793.0,468500.0,0.0,-468500.0
<a href=/player/kellm001>kellm001</a>,Mike Kelly,Cincinnati Reds,REDS,1,1,1,2,1997,1997,0,No,0,-0.19,0.0,0.19,106,0,-106,303,0,-303,0.0,0.0,0.0,175000.0,0.0,-175000.0
<a href=/player/kellm101>kellm101</a>,Mick Kelleher,St. Louis Cardinals,CARDS,22,45,42,87,1975,1998,23,No,7,89.8,159.0,69.2,8918,7438,-1480,24477,25727,1250,10540.0,4019.0,-6521.0,3088333.0,0.0,-3088333.0
<a href=/player/kellm103>kellm103</a>,Mike Kelley,Louisville Colonels,LS3,1,12,5,17,1899,1900,1,No,0,267.1,0.0,-267.1,7388,0,-7388,29004,0,-29004,7568.0,0.0,-7568.0,4350.0,0.0,-4350.0
<a href=/player/kellp101>kellp101</a>,Pat Kelly,Kansas City Royals,ROYALS,1,2,2,4,1970,1974,4,No,0,5.15,1.5,-3.65,692,230,-462,2721,588,-2133,0.0,0.0,0.0,26000.0,0.0,-26000.0
<a href=/player/kellp101>kellp101</a>,Pat Kelly,Chicago White Sox,WSOX,1,1,1,2,1976,1977,1,No,0,3.73,0.0,-3.73,377,0,-377,1155,0,-1155,0.0,0.0,0.0,0.0,0.0,0.0
<a href=/player/kellp102>kellp102</a>,Pat Kelly,California Angels,ANGELS,1,2,1,3,1977,1977,0,No,0,-0.09,0.0,0.09,9,0,-9,25,0,-25,0.0,0.0,0.0,0.0,0.0,0.0
<a href=/player/kellr001>kellr001</a>,Ryan Kelly,Oakland Athletics,ATLTCS,3,4,3,7,2011,2014,3,No,0,3.45,5.86,2.41,352,341,-11,551,854,303,434.0,601.0,167.0,3675000.0,0.0,-3675000.0
<a href=/player/kellr001>kellr001</a>,Ryan Kelly,Texas Rangers,RNGRS,1,1,1,2,2011,2013,2,No,0,0.0,-0.3,-0.3,0,10,10,0,19,19,0.0,0.0,0.0,0.0,0.0,0.0
<a href=/player/kellr001>kellr001</a>,Ryan Kelly,Pittsburgh Pirates,PIRATS,1,1,1,2,2010,2010,0,No,0,0.0,0.0,0.0,0,0,0,0,0,0,0.0,0.0,0.0,0.0,0.0,0.0
<a href=/player/kellr102>kellr102</a>,Ren Kelly,Philadelphia Athletics,ATLTCS,1,3,1,4,1924,1926,2,No,0,0.0,8.0,8.0,0,166,166,0,103,103,0.0,950.0,950.0,0.0,0.0,0.0
<a href=/player/kells001>kells001</a>,Shawn Kelley,Seattle Mariners,MARNRS,2,3,2,5,2013,2014,1,No,0,0.03,0.09,0.06,189,84,-105,182,285,103,315.0,0.0,-315.0,0.0,0.0,0.0
<a href=/player/kells001>kells001</a>,Shawn Kelley,New York Yankees,YANKS,2,2,2,4,2014,2017,3,Yes,0,0.98,-0.29,-1.27,150,13,-137,1,0,-1,240.0,39.0,-201.0,1765000.0,0.0,-1765000.0
<a href=/player/kells001>kells001</a>,Shawn Kelley,Washington Nationals,NATEX,1,2,1,3,2018,2018,0,No,0,0.46,0.0,-0.46,19,0,-19,0,0,0,50.0,0.0,-50.0,5500000.0,0.0,-5500000.0
<a href=/player/kellt001>kellt001</a>,Ty Kelly,Baltimore Orioles,ORLS,1,1,1,2,2013,2013,0,No,0,0.0,0.0,0.0,0,0,0,0,0,0,0.0,0.0,0.0,0.0,0.0,0.0
<a href=/player/kellt001>kellt001</a>,Ty Kelly,Seattle Mariners,MARNRS,1,1,1,2,2014,2017,3,No,0,0.0,0.24,0.24,0,14,14,0,5,5,0.0,187.0,187.0,0.0,0.0,0.0
<a href=/player/kellv101>kellv101</a>,Van Kelly,Atlanta Braves,BRAVES,1,3,1,4,1969,1970,1,No,0,-0.8,2.26,3.06,142,212,70,403,844,441,0.0,0.0,0.0,0.0,0.0,0.0
<a href=/player/kelsb101>kelsb101</a>,Bill Kelso,California Angels,ANGELS,3,4,4,8,1967,1971,4,No,0,-0.47,-0.05,0.42,214,297,83,361,652,291,251.0,492.0,241.0,20000.0,0.0,-20000.0
<a href=/player/kelsb101>kelsb101</a>,Bill Kelso,Montreal Expos,NATEX,1,2,2,4,1972,1973,1,No,0,-1.6,-1.59,0.01,85,126,41,8,295,287,188.0,2.0,-186.0,0.0,0.0,0.0
<a href=/player/kemmr101>kemmr101</a>,Russ Kemmerer,Boston Red Sox,RSOX,3,5,4,9,1957,1961,4,No,0,-1.86,-2.15,-0.29,679,212,-467,1371,205,-1166,1950.0,366.0,-1584.0,0.0,0.0,0.0
<a href=/player/kemmr101>kemmr101</a>,Russ Kemmerer,Chicago White Sox,WSOX,1,1,1,2,1962,1963,1,No,0,0.25,0.75,0.5,106,54,-52,17,2,-15,314.0,91.0,-223.0,0.0,0.0,0.0
<a href=/player/kempm001>kempm001</a>,Matt Kemp,Los Angeles Dodgers,DOGRS,4,10,8,18,2014,2021,7,Yes,0,6.08,11.37,5.29,476,899,423,1306,2454,1148,1807.0,359.0,-1448.0,21000000.0,0.0,-21000000.0
<a href=/player/kempm001>kempm001</a>,Matt Kemp,San Diego Padres,PADRS,1,2,1,3,2016,2016,0,No,0,-1.22,0.0,1.22,171,0,-171,708,0,-708,0.0,0.0,0.0,0.0,0.0,0.0
<a href=/player/kempm001>kempm001</a>,Matt Kemp,Atlanta Braves,BRAVES,1,1,5,6,2017,2020,3,No,0,1.15,0.27,-0.88,146,264,118,506,504,-2,0.0,246.0,246.0,21750000.0,0.0,-21750000.0
<a href=/player/kempm001>kempm001</a>,Matt Kemp,Los Angeles Dodgers,DOGRS,3,12,8,20,2018,2021,3,Yes,0,5.8,8.33,2.53,663,133,-530,2223,501,-1722,299.0,229.0,-70.0,36964000.0,0.0,-36964000.0
<a href=/player/kemps001>kemps001</a>,Steve Kemp,Detroit Tigers,TIGRS,1,1,1,2,1981,1981,0,No,0,2.03,0.0,-2.03,160,0,-160,679,0,-679,0.0,0.0,0.0,600000.0,0.0,-600000.0
<a href=/player/kemps001>kemps001</a>,Steve Kemp,New York Yankees,YANKS,3,7,5,12,1984,1989,5,No,0,23.0,1.52,-21.48,1607,253,-1354,6240,680,-5560,0.0,0.0,0.0,2062000.0,0.0,-2062000.0
<a href=/player/kempt001>kempt001</a>,Tony Kemp,Houston Astros,ASTROS,1,1,1,2,2019,2019,0,Yes,0,-0.1,0.55,0.65,44,27,-17,93,98,5,0.0,0.0,0.0,583600.0,0.0,-583600.0
<a href=/player/kempt001>kempt001</a>,Tony Kemp,Chicago Cubs,CUBS,1,1,1,2,2020,2020,0,Yes,0,3.17,0.0,-3.17,180,0,-180,511,0,-511,0.0,0.0,0.0,0.0,0.0,0.0
<a href=/player/kendf101>kendf101</a>,Fred Kendall,San Diego Padres,PADRS,2,4,2,6,1976,1981,5,No,0,20.22,7.28,-12.94,1143,413,-730,4572,857,-3715,0.0,1243.0,1243.0,0.0,0.0,0.0
<a href=/player/kendf101>kendf101</a>,Fred Kendall,Cleveland Indians,INDINS,11,17,24,41,1978,2011,33,No,4,62.43,64.43,2.0,2207,3216,1009,7220,10249,3029,6797.0,7509.0,712.0,1767500.0,0.0,-1767500.0
<a href=/player/kendh001>kendh001</a>,Howie Kendrick,Anaheim Angels,ANGELS,2,3,3,6,2014,2021,7,Yes,0,1.6,5.7,4.1,277,115,-162,1039,17,-1022,107.0,1764.0,1657.0,16100000.0,0.0,-16100000.0
<a href=/player/kendh001>kendh001</a>,Howie Kendrick,Los Angeles Dodgers,DOGRS,1,1,2,3,2016,2017,1,No,0,1.24,0.0,-1.24,39,0,-39,156,0,-156,0.0,0.0,0.0,10000000.0,0.0,-10000000.0
<a href=/player/kendh001>kendh001</a>,Howie Kendrick,Philadelphia Phillies,PHILS,2,3,4,7,2017,2018,1,No,0,3.05,-0.18,-3.23,238,29,-209,808,54,-754,0.0,0.0,0.0,10000000.0,0.0,-10000000.0
<a href=/player/kendj001>kendj001</a>,Jason Kendall,Pittsburgh Pirates,PIRATS,4,5,8,13,2004,2008,4,No,0,8.37,-0.3,-8.67,471,259,-212,1700,523,-1177,631.0,692.0,61.0,20821429.0,0.0,-20821429.0
<a href=/player/kendj001>kendj001</a>,Jason Kendall,Oakland Athletics,ATLTCS,4,5,5,10,2007,2017,10,Yes,0,-1.72,5.43,7.15,231,610,379,284,1129,845,172.0,801.0,629.0,13958194.0,0.0,-13958194.0
<a href=/player/kenna001>kenna001</a>,Adam Kennedy,St. Louis Cardinals,CARDS,4,6,6,12,2000,2019,19,No,0,27.34,51.35,24.01,1988,2348,360,6641,8016,1375,960.0,194.0,-766.0,13224540.0,0.0,-13224540.0
<a href=/player/kenna001>kenna001</a>,Adam Kennedy,Tampa Bay Devil Rays,RAYS,1,1,1,2,2009,2010,1,No,0,1.07,0.16,-0.91,129,15,-114,587,35,-552,0.0,0.0,0.0,0.0,0.0,0.0
<a href=/player/kennb103>kennb103</a>,Bill Kennedy,Cleveland Indians,INDINS,2,5,2,7,1948,1951,3,No,0,4.59,4.03,-0.56,440,274,-166,755,90,-665,1641.0,1005.0,-636.0,0.0,0.0,0.0
<a href=/player/kennb103>kennb103</a>,Bill Kennedy,Chicago White Sox,WSOX,1,3,1,4,1953,1953,0,No,0,1.18,-0.21,-1.39,202,44,-158,118,143,25,1116.0,0.0,-1116.0,0.0,0.0,0.0
<a href=/player/kennb104>kennb104</a>,Bob Kennedy,Chicago White Sox,WSOX,1,1,2,3,1948,1949,1,No,0,3.02,1.54,-1.48,564,179,-385,1747,480,-1267,0.0,633.0,633.0,0.0,0.0,0.0
<a href=/player/kennb104>kennb104</a>,Bob Kennedy,Cleveland Indians,INDINS,1,1,1,2,1954,1955,1,No,0,-0.81,0.0,0.81,132,2,-130,439,2,-437,0.0,0.0,0.0,0.0,0.0,0.0
<a href=/player/kennb104>kennb104</a>,Bob Kennedy,Chicago White Sox,WSOX,10,18,21,39,1956,1971,15,No,0,41.93,77.23,35.3,3299,4500,1201,10984,12532,1548,917.0,5807.0,4890.0,83500.0,0.0,-83500.0
<a href=/player/kenni001>kenni001</a>,Ian Kennedy,New York Yankees,YANKS,1,3,1,4,2009,2013,4,No,0,8.92,14.94,6.02,232,513,281,259,2148,1889,2245.0,0.0,-2245.0,812225.0,0.0,-812225.0
<a href=/player/kenni001>kenni001</a>,Ian Kennedy,Arizona Diamondbacks,DBACKS,2,3,4,7,2013,2019,6,Yes,0,1.03,-1.21,-2.24,176,209,33,146,0,-146,1299.0,234.0,-1065.0,2884500.0,0.0,-2884500.0
<a href=/player/kenni001>kenni001</a>,Ian Kennedy,Texas Rangers,RNGRS,1,4,3,7,2021,2021,0,Yes,0,0.8,-1.21,-2.01,74,9,-65,29,0,-29,300.0,64.0,-236.0,9766666.0,0.0,-9766666.0
<a href=/player/kennj001>kennj001</a>,Joe Kennedy,Tampa Bay Devil Rays,RAYS,2,4,4,8,2003,2012,9,No,0,3.74,4.31,0.57,213,667,454,202,1894,1692,1356.0,1780.0,424.0,4500000.0,0.0,-4500000.0
<a href=/player/kennj001>kennj001</a>,Joe Kennedy,Colorado Rockies,ROCKS,3,5,4,9,2005,2010,5,No,0,4.0,-0.14,-4.14,707,385,-322,1691,690,-1001,801.0,134.0,-667.0,2526000.0,0.0,-2526000.0
<a href=/player/kennj101>kennj101</a>,Junior Kennedy,Baltimore Orioles,ORLS,2,4,3,7,1973,1977,4,No,1,4.01,5.74,1.73,498,137,-361,1375,0,-1375,0.0,2543.0,2543.0,40000.0,0.0,-40000.0
<a href=/player/kennj103>kennj103</a>,Jerry Kenney,New York Yankees,YANKS,5,8,9,17,1972,1987,15,No,0,9.09,48.73,39.64,1757,1810,53,5603,6602,999,883.0,1959.0,1076.0,246600.0,0.0,-246600.0
<a href=/player/kennj105>kennj105</a>,John Kennedy,Washington Senators,RNGRS,26,45,52,97,1964,1992,28,No,2,142.7,104.34,-38.36,8431,6607,-1824,19421,19320,-101,25577.0,10933.0,-14644.0,342900.0,0.0,-342900.0
<a href=/player/kennj105>kennj105</a>,John Kennedy,Los Angeles Dodgers,DOGRS,1,1,3,4,1967,1967,0,No,0,-0.55,0.0,0.55,78,0,-78,208,0,-208,0.0,0.0,0.0,0.0,0.0,0.0
<a href=/player/kennj106>kennj106</a>,Jim Kennedy,St. Louis Cardinals,CARDS,1,2,2,4,1970,1970,0,No,0,0.05,0.0,-0.05,12,0,-12,0,0,0,13.0,0.0,-13.0,12000.0,0.0,-12000.0
<a href=/player/kennt001>kennt001</a>,Terry Kennedy,St. Louis Cardinals,CARDS,12,29,23,52,1980,1998,18,No,5,83.63,121.95,38.32,6733,4994,-1739,20851,17148,-3703,6532.0,3025.0,-3507.0,1533333.0,0.0,-1533333.0
<a href=/player/kennt001>kennt001</a>,Terry Kennedy,San Diego Padres,PADRS,2,3,3,6,1986,1990,4,No,0,10.9,-1.16,-12.06,682,244,-438,834,162,-672,3461.0,484.0,-2977.0,1525000.0,0.0,-1525000.0
<a href=/player/kennt001>kennt001</a>,Terry Kennedy,Baltimore Orioles,ORLS,2,2,2,4,1989,1992,3,No,0,3.87,2.38,-1.49,333,305,-28,995,864,-131,0.0,268.0,268.0,650000.0,0.0,-650000.0
<a href=/player/kennv101>kennv101</a>,Vern Kennedy,Chicago White Sox,WSOX,2,4,5,9,1937,1950,13,No,0,5.83,16.69,10.86,429,2282,1853,1515,8577,7062,633.0,270.0,-363.0,37500.0,0.0,-37500.0
<a href=/player/kennv101>kennv101</a>,Vern Kennedy,Detroit Tigers,TIGRS,3,9,7,16,1939,1948,9,No,0,19.29,21.11,1.82,2183,1686,-497,6579,6030,-549,3951.0,2317.0,-1634.0,44300.0,0.0,-44300.0
<a href=/player/kennv101>kennv101</a>,Vern Kennedy,St.Louis Browns,ORLS,2,2,3,5,1941,1944,3,No,0,3.13,0.7,-2.43,262,273,11,859,934,75,199.0,0.0,-199.0,9000.0,0.0,-9000.0
<a href=/player/kennv101>kennv101</a>,Vern Kennedy,Philadelphia Phillies,PHILS,1,1,1,2,1945,1945,0,No,0,1.86,0.35,-1.51,48,49,1,55,187,132,473.0,0.0,-473.0,0.0,0.0,0.0
<a href=/player/kensl001>kensl001</a>,Logan Kensing,Florida Marlins,MARLNS,1,1,1,2,2009,2009,0,No,0,-0.93,0.0,0.93,52,0,-52,2,0,-2,84.0,0.0,-84.0,660000.0,0.0,-660000.0
<a href=/player/kentj001>kentj001</a>,Jeff Kent,Toronto Blue Jays,BJAYS,4,7,7,14,1992,1997,5,No,2,31.44,9.8,-21.64,988,69,-919,3245,0,-3245,2766.0,1237.0,-1529.0,8109000.0,0.0,-8109000.0
<a href=/player/kentj001>kentj001</a>,Jeff Kent,New York Mets,METS,1,2,2,4,1996,1998,2,No,0,0.91,1.15,0.24,87,354,267,307,1284,977,0.0,0.0,0.0,4160000.0,0.0,-4160000.0
<a href=/player/kentj001>kentj001</a>,Jeff Kent,Cleveland Indians,INDINS,3,6,6,12,1996,2001,5,No,0,40.02,3.44,-36.58,2173,212,-1961,7166,649,-6517,933.0,172.0,-761.0,7541666.0,0.0,-7541666.0
<a href=/player/kenwd101>kenwd101</a>,Duke Kenworthy,KansasCity,KansasCity,3,4,7,11,1912,1915,3,No,0,56.9,0.0,-56.9,1282,0,-1282,2403,0,-2403,9207.0,0.0,-9207.0,0.0,0.0,0.0
<a href=/player/keouj101>keouj101</a>,Joe Keough,Kansas City Royals,ROYALS,1,1,1,2,1973,1973,0,No,0,0.0,0.0,0.0,5,0,-5,1,0,-1,0.0,0.0,0.0,0.0,0.0,0.0
<a href=/player/keoum001>keoum001</a>,Matt Keough,Oakland Athletics,ATLTCS,1,1,3,4,1983,1983,0,No,0,-0.76,-1.24,-0.48,12,9,-3,0,14,14,167.0,28.0,-139.0,0.0,0.0,0.0
<a href=/player/keoum101>keoum101</a>,Marty Keough,Boston Red Sox,RSOX,4,8,6,14,1960,1966,6,No,0,-2.7,-1.76,0.94,273,963,690,690,2516,1826,122.0,336.0,214.0,18500.0,0.0,-18500.0
<a href=/player/keoum101>keoum101</a>,Marty Keough,Washington Senators,RNGRS,1,2,2,4,1961,1963,2,No,0,1.4,0.77,-0.63,457,97,-360,839,291,-548,326.0,0.0,-326.0,0.0,0.0,0.0
<a href=/player/keoum101>keoum101</a>,Marty Keough,Atlanta Braves,BRAVES,2,4,3,7,1966,1966,0,No,0,-0.17,-0.08,0.09,59,17,-42,34,18,-16,53.0,0.0,-53.0,0.0,0.0,0.0
<a href=/player/keppj001>keppj001</a>,Jeff Keppinger,Pittsburgh Pirates,PIRATS,2,3,4,7,2004,2009,5,No,0,40.94,-2.9,-43.84,1344,558,-786,5481,2041,-3440,727.0,0.0,-727.0,7950000.0,0.0,-7950000.0
<a href=/player/keppj001>keppj001</a>,Jeff Keppinger,New York Mets,METS,1,1,1,2,2006,2008,2,No,0,0.13,0.08,-0.05,22,98,76,67,211,144,0.0,0.0,0.0,0.0,0.0,0.0
<a href=/player/keppj001>keppj001</a>,Jeff Keppinger,Kansas City Royals,ROYALS,1,1,1,2,2007,2007,0,No,0,-0.16,0.0,0.16,188,0,-188,778,0,-778,0.0,0.0,0.0,0.0,0.0,0.0
<a href=/player/keppj001>keppj001</a>,Jeff Keppinger,Cincinnati Reds,REDS,1,1,1,2,2009,2010,1,No,0,1.11,0.02,-1.09,287,44,-243,1089,79,-1010,0.0,0.0,0.0,0.0,0.0,0.0
<a href=/player/keppj001>keppj001</a>,Jeff Keppinger,Houston Astros,ASTROS,1,1,2,3,2011,2012,1,No,0,-0.74,-0.35,0.39,56,20,-36,230,18,-212,0.0,160.0,160.0,2300000.0,0.0,-2300000.0
<a href=/player/kerfc001>kerfc001</a>,Charlie Kerfeld,Houston Astros,ASTROS,1,1,2,3,1990,1990,0,No,0,-0.56,0.0,0.56,50,0,-50,0,0,0,92.0,0.0,-92.0,122000.0,0.0,-122000.0
<a href=/player/kerig101>kerig101</a>,Gus Keriazakos,Chicago White Sox,WSOX,2,5,3,8,1954,1956,2,No,0,0.93,2.11,1.18,375,206,-169,742,121,-621,750.0,421.0,-329.0,8500.0,0.0,-8500.0
<a href=/player/kerig101>kerig101</a>,Gus Keriazakos,Washington Senators,TWINS,1,1,1,2,1955,1955,0,No,0,-0.73,0.0,0.73,10,0,-10,3,0,-3,35.0,0.0,-35.0,0.0,0.0,0.0
<a href=/player/kernj001>kernj001</a>,Jim Kern,Cleveland Indians,INDINS,14,21,31,52,1978,2011,33,No,4,61.95,134.64,72.69,2403,5295,2892,7210,17001,9791,7208.0,16506.0,9298.0,2352500.0,0.0,-2352500.0
<a href=/player/kernj001>kernj001</a>,Jim Kern,Texas Rangers,RNGRS,1,1,2,3,1981,1982,1,No,0,0.0,-1.77,-1.77,0,88,88,0,283,283,0.0,0.0,0.0,163000.0,0.0,-163000.0
<a href=/player/kernj001>kernj001</a>,Jim Kern,New York Mets,METS,1,3,1,4,1982,1986,4,No,0,1.8,4.68,2.88,378,655,277,630,2610,1980,505.0,0.0,-505.0,0.0,0.0,0.0
<a href=/player/kernj001>kernj001</a>,Jim Kern,Cincinnati Reds,REDS,2,2,3,5,1982,1988,6,No,0,-0.34,0.98,1.32,25,173,148,34,225,191,86.0,476.0,390.0,0.0,0.0,0.0
<a href=/player/kerrb101>kerrb101</a>,Buddy Kerr,New York Giants,GIANTS,14,31,27,58,1949,1968,19,No,0,59.86,70.44,10.58,4286,4168,-118,14522,10114,-4408,1384.0,8678.0,7294.0,127500.0,0.0,-127500.0
<a href=/player/kerrj101>kerrj101</a>,Joe Kerrigan,Montreal Expos,NATEX,2,4,4,8,1977,1986,9,No,1,17.04,9.82,-7.22,1002,871,-131,2634,1351,-1283,744.0,3222.0,2478.0,0.0,0.0,0.0
<a href=/player/kerrj101>kerrj101</a>,Joe Kerrigan,Baltimore Orioles,ORLS,1,2,2,4,1981,1981,0,No,0,0.0,0.0,0.0,0,0,0,0,0,0,0.0,0.0,0.0,0.0,0.0,0.0
<a href=/player/kerrj102>kerrj102</a>,John Kerr,Chicago White Sox,WSOX,3,5,5,10,1931,1940,9,No,0,20.15,15.13,-5.02,1226,1402,176,4055,5150,1095,2296.0,2157.0,-139.0,35600.0,0.0,-35600.0
<a href=/player/kessd101>kessd101</a>,Don Kessinger,Chicago Cubs,CUBS,7,10,16,26,1975,1996,21,No,0,23.71,94.5,70.79,2653,4614,1961,6964,18168,11204,2336.0,1952.0,-384.0,0.0,0.0,0.0
<a href=/player/kessd101>kessd101</a>,Don Kessinger,St. Louis Cardinals,CARDS,1,1,1,2,1977,1977,0,No,0,-1.19,0.0,1.19,226,0,-226,738,0,-738,0.0,0.0,0.0,0.0,0.0,0.0
<a href=/player/kessk001>kessk001</a>,Keith Kessinger,Cincinnati Reds,REDS,1,1,1,2,1995,1995,0,No,0,0.0,0.0,0.0,0,0,0,0,0,0,0.0,0.0,0.0,0.0,0.0,0.0
<a href=/player/ketcf101>ketcf101</a>,Fred Ketchum,Pittsburgh Pirates,PIRATS,1,3,1,4,1901,1901,0,No,0,0.0,-0.42,-0.42,0,14,14,0,21,21,0.0,133.0,133.0,0.0,0.0,0.0
<a href=/player/kibbj101>kibbj101</a>,Jack Kibble,Cleveland Indians,INDINS,1,6,1,7,1913,1914,1,No,0,0.0,-0.98,-0.98,0,48,48,0,37,37,0.0,303.0,303.0,0.0,0.0,0.0
<a href=/player/kickm001>kickm001</a>,Mike Kickham,Chicago Cubs,CUBS,1,1,1,2,2015,2015,0,Yes,0,0.0,0.0,0.0,0,0,0,0,0,0,0.0,0.0,0.0,0.0,0.0,0.0
<a href=/player/kiefj101>kiefj101</a>,Joe Kiefer,Boston Red Sox,RSOX,1,3,1,4,1926,1926,0,No,0,0.0,-0.79,-0.79,0,31,31,0,103,103,0.0,0.0,0.0,7100.0,0.0,-7100.0
<a href=/player/kiefm001>kiefm001</a>,Mark Kiefer,Milwaukee Brewers,BREWRS,1,1,1,2,1996,1996,0,No,0,0.0,0.0,0.0,0,0,0,0,0,0,0.0,0.0,0.0,130000.0,0.0,-130000.0
<a href=/player/kiefs001>kiefs001</a>,Steve Kiefer,Oakland Athletics,ATLTCS,1,4,1,5,1986,1987,1,No,0,2.24,1.63,-0.61,195,21,-174,688,0,-688,0.0,339.0,339.0,0.0,0.0,0.0
<a href=/player/kielb001>kielb001</a>,Bobby Kielty,Minnesota Twins,TWINS,1,1,2,3,2003,2007,4,No,0,-0.21,4.68,4.89,62,335,273,225,1523,1298,0.0,23.0,23.0,325000.0,0.0,-325000.0
<a href=/player/kielb001>kielb001</a>,Bobby Kielty,Toronto Blue Jays,BJAYS,3,4,3,7,2003,2013,10,No,1,2.33,7.53,5.2,302,441,139,1048,1195,147,44.0,1516.0,1472.0,0.0,0.0,0.0
<a href=/player/kiell101>kiell101</a>,Leo Kiely,Boston Red Sox,RSOX,1,1,1,2,1960,1960,0,No,0,0.0,0.1,0.1,0,7,7,0,5,5,0.0,0.0,0.0,0.0,0.0,0.0
<a href=/player/kiell101>kiell101</a>,Leo Kiely,Cleveland Indians,INDINS,1,1,1,2,1960,1960,0,No,0,1.48,-0.36,-1.84,40,6,-34,3,0,-3,62.0,7.0,-55.0,0.0,0.0,0.0
<a href=/player/kildp101>kildp101</a>,Pete Kilduff,New York Giants,GIANTS,1,1,1,2,1917,1919,2,No,0,0.8,-0.07,-0.87,117,82,-35,435,75,-360,0.0,667.0,667.0,0.0,0.0,0.0
<a href=/player/kildp101>kildp101</a>,Pete Kilduff,Chicago Cubs,CUBS,1,1,1,2,1919,1919,0,No,0,5.5,1.59,-3.91,280,79,-201,1068,299,-769,0.0,0.0,0.0,0.0,0.0,0.0
<a href=/player/kiled001>kiled001</a>,Darryl Kile,Colorado Rockies,ROCKS,13,23,24,47,1999,2003,4,No,0,20.8,11.07,-9.73,2188,1626,-562,1402,1034,-368,5980.0,2442.0,-3538.0,24071314.0,0.0,-24071314.0
<a href=/player/kilgp001>kilgp001</a>,Paul Kilgus,Texas Rangers,RNGRS,2,7,4,11,1988,1994,6,No,0,0.27,27.89,27.62,791,1284,493,491,4575,4084,1767.0,710.0,-1057.0,532500.0,0.0,-532500.0
<a href=/player/kilgp001>kilgp001</a>,Paul Kilgus,Chicago Cubs,CUBS,1,1,1,2,1989,1989,0,No,0,-0.19,0.0,0.19,11,0,-11,0,0,0,49.0,0.0,-49.0,130000.0,0.0,-130000.0
<a href=/player/kilgp001>kilgp001</a>,Paul Kilgus,Toronto Blue Jays,BJAYS,1,1,1,2,1990,1991,1,No,0,-0.6,0.08,0.68,38,2,-36,0,0,0,186.0,6.0,-180.0,242500.0,0.0,-242500.0
<a href=/player/kilkm101>kilkm101</a>,Mike Kilkenny,Detroit Tigers,TIGRS,2,2,2,4,1972,1975,3,No,0,0.03,0.09,0.06,2,79,77,0,299,299,3.0,0.0,-3.0,0.0,0.0,0.0
<a href=/player/kilkm101>kilkm101</a>,Mike Kilkenny,Oakland Athletics,ATLTCS,1,3,1,4,1972,1972,0,No,0,-0.03,-0.15,-0.12,84,20,-64,122,60,-62,13.0,0.0,-13.0,20500.0,0.0,-20500.0
<a href=/player/kilkm101>kilkm101</a>,Mike Kilkenny,San Diego Padres,PADRS,2,2,2,4,1972,1972,0,No,0,2.83,-0.3,-3.13,570,39,-531,1173,99,-1074,180.0,0.0,-180.0,0.0,0.0,0.0
<a href=/player/killb101>killb101</a>,Bill Killefer,Philadelphia Phillies,PHILS,5,11,13,24,1917,1929,12,No,0,74.14,17.51,-56.63,2587,762,-1825,7576,2068,-5508,10093.0,3446.0,-6647.0,21000.0,0.0,-21000.0
<a href=/player/killb101>killb101</a>,Bill Killefer,Buffalo,Buffalo,1,1,2,3,1911,1916,5,No,0,6.81,0.0,-6.81,636,0,-636,2095,0,-2095,0.0,0.0,0.0,0.0,0.0,0.0
<a href=/player/kille101>kille101</a>,Ed Killian,Cleveland Indians,INDINS,1,2,1,3,1904,1904,0,No,0,22.67,2.88,-19.79,462,138,-324,681,580,-101,5040.0,0.0,-5040.0,0.0,0.0,0.0
<a href=/player/killf101>killf101</a>,Frank Killen,Washington Senators,WSN,2,3,5,8,1893,1894,1,No,0,54.92,2.16,-52.76,1137,156,-981,2556,613,-1943,10234.0,309.0,-9925.0,0.0,0.0,0.0
<a href=/player/killr101>killr101</a>,Red Killefer,Detroit Tigers,TIGRS,1,2,1,3,1909,1909,0,No,0,6.2,1.23,-4.97,528,46,-482,1839,188,-1651,2.0,0.0,-2.0,0.0,0.0,0.0
<a href=/player/killr101>killr101</a>,Red Killefer,Cincinnati Reds,REDS,2,3,5,8,1916,1930,14,No,0,6.12,44.47,38.35,494,1760,1266,2101,7377,5276,0.0,27.0,27.0,0.0,0.0,0.0
<a href=/player/killr101>killr101</a>,Red Killefer,Minneapolis,Minneapolis,1,1,3,4,1914,1914,0,No,0,3.75,0.0,-3.75,267,0,-267,1074,0,-1074,0.0,0.0,0.0,0.0,0.0,0.0
<a href=/player/kilof001>kilof001</a>,Franklyn Kilome,Philadelphia Phillies,PHILS,1,1,1,2,2018,2018,0,No,0,-0.31,-0.75,-0.44,4,49,45,0,185,185,34.0,0.0,-34.0,0.0,0.0,0.0
<a href=/player/kim-b001>kim-b001</a>,Byung-Hyun Kim,Arizona Diamondbacks,DBACKS,2,2,2,4,2003,2005,2,No,0,3.93,0.4,-3.53,293,233,-60,971,958,-13,290.0,0.0,-290.0,3250000.0,0.0,-3250000.0
<a href=/player/kim-b001>kim-b001</a>,Byung-Hyun Kim,Boston Red Sox,RSOX,1,2,2,4,2005,2005,0,No,0,1.04,0.0,-1.04,138,0,-138,104,0,-104,927.0,0.0,-927.0,0.0,0.0,0.0
<a href=/player/kim-b001>kim-b001</a>,Byung-Hyun Kim,Colorado Rockies,ROCKS,1,1,1,2,2007,2007,0,No,0,-0.15,0.73,0.88,44,112,68,39,1,-38,329.0,158.0,-171.0,2500000.0,0.0,-2500000.0
<a href=/player/kim-h001>kim-h001</a>,Hyun Soo Kim,Baltimore Orioles,ORLS,1,3,1,4,2017,2017,0,No,0,-0.92,-0.85,0.07,41,10,-31,97,0,-97,2.0,155.0,153.0,4200000.0,0.0,-4200000.0
<a href=/player/kim-s001>kim-s001</a>,Sun-Woo Kim,Boston Red Sox,RSOX,7,14,11,25,2002,2019,17,No,4,17.77,34.63,16.86,1361,1798,437,2427,6905,4478,1558.0,188.0,-1370.0,12471000.0,0.0,-12471000.0
<a href=/player/kimbc001>kimbc001</a>,Craig Kimbrel,Atlanta Braves,BRAVES,4,8,11,19,2015,2021,6,Yes,0,6.43,9.54,3.11,663,1279,616,1140,3485,2345,998.0,1493.0,495.0,8100000.0,0.0,-8100000.0
<a href=/player/kimbc001>kimbc001</a>,Craig Kimbrel,San Diego Padres,PADRS,4,10,9,19,2015,2021,6,Yes,0,17.49,6.57,-10.92,972,677,-295,2890,2192,-698,745.0,184.0,-561.0,9570500.0,0.0,-9570500.0
<a href=/player/kimbc001>kimbc001</a>,Craig Kimbrel,Chicago Cubs,CUBS,1,1,2,3,2021,2021,0,Yes,0,-0.03,0.52,0.55,26,48,22,0,0,0,69.0,86.0,17.0,16000000.0,0.0,-16000000.0
<a href=/player/kimbn101>kimbn101</a>,Newt Kimball,Chicago Cubs,CUBS,1,2,1,3,1939,1943,4,No,0,1.28,-0.27,-1.55,170,131,-39,187,453,266,378.0,0.0,-378.0,12500.0,0.0,-12500.0
<a href=/player/kimmb101>kimmb101</a>,Bruce Kimm,Chicago White Sox,WSOX,1,2,1,3,1972,1973,1,No,0,0.0,0.54,0.54,0,38,38,0,7,7,0.0,399.0,399.0,0.0,0.0,0.0
<a href=/player/kimmb101>kimmb101</a>,Bruce Kimm,California Angels,ANGELS,1,1,1,2,1973,1973,0,No,0,1.22,-0.04,-1.26,77,4,-73,200,7,-193,0.0,0.0,0.0,0.0,0.0,0.0
<a href=/player/kimmw101>kimmw101</a>,Wally Kimmick,Vernon,Vernon,1,1,1,2,1924,1931,7,No,0,0.24,0.0,-0.24,90,0,-90,196,0,-196,0.0,0.0,0.0,0.0,0.0,0.0
<a href=/player/kimsc101>kimsc101</a>,Chad Kimsey,Chicago White Sox,WSOX,1,2,1,3,1933,1933,0,No,0,0.0,0.0,0.0,0,0,0,0,0,0,0.0,0.0,0.0,6000.0,0.0,-6000.0
<a href=/player/kinde101>kinde101</a>,Ellis Kinder,St.Louis Browns,ORLS,13,24,31,55,1947,1960,13,No,0,52.08,29.92,-22.16,3700,3192,-508,8156,7991,-165,9955.0,6124.0,-3831.0,59000.0,0.0,-59000.0
<a href=/player/kindj101>kindj101</a>,Jerry Kindall,Chicago Cubs,CUBS,2,2,2,4,1961,1962,1,No,0,1.94,0.0,-1.94,265,0,-265,879,0,-879,6.0,0.0,-6.0,0.0,0.0,0.0
<a href=/player/kindj101>kindj101</a>,Jerry Kindall,Cleveland Indians,INDINS,1,1,1,2,1964,1964,0,No,0,-1.4,-0.72,0.68,187,69,-118,534,175,-359,0.0,0.0,0.0,16000.0,0.0,-16000.0
<a href=/player/kiner101>kiner101</a>,Ralph Kiner,Pittsburgh Pirates,PIRATS,7,12,15,27,1953,1962,9,No,0,9.43,3.47,-5.96,1075,1271,196,3095,3842,747,1449.0,56.0,-1393.0,86000.0,0.0,-86000.0
<a href=/player/kiner101>kiner101</a>,Ralph Kiner,Chicago Cubs,CUBS,6,11,12,23,1954,1965,11,No,0,7.51,12.81,5.3,750,1225,475,1798,351,-1447,1395.0,4049.0,2654.0,65000.0,0.0,-65000.0
<a href=/player/kingc101>kingc101</a>,Clyde King,Brooklyn Dodgers,DOGRS,1,1,2,3,1952,1952,0,No,0,0.06,0.0,-0.06,70,0,-70,13,0,-13,228.0,0.0,-228.0,0.0,0.0,0.0
<a href=/player/kingc102>kingc102</a>,Chick King,Detroit Tigers,TIGRS,2,3,2,5,1957,1958,1,No,0,0.0,0.0,0.0,0,16,16,0,24,24,0.0,0.0,0.0,0.0,0.0,0.0
<a href=/player/kingc102>kingc102</a>,Chick King,Milwaukee Braves,BRAVES,2,7,3,10,1957,1961,4,No,0,-1.07,-0.69,0.38,281,102,-179,637,325,-312,138.0,0.0,-138.0,0.0,0.0,0.0
<a href=/player/kingc102>kingc102</a>,Chick King,Chicago Cubs,CUBS,1,1,1,2,1959,1960,1,No,0,0.02,1.9,1.88,5,77,72,8,186,178,0.0,0.0,0.0,0.0,0.0,0.0
<a href=/player/kingd001>kingd001</a>,Dave Kingman,New York Mets,METS,2,2,3,5,1977,1979,2,No,0,0.36,-0.17,-0.53,56,215,159,187,280,93,0.0,168.0,168.0,95000.0,0.0,-95000.0
<a href=/player/kingd001>kingd001</a>,Dave Kingman,California Angels,ANGELS,1,1,2,3,1977,1977,0,No,0,0.37,0.0,-0.37,8,0,-8,27,0,-27,0.0,0.0,0.0,0.0,0.0,0.0
<a href=/player/kingd001>kingd001</a>,Dave Kingman,Chicago Cubs,CUBS,4,9,7,16,1981,1987,6,No,0,4.35,1.97,-2.38,1026,637,-389,2958,998,-1960,766.0,1115.0,349.0,873333.0,0.0,-873333.0
<a href=/player/kinge001>kinge001</a>,Eric King,San Francisco Giants,GIANTS,3,6,5,11,1985,1991,6,No,0,8.16,14.64,6.48,1129,850,-279,2301,1999,-302,2390.0,2023.0,-367.0,0.0,0.0,0.0
<a href=/player/kinge001>kinge001</a>,Eric King,Detroit Tigers,TIGRS,1,1,1,2,1989,1990,1,No,0,5.11,-1.56,-6.67,50,151,101,0,373,373,931.0,0.0,-931.0,0.0,0.0,0.0
<a href=/player/kinge001>kinge001</a>,Eric King,Chicago White Sox,WSOX,2,3,4,7,1990,1991,1,No,0,1.38,-0.4,-1.78,97,56,-41,54,126,72,701.0,15.0,-686.0,1315000.0,0.0,-1315000.0
<a href=/player/kingg001>kingg001</a>,Gene Kingsale,San Diego Padres,PADRS,1,1,1,2,2002,2003,1,No,0,-0.58,-0.41,0.17,39,19,-20,140,58,-82,0.0,0.0,0.0,0.0,0.0,0.0
<a href=/player/kingh102>kingh102</a>,Hal King,Houston Astros,ASTROS,8,15,11,26,1969,1989,20,No,0,9.86,19.8,9.94,2403,1970,-433,5583,4832,-751,5444.0,4390.0,-1054.0,22500.0,0.0,-22500.0
<a href=/player/kingh102>kingh102</a>,Hal King,Atlanta Braves,BRAVES,1,1,1,2,1971,1975,4,No,0,0.97,-1.91,-2.88,50,173,123,150,500,350,0.0,0.0,0.0,17500.0,0.0,-17500.0
<a href=/player/kingh102>kingh102</a>,Hal King,Texas Rangers,RNGRS,1,2,1,3,1972,1975,3,No,0,0.39,2.11,1.72,55,66,11,69,0,-69,0.0,589.0,589.0,20000.0,0.0,-20000.0
<a href=/player/kingj001>kingj001</a>,Jeff King,Pittsburgh Pirates,PIRATS,1,2,4,6,1996,2000,4,No,0,11.41,4.01,-7.4,460,303,-157,1938,501,-1437,0.0,260.0,260.0,7200000.0,0.0,-7200000.0
<a href=/player/kingj101>kingj101</a>,Jim King,Chicago Cubs,CUBS,1,1,2,3,1957,1957,0,No,0,-0.1,0.09,0.19,22,26,4,39,53,14,0.0,23.0,23.0,0.0,0.0,0.0
<a href=/player/kingj101>kingj101</a>,Jim King,St. Louis Cardinals,CARDS,1,1,1,2,1958,1958,0,No,0,0.21,-0.17,-0.38,34,19,-15,66,47,-19,0.0,0.0,0.0,0.0,0.0,0.0
<a href=/player/kingj101>kingj101</a>,Jim King,Washington Senators,RNGRS,6,9,6,15,1967,1977,10,No,0,-1.31,6.36,7.67,410,744,334,1041,1994,953,759.0,568.0,-191.0,0.0,0.0,0.0
<a href=/player/kingj101>kingj101</a>,Jim King,Chicago White Sox,WSOX,1,2,1,3,1967,1968,1,No,0,-0.19,0.06,0.25,19,60,41,22,220,198,0.0,0.0,0.0,25000.0,0.0,-25000.0
<a href=/player/kingl101>kingl101</a>,Lee King,Philadelphia Athletics,ATLTCS,1,1,1,2,1916,1916,0,No,0,0.0,0.1,0.1,0,14,14,0,49,49,0.0,0.0,0.0,0.0,0.0,0.0
<a href=/player/kingl103>kingl103</a>,Lee King,New York Giants,GIANTS,3,7,5,12,1921,1927,6,No,0,10.96,8.57,-2.39,1223,793,-430,4975,2790,-2185,0.0,87.0,87.0,29500.0,0.0,-29500.0
<a href=/player/kingm001>kingm001</a>,Mike Kingery,Kansas City Royals,ROYALS,4,8,7,15,1986,1994,8,No,2,22.08,13.31,-8.77,1163,870,-293,1083,3196,2113,6286.0,300.0,-5986.0,1438000.0,0.0,-1438000.0
<a href=/player/kingm002>kingm002</a>,Michael King,Miami Marlins,MARLNS,3,6,4,10,2017,2021,4,Yes,0,2.97,5.31,2.34,193,202,9,284,481,197,717.0,873.0,156.0,0.0,0.0,0.0
<a href=/player/kingr001>kingr001</a>,Ray King,Cincinnati Reds,REDS,2,3,2,5,1996,1997,1,No,0,0.1,0.89,0.79,322,92,-230,303,211,-92,259.0,0.0,-259.0,175000.0,0.0,-175000.0
<a href=/player/kingr001>kingr001</a>,Ray King,Atlanta Braves,BRAVES,1,1,1,2,1998,1999,1,No,0,-0.18,0.0,0.18,19,0,-19,1,0,-1,32.0,0.0,-32.0,0.0,0.0,0.0
<a href=/player/kingr001>kingr001</a>,Ray King,Chicago Cubs,CUBS,1,1,1,2,2000,2000,0,No,0,3.16,0.0,-3.16,406,0,-406,2,0,-2,464.0,0.0,-464.0,0.0,0.0,0.0
<a href=/player/kingr001>kingr001</a>,Ray King,Milwaukee Brewers,BREWRS,1,1,2,3,2002,2005,3,No,0,0.13,0.02,-0.11,157,367,210,0,1030,1030,177.0,63.0,-114.0,300000.0,0.0,-300000.0
<a href=/player/kingr001>kingr001</a>,Ray King,Atlanta Braves,BRAVES,2,5,3,8,2003,2005,2,No,0,48.74,10.63,-38.11,1422,247,-1175,1200,926,-274,9241.0,27.0,-9214.0,3968000.0,0.0,-3968000.0
<a href=/player/kingr001>kingr001</a>,Ray King,St. Louis Cardinals,CARDS,1,1,2,3,2005,2008,3,No,0,0.15,1.75,1.6,131,422,291,1,1356,1355,134.0,9.0,-125.0,1850000.0,0.0,-1850000.0
<a href=/player/kingr001>kingr001</a>,Ray King,Washington Nationals,NATEX,1,1,1,2,2007,2007,0,No,0,-0.02,0.0,0.02,24,0,-24,0,0,0,18.0,0.0,-18.0,850000.0,0.0,-850000.0
<a href=/player/kinkm001>kinkm001</a>,Mike Kinkade,Milwaukee Brewers,BREWRS,2,2,2,4,1998,2002,4,No,0,-0.42,0.24,0.66,37,235,198,57,531,474,20.0,436.0,416.0,0.0,0.0,0.0
<a href=/player/kinkm001>kinkm001</a>,Mike Kinkade,New York Mets,METS,1,4,1,5,2000,2000,0,No,0,28.33,0.16,-28.17,1330,56,-1274,5573,211,-5362,33.0,0.0,-33.0,210000.0,0.0,-210000.0
<a href=/player/kinnd101>kinnd101</a>,Dennis Kinney,Cleveland Indians,INDINS,2,2,2,4,1978,1984,6,No,0,1.04,8.89,7.85,216,294,78,17,0,-17,743.0,2348.0,1605.0,400000.0,0.0,-400000.0
<a href=/player/kinnd101>kinnd101</a>,Dennis Kinney,San Diego Padres,PADRS,2,2,2,4,1980,1981,1,No,0,-0.22,0.0,0.22,8,0,-8,0,0,0,11.0,0.0,-11.0,0.0,0.0,0.0
<a href=/player/kinnm001>kinnm001</a>,Mike Kinnunen,Minnesota Twins,TWINS,1,1,1,2,1981,1983,2,No,0,0.0,0.03,0.03,0,33,33,0,0,0,0.0,109.0,109.0,0.0,0.0,0.0
<a href=/player/kinnm001>kinnm001</a>,Mike Kinnunen,Montreal Expos,NATEX,1,2,1,3,1985,1985,0,No,0,0.0,0.55,0.55,0,68,68,0,209,209,0.0,0.0,0.0,0.0,0.0,0.0
<a href=/player/kinnm002>kinnm002</a>,Matt Kinney,Boston Red Sox,RSOX,4,10,6,16,1998,2008,10,No,2,10.55,21.23,10.68,969,325,-644,310,23,-287,3461.0,3027.0,-434.0,859000.0,0.0,-859000.0
<a href=/player/kinnm002>kinnm002</a>,Matt Kinney,Minnesota Twins,TWINS,1,2,2,4,2002,2002,0,No,0,-0.32,0.0,0.32,128,0,-128,72,0,-72,759.0,0.0,-759.0,0.0,0.0,0.0
<a href=/player/kinsb101>kinsb101</a>,Bob Kinsella,New York Giants,GIANTS,1,3,1,4,1920,1920,0,No,0,0.0,0.0,0.0,0,0,0,0,0,0,0.0,0.0,0.0,1800.0,0.0,-1800.0
<a href=/player/kinsi001>kinsi001</a>,Ian Kinsler,Texas Rangers,RNGRS,1,1,2,3,2013,2017,4,No,0,17.41,0.11,-17.3,607,289,-318,2693,1241,-1452,0.0,0.0,0.0,13000000.0,0.0,-13000000.0
<a href=/player/kinsi001>kinsi001</a>,Ian Kinsler,Detroit Tigers,TIGRS,1,1,2,3,2017,2017,0,Yes,0,2.51,0.0,-2.51,91,0,-91,391,0,-391,0.0,0.0,0.0,11000000.0,0.0,-11000000.0
<a href=/player/kinsi001>kinsi001</a>,Ian Kinsler,Anaheim Angels,ANGELS,2,3,3,6,2018,2019,1,Yes,0,0.03,-1.1,-1.13,49,44,-5,143,2,-141,20.0,182.0,162.0,11000000.0,0.0,-11000000.0
<a href=/player/kinst101>kinst101</a>,Tom Kinslow,Brooklyn Dodgers,DOGRS,1,1,1,2,1895,1895,0,No,0,-0.52,0.95,1.47,19,67,48,67,105,38,0.0,702.0,702.0,0.0,0.0,0.0
<a href=/player/kintb001>kintb001</a>,Brandon Kintzler,Minnesota Twins,TWINS,1,1,2,3,2017,2017,0,Yes,0,1.31,0.0,-1.31,141,0,-141,0,0,0,206.0,0.0,-206.0,2925000.0,0.0,-2925000.0
<a href=/player/kintb001>kintb001</a>,Brandon Kintzler,Washington Nationals,NATEX,1,1,1,2,2018,2018,0,Yes,0,1.17,0.0,-1.17,168,0,-168,1,0,-1,225.0,0.0,-225.0,5000000.0,0.0,-5000000.0
<a href=/player/kinzm001>kinzm001</a>,Matt Kinzer,St. Louis Cardinals,CARDS,1,2,3,5,1989,1989,0,No,0,-0.12,0.0,0.12,13,0,-13,34,0,-34,5.0,0.0,-5.0,0.0,0.0,0.0
<a href=/player/kippb001>kippb001</a>,Bob Kipper,California Angels,ANGELS,3,5,7,12,1985,1988,3,No,2,1.4,3.61,2.21,825,316,-509,630,678,48,1883.0,911.0,-972.0,800000.0,0.0,-800000.0
<a href=/player/kippf101>kippf101</a>,Fred Kipp,Los Angeles Dodgers,DOGRS,3,4,6,10,1960,1962,2,No,0,-0.51,0.05,0.56,43,34,-9,74,37,-37,13.0,0.0,-13.0,0.0,0.0,0.0
<a href=/player/kippt101>kippt101</a>,Thornton Kipper,Philadelphia Phillies,PHILS,1,4,4,8,1956,1956,0,No,0,0.0,0.0,0.0,0,0,0,0,0,0,0.0,0.0,0.0,0.0,0.0,0.0
<a href=/player/kirbc101>kirbc101</a>,Clay Kirby,San Diego Padres,PADRS,6,11,9,20,1973,1984,11,No,0,16.69,11.15,-5.54,1162,1282,120,3749,2918,-831,1553.0,2427.0,874.0,0.0,0.0,0.0
<a href=/player/kirbc101>kirbc101</a>,Clay Kirby,Cincinnati Reds,REDS,2,2,3,5,1975,1977,2,No,0,-1.91,0.41,2.32,89,118,29,143,233,90,236.0,0.0,-236.0,0.0,0.0,0.0
<a href=/player/kirbw001>kirbw001</a>,Wayne Kirby,St. Louis Cardinals,CARDS,1,1,1,2,1998,1998,0,No,0,-0.39,0.03,0.42,26,4,-22,33,2,-31,0.0,0.0,0.0,0.0,0.0,0.0
<a href=/player/kirkd101>kirkd101</a>,Don Kirkwood,California Angels,ANGELS,1,3,1,4,1977,1979,2,No,0,0.12,1.23,1.11,29,53,24,3,0,-3,151.0,726.0,575.0,0.0,0.0,0.0
<a href=/player/kirke101>kirke101</a>,Enos Kirkpatrick,Newark,Newark,1,1,1,2,1912,1912,0,No,0,0.1,0.0,-0.1,80,0,-80,200,0,-200,0.0,0.0,0.0,0.0,0.0,0.0
<a href=/player/kirke102>kirke102</a>,Ed Kirkpatrick,California Angels,ANGELS,4,9,7,16,1968,1990,22,No,0,52.18,61.82,9.64,2063,2537,474,5135,9859,4724,8249.0,1533.0,-6716.0,230000.0,0.0,-230000.0
<a href=/player/kirke102>kirke102</a>,Ed Kirkpatrick,Kansas City Royals,ROYALS,2,4,3,7,1973,1978,5,No,0,2.68,1.78,-0.9,438,157,-281,817,247,-570,955.0,645.0,-310.0,49000.0,0.0,-49000.0
<a href=/player/kirke102>kirke102</a>,Ed Kirkpatrick,Pittsburgh Pirates,PIRATS,1,1,1,2,1977,1978,1,No,0,-0.24,0.53,0.77,20,56,36,52,97,45,0.0,0.0,0.0,0.0,0.0,0.0
<a href=/player/kirke102>kirke102</a>,Ed Kirkpatrick,Texas Rangers,RNGRS,1,1,1,2,1977,1978,1,No,0,0.16,0.0,-0.16,29,0,-29,88,0,-88,0.0,0.0,0.0,0.0,0.0,0.0
<a href=/player/kirkw101>kirkw101</a>,Willie Kirkland,San Francisco Giants,GIANTS,4,7,5,12,1960,1968,8,No,0,1.33,3.3,1.97,705,765,60,1946,2705,759,636.0,0.0,-636.0,33000.0,0.0,-33000.0
<a href=/player/kirkw101>kirkw101</a>,Willie Kirkland,Cleveland Indians,INDINS,1,1,2,3,1963,1964,1,No,0,0.52,-0.9,-1.42,66,61,-5,172,147,-25,0.0,0.0,0.0,0.0,0.0,0.0
<a href=/player/kisir101>kisir101</a>,Rube Kisinger,Detroit Tigers,TIGRS,1,4,2,6,1903,1911,8,No,0,0.0,16.79,16.79,0,801,801,0,3453,3453,0.0,39.0,39.0,0.0,0.0,0.0
<a href=/player/kissb101>kissb101</a>,Bill Kissinger,Baltimore Orioles,BLN,1,2,1,3,1895,1895,0,No,0,-4.82,1.63,6.45,136,40,-96,276,66,-210,924.0,426.0,-498.0,0.0,0.0,0.0
<a href=/player/kitsf101>kitsf101</a>,Frank Kitson,Detroit Tigers,TIGRS,2,2,2,4,1905,1905,0,No,0,0.99,0.0,-0.99,107,0,-107,134,0,-134,966.0,0.0,-966.0,0.0,0.0,0.0
<a href=/player/kitta001>kitta001</a>,Andrew Kittredge,Seattle Mariners,MARNRS,1,3,2,5,2016,2018,2,No,0,1.91,-0.63,-2.54,161,100,-61,1,297,296,549.0,3.0,-546.0,0.0,0.0,0.0
<a href=/player/kittm101>kittm101</a>,Malachi Kittridge,Worcester,Worcester,1,1,1,2,1901,1901,0,No,0,3.14,0.0,-3.14,226,0,-226,830,0,-830,0.0,0.0,0.0,0.0,0.0,0.0
<a href=/player/kittr001>kittr001</a>,Ron Kittle,Chicago White Sox,WSOX,1,3,3,6,1986,1991,5,No,0,0.75,-0.11,-0.86,650,316,-334,1809,1056,-753,0.0,0.0,0.0,475000.0,0.0,-475000.0
<a href=/player/kittr001>kittr001</a>,Ron Kittle,Chicago White Sox,WSOX,1,1,1,2,1990,1990,0,No,0,-0.63,-0.07,0.56,22,45,23,64,162,98,0.0,0.0,0.0,550000.0,0.0,-550000.0
<a href=/player/kivlp001>kivlp001</a>,Patrick Kivlehan,Seattle Mariners,MARNRS,2,5,3,8,2015,2017,2,No,0,-1.06,0.95,2.01,37,177,140,16,698,682,66.0,0.0,-66.0,6250000.0,0.0,-6250000.0
<a href=/player/kivlp001>kivlp001</a>,Patrick Kivlehan,Texas Rangers,RNGRS,1,1,1,2,2016,2016,0,No,0,0.0,0.0,0.0,0,0,0,0,0,0,0.0,0.0,0.0,0.0,0.0,0.0
<a href=/player/klaeh101>klaeh101</a>,Hugo Klaerner,Savannah,Savannah,1,1,1,2,1941,1946,5,No,0,0.0,0.0,0.0,0,0,0,0,0,0,0.0,0.0,0.0,0.0,0.0,0.0
<a href=/player/klaub101>klaub101</a>,Billy Klaus,Milwaukee Braves,BRAVES,2,8,3,11,1954,1960,6,No,0,39.41,8.38,-31.03,1145,621,-524,1887,2335,448,6059.0,0.0,-6059.0,0.0,0.0,0.0
<a href=/player/klaub101>klaub101</a>,Billy Klaus,New York Giants,GIANTS,1,1,1,2,1954,1954,0,No,0,6.13,0.0,-6.13,458,0,-458,1860,0,-1860,0.0,0.0,0.0,0.0,0.0,0.0
<a href=/player/klaub101>klaub101</a>,Billy Klaus,Boston Red Sox,RSOX,1,1,1,2,1958,1960,2,No,0,1.54,-0.22,-1.76,150,62,-88,430,110,-320,0.0,0.0,0.0,0.0,0.0,0.0
<a href=/player/klaub102>klaub102</a>,Bobby Klaus,Cincinnati Reds,REDS,1,1,1,2,1964,1964,0,No,0,0.81,0.0,-0.81,175,0,-175,573,0,-573,0.0,0.0,0.0,0.0,0.0,0.0
<a href=/player/klaub102>klaub102</a>,Bobby Klaus,New York Mets,METS,1,3,1,4,1966,1966,0,No,0,-0.11,-0.09,0.02,10,31,21,19,96,77,0.0,0.0,0.0,0.0,0.0,0.0
<a href=/player/klaub102>klaub102</a>,Bobby Klaus,San Diego Padres,PADRS,3,4,4,8,1969,1971,2,No,0,-1.24,2.5,3.74,167,452,285,311,1178,867,100.0,445.0,345.0,0.0,0.0,0.0
<a href=/player/kleic101>kleic101</a>,Chuck Klein,FortWayne,FortWayne,1,1,1,2,1928,1928,0,No,0,37.14,0.0,-37.14,1405,0,-1405,5773,0,-5773,0.0,0.0,0.0,0.0,0.0,0.0
<a href=/player/kleic101>kleic101</a>,Chuck Klein,Philadelphia Phillies,PHILS,5,10,10,20,1933,1941,8,No,0,5.03,23.76,18.73,553,1116,563,2026,2685,659,324.0,2895.0,2571.0,17500.0,0.0,-17500.0
<a href=/player/kleic101>kleic101</a>,Chuck Klein,Chicago Cubs,CUBS,2,6,3,9,1936,1938,2,No,0,12.91,6.74,-6.17,1222,221,-1001,2483,534,-1949,3125.0,1054.0,-2071.0,0.0,0.0,0.0
<a href=/player/kleil101>kleil101</a>,Lou Klein,St. Louis Cardinals,CARDS,1,2,1,3,1949,1952,3,No,0,0.18,-0.58,-0.76,27,68,41,92,195,103,0.0,0.0,0.0,9000.0,0.0,-9000.0
<a href=/player/kleil101>kleil101</a>,Lou Klein,Cleveland Indians,INDINS,1,2,1,3,1951,1952,1,No,0,0.02,-0.66,-0.68,196,94,-102,612,273,-339,0.0,0.0,0.0,0.0,0.0,0.0
<a href=/player/kleir101>kleir101</a>,Red Kleinow,Toledo,Toledo,1,1,2,3,1904,1904,0,No,0,5.04,0.0,-5.04,522,0,-522,1684,0,-1684,0.0,0.0,0.0,0.0,0.0,0.0
<a href=/player/kleit101>kleit101</a>,Ted Kleinhans,Chicago Cubs,CUBS,3,10,4,14,1933,1938,5,No,0,12.44,14.42,1.98,1291,484,-807,2611,1630,-981,3141.0,1054.0,-2087.0,10000.0,0.0,-10000.0
<a href=/player/kleit101>kleit101</a>,Ted Kleinhans,Philadelphia Phillies,PHILS,1,3,2,5,1934,1941,7,No,0,-1.11,22.67,23.78,139,911,772,269,2270,2001,324.0,2379.0,2055.0,0.0,0.0,0.0
<a href=/player/klepe101>klepe101</a>,Ed Klepfer,Chicago White Sox,WSOX,1,4,1,5,1915,1915,0,No,0,12.78,0.79,-11.99,588,45,-543,1793,193,-1600,1219.0,0.0,-1219.0,0.0,0.0,0.0
<a href=/player/klepe101>klepe101</a>,Ed Klepfer,New York Yankees,YANKS,1,3,1,4,1911,1911,0,No,0,0.0,0.0,0.0,0,0,0,0,0,0,0.0,0.0,0.0,0.0,0.0,0.0
<a href=/player/klesr001>klesr001</a>,Ryan Klesko,Atlanta Braves,BRAVES,1,3,3,6,1999,2001,2,No,0,15.79,3.54,-12.25,961,377,-584,3858,1296,-2562,4.0,0.0,-4.0,7650000.0,0.0,-7650000.0
<a href=/player/kliee101>kliee101</a>,Ed Klieman,Cleveland Indians,INDINS,14,26,24,50,1948,1968,20,No,0,162.56,72.5,-90.06,7462,3103,-4359,23911,8852,-15059,13186.0,8500.0,-4686.0,30900.0,0.0,-30900.0
<a href=/player/kliee101>kliee101</a>,Ed Klieman,Chicago White Sox,WSOX,29,55,46,101,1949,1969,20,No,0,85.97,64.59,-21.38,7069,5405,-1664,17934,12236,-5698,13204.0,9922.0,-3282.0,288750.0,0.0,-288750.0
<a href=/player/kliml101>kliml101</a>,Lou Klimchock,Kansas City Athletics,ATLTCS,14,29,24,53,1961,1976,15,No,0,53.0,28.85,-24.15,5847,3256,-2591,13868,9788,-4080,6333.0,2140.0,-4193.0,393100.0,0.0,-393100.0
<a href=/player/kliml101>kliml101</a>,Lou Klimchock,Milwaukee Braves,BRAVES,4,5,8,13,1965,1971,6,No,0,0.93,-0.4,-1.33,225,245,20,724,738,14,0.0,0.0,0.0,0.0,0.0,0.0
<a href=/player/kliml101>kliml101</a>,Lou Klimchock,New York Mets,METS,1,2,1,3,1966,1968,2,No,0,-0.53,0.0,0.53,142,0,-142,357,0,-357,0.0,0.0,0.0,0.0,0.0,0.0
<a href=/player/klimr101>klimr101</a>,Ron Klimkowski,Boston Red Sox,RSOX,1,2,1,3,1967,1968,1,No,0,2.06,-0.63,-2.69,128,113,-15,32,358,326,431.0,0.0,-431.0,0.0,0.0,0.0
<a href=/player/klimr101>klimr101</a>,Ron Klimkowski,New York Yankees,YANKS,1,2,1,3,1971,1973,2,No,0,0.33,1.03,0.7,63,344,281,8,1145,1137,181.0,0.0,-181.0,0.0,0.0,0.0
<a href=/player/klinb103>klinb103</a>,Bob Kline,Boston Red Sox,RSOX,1,3,3,6,1933,1937,4,No,0,1.87,9.37,7.5,361,417,56,1356,657,-699,119.0,1357.0,1238.0,8500.0,0.0,-8500.0
<a href=/player/klinb104>klinb104</a>,Bobby Kline,Washington Senators,TWINS,6,9,11,20,1956,1962,6,No,0,3.55,-3.94,-7.49,344,1439,1095,915,4243,3328,381.0,450.0,69.0,21000.0,0.0,-21000.0
<a href=/player/klinj001>klinj001</a>,Joe Klink,New York Mets,METS,2,4,3,7,1986,1991,5,No,0,0.96,6.32,5.36,405,543,138,1082,1694,612,117.0,0.0,-117.0,637500.0,0.0,-637500.0
<a href=/player/klinj001>klinj001</a>,Joe Klink,Minnesota Twins,TWINS,1,1,1,2,1988,1988,0,No,0,0.83,0.0,-0.83,105,0,-105,0,0,0,305.0,0.0,-305.0,0.0,0.0,0.0
<a href=/player/klinj101>klinj101</a>,Johnny Kling,Chicago Cubs,CUBS,3,6,7,13,1911,1916,5,No,0,-3.91,1.45,5.36,376,507,131,960,1665,705,899.0,27.0,-872.0,4500.0,0.0,-4500.0
<a href=/player/klinj101>klinj101</a>,Johnny Kling,Boston Braves,BRAVES,1,1,2,3,1913,1914,1,No,0,1.29,1.26,-0.03,80,62,-18,226,167,-59,0.0,0.0,0.0,0.0,0.0,0.0
<a href=/player/klinr102>klinr102</a>,Ron Kline,Pittsburgh Pirates,PIRATS,3,3,4,7,1959,1963,4,No,0,3.0,3.01,0.01,287,428,141,298,861,563,1533.0,814.0,-719.0,0.0,0.0,0.0
<a href=/player/klinr102>klinr102</a>,Ron Kline,Washington Senators,RNGRS,18,40,31,71,1966,1988,22,No,0,51.31,65.52,14.21,3432,4169,737,10653,12193,1540,4752.0,9267.0,4515.0,592000.0,0.0,-592000.0
<a href=/player/klinr102>klinr102</a>,Ron Kline,Minnesota Twins,TWINS,1,1,1,2,1967,1968,1,No,0,1.02,0.0,-1.02,152,0,-152,24,0,-24,431.0,0.0,-431.0,35000.0,0.0,-35000.0
<a href=/player/klinr102>klinr102</a>,Ron Kline,Pittsburgh Pirates,PIRATS,1,1,1,2,1969,1970,1,No,0,-0.01,0.85,0.86,14,152,138,0,10,10,33.0,277.0,244.0,0.0,0.0,0.0
<a href=/player/klins001>klins001</a>,Scott Klingenbeck,Baltimore Orioles,ORLS,1,2,1,3,1995,2003,8,No,0,-1.6,13.23,14.83,28,211,183,0,27,27,231.0,3863.0,3632.0,109000.0,0.0,-109000.0
<a href=/player/klins002>klins002</a>,Steve Kline,Cleveland Indians,INDINS,6,8,9,17,1997,2003,6,No,0,3.28,5.94,2.66,1262,272,-990,1929,1,-1928,1607.0,1043.0,-564.0,9300000.0,0.0,-9300000.0
<a href=/player/klins002>klins002</a>,Steve Kline,Montreal Expos,NATEX,1,2,2,4,2000,2003,3,No,0,5.18,-3.67,-8.85,698,376,-322,77,830,753,1408.0,493.0,-915.0,3988333.0,0.0,-3988333.0
<a href=/player/klins002>klins002</a>,Steve Kline,Baltimore Orioles,ORLS,1,1,1,2,2005,2006,1,No,0,0.71,0.59,-0.12,279,63,-216,1,0,-1,293.0,181.0,-112.0,2500000.0,0.0,-2500000.0
<a href=/player/klins101>klins101</a>,Steve Kline,New York Yankees,YANKS,18,35,30,65,1974,2001,27,No,1,68.7,43.61,-25.09,4667,3496,-1171,10476,9633,-843,15153.0,7546.0,-7607.0,4780000.0,0.0,-4780000.0
<a href=/player/klipj101>klipj101</a>,Johnny Klippstein,Chicago Cubs,CUBS,3,6,6,12,1954,1961,7,No,0,3.29,2.06,-1.23,406,565,159,221,1460,1239,2057.0,7.0,-2050.0,0.0,0.0,0.0
<a href=/player/klipj101>klipj101</a>,Johnny Klippstein,Cincinnati Reds,REDS,1,4,1,5,1958,1960,2,No,0,0.85,9.64,8.79,265,190,-75,151,233,82,590.0,1314.0,724.0,14000.0,0.0,-14000.0
<a href=/player/klipj101>klipj101</a>,Johnny Klippstein,Washington Senators,RNGRS,1,2,2,4,1961,1963,2,No,0,1.4,0.77,-0.63,457,97,-360,839,291,-548,326.0,0.0,-326.0,0.0,0.0,0.0
<a href=/player/klubc001>klubc001</a>,Corey Kluber,San Diego Padres,PADRS,1,2,1,3,2010,2011,1,No,0,32.15,-0.64,-32.79,223,160,-63,30,664,634,4025.0,0.0,-4025.0,0.0,0.0,0.0
<a href=/player/klubc001>klubc001</a>,Corey Kluber,Cleveland Indians,INDINS,1,2,2,4,2019,2020,1,Yes,0,0.06,-0.03,-0.09,1,37,36,0,120,120,3.0,0.0,-3.0,17000000.0,0.0,-17000000.0
<a href=/player/klust101>klust101</a>,Ted Kluszewski,Cincinnati Reds,REDS,1,1,1,2,1957,1957,0,No,0,0.56,0.0,-0.56,160,0,-160,458,0,-458,0.0,0.0,0.0,40000.0,0.0,-40000.0
<a href=/player/klust101>klust101</a>,Ted Kluszewski,Pittsburgh Pirates,PIRATS,1,1,2,3,1959,1959,0,No,0,0.59,0.08,-0.51,112,9,-103,318,15,-303,0.0,0.0,0.0,0.0,0.0,0.0
<a href=/player/klutc101>klutc101</a>,Clyde Kluttz,Boston Braves,BRAVES,2,3,3,6,1945,1946,1,No,0,1.29,-0.96,-2.25,78,148,70,249,256,7,0.0,261.0,261.0,0.0,0.0,0.0
<a href=/player/klutc101>klutc101</a>,Clyde Kluttz,New York Giants,GIANTS,1,1,1,2,1946,1946,0,No,0,0.0,-0.61,-0.61,0,15,15,0,28,28,0.0,0.0,0.0,0.0,0.0,0.0
<a href=/player/klutc101>klutc101</a>,Clyde Kluttz,Philadelphia Phillies,PHILS,1,1,1,2,1946,1948,2,No,0,0.31,1.87,1.56,52,348,296,151,1271,1120,0.0,0.0,0.0,0.0,0.0,0.0
<a href=/player/klutm101>klutm101</a>,Mickey Klutts,New York Yankees,YANKS,8,15,13,28,1978,1992,14,No,0,6.29,14.79,8.5,1596,742,-854,3686,2169,-1517,2564.0,669.0,-1895.0,913333.0,0.0,-913333.0
<a href=/player/knapc101>knapc101</a>,Chris Knapp,Chicago White Sox,WSOX,8,12,15,27,1977,1997,20,No,0,45.63,32.75,-12.88,2200,2303,103,7990,6201,-1789,3475.0,5246.0,1771.0,1390000.0,0.0,-1390000.0
<a href=/player/knebc001>knebc001</a>,Corey Knebel,Detroit Tigers,TIGRS,2,3,2,5,2014,2021,7,No,0,0.73,1.99,1.26,58,412,354,0,1195,1195,80.0,156.0,76.0,7000000.0,0.0,-7000000.0
<a href=/player/knebc001>knebc001</a>,Corey Knebel,Texas Rangers,RNGRS,1,3,2,5,2015,2015,0,No,0,4.24,4.26,0.02,471,35,-436,105,4,-101,683.0,553.0,-130.0,0.0,0.0,0.0
<a href=/player/knebc001>knebc001</a>,Corey Knebel,Milwaukee Brewers,BREWRS,1,1,1,2,2020,2020,0,Yes,0,0.7,0.0,-0.7,53,0,-53,2,0,-2,77.0,0.0,-77.0,5125000.0,0.0,-5125000.0
<a href=/player/knepb001>knepb001</a>,Bob Knepper,San Francisco Giants,GIANTS,3,5,4,9,1980,1984,4,No,0,13.32,-1.81,-15.13,864,212,-652,1590,613,-977,5214.0,0.0,-5214.0,0.0,0.0,0.0
<a href=/player/knerl101>knerl101</a>,Lou Knerr,Philadelphia Athletics,ATLTCS,38,83,80,163,1947,1976,29,No,0,92.78,73.92,-18.86,10628,9649,-979,25815,29918,4103,12609.0,7417.0,-5192.0,507800.0,0.0,-507800.0
<a href=/player/knerl101>knerl101</a>,Lou Knerr,Toronto,Toronto,1,1,2,3,1944,1944,0,No,0,-2.22,0.0,2.22,115,0,-115,101,0,-101,835.0,0.0,-835.0,0.0,0.0,0.0
<a href=/player/knica001>knica001</a>,Alan Knicely,Houston Astros,ASTROS,1,1,2,3,1983,1986,3,No,0,-0.68,4.85,5.53,117,314,197,328,31,-297,0.0,776.0,776.0,0.0,0.0,0.0
<a href=/player/knica001>knica001</a>,Alan Knicely,Cincinnati Reds,REDS,1,3,2,5,1985,1989,4,No,0,0.22,4.93,4.71,144,460,316,269,1695,1426,243.0,0.0,-243.0,117500.0,0.0,-117500.0
<a href=/player/knicb101>knicb101</a>,Bill Knickerbocker,Cleveland Indians,INDINS,1,3,3,6,1937,1939,2,No,0,6.18,8.46,2.28,372,600,228,1331,2387,1056,1093.0,179.0,-914.0,0.0,0.0,0.0
<a href=/player/knicb101>knicb101</a>,Bill Knickerbocker,St.Louis Browns,ORLS,1,1,2,3,1938,1943,5,No,0,0.48,-4.11,-4.59,97,524,427,302,2039,1737,0.0,0.0,0.0,0.0,0.0,0.0
<a href=/player/knicb101>knicb101</a>,Bill Knickerbocker,New York Yankees,YANKS,1,1,1,2,1940,1948,8,No,0,0.74,0.16,-0.58,89,33,-56,397,83,-314,0.0,0.0,0.0,9000.0,0.0,-9000.0
<a href=/player/knigb001>knigb001</a>,Brandon Knight,Texas Rangers,RNGRS,1,2,1,3,1999,2001,2,No,0,-0.67,0.61,1.28,13,146,133,0,511,511,62.0,0.0,-62.0,0.0,0.0,0.0
<a href=/player/knigj102>knigj102</a>,John Knight,Washington Senators,TWINS,1,1,1,2,1912,1912,0,No,0,0.0,0.13,0.13,0,2,2,0,2,2,0.0,0.0,0.0,4000.0,0.0,-4000.0
<a href=/player/knigj102>knigj102</a>,John Knight,Philadelphia Athletics,ATLTCS,1,1,1,2,1907,1907,0,No,0,0.39,2.21,1.82,98,99,1,390,403,13,0.0,0.0,0.0,0.0,0.0,0.0
<a href=/player/knigj102>knigj102</a>,John Knight,Boston Red Sox,RSOX,1,2,1,3,1907,1907,0,No,0,0.0,0.02,0.02,0,4,4,0,5,5,0.0,30.0,30.0,0.0,0.0,0.0
<a href=/player/knigj102>knigj102</a>,John Knight,New York Yankees,YANKS,1,2,1,3,1912,1912,0,No,0,4.64,-0.55,-5.19,406,29,-377,1061,95,-966,0.0,0.0,0.0,0.0,0.0,0.0
<a href=/player/knigj102>knigj102</a>,John Knight,JerseyCity,JerseyCity,1,1,2,3,1913,1916,3,No,0,0.28,0.0,-0.28,70,0,-70,282,0,-282,0.0,0.0,0.0,0.0,0.0,0.0
<a href=/player/knigr001>knigr001</a>,Ray Knight,Cincinnati Reds,REDS,2,2,2,4,1981,1985,4,No,0,5.84,2.37,-3.47,419,429,10,1622,1575,-47,0.0,0.0,0.0,0.0,0.0,0.0
<a href=/player/knigr001>knigr001</a>,Ray Knight,Houston Astros,ASTROS,1,1,3,4,1984,1992,8,No,0,2.33,6.19,3.86,254,605,351,932,2016,1084,0.0,0.0,0.0,0.0,0.0,0.0
<a href=/player/knigr001>knigr001</a>,Ray Knight,Baltimore Orioles,ORLS,1,1,1,2,1988,1989,1,No,0,-1.01,-0.03,0.98,105,92,-13,327,0,-327,0.0,494.0,494.0,0.0,0.0,0.0
<a href=/player/knisp101>knisp101</a>,Pete Knisely,Cincinnati Reds,REDS,3,8,5,13,1912,1913,1,No,0,9.38,6.71,-2.67,842,270,-572,2287,704,-1583,1567.0,500.0,-1067.0,11280.0,0.0,-11280.0
<a href=/player/knobc001>knobc001</a>,Chuck Knoblauch,Minnesota Twins,TWINS,7,10,17,27,1998,2015,17,No,1,43.18,57.24,14.06,2387,3611,1224,8979,10997,2018,2380.0,7422.0,5042.0,18555000.0,0.0,-18555000.0
<a href=/player/knolh101>knolh101</a>,Hub Knolls,Chicago Cubs,CUBS,2,4,2,6,1906,1907,1,No,0,-0.02,0.08,0.1,4,78,74,2,146,144,20.0,415.0,395.0,0.0,0.0,0.0
<a href=/player/knoob101>knoob101</a>,Bobby Knoop,California Angels,ANGELS,4,8,8,16,1969,1990,21,No,0,45.31,70.62,25.31,1604,3274,1670,3577,13169,9592,8249.0,1415.0,-6834.0,212000.0,0.0,-212000.0
<a href=/player/knoob101>knoob101</a>,Bobby Knoop,Chicago White Sox,WSOX,1,1,2,3,1971,1971,0,No,0,-0.92,0.0,0.92,116,0,-116,287,0,-287,0.0,0.0,0.0,0.0,0.0,0.0
<a href=/player/knotf101>knotf101</a>,Fritz Knothe,Seattle,Seattle,1,1,2,3,1931,1933,2,No,0,0.8,0.0,-0.8,133,0,-133,561,0,-561,0.0,0.0,0.0,0.0,0.0,0.0
<a href=/player/knotf101>knotf101</a>,Fritz Knothe,Philadelphia Phillies,PHILS,2,5,2,7,1933,1934,1,No,0,0.0,-0.7,-0.7,0,28,28,0,32,32,0.0,115.0,115.0,0.0,0.0,0.0
<a href=/player/knotf101>knotf101</a>,Fritz Knothe,Boston Braves,BRAVES,3,4,4,8,1933,1938,5,No,0,5.87,7.69,1.82,599,982,383,2168,3856,1688,0.0,0.0,0.0,0.0,0.0,0.0
<a href=/player/knotg001>knotg001</a>,Gary Knotts,Florida Marlins,MARLNS,12,23,29,52,2003,2019,16,Yes,0,83.08,57.28,-25.8,2779,2940,161,6322,8392,2070,15065.0,6008.0,-9057.0,40718667.0,0.0,-40718667.0
<a href=/player/knotj102>knotj102</a>,Jack Knott,St.Louis Browns,ORLS,1,1,1,2,1938,1938,0,No,0,5.05,-0.37,-5.42,140,46,-94,175,18,-157,1317.0,189.0,-1128.0,6500.0,0.0,-6500.0
<a href=/player/knotj102>knotj102</a>,Jack Knott,Chicago White Sox,WSOX,1,1,1,2,1940,1947,7,No,0,-1.48,1.34,2.82,100,190,90,112,733,621,888.0,0.0,-888.0,8000.0,0.0,-8000.0
<a href=/player/knotj102>knotj102</a>,Jack Knott,Milwaukee,Milwaukee,1,2,3,5,1932,1932,0,No,0,3.6,0.0,-3.6,514,0,-514,595,0,-595,2467.0,0.0,-2467.0,0.0,0.0,0.0
<a href=/player/knowd101>knowd101</a>,Darold Knowles,Baltimore Orioles,ORLS,13,28,25,53,1965,1994,29,No,3,56.99,119.52,62.53,3157,5392,2235,5411,14197,8786,13047.0,15470.0,2423.0,940333.0,0.0,-940333.0
<a href=/player/knowd101>knowd101</a>,Darold Knowles,Philadelphia Phillies,PHILS,2,3,2,5,1966,1969,3,No,0,9.35,1.64,-7.71,553,215,-338,133,649,516,1272.0,0.0,-1272.0,10500.0,0.0,-10500.0
<a href=/player/knowd101>knowd101</a>,Darold Knowles,Washington Senators,RNGRS,15,28,30,58,1971,1992,21,No,2,67.34,36.18,-31.16,3624,2189,-1435,6695,5567,-1128,11858.0,4741.0,-7117.0,245000.0,0.0,-245000.0
<a href=/player/knowd101>knowd101</a>,Darold Knowles,Oakland Athletics,ATLTCS,1,3,1,4,1974,1976,2,No,0,1.24,1.92,0.68,1157,275,-882,3065,1015,-2050,578.0,0.0,-578.0,69800.0,0.0,-69800.0
<a href=/player/knowd101>knowd101</a>,Darold Knowles,Chicago Cubs,CUBS,1,1,2,3,1977,1979,2,No,0,0.49,-0.19,-0.68,42,220,178,0,533,533,151.0,0.0,-151.0,0.0,0.0,0.0
<a href=/player/knudm001>knudm001</a>,Mark Knudson,Houston Astros,ASTROS,2,3,2,5,1986,1990,4,No,1,4.82,13.16,8.34,196,416,220,0,208,208,2588.0,2180.0,-408.0,0.0,0.0,0.0
<a href=/player/kobej001>kobej001</a>,Jeff Kobernus,Boston Red Sox,RSOX,1,1,1,2,2012,2012,0,No,0,0.0,0.0,0.0,0,0,0,0,0,0,0.0,0.0,0.0,0.0,0.0,0.0
<a href=/player/kobek101>kobek101</a>,Kevin Kobel,New York Mets,METS,1,1,1,2,1980,1980,0,No,0,0.0,0.0,0.0,0,0,0,0,0,0,0.0,0.0,0.0,0.0,0.0,0.0
<a href=/player/kochb001>kochb001</a>,Billy Koch,Toronto Blue Jays,BJAYS,1,1,2,3,2001,2006,5,No,0,1.81,6.6,4.79,90,702,612,0,2561,2561,281.0,559.0,278.0,733333.0,0.0,-733333.0
<a href=/player/kochb001>kochb001</a>,Billy Koch,Oakland Athletics,ATLTCS,4,8,8,16,2002,2012,10,No,2,15.18,3.42,-11.76,801,269,-532,480,656,176,4974.0,275.0,-4699.0,2433333.0,0.0,-2433333.0
<a href=/player/kochb001>kochb001</a>,Billy Koch,Chicago White Sox,WSOX,1,1,2,3,2004,2005,1,No,0,0.26,0.33,0.07,45,19,-26,0,46,46,77.0,0.0,-77.0,6375000.0,0.0,-6375000.0
<a href=/player/kochm001>kochm001</a>,Matt Koch,New York Mets,METS,3,8,7,15,2015,2018,3,Yes,0,0.7,4.78,4.08,291,310,19,600,0,-600,833.0,459.0,-374.0,24250000.0,0.0,-24250000.0
<a href=/player/koegp101>koegp101</a>,Pete Koegel,Oakland Athletics,ATLTCS,1,2,1,3,1969,1969,0,No,0,-0.03,-0.27,-0.24,41,24,-17,30,3,-27,153.0,57.0,-96.0,0.0,0.0,0.0
<a href=/player/koegp101>koegp101</a>,Pete Koegel,Milwaukee Brewers,BREWRS,4,7,4,11,1971,1976,5,No,0,4.46,14.89,10.43,682,733,51,2218,2738,520,335.0,0.0,-335.0,159600.0,0.0,-159600.0
<a href=/player/koegp101>koegp101</a>,Pete Koegel,Philadelphia Phillies,PHILS,1,1,1,2,1973,1973,0,No,0,0.0,0.0,0.0,0,0,0,0,0,0,0.0,0.0,0.0,0.0,0.0,0.0
<a href=/player/koehp101>koehp101</a>,Pip Koehler,New York Giants,GIANTS,1,2,1,3,1926,1933,7,No,0,0.0,0.0,0.0,0,0,0,0,0,0,0.0,0.0,0.0,0.0,0.0,0.0
<a href=/player/koeht001>koeht001</a>,Tom Koehler,Miami Marlins,MARLNS,1,2,1,3,2017,2017,0,Yes,0,0.48,0.0,-0.48,15,0,-15,0,0,0,51.0,0.0,-51.0,5750000.0,0.0,-5750000.0
<a href=/player/koenl101>koenl101</a>,Len Koenecke,Indianapolis,Indianapolis,2,3,7,10,1931,1936,5,No,0,2.11,0.0,-2.11,355,0,-355,1256,0,-1256,0.0,0.0,0.0,0.0,0.0,0.0
<a href=/player/koenm101>koenm101</a>,Mark Koenig,StPaul,StPaul,6,8,15,23,1925,1930,5,No,0,7.08,0.0,-7.08,1228,0,-1228,4402,0,-4402,611.0,0.0,-611.0,0.0,0.0,0.0
<a href=/player/koenm101>koenm101</a>,Mark Koenig,New York Yankees,YANKS,1,2,3,5,1930,1931,1,No,0,-1.14,0.55,1.69,271,146,-125,761,467,-294,731.0,97.0,-634.0,25000.0,0.0,-25000.0
<a href=/player/koenm101>koenm101</a>,Mark Koenig,Chicago Cubs,CUBS,3,10,4,14,1933,1938,5,No,0,12.44,14.42,1.98,1291,484,-807,2611,1630,-981,3141.0,1054.0,-2087.0,10000.0,0.0,-10000.0
<a href=/player/koenm101>koenm101</a>,Mark Koenig,Philadelphia Phillies,PHILS,3,6,4,10,1933,1935,2,No,0,-1.54,1.56,3.1,151,136,-15,661,287,-374,0.0,500.0,500.0,0.0,0.0,0.0
<a href=/player/koenm101>koenm101</a>,Mark Koenig,Cincinnati Reds,REDS,3,4,5,9,1934,1942,8,No,0,0.78,14.44,13.66,253,956,703,577,3608,3031,264.0,0.0,-264.0,23000.0,0.0,-23000.0
<a href=/player/kokod101>kokod101</a>,Dick Kokos,Cleveland Indians,INDINS,1,4,2,6,1947,1949,2,No,0,3.17,0.88,-2.29,606,121,-485,1943,303,-1640,368.0,217.0,-151.0,0.0,0.0,0.0
<a href=/player/kokod101>kokod101</a>,Dick Kokos,Baltimore Orioles,ORLS,5,10,10,20,1954,1960,6,No,0,15.05,10.79,-4.26,745,954,209,1673,2729,1056,2291.0,1208.0,-1083.0,10000.0,0.0,-10000.0
<a href=/player/kolaa001>kolaa001</a>,Adam Kolarek,Tampa Bay Devil Rays,RAYS,1,1,1,2,2019,2019,0,Yes,0,1.05,0.0,-1.05,72,0,-72,0,0,0,92.0,0.0,-92.0,560800.0,0.0,-560800.0
<a href=/player/kolaa001>kolaa001</a>,Adam Kolarek,Los Angeles Dodgers,DOGRS,1,2,2,4,2021,2021,0,Yes,0,-0.38,-0.48,-0.1,13,33,20,0,66,66,27.0,0.0,-27.0,0.0,0.0,0.0
<a href=/player/kolbb001>kolbb001</a>,Brandon Kolb,San Diego Padres,PADRS,1,2,2,4,2000,2001,1,No,0,-1.16,-0.17,0.99,82,43,-39,8,97,89,184.0,0.0,-184.0,230000.0,0.0,-230000.0
<a href=/player/kolbd001>kolbd001</a>,Danny Kolb,Milwaukee Brewers,BREWRS,2,2,3,5,2004,2007,3,No,0,-1.69,0.62,2.31,138,166,28,1,2,1,215.0,298.0,83.0,1500000.0,0.0,-1500000.0
<a href=/player/kolbd001>kolbd001</a>,Danny Kolb,Atlanta Braves,BRAVES,1,1,1,2,2005,2006,1,No,0,-0.04,0.0,0.04,105,0,-105,0,0,0,145.0,0.0,-145.0,3400000.0,0.0,-3400000.0
<a href=/player/kolbg101>kolbg101</a>,Gary Kolb,St. Louis Cardinals,CARDS,12,25,20,45,1964,1972,8,No,0,30.8,2.13,-28.67,3297,763,-2534,8519,1730,-6789,1865.0,703.0,-1162.0,32500.0,0.0,-32500.0
<a href=/player/kolbg101>kolbg101</a>,Gary Kolb,Milwaukee Braves,BRAVES,1,1,1,2,1965,1965,0,No,0,-0.85,-0.11,0.74,40,31,-9,94,57,-37,0.0,0.0,0.0,0.0,0.0,0.0
<a href=/player/kolbg101>kolbg101</a>,Gary Kolb,New York Mets,METS,1,2,2,4,1966,1970,4,No,0,1.41,1.94,0.53,188,298,110,235,385,150,516.0,1427.0,911.0,0.0,0.0,0.0
<a href=/player/kolld101>kolld101</a>,Don Kolloway,OklahomaCity,OklahomaCity,1,1,3,4,1939,1939,0,No,0,2.8,0.0,-2.8,683,0,-683,2785,0,-2785,0.0,0.0,0.0,0.0,0.0,0.0
<a href=/player/kolld101>kolld101</a>,Don Kolloway,Chicago White Sox,WSOX,2,3,2,5,1949,1950,1,No,0,-0.26,-0.26,0.0,394,112,-282,1460,440,-1020,0.0,0.0,0.0,10000.0,0.0,-10000.0
<a href=/player/kolld101>kolld101</a>,Don Kolloway,Detroit Tigers,TIGRS,1,1,1,2,1953,1953,0,No,0,-0.03,-0.29,-0.26,2,22,20,1,41,40,0.0,0.0,0.0,0.0,0.0,0.0
<a href=/player/kolpr101>kolpr101</a>,Ray Kolp,St.Louis Browns,ORLS,1,4,1,5,1925,1928,3,No,0,0.0,-0.47,-0.47,0,145,145,0,462,462,0.0,0.0,0.0,0.0,0.0,0.0
<a href=/player/kolsh101>kolsh101</a>,Hal Kolstad,Boston Red Sox,RSOX,8,15,16,31,1965,1977,12,No,0,34.3,15.16,-19.14,1704,1184,-520,5095,2722,-2373,3875.0,4100.0,225.0,155000.0,0.0,-155000.0
<a href=/player/komae001>komae001</a>,Erik Komatsu,Milwaukee Brewers,BREWRS,1,1,1,2,2011,2011,0,No,0,0.0,0.99,0.99,0,45,45,0,138,138,0.0,0.0,0.0,0.0,0.0,0.0
<a href=/player/kommb001>kommb001</a>,Brad Komminsk,Atlanta Braves,BRAVES,2,2,2,4,1987,1991,4,No,0,0.67,5.03,4.36,165,518,353,568,1860,1292,0.0,0.0,0.0,400000.0,0.0,-400000.0
<a href=/player/kommf101>kommf101</a>,Fred Kommers,Springfield,Springfield,1,1,1,2,1913,1914,1,No,0,-0.54,0.0,0.54,40,0,-40,169,0,-169,0.0,0.0,0.0,0.0,0.0,0.0
<a href=/player/konee101>konee101</a>,Ed Konetchy,St. Louis Cardinals,CARDS,1,3,5,8,1913,1920,7,No,0,9.94,10.5,0.56,493,813,320,1225,2891,1666,2306.0,795.0,-1511.0,13500.0,0.0,-13500.0
<a href=/player/konep001>konep001</a>,Paul Konerko,Los Angeles Dodgers,DOGRS,1,2,1,3,1998,2001,3,No,0,-0.12,3.63,3.75,362,466,104,111,0,-111,591.0,706.0,115.0,170000.0,0.0,-170000.0
<a href=/player/konep001>konep001</a>,Paul Konerko,Cincinnati Reds,REDS,3,7,4,11,1998,2013,15,No,0,47.91,21.42,-26.49,2964,1586,-1378,11936,4589,-7347,381.0,721.0,340.0,8282695.0,0.0,-8282695.0
<a href=/player/konnm101>konnm101</a>,Mike Konnick,Wilkes-Barre,Wilkes-Barre,1,1,2,3,1909,1909,0,No,0,-0.03,0.0,0.03,3,0,-3,10,0,-10,0.0,0.0,0.0,0.0,0.0,0.0
<a href=/player/konsj101>konsj101</a>,Jim Konstanty,Cincinnati Reds,REDS,1,2,1,3,1946,1947,1,No,0,-0.01,0.38,0.39,20,72,52,3,235,232,46.0,0.0,-46.0,0.0,0.0,0.0
<a href=/player/kontg001>kontg001</a>,George Kontos,New York Yankees,YANKS,2,2,2,4,2012,2013,1,Yes,0,3.19,0.83,-2.36,771,164,-607,593,497,-96,929.0,0.0,-929.0,515100.0,0.0,-515100.0
<a href=/player/koobe101>koobe101</a>,Ernie Koob,St.Louis Browns,ORLS,1,2,1,3,1920,1920,0,No,0,0.0,5.97,5.97,0,76,76,0,110,110,0.0,806.0,806.0,0.0,0.0,0.0
<a href=/player/koong001>koong001</a>,Graham Koonce,Kansas City Royals,ROYALS,1,1,1,2,2007,2007,0,No,0,0.0,0.0,0.0,0,0,0,0,0,0,0.0,0.0,0.0,0.0,0.0,0.0
<a href=/player/koosj001>koosj001</a>,Jerry Koosman,New York Mets,METS,9,20,14,34,1978,1993,15,No,2,96.4,33.36,-63.04,2897,1789,-1108,3255,2435,-820,16305.0,6137.0,-10168.0,4561000.0,0.0,-4561000.0
<a href=/player/koosj001>koosj001</a>,Jerry Koosman,Minnesota Twins,TWINS,3,4,6,10,1981,1985,4,No,0,3.07,0.85,-2.22,87,223,136,0,727,727,1110.0,0.0,-1110.0,0.0,0.0,0.0
<a href=/player/koosj001>koosj001</a>,Jerry Koosman,Chicago White Sox,WSOX,1,1,1,2,1984,1985,1,No,0,2.71,1.34,-1.37,110,53,-57,126,1,-125,970.0,219.0,-751.0,0.0,0.0,0.0
<a href=/player/kopag101>kopag101</a>,George Kopacz,Atlanta Braves,BRAVES,1,1,1,2,1969,1969,0,No,0,-0.12,0.0,0.12,10,0,-10,17,0,-17,0.0,0.0,0.0,0.0,0.0,0.0
<a href=/player/kopag101>kopag101</a>,George Kopacz,Pittsburgh Pirates,PIRATS,1,1,1,2,1973,1973,0,No,0,0.0,0.0,0.0,0,0,0,0,0,0,0.0,0.0,0.0,0.0,0.0,0.0
<a href=/player/kopem001>kopem001</a>,Michael Kopech,Boston Red Sox,RSOX,1,4,1,5,2016,2016,0,Yes,0,14.34,0.0,-14.34,583,0,-583,2288,0,-2288,251.0,0.0,-251.0,0.0,0.0,0.0
<a href=/player/kopfl101>kopfl101</a>,Larry Kopf,Cincinnati Reds,REDS,1,2,1,3,1922,1922,0,No,0,0.41,-0.04,-0.45,383,2,-381,879,1,-878,1636.0,3.0,-1633.0,0.0,0.0,0.0
<a href=/player/koplm001>koplm001</a>,Mike Koplove,Pittsburgh Pirates,PIRATS,1,1,1,2,2009,2009,0,No,0,0.0,0.0,0.0,0,0,0,0,0,0,0.0,0.0,0.0,0.0,0.0,0.0
<a href=/player/koppj101>koppj101</a>,Joe Koppe,Milwaukee Braves,BRAVES,2,4,4,8,1959,1964,5,No,0,9.25,-0.88,-10.13,355,69,-286,908,184,-724,1090.0,0.0,-1090.0,0.0,0.0,0.0
<a href=/player/koppj101>koppj101</a>,Joe Koppe,Philadelphia Phillies,PHILS,7,14,15,29,1961,1979,18,No,0,36.73,77.38,40.65,2596,3152,556,7221,9470,2249,6229.0,10159.0,3930.0,74500.0,0.0,-74500.0
<a href=/player/koppj101>koppj101</a>,Joe Koppe,Los Angeles Dodgers,DOGRS,1,1,1,2,1961,1962,1,No,0,0.0,0.0,0.0,0,0,0,0,0,0,0.0,0.0,0.0,0.0,0.0,0.0
<a href=/player/koppm101>koppm101</a>,Merlin Kopp,Boston Red Sox,RSOX,22,48,61,109,1917,1937,20,No,0,205.66,131.1,-74.56,9653,6423,-3230,27902,20755,-7147,27230.0,14799.0,-12431.0,136800.0,0.0,-136800.0
<a href=/player/koppm101>koppm101</a>,Merlin Kopp,Philadelphia Athletics,ATLTCS,1,3,1,4,1919,1921,2,No,0,0.0,-1.44,-1.44,0,50,50,0,86,86,0.0,133.0,133.0,0.0,0.0,0.0
<a href=/player/koreb001>koreb001</a>,Bobby Korecky,Philadelphia Phillies,PHILS,1,3,1,4,2003,2004,1,No,0,19.34,1.44,-17.9,901,67,-834,2722,75,-2647,2374.0,603.0,-1771.0,610000.0,0.0,-610000.0
<a href=/player/koroj001>koroj001</a>,John Koronka,Cincinnati Reds,REDS,1,1,1,2,2003,2004,1,No,0,-0.3,-0.01,0.29,8,168,160,5,1,-4,47.0,241.0,194.0,0.0,0.0,0.0
<a href=/player/koroj001>koroj001</a>,John Koronka,Chicago Cubs,CUBS,4,7,7,14,2006,2013,7,No,0,13.94,1.01,-12.93,1170,453,-717,3302,221,-3081,1125.0,1062.0,-63.0,732500.0,0.0,-732500.0
<a href=/player/kosca101>kosca101</a>,Andy Kosco,New York Yankees,YANKS,2,2,2,4,1968,1974,6,No,0,-1.51,-2.01,-0.5,213,245,32,681,193,-488,150.0,1691.0,1541.0,0.0,0.0,0.0
<a href=/player/kosca101>kosca101</a>,Andy Kosco,Los Angeles Dodgers,DOGRS,1,1,1,2,1971,1977,6,No,0,0.68,5.16,4.48,98,340,242,290,308,18,0.0,2693.0,2693.0,0.0,0.0,0.0
<a href=/player/kosca101>kosca101</a>,Andy Kosco,Milwaukee Brewers,BREWRS,1,1,1,2,1972,1972,0,No,0,0.5,0.03,-0.47,49,72,23,151,141,-10,0.0,0.0,0.0,0.0,0.0,0.0
<a href=/player/kosca101>kosca101</a>,Andy Kosco,California Angels,ANGELS,3,5,4,9,1972,1976,4,No,0,2.68,3.35,0.67,419,169,-250,1462,595,-867,0.0,0.0,0.0,65500.0,0.0,-65500.0
<a href=/player/kosca101>kosca101</a>,Andy Kosco,Boston Red Sox,RSOX,1,2,1,3,1973,1973,0,No,0,0.47,0.0,-0.47,189,0,-189,309,0,-309,0.0,0.0,0.0,0.0,0.0,0.0
<a href=/player/koskc001>koskc001</a>,Corey Koskie,Toronto Blue Jays,BJAYS,1,1,1,2,2006,2009,3,No,0,1.11,0.72,-0.39,76,75,-1,289,0,-289,0.0,248.0,248.0,0.0,0.0,0.0
<a href=/player/kostf101>kostf101</a>,Frank Kostro,Detroit Tigers,TIGRS,2,5,3,8,1963,1967,4,No,0,-0.97,-0.32,0.65,448,297,-151,1059,675,-384,218.0,314.0,96.0,32800.0,0.0,-32800.0
<a href=/player/kostf101>kostf101</a>,Frank Kostro,Los Angeles Angels,ANGELS,4,6,6,12,1964,1968,4,No,0,-0.55,3.52,4.07,404,392,-12,532,716,184,443.0,1270.0,827.0,44000.0,0.0,-44000.0
<a href=/player/kotcc001>kotcc001</a>,Casey Kotchman,Anaheim Angels,ANGELS,3,7,4,11,2008,2012,4,No,2,13.8,10.21,-3.59,628,138,-490,1008,245,-763,4323.0,1527.0,-2796.0,5150000.0,0.0,-5150000.0
<a href=/player/kotcc001>kotcc001</a>,Casey Kotchman,Atlanta Braves,BRAVES,1,1,1,2,2009,2009,0,No,0,0.16,1.99,1.83,39,57,18,95,242,147,0.0,0.0,0.0,2885000.0,0.0,-2885000.0
<a href=/player/kotcc001>kotcc001</a>,Casey Kotchman,Boston Red Sox,RSOX,1,1,2,3,2010,2010,0,No,0,-0.77,1.78,2.55,125,120,-5,457,382,-75,0.0,3.0,3.0,0.0,0.0,0.0
<a href=/player/kotsm001>kotsm001</a>,Mark Kotsay,Florida Marlins,MARLNS,8,11,19,30,2001,2013,12,No,0,78.22,23.68,-54.54,3802,1869,-1933,11801,2165,-9636,3483.0,6395.0,2912.0,18420219.0,0.0,-18420219.0
<a href=/player/kotsm001>kotsm001</a>,Mark Kotsay,San Diego Padres,PADRS,5,10,9,19,2003,2010,7,No,2,6.18,5.23,-0.95,622,504,-118,2612,1391,-1221,24.0,273.0,249.0,12382300.0,0.0,-12382300.0
<a href=/player/kotsm001>kotsm001</a>,Mark Kotsay,Oakland Athletics,ATLTCS,1,1,2,3,2008,2012,4,No,0,1.01,2.34,1.33,88,73,-15,345,0,-345,0.0,206.0,206.0,0.0,0.0,0.0
<a href=/player/kotsm001>kotsm001</a>,Mark Kotsay,Atlanta Braves,BRAVES,1,1,1,2,2008,2008,0,No,0,-0.79,0.0,0.79,49,0,-49,170,0,-170,0.0,0.0,0.0,7000000.0,0.0,-7000000.0
<a href=/player/kotsm001>kotsm001</a>,Mark Kotsay,Boston Red Sox,RSOX,1,1,1,2,2009,2009,0,No,0,-0.65,-0.1,0.55,147,21,-126,486,21,-465,0.0,0.0,0.0,1500000.0,0.0,-1500000.0
<a href=/player/kottg001>kottg001</a>,George Kottaras,San Diego Padres,PADRS,1,1,1,2,2006,2007,1,No,0,-0.21,-0.26,-0.05,48,54,6,112,50,-62,0.0,441.0,441.0,0.0,0.0,0.0
<a href=/player/kottg001>kottg001</a>,George Kottaras,Milwaukee Brewers,BREWRS,1,1,1,2,2012,2013,1,No,0,0.32,0.0,-0.32,27,0,-27,93,0,-93,0.0,0.0,0.0,700000.0,0.0,-700000.0
<a href=/player/koupl101>koupl101</a>,Lou Koupal,Brooklyn Dodgers,DOGRS,1,1,1,2,1929,1929,0,No,0,0.08,0.03,-0.05,56,4,-52,46,1,-45,373.0,11.0,-362.0,5500.0,0.0,-5500.0
<a href=/player/koupl101>koupl101</a>,Lou Koupal,Seattle,Seattle,1,1,2,3,1937,1937,0,No,0,-0.76,0.0,0.76,52,0,-52,35,0,-35,317.0,0.0,-317.0,0.0,0.0,0.0
<a href=/player/kouzk001>kouzk001</a>,Kevin Kouzmanoff,Cleveland Indians,INDINS,1,2,1,3,2006,2009,3,No,0,5.38,-0.48,-5.86,440,159,-281,1775,497,-1278,0.0,0.0,0.0,0.0,0.0,0.0
<a href=/player/kouzk001>kouzk001</a>,Kevin Kouzmanoff,San Diego Padres,PADRS,3,4,4,8,2010,2013,3,No,0,5.05,1.13,-3.92,706,243,-463,2175,585,-1590,34.0,54.0,20.0,0.0,0.0,0.0
<a href=/player/kowaf101>kowaf101</a>,Fabian Kowalik,Chicago Cubs,CUBS,2,6,3,9,1936,1938,2,No,0,12.91,6.74,-6.17,1222,221,-1001,2483,534,-1949,3125.0,1054.0,-2071.0,0.0,0.0,0.0
<a href=/player/koy-e101>koy-e101</a>,Ernie Koy,Brooklyn Dodgers,DOGRS,1,5,2,7,1940,1946,6,No,0,2.24,22.24,20.0,200,770,570,485,2187,1702,487.0,3020.0,2533.0,0.0,0.0,0.0
<a href=/player/kozaa101>kozaa101</a>,Al Kozar,Boston Red Sox,RSOX,5,13,10,23,1947,1956,9,No,0,13.4,14.7,1.3,2053,1460,-593,7010,4777,-2233,1880.0,1611.0,-269.0,136000.0,0.0,-136000.0
<a href=/player/kozaa101>kozaa101</a>,Al Kozar,Washington Senators,TWINS,12,23,24,47,1950,1963,13,No,0,21.31,19.51,-1.8,2117,2519,402,6320,5694,-626,2404.0,6282.0,3878.0,32000.0,0.0,-32000.0
<a href=/player/kozlb001>kozlb001</a>,Ben Kozlowski,Atlanta Braves,BRAVES,3,6,4,10,2002,2013,11,No,0,-3.28,26.79,30.07,88,575,487,55,584,529,265.0,4939.0,4674.0,370000.0,0.0,-370000.0
<a href=/player/kozlb001>kozlb001</a>,Ben Kozlowski,Cincinnati Reds,REDS,1,1,1,2,2006,2015,9,Yes,0,0.0,-0.15,-0.15,0,2,2,0,5,5,0.0,0.0,0.0,0.0,0.0,0.0
<a href=/player/krakj101>krakj101</a>,Joe Krakauskas,Washington Senators,TWINS,1,1,1,2,1940,1941,1,No,0,-1.24,-0.27,0.97,88,28,-60,25,121,96,285.0,0.0,-285.0,0.0,0.0,0.0
<a href=/player/kralj101>kralj101</a>,Jack Kralick,Minnesota Twins,TWINS,2,2,3,5,1963,1973,10,No,0,9.86,29.14,19.28,269,766,497,180,681,501,2242.0,5804.0,3562.0,0.0,0.0,0.0
<a href=/player/kramj101>kramj101</a>,Jack Kramer,St.Louis Browns,ORLS,54,128,140,268,1947,1994,47,No,3,236.61,240.84,4.23,15655,22232,6577,39533,64017,24484,40519.0,30415.0,-10104.0,1142083.0,0.0,-1142083.0
<a href=/player/kramk001>kramk001</a>,Kevin Kramer,Pittsburgh Pirates,PIRATS,1,1,1,2,2021,2021,0,Yes,0,0.0,0.0,0.0,0,0,0,0,0,0,0.0,0.0,0.0,0.0,0.0,0.0
<a href=/player/kramr001>kramr001</a>,Randy Kramer,Texas Rangers,RNGRS,1,1,1,2,1986,1986,0,No,0,-0.49,0.0,0.49,106,0,-106,42,0,-42,441.0,0.0,-441.0,0.0,0.0,0.0
<a href=/player/kramr001>kramr001</a>,Randy Kramer,Pittsburgh Pirates,PIRATS,1,1,1,2,1990,1990,0,No,0,0.14,0.0,-0.14,20,0,-20,2,0,-2,61.0,0.0,-61.0,150000.0,0.0,-150000.0
<a href=/player/kramt001>kramt001</a>,Tom Kramer,Cleveland Indians,INDINS,1,1,1,2,1994,1994,0,No,0,0.0,0.0,0.0,0,0,0,0,0,0,0.0,0.0,0.0,0.0,0.0,0.0
<a href=/player/krate001>krate001</a>,Erik Kratz,Philadelphia Phillies,PHILS,1,2,1,3,2013,2014,1,No,0,0.38,-0.1,-0.48,46,4,-42,84,0,-84,37.0,7.0,-30.0,496000.0,0.0,-496000.0
<a href=/player/krate001>krate001</a>,Erik Kratz,Toronto Blue Jays,BJAYS,1,2,1,3,2014,2015,1,No,0,-0.13,0.39,0.52,23,108,85,36,338,302,58.0,0.0,-58.0,510200.0,0.0,-510200.0
<a href=/player/krate001>krate001</a>,Erik Kratz,San Diego Padres,PADRS,1,1,1,2,2016,2016,0,No,0,-0.55,0.0,0.55,15,0,-15,30,0,-30,3.0,0.0,-3.0,0.0,0.0,0.0
<a href=/player/krate001>krate001</a>,Erik Kratz,New York Yankees,YANKS,1,1,1,2,2018,2018,0,Yes,0,-0.02,0.0,0.02,70,0,-70,219,0,-219,9.0,0.0,-9.0,0.0,0.0,0.0
<a href=/player/krate001>krate001</a>,Erik Kratz,Milwaukee Brewers,BREWRS,1,1,1,2,2019,2019,0,Yes,0,-0.21,0.0,0.21,15,0,-15,36,0,-36,0.0,0.0,0.0,0.0,0.0,0.0
<a href=/player/krate001>krate001</a>,Erik Kratz,San Francisco Giants,GIANTS,1,2,1,3,2019,2019,0,No,0,-0.31,0.0,0.31,6,0,-6,17,0,-17,0.0,0.0,0.0,0.0,0.0,0.0
<a href=/player/krauj101>krauj101</a>,Jack Kraus,Brooklyn Dodgers,DOGRS,1,2,1,3,1943,1946,3,No,0,1.98,0.1,-1.88,107,168,61,100,529,429,847.0,0.0,-847.0,0.0,0.0,0.0
<a href=/player/kraul101>kraul101</a>,Lew Krausse,Brooklyn Dodgers,DOGRS,2,4,3,7,1938,1940,2,No,0,2.67,-0.72,-3.39,454,199,-255,1715,406,-1309,0.0,317.0,317.0,0.0,0.0,0.0
<a href=/player/kraul102>kraul102</a>,Lew Krausse,Oakland Athletics,ATLTCS,9,20,12,32,1970,1976,6,No,0,26.16,16.01,-10.15,3775,1399,-2376,8326,3903,-4423,4415.0,1098.0,-3317.0,340600.0,0.0,-340600.0
<a href=/player/kraul102>kraul102</a>,Lew Krausse,Milwaukee Brewers,BREWRS,9,23,22,45,1971,1984,13,No,0,35.91,84.88,48.97,2475,4171,1696,6161,14852,8691,10247.0,5331.0,-4916.0,466901.0,0.0,-466901.0
<a href=/player/kraum001>kraum001</a>,Marc Krauss,Arizona Diamondbacks,DBACKS,6,11,12,23,2012,2019,7,Yes,0,8.73,6.22,-2.51,828,1204,376,3152,2716,-436,0.0,1347.0,1347.0,0.0,0.0,0.0
<a href=/player/kraum001>kraum001</a>,Marc Krauss,Anaheim Angels,ANGELS,1,1,1,2,2015,2015,0,Yes,0,-0.26,0.0,0.26,4,0,-4,10,0,-10,0.0,0.0,0.0,0.0,0.0,0.0
<a href=/player/kravd101>kravd101</a>,Danny Kravitz,Pittsburgh Pirates,PIRATS,2,2,3,5,1960,1960,0,No,0,-0.47,0.0,0.47,83,0,-83,262,0,-262,0.0,0.0,0.0,0.0,0.0,0.0
<a href=/player/kravd101>kravd101</a>,Danny Kravitz,Kansas City Athletics,ATLTCS,1,1,1,2,1960,1960,0,No,0,0.0,0.0,0.0,0,0,0,0,0,0,0.0,0.0,0.0,0.0,0.0,0.0
<a href=/player/kravk101>kravk101</a>,Ken Kravec,Chicago White Sox,WSOX,2,2,2,4,1981,1990,9,No,1,-0.89,6.09,6.98,75,122,47,25,0,-25,310.0,1299.0,989.0,0.0,0.0,0.0
<a href=/player/kreem101>kreem101</a>,Mike Kreevich,Chicago White Sox,WSOX,1,2,1,3,1941,1946,5,No,0,0.52,12.57,12.05,116,628,512,494,2724,2230,0.0,0.0,0.0,13900.0,0.0,-13900.0
<a href=/player/krehj001>krehj001</a>,Joey Krehbiel,Anaheim Angels,ANGELS,1,2,2,4,2014,2014,0,No,0,0.11,-0.49,-0.6,4,34,30,0,15,15,9.0,19.0,10.0,0.0,0.0,0.0
<a href=/player/kremd001>kremd001</a>,Dean Kremer,Los Angeles Dodgers,DOGRS,1,5,1,6,2018,2018,0,No,0,-0.21,2.49,2.7,29,66,37,41,296,255,217.0,0.0,-217.0,0.0,0.0,0.0
<a href=/player/kremj001>kremj001</a>,Jimmy Kremers,Atlanta Braves,BRAVES,12,26,22,48,1991,2015,24,No,4,94.1,34.64,-59.46,4716,2589,-2127,15043,6609,-8434,7498.0,3071.0,-4427.0,29276500.0,0.0,-29276500.0
<a href=/player/kremj101>kremj101</a>,Jim Kremmel,Texas Rangers,RNGRS,1,1,1,2,1973,1973,0,No,0,0.0,-1.09,-1.09,0,16,16,0,0,0,0.0,121.0,121.0,6600.0,0.0,-6600.0
<a href=/player/kremj101>kremj101</a>,Jim Kremmel,St. Louis Cardinals,CARDS,2,2,2,4,1973,1973,0,No,0,0.0,0.0,0.0,0,0,0,0,0,0,0.0,0.0,0.0,0.0,0.0,0.0
<a href=/player/kremj101>kremj101</a>,Jim Kremmel,Chicago White Sox,WSOX,1,4,1,5,1973,1973,0,No,0,6.5,0.0,-6.5,800,0,-800,1477,0,-1477,2061.0,0.0,-2061.0,32700.0,0.0,-32700.0
<a href=/player/krenw001>krenw001</a>,Wayne Krenchicki,Baltimore Orioles,ORLS,1,1,1,2,1982,1982,0,No,0,3.19,0.0,-3.19,332,0,-332,701,0,-701,0.0,0.0,0.0,0.0,0.0,0.0
<a href=/player/krenw001>krenw001</a>,Wayne Krenchicki,Cincinnati Reds,REDS,1,1,1,2,1983,1983,0,No,0,0.75,0.0,-0.75,59,0,-59,149,0,-149,0.0,0.0,0.0,0.0,0.0,0.0
<a href=/player/krenw001>krenw001</a>,Wayne Krenchicki,Cincinnati Reds,REDS,2,2,3,5,1986,1994,8,No,0,1.73,13.14,11.41,357,667,310,247,834,587,825.0,1502.0,677.0,1200000.0,0.0,-1200000.0
<a href=/player/kresc101>kresc101</a>,Chuck Kress,Detroit Tigers,TIGRS,5,14,10,24,1954,1961,7,No,0,12.9,0.88,-12.02,615,749,134,406,2092,1686,3228.0,40.0,-3188.0,13200.0,0.0,-13200.0
<a href=/player/kresr101>kresr101</a>,Red Kress,St.Louis Browns,ORLS,4,4,8,12,1932,1936,4,No,0,13.67,15.04,1.37,895,883,-12,3348,2931,-417,691.0,2279.0,1588.0,12250.0,0.0,-12250.0
<a href=/player/kresr101>kresr101</a>,Red Kress,Chicago White Sox,WSOX,1,1,1,2,1934,1940,6,No,0,2.34,-2.0,-4.34,252,81,-171,903,319,-584,17.0,0.0,-17.0,6000.0,0.0,-6000.0
<a href=/player/kresr101>kresr101</a>,Red Kress,Washington Senators,TWINS,1,3,1,4,1937,1940,3,No,0,0.0,-1.14,-1.14,0,124,124,0,429,429,0.0,0.0,0.0,0.0,0.0,0.0
<a href=/player/kresr101>kresr101</a>,Red Kress,Boston Red Sox,RSOX,1,3,1,4,1937,1940,3,No,0,5.49,2.22,-3.27,408,291,-117,1388,1330,-58,1283.0,0.0,-1283.0,4000.0,0.0,-4000.0
<a href=/player/kresr101>kresr101</a>,Red Kress,St.Louis Browns,ORLS,6,10,14,24,1939,1952,13,No,0,23.39,27.61,4.22,1164,2723,1559,2963,7190,4227,3417.0,6493.0,3076.0,67500.0,0.0,-67500.0
<a href=/player/kretl101>kretl101</a>,Lou Kretlow,Detroit Tigers,TIGRS,1,2,1,3,1949,1953,4,No,0,-1.32,6.81,8.13,157,451,294,102,1933,1831,901.0,0.0,-901.0,6000.0,0.0,-6000.0
<a href=/player/kretl101>kretl101</a>,Lou Kretlow,Chicago White Sox,WSOX,7,12,13,25,1953,1969,16,No,0,11.99,30.83,18.84,1538,1586,48,4583,5396,813,1710.0,1860.0,150.0,87250.0,0.0,-87250.0
<a href=/player/kreuc001>kreuc001</a>,Chad Kreuter,Chicago White Sox,WSOX,1,2,2,4,1997,1997,0,No,0,1.15,1.16,0.01,178,151,-27,735,342,-393,0.0,178.0,178.0,2847500.0,0.0,-2847500.0
<a href=/player/kreuf101>kreuf101</a>,Frank Kreutzer,Chicago White Sox,WSOX,3,4,5,9,1964,1969,5,No,0,-1.84,4.73,6.57,327,350,23,584,1283,699,492.0,0.0,-492.0,70250.0,0.0,-70250.0
<a href=/player/kreuf101>kreuf101</a>,Frank Kreutzer,Washington Senators,RNGRS,1,1,1,2,1969,1975,6,No,0,0.0,0.92,0.92,0,276,276,0,106,106,0.0,1216.0,1216.0,10000.0,0.0,-10000.0
<a href=/player/kreur101>kreur101</a>,Rick Kreuger,Boston Red Sox,RSOX,1,1,1,2,1978,1979,1,No,0,0.15,-0.74,-0.89,6,70,64,0,120,120,28.0,0.0,-28.0,0.0,0.0,0.0
<a href=/player/krivr001>krivr001</a>,Rick Krivda,Cleveland Indians,INDINS,1,1,2,3,1998,1998,0,No,0,-1.7,0.0,1.7,31,0,-31,4,0,-4,79.0,0.0,-79.0,205000.0,0.0,-205000.0
<a href=/player/krolg101>krolg101</a>,Gary Kroll,Philadelphia Phillies,PHILS,1,3,1,4,1964,1965,1,No,0,-0.3,1.17,1.47,100,74,-26,65,237,172,326.0,0.0,-326.0,0.0,0.0,0.0
<a href=/player/krolg101>krolg101</a>,Gary Kroll,New York Mets,METS,1,1,2,3,1966,1966,0,No,0,0.2,0.0,-0.2,20,0,-20,3,0,-3,71.0,0.0,-71.0,0.0,0.0,0.0
<a href=/player/kroli001>kroli001</a>,Ian Krol,Oakland Athletics,ATLTCS,8,15,10,25,2013,2018,5,Yes,0,10.44,2.58,-7.86,1089,362,-727,2080,1057,-1023,1184.0,312.0,-872.0,8300001.0,0.0,-8300001.0
<a href=/player/kroli001>kroli001</a>,Ian Krol,Washington Nationals,NATEX,1,3,1,4,2013,2015,2,No,0,-1.71,4.39,6.1,114,103,-11,3,101,98,324.0,801.0,477.0,501250.0,0.0,-501250.0
<a href=/player/kroli001>kroli001</a>,Ian Krol,Detroit Tigers,TIGRS,2,3,2,5,2015,2019,4,No,0,1.92,2.82,0.9,314,181,-133,389,391,2,300.0,240.0,-60.0,8515000.0,0.0,-8515000.0
<a href=/player/kroom001>kroom001</a>,Marc Kroon,New York Mets,METS,1,2,3,5,1993,1994,1,No,0,-0.15,-0.19,-0.04,32,20,-12,0,3,3,46.0,51.0,5.0,0.0,0.0,0.0
<a href=/player/kroom001>kroom001</a>,Marc Kroon,San Diego Padres,PADRS,1,1,1,2,1998,2000,2,No,0,-0.23,-0.55,-0.32,8,22,14,0,11,11,16.0,122.0,106.0,176000.0,0.0,-176000.0
<a href=/player/krsnr101>krsnr101</a>,Rocky Krsnich,Chicago White Sox,WSOX,1,3,1,4,1953,1955,2,No,0,0.0,-0.06,-0.06,1,69,68,1,138,137,0.0,0.0,0.0,0.0,0.0,0.0
<a href=/player/krueb001>krueb001</a>,Bill Krueger,Oakland Athletics,ATLTCS,1,1,1,2,1987,1987,0,No,0,-0.21,0.0,0.21,6,0,-6,0,0,0,14.0,0.0,-14.0,0.0,0.0,0.0
<a href=/player/krueb001>krueb001</a>,Bill Krueger,Los Angeles Dodgers,DOGRS,1,1,1,2,1988,1988,0,No,0,0.0,0.0,0.0,0,0,0,0,0,0,0.0,0.0,0.0,0.0,0.0,0.0
<a href=/player/krueb001>krueb001</a>,Bill Krueger,Minnesota Twins,TWINS,2,2,2,4,1992,1992,0,No,0,-0.51,-0.28,0.23,18,14,-4,4,37,33,52.0,0.0,-52.0,920000.0,0.0,-920000.0
<a href=/player/krueo101>krueo101</a>,Otto Krueger,St. Louis Cardinals,CARDS,1,1,1,2,1903,1906,3,No,0,0.61,1.51,0.9,166,355,189,607,1383,776,0.0,0.0,0.0,0.0,0.0,0.0
<a href=/player/krueo101>krueo101</a>,Otto Krueger,Pittsburgh Pirates,PIRATS,2,6,3,9,1904,1910,6,No,0,14.45,22.9,8.45,1603,573,-1030,5618,1466,-4152,2702.0,3643.0,941.0,0.0,0.0,0.0
<a href=/player/kruga101>kruga101</a>,Art Kruger,Columbus,Columbus,1,2,1,3,1909,1909,0,No,0,0.53,0.0,-0.53,106,0,-106,302,0,-302,383.0,0.0,-383.0,0.0,0.0,0.0
<a href=/player/krugc101>krugc101</a>,Chris Krug,Chicago Cubs,CUBS,1,2,2,4,1966,1966,0,No,0,0.0,0.0,0.0,0,0,0,0,0,0,0.0,0.0,0.0,0.0,0.0,0.0
<a href=/player/krukj001>krukj001</a>,John Kruk,San Diego Padres,PADRS,8,16,17,33,1989,1998,9,No,0,97.76,11.55,-86.21,6640,1589,-5051,25821,4524,-21297,1355.0,1888.0,533.0,9476667.0,0.0,-9476667.0
<a href=/player/krukm001>krukm001</a>,Mike Krukow,Chicago Cubs,CUBS,4,6,9,15,1981,1989,8,No,0,1.13,3.09,1.96,267,1148,881,639,3744,3105,1316.0,1145.0,-171.0,0.0,0.0,0.0
<a href=/player/krukm001>krukm001</a>,Mike Krukow,Philadelphia Phillies,PHILS,2,5,3,8,1982,1988,6,No,0,12.97,14.82,1.85,911,983,72,587,531,-56,5303.0,1684.0,-3619.0,0.0,0.0,0.0
<a href=/player/kryhd101>kryhd101</a>,Dick Kryhoski,New York Yankees,YANKS,1,1,1,2,1949,1950,1,No,0,0.37,0.0,-0.37,172,3,-169,634,3,-631,0.0,0.0,0.0,0.0,0.0,0.0
<a href=/player/kryhd101>kryhd101</a>,Dick Kryhoski,Detroit Tigers,TIGRS,11,26,24,50,1952,1961,9,No,0,21.38,15.7,-5.68,2119,2215,96,3938,6442,2504,5639.0,2357.0,-3282.0,45200.0,0.0,-45200.0
<a href=/player/kryhd101>kryhd101</a>,Dick Kryhoski,Baltimore Orioles,ORLS,21,46,43,89,1954,1994,40,No,3,83.66,150.67,67.01,4979,8510,3531,10385,24729,14344,18519.0,15968.0,-2551.0,970833.0,0.0,-970833.0
<a href=/player/krynd001>krynd001</a>,Dave Krynzel,Milwaukee Brewers,BREWRS,2,4,4,8,2006,2008,2,No,0,5.76,-0.61,-6.37,192,321,129,188,507,319,1641.0,616.0,-1025.0,6600000.0,0.0,-6600000.0
<a href=/player/kubej002>kubej002</a>,Jason Kubel,Arizona Diamondbacks,DBACKS,1,1,2,3,2013,2014,1,No,0,-0.06,-0.06,0.0,8,16,8,23,1,-22,0.0,26.0,26.0,0.0,0.0,0.0
<a href=/player/kubij101>kubij101</a>,Jack Kubiszyn,Cleveland Indians,INDINS,2,5,2,7,1962,1968,6,No,0,3.21,3.85,0.64,600,709,109,441,2271,1830,1817.0,0.0,-1817.0,27000.0,0.0,-27000.0
<a href=/player/kubik001>kubik001</a>,Kyle Kubitza,Atlanta Braves,BRAVES,1,1,2,3,2015,2018,3,Yes,0,-0.31,0.0,0.31,19,0,-19,39,0,-39,0.0,0.0,0.0,0.0,0.0,0.0
<a href=/player/kubit101>kubit101</a>,Ted Kubiak,Oakland Athletics,ATLTCS,1,2,2,4,1969,1972,3,No,0,0.15,3.68,3.53,269,160,-109,950,108,-842,105.0,993.0,888.0,22500.0,0.0,-22500.0
<a href=/player/kubit101>kubit101</a>,Ted Kubiak,Milwaukee Brewers,BREWRS,10,16,19,35,1971,1986,15,No,0,43.81,45.76,1.95,2829,2561,-268,7569,6589,-980,5854.0,7527.0,1673.0,612800.0,0.0,-612800.0
<a href=/player/kubit101>kubit101</a>,Ted Kubiak,St. Louis Cardinals,CARDS,1,1,1,2,1971,1971,0,No,0,-0.34,0.0,0.34,46,0,-46,130,0,-130,0.0,0.0,0.0,27000.0,0.0,-27000.0
<a href=/player/kubit101>kubit101</a>,Ted Kubiak,Texas Rangers,RNGRS,12,24,23,47,1972,1992,20,No,2,55.26,25.52,-29.74,2860,1710,-1150,5732,4604,-1128,9799.0,4191.0,-5608.0,214000.0,0.0,-214000.0
<a href=/player/kubit101>kubit101</a>,Ted Kubiak,Oakland Athletics,ATLTCS,1,1,1,2,1975,1975,0,No,0,-0.93,0.46,1.39,183,18,-165,468,1,-467,0.0,183.0,183.0,42500.0,0.0,-42500.0
<a href=/player/kubsg101>kubsg101</a>,Gil Kubski,California Angels,ANGELS,1,1,1,2,1981,1981,0,No,0,0.0,0.0,0.0,0,0,0,0,0,0,0.0,0.0,0.0,0.0,0.0,0.0
<a href=/player/kubsg101>kubsg101</a>,Gil Kubski,Toronto Blue Jays,BJAYS,1,1,1,2,1981,1986,5,No,0,0.0,3.51,3.51,0,454,454,0,1261,1261,0.0,0.0,0.0,0.0,0.0,0.0
<a href=/player/kucej101>kucej101</a>,Jack Kucek,Chicago White Sox,WSOX,2,2,2,4,1979,1982,3,No,0,8.09,4.64,-3.45,560,376,-184,1833,1430,-403,13.0,22.0,9.0,0.0,0.0,0.0
<a href=/player/kuckj101>kuckj101</a>,Johnny Kucks,New York Yankees,YANKS,3,7,5,12,1959,1966,7,No,0,10.26,14.71,4.45,1028,1524,496,3254,3264,10,1701.0,4103.0,2402.0,84000.0,0.0,-84000.0
<a href=/player/kuckj101>kuckj101</a>,Johnny Kucks,Baltimore Orioles,ORLS,1,1,1,2,1961,1961,0,No,0,0.0,0.0,0.0,0,0,0,0,0,0,0.0,0.0,0.0,0.0,0.0,0.0
<a href=/player/kuenh101>kuenh101</a>,Harvey Kuenn,Detroit Tigers,TIGRS,5,7,7,14,1960,1972,12,No,0,10.2,23.19,12.99,762,1846,1084,1264,5438,4174,1071.0,2815.0,1744.0,103000.0,0.0,-103000.0
<a href=/player/kuenh101>kuenh101</a>,Harvey Kuenn,Cleveland Indians,INDINS,2,2,4,6,1960,1964,4,No,0,3.83,1.83,-2.0,581,494,-87,2181,1696,-485,0.0,144.0,144.0,40000.0,0.0,-40000.0
<a href=/player/kuenh101>kuenh101</a>,Harvey Kuenn,San Francisco Giants,GIANTS,3,5,4,9,1965,1968,3,No,0,-1.4,-0.01,1.39,272,250,-22,397,696,299,492.0,0.0,-492.0,33000.0,0.0,-33000.0
<a href=/player/kuhej101>kuhej101</a>,Joe Kuhel,Washington Senators,TWINS,2,2,4,6,1938,1938,0,No,0,15.12,1.81,-13.31,1022,137,-885,4378,589,-3789,0.0,0.0,0.0,0.0,0.0,0.0
<a href=/player/kuipd001>kuipd001</a>,Duane Kuiper,Cleveland Indians,INDINS,2,2,3,5,1981,1984,3,No,0,14.47,1.93,-12.54,734,205,-529,1087,273,-814,4063.0,725.0,-3338.0,0.0,0.0,0.0
<a href=/player/kunkb101>kunkb101</a>,Bill Kunkel,Kansas City Athletics,ATLTCS,1,2,1,3,1962,1965,3,No,0,0.0,6.11,6.11,0,202,202,0,205,205,0.0,1684.0,1684.0,0.0,0.0,0.0
<a href=/player/kunkj001>kunkj001</a>,Jeff Kunkel,Milwaukee Brewers,BREWRS,1,1,1,2,1992,1992,0,No,0,-0.15,0.0,0.15,20,0,-20,29,0,-29,0.0,0.0,0.0,0.0,0.0,0.0
<a href=/player/kuntr001>kuntr001</a>,Rusty Kuntz,Chicago White Sox,WSOX,1,1,1,2,1983,1992,9,No,0,-0.65,0.0,0.65,31,0,-31,113,0,-113,0.0,0.0,0.0,0.0,0.0,0.0
<a href=/player/kuntr001>kuntr001</a>,Rusty Kuntz,Minnesota Twins,TWINS,1,1,1,2,1983,1983,0,No,0,-0.24,0.0,0.24,89,0,-89,175,0,-175,0.0,0.0,0.0,0.0,0.0,0.0
<a href=/player/kunze001>kunze001</a>,Eddie Kunz,New York Mets,METS,1,1,1,2,2011,2014,3,No,0,0.0,0.0,0.0,0,0,0,0,0,0,0.0,0.0,0.0,0.0,0.0,0.0
<a href=/player/kunze101>kunze101</a>,Earl Kunz,Sacramento,Sacramento,1,1,5,6,1922,1922,0,No,0,-0.78,0.0,0.78,42,0,-42,12,0,-12,136.0,0.0,-136.0,0.0,0.0,0.0
<a href=/player/kusna101>kusna101</a>,Art Kusnyer,Chicago White Sox,WSOX,2,2,3,5,1971,1974,3,No,0,-1.52,0.66,2.18,111,200,89,278,14,-264,0.0,493.0,493.0,0.0,0.0,0.0
<a href=/player/kusna101>kusna101</a>,Art Kusnyer,California Angels,ANGELS,3,7,8,15,1973,1976,3,No,0,0.2,6.55,6.35,187,557,370,417,1633,1216,696.0,244.0,-452.0,35000.0,0.0,-35000.0
<a href=/player/kusna101>kusna101</a>,Art Kusnyer,Milwaukee Brewers,BREWRS,1,1,1,2,1978,1978,0,No,0,0.04,0.0,-0.04,9,0,-9,15,0,-15,0.0,0.0,0.0,0.0,0.0,0.0
<a href=/player/kutcr001>kutcr001</a>,Randy Kutcher,San Francisco Giants,GIANTS,1,1,1,2,1987,1994,7,No,0,0.58,0.22,-0.36,159,15,-144,277,29,-248,0.0,0.0,0.0,0.0,0.0,0.0
<a href=/player/kutym101>kutym101</a>,Marty Kutyna,St. Louis Cardinals,CARDS,31,60,55,115,1957,1998,41,No,7,117.05,218.79,101.74,11329,10308,-1021,30194,36340,6146,12663.0,4453.0,-8210.0,3323333.0,0.0,-3323333.0
<a href=/player/kutym101>kutym101</a>,Marty Kutyna,Cincinnati Reds,REDS,1,1,1,2,1959,1959,0,No,0,0.95,0.0,-0.95,110,0,-110,6,0,-6,207.0,0.0,-207.0,0.0,0.0,0.0
<a href=/player/kutym101>kutym101</a>,Marty Kutyna,Kansas City Athletics,ATLTCS,1,2,1,3,1960,1960,0,No,0,0.38,0.0,-0.38,208,0,-208,47,0,-47,663.0,0.0,-663.0,0.0,0.0,0.0
<a href=/player/kuzab101>kuzab101</a>,Bob Kuzava,Cleveland Indians,INDINS,1,2,1,3,1948,1949,1,No,0,0.65,0.86,0.21,84,50,-34,82,13,-69,618.0,186.0,-432.0,0.0,0.0,0.0
<a href=/player/kuzab101>kuzab101</a>,Bob Kuzava,Chicago White Sox,WSOX,10,25,21,46,1950,1963,13,No,0,23.73,52.01,28.28,4184,3652,-532,12734,11891,-843,4692.0,2309.0,-2383.0,109500.0,0.0,-109500.0
<a href=/player/kuzab101>kuzab101</a>,Bob Kuzava,Washington Senators,TWINS,9,18,18,36,1951,1963,12,No,0,12.21,16.51,4.3,1377,2054,677,3595,4242,647,1956.0,5489.0,3533.0,17500.0,0.0,-17500.0
<a href=/player/laabc101>laabc101</a>,Chet Laabs,Detroit Tigers,TIGRS,3,9,7,16,1939,1948,9,No,0,19.29,21.11,1.82,2183,1686,-497,6579,6030,-549,3951.0,2317.0,-1634.0,44300.0,0.0,-44300.0
<a href=/player/labic101>labic101</a>,Clem Labine,Los Angeles Dodgers,DOGRS,1,1,2,3,1960,1960,0,No,0,-0.36,0.0,0.36,28,0,-28,2,0,-2,58.0,0.0,-58.0,28000.0,0.0,-28000.0
<a href=/player/laboj001>laboj001</a>,Jairo Labourt,Toronto Blue Jays,BJAYS,1,3,1,4,2015,2015,0,No,0,13.77,2.5,-11.27,310,12,-298,26,4,-22,3733.0,223.0,-3510.0,508700.0,0.0,-508700.0
<a href=/player/laceb001>laceb001</a>,Bob Lacey,Oakland Athletics,ATLTCS,1,2,3,5,1981,1987,6,No,0,0.0,11.95,11.95,0,617,617,0,2241,2241,0.0,0.0,0.0,0.0,0.0,0.0
<a href=/player/laceb001>laceb001</a>,Bob Lacey,San Diego Padres,PADRS,1,1,1,2,1981,1984,3,No,0,-0.56,2.85,3.41,14,296,282,0,1221,1221,64.0,0.0,-64.0,0.0,0.0,0.0
<a href=/player/lachc101>lachc101</a>,Candy LaChance,Cleveland Indians,INDINS,1,1,1,2,1901,1902,1,No,0,0.74,0.11,-0.63,448,18,-430,1834,74,-1760,0.0,0.0,0.0,0.0,0.0,0.0
<a href=/player/lackj001>lackj001</a>,John Lackey,Boston Red Sox,RSOX,1,3,2,5,2014,2018,4,No,0,5.3,1.43,-3.87,83,264,181,89,204,115,836.0,1078.0,242.0,0.0,0.0,0.0
<a href=/player/lacof001>lacof001</a>,Frank LaCorte,Atlanta Braves,BRAVES,1,1,1,2,1979,1981,2,No,0,-1.78,-0.34,1.44,392,74,-318,30,6,-24,845.0,149.0,-696.0,0.0,0.0,0.0
<a href=/player/lacop101>lacop101</a>,Pete LaCock,Chicago Cubs,CUBS,1,1,1,2,1976,1977,1,No,0,0.79,0.0,-0.79,452,0,-452,1214,0,-1214,0.0,0.0,0.0,0.0,0.0,0.0
<a href=/player/lacyk001>lacyk001</a>,Kerry Lacy,Texas Rangers,RNGRS,3,6,6,12,1996,2002,6,No,2,0.53,0.51,-0.02,205,106,-99,245,209,-36,377.0,194.0,-183.0,1973500.0,0.0,-1973500.0
<a href=/player/lacyl001>lacyl001</a>,Lee Lacy,Los Angeles Dodgers,DOGRS,1,4,2,6,1975,1984,9,No,0,-0.88,19.14,20.02,1504,1261,-243,5163,4749,-414,0.0,0.0,0.0,0.0,0.0,0.0
<a href=/player/lacyl001>lacyl001</a>,Lee Lacy,Atlanta Braves,BRAVES,1,2,1,3,1976,1977,1,No,0,4.08,0.61,-3.47,368,56,-312,639,9,-630,292.0,128.0,-164.0,0.0,0.0,0.0
<a href=/player/laddp001>laddp001</a>,Pete Ladd,Boston Red Sox,RSOX,5,11,7,18,1979,1993,14,No,1,6.69,9.69,3.0,1042,1268,226,3358,3501,143,507.0,2168.0,1661.0,1275000.0,0.0,-1275000.0
<a href=/player/laddp001>laddp001</a>,Pete Ladd,Houston Astros,ASTROS,1,1,1,2,1981,1981,0,No,0,0.18,0.0,-0.18,144,0,-144,0,0,0,612.0,0.0,-612.0,0.0,0.0,0.0
<a href=/player/laded101>laded101</a>,Doyle Lade,Cleveland Indians,INDINS,1,1,1,2,1941,1941,0,No,0,0.0,0.0,0.0,0,0,0,0,0,0,0.0,0.0,0.0,0.0,0.0,0.0
<a href=/player/ladet001>ladet001</a>,Tyler Ladendorf,Minnesota Twins,TWINS,1,1,1,2,2009,2009,0,No,0,-0.43,-0.05,0.38,54,59,5,68,260,192,3.0,0.0,-3.0,0.0,0.0,0.0
<a href=/player/lafaj101>lafaj101</a>,Joe Lafata,New York Giants,GIANTS,1,5,3,8,1950,1954,4,No,0,0.0,-0.44,-0.44,0,186,186,0,308,308,0.0,172.0,172.0,0.0,0.0,0.0
<a href=/player/laffa001>laffa001</a>,Aaron Laffey,Cleveland Indians,INDINS,1,1,2,3,2011,2011,0,No,0,0.19,0.0,-0.19,37,0,-37,0,0,0,128.0,0.0,-128.0,0.0,0.0,0.0
<a href=/player/lagam001>lagam001</a>,Mike Laga,Detroit Tigers,TIGRS,8,16,17,33,1986,2010,24,No,2,13.67,30.35,16.68,4407,1892,-2515,10437,3664,-6773,6305.0,6807.0,502.0,11601500.0,0.0,-11601500.0
<a href=/player/lagrl101>lagrl101</a>,Lerrin LaGrow,St. Louis Cardinals,CARDS,4,5,6,11,1977,1990,13,No,0,8.31,14.6,6.29,508,1056,548,1263,2605,1342,1883.0,1997.0,114.0,740000.0,0.0,-740000.0
<a href=/player/lahoj101>lahoj101</a>,Joe Lahoud,Boston Red Sox,RSOX,5,10,10,20,1971,1977,6,No,0,35.42,11.92,-23.5,1569,736,-833,4628,2092,-2536,3846.0,2344.0,-1502.0,155000.0,0.0,-155000.0
<a href=/player/lahoj101>lahoj101</a>,Joe Lahoud,Milwaukee Brewers,BREWRS,3,7,7,14,1973,1978,5,No,0,7.23,1.8,-5.43,546,209,-337,1533,327,-1206,524.0,1634.0,1110.0,168301.0,0.0,-168301.0
<a href=/player/lahtj001>lahtj001</a>,Jeff Lahti,Cincinnati Reds,REDS,2,3,2,5,1982,1994,12,No,1,2.67,4.16,1.49,410,634,224,39,1985,1946,858.0,458.0,-400.0,0.0,0.0,0.0
<a href=/player/lairb001>lairb001</a>,Brandon Laird,Kansas City Royals,ROYALS,1,1,1,2,2014,2014,0,No,0,0.0,0.0,0.0,0,0,0,0,0,0,0.0,0.0,0.0,0.0,0.0,0.0
<a href=/player/lairg001>lairg001</a>,Gerald Laird,Oakland Athletics,ATLTCS,7,12,11,23,2002,2009,7,No,0,21.2,14.17,-7.03,1375,998,-377,3394,3388,-6,5508.0,716.0,-4792.0,947000.0,0.0,-947000.0
<a href=/player/lairg001>lairg001</a>,Gerald Laird,Texas Rangers,RNGRS,3,3,4,7,2008,2013,5,No,0,2.85,-0.23,-3.08,311,21,-290,970,19,-951,384.0,44.0,-340.0,1600000.0,0.0,-1600000.0
<a href=/player/lakea101>lakea101</a>,Al Lakeman,Cincinnati Reds,REDS,1,1,2,3,1947,1954,7,No,0,-2.12,23.82,25.94,88,519,431,262,570,308,2.0,4467.0,4465.0,0.0,0.0,0.0
<a href=/player/lakee101>lakee101</a>,Eddie Lake,Boston Red Sox,RSOX,2,2,2,4,1946,1947,1,No,0,4.74,2.01,-2.73,593,311,-282,2454,1326,-1128,0.0,0.0,0.0,0.0,0.0,0.0
<a href=/player/lakef101>lakef101</a>,Fred Lake,Boston Braves,BRAVES,4,6,7,13,1897,1917,20,No,0,22.76,69.87,47.11,670,2683,2013,1752,8723,6971,3628.0,10422.0,6794.0,0.0,0.0,0.0
<a href=/player/lakej001>lakej001</a>,Junior Lake,Chicago Cubs,CUBS,1,1,1,2,2015,2015,0,No,0,-0.41,-0.24,0.17,8,37,29,22,0,-22,0.0,47.0,47.0,0.0,0.0,0.0
<a href=/player/lakej101>lakej101</a>,Joe Lake,New York Yankees,YANKS,1,2,1,3,1909,1909,0,No,0,6.01,0.0,-6.01,373,0,-373,970,0,-970,1597.0,0.0,-1597.0,0.0,0.0,0.0
<a href=/player/lakes001>lakes001</a>,Steve Lake,Milwaukee Brewers,BREWRS,2,4,4,8,1983,1987,4,No,0,0.96,0.59,-0.37,175,124,-51,420,432,12,0.0,0.0,0.0,0.0,0.0,0.0
<a href=/player/lakes001>lakes001</a>,Steve Lake,St. Louis Cardinals,CARDS,1,2,1,3,1988,1992,4,No,0,-1.2,10.67,11.87,295,514,219,652,1641,989,0.0,0.0,0.0,340000.0,0.0,-340000.0
<a href=/player/laket001>laket001</a>,Tim Laker,Los Angeles Dodgers,DOGRS,1,1,1,2,1999,2001,2,No,0,-0.01,0.0,0.01,6,0,-6,9,0,-9,0.0,0.0,0.0,0.0,0.0,0.0
<a href=/player/lakit001>lakit001</a>,Travis Lakins,Boston Red Sox,RSOX,1,1,1,2,2020,2020,0,Yes,0,0.0,0.0,0.0,0,0,0,0,0,0,0.0,0.0,0.0,0.0,0.0,0.0
<a href=/player/lallb001>lallb001</a>,Blake Lalli,Chicago Cubs,CUBS,1,1,1,2,2012,2012,0,No,0,0.0,0.12,0.12,0,9,9,0,21,21,0.0,0.0,0.0,0.0,0.0,0.0
<a href=/player/lamaa101>lamaa101</a>,Al LaMacchia,St.Louis Browns,ORLS,1,2,1,3,1946,1947,1,No,0,1.06,5.22,4.16,159,227,68,625,935,310,8.0,0.0,-8.0,3000.0,0.0,-3000.0
<a href=/player/lamab101>lamab101</a>,Bill Lamar,Boston Red Sox,RSOX,1,2,1,3,1920,1920,0,No,0,0.0,1.88,1.88,0,99,99,0,420,420,0.0,0.0,0.0,0.0,0.0,0.0
<a href=/player/lamab101>lamab101</a>,Bill Lamar,Toledo,Toledo,1,1,3,4,1924,1924,0,No,0,4.07,0.0,-4.07,425,0,-425,1818,0,-1818,0.0,0.0,0.0,0.0,0.0,0.0
<a href=/player/lamaj101>lamaj101</a>,Jack Lamabe,Pittsburgh Pirates,PIRATS,2,3,3,6,1962,1967,5,No,0,1.35,11.96,10.61,573,824,251,1418,1789,371,1199.0,1482.0,283.0,30000.0,0.0,-30000.0
<a href=/player/lamaj101>lamaj101</a>,Jack Lamabe,Boston Red Sox,RSOX,1,1,1,2,1965,1968,3,No,0,-0.05,1.46,1.51,6,175,169,4,105,101,38.0,984.0,946.0,19500.0,0.0,-19500.0
<a href=/player/lamaj101>lamaj101</a>,Jack Lamabe,Houston Astros,ASTROS,5,9,10,19,1965,1973,8,No,0,-0.32,0.69,1.01,384,965,581,306,1025,719,923.0,2019.0,1096.0,57500.0,0.0,-57500.0
<a href=/player/lamaj101>lamaj101</a>,Jack Lamabe,New York Mets,METS,1,1,1,2,1967,1969,2,No,0,0.58,-0.76,-1.34,46,70,24,11,31,20,143.0,311.0,168.0,0.0,0.0,0.0
<a href=/player/lamaj101>lamaj101</a>,Jack Lamabe,St. Louis Cardinals,CARDS,3,5,6,11,1968,1972,4,No,0,-0.84,1.08,1.92,394,109,-285,40,207,167,1007.0,64.0,-943.0,17500.0,0.0,-17500.0
<a href=/player/lamaj101>lamaj101</a>,Jack Lamabe,Chicago Cubs,CUBS,2,3,3,6,1969,1976,7,No,0,1.26,-2.01,-3.27,234,496,262,608,1128,520,0.0,471.0,471.0,0.0,0.0,0.0
<a href=/player/lamar001>lamar001</a>,Ryan LaMarre,Anaheim Angels,ANGELS,1,1,1,2,2017,2017,0,No,0,-0.14,0.0,0.14,3,0,-3,8,0,-8,0.0,0.0,0.0,0.0,0.0,0.0
<a href=/player/lamaw101>lamaw101</a>,Wayne LaMaster,Philadelphia Phillies,PHILS,2,2,2,4,1938,1940,2,No,0,15.0,3.5,-11.5,414,134,-280,436,342,-94,3540.0,613.0,-2927.0,0.0,0.0,0.0
<a href=/player/lamba001>lamba001</a>,Andrew Lambo,Los Angeles Dodgers,DOGRS,2,3,3,6,2010,2010,0,No,0,2.04,0.31,-1.73,235,38,-197,259,1,-258,1323.0,56.0,-1267.0,0.0,0.0,0.0
<a href=/player/lambc001>lambc001</a>,Chris Lambert,St. Louis Cardinals,CARDS,1,1,1,2,2007,2007,0,No,0,-0.81,-2.36,-1.55,10,29,19,0,11,11,82.0,114.0,32.0,0.0,0.0,0.0
<a href=/player/lambj002>lambj002</a>,John Lamb,Kansas City Royals,ROYALS,1,3,2,5,2015,2015,0,No,0,-1.23,0.27,1.5,231,13,-218,147,0,-147,1419.0,244.0,-1175.0,0.0,0.0,0.0
<a href=/player/lambm001>lambm001</a>,Mike Lamb,Texas Rangers,RNGRS,1,1,1,2,2004,2004,0,No,0,0.0,0.0,0.0,0,0,0,0,0,0,0.0,0.0,0.0,0.0,0.0,0.0
<a href=/player/lambm001>lambm001</a>,Mike Lamb,New York Yankees,YANKS,1,1,1,2,2004,2004,0,No,0,4.32,0.0,-4.32,487,0,-487,1436,0,-1436,0.0,0.0,0.0,0.0,0.0,0.0
<a href=/player/lambr101>lambr101</a>,Ray Lamb,Los Angeles Dodgers,DOGRS,1,2,1,3,1970,1972,2,No,0,4.26,1.8,-2.46,259,141,-118,136,432,296,1602.0,0.0,-1602.0,10000.0,0.0,-10000.0
<a href=/player/lamob101>lamob101</a>,Bobby LaMotte,St.Louis Browns,ORLS,25,52,60,112,1927,1952,25,No,0,169.13,172.17,3.04,8392,11292,2900,28367,37730,9363,13765.0,19339.0,5574.0,243500.0,0.0,-243500.0
<a href=/player/lamob101>lamob101</a>,Bobby LaMotte,St.Louis Browns,ORLS,21,42,49,91,1926,1952,26,No,0,96.01,107.81,11.8,5218,9406,4188,17109,30707,13598,8613.0,15510.0,6897.0,200300.0,0.0,-200300.0
<a href=/player/lamog101>lamog101</a>,Gene Lamont,Detroit Tigers,TIGRS,1,1,1,2,1973,1974,1,No,0,0.0,0.28,0.28,0,7,7,0,25,25,0.0,0.0,0.0,0.0,0.0,0.0
<a href=/player/lampd001>lampd001</a>,Dennis Lamp,Chicago Cubs,CUBS,1,1,1,2,1981,1982,1,No,0,6.09,-0.89,-6.98,122,75,-47,0,25,25,1299.0,310.0,-989.0,0.0,0.0,0.0
<a href=/player/lampk101>lampk101</a>,Keith Lampard,St. Louis Cardinals,CARDS,1,1,1,2,1972,1972,0,No,0,0.0,0.0,0.0,0,0,0,0,0,0,0.0,0.0,0.0,0.0,0.0,0.0
<a href=/player/lampt001>lampt001</a>,Tom Lampkin,Cleveland Indians,INDINS,3,4,4,8,1990,1995,5,No,0,2.91,2.56,-0.35,388,226,-162,1163,817,-346,0.0,0.0,0.0,162500.0,0.0,-162500.0
<a href=/player/lampt001>lampt001</a>,Tom Lampkin,San Francisco Giants,GIANTS,1,1,1,2,1996,1997,1,No,0,0.64,-0.71,-1.35,201,12,-189,515,1,-514,0.0,31.0,31.0,230000.0,0.0,-230000.0
<a href=/player/lampt001>lampt001</a>,Tom Lampkin,Seattle Mariners,MARNRS,12,24,25,49,2001,2015,14,No,0,25.13,36.61,11.48,2313,2617,304,5473,8533,3060,4049.0,2794.0,-1255.0,29602500.0,0.0,-29602500.0
<a href=/player/lancg101>lancg101</a>,Gary Lance,Kansas City Royals,ROYALS,1,1,1,2,1978,1978,0,No,0,0.0,0.0,0.0,0,0,0,0,0,0,0.0,0.0,0.0,0.0,0.0,0.0
<a href=/player/lancr001>lancr001</a>,Rick Lancellotti,Pittsburgh Pirates,PIRATS,1,2,2,4,1980,1982,2,No,0,6.29,0.5,-5.79,723,83,-640,2424,87,-2337,6.0,76.0,70.0,0.0,0.0,0.0
<a href=/player/lancr001>lancr001</a>,Rick Lancellotti,San Diego Padres,PADRS,2,2,3,5,1985,1986,1,No,0,0.04,0.5,0.46,22,36,14,42,1,-41,0.0,70.0,70.0,0.0,0.0,0.0
<a href=/player/landb001>landb001</a>,Bill Landrum,Cincinnati Reds,REDS,1,1,1,2,1988,1991,3,No,0,-0.14,1.81,1.95,14,300,286,2,836,834,37.0,0.0,-37.0,0.0,0.0,0.0
<a href=/player/landb101>landb101</a>,Bill Landis,Boston Red Sox,RSOX,2,2,2,4,1970,1971,1,No,0,0.0,0.0,0.0,0,0,0,0,0,0,0.0,0.0,0.0,0.0,0.0,0.0
<a href=/player/landc001>landc001</a>,Ced Landrum,Chicago Cubs,CUBS,1,1,1,2,1992,1992,0,No,0,0.0,-0.15,-0.15,0,20,20,0,29,29,0.0,0.0,0.0,0.0,0.0,0.0
<a href=/player/landd101>landd101</a>,Don Landrum,St. Louis Cardinals,CARDS,1,2,2,4,1962,1963,1,No,0,2.09,-0.45,-2.54,348,91,-257,1098,139,-959,0.0,0.0,0.0,0.0,0.0,0.0
<a href=/player/landd101>landd101</a>,Don Landrum,Chicago Cubs,CUBS,4,8,5,13,1965,1977,12,No,0,12.44,36.7,24.26,637,2096,1459,244,5232,4988,3515.0,5246.0,1731.0,122500.0,0.0,-122500.0
<a href=/player/landd101>landd101</a>,Don Landrum,Philadelphia Phillies,PHILS,2,3,7,10,1960,1962,2,No,0,-0.16,-0.53,-0.37,170,16,-154,318,59,-259,42.0,0.0,-42.0,0.0,0.0,0.0
<a href=/player/landg101>landg101</a>,Grover Land,Toledo,Toledo,1,1,2,3,1908,1908,0,No,0,-1.58,0.0,1.58,95,0,-95,309,0,-309,0.0,0.0,0.0,0.0,0.0,0.0
<a href=/player/landh101>landh101</a>,Hobie Landrith,Cincinnati Reds,REDS,3,3,3,6,1955,1963,8,No,0,0.32,11.82,11.5,224,752,528,378,223,-155,272.0,2547.0,2275.0,0.0,0.0,0.0
<a href=/player/landh101>landh101</a>,Hobie Landrith,Chicago Cubs,CUBS,5,10,9,19,1956,1965,9,No,0,7.39,7.94,0.55,637,1087,450,1408,195,-1213,1395.0,2758.0,1363.0,0.0,0.0,0.0
<a href=/player/landh101>landh101</a>,Hobie Landrith,St. Louis Cardinals,CARDS,2,6,5,11,1958,1965,7,No,0,0.78,23.86,23.08,573,513,-60,1253,888,-365,694.0,3387.0,2693.0,0.0,0.0,0.0
<a href=/player/landh101>landh101</a>,Hobie Landrith,New York Mets,METS,1,2,1,3,1962,1962,0,No,0,0.38,0.25,-0.13,62,116,54,190,396,206,0.0,0.0,0.0,0.0,0.0,0.0
<a href=/player/landj102>landj102</a>,Jesse Landrum,Chicago White Sox,WSOX,3,6,3,9,1939,1950,11,No,0,-0.26,2.54,2.8,394,795,401,1460,3225,1765,0.0,0.0,0.0,14200.0,0.0,-14200.0
<a href=/player/landj103>landj103</a>,Jim Landis,Chicago White Sox,WSOX,19,37,35,72,1965,1985,20,No,1,67.23,101.41,34.18,5604,5055,-549,14828,15211,383,11632.0,9695.0,-1937.0,609700.0,0.0,-609700.0
<a href=/player/landj103>landj103</a>,Jim Landis,Kansas City Athletics,ATLTCS,10,22,14,36,1965,1976,11,No,0,26.85,38.2,11.35,3876,2816,-1060,8514,9189,675,4493.0,1098.0,-3395.0,362100.0,0.0,-362100.0
<a href=/player/landj103>landj103</a>,Jim Landis,Cleveland Indians,INDINS,2,4,4,8,1967,1969,2,No,0,1.58,2.6,1.02,217,267,50,702,761,59,0.0,0.0,0.0,0.0,0.0,0.0
<a href=/player/landj103>landj103</a>,Jim Landis,Houston Astros,ASTROS,1,1,1,2,1967,1968,1,No,0,-0.12,-0.89,-0.77,25,58,33,56,5,-51,0.0,122.0,122.0,0.0,0.0,0.0
<a href=/player/landk001>landk001</a>,Ken Landreaux,California Angels,ANGELS,1,4,1,5,1979,1985,6,No,0,6.38,17.39,11.01,810,834,24,2648,3570,922,1590.0,0.0,-1590.0,0.0,0.0,0.0
<a href=/player/landk001>landk001</a>,Ken Landreaux,Minnesota Twins,TWINS,1,1,3,4,1981,1987,6,No,0,8.48,3.72,-4.76,868,672,-196,2981,2514,-467,0.0,0.0,0.0,0.0,0.0,0.0
<a href=/player/landl101>landl101</a>,Larry Landreth,Montreal Expos,NATEX,1,2,1,3,1978,1979,1,No,0,0.0,-1.34,-1.34,10,94,84,4,5,1,54.0,184.0,130.0,0.0,0.0,0.0
<a href=/player/landr001>landr001</a>,Rafael Landestoy,Los Angeles Dodgers,DOGRS,1,2,2,4,1978,1981,3,No,0,4.6,3.69,-0.91,609,283,-326,1828,907,-921,0.0,0.0,0.0,0.0,0.0,0.0
<a href=/player/landr001>landr001</a>,Rafael Landestoy,Houston Astros,ASTROS,1,1,1,2,1981,1985,4,No,0,-0.51,-0.85,-0.34,92,184,92,144,343,199,0.0,0.0,0.0,0.0,0.0,0.0
<a href=/player/landr001>landr001</a>,Rafael Landestoy,Cincinnati Reds,REDS,10,14,20,34,1983,2006,23,No,0,18.56,36.05,17.49,3038,2935,-103,2001,4186,2185,4092.0,5583.0,1491.0,22668833.0,0.0,-22668833.0
<a href=/player/landt001>landt001</a>,Tito Landrum,St. Louis Cardinals,CARDS,1,1,1,2,1983,1984,1,No,0,-0.07,-0.3,-0.23,39,56,17,72,117,45,0.0,0.0,0.0,0.0,0.0,0.0
<a href=/player/landt001>landt001</a>,Tito Landrum,Baltimore Orioles,ORLS,1,1,1,2,1984,1984,0,No,0,1.04,0.0,-1.04,316,0,-316,655,0,-655,0.0,0.0,0.0,0.0,0.0,0.0
<a href=/player/lanfw101>lanfw101</a>,Walt Lanfranconi,Boston Braves,BRAVES,1,2,1,3,1948,1948,0,No,0,-0.05,-0.28,-0.23,48,34,-14,105,82,-23,0.0,0.0,0.0,0.0,0.0,0.0
<a href=/player/langa001>langa001</a>,Alex Lange,Chicago Cubs,CUBS,1,2,2,4,2019,2019,0,No,0,0.3,1.75,1.45,39,51,12,0,225,225,107.0,0.0,-107.0,0.0,0.0,0.0
<a href=/player/langd102>langd102</a>,Don Lang,Cincinnati Reds,REDS,1,2,1,3,1940,1941,1,No,0,0.0,-0.31,-0.31,0,15,15,0,6,6,0.0,73.0,73.0,0.0,0.0,0.0
<a href=/player/langd102>langd102</a>,Don Lang,Boston Red Sox,RSOX,1,2,1,3,1946,1946,0,No,0,3.72,0.0,-3.72,260,0,-260,831,0,-831,0.0,0.0,0.0,0.0,0.0,0.0
<a href=/player/langm001>langm001</a>,Mark Langston,Seattle Mariners,MARNRS,15,25,31,56,1989,2015,26,No,0,47.96,108.51,60.55,2885,3632,747,7463,9980,2517,4388.0,14029.0,9641.0,34882500.0,0.0,-34882500.0
<a href=/player/langm002>langm002</a>,Matt Langwell,Cleveland Indians,INDINS,1,2,1,3,2013,2013,0,No,0,-0.06,-0.06,0.0,16,8,-8,1,23,22,26.0,0.0,-26.0,0.0,0.0,0.0
<a href=/player/langr001>langr001</a>,Rick Langford,Pittsburgh Pirates,PIRATS,5,10,11,21,1977,1988,11,No,0,53.71,31.99,-21.72,2929,1675,-1254,9660,6568,-3092,5429.0,149.0,-5280.0,807000.0,0.0,-807000.0
<a href=/player/langr002>langr002</a>,Ryan Langerhans,Oakland Athletics,ATLTCS,1,1,1,2,2007,2007,0,No,0,-0.21,0.24,0.45,176,6,-170,326,25,-301,0.0,0.0,0.0,0.0,0.0,0.0
<a href=/player/langr002>langr002</a>,Ryan Langerhans,Washington Nationals,NATEX,5,9,8,17,2009,2020,11,Yes,0,4.09,17.73,13.64,553,1365,812,690,1506,816,1207.0,2502.0,1295.0,8731616.0,0.0,-8731616.0
<a href=/player/lanim101>lanim101</a>,Max Lanier,St. Louis Cardinals,CARDS,1,2,1,3,1951,1951,0,No,0,0.42,0.0,-0.42,122,0,-122,75,0,-75,427.0,0.0,-427.0,25000.0,0.0,-25000.0
<a href=/player/lankr001>lankr001</a>,Ray Lankford,St. Louis Cardinals,CARDS,1,2,1,3,2001,2004,3,No,0,0.53,11.71,11.18,121,185,64,385,221,-164,0.0,1766.0,1766.0,8100000.0,0.0,-8100000.0
<a href=/player/lannj101>lannj101</a>,Johnny Lanning,Boston Braves,BRAVES,1,1,2,3,1939,1945,6,No,0,6.51,20.23,13.72,292,447,155,168,628,460,1592.0,4101.0,2509.0,4500.0,0.0,-4500.0
<a href=/player/lansc001>lansc001</a>,Carney Lansford,California Angels,ANGELS,2,4,3,7,1980,1986,6,No,0,8.12,4.18,-3.94,957,338,-619,2329,1304,-1025,1201.0,0.0,-1201.0,233333.0,0.0,-233333.0
<a href=/player/lansc001>lansc001</a>,Carney Lansford,Boston Red Sox,RSOX,1,3,2,5,1982,1986,4,No,0,26.9,1.92,-24.98,1356,609,-747,5373,2373,-3000,4.0,0.0,-4.0,440000.0,0.0,-440000.0
<a href=/player/lansj101>lansj101</a>,Joe Lansford,San Diego Padres,PADRS,10,18,19,37,1985,1998,13,No,0,97.76,19.36,-78.4,6640,1871,-4769,25821,5457,-20364,1355.0,1888.0,533.0,9476667.0,0.0,-9476667.0
<a href=/player/lansm001>lansm001</a>,Mike Lansing,Montreal Expos,NATEX,3,6,6,12,1997,2001,4,No,0,6.33,1.3,-5.03,602,104,-498,1203,335,-868,1105.0,214.0,-891.0,3425000.0,0.0,-3425000.0
<a href=/player/lansm001>lansm001</a>,Mike Lansing,Colorado Rockies,ROCKS,7,13,12,25,2000,2002,2,No,0,6.04,1.37,-4.67,876,433,-443,660,150,-510,2239.0,928.0,-1311.0,9375000.0,0.0,-9375000.0
<a href=/player/lapap102>lapap102</a>,Paul LaPalme,Pittsburgh Pirates,PIRATS,1,1,2,3,1955,1955,0,No,0,2.31,0.73,-1.58,114,22,-92,20,5,-15,277.0,84.0,-193.0,0.0,0.0,0.0
<a href=/player/lapap102>lapap102</a>,Paul LaPalme,St. Louis Cardinals,CARDS,1,1,1,2,1956,1956,0,No,0,0.39,0.0,-0.39,22,0,-22,6,0,-6,81.0,0.0,-81.0,0.0,0.0,0.0
<a href=/player/lapod001>lapod001</a>,Dave LaPoint,Milwaukee Brewers,BREWRS,3,6,7,13,1980,1986,6,No,1,6.59,20.26,13.67,970,997,27,2159,3010,851,2112.0,2376.0,264.0,0.0,0.0,0.0
<a href=/player/lapod001>lapod001</a>,Dave LaPoint,St. Louis Cardinals,CARDS,3,6,5,11,1985,1998,13,No,4,10.04,29.74,19.7,1204,965,-239,3785,3877,92,620.0,0.0,-620.0,0.0,0.0,0.0
<a href=/player/lapod001>lapod001</a>,Dave LaPoint,San Francisco Giants,GIANTS,3,6,5,11,1985,1991,6,No,0,8.16,14.64,6.48,1129,850,-279,2301,1999,-302,2390.0,2023.0,-367.0,0.0,0.0,0.0
<a href=/player/lapod001>lapod001</a>,Dave LaPoint,Detroit Tigers,TIGRS,2,2,2,4,1986,1988,2,No,0,-0.35,0.84,1.19,140,180,40,12,327,315,678.0,340.0,-338.0,550000.0,0.0,-550000.0
<a href=/player/lapod001>lapod001</a>,Dave LaPoint,St. Louis Cardinals,CARDS,1,1,1,2,1987,1987,0,No,0,5.2,0.0,-5.2,39,0,-39,0,0,0,732.0,0.0,-732.0,0.0,0.0,0.0
<a href=/player/lapod001>lapod001</a>,Dave LaPoint,Chicago White Sox,WSOX,3,4,5,9,1988,1996,8,No,0,8.04,20.1,12.06,594,752,158,1682,2873,1191,422.0,391.0,-31.0,5255000.0,0.0,-5255000.0
<a href=/player/lapof101>lapof101</a>,Frank LaPorte,New York Yankees,YANKS,1,1,1,2,1907,1908,1,No,0,0.52,1.29,0.77,62,75,13,167,301,134,0.0,0.0,0.0,0.0,0.0,0.0
<a href=/player/lapof101>lapof101</a>,Frank LaPorte,Boston Red Sox,RSOX,1,1,1,2,1908,1910,2,No,0,4.01,0.97,-3.04,252,181,-71,999,716,-283,0.0,0.0,0.0,0.0,0.0,0.0
<a href=/player/lapof101>lapof101</a>,Frank LaPorte,New York Yankees,YANKS,1,2,2,4,1911,1911,0,No,0,24.82,2.99,-21.83,1527,144,-1383,6167,615,-5552,0.0,0.0,0.0,0.0,0.0,0.0
<a href=/player/lapom001>lapom001</a>,Matt LaPorta,Milwaukee Brewers,BREWRS,2,5,3,8,2008,2008,0,No,2,22.37,5.2,-17.17,1354,34,-1320,5551,50,-5501,190.0,392.0,202.0,0.0,0.0,0.0
<a href=/player/lapor101>lapor101</a>,Ralph LaPointe,Philadelphia Phillies,PHILS,4,10,8,18,1948,1957,9,No,0,11.82,23.96,12.14,1009,1518,509,3058,5428,2370,109.0,186.0,77.0,63000.0,0.0,-63000.0
<a href=/player/larkn101>larkn101</a>,Norm Larker,Houston Astros,ASTROS,1,1,3,4,1962,1965,3,No,0,-0.09,3.88,3.97,64,176,112,177,179,2,0.0,1524.0,1524.0,0.0,0.0,0.0
<a href=/player/larkp101>larkp101</a>,Pat Larkin,San Francisco Giants,GIANTS,2,2,2,4,1984,1989,5,No,0,0.0,0.02,0.02,0,12,12,0,2,2,0.0,37.0,37.0,0.0,0.0,0.0
<a href=/player/larks001>larks001</a>,Stephen Larkin,Texas Rangers,RNGRS,1,2,1,3,1995,1996,1,No,0,0.02,0.43,0.41,1,39,38,3,104,101,0.0,0.0,0.0,0.0,0.0,0.0
<a href=/player/laroa001>laroa001</a>,Adam LaRoche,Atlanta Braves,BRAVES,7,15,18,33,2007,2015,8,No,2,20.02,10.32,-9.7,2739,1597,-1142,4450,3607,-843,3035.0,1968.0,-1067.0,26080000.0,0.0,-26080000.0
<a href=/player/laroa001>laroa001</a>,Adam LaRoche,Pittsburgh Pirates,PIRATS,1,1,2,3,2009,2013,4,No,0,-0.02,-0.42,-0.4,6,22,16,19,36,17,0.0,0.0,0.0,7050000.0,0.0,-7050000.0
<a href=/player/laroa001>laroa001</a>,Adam LaRoche,Boston Red Sox,RSOX,2,2,3,5,2009,2010,1,No,0,1.22,1.94,0.72,182,159,-23,699,477,-222,0.0,3.0,3.0,0.0,0.0,0.0
<a href=/player/laroa002>laroa002</a>,Andy LaRoche,Los Angeles Dodgers,DOGRS,1,2,1,3,2008,2010,2,No,0,0.68,6.26,5.58,458,223,-235,1050,892,-158,281.0,0.0,-281.0,392500.0,0.0,-392500.0
<a href=/player/larod101>larod101</a>,Dave LaRoche,California Angels,ANGELS,2,2,3,5,1971,1974,3,No,0,-0.02,2.62,2.64,196,305,109,227,1031,804,286.0,0.0,-286.0,15500.0,0.0,-15500.0
<a href=/player/larod101>larod101</a>,Dave LaRoche,Minnesota Twins,TWINS,1,1,3,4,1972,1976,4,No,0,0.4,7.0,6.6,189,163,-26,33,0,-33,439.0,2282.0,1843.0,25000.0,0.0,-25000.0
<a href=/player/larod101>larod101</a>,Dave LaRoche,Chicago Cubs,CUBS,1,2,1,3,1975,1976,1,No,0,5.2,-0.21,-5.41,136,50,-86,0,3,3,592.0,115.0,-477.0,0.0,0.0,0.0
<a href=/player/larod101>larod101</a>,Dave LaRoche,Cleveland Indians,INDINS,2,3,4,7,1977,1983,6,No,0,4.0,9.46,5.46,343,468,125,13,775,762,1466.0,1221.0,-245.0,85000.0,0.0,-85000.0
<a href=/player/larsd101>larsd101</a>,Dan Larson,St. Louis Cardinals,CARDS,1,2,1,3,1974,1975,1,No,0,-0.69,-0.39,0.3,92,16,-76,63,7,-56,570.0,68.0,-502.0,0.0,0.0,0.0
<a href=/player/larsd101>larsd101</a>,Dan Larson,Houston Astros,ASTROS,1,1,1,2,1978,1979,1,No,0,0.45,-0.02,-0.47,42,10,-32,32,2,-30,281.0,32.0,-249.0,0.0,0.0,0.0
<a href=/player/larsd101>larsd101</a>,Dan Larson,Philadelphia Phillies,PHILS,3,8,5,13,1981,1988,7,No,0,16.51,17.82,1.31,2071,1049,-1022,4347,608,-3739,6629.0,2308.0,-4321.0,0.0,0.0,0.0
<a href=/player/larsd102>larsd102</a>,Don Larsen,Baltimore Orioles,ORLS,21,46,43,89,1954,1994,40,No,3,83.66,150.67,67.01,4979,8510,3531,10385,24729,14344,18519.0,15968.0,-2551.0,970833.0,0.0,-970833.0
<a href=/player/larsd102>larsd102</a>,Don Larsen,New York Yankees,YANKS,4,7,6,13,1959,1969,10,No,0,14.99,27.57,12.58,1233,1032,-201,4340,4017,-323,296.0,0.0,-296.0,175000.0,0.0,-175000.0
<a href=/player/larsd102>larsd102</a>,Don Larsen,Kansas City Athletics,ATLTCS,19,40,34,74,1961,1976,15,No,0,67.84,34.29,-33.55,6835,3922,-2913,16048,11060,-4988,8728.0,3414.0,-5314.0,393100.0,0.0,-393100.0
<a href=/player/larsd102>larsd102</a>,Don Larsen,Chicago White Sox,WSOX,6,7,11,18,1961,1968,7,No,0,9.19,14.32,5.13,984,1200,216,811,1186,375,2300.0,2896.0,596.0,31250.0,0.0,-31250.0
<a href=/player/larsd102>larsd102</a>,Don Larsen,Houston Astros,ASTROS,1,1,2,3,1965,1965,0,No,0,0.29,0.0,-0.29,54,0,-54,11,0,-11,162.0,0.0,-162.0,0.0,0.0,0.0
<a href=/player/larut101>larut101</a>,Tony LaRussa,Atlanta Braves,BRAVES,1,1,1,2,1972,1972,0,No,0,0.0,0.0,0.0,1,0,-1,0,0,0,0.0,0.0,0.0,0.0,0.0,0.0
<a href=/player/larut101>larut101</a>,Tony LaRussa,Chicago White Sox,WSOX,1,1,1,2,1976,1977,1,No,0,0.0,-0.22,-0.22,0,5,5,0,0,0,0.0,8.0,8.0,0.0,0.0,0.0
<a href=/player/laryf101>laryf101</a>,Frank Lary,New York Mets,METS,2,3,4,7,1964,1970,6,No,0,1.31,5.65,4.34,198,446,248,238,478,240,553.0,2271.0,1718.0,30000.0,0.0,-30000.0
<a href=/player/laryf101>laryf101</a>,Frank Lary,New York Mets,METS,2,4,2,6,1965,1966,1,No,0,-0.17,-0.64,-0.47,38,55,17,22,134,112,80.0,0.0,-80.0,0.0,0.0,0.0
<a href=/player/laryl101>laryl101</a>,Lyn Lary,Oakland,Oakland,1,2,1,3,1927,1927,0,No,0,12.23,0.0,-12.23,638,0,-638,2477,0,-2477,0.0,0.0,0.0,0.0,0.0,0.0
<a href=/player/laryl101>laryl101</a>,Lyn Lary,New York Yankees,YANKS,1,1,2,3,1934,1934,0,No,0,0.54,0.0,-0.54,129,0,-129,501,0,-501,0.0,0.0,0.0,7500.0,0.0,-7500.0
<a href=/player/laryl101>laryl101</a>,Lyn Lary,Boston Red Sox,RSOX,1,2,1,3,1934,1946,12,No,0,-0.53,27.76,28.29,39,1134,1095,121,4584,4463,0.0,0.0,0.0,0.0,0.0,0.0
<a href=/player/laryl101>laryl101</a>,Lyn Lary,Washington Senators,TWINS,1,1,1,2,1935,1937,2,No,0,3.8,-0.16,-3.96,275,20,-255,1246,59,-1187,0.0,0.0,0.0,8000.0,0.0,-8000.0
<a href=/player/laryl101>laryl101</a>,Lyn Lary,St.Louis Browns,ORLS,12,23,32,55,1937,1952,15,No,0,55.87,54.37,-1.5,2736,6464,3728,7991,19515,11524,6789.0,12669.0,5880.0,129000.0,0.0,-129000.0
<a href=/player/lashf101>lashf101</a>,Fred Lasher,Detroit Tigers,TIGRS,1,1,2,3,1970,1970,0,No,0,-0.64,-0.16,0.48,86,28,-58,9,38,29,173.0,0.0,-173.0,0.0,0.0,0.0
<a href=/player/laskb001>laskb001</a>,Bill Laskey,Kansas City Royals,ROYALS,1,2,1,3,1981,1983,2,No,0,7.18,1.45,-5.73,329,160,-169,289,613,324,2571.0,0.0,-2571.0,0.0,0.0,0.0
<a href=/player/laskb001>laskb001</a>,Bill Laskey,San Francisco Giants,GIANTS,1,2,1,3,1985,1986,1,No,0,-1.74,-0.39,1.35,56,69,13,46,222,176,103.0,0.0,-103.0,552000.0,0.0,-552000.0
<a href=/player/laskb001>laskb001</a>,Bill Laskey,Montreal Expos,NATEX,3,3,4,7,1985,1990,5,No,0,0.41,-0.44,-0.85,115,47,-68,115,57,-58,424.0,26.0,-398.0,0.0,0.0,0.0
<a href=/player/lasot101>lasot101</a>,Tom Lasorda,Kansas City Athletics,ATLTCS,1,1,1,2,1956,1956,0,No,0,0.0,2.56,2.56,0,36,36,0,45,45,0.0,363.0,363.0,0.0,0.0,0.0
<a href=/player/lastt001>lastt001</a>,Tommy La Stella,Atlanta Braves,BRAVES,2,3,3,6,2014,2019,5,No,0,0.92,4.18,3.26,315,439,124,587,0,-587,37.0,635.0,598.0,5375000.0,0.0,-5375000.0
<a href=/player/lastt001>lastt001</a>,Tommy La Stella,Chicago Cubs,CUBS,1,1,1,2,2018,2018,0,Yes,0,2.16,0.0,-2.16,108,0,-108,438,0,-438,0.0,0.0,0.0,950000.0,0.0,-950000.0
<a href=/player/lastt001>lastt001</a>,Tommy La Stella,Anaheim Angels,ANGELS,1,1,1,2,2020,2021,1,No,0,0.42,-0.23,-0.65,27,6,-21,111,18,-93,0.0,0.0,0.0,3250000.0,0.0,-3250000.0
<a href=/player/latha101>latha101</a>,Arlie Latham,Cincinnati Reds,REDS,4,11,5,16,1895,1906,11,No,0,8.81,24.47,15.66,1114,1079,-35,4520,3525,-995,393.0,2208.0,1815.0,1500.0,0.0,-1500.0
<a href=/player/lathb001>lathb001</a>,Bill Latham,New York Mets,METS,2,4,3,7,1986,1991,5,No,0,0.96,6.32,5.36,405,543,138,1082,1694,612,117.0,0.0,-117.0,637500.0,0.0,-637500.0
<a href=/player/lathb001>lathb001</a>,Bill Latham,Minnesota Twins,TWINS,1,1,1,2,1987,1987,0,No,0,0.0,0.0,0.0,0,0,0,0,0,0,0.0,0.0,0.0,0.0,0.0,0.0
<a href=/player/lathc001>lathc001</a>,Chris Latham,Los Angeles Dodgers,DOGRS,1,4,2,6,1995,1998,3,No,0,-0.49,1.39,1.88,829,429,-400,2713,30,-2683,618.0,819.0,201.0,218000.0,0.0,-218000.0
<a href=/player/lathc001>lathc001</a>,Chris Latham,Minnesota Twins,TWINS,1,1,1,2,1999,2000,1,No,0,0.0,0.0,0.0,0,0,0,0,0,0,0.0,0.0,0.0,202500.0,0.0,-202500.0
<a href=/player/latit101>latit101</a>,Tacks Latimer,Louisville Colonels,LS3,1,12,5,17,1899,1900,1,No,0,267.1,0.0,-267.1,7388,0,-7388,29004,0,-29004,7568.0,0.0,-7568.0,4350.0,0.0,-4350.0
<a href=/player/latmb101>latmb101</a>,Barry Latman,Chicago White Sox,WSOX,1,1,1,2,1960,1960,0,No,0,1.41,0.7,-0.71,318,46,-272,218,35,-183,1958.0,341.0,-1617.0,0.0,0.0,0.0
<a href=/player/latmb101>latmb101</a>,Barry Latman,Cleveland Indians,INDINS,9,16,15,31,1963,1978,15,No,0,26.81,13.21,-13.6,2236,1670,-566,5404,5743,339,2936.0,1183.0,-1753.0,115500.0,0.0,-115500.0
<a href=/player/latmb101>latmb101</a>,Barry Latman,California Angels,ANGELS,1,1,2,3,1965,1970,5,No,0,1.4,0.0,-1.4,140,0,-140,40,0,-40,542.0,0.0,-542.0,20000.0,0.0,-20000.0
<a href=/player/latom001>latom001</a>,Mat Latos,San Diego Padres,PADRS,12,21,25,46,2011,2021,10,Yes,0,36.6,13.97,-22.63,2134,1982,-152,5215,5140,-75,5096.0,2387.0,-2709.0,6329300.0,0.0,-6329300.0
<a href=/player/latom001>latom001</a>,Mat Latos,Cincinnati Reds,REDS,1,1,2,3,2014,2020,6,No,0,0.44,6.45,6.01,31,217,186,27,221,194,265.0,1870.0,1605.0,7250000.0,0.0,-7250000.0
<a href=/player/latom001>latom001</a>,Mat Latos,Miami Marlins,MARLNS,1,3,3,6,2015,2015,0,Yes,0,-0.52,0.0,0.52,12,0,-12,7,0,-7,73.0,0.0,-73.0,9400000.0,0.0,-9400000.0
<a href=/player/lau-c101>lau-c101</a>,Charlie Lau,Detroit Tigers,TIGRS,1,2,2,4,1959,1959,0,No,0,0.34,0.0,-0.34,101,0,-101,212,0,-212,0.0,0.0,0.0,0.0,0.0,0.0
<a href=/player/lau-c101>lau-c101</a>,Charlie Lau,Detroit Tigers,TIGRS,1,2,3,5,1959,1964,5,No,0,0.34,-0.23,-0.57,101,194,93,212,543,331,0.0,0.0,0.0,0.0,0.0,0.0
<a href=/player/lau-c101>lau-c101</a>,Charlie Lau,Kansas City Athletics,ATLTCS,1,1,1,2,1964,1967,3,No,0,1.47,3.8,2.33,159,296,137,359,29,-330,0.0,713.0,713.0,0.0,0.0,0.0
<a href=/player/lauee001>lauee001</a>,Eric Lauer,San Diego Padres,PADRS,2,8,4,12,2019,2020,1,Yes,0,4.06,1.62,-2.44,306,12,-294,771,0,-771,833.0,208.0,-625.0,6368900.0,0.0,-6368900.0
<a href=/player/laurr001>laurr001</a>,Ramon Laureano,Houston Astros,ASTROS,1,1,1,2,2017,2019,2,No,0,9.58,0.0,-9.58,313,0,-313,1257,0,-1257,0.0,0.0,0.0,0.0,0.0,0.0
<a href=/player/lauzg101>lauzg101</a>,George Lauzerique,Oakland Athletics,ATLTCS,1,2,2,4,1969,1972,3,No,0,0.15,3.68,3.53,269,160,-109,950,108,-842,105.0,993.0,888.0,22500.0,0.0,-22500.0
<a href=/player/lauzg101>lauzg101</a>,George Lauzerique,Milwaukee Brewers,BREWRS,5,11,10,21,1970,1978,8,No,0,8.62,9.79,1.17,793,534,-259,2099,1479,-620,524.0,1634.0,1110.0,180301.0,0.0,-180301.0
<a href=/player/lavac101>lavac101</a>,Cookie Lavagetto,Pittsburgh Pirates,PIRATS,1,2,1,3,1936,1939,3,No,0,12.93,4.3,-8.63,841,114,-727,3255,108,-3147,89.0,818.0,729.0,0.0,0.0,0.0
<a href=/player/lavac101>lavac101</a>,Cookie Lavagetto,Oakland,Oakland,1,1,2,3,1933,1937,4,No,0,-0.57,0.0,0.57,225,0,-225,798,0,-798,0.0,0.0,0.0,0.0,0.0,0.0
<a href=/player/lavad101>lavad101</a>,Doc Lavan,St.Louis Browns,ORLS,1,2,2,4,1917,1920,3,No,0,3.97,0.15,-3.82,243,110,-133,1072,129,-943,0.0,1048.0,1048.0,9000.0,0.0,-9000.0
<a href=/player/lavam001>lavam001</a>,Mike LaValliere,St. Louis Cardinals,CARDS,2,4,3,7,1987,1997,10,No,2,43.01,2.09,-40.92,1782,407,-1375,6646,1438,-5208,1043.0,0.0,-1043.0,0.0,0.0,0.0
<a href=/player/laveg001>laveg001</a>,Gary Lavelle,San Francisco Giants,GIANTS,1,1,3,4,1985,1986,1,No,0,0.56,0.97,0.41,92,70,-22,0,60,60,301.0,484.0,183.0,0.0,0.0,0.0
<a href=/player/lavej101>lavej101</a>,Jimmy Lavender,Chicago Cubs,CUBS,3,4,3,7,1917,1919,2,No,0,5.24,4.61,-0.63,418,244,-174,1183,779,-404,1055.0,423.0,-632.0,0.0,0.0,0.0
<a href=/player/law-d001>law-d001</a>,Derek Law,San Francisco Giants,GIANTS,1,3,1,4,2019,2019,0,No,0,-0.38,0.77,1.15,80,156,76,48,628,580,182.0,0.0,-182.0,0.0,0.0,0.0
<a href=/player/law-r001>law-r001</a>,Rudy Law,Los Angeles Dodgers,DOGRS,2,4,3,7,1982,1987,5,No,0,20.6,2.18,-18.42,1937,186,-1751,6428,630,-5798,0.0,0.0,0.0,0.0,0.0,0.0
<a href=/player/law-r101>law-r101</a>,Ron Law,Cleveland Indians,INDINS,5,8,7,15,1969,1974,5,No,0,5.0,-0.41,-5.41,1218,311,-907,2882,450,-2432,1036.0,482.0,-554.0,104000.0,0.0,-104000.0
<a href=/player/law-v001>law-v001</a>,Vance Law,Pittsburgh Pirates,PIRATS,1,2,2,4,1982,1983,1,No,0,4.04,-0.83,-4.87,410,24,-386,1402,12,-1390,0.0,132.0,132.0,0.0,0.0,0.0
<a href=/player/law-v001>law-v001</a>,Vance Law,Chicago White Sox,WSOX,1,1,1,2,1984,1987,3,No,0,5.26,3.0,-2.26,398,170,-228,1515,0,-1515,22.0,667.0,645.0,0.0,0.0,0.0
<a href=/player/lawlt001>lawlt001</a>,Tom Lawless,Cincinnati Reds,REDS,1,1,1,2,1984,1986,2,No,0,-0.14,0.35,0.49,11,217,206,17,880,863,0.0,0.0,0.0,0.0,0.0,0.0
<a href=/player/lawlt001>lawlt001</a>,Tom Lawless,Montreal Expos,NATEX,1,1,1,2,1985,1985,0,No,0,0.03,0.28,0.25,166,18,-148,217,17,-200,0.0,145.0,145.0,0.0,0.0,0.0
<a href=/player/lawrb001>lawrb001</a>,Brian Lawrence,San Diego Padres,PADRS,1,2,1,3,2005,2006,1,No,0,0.0,-0.84,-0.84,0,72,72,0,269,269,0.0,0.0,0.0,2375000.0,0.0,-2375000.0
<a href=/player/lawrb002>lawrb002</a>,Brett Lawrie,Milwaukee Brewers,BREWRS,1,1,1,2,2010,2012,2,No,0,12.67,4.46,-8.21,345,106,-239,1431,120,-1311,0.0,974.0,974.0,0.0,0.0,0.0
<a href=/player/lawrb002>lawrb002</a>,Brett Lawrie,Toronto Blue Jays,BJAYS,2,6,2,8,2014,2018,4,Yes,0,6.54,19.48,12.94,350,462,112,887,2066,1179,1411.0,0.0,-1411.0,23516100.0,0.0,-23516100.0
<a href=/player/lawrb002>lawrb002</a>,Brett Lawrie,Oakland Athletics,ATLTCS,1,1,2,3,2015,2021,6,Yes,0,1.19,1.38,0.19,94,101,7,384,0,-384,0.0,336.0,336.0,1925000.0,0.0,-1925000.0
<a href=/player/lawrb103>lawrb103</a>,Brooks Lawrence,St. Louis Cardinals,CARDS,16,37,31,68,1956,1972,16,No,0,46.04,61.47,15.43,4532,2723,-1809,10204,7606,-2598,7123.0,5609.0,-1514.0,32500.0,0.0,-32500.0
<a href=/player/lawro101>lawro101</a>,Otis Lawry,Philadelphia Athletics,ATLTCS,2,7,4,11,1917,1920,3,No,0,0.98,1.52,0.54,143,229,86,582,916,334,0.0,0.0,0.0,2400.0,0.0,-2400.0
<a href=/player/lawsr101>lawsr101</a>,Roxie Lawson,Detroit Tigers,TIGRS,3,9,7,16,1939,1948,9,No,0,19.29,21.11,1.82,2183,1686,-497,6579,6030,-549,3951.0,2317.0,-1634.0,44300.0,0.0,-44300.0
<a href=/player/lawss101>lawss101</a>,Steve Lawson,Oakland Athletics,ATLTCS,2,4,3,7,1972,1975,3,No,0,-3.14,2.17,5.31,448,341,-107,1329,643,-686,48.0,183.0,135.0,42500.0,0.0,-42500.0
<a href=/player/lawtm001>lawtm001</a>,Marcus Lawton,New York Mets,METS,1,1,1,2,1989,1989,0,No,0,-0.46,0.0,0.46,10,0,-10,14,0,-14,0.0,0.0,0.0,0.0,0.0,0.0
<a href=/player/lawtm002>lawtm002</a>,Matt Lawton,Minnesota Twins,TWINS,1,1,1,2,2001,2003,2,No,0,0.32,3.65,3.33,48,74,26,213,6,-207,0.0,1172.0,1172.0,3900000.0,0.0,-3900000.0
<a href=/player/lawtm002>lawtm002</a>,Matt Lawton,New York Mets,METS,3,9,8,17,2001,2008,7,No,0,12.43,-0.5,-12.93,1334,336,-998,2309,1012,-1297,1613.0,327.0,-1286.0,8000000.0,0.0,-8000000.0
<a href=/player/lawtm002>lawtm002</a>,Matt Lawton,Cleveland Indians,INDINS,2,2,2,4,2004,2008,4,No,0,0.85,2.32,1.47,208,298,90,445,910,465,137.0,130.0,-7.0,7250000.0,0.0,-7250000.0
<a href=/player/lawtm002>lawtm002</a>,Matt Lawton,Pittsburgh Pirates,PIRATS,1,1,2,3,2005,2007,2,No,0,-0.49,-0.11,0.38,19,4,-15,83,18,-65,0.0,0.0,0.0,7750000.0,0.0,-7750000.0
<a href=/player/lawtm002>lawtm002</a>,Matt Lawton,Chicago Cubs,CUBS,1,1,1,2,2005,2012,7,No,0,-0.42,0.28,0.7,21,119,98,57,2,-55,0.0,192.0,192.0,0.0,0.0,0.0
<a href=/player/laxtb001>laxtb001</a>,Brett Laxton,Oakland Athletics,ATLTCS,2,2,2,4,2000,2002,2,No,0,1.66,3.59,1.93,88,359,271,211,1143,932,50.0,0.0,-50.0,1065000.0,0.0,-1065000.0
<a href=/player/laxtb101>laxtb101</a>,Bill Laxton,Pittsburgh Pirates,PIRATS,2,5,4,9,1967,1973,6,No,0,15.42,-1.44,-16.86,860,110,-750,2406,119,-2287,2691.0,948.0,-1743.0,75000.0,0.0,-75000.0
<a href=/player/laxtb101>laxtb101</a>,Bill Laxton,New York Mets,METS,1,2,2,4,1975,1979,4,No,0,6.09,1.21,-4.88,575,71,-504,2407,95,-2312,284.0,578.0,294.0,110000.0,0.0,-110000.0
<a href=/player/laxtb101>laxtb101</a>,Bill Laxton,Seattle Mariners,MARNRS,2,3,2,5,1977,1977,0,No,1,-0.02,0.07,0.09,2,11,9,0,36,36,5.0,0.0,-5.0,0.0,0.0,0.0
<a href=/player/laxtb101>laxtb101</a>,Bill Laxton,Cleveland Indians,INDINS,2,2,2,4,1978,1979,1,No,0,-0.32,-1.03,-0.71,42,12,-30,0,0,0,273.0,133.0,-140.0,0.0,0.0,0.0
<a href=/player/laydp101>laydp101</a>,Pete Layden,Boston Red Sox,RSOX,2,8,5,13,1947,1955,8,No,0,6.5,21.93,15.43,835,962,127,1487,3127,1640,2844.0,2066.0,-778.0,10000.0,0.0,-10000.0
<a href=/player/laynh102>laynh102</a>,Herman Layne,Toronto,Toronto,1,1,1,2,1926,1926,0,No,0,-0.13,0.0,0.13,11,0,-11,7,0,-7,0.0,0.0,0.0,0.0,0.0,0.0
<a href=/player/lazzt101>lazzt101</a>,Tony Lazzeri,SaltLakeCity,SaltLakeCity,1,1,4,5,1925,1934,9,No,0,46.39,0.0,-46.39,1659,0,-1659,7068,0,-7068,0.0,0.0,0.0,0.0,0.0,0.0
<a href=/player/leacf101>leacf101</a>,Freddy Leach,Philadelphia Phillies,PHILS,6,13,12,25,1928,1941,13,No,0,20.25,42.09,21.84,1782,1994,212,6979,5506,-1473,324.0,4825.0,4501.0,24000.0,0.0,-24000.0
<a href=/player/leacj001>leacj001</a>,Jalal Leach,Seattle Mariners,MARNRS,1,2,1,3,1998,1998,0,No,0,-0.17,0.32,0.49,8,8,0,12,23,11,0.0,0.0,0.0,0.0,0.0,0.0
<a href=/player/leact001>leact001</a>,Terry Leach,New York Mets,METS,9,20,17,37,1983,2019,36,No,3,34.57,79.41,44.84,2275,4652,2377,5360,12176,6816,3537.0,3405.0,-132.0,15948000.0,0.0,-15948000.0
<a href=/player/leact001>leact001</a>,Terry Leach,Chicago Cubs,CUBS,2,2,3,5,1984,1986,2,No,0,-0.29,0.14,0.43,16,70,54,0,5,5,71.0,155.0,84.0,0.0,0.0,0.0
<a href=/player/leact001>leact001</a>,Terry Leach,New York Mets,METS,1,1,1,2,1989,1989,0,No,0,-0.38,0.0,0.38,30,0,-30,0,0,0,221.0,0.0,-221.0,425000.0,0.0,-425000.0
<a href=/player/leact101>leact101</a>,Tommy Leach,Louisville Colonels,LS3,1,12,5,17,1899,1900,1,No,0,267.1,0.0,-267.1,7388,0,-7388,29004,0,-29004,7568.0,0.0,-7568.0,4350.0,0.0,-4350.0
<a href=/player/leact101>leact101</a>,Tommy Leach,Pittsburgh Pirates,PIRATS,1,2,2,4,1912,1914,2,No,0,9.53,-1.23,-10.76,405,69,-336,1580,172,-1408,276.0,147.0,-129.0,5000.0,0.0,-5000.0
<a href=/player/leagb001>leagb001</a>,Brandon League,Toronto Blue Jays,BJAYS,1,2,1,3,2009,2014,5,No,0,0.98,5.22,4.24,193,105,-88,0,11,11,555.0,1614.0,1059.0,640000.0,0.0,-640000.0
<a href=/player/leagb001>leagb001</a>,Brandon League,Seattle Mariners,MARNRS,1,1,2,3,2012,2012,0,No,0,0.25,0.0,-0.25,290,0,-290,3,0,-3,434.0,0.0,-434.0,5000000.0,0.0,-5000000.0
<a href=/player/leakm001>leakm001</a>,Mike Leake,Cincinnati Reds,REDS,3,3,6,9,2015,2019,4,Yes,0,2.65,6.14,3.49,244,500,256,630,1743,1113,253.0,107.0,-146.0,10420000.0,0.0,-10420000.0
<a href=/player/leakm001>leakm001</a>,Mike Leake,St. Louis Cardinals,CARDS,1,2,1,3,2017,2017,0,Yes,0,4.73,0.0,-4.73,61,0,-61,6,0,-6,1064.0,0.0,-1064.0,0.0,0.0,0.0
<a href=/player/leakm001>leakm001</a>,Mike Leake,Seattle Mariners,MARNRS,1,2,1,3,2019,2019,0,Yes,0,-0.62,0.0,0.62,20,0,-20,22,0,-22,180.0,0.0,-180.0,16000000.0,0.0,-16000000.0
<a href=/player/leall001>leall001</a>,Luis Leal,Toronto Blue Jays,BJAYS,1,2,1,3,1987,1987,0,No,0,-0.66,0.0,0.66,21,0,-21,64,0,-64,0.0,0.0,0.0,0.0,0.0,0.0
<a href=/player/learf102>learf102</a>,Fred Lear,New York Giants,GIANTS,2,6,2,8,1920,1926,6,No,0,11.79,12.89,1.1,909,766,-143,3326,3233,-93,0.0,0.0,0.0,8100.0,0.0,-8100.0
<a href=/player/leart001>leart001</a>,Tim Leary,New York Mets,METS,2,2,2,4,1985,1985,0,No,0,2.94,0.0,-2.94,62,0,-62,0,0,0,1034.0,0.0,-1034.0,0.0,0.0,0.0
<a href=/player/leart001>leart001</a>,Tim Leary,Milwaukee Brewers,BREWRS,1,2,1,3,1986,1991,5,No,0,9.4,4.13,-5.27,749,517,-232,173,1958,1785,2632.0,0.0,-2632.0,90000.0,0.0,-90000.0
<a href=/player/leart001>leart001</a>,Tim Leary,Los Angeles Dodgers,DOGRS,2,3,3,6,1989,1993,4,No,0,3.28,8.3,5.02,375,891,516,1244,2884,1640,269.0,0.0,-269.0,3370000.0,0.0,-3370000.0
<a href=/player/leart001>leart001</a>,Tim Leary,Cincinnati Reds,REDS,1,2,2,4,1989,1997,8,No,0,0.48,12.7,12.22,78,910,832,0,3572,3572,1277.0,0.0,-1277.0,0.0,0.0,0.0
<a href=/player/leart001>leart001</a>,Tim Leary,New York Yankees,YANKS,1,2,1,3,1992,1992,0,No,0,0.13,0.0,-0.13,42,0,-42,0,0,0,640.0,0.0,-640.0,2175000.0,0.0,-2175000.0
<a href=/player/leblw001>leblw001</a>,Wade LeBlanc,San Diego Padres,PADRS,1,1,1,2,2011,2013,2,No,0,1.02,0.2,-0.82,75,79,4,29,260,231,352.0,0.0,-352.0,0.0,0.0,0.0
<a href=/player/leblw001>leblw001</a>,Wade LeBlanc,Toronto Blue Jays,BJAYS,1,1,1,2,2016,2016,0,No,0,3.21,0.0,-3.21,74,0,-74,6,0,-6,1000.0,0.0,-1000.0,0.0,0.0,0.0
<a href=/player/leblw001>leblw001</a>,Wade LeBlanc,Seattle Mariners,MARNRS,1,1,1,2,2016,2016,0,No,0,0.55,0.0,-0.55,112,0,-112,6,0,-6,240.0,0.0,-240.0,0.0,0.0,0.0
<a href=/player/lebob101>lebob101</a>,Bevo LeBourveau,Toledo,Toledo,2,3,2,5,1927,1928,1,No,0,-0.26,0.0,0.26,44,0,-44,66,0,-66,0.0,0.0,0.0,0.0,0.0,0.0
<a href=/player/ledea001>ledea001</a>,Aaron Ledesma,New York Mets,METS,1,1,1,2,1996,1996,0,No,0,0.0,0.0,0.0,0,0,0,0,0,0,0.0,0.0,0.0,0.0,0.0,0.0
<a href=/player/ledea001>ledea001</a>,Aaron Ledesma,Tampa Bay Devil Rays,RAYS,1,2,1,3,1999,2001,2,No,0,-0.33,-0.6,-0.27,69,109,40,75,451,376,304.0,0.0,-304.0,477500.0,0.0,-477500.0
<a href=/player/leder001>leder001</a>,Ricky Ledee,New York Yankees,YANKS,6,10,8,18,2000,2013,13,Yes,1,11.39,22.07,10.68,570,1540,970,441,4696,4255,3809.0,682.0,-3127.0,14660923.0,0.0,-14660923.0
<a href=/player/leder001>leder001</a>,Ricky Ledee,Cleveland Indians,INDINS,2,2,3,5,2000,2000,0,No,2,-1.73,0.96,2.69,136,57,-79,512,245,-267,0.0,0.0,0.0,0.0,0.0,0.0
<a href=/player/leder001>leder001</a>,Ricky Ledee,Philadelphia Phillies,PHILS,2,3,2,5,2004,2005,1,No,0,-0.1,4.09,4.19,66,156,90,60,406,346,97.0,63.0,-34.0,1225000.0,0.0,-1225000.0
<a href=/player/ledew001>ledew001</a>,Wil Ledezma,Detroit Tigers,TIGRS,1,1,1,2,2007,2009,2,No,0,-0.4,-0.23,0.17,24,20,-4,0,0,0,28.0,53.0,25.0,415000.0,0.0,-415000.0
<a href=/player/ledew001>ledew001</a>,Wil Ledezma,Atlanta Braves,BRAVES,1,2,1,3,2007,2008,1,No,0,-0.32,-1.08,-0.76,68,103,35,14,0,-14,206.0,82.0,-124.0,0.0,0.0,0.0
<a href=/player/lee-b001>lee-b001</a>,Braxton Lee,Tampa Bay Devil Rays,RAYS,2,4,2,6,2017,2018,1,Yes,0,0.0,0.91,0.91,23,138,115,65,518,453,0.0,0.0,0.0,5900000.0,0.0,-5900000.0
<a href=/player/lee-b101>lee-b101</a>,Bill Lee,Boston Red Sox,RSOX,2,3,2,5,1978,1980,2,No,0,3.39,0.78,-2.61,191,101,-90,144,278,134,1323.0,0.0,-1323.0,0.0,0.0,0.0
<a href=/player/lee-b103>lee-b103</a>,Bill Lee,Chicago Cubs,CUBS,1,1,1,2,1943,1947,4,No,0,2.12,1.72,-0.4,114,192,78,123,613,490,1037.0,0.0,-1037.0,0.0,0.0,0.0
<a href=/player/lee-b104>lee-b104</a>,Bob Lee,California Angels,ANGELS,6,6,7,13,1966,1973,7,No,0,0.39,3.62,3.23,367,666,299,804,481,-323,536.0,1872.0,1336.0,37500.0,0.0,-37500.0
<a href=/player/lee-c001>lee-c001</a>,Carlos Lee,Chicago White Sox,WSOX,4,8,10,18,2004,2015,11,No,0,24.22,21.59,-2.63,1425,1269,-156,4832,3644,-1188,1060.0,2093.0,1033.0,23205000.0,0.0,-23205000.0
<a href=/player/lee-c001>lee-c001</a>,Carlos Lee,Milwaukee Brewers,BREWRS,10,19,21,40,2006,2020,14,Yes,1,46.28,26.59,-19.69,3627,1663,-1964,13855,4499,-9356,777.0,3218.0,2441.0,28905500.0,0.0,-28905500.0
<a href=/player/lee-c001>lee-c001</a>,Carlos Lee,Houston Astros,ASTROS,2,2,3,5,2012,2015,3,No,0,-0.39,1.76,2.15,81,340,259,338,1309,971,0.0,0.0,0.0,18500000.0,0.0,-18500000.0
<a href=/player/lee-c002>lee-c002</a>,Corey Lee,Texas Rangers,RNGRS,1,1,1,2,2001,2004,3,No,0,0.0,1.52,1.52,0,192,192,0,673,673,0.0,0.0,0.0,0.0,0.0,0.0
<a href=/player/lee-c003>lee-c003</a>,Cliff Lee,Montreal Expos,NATEX,2,6,6,12,2002,2004,2,No,0,48.64,-2.57,-51.21,1323,330,-993,4723,156,-4567,4264.0,874.0,-3390.0,4000000.0,0.0,-4000000.0
<a href=/player/lee-c003>lee-c003</a>,Cliff Lee,Cleveland Indians,INDINS,6,12,19,31,2009,2021,12,Yes,0,33.76,50.43,16.67,987,1821,834,2686,3190,504,3042.0,8206.0,5164.0,29385300.0,0.0,-29385300.0
<a href=/player/lee-c003>lee-c003</a>,Cliff Lee,Philadelphia Phillies,PHILS,1,1,3,4,2009,2015,6,No,0,3.42,-1.46,-4.88,14,125,111,3,3,0,311.0,203.0,-108.0,0.0,0.0,0.0
<a href=/player/lee-c003>lee-c003</a>,Cliff Lee,Seattle Mariners,MARNRS,5,8,8,16,2010,2014,4,No,0,3.8,5.22,1.42,345,797,452,623,2614,1991,753.0,1105.0,352.0,10564000.0,0.0,-10564000.0
<a href=/player/lee-c101>lee-c101</a>,Cliff Lee,Cincinnati Reds,REDS,1,1,1,2,1924,1924,0,No,0,0.0,0.0,0.0,0,0,0,0,0,0,0.0,0.0,0.0,4500.0,0.0,-4500.0
<a href=/player/lee-d001>lee-d001</a>,Derek Lee,Minnesota Twins,TWINS,1,1,1,2,1994,1994,0,No,0,0.0,0.0,0.0,0,0,0,0,0,0,0.0,0.0,0.0,0.0,0.0,0.0
<a href=/player/lee-d002>lee-d002</a>,Derrek Lee,San Diego Padres,PADRS,3,8,6,14,1997,2004,7,No,2,9.3,8.56,-0.74,1047,116,-931,3508,178,-3330,311.0,814.0,503.0,0.0,0.0,0.0
<a href=/player/lee-d002>lee-d002</a>,Derrek Lee,Florida Marlins,MARLNS,11,20,27,47,2003,2019,16,Yes,0,98.47,55.74,-42.73,3402,2977,-425,10315,8666,-1649,10672.0,5424.0,-5248.0,42818667.0,0.0,-42818667.0
<a href=/player/lee-d002>lee-d002</a>,Derrek Lee,Chicago Cubs,CUBS,1,1,3,4,2010,2010,0,No,0,0.92,0.0,-0.92,39,0,-39,151,0,-151,0.0,0.0,0.0,13250000.0,0.0,-13250000.0
<a href=/player/lee-d002>lee-d002</a>,Derrek Lee,Baltimore Orioles,ORLS,1,1,1,2,2011,2011,0,No,0,0.86,0.0,-0.86,28,0,-28,113,0,-113,0.0,0.0,0.0,7250000.0,0.0,-7250000.0
<a href=/player/lee-d003>lee-d003</a>,David Lee,Colorado Rockies,ROCKS,1,1,2,3,2001,2001,0,No,0,0.0,0.0,0.0,0,0,0,0,0,0,0.0,0.0,0.0,0.0,0.0,0.0
<a href=/player/lee-d003>lee-d003</a>,David Lee,New York Yankees,YANKS,1,1,1,2,2001,2001,0,No,0,0.68,0.25,-0.43,79,11,-68,1,0,-1,146.0,32.0,-114.0,0.0,0.0,0.0
<a href=/player/lee-d003>lee-d003</a>,David Lee,Los Angeles Dodgers,DOGRS,1,1,1,2,2003,2003,0,No,0,-0.13,0.0,0.13,12,0,-12,0,0,0,36.0,0.0,-36.0,0.0,0.0,0.0
<a href=/player/lee-d102>lee-d102</a>,Don Lee,Detroit Tigers,TIGRS,1,2,3,5,1959,1964,5,No,0,0.34,-0.23,-0.57,101,194,93,212,543,331,0.0,0.0,0.0,0.0,0.0,0.0
<a href=/player/lee-d102>lee-d102</a>,Don Lee,Minnesota Twins,TWINS,1,1,1,2,1962,1962,0,No,0,2.67,-0.41,-3.08,220,12,-208,129,2,-127,1232.0,31.0,-1201.0,0.0,0.0,0.0
<a href=/player/lee-d102>lee-d102</a>,Don Lee,California Angels,ANGELS,1,1,1,2,1965,1966,1,No,0,0.69,0.69,0.0,32,57,25,2,115,113,78.0,0.0,-78.0,16500.0,0.0,-16500.0
<a href=/player/lee-h101>lee-h101</a>,Hal Lee,Brooklyn Dodgers,DOGRS,2,6,3,9,1930,1936,6,No,0,9.9,18.06,8.16,811,786,-25,1763,3200,1437,2519.0,0.0,-2519.0,18200.0,0.0,-18200.0
<a href=/player/lee-h101>lee-h101</a>,Hal Lee,Philadelphia Phillies,PHILS,4,10,6,16,1933,1941,8,No,0,6.58,22.7,16.12,1012,1092,80,3802,2883,-919,324.0,2494.0,2170.0,0.0,0.0,0.0
<a href=/player/lee-k001>lee-k001</a>,Khalil Lee,Kansas City Royals,ROYALS,1,4,2,6,2021,2021,0,Yes,0,-0.36,2.43,2.79,11,134,123,18,538,520,0.0,0.0,0.0,0.0,0.0,0.0
<a href=/player/lee-l101>lee-l101</a>,Leron Lee,St. Louis Cardinals,CARDS,5,6,5,11,1971,1976,5,No,0,12.13,1.76,-10.37,660,184,-476,1378,165,-1213,1880.0,841.0,-1039.0,34000.0,0.0,-34000.0
<a href=/player/lee-m001>lee-m001</a>,Manuel Lee,New York Mets,METS,8,19,15,34,1984,2019,35,No,3,34.57,79.41,44.84,2275,4652,2377,5360,12176,6816,3537.0,3405.0,-132.0,15948000.0,0.0,-15948000.0
<a href=/player/lee-m002>lee-m002</a>,Mark Lee,Detroit Tigers,TIGRS,1,2,1,3,1988,1989,1,No,0,-0.33,-0.3,0.03,105,4,-101,125,0,-125,15.0,56.0,41.0,0.0,0.0,0.0
<a href=/player/lee-m101>lee-m101</a>,Mark Lee,San Diego Padres,PADRS,3,8,6,14,1980,1989,9,No,0,23.83,6.58,-17.25,2167,688,-1479,6899,2080,-4819,2009.0,1127.0,-882.0,0.0,0.0,0.0
<a href=/player/lee-m102>lee-m102</a>,Mike Lee,Cleveland Indians,INDINS,1,3,1,4,1961,1962,1,No,0,0.0,0.7,0.7,3,41,38,3,74,71,0.0,0.0,0.0,0.0,0.0,0.0
<a href=/player/lee-t002>lee-t002</a>,Travis Lee,Arizona Diamondbacks,DBACKS,9,20,18,38,2000,2012,12,No,3,42.56,26.41,-16.15,3086,1039,-2047,7001,1054,-5947,9526.0,4276.0,-5250.0,24075667.0,0.0,-24075667.0
<a href=/player/lee-t101>lee-t101</a>,Thornton Lee,Cleveland Indians,INDINS,1,1,1,2,1936,1939,3,No,0,30.28,-1.03,-31.31,523,118,-405,732,125,-607,5664.0,922.0,-4742.0,5000.0,0.0,-5000.0
<a href=/player/lee-z001>lee-z001</a>,Zach Lee,Los Angeles Dodgers,DOGRS,1,1,1,2,2016,2021,5,No,0,0.0,14.83,14.83,0,657,657,0,2444,2444,0.0,0.0,0.0,0.0,0.0,0.0
<a href=/player/lefeb101>lefeb101</a>,Bill LeFebvre,Minneapolis,Minneapolis,1,1,1,2,1943,1943,0,No,0,-0.19,0.0,0.19,97,0,-97,90,0,-90,306.0,0.0,-306.0,0.0,0.0,0.0
<a href=/player/lefej001>lefej001</a>,Joe Lefebvre,New York Yankees,YANKS,6,13,11,24,1981,1992,11,No,0,27.03,19.65,-7.38,2401,1053,-1348,5956,3510,-2446,5438.0,699.0,-4739.0,913333.0,0.0,-913333.0
<a href=/player/lefej001>lefej001</a>,Joe Lefebvre,San Diego Padres,PADRS,1,1,1,2,1983,1984,1,No,0,1.67,0.31,-1.36,167,120,-47,503,12,-491,0.0,251.0,251.0,0.0,0.0,0.0
<a href=/player/leffc001>leffc001</a>,Craig Lefferts,Chicago Cubs,CUBS,2,4,2,6,1983,1989,6,No,1,15.56,10.82,-4.74,1534,321,-1213,2801,249,-2552,1977.0,2213.0,236.0,0.0,0.0,0.0
<a href=/player/leffc001>leffc001</a>,Craig Lefferts,San Diego Padres,PADRS,7,11,13,24,1987,2002,15,No,2,21.85,22.61,0.76,1316,1503,187,3009,1610,-1399,2250.0,5770.0,3520.0,10183333.0,0.0,-10183333.0
<a href=/player/leffc001>leffc001</a>,Craig Lefferts,San Diego Padres,PADRS,17,33,34,67,1992,2010,18,No,6,18.55,51.21,32.66,3704,4655,951,12670,16133,3463,1343.0,1789.0,446.0,27431467.0,0.0,-27431467.0
<a href=/player/leflr101>leflr101</a>,Ron LeFlore,Detroit Tigers,TIGRS,2,3,2,5,1979,1986,7,No,0,0.5,12.31,11.81,197,727,530,605,2558,1953,218.0,792.0,574.0,0.0,0.0,0.0
<a href=/player/leflw101>leflw101</a>,Wade Lefler,Washington Senators,TWINS,4,11,5,16,1924,1941,17,No,0,16.54,44.06,27.52,920,1674,754,2170,6771,4601,3390.0,1035.0,-2355.0,27200.0,0.0,-27200.0
<a href=/player/legel101>legel101</a>,Lou Legett,Chicago Cubs,CUBS,1,6,1,7,1928,1932,4,No,0,4.13,16.12,11.99,1036,317,-719,2232,1321,-911,4216.0,0.0,-4216.0,13000.0,0.0,-13000.0
<a href=/player/lehmk101>lehmk101</a>,Ken Lehman,Philadelphia Phillies,PHILS,1,2,1,3,1962,1962,0,No,0,0.0,-1.42,-1.42,19,65,46,19,111,92,0.0,0.0,0.0,0.0,0.0,0.0
<a href=/player/lehnp101>lehnp101</a>,Paul Lehner,St.Louis Browns,ORLS,1,2,5,7,1949,1951,2,No,0,2.11,-0.19,-2.3,207,217,10,887,812,-75,0.0,0.0,0.0,0.0,0.0,0.0
<a href=/player/lehnp101>lehnp101</a>,Paul Lehner,Philadelphia Athletics,ATLTCS,35,74,76,150,1951,1976,25,No,0,94.84,72.83,-22.01,10296,9253,-1043,24713,28375,3662,12563.0,7417.0,-5146.0,500300.0,0.0,-500300.0
<a href=/player/lehnp101>lehnp101</a>,Paul Lehner,Chicago White Sox,WSOX,27,53,44,97,1951,1969,18,No,0,83.35,62.63,-20.72,6936,5271,-1665,17430,11733,-5697,13187.0,9922.0,-3265.0,288750.0,0.0,-288750.0
<a href=/player/lehrj001>lehrj001</a>,Justin Lehr,Oakland Athletics,ATLTCS,1,2,1,3,2004,2006,2,No,0,-0.55,-0.87,-0.32,86,51,-35,10,156,146,151.0,0.0,-151.0,0.0,0.0,0.0
<a href=/player/leibc001>leibc001</a>,Charlie Leibrandt,Cincinnati Reds,REDS,1,1,1,2,1983,1983,0,No,0,22.85,0.0,-22.85,194,0,-194,0,0,0,3771.0,0.0,-3771.0,0.0,0.0,0.0
<a href=/player/leibc001>leibc001</a>,Charlie Leibrandt,Kansas City Royals,ROYALS,1,2,2,4,1989,1990,1,No,0,8.3,0.22,-8.08,256,133,-123,214,512,298,1914.0,0.0,-1914.0,1318000.0,0.0,-1318000.0
<a href=/player/leibc001>leibc001</a>,Charlie Leibrandt,Atlanta Braves,BRAVES,3,4,3,7,1992,1999,7,No,0,0.31,0.4,0.09,48,230,182,82,473,391,451.0,0.0,-451.0,3294833.0,0.0,-3294833.0
<a href=/player/leibh101>leibh101</a>,Hank Leiber,New York Giants,GIANTS,2,7,4,11,1938,1949,11,No,0,11.69,46.84,35.15,813,1845,1032,2964,7276,4312,38.0,0.0,-38.0,0.0,0.0,0.0
<a href=/player/leibh101>leibh101</a>,Hank Leiber,Chicago Cubs,CUBS,1,1,1,2,1941,1941,0,No,0,-0.08,0.0,0.08,59,0,-59,170,0,-170,27.0,0.0,-27.0,0.0,0.0,0.0
<a href=/player/leibn101>leibn101</a>,Nemo Leibold,Milwaukee,Milwaukee,1,1,1,2,1913,1915,2,No,0,2.31,0.0,-2.31,265,0,-265,1014,0,-1014,0.0,0.0,0.0,0.0,0.0,0.0
<a href=/player/leibn101>leibn101</a>,Nemo Leibold,Chicago White Sox,WSOX,1,2,1,3,1921,1921,0,No,0,-2.09,3.07,5.16,680,108,-572,2600,485,-2115,0.0,0.0,0.0,0.0,0.0,0.0
<a href=/player/leicj001>leicj001</a>,Jon Leicester,Chicago Cubs,CUBS,1,1,1,2,2005,2005,0,No,0,0.0,0.0,0.0,0,0,0,0,0,0,0.0,0.0,0.0,300000.0,0.0,-300000.0
<a href=/player/leifl101>leifl101</a>,Lefty Leifield,Pittsburgh Pirates,PIRATS,1,2,2,4,1912,1914,2,No,0,9.53,-1.23,-10.76,405,69,-336,1580,172,-1408,276.0,147.0,-129.0,5000.0,0.0,-5000.0
<a href=/player/leipd001>leipd001</a>,Dave Leiper,Oakland Athletics,ATLTCS,2,3,3,6,1987,1992,5,No,2,0.04,3.46,3.42,202,69,-133,145,0,-145,296.0,1204.0,908.0,73133.0,0.0,-73133.0
<a href=/player/leipd001>leipd001</a>,Dave Leiper,Oakland Athletics,ATLTCS,1,1,1,2,1995,1995,0,No,0,0.28,0.0,-0.28,66,0,-66,1,0,-1,78.0,0.0,-78.0,195000.0,0.0,-195000.0
<a href=/player/leita001>leita001</a>,Al Leiter,New York Yankees,YANKS,1,1,1,2,1989,1992,3,No,0,8.49,9.91,1.42,91,396,305,0,1525,1525,1246.0,0.0,-1246.0,80000.0,0.0,-80000.0
<a href=/player/leita001>leita001</a>,Al Leiter,Florida Marlins,MARLNS,13,17,28,45,1998,2013,15,No,2,104.01,35.0,-69.01,4242,2819,-1423,12260,4200,-8060,7601.0,10460.0,2859.0,18420219.0,0.0,-18420219.0
<a href=/player/leitm001>leitm001</a>,Mark Leiter,New York Yankees,YANKS,1,1,1,2,1991,1992,1,No,0,2.42,-0.45,-2.87,102,22,-80,0,59,59,1060.0,0.0,-1060.0,0.0,0.0,0.0
<a href=/player/leitm001>leitm001</a>,Mark Leiter,San Francisco Giants,GIANTS,1,1,2,3,1996,2005,9,No,0,0.67,12.18,11.51,24,598,574,29,619,590,209.0,4901.0,4692.0,1850000.0,0.0,-1850000.0
<a href=/player/leitm001>leitm001</a>,Mark Leiter,Philadelphia Phillies,PHILS,2,2,2,4,1998,2002,4,No,0,0.11,5.22,5.11,41,221,180,0,220,220,190.0,1853.0,1663.0,2450000.0,0.0,-2450000.0
<a href=/player/leitm001>leitm001</a>,Mark Leiter,New York Mets,METS,1,1,1,2,2001,2001,0,No,0,0.0,0.1,0.1,0,6,6,0,1,1,0.0,26.0,26.0,0.0,0.0,0.0
<a href=/player/leitm001>leitm001</a>,Mark Leiter,Colorado Rockies,ROCKS,3,5,5,10,2001,2002,1,No,0,3.56,0.31,-3.25,524,189,-335,63,5,-58,907.0,301.0,-606.0,0.0,0.0,0.0
<a href=/player/lejaf101>lejaf101</a>,Frank Leja,New York Yankees,YANKS,1,1,1,2,1961,1961,0,No,0,0.0,0.0,0.0,0,0,0,0,0,0,0.0,0.0,0.0,0.0,0.0,0.0
<a href=/player/lejaf101>lejaf101</a>,Frank Leja,Los Angeles Angels,ANGELS,3,3,3,6,1962,1965,3,No,0,0.53,0.33,-0.2,78,198,120,8,17,9,193.0,430.0,237.0,0.0,0.0,0.0
<a href=/player/lelib101>lelib101</a>,Bill Lelivelt,Mobile,Mobile,1,1,3,4,1909,1916,7,No,0,-0.07,0.0,0.07,10,0,-10,11,0,-11,87.0,0.0,-87.0,0.0,0.0,0.0
<a href=/player/lelij101>lelij101</a>,Jack Lelivelt,Rochester,Rochester,1,1,2,3,1912,1913,1,No,0,1.09,0.0,-1.09,54,0,-54,184,0,-184,0.0,0.0,0.0,0.0,0.0,0.0
<a href=/player/lelij101>lelij101</a>,Jack Lelivelt,New York Yankees,YANKS,5,13,8,21,1913,1946,33,No,0,28.8,113.37,84.57,1052,3692,2640,1402,9991,8589,7730.0,15194.0,7464.0,42500.0,0.0,-42500.0
<a href=/player/lelij101>lelij101</a>,Jack Lelivelt,Washington Senators,TWINS,5,11,10,21,1911,1926,15,No,0,13.21,49.63,36.42,1111,2437,1326,3734,9513,5779,894.0,3052.0,2158.0,21400.0,0.0,-21400.0
<a href=/player/lemad001>lemad001</a>,DJ LeMahieu,Chicago Cubs,CUBS,1,2,2,4,2011,2013,2,No,0,17.66,0.03,-17.63,1081,55,-1026,4267,202,-4065,0.0,0.0,0.0,440000.0,0.0,-440000.0
<a href=/player/lemad101>lemad101</a>,Dave Lemanczyk,Toronto Blue Jays,BJAYS,1,1,1,2,1980,1982,2,No,0,0.01,-0.15,-0.16,21,26,5,0,0,0,200.0,139.0,-61.0,0.0,0.0,0.0
<a href=/player/lemad102>lemad102</a>,Denny Lemaster,Atlanta Braves,BRAVES,1,2,2,4,1967,1974,7,No,0,20.12,0.7,-19.42,938,637,-301,2766,2102,-664,2072.0,0.0,-2072.0,0.0,0.0,0.0
<a href=/player/lemad103>lemad103</a>,Dick LeMay,San Francisco Giants,GIANTS,1,2,1,3,1962,1964,2,No,0,0.0,-0.41,-0.41,0,54,54,0,153,153,0.0,0.0,0.0,0.0,0.0,0.0
<a href=/player/lemad103>lemad103</a>,Dick LeMay,Houston Astros,ASTROS,3,7,4,11,1963,1965,2,No,0,1.38,1.37,-0.01,248,133,-115,214,502,288,382.0,0.0,-382.0,0.0,0.0,0.0
<a href=/player/lemad103>lemad103</a>,Dick LeMay,Chicago Cubs,CUBS,1,1,1,2,1964,1964,0,No,0,0.0,0.17,0.17,0,30,30,0,16,16,0.0,54.0,54.0,0.0,0.0,0.0
<a href=/player/lemaj001>lemaj001</a>,Johnnie LeMaster,San Francisco Giants,GIANTS,1,1,2,3,1985,1986,1,No,0,-0.5,-0.96,-0.46,11,109,98,21,117,96,0.0,66.0,66.0,500000.0,0.0,-500000.0
<a href=/player/lemaj001>lemaj001</a>,Johnnie LeMaster,Cleveland Indians,INDINS,2,2,3,5,1985,1991,6,No,0,-2.11,1.58,3.69,123,251,128,65,245,180,377.0,1475.0,1098.0,0.0,0.0,0.0
<a href=/player/lemoc001>lemoc001</a>,Chet Lemon,Oakland Athletics,ATLTCS,4,6,5,11,1975,1987,12,No,1,27.96,4.15,-23.81,1459,277,-1182,3568,237,-3331,2461.0,2375.0,-86.0,425000.0,0.0,-425000.0
<a href=/player/lemoc001>lemoc001</a>,Chet Lemon,Chicago White Sox,WSOX,3,4,3,7,1981,1989,8,No,1,30.93,3.46,-27.47,1212,275,-937,4676,908,-3768,99.0,743.0,644.0,0.0,0.0,0.0
<a href=/player/lemod101>lemod101</a>,Dave Lemonds,Chicago Cubs,CUBS,1,3,2,5,1970,1973,3,No,0,1.15,0.0,-1.15,69,0,-69,29,0,-29,290.0,0.0,-290.0,0.0,0.0,0.0
<a href=/player/lemom101>lemom101</a>,Mark Lemongello,Detroit Tigers,TIGRS,1,4,3,7,1975,1979,4,No,0,4.11,5.38,1.27,431,290,-141,467,862,395,1859.0,1144.0,-715.0,16500.0,0.0,-16500.0
<a href=/player/lemom101>lemom101</a>,Mark Lemongello,Houston Astros,ASTROS,1,3,1,4,1978,1989,11,No,0,-3.72,7.9,11.62,160,965,805,206,3318,3112,249.0,0.0,-249.0,22500.0,0.0,-22500.0
<a href=/player/lenhd101>lenhd101</a>,Don Lenhardt,St.Louis Browns,ORLS,25,55,52,107,1951,1994,43,No,3,84.38,155.45,71.07,5444,9197,3753,11482,26381,14899,18826.0,17928.0,-898.0,984333.0,0.0,-984333.0
<a href=/player/lenhd101>lenhd101</a>,Don Lenhardt,Chicago White Sox,WSOX,26,50,43,93,1951,1969,18,No,0,84.01,61.56,-22.45,6907,5207,-1700,17328,11506,-5822,13187.0,9922.0,-3265.0,288750.0,0.0,-288750.0
<a href=/player/lenhd101>lenhd101</a>,Don Lenhardt,Boston Red Sox,RSOX,2,6,6,12,1952,1956,4,No,0,8.2,10.1,1.9,1335,867,-468,4777,3045,-1732,507.0,401.0,-106.0,80000.0,0.0,-80000.0
<a href=/player/lenhd101>lenhd101</a>,Don Lenhardt,Detroit Tigers,TIGRS,6,16,16,32,1952,1961,9,No,0,19.6,10.08,-9.52,1436,1371,-65,2274,3811,1537,4378.0,2214.0,-2164.0,23200.0,0.0,-23200.0
<a href=/player/lennb102>lennb102</a>,Bob Lennon,New York Giants,GIANTS,3,5,5,10,1957,1961,4,No,0,26.85,7.67,-19.18,1312,551,-761,4817,1078,-3739,197.0,1899.0,1702.0,0.0,0.0,0.0
<a href=/player/lentj101>lentj101</a>,Jim Lentine,St. Louis Cardinals,CARDS,1,1,2,3,1980,1983,3,No,0,0.54,1.37,0.83,67,153,86,195,89,-106,0.0,831.0,831.0,0.0,0.0,0.0
<a href=/player/lentj101>lentj101</a>,Jim Lentine,Cleveland Indians,INDINS,2,3,2,5,1981,1988,7,No,0,-0.63,0.93,1.56,71,387,316,116,855,739,0.0,0.0,0.0,190000.0,0.0,-190000.0
<a href=/player/leond003>leond003</a>,Dominic Leone,Seattle Mariners,MARNRS,3,7,4,11,2015,2017,2,Yes,0,4.57,3.33,-1.24,655,244,-411,2424,508,-1916,92.0,403.0,311.0,9532900.0,0.0,-9532900.0
<a href=/player/leond003>leond003</a>,Dominic Leone,Toronto Blue Jays,BJAYS,1,2,1,3,2018,2018,0,Yes,0,-0.49,2.45,2.94,137,124,-13,0,462,462,194.0,0.0,-194.0,0.0,0.0,0.0
<a href=/player/leond101>leond101</a>,Dave Leonhard,Baltimore Orioles,ORLS,1,1,1,2,1973,1973,0,No,0,0.0,0.0,0.0,0,0,0,0,0,0,0.0,0.0,0.0,0.0,0.0,0.0
<a href=/player/leond102>leond102</a>,Dutch Leonard,Boston Red Sox,RSOX,4,11,11,22,1918,1925,7,No,0,12.28,-1.18,-13.46,1743,839,-904,6150,3067,-3083,700.0,265.0,-435.0,3300.0,0.0,-3300.0
<a href=/player/leond102>leond102</a>,Dutch Leonard,Detroit Tigers,TIGRS,2,6,2,8,1925,1928,3,No,0,0.0,1.07,1.07,0,324,324,0,1271,1271,0.0,0.0,0.0,0.0,0.0,0.0
<a href=/player/leond103>leond103</a>,Dutch Leonard,Brooklyn Dodgers,DOGRS,1,3,1,4,1936,1938,2,No,0,0.05,-0.59,-0.64,177,153,-24,491,535,44,0.0,3.0,3.0,0.0,0.0,0.0
<a href=/player/leond103>leond103</a>,Dutch Leonard,Philadelphia Phillies,PHILS,1,2,2,4,1948,1954,6,No,0,13.76,7.72,-6.04,587,642,55,227,2516,2289,2431.0,597.0,-1834.0,0.0,0.0,0.0
<a href=/player/leone102>leone102</a>,Eddie Leon,Cleveland Indians,INDINS,5,8,6,14,1972,1976,4,No,0,-4.65,5.11,9.76,465,173,-292,963,371,-592,1098.0,1299.0,201.0,90500.0,0.0,-90500.0
<a href=/player/leone102>leone102</a>,Eddie Leon,Chicago White Sox,WSOX,1,1,1,2,1974,1976,2,No,0,0.0,0.79,0.79,1,29,28,0,0,0,0.0,142.0,142.0,29000.0,0.0,-29000.0
<a href=/player/leonj001>leonj001</a>,Jeffrey Leonard,Los Angeles Dodgers,DOGRS,1,2,2,4,1978,1981,3,No,0,4.6,3.69,-0.91,609,283,-326,1828,907,-921,0.0,0.0,0.0,0.0,0.0,0.0
<a href=/player/leonj001>leonj001</a>,Jeffrey Leonard,Houston Astros,ASTROS,1,2,1,3,1981,1982,1,No,0,11.7,-0.13,-11.83,1042,26,-1016,3644,52,-3592,0.0,0.0,0.0,0.0,0.0,0.0
<a href=/player/leonj001>leonj001</a>,Jeffrey Leonard,San Francisco Giants,GIANTS,5,7,11,18,1988,1998,10,No,0,9.31,9.81,0.5,513,1045,532,1166,3331,2165,1958.0,96.0,-1862.0,7402778.0,0.0,-7402778.0
<a href=/player/leonj002>leonj002</a>,Jose Leon,St. Louis Cardinals,CARDS,1,1,2,3,2000,2000,0,No,0,-0.66,2.14,2.8,88,51,-37,221,197,-24,0.0,0.0,0.0,0.0,0.0,0.0
<a href=/player/leonj101>leonj101</a>,Joe Leonard,Cleveland Indians,INDINS,1,2,2,4,1916,1916,0,No,0,1.57,0.61,-0.96,293,50,-243,1105,56,-1049,0.0,182.0,182.0,0.0,0.0,0.0
<a href=/player/leonm001>leonm001</a>,Mark Leonard,San Francisco Giants,GIANTS,1,1,1,2,1993,1996,3,No,0,-0.25,1.3,1.55,10,281,271,21,810,789,0.0,0.0,0.0,0.0,0.0,0.0
<a href=/player/leons001>leons001</a>,Sandy Leon,Boston Red Sox,RSOX,1,1,1,2,2019,2019,0,Yes,0,-0.16,0.0,0.16,25,0,-25,81,0,-81,0.0,0.0,0.0,2475000.0,0.0,-2475000.0
<a href=/player/lepct101>lepct101</a>,Ted Lepcio,Boston Red Sox,RSOX,2,3,2,5,1959,1959,0,No,0,7.37,-0.54,-7.91,476,29,-447,344,14,-330,1329.0,127.0,-1202.0,11000.0,0.0,-11000.0
<a href=/player/lepct101>lepct101</a>,Ted Lepcio,Detroit Tigers,TIGRS,5,9,7,16,1959,1967,8,No,0,4.29,0.05,-4.24,724,813,89,2270,1691,-579,122.0,890.0,768.0,38000.0,0.0,-38000.0
<a href=/player/leppd101>leppd101</a>,Don Leppert,Dallas,Dallas,1,1,1,2,1960,1961,1,No,0,0.65,0.0,-0.65,67,0,-67,216,0,-216,0.0,0.0,0.0,0.0,0.0,0.0
<a href=/player/leppd101>leppd101</a>,Don Leppert,Pittsburgh Pirates,PIRATS,1,1,2,3,1962,1962,0,No,0,-0.33,0.0,0.33,123,0,-123,369,0,-369,0.0,0.0,0.0,0.0,0.0,0.0
<a href=/player/leppd102>leppd102</a>,Don Leppert,New York Yankees,YANKS,12,33,27,60,1954,1970,16,No,0,40.55,76.98,36.43,5201,4368,-833,16466,10777,-5689,3212.0,10751.0,7539.0,302500.0,0.0,-302500.0
<a href=/player/lercr001>lercr001</a>,Randy Lerch,Philadelphia Phillies,PHILS,3,3,3,6,1981,1983,2,No,0,-1.26,0.49,1.75,48,118,70,12,263,251,658.0,0.0,-658.0,160000.0,0.0,-160000.0
<a href=/player/leriw101>leriw101</a>,Walt Lerian,NewHaven,NewHaven,1,1,3,4,1928,1928,0,No,0,1.99,0.0,-1.99,201,0,-201,625,0,-625,0.0,0.0,0.0,0.0,0.0,0.0
<a href=/player/lersb101>lersb101</a>,Barry Lersch,Philadelphia Phillies,PHILS,1,2,1,3,1973,1977,4,No,0,-0.85,1.42,2.27,197,250,53,576,78,-498,0.0,1037.0,1037.0,0.0,0.0,0.0
<a href=/player/leskc001>leskc001</a>,Curt Leskanic,Cleveland Indians,INDINS,1,2,1,3,1992,1995,3,No,0,-0.31,3.9,4.21,10,487,477,0,1779,1779,106.0,0.0,-106.0,0.0,0.0,0.0
<a href=/player/leskc001>leskc001</a>,Curt Leskanic,Colorado Rockies,ROCKS,3,3,4,7,1999,2006,7,No,0,5.07,3.08,-1.99,614,513,-101,88,616,528,740.0,256.0,-484.0,1050000.0,0.0,-1050000.0
<a href=/player/leskc001>leskc001</a>,Curt Leskanic,Milwaukee Brewers,BREWRS,2,2,3,5,2003,2006,3,No,0,0.53,0.38,-0.15,46,223,177,0,83,83,125.0,891.0,766.0,4042000.0,0.0,-4042000.0
<a href=/player/leslr101>leslr101</a>,Roy Leslie,Philadelphia Phillies,PHILS,4,9,8,17,1922,1936,14,No,0,25.37,3.27,-22.1,1352,2052,700,5364,8721,3357,77.0,0.0,-77.0,43100.0,0.0,-43100.0
<a href=/player/leslr101>leslr101</a>,Roy Leslie,NewOrleans,NewOrleans,1,1,2,3,1921,1922,1,No,0,-2.16,0.0,2.16,141,0,-141,567,0,-567,0.0,0.0,0.0,0.0,0.0,0.0
<a href=/player/lesls101>lesls101</a>,Sam Leslie,New York Giants,GIANTS,1,1,2,3,1933,1935,2,No,0,7.41,2.63,-4.78,384,203,-181,1597,478,-1119,0.0,188.0,188.0,0.0,0.0,0.0
<a href=/player/lestj001>lestj001</a>,Jon Lester,Boston Red Sox,RSOX,2,6,3,9,2014,2019,5,No,0,10.72,10.88,0.16,412,221,-191,504,237,-267,1024.0,2892.0,1868.0,15500000.0,0.0,-15500000.0
<a href=/player/lestj001>lestj001</a>,Jon Lester,Washington Nationals,NATEX,1,1,1,2,2021,2021,0,Yes,0,0.07,1.31,1.24,23,45,22,22,206,184,198.0,0.0,-198.0,0.0,0.0,0.0
<a href=/player/levej101>levej101</a>,Jim Levey,St.Louis Browns,ORLS,14,27,34,61,1933,1952,19,No,0,55.71,57.94,2.23,2756,6888,4132,8050,21355,13305,6789.0,12669.0,5880.0,138000.0,0.0,-138000.0
<a href=/player/levia001>levia001</a>,Al Levine,Chicago White Sox,WSOX,1,2,1,3,1997,1998,1,No,0,0.48,0.0,-0.48,32,0,-32,0,0,0,174.0,0.0,-174.0,157500.0,0.0,-157500.0
<a href=/player/levij001>levij001</a>,Jesse Levis,Cleveland Indians,INDINS,1,1,2,3,1996,1999,3,No,0,1.72,0.0,-1.72,237,0,-237,590,0,-590,0.0,0.0,0.0,0.0,0.0,0.0
<a href=/player/levye101>levye101</a>,Ed Levy,New York Yankees,YANKS,1,1,2,3,1940,1940,0,No,0,0.0,0.0,0.0,1,0,-1,1,0,-1,0.0,0.0,0.0,0.0,0.0,0.0
<a href=/player/levye101>levye101</a>,Ed Levy,New York Yankees,YANKS,1,3,1,4,1943,1947,4,No,0,0.0,11.41,11.41,0,568,568,0,2373,2373,0.0,0.0,0.0,0.0,0.0,0.0
<a href=/player/levye101>levye101</a>,Ed Levy,New York Yankees,YANKS,1,2,1,3,1944,1944,0,No,0,0.0,2.33,2.33,0,85,85,0,368,368,0.0,0.0,0.0,0.0,0.0,0.0
<a href=/player/levye101>levye101</a>,Ed Levy,Milwaukee,Milwaukee,1,1,3,4,1944,1944,0,No,0,0.0,0.0,0.0,0,0,0,0,0,0,0.0,0.0,0.0,0.0,0.0,0.0
<a href=/player/lewad101>lewad101</a>,Dennis Lewallyn,Los Angeles Dodgers,DOGRS,1,2,1,3,1980,1981,1,No,0,-0.26,-0.19,0.07,4,39,35,0,48,48,17.0,0.0,-17.0,0.0,0.0,0.0
<a href=/player/lewib101>lewib101</a>,Bill Lewis,Boston Braves,BRAVES,2,2,3,5,1936,1940,4,No,0,3.89,9.19,5.3,101,210,109,121,334,213,909.0,2042.0,1133.0,12500.0,0.0,-12500.0
<a href=/player/lewib102>lewib102</a>,Bert Lewis,Richmond,Richmond,1,1,1,2,1924,1924,0,No,0,0.1,0.0,-0.1,24,0,-24,5,0,-5,54.0,0.0,-54.0,0.0,0.0,0.0
<a href=/player/lewid001>lewid001</a>,Darren Lewis,Oakland Athletics,ATLTCS,1,2,1,3,1990,1991,1,No,0,4.57,0.41,-4.16,496,108,-388,2054,321,-1733,0.0,0.0,0.0,100000.0,0.0,-100000.0
<a href=/player/lewid001>lewid001</a>,Darren Lewis,San Francisco Giants,GIANTS,3,5,8,13,1995,1998,3,No,0,9.99,0.74,-9.25,311,256,-55,447,555,108,1958.0,96.0,-1862.0,5827778.0,0.0,-5827778.0
<a href=/player/lewid001>lewid001</a>,Darren Lewis,Chicago White Sox,WSOX,1,1,1,2,1997,1997,0,No,0,0.61,-0.06,-0.67,26,9,-17,85,11,-74,0.0,0.0,0.0,1325000.0,0.0,-1325000.0
<a href=/player/lewid001>lewid001</a>,Darren Lewis,Chicago Cubs,CUBS,2,3,3,6,2002,2004,2,No,0,-0.13,1.72,1.85,32,351,319,68,1223,1155,0.0,0.0,0.0,7000000.0,0.0,-7000000.0
<a href=/player/lewid101>lewid101</a>,Duffy Lewis,Boston Red Sox,RSOX,4,11,11,22,1918,1925,7,No,0,12.28,-1.18,-13.46,1743,839,-904,6150,3067,-3083,700.0,265.0,-435.0,3300.0,0.0,-3300.0
<a href=/player/lewid101>lewid101</a>,Duffy Lewis,New York Yankees,YANKS,1,2,1,3,1920,1920,0,No,0,16.01,0.0,-16.01,317,0,-317,510,0,-510,3052.0,0.0,-3052.0,11500.0,0.0,-11500.0
<a href=/player/lewij001>lewij001</a>,Jim Lewis,Seattle Mariners,MARNRS,6,10,11,21,1979,1995,16,No,1,7.87,12.43,4.56,602,1155,553,1044,2694,1650,1952.0,3686.0,1734.0,982500.0,0.0,-982500.0
<a href=/player/lewij002>lewij002</a>,Jim Lewis,San Diego Padres,PADRS,1,2,2,4,1992,1993,1,No,0,0.0,0.0,0.0,0,0,0,0,0,0,0.0,0.0,0.0,0.0,0.0,0.0
<a href=/player/lewij102>lewij102</a>,Johnny Lewis,St. Louis Cardinals,CARDS,1,2,2,4,1964,1964,0,No,0,0.92,0.0,-0.92,326,0,-326,777,0,-777,213.0,0.0,-213.0,0.0,0.0,0.0
<a href=/player/lewim001>lewim001</a>,Mark Lewis,Cleveland Indians,INDINS,1,1,1,2,1994,1994,0,No,0,0.21,0.0,-0.21,180,0,-180,398,0,-398,0.0,0.0,0.0,182500.0,0.0,-182500.0
<a href=/player/lewim001>lewim001</a>,Mark Lewis,Cincinnati Reds,REDS,3,5,4,9,1995,1998,3,No,0,1.13,-0.21,-1.34,524,176,-348,786,483,-303,1638.0,269.0,-1369.0,299000.0,0.0,-299000.0
<a href=/player/lewim001>lewim001</a>,Mark Lewis,Detroit Tigers,TIGRS,1,1,1,2,1996,1996,0,No,0,-0.25,0.0,0.25,118,0,-118,372,0,-372,0.0,0.0,0.0,670000.0,0.0,-670000.0
<a href=/player/lewir001>lewir001</a>,Richie Lewis,Montreal Expos,NATEX,1,1,1,2,1991,1991,0,No,0,-0.69,0.0,0.69,4,0,-4,0,0,0,34.0,0.0,-34.0,0.0,0.0,0.0
<a href=/player/lewir001>lewir001</a>,Richie Lewis,San Diego Padres,PADRS,2,4,4,8,1996,1998,2,No,0,1.67,-1.26,-2.93,549,225,-324,1460,118,-1342,1084.0,637.0,-447.0,0.0,0.0,0.0
<a href=/player/ley-t101>ley-t101</a>,Terry Ley,New York Yankees,YANKS,1,2,1,3,1971,1973,2,No,0,0.0,0.67,0.67,0,101,101,0,310,310,0.0,0.0,0.0,4800.0,0.0,-4800.0
<a href=/player/ley-t101>ley-t101</a>,Terry Ley,Texas Rangers,RNGRS,15,34,23,57,1971,1988,17,No,0,48.57,49.18,0.61,3015,3170,155,9911,9907,-4,4375.0,6620.0,2245.0,528000.0,0.0,-528000.0
<a href=/player/ley-t101>ley-t101</a>,Terry Ley,Cleveland Indians,INDINS,1,2,1,3,1974,1974,0,No,0,1.74,-1.01,-2.75,126,11,-115,121,0,-121,1043.0,131.0,-912.0,0.0,0.0,0.0
<a href=/player/leybd001>leybd001</a>,Domingo Leyba,Detroit Tigers,TIGRS,2,3,3,6,2014,2021,7,Yes,0,9.39,0.09,-9.3,428,326,-102,315,226,-89,2587.0,942.0,-1645.0,4000000.0,0.0,-4000000.0
<a href=/player/leyrj001>leyrj001</a>,Jim Leyritz,New York Yankees,YANKS,1,1,2,3,1996,1996,0,No,0,2.0,0.0,-2.0,84,0,-84,342,0,-342,0.0,0.0,0.0,1470000.0,0.0,-1470000.0
<a href=/player/leyrj001>leyrj001</a>,Jim Leyritz,Anaheim Angels,ANGELS,1,2,1,3,1997,2000,3,No,0,0.66,4.28,3.62,38,78,40,115,11,-104,0.0,1167.0,1167.0,1916972.0,0.0,-1916972.0
<a href=/player/leyrj001>leyrj001</a>,Jim Leyritz,Texas Rangers,RNGRS,2,3,5,8,1997,2007,10,No,2,2.88,7.0,4.12,229,110,-119,721,120,-601,0.0,1253.0,1253.0,225000.0,0.0,-225000.0
<a href=/player/leyrj001>leyrj001</a>,Jim Leyritz,Boston Red Sox,RSOX,2,3,4,7,1998,1999,1,No,0,0.18,0.39,0.21,112,44,-68,326,16,-310,0.0,139.0,139.0,2000000.0,0.0,-2000000.0
<a href=/player/leyrj001>leyrj001</a>,Jim Leyritz,San Diego Padres,PADRS,3,5,5,10,1999,2002,3,No,0,3.84,0.64,-3.2,428,277,-151,1432,508,-924,0.0,215.0,215.0,3650000.0,0.0,-3650000.0
<a href=/player/leyrj001>leyrj001</a>,Jim Leyritz,New York Yankees,YANKS,1,1,2,3,2000,2000,0,No,0,-0.61,0.24,0.85,41,73,32,68,191,123,0.0,0.0,0.0,1000000.0,0.0,-1000000.0
<a href=/player/lezcs001>lezcs001</a>,Sixto Lezcano,Milwaukee Brewers,BREWRS,3,6,7,13,1980,1986,6,No,1,6.59,20.26,13.67,970,997,27,2159,3010,851,2112.0,2376.0,264.0,0.0,0.0,0.0
<a href=/player/lezcs001>lezcs001</a>,Sixto Lezcano,St. Louis Cardinals,CARDS,1,3,3,6,1981,1992,11,No,0,19.37,59.81,40.44,1893,1695,-198,5833,6828,995,883.0,553.0,-330.0,793333.0,0.0,-793333.0
<a href=/player/lezcs001>lezcs001</a>,Sixto Lezcano,San Diego Padres,PADRS,5,8,9,17,1983,1992,9,No,1,0.01,11.95,11.94,244,925,681,351,1136,785,610.0,1770.0,1160.0,375000.0,0.0,-375000.0
<a href=/player/libea001>libea001</a>,Adam Liberatore,Tampa Bay Devil Rays,RAYS,1,2,2,4,2014,2015,1,Yes,0,0.98,0.23,-0.75,298,5,-293,4,0,-4,353.0,17.0,-336.0,3000000.0,0.0,-3000000.0
<a href=/player/librf101>librf101</a>,Frankie Libran,Chicago Cubs,CUBS,3,6,4,10,1969,1974,5,No,0,4.19,2.65,-1.54,1200,512,-688,1393,950,-443,2550.0,898.0,-1652.0,19000.0,0.0,-19000.0
<a href=/player/liddd001>liddd001</a>,Dave Liddell,Chicago Cubs,CUBS,1,2,1,3,1986,1987,1,No,0,0.08,1.13,1.05,1,162,161,1,51,50,0.0,630.0,630.0,0.0,0.0,0.0
<a href=/player/liddd101>liddd101</a>,Don Liddle,Milwaukee Braves,BRAVES,2,8,3,11,1954,1960,6,No,0,39.41,8.38,-31.03,1145,621,-524,1887,2335,448,6059.0,0.0,-6059.0,0.0,0.0,0.0
<a href=/player/liddd101>liddd101</a>,Don Liddle,New York Giants,GIANTS,11,22,22,44,1956,1968,12,No,0,37.88,26.25,-11.63,3162,2563,-599,10326,4535,-5791,1384.0,7539.0,6155.0,95000.0,0.0,-95000.0
<a href=/player/lidgb001>lidgb001</a>,Brad Lidge,Houston Astros,ASTROS,5,17,11,28,2007,2020,13,No,0,26.64,22.25,-4.39,2124,1522,-602,3444,4092,648,4062.0,2080.0,-1982.0,15247800.0,0.0,-15247800.0
<a href=/player/lidlc001>lidlc001</a>,Cory Lidle,Milwaukee Brewers,BREWRS,1,1,1,2,1996,1997,1,No,0,0.35,-0.45,-0.8,105,44,-61,6,68,62,245.0,0.0,-245.0,0.0,0.0,0.0
<a href=/player/lidlc001>lidlc001</a>,Cory Lidle,Tampa Bay Devil Rays,RAYS,1,2,1,3,2001,2003,2,No,0,6.9,3.18,-3.72,63,345,282,4,1405,1401,1140.0,0.0,-1140.0,0.0,0.0,0.0
<a href=/player/lidlc001>lidlc001</a>,Cory Lidle,Oakland Athletics,ATLTCS,1,1,2,3,2002,2006,4,No,0,0.58,0.04,-0.54,33,8,-25,6,26,20,578.0,0.0,-578.0,2550000.0,0.0,-2550000.0
<a href=/player/lidlc001>lidlc001</a>,Cory Lidle,Cincinnati Reds,REDS,3,4,6,10,2004,2007,3,No,0,1.18,-0.86,-2.04,141,141,0,181,284,103,1117.0,428.0,-689.0,4750000.0,0.0,-4750000.0
<a href=/player/lidlc001>lidlc001</a>,Cory Lidle,Philadelphia Phillies,PHILS,1,2,4,6,2006,2009,3,No,0,7.5,0.06,-7.44,382,46,-336,1631,0,-1631,136.0,38.0,-98.0,16900000.0,0.0,-16900000.0
<a href=/player/liebg101>liebg101</a>,Glenn Liebhardt,Cleveland Indians,INDINS,1,1,2,3,1909,1910,1,No,0,0.0,0.53,0.53,0,106,106,0,302,302,0.0,383.0,383.0,0.0,0.0,0.0
<a href=/player/liebj001>liebj001</a>,Jon Lieber,Kansas City Royals,ROYALS,1,2,1,3,1993,1994,1,No,0,4.73,-0.04,-4.77,577,61,-516,244,0,-244,2577.0,229.0,-2348.0,0.0,0.0,0.0
<a href=/player/liebj001>liebj001</a>,Jon Lieber,Pittsburgh Pirates,PIRATS,2,2,2,4,1998,2000,2,No,0,12.51,-1.66,-14.17,328,202,-126,382,524,142,2623.0,0.0,-2623.0,1740000.0,0.0,-1740000.0
<a href=/player/liefj001>liefj001</a>,Jeff Liefer,Chicago White Sox,WSOX,3,7,5,12,2003,2010,7,No,2,-4.18,5.27,9.45,270,142,-128,107,7,-100,449.0,996.0,547.0,0.0,0.0,0.0
<a href=/player/liesf101>liesf101</a>,Fred Liese,Chicago Cubs,CUBS,1,1,1,2,1909,1909,0,No,0,0.0,-0.27,-0.27,0,13,13,0,28,28,0.0,0.0,0.0,0.0,0.0,0.0
<a href=/player/liesf101>liesf101</a>,Fred Liese,Chicago Cubs,CUBS,1,2,1,3,1910,1910,0,No,0,0.0,0.76,0.76,5,76,71,4,210,206,0.0,0.0,0.0,0.0,0.0,0.0
<a href=/player/lighp001>lighp001</a>,Pat Light,Boston Red Sox,RSOX,1,1,1,2,2016,2017,1,No,0,-0.48,0.22,0.7,16,72,56,0,0,0,42.0,169.0,127.0,0.0,0.0,0.0
<a href=/player/lighp001>lighp001</a>,Pat Light,Minnesota Twins,TWINS,1,1,1,2,2017,2017,0,No,0,0.0,0.0,0.0,0,0,0,0,0,0,0.0,0.0,0.0,0.0,0.0,0.0
<a href=/player/lillb001>lillb001</a>,Brent Lillibridge,Pittsburgh Pirates,PIRATS,2,3,4,7,2007,2013,6,No,0,1.29,2.54,1.25,298,397,99,105,1590,1485,375.0,0.0,-375.0,7050000.0,0.0,-7050000.0
<a href=/player/lillb001>lillb001</a>,Brent Lillibridge,Atlanta Braves,BRAVES,5,12,14,26,2008,2014,6,No,0,17.06,9.0,-8.06,2364,1258,-1106,2896,3420,524,3035.0,1593.0,-1442.0,26080000.0,0.0,-26080000.0
<a href=/player/lillb001>lillb001</a>,Brent Lillibridge,Chicago White Sox,WSOX,1,2,2,4,2012,2012,0,No,0,-0.96,1.4,2.36,12,80,68,16,344,328,17.0,0.0,-17.0,0.0,0.0,0.0
<a href=/player/lillb001>lillb001</a>,Brent Lillibridge,Boston Red Sox,RSOX,1,1,1,2,2012,2013,1,No,0,-0.07,-0.13,-0.06,43,7,-36,123,0,-123,0.0,34.0,34.0,500000.0,0.0,-500000.0
<a href=/player/lillb101>lillb101</a>,Bob Lillis,Los Angeles Dodgers,DOGRS,1,2,1,3,1961,1963,2,No,0,-1.3,1.55,2.85,292,144,-148,701,421,-280,0.0,0.0,0.0,0.0,0.0,0.0
<a href=/player/lilld001>lilld001</a>,Derek Lilliquist,Atlanta Braves,BRAVES,1,1,1,2,1990,1991,1,No,0,-0.08,0.02,0.1,44,66,22,25,6,-19,224.0,157.0,-67.0,135000.0,0.0,-135000.0
<a href=/player/lillg101>lillg101</a>,Gene Lillard,Chicago Cubs,CUBS,2,7,2,9,1936,1947,11,No,0,6.07,33.87,27.8,546,772,226,1567,1415,-152,1708.0,5741.0,4033.0,9500.0,0.0,-9500.0
<a href=/player/lillg101>lillg101</a>,Gene Lillard,Chicago Cubs,CUBS,2,4,3,7,1939,1947,8,No,0,5.18,0.94,-4.24,213,106,-107,268,37,-231,1599.0,395.0,-1204.0,7800.0,0.0,-7800.0
<a href=/player/lillt001>lillt001</a>,Ted Lilly,Los Angeles Dodgers,DOGRS,4,8,8,16,1998,2006,8,No,0,3.75,12.46,8.71,1576,982,-594,3524,3610,86,1585.0,233.0,-1352.0,12365000.0,0.0,-12365000.0
<a href=/player/lillt001>lillt001</a>,Ted Lilly,Montreal Expos,NATEX,1,3,1,4,2000,2001,1,No,0,1.49,-0.32,-1.81,57,27,-30,6,21,15,645.0,214.0,-431.0,0.0,0.0,0.0
<a href=/player/lillt001>lillt001</a>,Ted Lilly,New York Yankees,YANKS,2,7,2,9,2002,2005,3,No,0,6.71,3.6,-3.11,546,85,-461,184,2,-182,2652.0,1328.0,-1324.0,4387150.0,0.0,-4387150.0
<a href=/player/lillt001>lillt001</a>,Ted Lilly,Oakland Athletics,ATLTCS,1,1,1,2,2003,2007,4,No,0,5.93,2.48,-3.45,96,293,197,10,1048,1038,1516.0,0.0,-1516.0,335000.0,0.0,-335000.0
<a href=/player/lillt001>lillt001</a>,Ted Lilly,Chicago Cubs,CUBS,1,3,3,6,2010,2012,2,No,0,3.28,-0.26,-3.54,168,192,24,342,477,135,1023.0,0.0,-1023.0,15600000.0,0.0,-15600000.0
<a href=/player/limaj001>limaj001</a>,Jose Lima,Detroit Tigers,TIGRS,6,13,15,28,1996,2010,14,No,1,13.89,24.32,10.43,4127,1434,-2693,10052,2196,-7856,4562.0,6757.0,2195.0,11529000.0,0.0,-11529000.0
<a href=/player/limaj001>limaj001</a>,Jose Lima,Houston Astros,ASTROS,1,1,1,2,2001,2001,0,No,0,-0.43,0.16,0.59,39,36,-3,1,30,29,543.0,260.0,-283.0,6250000.0,0.0,-6250000.0
<a href=/player/lincb001>lincb001</a>,Brad Lincoln,Pittsburgh Pirates,PIRATS,4,5,6,11,2012,2018,6,Yes,0,2.63,4.38,1.75,186,458,272,242,958,716,843.0,1241.0,398.0,9167000.0,0.0,-9167000.0
<a href=/player/lincb001>lincb001</a>,Brad Lincoln,Toronto Blue Jays,BJAYS,3,6,4,10,2013,2015,2,No,0,-1.33,0.83,2.16,51,179,128,36,422,386,108.0,94.0,-14.0,510200.0,0.0,-510200.0
<a href=/player/linda001>linda001</a>,Adam Lind,Toronto Blue Jays,BJAYS,1,1,1,2,2014,2018,4,No,0,3.6,10.06,6.46,149,131,-18,572,16,-556,0.0,2060.0,2060.0,7000000.0,0.0,-7000000.0
<a href=/player/linda001>linda001</a>,Adam Lind,Milwaukee Brewers,BREWRS,1,1,3,4,2015,2015,0,Yes,0,-0.26,0.0,0.26,126,0,-126,430,0,-430,0.0,0.0,0.0,7500000.0,0.0,-7500000.0
<a href=/player/lindb001>lindb001</a>,Bill Lindsey,New York Yankees,YANKS,2,5,4,9,1986,1992,6,No,0,1.11,3.87,2.76,606,1169,563,1878,3720,1842,0.0,0.0,0.0,400873.0,0.0,-400873.0
<a href=/player/lindc103>lindc103</a>,Carl Lindquist,Boston Braves,BRAVES,2,4,3,7,1944,1948,4,No,0,-0.05,3.65,3.7,48,381,333,105,1465,1360,0.0,0.0,0.0,0.0,0.0,0.0
<a href=/player/lindd001>lindd001</a>,Doug Lindsey,Philadelphia Phillies,PHILS,1,1,1,2,1993,1993,0,No,0,-0.03,0.28,0.31,2,16,14,1,0,-1,0.0,53.0,53.0,0.0,0.0,0.0
<a href=/player/lindf001>lindf001</a>,Francisco Lindor,Cleveland Indians,INDINS,1,2,4,6,2021,2021,0,Yes,0,2.19,2.78,0.59,149,209,60,543,798,255,161.0,0.0,-161.0,0.0,0.0,0.0
<a href=/player/lindf101>lindf101</a>,Freddie Lindstrom,New York Giants,GIANTS,6,16,9,25,1932,1949,17,No,0,14.14,67.57,53.43,1519,2679,1160,5550,10428,4878,296.0,142.0,-154.0,0.0,0.0,0.0
<a href=/player/lindf101>lindf101</a>,Freddie Lindstrom,Pittsburgh Pirates,PIRATS,1,2,3,5,1934,1938,4,No,0,22.26,3.72,-18.54,634,346,-288,941,358,-583,4458.0,2252.0,-2206.0,0.0,0.0,0.0
<a href=/player/lindj001>lindj001</a>,Jim Lindeman,St. Louis Cardinals,CARDS,1,2,3,5,1989,1989,0,No,0,-0.12,0.0,0.12,13,0,-13,34,0,-34,5.0,0.0,-5.0,0.0,0.0,0.0
<a href=/player/lindj002>lindj002</a>,Jose Lind,Pittsburgh Pirates,PIRATS,1,1,2,3,1992,1994,2,No,0,-1.65,-0.61,1.04,250,94,-156,880,7,-873,0.0,219.0,219.0,2000000.0,0.0,-2000000.0
<a href=/player/lindj004>lindj004</a>,Josh Lindblom,Los Angeles Dodgers,DOGRS,1,3,1,4,2012,2012,0,No,0,-1.0,1.11,2.11,86,53,-33,10,235,225,202.0,0.0,-202.0,483000.0,0.0,-483000.0
<a href=/player/lindj004>lindj004</a>,Josh Lindblom,Philadelphia Phillies,PHILS,3,6,4,10,2012,2014,2,No,0,0.71,-1.18,-1.89,80,130,50,137,512,375,193.0,7.0,-186.0,496000.0,0.0,-496000.0
<a href=/player/lindj004>lindj004</a>,Josh Lindblom,Texas Rangers,RNGRS,2,4,3,7,2013,2015,2,No,0,1.42,-3.21,-4.63,125,105,-20,314,281,-33,19.0,129.0,110.0,1001100.0,0.0,-1001100.0
<a href=/player/lindj101>lindj101</a>,Johnny Lindell,St. Louis Cardinals,CARDS,1,1,1,2,1950,1950,0,No,0,0.0,0.0,0.0,0,0,0,0,0,0,0.0,0.0,0.0,0.0,0.0,0.0
<a href=/player/lindj102>lindj102</a>,Jim Lindsey,Cincinnati Reds,REDS,1,3,1,4,1934,1936,2,No,0,0.0,1.84,1.84,0,131,131,0,110,110,0.0,910.0,910.0,3000.0,0.0,-3000.0
<a href=/player/lindj102>lindj102</a>,Jim Lindsey,Cleveland Indians,INDINS,1,5,1,6,1922,1935,13,No,0,0.0,5.93,5.93,0,850,850,0,2604,2604,0.0,0.0,0.0,0.0,0.0,0.0
<a href=/player/lindm001>lindm001</a>,Matt Lindstrom,New York Mets,METS,2,9,5,14,2006,2010,4,No,0,11.2,-1.8,-13.0,974,362,-612,1347,182,-1165,2746.0,356.0,-2390.0,3398000.0,0.0,-3398000.0
<a href=/player/lindm001>lindm001</a>,Matt Lindstrom,Florida Marlins,MARLNS,1,1,3,4,2009,2009,0,No,0,0.25,0.0,-0.25,114,0,-114,0,0,0,160.0,0.0,-160.0,410000.0,0.0,-410000.0
<a href=/player/lindm001>lindm001</a>,Matt Lindstrom,Houston Astros,ASTROS,1,1,2,3,2010,2010,0,No,0,1.04,0.0,-1.04,124,0,-124,0,0,0,162.0,0.0,-162.0,1625000.0,0.0,-1625000.0
<a href=/player/lindm001>lindm001</a>,Matt Lindstrom,Colorado Rockies,ROCKS,2,3,2,5,2012,2012,0,No,0,6.7,-1.0,-7.7,199,47,-152,28,33,5,2842.0,306.0,-2536.0,8200000.0,0.0,-8200000.0
<a href=/player/lindm001>lindm001</a>,Matt Lindstrom,Baltimore Orioles,ORLS,1,2,2,4,2012,2012,0,No,0,0.25,0.76,0.51,24,7,-17,0,0,0,32.0,134.0,102.0,3600000.0,0.0,-3600000.0
<a href=/player/lindp101>lindp101</a>,Paul Lindblad,Oakland Athletics,ATLTCS,5,12,6,18,1971,1976,5,No,0,13.14,12.72,-0.42,2868,1140,-1728,6939,2992,-3947,2263.0,1076.0,-1187.0,223600.0,0.0,-223600.0
<a href=/player/lindp101>lindp101</a>,Paul Lindblad,Texas Rangers,RNGRS,2,2,3,5,1972,1973,1,No,0,3.91,1.38,-2.53,223,82,-141,1,263,262,1247.0,0.0,-1247.0,31000.0,0.0,-31000.0
<a href=/player/lindr001>lindr001</a>,Rod Lindsey,San Diego Padres,PADRS,1,1,1,2,1998,1998,0,No,0,0.12,-0.22,-0.34,11,46,35,5,1,-4,0.0,92.0,92.0,0.0,0.0,0.0
<a href=/player/lindv101>lindv101</a>,Vive Lindaman,Pittsburgh Pirates,PIRATS,1,3,1,4,1905,1910,5,No,0,9.35,21.13,11.78,731,320,-411,2264,464,-1800,2702.0,3628.0,926.0,0.0,0.0,0.0
<a href=/player/lines001>lines001</a>,Scott Linebrink,San Francisco Giants,GIANTS,1,1,1,2,2000,2000,0,No,0,0.17,0.32,0.15,96,54,-42,10,0,-10,228.0,76.0,-152.0,0.0,0.0,0.0
<a href=/player/lines001>lines001</a>,Scott Linebrink,San Diego Padres,PADRS,2,3,4,7,2007,2015,8,No,0,-1.28,4.08,5.36,259,701,442,1,132,131,301.0,1875.0,1574.0,2150000.0,0.0,-2150000.0
<a href=/player/lines001>lines001</a>,Scott Linebrink,Chicago White Sox,WSOX,1,2,1,3,2010,2010,0,No,0,0.42,0.0,-0.42,126,0,-126,0,0,0,163.0,0.0,-163.0,5000000.0,0.0,-5000000.0
<a href=/player/linic001>linic001</a>,Cole Liniak,Boston Red Sox,RSOX,1,2,1,3,1999,2001,2,No,0,0.54,2.66,2.12,201,119,-82,36,1,-35,221.0,406.0,185.0,1600000.0,0.0,-1600000.0
<a href=/player/linke101>linke101</a>,Ed Linke,Washington Senators,TWINS,1,1,1,2,1937,1938,1,No,0,-0.56,-0.62,-0.06,42,63,21,12,25,13,119.0,273.0,154.0,4500.0,0.0,-4500.0
<a href=/player/linkf101>linkf101</a>,Fred Link,Columbus,Columbus,1,2,1,3,1909,1909,0,No,0,0.53,0.0,-0.53,106,0,-106,302,0,-302,383.0,0.0,-383.0,0.0,0.0,0.0
<a href=/player/linkj001>linkj001</a>,Jon Link,San Diego Padres,PADRS,1,1,1,2,2007,2007,0,No,0,0.0,0.03,0.03,0,28,28,0,61,61,0.0,0.0,0.0,0.0,0.0,0.0
<a href=/player/linkj001>linkj001</a>,Jon Link,Chicago White Sox,WSOX,1,2,1,3,2009,2011,2,No,0,-1.22,-0.64,0.58,67,318,251,36,1445,1409,372.0,0.0,-372.0,0.0,0.0,0.0
<a href=/player/lintl101>lintl101</a>,Larry Lintz,Montreal Expos,NATEX,2,3,3,6,1975,1978,3,No,0,0.07,2.86,2.79,87,598,511,159,1574,1415,0.0,0.0,0.0,0.0,0.0,0.0
<a href=/player/lintl101>lintl101</a>,Larry Lintz,St. Louis Cardinals,CARDS,1,1,1,2,1975,1975,0,No,0,0.35,0.0,-0.35,109,0,-109,44,0,-44,0.0,0.0,0.0,0.0,0.0,0.0
<a href=/player/linzf101>linzf101</a>,Frank Linzy,San Francisco Giants,GIANTS,1,1,1,2,1970,1973,3,No,0,3.11,-0.5,-3.61,194,296,102,11,40,29,362.0,743.0,381.0,0.0,0.0,0.0
<a href=/player/linzf101>linzf101</a>,Frank Linzy,St. Louis Cardinals,CARDS,1,1,1,2,1972,1972,0,No,0,-0.57,0.0,0.57,137,0,-137,10,0,-10,421.0,0.0,-421.0,0.0,0.0,0.0
<a href=/player/linzf101>linzf101</a>,Frank Linzy,Milwaukee Brewers,BREWRS,1,1,1,2,1973,1974,1,No,0,0.14,0.0,-0.14,44,0,-44,0,0,0,74.0,0.0,-74.0,0.0,0.0,0.0
<a href=/player/linzp101>linzp101</a>,Phil Linz,New York Yankees,YANKS,1,1,1,2,1965,1968,3,No,0,-0.68,-0.7,-0.02,63,191,128,92,543,451,0.0,0.0,0.0,20200.0,0.0,-20200.0
<a href=/player/linzp101>linzp101</a>,Phil Linz,Philadelphia Phillies,PHILS,1,1,1,2,1967,1967,0,No,0,-1.41,0.01,1.42,102,31,-71,340,45,-295,0.0,0.0,0.0,0.0,0.0,0.0
<a href=/player/lipoj101>lipoj101</a>,Johnny Lipon,Detroit Tigers,TIGRS,18,41,43,84,1952,1964,12,No,0,49.33,53.4,4.07,4601,4657,56,11266,12496,1230,8483.0,9258.0,775.0,157700.0,0.0,-157700.0
<a href=/player/lipoj101>lipoj101</a>,Johnny Lipon,Baltimore Orioles,ORLS,6,12,12,24,1954,1960,6,No,0,16.12,9.55,-6.57,902,1031,129,2238,2995,757,2291.0,1208.0,-1083.0,10000.0,0.0,-10000.0
<a href=/player/lipoj101>lipoj101</a>,Johnny Lipon,Chicago White Sox,WSOX,4,8,5,13,1954,1961,7,No,0,23.88,9.53,-14.35,1231,794,-437,3827,2335,-1492,2136.0,479.0,-1657.0,62000.0,0.0,-62000.0
<a href=/player/lipsb101>lipsb101</a>,Bob Lipski,St. Louis Cardinals,CARDS,1,2,1,3,1965,1965,0,No,0,0.0,0.0,0.0,0,0,0,0,0,0,0.0,0.0,0.0,0.0,0.0,0.0
<a href=/player/liraf001>liraf001</a>,Felipe Lira,Detroit Tigers,TIGRS,7,19,13,32,1997,2002,5,No,1,3.14,14.72,11.58,1662,1186,-476,4060,2874,-1186,1346.0,2263.0,917.0,9860000.0,0.0,-9860000.0
<a href=/player/lirif001>lirif001</a>,Francisco Liriano,San Francisco Giants,GIANTS,1,3,2,5,2003,2004,1,No,0,27.51,0.25,-27.26,760,131,-629,32,510,478,4915.0,0.0,-4915.0,300000.0,0.0,-300000.0
<a href=/player/lirif001>lirif001</a>,Francisco Liriano,Minnesota Twins,TWINS,2,2,5,7,2012,2018,6,Yes,0,5.77,5.04,-0.73,376,686,310,1544,2423,879,170.0,173.0,3.0,10350000.0,0.0,-10350000.0
<a href=/player/lirif001>lirif001</a>,Francisco Liriano,Pittsburgh Pirates,PIRATS,1,3,1,4,2016,2017,1,No,0,1.56,-0.04,-1.6,169,12,-157,400,1,-399,396.0,34.0,-362.0,0.0,0.0,0.0
<a href=/player/lirif001>lirif001</a>,Francisco Liriano,Toronto Blue Jays,BJAYS,1,1,2,3,2017,2017,0,Yes,0,-0.16,0.88,1.04,21,38,17,0,129,129,43.0,0.0,-43.0,13666667.0,0.0,-13666667.0
<a href=/player/lirin001>lirin001</a>,Nelson Liriano,Toronto Blue Jays,BJAYS,1,2,1,3,1990,1990,0,No,0,0.48,-0.21,-0.69,536,13,-523,1913,0,-1913,0.0,64.0,64.0,255000.0,0.0,-255000.0
<a href=/player/lirip001>lirip001</a>,Pedro Liriano,Anaheim Angels,ANGELS,1,3,2,5,2002,2002,0,No,0,-0.5,0.27,0.77,52,39,-13,74,76,2,47.0,0.0,-47.0,500000.0,0.0,-500000.0
<a href=/player/lirir001>lirir001</a>,Rymer Liriano,San Diego Padres,PADRS,1,1,1,2,2016,2016,0,Yes,0,0.0,0.0,0.0,0,0,0,0,0,0,0.0,0.0,0.0,0.0,0.0,0.0
<a href=/player/lis-j101>lis-j101</a>,Joe Lis,Philadelphia Phillies,PHILS,1,3,1,4,1972,1973,1,No,0,-1.38,0.91,2.29,154,97,-57,334,364,30,133.0,0.0,-133.0,14500.0,0.0,-14500.0
<a href=/player/liseh101>liseh101</a>,Hod Lisenbee,Washington Senators,TWINS,1,5,1,6,1928,1941,13,No,0,14.54,41.49,26.95,801,1492,691,1696,6460,4764,3390.0,0.0,-3390.0,20500.0,0.0,-20500.0
<a href=/player/liseh101>liseh101</a>,Hod Lisenbee,Memphis,Memphis,2,2,5,7,1926,1940,14,No,0,4.5,0.0,-4.5,280,0,-280,708,0,-708,957.0,0.0,-957.0,0.0,0.0,0.0
<a href=/player/lisir101>lisir101</a>,Rick Lisi,Texas Rangers,RNGRS,1,1,1,2,1982,1982,0,No,0,0.0,0.0,0.0,0,0,0,0,0,0,0.0,0.0,0.0,0.0,0.0,0.0
<a href=/player/listp001>listp001</a>,Pat Listach,Milwaukee Brewers,BREWRS,12,24,27,51,1996,2012,16,No,2,48.89,48.53,-0.36,3405,3905,500,10041,7823,-2218,2917.0,8947.0,6030.0,18537000.0,0.0,-18537000.0
<a href=/player/littb001>littb001</a>,Bryan Little,Montreal Expos,NATEX,1,1,1,2,1984,1985,1,No,0,1.15,0.34,-0.81,93,84,-9,262,1,-261,0.0,204.0,204.0,0.0,0.0,0.0
<a href=/player/littd101>littd101</a>,Dennis Littlejohn,San Francisco Giants,GIANTS,1,1,1,2,1982,1985,3,No,0,0.0,-0.98,-0.98,0,46,46,0,4,4,0.0,115.0,115.0,0.0,0.0,0.0
<a href=/player/littd102>littd102</a>,Dick Littlefield,Boston Red Sox,RSOX,3,9,8,17,1950,1956,6,No,0,14.02,9.79,-4.23,1662,1085,-577,5506,3192,-2314,1880.0,1611.0,-269.0,111000.0,0.0,-111000.0
<a href=/player/littd102>littd102</a>,Dick Littlefield,Chicago White Sox,WSOX,2,6,4,10,1951,1963,12,No,0,1.43,25.02,23.59,363,1422,1059,910,5079,4169,614.0,0.0,-614.0,0.0,0.0,0.0
<a href=/player/littd102>littd102</a>,Dick Littlefield,St.Louis Browns,ORLS,23,51,48,99,1952,1994,42,No,3,84.08,155.33,71.25,5312,9112,3800,11244,26050,14806,18662.0,17928.0,-734.0,984333.0,0.0,-984333.0
<a href=/player/littd102>littd102</a>,Dick Littlefield,Detroit Tigers,TIGRS,6,16,16,32,1952,1961,9,No,0,19.6,10.08,-9.52,1436,1371,-65,2274,3811,1537,4378.0,2214.0,-2164.0,23200.0,0.0,-23200.0
<a href=/player/littd102>littd102</a>,Dick Littlefield,Baltimore Orioles,ORLS,2,2,2,4,1954,1956,2,No,0,1.94,5.99,4.05,132,274,142,101,1056,955,893.0,0.0,-893.0,16000.0,0.0,-16000.0
<a href=/player/littd102>littd102</a>,Dick Littlefield,Pittsburgh Pirates,PIRATS,1,2,1,3,1956,1965,9,No,0,0.09,18.14,18.05,108,1409,1301,317,5853,5536,29.0,0.0,-29.0,0.0,0.0,0.0
<a href=/player/littd102>littd102</a>,Dick Littlefield,New York Giants,GIANTS,1,2,1,3,1956,1956,0,No,0,0.0,0.0,0.0,0,0,0,0,0,0,0.0,0.0,0.0,0.0,0.0,0.0
<a href=/player/littd102>littd102</a>,Dick Littlefield,New York Giants,GIANTS,3,5,5,10,1957,1961,4,No,0,26.85,7.67,-19.18,1312,551,-761,4817,1078,-3739,197.0,1899.0,1702.0,0.0,0.0,0.0
<a href=/player/littd102>littd102</a>,Dick Littlefield,St. Louis Cardinals,CARDS,19,44,38,82,1956,1972,16,No,0,56.42,67.4,10.98,5645,3260,-2385,13530,9157,-4373,6309.0,6165.0,-144.0,120500.0,0.0,-120500.0
<a href=/player/littj101>littj101</a>,Jeff Little,St. Louis Cardinals,CARDS,1,1,1,2,1981,1983,2,No,0,0.03,0.0,-0.03,33,0,-33,0,0,0,109.0,0.0,-109.0,0.0,0.0,0.0
<a href=/player/littj102>littj102</a>,John Littlefield,St. Louis Cardinals,CARDS,12,29,23,52,1980,1998,18,No,5,83.63,121.95,38.32,6733,4994,-1739,20851,17148,-3703,6532.0,3025.0,-3507.0,1533333.0,0.0,-1533333.0
<a href=/player/littl101>littl101</a>,Larry Littleton,Pittsburgh Pirates,PIRATS,2,4,2,6,1979,1982,3,No,0,-0.15,0.88,1.03,107,26,-81,27,13,-14,442.0,163.0,-279.0,0.0,0.0,0.0
<a href=/player/littl101>littl101</a>,Larry Littleton,Cleveland Indians,INDINS,1,1,1,2,1982,1982,0,No,0,0.0,-0.36,-0.36,0,82,82,0,319,319,0.0,0.0,0.0,0.0,0.0,0.0
<a href=/player/littm001>littm001</a>,Mark Little,Texas Rangers,RNGRS,10,22,21,43,1998,2013,15,No,6,69.97,35.86,-34.11,3830,2430,-1400,13190,7848,-5342,3667.0,3730.0,63.0,14990260.0,0.0,-14990260.0
<a href=/player/littm001>littm001</a>,Mark Little,Colorado Rockies,ROCKS,1,2,3,5,2002,2003,1,No,0,-0.58,3.78,4.36,21,232,211,25,840,815,163.0,36.0,-127.0,1350000.0,0.0,-1350000.0
<a href=/player/littm001>littm001</a>,Mark Little,New York Mets,METS,1,1,1,2,2002,2002,0,No,0,0.02,0.0,-0.02,15,0,-15,28,0,-28,0.0,0.0,0.0,0.0,0.0,0.0
<a href=/player/littm101>littm101</a>,Mark Littell,Kansas City Royals,ROYALS,1,2,1,3,1977,1979,2,No,0,2.3,2.25,-0.05,386,116,-270,35,0,-35,783.0,420.0,-363.0,50000.0,0.0,-50000.0
<a href=/player/litts001>litts001</a>,Scott Little,New York Mets,METS,2,3,3,6,1987,1990,3,No,0,0.91,0.12,-0.79,161,49,-112,446,62,-384,0.0,0.0,0.0,0.0,0.0,0.0
<a href=/player/littw001>littw001</a>,Wes Littleton,Texas Rangers,RNGRS,1,1,2,3,2008,2008,0,No,0,0.0,0.0,0.0,0,0,0,0,0,0,0.0,0.0,0.0,0.0,0.0,0.0
<a href=/player/littz001>littz001</a>,Zack Littell,Seattle Mariners,MARNRS,4,8,6,14,2016,2019,3,Yes,0,12.9,2.82,-10.08,683,190,-493,2542,289,-2253,142.0,311.0,169.0,17350000.0,0.0,-17350000.0
<a href=/player/littz001>littz001</a>,Zack Littell,New York Yankees,YANKS,1,2,1,3,2017,2017,0,No,0,0.02,-0.11,-0.13,48,9,-39,2,2,0,203.0,112.0,-91.0,0.0,0.0,0.0
<a href=/player/litwd101>litwd101</a>,Danny Litwhiler,Philadelphia Phillies,PHILS,3,4,6,10,1943,1946,3,No,0,9.8,8.3,-1.5,880,637,-243,3396,2656,-740,0.0,0.0,0.0,0.0,0.0,0.0
<a href=/player/litwd101>litwd101</a>,Danny Litwhiler,Boston Braves,BRAVES,1,1,1,2,1948,1949,1,No,0,4.68,1.4,-3.28,274,103,-171,891,314,-577,0.0,0.0,0.0,0.0,0.0,0.0
<a href=/player/liveb001>liveb001</a>,Ben Lively,Cincinnati Reds,REDS,2,3,3,6,2014,2015,1,Yes,0,1.93,0.81,-1.12,78,96,18,189,388,199,337.0,0.0,-337.0,0.0,0.0,0.0
<a href=/player/livim101>livim101</a>,Mickey Livingston,Brooklyn Dodgers,DOGRS,2,9,3,12,1940,1947,7,No,0,2.8,7.69,4.89,657,371,-286,1221,447,-774,1499.0,2793.0,1294.0,17500.0,0.0,-17500.0
<a href=/player/livim101>livim101</a>,Mickey Livingston,Philadelphia Phillies,PHILS,1,1,1,2,1943,1945,2,No,0,1.72,2.12,0.4,192,114,-78,613,123,-490,0.0,1037.0,1037.0,0.0,0.0,0.0
<a href=/player/livip101>livip101</a>,Paddy Livingston,St. Louis Cardinals,CARDS,1,5,1,6,1917,1917,0,No,0,0.0,0.36,0.36,0,28,28,0,29,29,0.0,256.0,256.0,9800.0,0.0,-9800.0
<a href=/player/livis001>livis001</a>,Scott Livingstone,Detroit Tigers,TIGRS,1,2,1,3,1994,1994,0,No,0,0.37,-0.32,-0.69,295,11,-284,639,0,-639,0.0,34.0,34.0,365000.0,0.0,-365000.0
<a href=/player/livis001>livis001</a>,Scott Livingstone,San Diego Padres,PADRS,5,11,12,23,1997,2006,9,No,1,5.86,22.51,16.65,827,1744,917,2661,6285,3624,68.0,189.0,121.0,10901680.0,0.0,-10901680.0
<a href=/player/lloyg001>lloyg001</a>,Graeme Lloyd,Philadelphia Phillies,PHILS,1,1,1,2,1992,1992,0,No,0,3.6,0.0,-3.6,184,0,-184,0,0,0,581.0,0.0,-581.0,0.0,0.0,0.0
<a href=/player/lloyg001>lloyg001</a>,Graeme Lloyd,Milwaukee Brewers,BREWRS,12,24,27,51,1996,2012,16,No,2,48.89,48.53,-0.36,3405,3905,500,10041,7823,-2218,2917.0,8947.0,6030.0,18537000.0,0.0,-18537000.0
<a href=/player/lloyg001>lloyg001</a>,Graeme Lloyd,New York Yankees,YANKS,1,3,1,4,1999,2003,4,No,0,11.64,19.58,7.94,456,165,-291,1235,16,-1219,1600.0,3012.0,1412.0,0.0,0.0,0.0
<a href=/player/lloyg001>lloyg001</a>,Graeme Lloyd,Montreal Expos,NATEX,2,6,6,12,2002,2005,3,No,0,7.25,0.27,-6.98,492,319,-173,648,239,-409,1719.0,1333.0,-386.0,4812500.0,0.0,-4812500.0
<a href=/player/lloyg001>lloyg001</a>,Graeme Lloyd,New York Mets,METS,1,1,1,2,2003,2006,3,No,0,-0.68,0.0,0.68,16,0,-16,0,0,0,37.0,0.0,-37.0,650000.0,0.0,-650000.0
<a href=/player/loaie001>loaie001</a>,Esteban Loaiza,Pittsburgh Pirates,PIRATS,1,1,2,3,1998,2002,4,No,0,3.11,1.28,-1.83,67,375,308,3,1310,1307,921.0,141.0,-780.0,450000.0,0.0,-450000.0
<a href=/player/loaie001>loaie001</a>,Esteban Loaiza,Texas Rangers,RNGRS,5,8,8,16,2000,2015,15,No,0,4.23,22.63,18.4,386,1954,1568,834,8328,7494,1398.0,338.0,-1060.0,19651100.0,0.0,-19651100.0
<a href=/player/loaie001>loaie001</a>,Esteban Loaiza,Chicago White Sox,WSOX,2,3,3,6,2004,2009,5,No,0,-0.12,9.88,10.0,24,156,132,4,18,14,178.0,2700.0,2522.0,14000000.0,0.0,-14000000.0
<a href=/player/lobaj001>lobaj001</a>,Jose Lobaton,Tampa Bay Devil Rays,RAYS,3,8,5,13,2014,2018,4,Yes,0,0.49,9.21,8.72,459,720,261,782,2375,1593,577.0,688.0,111.0,508800.0,0.0,-508800.0
<a href=/player/lobeh101>lobeh101</a>,Hans Lobert,Cincinnati Reds,REDS,2,6,5,11,1910,1914,4,No,0,23.79,7.43,-16.36,1495,715,-780,6220,2571,-3649,283.0,231.0,-52.0,0.0,0.0,0.0
<a href=/player/lobeh101>lobeh101</a>,Hans Lobert,Philadelphia Phillies,PHILS,6,11,15,26,1915,1929,14,No,0,30.92,28.6,-2.32,2041,1450,-591,6407,4294,-2113,4874.0,5311.0,437.0,8500.0,0.0,-8500.0
<a href=/player/lobsk001>lobsk001</a>,Kyle Lobstein,Pittsburgh Pirates,PIRATS,1,1,1,2,2016,2016,0,No,0,0.0,0.18,0.18,0,16,16,0,0,0,0.0,20.0,20.0,520000.0,0.0,-520000.0
<a href=/player/locat001>locat001</a>,Tim Locastro,Toronto Blue Jays,BJAYS,1,2,1,3,2015,2015,0,No,0,0.08,0.0,-0.08,21,0,-21,15,0,-15,0.0,0.0,0.0,0.0,0.0,0.0
<a href=/player/locat001>locat001</a>,Tim Locastro,Los Angeles Dodgers,DOGRS,1,1,2,3,2018,2018,0,Yes,0,-0.05,0.0,0.05,9,0,-9,23,0,-23,0.0,0.0,0.0,0.0,0.0,0.0
<a href=/player/locat001>locat001</a>,Tim Locastro,New York Yankees,YANKS,1,1,1,2,2019,2019,0,No,0,0.36,0.0,-0.36,179,0,-179,465,0,-465,0.0,0.0,0.0,0.0,0.0,0.0
<a href=/player/locat001>locat001</a>,Tim Locastro,Arizona Diamondbacks,DBACKS,1,1,1,2,2021,2021,0,Yes,0,-0.05,0.0,0.05,9,0,-9,23,0,-23,0.0,0.0,0.0,0.0,0.0,0.0
<a href=/player/lockb101>lockb101</a>,Bobby Locke,Cleveland Indians,INDINS,2,2,2,4,1961,1964,3,No,0,-1.4,1.15,2.55,187,332,145,534,1054,520,0.0,0.0,0.0,16000.0,0.0,-16000.0
<a href=/player/lockb101>lockb101</a>,Bobby Locke,Chicago Cubs,CUBS,1,1,1,2,1962,1962,0,No,0,0.07,0.0,-0.07,2,0,-2,0,0,0,6.0,0.0,-6.0,0.0,0.0,0.0
<a href=/player/lockb101>lockb101</a>,Bobby Locke,St. Louis Cardinals,CARDS,3,4,3,7,1962,1964,2,No,0,0.95,1.5,0.55,172,76,-96,34,5,-29,466.0,170.0,-296.0,0.0,0.0,0.0
<a href=/player/lockb101>lockb101</a>,Bobby Locke,California Angels,ANGELS,1,1,2,3,1965,1965,0,No,0,-0.48,0.05,0.53,22,34,12,2,1,-1,52.0,84.0,32.0,0.0,0.0,0.0
<a href=/player/lockb102>lockb102</a>,Bob Locker,Chicago White Sox,WSOX,1,1,1,2,1969,1969,0,No,0,1.78,-0.44,-2.22,158,46,-112,14,6,-8,331.0,116.0,-215.0,0.0,0.0,0.0
<a href=/player/lockb102>lockb102</a>,Bob Locker,Oakland Athletics,ATLTCS,2,2,2,4,1972,1978,6,No,0,4.01,19.41,15.4,280,747,467,393,3076,2683,417.0,0.0,-417.0,35000.0,0.0,-35000.0
<a href=/player/lockb102>lockb102</a>,Bob Locker,Chicago Cubs,CUBS,3,3,3,6,1973,1978,5,No,0,0.43,1.08,0.65,11,93,82,0,61,61,35.0,142.0,107.0,69000.0,0.0,-69000.0
<a href=/player/lockb102>lockb102</a>,Bob Locker,Oakland Athletics,ATLTCS,1,3,1,4,1974,1976,2,No,0,1.24,1.92,0.68,1157,275,-882,3065,1015,-2050,578.0,0.0,-578.0,69800.0,0.0,-69800.0
<a href=/player/lockd101>lockd101</a>,Don Lock,New York Yankees,YANKS,1,1,1,2,1962,1963,1,No,0,10.43,0.46,-9.97,653,55,-598,2397,129,-2268,0.0,0.0,0.0,0.0,0.0,0.0
<a href=/player/lockd101>lockd101</a>,Don Lock,Washington Senators,RNGRS,16,29,32,61,1966,1992,26,No,2,68.98,45.12,-23.86,3839,2647,-1192,7344,5630,-1714,11858.0,5862.0,-5996.0,263000.0,0.0,-263000.0
<a href=/player/lockd101>lockd101</a>,Don Lock,Philadelphia Phillies,PHILS,1,1,1,2,1969,1969,0,No,0,-0.08,0.0,0.08,53,0,-53,70,0,-70,0.0,0.0,0.0,0.0,0.0,0.0
<a href=/player/lockg101>lockg101</a>,Gene Locklear,Cincinnati Reds,REDS,2,4,2,6,1973,1979,6,No,1,1.85,11.84,9.99,285,462,177,593,484,-109,64.0,3945.0,3881.0,0.0,0.0,0.0
<a href=/player/lockg101>lockg101</a>,Gene Locklear,San Diego Padres,PADRS,1,1,1,2,1976,1977,1,No,0,-0.29,0.41,0.7,14,138,124,39,58,19,0.0,578.0,578.0,0.0,0.0,0.0
<a href=/player/lockj001>lockj001</a>,Jeff Locke,Atlanta Braves,BRAVES,1,3,1,4,2009,2011,2,No,0,-2.0,-0.61,1.39,553,250,-303,514,1005,491,4336.0,0.0,-4336.0,0.0,0.0,0.0
<a href=/player/lockk001>lockk001</a>,Keith Lockhart,Kansas City Royals,ROYALS,2,3,3,6,1997,2002,5,No,0,6.48,5.78,-0.7,926,799,-127,2620,3080,460,0.0,181.0,181.0,3800000.0,0.0,-3800000.0
<a href=/player/lockr101>lockr101</a>,Ron Locke,New York Mets,METS,1,2,1,3,1966,1966,0,No,0,0.0,0.78,0.78,0,34,34,0,12,12,0.0,130.0,130.0,0.0,0.0,0.0
<a href=/player/locks101>locks101</a>,Skip Lockwood,Milwaukee Brewers,BREWRS,3,7,7,14,1973,1978,5,No,0,7.23,1.8,-5.43,546,209,-337,1533,327,-1206,524.0,1634.0,1110.0,168301.0,0.0,-168301.0
<a href=/player/locks101>locks101</a>,Skip Lockwood,California Angels,ANGELS,1,1,1,2,1974,1975,1,No,0,0.0,-0.55,-0.55,0,30,30,0,73,73,0.0,0.0,0.0,20000.0,0.0,-20000.0
<a href=/player/locks102>locks102</a>,Stu Locklin,Cleveland Indians,INDINS,1,1,1,2,1958,1959,1,No,0,0.0,0.0,0.0,0,0,0,0,0,0,0.0,0.0,0.0,0.0,0.0,0.0
<a href=/player/lockw001>lockw001</a>,Walker Lockett,San Diego Padres,PADRS,1,1,1,2,2018,2018,0,Yes,0,0.0,0.0,0.0,0,0,0,0,0,0,0.0,0.0,0.0,0.0,0.0,0.0
<a href=/player/lockw001>lockw001</a>,Walker Lockett,Cleveland Indians,INDINS,1,2,1,3,2019,2019,0,No,0,-0.48,-0.04,0.44,31,61,30,11,174,163,92.0,6.0,-86.0,0.0,0.0,0.0
<a href=/player/lockw101>lockw101</a>,Whitey Lockman,St. Louis Cardinals,CARDS,1,1,1,2,1957,1957,0,No,0,-1.14,0.28,1.42,225,80,-145,643,6,-637,0.0,165.0,165.0,0.0,0.0,0.0
<a href=/player/lockw101>lockw101</a>,Whitey Lockman,Baltimore Orioles,ORLS,1,1,1,2,1959,1961,2,No,0,0.0,0.4,0.4,73,155,82,102,398,296,0.0,0.0,0.0,0.0,0.0,0.0
<a href=/player/lockw101>lockw101</a>,Whitey Lockman,New York Giants,GIANTS,11,22,22,44,1956,1968,12,No,0,37.88,26.25,-11.63,3162,2563,-599,10326,4535,-5791,1384.0,7539.0,6155.0,95000.0,0.0,-95000.0
<a href=/player/lodid101>lodid101</a>,Dario Lodigiani,Oakland,Oakland,1,1,3,4,1937,1943,6,No,0,-0.11,0.0,0.11,215,0,-215,819,0,-819,0.0,0.0,0.0,0.0,0.0,0.0
<a href=/player/lodid101>lodid101</a>,Dario Lodigiani,Philadelphia Athletics,ATLTCS,1,1,1,2,1940,1946,6,No,0,1.34,-1.48,-2.82,190,100,-90,733,112,-621,0.0,888.0,888.0,3500.0,0.0,-3500.0
<a href=/player/lodup001>lodup001</a>,Paul Lo Duca,Los Angeles Dodgers,DOGRS,2,6,5,11,2004,2008,4,No,0,2.71,12.71,10.0,623,499,-124,1632,1049,-583,321.0,2036.0,1715.0,9106667.0,0.0,-9106667.0
<a href=/player/lodup001>lodup001</a>,Paul Lo Duca,Florida Marlins,MARLNS,2,2,3,5,2005,2008,3,No,0,2.55,0.89,-1.66,243,50,-193,1039,0,-1039,0.0,40.0,40.0,4666667.0,0.0,-4666667.0
<a href=/player/loepg101>loepg101</a>,George Loepp,Baltimore,Baltimore,2,3,6,9,1929,1930,1,No,0,-0.47,0.0,0.47,84,0,-84,186,0,-186,173.0,0.0,-173.0,0.0,0.0,0.0
<a href=/player/loesb101>loesb101</a>,Billy Loes,Baltimore Orioles,ORLS,1,1,1,2,1959,1959,0,No,0,0.0,0.0,0.0,0,0,0,0,0,0,0.0,0.0,0.0,0.0,0.0,0.0
<a href=/player/loesb101>loesb101</a>,Billy Loes,Baltimore Orioles,ORLS,14,30,28,58,1959,1994,35,No,3,64.68,130.52,65.84,3731,6258,2527,5785,17265,11480,16291.0,15650.0,-641.0,940333.0,0.0,-940333.0
<a href=/player/loewc001>loewc001</a>,Carlton Loewer,Philadelphia Phillies,PHILS,3,6,5,11,1999,2003,4,No,0,6.55,1.13,-5.42,362,281,-81,360,99,-261,2958.0,1114.0,-1844.0,6615000.0,0.0,-6615000.0
<a href=/player/loftd101>loftd101</a>,Dick Loftus,Brooklyn Dodgers,DOGRS,3,9,3,12,1926,1934,8,No,0,0.53,8.67,8.14,100,822,722,99,3036,2937,677.0,0.0,-677.0,30000.0,0.0,-30000.0
<a href=/player/loftf101>loftf101</a>,Frank Loftus,Philadelphia Athletics,ATLTCS,1,3,1,4,1924,1926,2,No,0,0.0,8.0,8.0,0,166,166,0,103,103,0.0,950.0,950.0,0.0,0.0,0.0
<a href=/player/loftk001>loftk001</a>,Kenny Lofton,Houston Astros,ASTROS,2,3,4,7,1991,1995,4,No,0,53.38,-0.45,-53.83,1975,315,-1660,8100,672,-7428,0.0,285.0,285.0,375000.0,0.0,-375000.0
<a href=/player/loftk001>loftk001</a>,Kenny Lofton,Cleveland Indians,INDINS,15,20,25,45,1997,2020,23,Yes,2,33.89,80.62,46.73,2990,2655,-335,9123,6094,-3029,3747.0,9391.0,5644.0,44554400.0,0.0,-44554400.0
<a href=/player/loftk001>loftk001</a>,Kenny Lofton,Chicago White Sox,WSOX,2,2,3,5,2002,2005,3,No,0,1.76,-1.16,-2.92,46,50,4,205,100,-105,0.0,148.0,148.0,1025000.0,0.0,-1025000.0
<a href=/player/loftk001>loftk001</a>,Kenny Lofton,Pittsburgh Pirates,PIRATS,2,4,4,8,2003,2005,2,No,0,25.85,-0.22,-26.07,1180,243,-937,4941,589,-4352,0.0,0.0,0.0,4351000.0,0.0,-4351000.0
<a href=/player/loftk001>loftk001</a>,Kenny Lofton,New York Yankees,YANKS,1,1,1,2,2004,2005,1,No,0,3.55,0.31,-3.24,110,35,-75,406,0,-406,0.0,97.0,97.0,3100000.0,0.0,-3100000.0
<a href=/player/loftk001>loftk001</a>,Kenny Lofton,Texas Rangers,RNGRS,1,1,1,2,2007,2011,4,No,0,0.74,0.29,-0.45,52,45,-7,196,140,-56,0.0,0.0,0.0,6000000.0,0.0,-6000000.0
<a href=/player/logab001>logab001</a>,Boone Logan,Chicago White Sox,WSOX,2,4,6,10,2008,2015,7,No,0,5.25,6.88,1.63,121,767,646,107,2238,2131,727.0,0.0,-727.0,11905000.0,0.0,-11905000.0
<a href=/player/logab001>logab001</a>,Boone Logan,Atlanta Braves,BRAVES,3,6,8,14,2009,2014,5,No,0,9.14,2.66,-6.48,1368,918,-450,996,2818,1822,2035.0,774.0,-1261.0,14152500.0,0.0,-14152500.0
<a href=/player/logab101>logab101</a>,Bob Logan,Indianapolis,Indianapolis,1,2,3,5,1936,1936,0,No,0,49.01,0.0,-49.01,1002,0,-1002,1002,0,-1002,7777.0,0.0,-7777.0,0.0,0.0,0.0
<a href=/player/logab101>logab101</a>,Bob Logan,Chicago Cubs,CUBS,1,2,1,3,1938,1938,0,No,0,0.0,0.41,0.41,0,26,26,0,27,27,0.0,204.0,204.0,0.0,0.0,0.0
<a href=/player/logab101>logab101</a>,Bob Logan,Indianapolis,Indianapolis,1,1,2,3,1945,1945,0,No,0,2.8,0.0,-2.8,68,0,-68,69,0,-69,561.0,0.0,-561.0,0.0,0.0,0.0
<a href=/player/logaj101>logaj101</a>,Johnny Logan,Milwaukee Braves,BRAVES,1,1,1,2,1961,1961,0,No,0,-0.36,-0.48,-0.12,152,37,-115,355,131,-224,0.0,0.0,0.0,0.0,0.0,0.0
<a href=/player/lohrb101>lohrb101</a>,Bill Lohrman,New York Giants,GIANTS,1,4,1,5,1941,1949,8,No,0,5.95,28.96,23.01,346,655,309,1181,2815,1634,38.0,0.0,-38.0,0.0,0.0,0.0
<a href=/player/lohrb101>lohrb101</a>,Bill Lohrman,New York Giants,GIANTS,2,4,3,7,1943,1945,2,No,0,-0.25,-0.04,0.21,36,72,36,28,39,11,123.0,375.0,252.0,0.0,0.0,0.0
<a href=/player/lohrb101>lohrb101</a>,Bill Lohrman,Brooklyn Dodgers,DOGRS,1,3,1,4,1944,1946,2,No,0,-0.35,6.14,6.49,4,237,233,0,969,969,5.0,0.0,-5.0,0.0,0.0,0.0
<a href=/player/lohrj101>lohrj101</a>,Jack Lohrke,New York Giants,GIANTS,1,1,1,2,1951,1951,0,No,0,-0.12,0.0,0.12,37,0,-37,47,0,-47,0.0,0.0,0.0,12000.0,0.0,-12000.0
<a href=/player/lohrj101>lohrj101</a>,Jack Lohrke,Philadelphia Phillies,PHILS,5,10,8,18,1954,1968,14,No,0,28.54,39.33,10.79,1270,2132,862,1527,6127,4600,4802.0,3446.0,-1356.0,0.0,0.0,0.0
<a href=/player/lohsk001>lohsk001</a>,Kyle Lohse,Chicago Cubs,CUBS,3,4,5,9,1999,2001,2,No,2,5.9,3.0,-2.9,235,338,103,49,464,415,3132.0,564.0,-2568.0,0.0,0.0,0.0
<a href=/player/lohsk001>lohsk001</a>,Kyle Lohse,Minnesota Twins,TWINS,1,1,1,2,2006,2006,0,No,0,2.25,0.0,-2.25,64,0,-64,66,0,-66,584.0,0.0,-584.0,3950000.0,0.0,-3950000.0
<a href=/player/lohsk001>lohsk001</a>,Kyle Lohse,Cincinnati Reds,REDS,1,1,1,2,2007,2011,4,No,0,0.65,0.05,-0.6,26,44,18,23,24,1,183.0,240.0,57.0,4200000.0,0.0,-4200000.0
<a href=/player/loisr001>loisr001</a>,Rich Loiselle,San Diego Padres,PADRS,1,2,1,3,1995,1995,0,No,0,-0.01,0.15,0.16,84,54,-30,3,165,162,134.0,0.0,-134.0,140000.0,0.0,-140000.0
<a href=/player/loisr001>loisr001</a>,Rich Loiselle,Houston Astros,ASTROS,1,1,1,2,1996,1996,0,No,0,2.3,-0.94,-3.24,397,30,-367,11,12,1,672.0,127.0,-545.0,0.0,0.0,0.0
<a href=/player/lolim101>lolim101</a>,Mickey Lolich,Detroit Tigers,TIGRS,2,3,4,7,1975,1979,4,No,0,1.24,6.09,4.85,109,575,466,196,2407,2211,578.0,284.0,-294.0,95000.0,0.0,-95000.0
<a href=/player/lolls101>lolls101</a>,Sherm Lollar,Cleveland Indians,INDINS,3,5,5,10,1946,1955,9,No,0,0.0,7.38,7.38,349,809,460,998,1967,969,633.0,1677.0,1044.0,0.0,0.0,0.0
<a href=/player/lolls101>lolls101</a>,Sherm Lollar,New York Yankees,YANKS,2,7,3,10,1948,1954,6,No,0,24.48,2.06,-22.42,970,341,-629,1730,188,-1542,4702.0,1746.0,-2956.0,11500.0,0.0,-11500.0
<a href=/player/lolls101>lolls101</a>,Sherm Lollar,St.Louis Browns,ORLS,40,98,101,199,1951,1994,43,No,3,172.85,216.49,43.64,11423,17730,6307,26850,53504,26654,34401.0,21386.0,-13015.0,1044583.0,0.0,-1044583.0
<a href=/player/lollt001>lollt001</a>,Tim Lollar,New York Yankees,YANKS,6,13,11,24,1981,1992,11,No,0,27.03,19.65,-7.38,2401,1053,-1348,5956,3510,-2446,5438.0,699.0,-4739.0,913333.0,0.0,-913333.0
<a href=/player/lollt001>lollt001</a>,Tim Lollar,San Diego Padres,PADRS,2,6,4,10,1984,1989,5,No,0,23.33,0.76,-22.57,2084,146,-1938,6812,127,-6685,1933.0,1127.0,-806.0,0.0,0.0,0.0
<a href=/player/lollt001>lollt001</a>,Tim Lollar,Chicago White Sox,WSOX,1,1,1,2,1985,1987,2,No,0,-0.43,0.29,0.72,50,125,75,2,286,284,330.0,0.0,-330.0,463000.0,0.0,-463000.0
<a href=/player/lombe101>lombe101</a>,Ernie Lombardi,Oakland,Oakland,1,1,2,3,1931,1932,1,No,0,0.44,0.0,-0.44,73,0,-73,196,0,-196,0.0,0.0,0.0,0.0,0.0,0.0
<a href=/player/lombe101>lombe101</a>,Ernie Lombardi,Brooklyn Dodgers,DOGRS,7,17,12,29,1932,1948,16,No,0,60.59,33.44,-27.15,3224,2810,-414,11104,10257,-847,2159.0,791.0,-1368.0,10000.0,0.0,-10000.0
<a href=/player/lombe101>lombe101</a>,Ernie Lombardi,Boston Braves,BRAVES,2,2,3,5,1943,1954,11,No,0,11.0,16.26,5.26,715,1091,376,2508,4022,1514,0.0,0.0,0.0,0.0,0.0,0.0
<a href=/player/lombg001>lombg001</a>,George Lombard,Atlanta Braves,BRAVES,1,1,1,2,2002,2002,0,No,0,-0.3,0.0,0.3,72,0,-72,270,0,-270,0.0,0.0,0.0,0.0,0.0,0.0
<a href=/player/lombp001>lombp001</a>,Phil Lombardi,New York Yankees,YANKS,1,3,2,5,1987,1989,2,No,0,0.13,-0.61,-0.74,44,148,104,95,521,426,0.0,0.0,0.0,0.0,0.0,0.0
<a href=/player/lombs001>lombs001</a>,Steve Lombardozzi,Minnesota Twins,TWINS,1,1,2,3,1989,1989,0,No,0,0.35,0.0,-0.35,23,0,-23,43,0,-43,0.0,0.0,0.0,0.0,0.0,0.0
<a href=/player/lombs002>lombs002</a>,Steve Lombardozzi,Washington Nationals,NATEX,1,3,1,4,2013,2015,2,No,0,-1.71,4.39,6.1,114,103,-11,3,101,98,324.0,801.0,477.0,501250.0,0.0,-501250.0
<a href=/player/lombs002>lombs002</a>,Steve Lombardozzi,Detroit Tigers,TIGRS,1,1,1,2,2014,2014,0,No,0,-0.68,-0.53,0.15,20,9,-11,74,32,-42,0.0,0.0,0.0,0.0,0.0,0.0
<a href=/player/lombv101>lombv101</a>,Vic Lombardi,Brooklyn Dodgers,DOGRS,3,7,9,16,1947,1954,7,No,0,6.69,26.56,19.87,628,1156,528,1259,3340,2081,1417.0,3832.0,2415.0,38000.0,0.0,-38000.0
<a href=/player/lonbj101>lonbj101</a>,Jim Lonborg,Boston Red Sox,RSOX,5,10,10,20,1971,1977,6,No,0,35.42,11.92,-23.5,1569,736,-833,4628,2092,-2536,3846.0,2344.0,-1502.0,155000.0,0.0,-155000.0
<a href=/player/lonbj101>lonbj101</a>,Jim Lonborg,Milwaukee Brewers,BREWRS,3,6,5,11,1972,1984,12,No,0,7.41,27.71,20.3,475,1402,927,547,5127,4580,4062.0,1332.0,-2730.0,59800.0,0.0,-59800.0
<a href=/player/lonej001>lonej001</a>,James Loney,Los Angeles Dodgers,DOGRS,5,22,14,36,2012,2021,9,Yes,0,4.41,31.13,26.72,1016,1541,525,2843,5562,2719,1152.0,835.0,-317.0,78709000.0,0.0,-78709000.0
<a href=/player/lonew101>lonew101</a>,Walter Lonergan,Boston Red Sox,RSOX,9,25,23,48,1912,1935,23,No,0,51.77,27.05,-24.72,3792,3039,-753,15081,11185,-3896,0.0,1203.0,1203.0,45050.0,0.0,-45050.0
<a href=/player/lonew101>lonew101</a>,Walter Lonergan,Brockton,Brockton,1,2,4,6,1911,1911,0,No,0,1.67,0.0,-1.67,331,0,-331,645,0,-645,0.0,0.0,0.0,0.0,0.0,0.0
<a href=/player/longb002>longb002</a>,Bill Long,San Diego Padres,PADRS,2,6,4,10,1984,1989,5,No,0,23.33,0.76,-22.57,2084,146,-1938,6812,127,-6685,1933.0,1127.0,-806.0,0.0,0.0,0.0
<a href=/player/longb002>longb002</a>,Bill Long,Chicago White Sox,WSOX,1,1,1,2,1990,1990,0,No,0,0.28,0.0,-0.28,84,0,-84,6,0,-6,167.0,0.0,-167.0,257500.0,0.0,-257500.0
<a href=/player/longd101>longd101</a>,Dale Long,Middletown,Middletown,1,2,2,4,1945,1945,0,No,0,0.0,0.0,0.0,0,0,0,0,0,0,0.0,0.0,0.0,0.0,0.0,0.0
<a href=/player/longd101>longd101</a>,Dale Long,Pittsburgh Pirates,PIRATS,3,4,5,9,1957,1959,2,No,0,9.68,2.34,-7.34,949,404,-545,3178,1303,-1875,0.0,0.0,0.0,0.0,0.0,0.0
<a href=/player/longd101>longd101</a>,Dale Long,Washington Senators,RNGRS,17,30,33,63,1962,1992,30,No,2,69.44,55.55,-13.89,3894,3300,-594,7473,8027,554,11858.0,5862.0,-5996.0,263000.0,0.0,-263000.0
<a href=/player/longe001>longe001</a>,Evan Longoria,Tampa Bay Devil Rays,RAYS,3,7,8,15,2017,2019,2,Yes,0,8.59,1.25,-7.34,553,79,-474,1848,289,-1559,188.0,0.0,-188.0,18300000.0,0.0,-18300000.0
<a href=/player/longh101>longh101</a>,Herman Long,New York Yankees,YANKS,1,2,1,3,1903,1909,6,No,0,0.01,19.09,19.08,92,667,575,343,2757,2414,0.0,0.0,0.0,0.0,0.0,0.0
<a href=/player/longj101>longj101</a>,Jeoff Long,Chicago White Sox,WSOX,3,4,4,8,1964,1969,5,No,0,5.43,1.58,-3.85,657,600,-57,2273,1624,-649,543.0,0.0,-543.0,26500.0,0.0,-26500.0
<a href=/player/longs001>longs001</a>,Shed Long,Cincinnati Reds,REDS,1,2,2,4,2019,2019,0,Yes,0,0.0,5.83,5.83,0,63,63,0,60,60,0.0,526.0,526.0,0.0,0.0,0.0
<a href=/player/longs001>longs001</a>,Shed Long,New York Yankees,YANKS,2,3,3,6,2019,2021,2,No,0,-0.42,0.33,0.75,110,102,-8,417,361,-56,0.0,0.0,0.0,0.0,0.0,0.0
<a href=/player/longt001>longt001</a>,Tony Longmire,Pittsburgh Pirates,PIRATS,2,4,2,6,1990,1991,1,No,0,3.0,-0.21,-3.21,512,23,-489,1575,37,-1538,0.0,0.0,0.0,925000.0,0.0,-925000.0
<a href=/player/longt002>longt002</a>,Terrence Long,New York Mets,METS,1,2,1,3,1999,1999,0,No,0,4.65,1.12,-3.53,602,24,-578,2480,30,-2450,0.0,228.0,228.0,200000.0,0.0,-200000.0
<a href=/player/longt002>longt002</a>,Terrence Long,Oakland Athletics,ATLTCS,2,3,3,6,2003,2012,9,No,0,7.5,9.83,2.33,434,545,111,1482,2087,605,0.0,206.0,206.0,4062500.0,0.0,-4062500.0
<a href=/player/longt002>longt002</a>,Terrence Long,San Diego Padres,PADRS,2,6,3,9,2004,2005,1,No,0,-0.69,-0.05,0.64,140,84,-56,489,11,-478,24.0,273.0,249.0,7550000.0,0.0,-7550000.0
<a href=/player/lonnj101>lonnj101</a>,Joe Lonnett,Philadelphia Phillies,PHILS,2,2,3,5,1958,1961,3,No,0,3.25,2.09,-1.16,305,311,6,785,858,73,0.0,0.0,0.0,0.0,0.0,0.0
<a href=/player/lonnj101>lonnj101</a>,Joe Lonnett,Milwaukee Braves,BRAVES,1,2,2,4,1959,1961,2,No,0,0.0,0.34,0.34,0,49,49,0,163,163,0.0,0.0,0.0,0.0,0.0,0.0
<a href=/player/lookb101>lookb101</a>,Bruce Look,New York Yankees,YANKS,1,1,1,2,1971,1971,0,No,0,0.0,0.0,0.0,0,0,0,0,0,0,0.0,0.0,0.0,0.0,0.0,0.0
<a href=/player/lookb101>lookb101</a>,Bruce Look,Milwaukee Brewers,BREWRS,2,3,3,6,1971,1973,2,No,0,-0.12,-0.77,-0.65,3,126,123,9,406,397,0.0,22.0,22.0,18000.0,0.0,-18000.0
<a href=/player/loonb001>loonb001</a>,Brian Looney,Boston Red Sox,RSOX,1,1,1,2,1996,1997,1,No,0,0.0,-0.22,-0.22,0,21,21,0,0,0,0.0,67.0,67.0,0.0,0.0,0.0
<a href=/player/loopa001>loopa001</a>,Aaron Looper,Seattle Mariners,MARNRS,1,2,1,3,2004,2005,1,No,0,0.0,0.37,0.37,0,113,113,0,391,391,0.0,0.0,0.0,0.0,0.0,0.0
<a href=/player/loopa001>loopa001</a>,Aaron Looper,Los Angeles Dodgers,DOGRS,1,1,1,2,2004,2004,0,No,0,0.0,0.0,0.0,0,0,0,0,0,0,0.0,0.0,0.0,0.0,0.0,0.0
<a href=/player/loopb001>loopb001</a>,Braden Looper,St. Louis Cardinals,CARDS,7,12,11,23,1998,2019,21,Yes,4,10.35,24.54,14.19,1808,1669,-139,1715,5353,3638,2044.0,547.0,-1497.0,3363000.0,0.0,-3363000.0
<a href=/player/lopae101>lopae101</a>,Eddie Lopat,Chicago White Sox,WSOX,13,20,26,46,1948,1968,20,No,0,32.37,102.48,70.11,2995,4360,1365,5442,9081,3639,8616.0,15133.0,6517.0,51250.0,0.0,-51250.0
<a href=/player/lopae101>lopae101</a>,Eddie Lopat,New York Yankees,YANKS,1,1,1,2,1955,1956,1,No,0,0.39,0.0,-0.39,20,0,-20,18,0,-18,147.0,0.0,-147.0,0.0,0.0,0.0
<a href=/player/lopas101>lopas101</a>,Stan Lopata,Philadelphia Phillies,PHILS,9,18,19,37,1959,1979,20,No,0,39.51,86.58,47.07,2824,3643,819,7602,10419,2817,7676.0,11796.0,4120.0,74500.0,0.0,-74500.0
<a href=/player/lopea001>lopea001</a>,Aurelio Lopez,St. Louis Cardinals,CARDS,5,7,10,17,1978,1994,16,No,2,8.24,37.26,29.02,800,1928,1128,1636,7432,5796,2139.0,691.0,-1448.0,1500000.0,0.0,-1500000.0
<a href=/player/lopea002>lopea002</a>,Albie Lopez,Tampa Bay Devil Rays,RAYS,2,3,3,6,2001,2003,2,No,0,0.72,-0.23,-0.95,68,152,84,104,387,283,243.0,290.0,47.0,3750000.0,0.0,-3750000.0
<a href=/player/lopea003>lopea003</a>,Aquilino Lopez,Philadelphia Phillies,PHILS,1,1,2,3,2006,2006,0,No,0,0.0,0.0,0.0,0,0,0,0,0,0,0.0,0.0,0.0,0.0,0.0,0.0
<a href=/player/lopea102>lopea102</a>,Al Lopez,Brooklyn Dodgers,DOGRS,5,10,8,18,1935,1948,13,No,0,23.18,15.94,-7.24,1423,1121,-302,4586,3821,-765,1769.0,791.0,-978.0,0.0,0.0,0.0
<a href=/player/lopea102>lopea102</a>,Al Lopez,Boston Braves,BRAVES,1,1,2,3,1940,1942,2,No,0,4.62,-0.87,-5.49,656,205,-451,2135,559,-1576,0.0,0.0,0.0,0.0,0.0,0.0
<a href=/player/lopea102>lopea102</a>,Al Lopez,Pittsburgh Pirates,PIRATS,2,6,2,8,1946,1947,1,No,0,0.35,0.08,-0.27,61,22,-39,135,87,-48,0.0,0.0,0.0,5000.0,0.0,-5000.0
<a href=/player/lopec101>lopec101</a>,Carlos Lopez,Seattle Mariners,MARNRS,2,3,2,5,1977,1982,5,No,0,-0.28,1.01,1.29,129,138,9,207,50,-157,0.0,1472.0,1472.0,0.0,0.0,0.0
<a href=/player/loped001>loped001</a>,Davey Lopes,Los Angeles Dodgers,DOGRS,1,1,1,2,1982,1982,0,No,0,5.3,0.0,-5.3,347,0,-347,1324,0,-1324,0.0,0.0,0.0,0.0,0.0,0.0
<a href=/player/loped001>loped001</a>,Davey Lopes,Oakland Athletics,ATLTCS,1,1,2,3,1984,1985,1,No,0,3.96,-1.23,-5.19,174,16,-158,539,0,-539,0.0,92.0,92.0,450000.0,0.0,-450000.0
<a href=/player/loped001>loped001</a>,Davey Lopes,Chicago Cubs,CUBS,1,1,1,2,1986,1988,2,No,0,0.84,0.82,-0.02,84,324,240,169,15,-154,0.0,631.0,631.0,490000.0,0.0,-490000.0
<a href=/player/lopef001>lopef001</a>,Felipe Lopez,Toronto Blue Jays,BJAYS,1,1,1,2,2002,2002,0,No,0,4.22,0.0,-4.22,371,0,-371,1566,0,-1566,0.0,0.0,0.0,221000.0,0.0,-221000.0
<a href=/player/lopef001>lopef001</a>,Felipe Lopez,Cincinnati Reds,REDS,1,3,5,8,2006,2012,6,No,0,0.43,-0.61,-1.04,795,705,-90,2860,181,-2679,139.0,809.0,670.0,4550000.0,0.0,-4550000.0
<a href=/player/lopef001>lopef001</a>,Felipe Lopez,Arizona Diamondbacks,DBACKS,1,1,2,3,2009,2012,3,No,0,1.78,-0.62,-2.4,82,50,-32,348,120,-228,0.0,0.0,0.0,3500000.0,0.0,-3500000.0
<a href=/player/lopeh101>lopeh101</a>,Hector Lopez,Kansas City Athletics,ATLTCS,17,36,31,67,1959,1976,17,No,0,68.33,55.7,-12.63,8021,5164,-2857,18125,17078,-1047,14086.0,3207.0,-10879.0,387100.0,0.0,-387100.0
<a href=/player/lopej001>lopej001</a>,Javy Lopez,Baltimore Orioles,ORLS,1,1,2,3,2006,2008,2,No,0,-0.68,0.0,0.68,18,2,-16,65,0,-65,0.0,0.0,0.0,9000000.0,0.0,-9000000.0
<a href=/player/lopej002>lopej002</a>,Javier Lopez,Boston Red Sox,RSOX,1,1,1,2,2003,2003,0,No,0,0.01,0.0,-0.01,276,0,-276,8,0,-8,303.0,0.0,-303.0,0.0,0.0,0.0
<a href=/player/lopej002>lopej002</a>,Javier Lopez,Chicago White Sox,WSOX,1,1,1,2,2006,2006,0,No,0,2.51,0.55,-1.96,182,37,-145,1,0,-1,385.0,103.0,-282.0,0.0,0.0,0.0
<a href=/player/lopej002>lopej002</a>,Javier Lopez,Pittsburgh Pirates,PIRATS,1,1,2,3,2010,2011,1,No,0,5.3,0.17,-5.13,867,55,-812,4,96,92,753.0,26.0,-727.0,775000.0,0.0,-775000.0
<a href=/player/lopej003>lopej003</a>,Jose Lopez,Seattle Mariners,MARNRS,1,1,1,2,2010,2011,1,No,0,-0.43,0.0,0.43,38,0,-38,129,0,-129,0.0,0.0,0.0,3000000.0,0.0,-3000000.0
<a href=/player/lopej004>lopej004</a>,Jorge Lopez,Milwaukee Brewers,BREWRS,1,2,1,3,2018,2019,1,No,0,-0.83,3.09,3.92,134,197,63,238,802,564,475.0,0.0,-475.0,0.0,0.0,0.0
<a href=/player/lopel002>lopel002</a>,Luis Lopez,San Diego Padres,PADRS,1,1,1,2,1997,1997,0,No,0,0.0,0.0,0.0,0,0,0,0,0,0,0.0,0.0,0.0,0.0,0.0,0.0
<a href=/player/lopel002>lopel002</a>,Luis Lopez,Houston Astros,ASTROS,1,1,1,2,1997,2000,3,No,0,-0.04,0.72,0.76,263,394,131,612,1149,537,0.0,6.0,6.0,0.0,0.0,0.0
<a href=/player/lopel002>lopel002</a>,Luis Lopez,New York Mets,METS,13,26,28,54,2000,2021,21,Yes,0,24.29,23.27,-1.02,1150,1892,742,2106,4808,2702,6006.0,3574.0,-2432.0,30731467.0,0.0,-30731467.0
<a href=/player/lopem002>lopem002</a>,Mickey Lopez,Milwaukee Brewers,BREWRS,1,1,1,2,2001,2001,0,No,0,0.0,0.0,0.0,0,0,0,0,0,0,0.0,0.0,0.0,0.0,0.0,0.0
<a href=/player/lopem101>lopem101</a>,Marcelino Lopez,Philadelphia Phillies,PHILS,1,2,1,3,1964,1964,0,No,0,3.87,0.04,-3.83,190,18,-172,145,50,-95,1270.0,0.0,-1270.0,0.0,0.0,0.0
<a href=/player/lopem101>lopem101</a>,Marcelino Lopez,California Angels,ANGELS,2,3,2,5,1967,1968,1,No,0,0.18,0.22,0.04,210,95,-115,182,230,48,443.0,0.0,-443.0,0.0,0.0,0.0
<a href=/player/lopem101>lopem101</a>,Marcelino Lopez,Baltimore Orioles,ORLS,13,28,24,52,1971,1994,23,No,3,51.36,92.12,40.76,3163,4677,1514,7108,11641,4533,12206.0,13973.0,1767.0,846833.0,0.0,-846833.0
<a href=/player/lopep002>lopep002</a>,Pablo Lopez,Seattle Mariners,MARNRS,1,4,1,5,2017,2018,1,No,0,5.31,0.23,-5.08,114,11,-103,89,0,-89,990.0,26.0,-964.0,0.0,0.0,0.0
<a href=/player/loper001>loper001</a>,Rodrigo Lopez,Baltimore Orioles,ORLS,1,1,2,3,2007,2010,3,No,0,0.74,0.16,-0.58,27,8,-19,24,0,-24,238.0,23.0,-215.0,0.0,0.0,0.0
<a href=/player/loper001>loper001</a>,Rodrigo Lopez,Atlanta Braves,BRAVES,1,1,1,2,2011,2014,3,No,0,-0.51,0.09,0.6,59,2,-57,33,0,-33,312.0,3.0,-309.0,0.0,0.0,0.0
<a href=/player/loper002>loper002</a>,Rafael Lopez,Chicago Cubs,CUBS,1,1,2,3,2015,2015,0,Yes,0,0.0,0.0,0.0,0,0,0,0,0,0,0.0,0.0,0.0,0.0,0.0,0.0
<a href=/player/loper003>loper003</a>,Reynaldo Lopez,Washington Nationals,NATEX,1,3,1,4,2016,2020,4,No,0,16.01,2.64,-13.37,233,310,77,19,1309,1290,3554.0,0.0,-3554.0,0.0,0.0,0.0
<a href=/player/lopet001>lopet001</a>,Tim Lopes,Seattle Mariners,MARNRS,2,2,2,4,2016,2017,1,Yes,0,0.0,-0.15,-0.15,0,7,7,0,0,0,0.0,40.0,40.0,0.0,0.0,0.0
<a href=/player/lopew001>lopew001</a>,Wilton Lopez,Houston Astros,ASTROS,1,2,2,4,2012,2015,3,No,0,0.63,0.0,-0.63,153,0,-153,1,0,-1,245.0,0.0,-245.0,515500.0,0.0,-515500.0
<a href=/player/lopey001>lopey001</a>,Yoan Lopez,Arizona Diamondbacks,DBACKS,1,1,1,2,2021,2021,0,Yes,0,0.0,0.0,0.0,0,0,0,0,0,0,0.0,0.0,0.0,0.0,0.0,0.0
<a href=/player/lordb101>lordb101</a>,Bris Lord,Cleveland Indians,INDINS,3,4,9,13,1910,1932,22,No,0,36.24,73.71,37.47,997,2838,1841,4399,11636,7237,0.0,807.0,807.0,0.0,0.0,0.0
<a href=/player/lordb101>lordb101</a>,Bris Lord,Philadelphia Athletics,ATLTCS,2,5,3,8,1912,1916,4,No,0,0.94,11.21,10.27,71,847,776,237,3547,3310,0.0,0.0,0.0,0.0,0.0,0.0
<a href=/player/lordb101>lordb101</a>,Bris Lord,Baltimore,Baltimore,1,1,1,2,1913,1913,0,No,0,-0.46,0.0,0.46,73,0,-73,247,0,-247,0.0,0.0,0.0,0.0,0.0,0.0
<a href=/player/lordh101>lordh101</a>,Harry Lord,Boston Red Sox,RSOX,10,27,25,52,1910,1935,25,No,0,63.77,27.05,-36.72,4436,3125,-1311,17821,11484,-6337,0.0,1291.0,1291.0,45050.0,0.0,-45050.0
<a href=/player/lorem001>lorem001</a>,Mark Loretta,Milwaukee Brewers,BREWRS,13,24,27,51,2002,2020,18,Yes,1,46.62,31.32,-15.3,4021,2537,-1484,14901,5603,-9298,933.0,5300.0,4367.0,34288833.0,0.0,-34288833.0
<a href=/player/lorem001>lorem001</a>,Mark Loretta,San Diego Padres,PADRS,3,3,5,8,2005,2011,6,No,0,0.19,5.34,5.15,314,878,564,1006,1202,196,131.0,712.0,581.0,4680900.0,0.0,-4680900.0
<a href=/player/lorra001>lorra001</a>,Andrew Lorraine,California Angels,ANGELS,1,4,2,6,1995,1997,2,No,0,5.3,-0.85,-6.15,439,40,-399,87,0,-87,1686.0,680.0,-1006.0,0.0,0.0,0.0
<a href=/player/lorra001>lorra001</a>,Andrew Lorraine,Chicago White Sox,WSOX,1,2,1,3,1996,1996,0,No,0,-0.05,0.57,0.62,12,132,120,0,541,541,89.0,0.0,-89.0,0.0,0.0,0.0
<a href=/player/loucs001>loucs001</a>,Scott Loucks,Houston Astros,ASTROS,1,1,1,2,1984,1984,0,No,0,0.0,0.0,0.0,0,0,0,0,0,0,0.0,0.0,0.0,0.0,0.0,0.0
<a href=/player/lougd001>lougd001</a>,David Lough,Kansas City Royals,ROYALS,3,3,4,7,2013,2015,2,Yes,0,2.66,0.2,-2.46,371,59,-312,680,155,-525,234.0,58.0,-176.0,1065000.0,0.0,-1065000.0
<a href=/player/loupa001>loupa001</a>,Aaron Loup,Toronto Blue Jays,BJAYS,1,1,1,2,2018,2021,3,No,0,0.09,0.26,0.17,18,29,11,0,3,3,12.0,287.0,275.0,1812500.0,0.0,-1812500.0
<a href=/player/lovel102>lovel102</a>,Lynn Lovenguth,Toronto,Toronto,1,1,2,3,1956,1956,0,No,0,0.19,0.0,-0.19,5,0,-5,2,0,-2,27.0,0.0,-27.0,0.0,0.0,0.0
<a href=/player/loves101>loves101</a>,Slim Love,New York Yankees,YANKS,5,19,8,27,1918,1928,10,No,0,9.22,7.55,-1.67,1051,1233,182,2808,4705,1897,3476.0,418.0,-3058.0,39950.0,0.0,-39950.0
<a href=/player/loves101>loves101</a>,Slim Love,Boston Red Sox,RSOX,1,3,1,4,1919,1919,0,No,0,4.45,1.63,-2.82,567,133,-434,1739,583,-1156,282.0,0.0,-282.0,0.0,0.0,0.0
<a href=/player/lovev001>lovev001</a>,Vance Lovelace,Chicago Cubs,CUBS,3,4,3,7,1983,1988,5,No,0,1.79,5.67,3.88,345,610,265,964,2221,1257,0.0,37.0,37.0,0.0,0.0,0.0
<a href=/player/lovij101>lovij101</a>,Jay Loviglio,Philadelphia Phillies,PHILS,1,1,1,2,1981,1982,1,No,0,-0.79,0.31,1.1,29,70,41,49,7,-42,0.0,189.0,189.0,0.0,0.0,0.0
<a href=/player/lovij102>lovij102</a>,Joe Lovitto,Texas Rangers,RNGRS,2,3,2,5,1975,1977,2,No,0,-0.19,1.08,1.27,220,158,-62,533,480,-53,0.0,151.0,151.0,0.0,0.0,0.0
<a href=/player/lovut001>lovut001</a>,Torey Lovullo,Detroit Tigers,TIGRS,1,1,1,2,1991,1994,3,No,0,-0.45,2.42,2.87,22,102,80,59,0,-59,0.0,1060.0,1060.0,0.0,0.0,0.0
<a href=/player/lowdg101>lowdg101</a>,Grover Lowdermilk,Chicago Cubs,CUBS,1,3,5,8,1912,1913,1,No,0,3.8,1.08,-2.72,112,82,-30,420,326,-94,0.0,0.0,0.0,7925.0,0.0,-7925.0
<a href=/player/lowdg101>lowdg101</a>,Grover Lowdermilk,Cincinnati Reds,REDS,1,1,1,2,1913,1913,0,No,0,0.0,1.62,1.62,0,78,78,0,58,58,0.0,500.0,500.0,0.0,0.0,0.0
<a href=/player/lowdg101>lowdg101</a>,Grover Lowdermilk,St.Louis Browns,ORLS,1,6,1,7,1921,1921,0,No,0,0.0,0.0,0.0,0,0,0,0,0,0,0.0,0.0,0.0,6600.0,0.0,-6600.0
<a href=/player/lowdg101>lowdg101</a>,Grover Lowdermilk,Minneapolis,Minneapolis,1,1,1,2,1921,1933,12,No,0,0.0,0.0,0.0,0,0,0,0,0,0,0.0,0.0,0.0,0.0,0.0,0.0
<a href=/player/lowed001>lowed001</a>,Derek Lowe,Seattle Mariners,MARNRS,1,2,1,3,1997,1998,1,No,0,43.6,0.43,-43.17,1956,90,-1866,5862,0,-5862,3111.0,288.0,-2823.0,0.0,0.0,0.0
<a href=/player/lowed001>lowed001</a>,Derek Lowe,Atlanta Braves,BRAVES,2,3,2,5,2011,2013,2,No,0,-0.36,0.43,0.79,23,73,50,4,0,-4,357.0,93.0,-264.0,15000000.0,0.0,-15000000.0
<a href=/player/lowej001>lowej001</a>,John Lowenstein,Cleveland Indians,INDINS,3,4,3,7,1976,1979,3,No,0,1.78,5.31,3.53,491,315,-176,1873,1149,-724,0.0,405.0,405.0,0.0,0.0,0.0
<a href=/player/lowej001>lowej001</a>,John Lowenstein,Toronto Blue Jays,BJAYS,1,1,1,2,1977,1978,1,No,0,-0.25,-0.33,-0.08,81,91,10,172,294,122,0.0,0.0,0.0,0.0,0.0,0.0
<a href=/player/lowej001>lowej001</a>,John Lowenstein,Cleveland Indians,INDINS,2,4,5,9,1978,1980,2,No,0,-0.65,0.26,0.91,196,116,-80,422,243,-179,0.0,597.0,597.0,0.0,0.0,0.0
<a href=/player/lowem001>lowem001</a>,Mike Lowell,New York Yankees,YANKS,5,13,9,22,1999,2007,8,No,2,19.54,3.99,-15.55,1670,118,-1552,4208,14,-4194,3035.0,1662.0,-1373.0,4387150.0,0.0,-4387150.0
<a href=/player/lowem001>lowem001</a>,Mike Lowell,Florida Marlins,MARLNS,7,14,19,33,2005,2019,14,Yes,0,61.63,50.29,-11.34,1841,2297,456,4569,6863,2294,8636.0,5082.0,-3554.0,29867000.0,0.0,-29867000.0
<a href=/player/lowem002>lowem002</a>,Mark Lowe,Seattle Mariners,MARNRS,5,8,8,16,2010,2014,4,No,0,3.8,5.22,1.42,345,797,452,623,2614,1991,753.0,1105.0,352.0,10564000.0,0.0,-10564000.0
<a href=/player/lowem002>lowem002</a>,Mark Lowe,Seattle Mariners,MARNRS,4,8,9,17,2015,2020,5,Yes,0,1.54,-0.4,-1.94,243,115,-128,269,160,-109,257.0,195.0,-62.0,0.0,0.0,0.0
<a href=/player/lowen001>lowen001</a>,Nate Lowe,Tampa Bay Devil Rays,RAYS,1,3,3,6,2020,2020,0,Yes,0,2.36,0.0,-2.36,157,0,-157,642,0,-642,0.0,0.0,0.0,0.0,0.0,0.0
<a href=/player/lowes001>lowes001</a>,Sean Lowe,St. Louis Cardinals,CARDS,1,1,1,2,1999,1999,0,No,0,5.1,0.0,-5.1,171,0,-171,3,0,-3,880.0,0.0,-880.0,0.0,0.0,0.0
<a href=/player/lowes001>lowes001</a>,Sean Lowe,Chicago White Sox,WSOX,1,3,2,5,2001,2002,1,No,0,9.76,-1.6,-11.36,587,29,-558,520,5,-515,4516.0,401.0,-4115.0,300000.0,0.0,-300000.0
<a href=/player/lowet001>lowet001</a>,Terrell Lowery,Texas Rangers,RNGRS,3,4,6,10,1996,2007,11,No,2,2.88,7.64,4.76,229,322,93,721,686,-35,0.0,1253.0,1253.0,225000.0,0.0,-225000.0
<a href=/player/lownt101>lownt101</a>,Turk Lown,Chicago Cubs,CUBS,1,1,1,2,1958,1958,0,No,0,-0.14,-0.72,-0.58,22,18,-4,1,1,0,35.0,39.0,4.0,0.0,0.0,0.0
<a href=/player/lowrj001>lowrj001</a>,Jed Lowrie,Boston Red Sox,RSOX,2,6,3,9,2011,2019,8,No,0,10.72,7.46,-3.26,739,668,-71,662,2223,1561,960.0,157.0,-803.0,971000.0,0.0,-971000.0
<a href=/player/lowrj001>lowrj001</a>,Jed Lowrie,Houston Astros,ASTROS,2,3,5,8,2013,2020,7,Yes,0,13.46,8.06,-5.4,1071,776,-295,3907,2069,-1838,325.0,1629.0,1304.0,590100.0,0.0,-590100.0
<a href=/player/lowrj001>lowrj001</a>,Jed Lowrie,Houston Astros,ASTROS,1,1,1,2,2015,2015,0,Yes,0,7.25,0.0,-7.25,536,0,-536,2206,0,-2206,0.0,0.0,0.0,8000000.0,0.0,-8000000.0
<a href=/player/lowrp101>lowrp101</a>,Peanuts Lowrey,Chicago Cubs,CUBS,4,8,7,15,1949,1958,9,No,0,10.8,25.37,14.57,1114,1705,591,3490,6393,2903,130.0,197.0,67.0,0.0,0.0,0.0
<a href=/player/loynm001>loynm001</a>,Mike Loynd,Texas Rangers,RNGRS,1,1,1,2,1988,1988,0,No,0,0.0,0.0,0.0,0,0,0,0,0,0,0.0,0.0,0.0,0.0,0.0,0.0
<a href=/player/lubyh101>lubyh101</a>,Hal Luby,Philadelphia Athletics,ATLTCS,2,4,2,6,1937,1946,9,No,0,1.34,-1.59,-2.93,190,315,125,733,931,198,0.0,888.0,888.0,5300.0,0.0,-5300.0
<a href=/player/lucag001>lucag001</a>,Gary Lucas,San Diego Padres,PADRS,10,14,19,33,1983,2002,19,No,2,22.11,37.38,15.27,1694,2801,1107,3397,4346,949,2612.0,6924.0,4312.0,10413333.0,0.0,-10413333.0
<a href=/player/lucag001>lucag001</a>,Gary Lucas,Montreal Expos,NATEX,1,1,2,3,1985,1986,1,No,0,0.47,0.0,-0.47,75,0,-75,0,0,0,360.0,0.0,-360.0,513500.0,0.0,-513500.0
<a href=/player/lucaj001>lucaj001</a>,Josh Lucas,St. Louis Cardinals,CARDS,1,1,1,2,2018,2018,0,Yes,0,-0.21,0.0,0.21,9,0,-9,0,0,0,43.0,0.0,-43.0,0.0,0.0,0.0
<a href=/player/lucar101>lucar101</a>,Ray Lucas,Brooklyn Dodgers,DOGRS,3,5,3,8,1934,1939,5,No,0,16.05,2.05,-14.0,637,340,-297,2368,295,-2073,132.0,2357.0,2225.0,0.0,0.0,0.0
<a href=/player/lucar102>lucar102</a>,Red Lucas,Boston Braves,BRAVES,15,35,27,62,1925,1952,27,No,0,61.82,121.75,59.93,3287,6434,3147,11058,21686,10628,3053.0,10767.0,7714.0,50600.0,0.0,-50600.0
<a href=/player/lucar102>lucar102</a>,Red Lucas,Cincinnati Reds,REDS,1,2,2,4,1933,1935,2,No,0,11.2,-0.59,-11.79,432,112,-320,556,459,-97,2051.0,0.0,-2051.0,0.0,0.0,0.0
<a href=/player/luccj001>luccj001</a>,Joey Lucchesi,San Diego Padres,PADRS,1,5,1,6,2021,2021,0,Yes,0,0.12,3.49,3.37,21,68,47,11,57,46,115.0,544.0,429.0,0.0,0.0,0.0
<a href=/player/lucie001>lucie001</a>,Elvis Luciano,Arizona Diamondbacks,DBACKS,1,2,1,3,2018,2018,0,No,0,-0.12,-0.27,-0.15,25,84,59,0,320,320,62.0,0.0,-62.0,0.0,0.0,0.0
<a href=/player/lucrj001>lucrj001</a>,Jonathan Lucroy,Milwaukee Brewers,BREWRS,4,10,6,16,2016,2018,2,Yes,0,-0.21,7.76,7.97,1054,270,-784,3356,840,-2516,449.0,87.0,-362.0,2550000.0,0.0,-2550000.0
<a href=/player/lucrj001>lucrj001</a>,Jonathan Lucroy,Texas Rangers,RNGRS,1,1,1,2,2017,2017,0,Yes,0,0.82,0.0,-0.82,46,0,-46,175,0,-175,0.0,0.0,0.0,5250000.0,0.0,-5250000.0
<a href=/player/ludef101>ludef101</a>,Fred Luderus,Chicago Cubs,CUBS,1,1,1,2,1910,1910,0,No,0,19.94,-0.27,-20.21,1311,4,-1307,5308,2,-5306,0.0,15.0,15.0,0.0,0.0,0.0
<a href=/player/ludwe001>ludwe001</a>,Eric Ludwick,New York Mets,METS,5,9,7,16,1996,1999,3,No,0,12.32,10.55,-1.77,1251,422,-829,4420,1607,-2813,1041.0,86.0,-955.0,5050000.0,0.0,-5050000.0
<a href=/player/ludwe001>ludwe001</a>,Eric Ludwick,St. Louis Cardinals,CARDS,1,3,1,4,1997,1997,0,No,0,-0.38,2.04,2.42,256,51,-205,9,224,215,1161.0,0.0,-1161.0,395000.0,0.0,-395000.0
<a href=/player/ludwe001>ludwe001</a>,Eric Ludwick,Oakland Athletics,ATLTCS,2,2,3,5,1997,1998,1,No,0,-1.95,-0.55,1.4,164,35,-129,388,136,-252,98.0,0.0,-98.0,1000000.0,0.0,-1000000.0
<a href=/player/ludwe001>ludwe001</a>,Eric Ludwick,Detroit Tigers,TIGRS,1,1,1,2,1998,1999,1,No,0,-0.11,-0.26,-0.15,1,1,0,0,0,0,3.0,12.0,9.0,0.0,0.0,0.0
<a href=/player/ludwr001>ludwr001</a>,Ryan Ludwick,Oakland Athletics,ATLTCS,7,12,11,23,2002,2009,7,No,0,21.2,14.17,-7.03,1375,998,-377,3394,3388,-6,5508.0,716.0,-4792.0,947000.0,0.0,-947000.0
<a href=/player/ludwr001>ludwr001</a>,Ryan Ludwick,Texas Rangers,RNGRS,2,2,3,5,2003,2009,6,No,0,1.1,4.95,3.85,73,182,109,247,231,-16,0.0,2049.0,2049.0,0.0,0.0,0.0
<a href=/player/ludwr001>ludwr001</a>,Ryan Ludwick,St. Louis Cardinals,CARDS,1,1,2,3,2010,2015,5,No,0,-0.64,1.05,1.69,160,226,66,664,193,-471,0.0,1757.0,1757.0,5450000.0,0.0,-5450000.0
<a href=/player/luebd101>luebd101</a>,Dick Luebke,Baltimore Orioles,ORLS,2,3,3,6,1962,1966,4,No,0,0.15,0.64,0.49,200,82,-118,614,176,-438,0.0,0.0,0.0,8500.0,0.0,-8500.0
<a href=/player/luebl001>luebl001</a>,Larry Luebbers,Cincinnati Reds,REDS,2,4,2,6,1993,1996,3,No,0,1.51,1.69,0.18,53,302,249,0,11,11,157.0,464.0,307.0,817000.0,0.0,-817000.0
<a href=/player/luebs101>luebs101</a>,Steve Luebber,Baltimore Orioles,ORLS,1,1,1,2,1982,1982,0,No,0,0.0,0.0,0.0,0,0,0,0,0,0,0.0,0.0,0.0,0.0,0.0,0.0
<a href=/player/luecr001>luecr001</a>,Rick Luecken,Seattle Mariners,MARNRS,1,2,3,5,1986,1991,5,No,0,13.13,9.05,-4.08,676,330,-346,2684,625,-2059,71.0,1795.0,1724.0,85000.0,0.0,-85000.0
<a href=/player/luecr001>luecr001</a>,Rick Luecken,Kansas City Royals,ROYALS,1,2,2,4,1989,1990,1,No,0,8.3,0.22,-8.08,256,133,-123,214,512,298,1914.0,0.0,-1914.0,1318000.0,0.0,-1318000.0
<a href=/player/luekj001>luekj001</a>,Josh Lueke,Texas Rangers,RNGRS,2,5,4,9,2010,2012,2,No,2,2.66,1.99,-0.67,576,111,-465,1946,0,-1946,977.0,588.0,-389.0,0.0,0.0,0.0
<a href=/player/luekj001>luekj001</a>,Josh Lueke,Seattle Mariners,MARNRS,3,4,3,7,2011,2014,3,No,0,1.81,2.37,0.56,234,184,-50,623,668,45,165.0,0.0,-165.0,414000.0,0.0,-414000.0
<a href=/player/lugod001>lugod001</a>,Dawel Lugo,Toronto Blue Jays,BJAYS,1,1,2,3,2015,2015,0,No,0,0.0,-0.34,-0.34,0,33,33,0,92,92,0.0,0.0,0.0,0.0,0.0,0.0
<a href=/player/lugod001>lugod001</a>,Dawel Lugo,Arizona Diamondbacks,DBACKS,1,3,1,4,2017,2017,0,No,0,-1.37,2.41,3.78,123,62,-61,423,257,-166,0.0,0.0,0.0,0.0,0.0,0.0
<a href=/player/lugoj001>lugoj001</a>,Julio Lugo,Tampa Bay Devil Rays,RAYS,1,1,2,3,2006,2008,2,No,0,-0.96,-0.26,0.7,49,16,-33,164,39,-125,0.0,0.0,0.0,4950000.0,0.0,-4950000.0
<a href=/player/lugoj001>lugoj001</a>,Julio Lugo,Boston Red Sox,RSOX,1,1,1,2,2009,2009,0,No,0,0.64,0.0,-0.64,51,0,-51,170,0,-170,0.0,0.0,0.0,9250000.0,0.0,-9250000.0
<a href=/player/lugor002>lugor002</a>,Ruddy Lugo,Milwaukee Brewers,BREWRS,1,2,1,3,2001,2001,0,No,0,1.1,0.82,-0.28,246,126,-120,839,432,-407,0.0,0.0,0.0,0.0,0.0,0.0
<a href=/player/lugor002>lugor002</a>,Ruddy Lugo,Los Angeles Dodgers,DOGRS,1,1,1,2,2003,2003,0,No,0,0.0,-1.07,-1.07,0,52,52,0,114,114,0.0,0.0,0.0,0.0,0.0,0.0
<a href=/player/lum-m101>lum-m101</a>,Mike Lum,Atlanta Braves,BRAVES,1,1,1,2,1975,1979,4,No,0,0.12,-1.7,-1.82,251,379,128,469,1206,737,0.0,0.0,0.0,0.0,0.0,0.0
<a href=/player/lumpj101>lumpj101</a>,Jerry Lumpe,New York Yankees,YANKS,3,7,5,12,1959,1966,7,No,0,10.26,14.71,4.45,1028,1524,496,3254,3264,10,1701.0,4103.0,2402.0,84000.0,0.0,-84000.0
<a href=/player/lumpj101>lumpj101</a>,Jerry Lumpe,Kansas City Athletics,ATLTCS,15,33,27,60,1963,1976,13,No,0,55.99,46.74,-9.25,6677,4175,-2502,14870,13661,-1209,10290.0,2197.0,-8093.0,387100.0,0.0,-387100.0
<a href=/player/lunaf001>lunaf001</a>,Fernando Lunar,Atlanta Braves,BRAVES,1,3,2,5,2000,2002,2,No,0,-0.42,1.16,1.58,107,214,107,224,759,535,2.0,6.0,4.0,800000.0,0.0,-800000.0
<a href=/player/lunaf001>lunaf001</a>,Fernando Lunar,Texas Rangers,RNGRS,1,1,1,2,2003,2003,0,No,0,0.0,0.0,0.0,0,0,0,0,0,0,0.0,0.0,0.0,0.0,0.0,0.0
<a href=/player/lunah001>lunah001</a>,Hector Luna,St. Louis Cardinals,CARDS,1,1,1,2,2006,2006,0,No,0,-0.77,0.14,0.91,37,54,17,134,211,77,0.0,0.0,0.0,340000.0,0.0,-340000.0
<a href=/player/lundg101>lundg101</a>,Gordy Lund,Cleveland Indians,INDINS,3,4,5,9,1967,1969,2,No,0,0.08,0.41,0.33,486,148,-338,67,15,-52,1385.0,377.0,-1008.0,75600.0,0.0,-75600.0
<a href=/player/lundg101>lundg101</a>,Gordy Lund,Baltimore Orioles,ORLS,1,2,1,3,1969,1972,3,No,0,-0.94,-0.21,0.73,159,174,15,161,395,234,993.0,0.0,-993.0,0.0,0.0,0.0
<a href=/player/lundt101>lundt101</a>,Tom Lundstedt,Chicago Cubs,CUBS,1,1,1,2,1974,1978,4,No,0,-0.37,-0.22,0.15,18,27,9,32,40,8,0.0,0.0,0.0,0.0,0.0,0.0
<a href=/player/luplj001>luplj001</a>,Jordan Luplow,Pittsburgh Pirates,PIRATS,1,2,3,5,2018,2021,3,Yes,0,1.8,0.18,-1.62,170,174,4,509,578,69,0.0,0.0,0.0,0.0,0.0,0.0
<a href=/player/luplj001>luplj001</a>,Jordan Luplow,Cleveland Indians,INDINS,1,2,1,3,2021,2021,0,Yes,0,0.29,0.0,-0.29,29,0,-29,72,0,-72,11.0,0.0,-11.0,0.0,0.0,0.0
<a href=/player/luqud101>luqud101</a>,Dolf Luque,Cincinnati Reds,REDS,1,1,1,2,1930,1930,0,No,0,3.36,-0.24,-3.6,100,16,-84,123,8,-115,911.0,77.0,-834.0,0.0,0.0,0.0
<a href=/player/lushb101>lushb101</a>,Billy Lush,Detroit Tigers,TIGRS,1,1,2,3,1904,1910,6,No,0,2.88,22.67,19.79,138,462,324,580,681,101,0.0,5040.0,5040.0,0.0,0.0,0.0
<a href=/player/lushj101>lushj101</a>,Johnny Lush,Philadelphia Phillies,PHILS,14,28,31,59,1907,1931,24,No,0,118.02,97.66,-20.36,5707,5480,-227,17636,19732,2096,16115.0,6766.0,-9349.0,25000.0,0.0,-25000.0
<a href=/player/lutzj101>lutzj101</a>,Joe Lutz,St.Louis Browns,ORLS,24,54,49,103,1951,1994,43,No,3,84.08,155.15,71.07,5312,9145,3833,11244,26154,14910,18662.0,17928.0,-734.0,989433.0,0.0,-989433.0
<a href=/player/luulk001>luulk001</a>,Keith Luuloa,Anaheim Angels,ANGELS,1,2,3,5,2000,2000,0,No,0,0.0,0.0,0.0,0,0,0,0,0,0,0.0,0.0,0.0,0.0,0.0,0.0
<a href=/player/luzaj001>luzaj001</a>,Jesus Luzardo,Washington Nationals,NATEX,2,4,3,7,2017,2020,3,Yes,0,5.92,4.82,-1.1,246,410,164,62,3,-59,883.0,620.0,-263.0,8230366.0,0.0,-8230366.0
<a href=/player/luzaj001>luzaj001</a>,Jesus Luzardo,Oakland Athletics,ATLTCS,1,1,1,2,2021,2021,0,No,0,-0.51,1.92,2.43,23,56,33,19,251,232,172.0,0.0,-172.0,0.0,0.0,0.0
<a href=/player/lylej001>lylej001</a>,Jordan Lyles,Houston Astros,ASTROS,3,4,5,9,2013,2016,3,No,0,5.67,6.06,0.39,774,357,-417,2028,1370,-658,843.0,53.0,-790.0,491700.0,0.0,-491700.0
<a href=/player/lylej001>lylej001</a>,Jordan Lyles,Pittsburgh Pirates,PIRATS,1,1,1,2,2019,2019,0,Yes,0,1.85,0.0,-1.85,21,0,-21,22,0,-22,176.0,0.0,-176.0,2050000.0,0.0,-2050000.0
<a href=/player/lyles101>lyles101</a>,Sparky Lyle,Boston Red Sox,RSOX,3,3,4,7,1972,1978,6,No,0,14.95,3.84,-11.11,571,480,-91,261,1229,968,2237.0,606.0,-1631.0,0.0,0.0,0.0
<a href=/player/lyles101>lyles101</a>,Sparky Lyle,New York Yankees,YANKS,25,56,45,101,1978,2001,23,No,2,104.42,67.09,-37.33,6884,4113,-2771,17114,10039,-7075,21429.0,9704.0,-11725.0,5628333.0,0.0,-5628333.0
<a href=/player/lyles101>lyles101</a>,Sparky Lyle,Texas Rangers,RNGRS,2,2,2,4,1980,1983,3,No,0,1.64,1.16,-0.48,254,112,-142,10,293,283,645.0,0.0,-645.0,0.0,0.0,0.0
<a href=/player/lynce001>lynce001</a>,Ed Lynch,Texas Rangers,RNGRS,8,16,17,33,1979,1987,8,No,0,13.69,12.82,-0.87,1524,510,-1014,3006,820,-2186,5064.0,3278.0,-1786.0,1017500.0,0.0,-1017500.0
<a href=/player/lynce001>lynce001</a>,Ed Lynch,New York Mets,METS,1,1,2,3,1986,1990,4,No,0,1.13,0.08,-1.05,162,1,-161,51,1,-50,630.0,0.0,-630.0,530000.0,0.0,-530000.0
<a href=/player/lyncj102>lyncj102</a>,Jerry Lynch,Cincinnati Reds,REDS,2,2,3,5,1963,1964,1,No,0,0.52,0.45,-0.07,523,97,-426,1123,280,-843,0.0,0.0,0.0,26500.0,0.0,-26500.0
<a href=/player/lynnf001>lynnf001</a>,Fred Lynn,Boston Red Sox,RSOX,3,4,5,9,1981,1989,8,No,2,12.81,-0.08,-12.89,526,180,-346,1947,447,-1500,774.0,448.0,-326.0,0.0,0.0,0.0
<a href=/player/lynnf001>lynnf001</a>,Fred Lynn,Baltimore Orioles,ORLS,2,3,5,8,1988,1989,1,No,0,1.0,0.0,-1.0,152,0,-152,513,0,-513,0.0,0.0,0.0,1540000.0,0.0,-1540000.0
<a href=/player/lynnl001>lynnl001</a>,Lance Lynn,Minnesota Twins,TWINS,2,3,3,6,2018,2019,1,Yes,0,0.65,0.29,-0.36,82,37,-45,149,141,-8,163.0,0.0,-163.0,12000000.0,0.0,-12000000.0
<a href=/player/lynnl001>lynnl001</a>,Lance Lynn,Texas Rangers,RNGRS,1,1,2,3,2020,2020,0,Yes,0,5.38,0.0,-5.38,30,0,-30,5,0,-5,471.0,0.0,-471.0,11333334.0,0.0,-11333334.0
<a href=/player/lyona101>lyona101</a>,Al Lyons,Pittsburgh Pirates,PIRATS,2,5,3,8,1947,1949,2,No,0,5.52,3.82,-1.7,394,236,-158,1349,883,-466,38.0,0.0,-38.0,0.0,0.0,0.0
<a href=/player/lyona101>lyona101</a>,Al Lyons,Boston Braves,BRAVES,1,3,1,4,1948,1952,4,No,0,0.0,-0.21,-0.21,0,104,104,0,35,35,0.0,376.0,376.0,0.0,0.0,0.0
<a href=/player/lyonb003>lyonb003</a>,Brandon Lyon,Boston Red Sox,RSOX,3,9,6,15,2003,2008,5,No,0,19.22,17.72,-1.5,1732,227,-1505,2840,14,-2826,1848.0,2473.0,625.0,943500.0,0.0,-943500.0
<a href=/player/lyonb003>lyonb003</a>,Brandon Lyon,Pittsburgh Pirates,PIRATS,5,8,9,17,2003,2013,10,No,0,4.43,21.03,16.6,571,1401,830,955,4379,3424,773.0,467.0,-306.0,13800000.0,0.0,-13800000.0
<a href=/player/lyonb003>lyonb003</a>,Brandon Lyon,Boston Red Sox,RSOX,1,4,1,5,2003,2008,5,No,0,0.73,17.72,16.99,728,123,-605,51,11,-40,1381.0,2025.0,644.0,634000.0,0.0,-634000.0
<a href=/player/lyonb003>lyonb003</a>,Brandon Lyon,Houston Astros,ASTROS,4,10,10,20,2012,2019,7,No,0,17.22,11.07,-6.15,1238,246,-992,2359,341,-2018,4222.0,1816.0,-2406.0,8335000.0,0.0,-8335000.0
<a href=/player/lyonc001>lyonc001</a>,Curt Lyons,Cincinnati Reds,REDS,1,1,2,3,1997,1998,1,No,0,0.0,0.02,0.02,0,6,6,0,9,9,0.0,0.0,0.0,0.0,0.0,0.0
<a href=/player/lyong101>lyong101</a>,George Lyons,St.Louis Browns,ORLS,29,55,62,117,1924,1952,28,No,0,152.63,143.12,-9.51,7484,11236,3752,22593,31279,8686,18747.0,30694.0,11947.0,281100.0,0.0,-281100.0
<a href=/player/lyong101>lyong101</a>,George Lyons,St. Louis Cardinals,CARDS,1,3,1,4,1921,1921,0,No,0,0.0,0.87,0.87,0,76,76,0,77,77,0.0,625.0,625.0,0.0,0.0,0.0
<a href=/player/lyons001>lyons001</a>,Steve Lyons,Boston Red Sox,RSOX,1,1,1,2,1986,1986,0,No,0,1.71,1.94,0.23,498,16,-482,1529,0,-1529,6.0,313.0,307.0,0.0,0.0,0.0
<a href=/player/lysar001>lysar001</a>,Rick Lysander,Oakland Athletics,ATLTCS,1,1,1,2,1981,1983,2,No,0,0.0,0.27,0.27,0,76,76,0,157,157,0.0,0.0,0.0,0.0,0.0,0.0
<a href=/player/lysar001>lysar001</a>,Rick Lysander,Houston Astros,ASTROS,1,1,1,2,1983,1983,0,No,0,0.29,0.0,-0.29,132,0,-132,0,0,0,728.0,0.0,-728.0,0.0,0.0,0.0
<a href=/player/lyttj101>lyttj101</a>,Jim Lyttle,New York Yankees,YANKS,1,1,1,2,1971,1972,1,No,0,-0.55,-0.52,0.03,44,14,-30,84,3,-81,0.0,50.0,50.0,16000.0,0.0,-16000.0
<a href=/player/lyttj101>lyttj101</a>,Jim Lyttle,Chicago White Sox,WSOX,1,1,1,2,1973,1973,0,No,0,0.0,0.0,0.0,0,5,5,0,1,1,0.0,0.0,0.0,0.0,0.0,0.0
<a href=/player/maasd101>maasd101</a>,Duke Maas,Detroit Tigers,TIGRS,4,12,12,24,1957,1964,7,No,0,6.47,14.38,7.91,1197,947,-250,3186,1303,-1883,1459.0,3692.0,2233.0,20000.0,0.0,-20000.0
<a href=/player/maasd101>maasd101</a>,Duke Maas,Kansas City Athletics,ATLTCS,3,4,4,8,1958,1960,2,No,0,-3.45,4.79,8.24,286,319,33,181,498,317,1056.0,779.0,-277.0,12500.0,0.0,-12500.0
<a href=/player/maasd101>maasd101</a>,Duke Maas,Los Angeles Angels,ANGELS,1,1,1,2,1961,1961,0,No,0,-0.14,-0.79,-0.65,2,21,19,0,55,55,1.0,0.0,-1.0,0.0,0.0,0.0
<a href=/player/mabeb101>mabeb101</a>,Bob Mabe,St. Louis Cardinals,CARDS,2,5,5,10,1958,1963,5,No,0,8.1,2.95,-5.15,969,458,-511,3320,993,-2327,89.0,111.0,22.0,0.0,0.0,0.0
<a href=/player/mabrj001>mabrj001</a>,John Mabry,Seattle Mariners,MARNRS,1,2,1,3,2000,2001,1,No,0,0.34,1.23,0.89,184,142,-42,130,469,339,215.0,0.0,-215.0,1850000.0,0.0,-1850000.0
<a href=/player/mabrj001>mabrj001</a>,John Mabry,Philadelphia Phillies,PHILS,3,4,4,8,2002,2004,2,No,0,2.03,1.6,-0.43,204,147,-57,454,214,-240,206.0,112.0,-94.0,500000.0,0.0,-500000.0
<a href=/player/macdh101>macdh101</a>,Harvey MacDonald,Philadelphia Phillies,PHILS,6,11,11,22,1928,1941,13,No,0,5.03,58.02,52.99,553,1939,1386,2026,6396,4370,324.0,2895.0,2571.0,19900.0,0.0,-19900.0
<a href=/player/macdm001>macdm001</a>,Mike MacDougal,Kansas City Royals,ROYALS,6,12,12,24,2006,2021,15,Yes,0,13.66,47.45,33.79,983,2988,2005,2084,10524,8440,3468.0,2429.0,-1039.0,27030000.0,0.0,-27030000.0
<a href=/player/macfd101>macfd101</a>,Danny MacFayden,Boston Red Sox,RSOX,10,23,20,43,1932,1956,24,No,0,31.6,39.08,7.48,3187,3307,120,9337,10076,739,7417.0,8024.0,607.0,183500.0,0.0,-183500.0
<a href=/player/macfd101>macfd101</a>,Danny MacFayden,Boston Braves,BRAVES,1,1,2,3,1939,1940,1,No,0,0.77,-0.39,-1.16,70,8,-62,29,3,-26,274.0,28.0,-246.0,10000.0,0.0,-10000.0
<a href=/player/macfm001>macfm001</a>,Mike Macfarlane,Kansas City Royals,ROYALS,1,1,2,3,1998,1998,0,No,0,0.52,0.37,-0.15,159,66,-93,474,229,-245,0.0,0.0,0.0,725000.0,0.0,-725000.0
<a href=/player/macha001>macha001</a>,Anderson Machado,Philadelphia Phillies,PHILS,1,2,2,4,2004,2004,0,No,0,0.46,-0.03,-0.49,65,53,-12,87,1,-86,206.0,76.0,-130.0,0.0,0.0,0.0
<a href=/player/macha002>macha002</a>,Alejandro Machado,Atlanta Braves,BRAVES,1,2,1,3,2001,2001,0,No,0,-0.65,0.03,0.68,44,49,5,1,163,162,205.0,0.0,-205.0,0.0,0.0,0.0
<a href=/player/macha002>macha002</a>,Alejandro Machado,Kansas City Royals,ROYALS,1,2,1,3,2003,2004,1,No,0,0.42,0.53,0.11,118,46,-72,83,0,-83,746.0,125.0,-621.0,0.0,0.0,0.0
<a href=/player/macha002>macha002</a>,Alejandro Machado,Washington Nationals,NATEX,1,1,1,2,2005,2005,0,No,0,0.23,0.0,-0.23,10,0,-10,6,0,-6,0.0,0.0,0.0,0.0,0.0,0.0
<a href=/player/machd101>machd101</a>,Dave Machemer,California Angels,ANGELS,2,4,2,6,1976,1979,3,No,0,0.01,3.49,3.48,36,153,117,0,0,0,119.0,938.0,819.0,0.0,0.0,0.0
<a href=/player/machd101>machd101</a>,Dave Machemer,Boston Red Sox,RSOX,1,1,1,2,1977,1977,0,No,0,0.11,0.0,-0.11,10,0,-10,25,0,-25,0.0,0.0,0.0,0.0,0.0,0.0
<a href=/player/machj001>machj001</a>,Julio Machado,New York Mets,METS,2,3,3,6,1990,2008,18,No,1,2.61,2.24,-0.37,84,232,148,0,659,659,559.0,0.0,-559.0,200000.0,0.0,-200000.0
<a href=/player/machm001>machm001</a>,Manny Machado,Baltimore Orioles,ORLS,1,1,5,6,2018,2020,2,Yes,0,2.49,0.11,-2.38,66,12,-54,296,41,-255,0.0,0.0,0.0,16000000.0,0.0,-16000000.0
<a href=/player/machr001>machr001</a>,Robert Machado,Chicago Cubs,CUBS,1,1,1,2,2002,2002,0,No,0,0.1,0.0,-0.1,51,0,-51,169,0,-169,0.0,0.0,0.0,277500.0,0.0,-277500.0
<a href=/player/macij001>macij001</a>,Jose Macias,Detroit Tigers,TIGRS,1,1,1,2,2002,2002,0,No,0,-0.82,-1.4,-0.58,201,89,-112,540,292,-248,0.0,0.0,0.0,375000.0,0.0,-375000.0
<a href=/player/macij001>macij001</a>,Jose Macias,Montreal Expos,NATEX,1,1,1,2,2003,2003,0,No,0,-0.64,0.0,0.64,210,0,-210,394,0,-394,0.0,0.0,0.0,825000.0,0.0,-825000.0
<a href=/player/mackj101>mackj101</a>,Joe Mack,St. Louis Cardinals,CARDS,1,1,1,2,1944,1944,0,No,0,-0.32,0.0,0.32,66,0,-66,303,0,-303,0.0,0.0,0.0,0.0,0.0,0.0
<a href=/player/mackj101>mackj101</a>,Joe Mack,Toronto,Toronto,1,2,1,3,1942,1943,1,No,0,0.32,0.0,-0.32,4,0,-4,2,0,-2,21.0,0.0,-21.0,0.0,0.0,0.0
<a href=/player/mackk101>mackk101</a>,Ken MacKenzie,New York Mets,METS,1,1,1,2,1963,1963,0,No,0,-0.17,-0.07,0.1,16,18,2,0,3,3,26.0,57.0,31.0,0.0,0.0,0.0
<a href=/player/mackk101>mackk101</a>,Ken MacKenzie,St. Louis Cardinals,CARDS,13,26,21,47,1963,1972,9,No,0,30.59,2.13,-28.46,3317,763,-2554,8519,1730,-6789,1892.0,703.0,-1189.0,32500.0,0.0,-32500.0
<a href=/player/mackp101>mackp101</a>,Pete Mackanin,Texas Rangers,RNGRS,2,3,3,6,1974,1976,2,No,0,4.6,-0.5,-5.1,567,57,-510,1479,176,-1303,1066.0,63.0,-1003.0,14000.0,0.0,-14000.0
<a href=/player/mackp101>mackp101</a>,Pete Mackanin,Philadelphia Phillies,PHILS,1,1,1,2,1979,1979,0,No,0,-0.3,0.0,0.3,185,0,-185,579,0,-579,0.0,0.0,0.0,0.0,0.0,0.0
<a href=/player/mackr001>mackr001</a>,Rob Mackowiak,Pittsburgh Pirates,PIRATS,3,4,7,11,2005,2016,11,No,0,1.61,9.69,8.08,343,1504,1161,834,2178,1344,148.0,3661.0,3513.0,11000000.0,0.0,-11000000.0
<a href=/player/mackr001>mackr001</a>,Rob Mackowiak,Chicago White Sox,WSOX,2,3,2,5,2007,2011,4,No,0,-1.19,-0.64,0.55,95,318,223,97,1445,1348,372.0,0.0,-372.0,2750000.0,0.0,-2750000.0
<a href=/player/mackr101>mackr101</a>,Ray Mack,Cleveland Indians,INDINS,3,5,5,10,1946,1955,9,No,0,0.0,7.38,7.38,349,809,460,998,1967,969,633.0,1677.0,1044.0,0.0,0.0,0.0
<a href=/player/macks001>macks001</a>,Shane Mack,Oakland Athletics,ATLTCS,1,2,1,3,1998,1999,1,No,0,0.37,0.52,0.15,66,159,93,229,474,245,0.0,0.0,0.0,450000.0,0.0,-450000.0
<a href=/player/macle001>macle001</a>,Evan MacLane,New York Mets,METS,1,1,2,3,2006,2007,1,No,0,0.0,0.23,0.23,0,164,164,0,617,617,0.0,0.0,0.0,0.0,0.0,0.0
<a href=/player/macrm001>macrm001</a>,Matt Macri,Colorado Rockies,ROCKS,1,1,1,2,2007,2007,0,No,0,-0.07,-0.05,0.02,18,20,2,36,2,-34,0.0,39.0,39.0,0.0,0.0,0.0
<a href=/player/maddc101>maddc101</a>,Clarence Maddern,Chicago Cubs,CUBS,1,1,1,2,1951,1951,0,No,0,-0.14,0.0,0.14,11,0,-11,12,0,-12,0.0,0.0,0.0,0.0,0.0,0.0
<a href=/player/maddc101>maddc101</a>,Clarence Maddern,Cleveland Indians,INDINS,1,1,1,2,1951,1951,0,No,0,0.0,0.0,0.0,0,0,0,0,0,0,0.0,0.0,0.0,0.0,0.0,0.0
<a href=/player/madde101>madde101</a>,Elliott Maddox,Detroit Tigers,TIGRS,3,8,7,15,1970,1979,9,No,0,1.68,25.88,24.2,545,2212,1667,1182,7310,6128,747.0,4256.0,3509.0,232600.0,0.0,-232600.0
<a href=/player/madde101>madde101</a>,Elliott Maddox,New York Yankees,YANKS,1,2,1,3,1977,1979,2,No,0,0.81,-0.33,-1.14,49,160,111,128,324,196,0.0,0.0,0.0,0.0,0.0,0.0
<a href=/player/maddg001>maddg001</a>,Garry Maddox,San Francisco Giants,GIANTS,6,11,9,20,1975,1995,20,No,1,43.06,27.92,-15.14,2695,2237,-458,8595,7480,-1115,4215.0,726.0,-3489.0,1545000.0,0.0,-1545000.0
<a href=/player/maddg002>maddg002</a>,Greg Maddux,Chicago Cubs,CUBS,1,1,1,2,2006,2007,1,No,0,1.68,-0.81,-2.49,38,87,49,42,286,244,343.0,0.0,-343.0,9000000.0,0.0,-9000000.0
<a href=/player/maddg002>maddg002</a>,Greg Maddux,San Diego Padres,PADRS,1,1,2,3,2008,2008,0,No,0,-0.25,0.0,0.25,14,0,-14,13,0,-13,122.0,0.0,-122.0,10000000.0,0.0,-10000000.0
<a href=/player/maddm001>maddm001</a>,Mike Madden,Milwaukee Brewers,BREWRS,2,5,4,9,1982,1986,4,No,0,18.77,6.8,-11.97,1695,100,-1595,3977,0,-3977,2039.0,1974.0,-65.0,625000.0,0.0,-625000.0
<a href=/player/maddm002>maddm002</a>,Mike Maddux,San Diego Padres,PADRS,2,2,3,5,1992,1995,3,No,0,0.3,2.43,2.13,250,204,-46,9,12,3,532.0,427.0,-105.0,810000.0,0.0,-810000.0
<a href=/player/maddm003>maddm003</a>,Morris Madden,Detroit Tigers,TIGRS,1,2,1,3,1987,1988,1,No,0,0.01,-0.36,-0.37,138,58,-80,389,196,-193,59.0,0.0,-59.0,170000.0,0.0,-170000.0
<a href=/player/madel001>madel001</a>,Luis Madero,Arizona Diamondbacks,DBACKS,1,1,1,2,2017,2017,0,No,0,0.0,0.04,0.04,0,48,48,0,0,0,0.0,56.0,56.0,0.0,0.0,0.0
<a href=/player/madia101>madia101</a>,Art Madison,Pittsburgh Pirates,PIRATS,4,11,16,27,1899,1914,15,No,0,23.91,73.99,50.08,1271,3182,1911,4723,12859,8136,1693.0,797.0,-896.0,5000.0,0.0,-5000.0
<a href=/player/madid101>madid101</a>,Dave Madison,St.Louis Browns,ORLS,8,14,16,30,1952,1960,8,No,0,32.49,23.42,-9.07,2082,1835,-247,5453,4904,-549,5614.0,2626.0,-2988.0,41000.0,0.0,-41000.0
<a href=/player/madis001>madis001</a>,Scotti Madison,Minnesota Twins,TWINS,1,2,2,4,1982,1984,2,No,0,0.0,5.34,5.34,0,201,201,0,513,513,0.0,1207.0,1207.0,0.0,0.0,0.0
<a href=/player/madlb001>madlb001</a>,Bill Madlock,Texas Rangers,RNGRS,11,22,20,42,1973,1992,19,No,2,53.55,27.73,-25.82,2537,1445,-1092,5090,3743,-1347,9799.0,4143.0,-5656.0,214000.0,0.0,-214000.0
<a href=/player/madlb001>madlb001</a>,Bill Madlock,Chicago Cubs,CUBS,3,6,5,11,1977,1982,5,No,0,6.0,5.18,-0.82,669,907,238,2312,3575,1263,152.0,0.0,-152.0,320000.0,0.0,-320000.0
<a href=/player/madlb001>madlb001</a>,Bill Madlock,San Francisco Giants,GIANTS,13,25,28,53,1979,1998,19,No,2,47.4,67.93,20.53,2735,4727,1992,5444,6225,781,5201.0,15628.0,10427.0,10639278.0,0.0,-10639278.0
<a href=/player/madlb001>madlb001</a>,Bill Madlock,Pittsburgh Pirates,PIRATS,2,2,4,6,1985,1990,5,No,1,2.02,14.19,12.17,166,1259,1093,618,4250,3632,0.0,0.0,0.0,975500.0,0.0,-975500.0
<a href=/player/madra001>madra001</a>,Alex Madrid,Milwaukee Brewers,BREWRS,1,1,1,2,1988,1989,1,No,0,0.25,-0.38,-0.63,22,8,-14,10,18,8,123.0,0.0,-123.0,0.0,0.0,0.0
<a href=/player/madrn001>madrn001</a>,Nick Madrigal,Chicago White Sox,WSOX,1,2,1,3,2021,2021,0,Yes,0,0.52,-0.03,-0.55,48,26,-22,0,0,0,86.0,69.0,-17.0,0.0,0.0,0.0
<a href=/player/madsr001>madsr001</a>,Ryan Madson,Oakland Athletics,ATLTCS,3,5,6,11,2017,2021,4,Yes,0,3.83,7.65,3.82,466,297,-169,88,313,225,792.0,885.0,93.0,0.0,0.0,0.0
<a href=/player/madsr001>madsr001</a>,Ryan Madson,Washington Nationals,NATEX,1,1,1,2,2018,2018,0,Yes,0,-0.19,0.0,0.19,18,0,-18,0,0,0,25.0,0.0,-25.0,7666666.0,0.0,-7666666.0
<a href=/player/maduc001>maduc001</a>,Calvin Maduro,Baltimore Orioles,ORLS,1,2,2,4,1996,1997,1,No,0,0.34,0.44,0.1,89,89,0,71,320,249,679.0,0.0,-679.0,0.0,0.0,0.0
<a href=/player/maedk001>maedk001</a>,Kenta Maeda,Los Angeles Dodgers,DOGRS,1,3,3,6,2020,2020,0,Yes,0,1.94,0.24,-1.7,36,23,-13,4,0,-4,519.0,70.0,-449.0,0.0,0.0,0.0
<a href=/player/magad001>magad001</a>,Dave Magadan,Florida Marlins,MARLNS,2,3,3,6,1993,1994,1,No,0,-0.22,1.85,2.07,73,194,121,269,671,402,12.0,0.0,-12.0,900000.0,0.0,-900000.0
<a href=/player/magad001>magad001</a>,Dave Magadan,Seattle Mariners,MARNRS,2,2,3,5,1993,1995,2,No,0,2.39,0.2,-2.19,178,35,-143,529,88,-441,133.0,12.0,-121.0,0.0,0.0,0.0
<a href=/player/magel101>magel101</a>,Lee Magee,New York Yankees,YANKS,1,1,1,2,1917,1917,0,No,0,-0.31,0.29,0.6,36,25,-11,127,100,-27,0.0,0.0,0.0,8333.0,0.0,-8333.0
<a href=/player/magel101>magel101</a>,Lee Magee,St.Louis Browns,ORLS,1,1,1,2,1918,1919,1,No,0,2.92,1.37,-1.55,119,88,-31,514,268,-246,0.0,0.0,0.0,0.0,0.0,0.0
<a href=/player/magel101>magel101</a>,Lee Magee,Brooklyn Dodgers,DOGRS,1,1,1,2,1919,1919,0,No,0,1.59,0.49,-1.1,79,32,-47,299,89,-210,0.0,0.0,0.0,0.0,0.0,0.0
<a href=/player/mages101>mages101</a>,Sherry Magee,Philadelphia Phillies,PHILS,4,6,8,14,1914,1923,9,No,0,18.25,3.64,-14.61,978,1038,60,3812,3992,180,0.0,0.0,0.0,14500.0,0.0,-14500.0
<a href=/player/magew001>magew001</a>,Wendell Magee,Philadelphia Phillies,PHILS,2,2,2,4,2000,2001,1,No,0,1.58,0.0,-1.58,278,0,-278,795,0,-795,0.0,0.0,0.0,0.0,0.0,0.0
<a href=/player/magew001>magew001</a>,Wendell Magee,Cleveland Indians,INDINS,2,2,2,4,2003,2003,0,No,0,0.0,0.0,0.0,0,0,0,0,0,0,0.0,0.0,0.0,0.0,0.0,0.0
<a href=/player/magim001>magim001</a>,Matt Magill,Los Angeles Dodgers,DOGRS,1,1,1,2,2014,2015,1,No,0,-0.02,0.21,0.23,10,33,23,0,72,72,13.0,0.0,-13.0,0.0,0.0,0.0
<a href=/player/magnd001>magnd001</a>,Damien Magnifico,Milwaukee Brewers,BREWRS,1,1,1,2,2017,2017,0,No,0,0.0,0.0,0.0,0,0,0,0,0,0,0.0,0.0,0.0,0.0,0.0,0.0
<a href=/player/magnd001>magnd001</a>,Damien Magnifico,Baltimore Orioles,ORLS,1,1,1,2,2017,2017,0,Yes,0,0.01,0.0,-0.01,1,0,-1,0,0,0,1.0,0.0,-1.0,0.0,0.0,0.0
<a href=/player/magnt001>magnt001</a>,Trystan Magnuson,Toronto Blue Jays,BJAYS,1,2,1,3,2010,2013,3,No,0,-0.15,1.6,1.75,9,345,336,0,1185,1185,44.0,0.0,-44.0,0.0,0.0,0.0
<a href=/player/magog101>magog101</a>,George Magoon,Brooklyn Dodgers,DOGRS,2,4,2,6,1899,1902,3,No,0,3.35,2.49,-0.86,192,219,27,742,830,88,0.0,0.0,0.0,0.0,0.0,0.0
<a href=/player/magog101>magog101</a>,George Magoon,Baltimore Orioles,BLN,2,3,2,5,1899,1906,7,No,0,0.15,0.95,0.8,146,62,-84,513,265,-248,204.0,0.0,-204.0,0.0,0.0,0.0
<a href=/player/magog101>magog101</a>,George Magoon,Cincinnati Reds,REDS,1,1,2,3,1903,1905,2,No,0,-0.01,1.3,1.31,94,324,230,382,1382,1000,0.0,0.0,0.0,0.0,0.0,0.0
<a href=/player/magog101>magog101</a>,George Magoon,Chicago White Sox,WSOX,1,1,1,2,1904,1905,1,No,0,0.0,-0.01,-0.01,0,4,4,0,12,12,0.0,0.0,0.0,0.0,0.0,0.0
<a href=/player/magrc001>magrc001</a>,Chris Magruder,San Francisco Giants,GIANTS,1,3,1,4,2001,2001,0,No,0,1.58,0.17,-1.41,103,49,-54,31,174,143,323.0,0.0,-323.0,0.0,0.0,0.0
<a href=/player/magrc001>magrc001</a>,Chris Magruder,Texas Rangers,RNGRS,1,1,1,2,2002,2002,0,No,0,-0.08,0.0,0.08,96,0,-96,308,0,-308,0.0,0.0,0.0,0.0,0.0,0.0
<a href=/player/magrp101>magrp101</a>,Pete Magrini,Boston Red Sox,RSOX,1,2,1,3,1967,1968,1,No,0,2.06,-0.63,-2.69,128,113,-15,32,358,326,431.0,0.0,-431.0,0.0,0.0,0.0
<a href=/player/magrt001>magrt001</a>,Tom Magrann,Baltimore Orioles,ORLS,1,2,2,4,1988,1988,0,No,0,-0.33,0.0,0.33,9,0,-9,10,0,-10,0.0,0.0,0.0,0.0,0.0,0.0
<a href=/player/maguf101>maguf101</a>,Freddie Maguire,Chicago Cubs,CUBS,1,6,1,7,1928,1932,4,No,0,4.13,16.12,11.99,1036,317,-719,2232,1321,-911,4216.0,0.0,-4216.0,13000.0,0.0,-13000.0
<a href=/player/maguj101>maguj101</a>,Jack Maguire,St.Louis Browns,ORLS,2,5,3,8,1951,1952,1,No,0,0.64,0.33,-0.31,156,96,-60,332,319,-13,0.0,0.0,0.0,0.0,0.0,0.0
<a href=/player/mahaa102>mahaa102</a>,Art Mahaffey,Philadelphia Phillies,PHILS,9,17,16,33,1965,1984,19,No,0,32.54,23.78,-8.76,2044,2671,627,6114,5833,-281,1729.0,2166.0,437.0,32000.0,0.0,-32000.0
<a href=/player/mahaa102>mahaa102</a>,Art Mahaffey,St. Louis Cardinals,CARDS,1,3,3,6,1967,1967,0,No,0,-0.52,-0.9,-0.38,197,52,-145,651,76,-575,0.0,0.0,0.0,0.0,0.0,0.0
<a href=/player/mahar001>mahar001</a>,Ron Mahay,Texas Rangers,RNGRS,8,20,28,48,2007,2021,14,Yes,0,23.19,61.95,38.76,1540,2663,1123,4320,8186,3866,2620.0,5087.0,2467.0,14431080.0,0.0,-14431080.0
<a href=/player/mahar101>mahar101</a>,Roy Mahaffey,St.Louis Browns,ORLS,1,2,1,3,1937,1937,0,No,0,0.0,-0.76,-0.76,0,52,52,0,35,35,0.0,317.0,317.0,0.0,0.0,0.0
<a href=/player/mahar101>mahar101</a>,Roy Mahaffey,Portland,Portland,1,2,4,6,1929,1933,4,No,0,5.27,0.0,-5.27,394,0,-394,395,0,-395,2946.0,0.0,-2946.0,0.0,0.0,0.0
<a href=/player/mahlg101>mahlg101</a>,Greg Mahlberg,Texas Rangers,RNGRS,1,2,2,4,1980,1983,3,No,0,0.0,-0.43,-0.43,0,24,24,0,73,73,0.0,0.0,0.0,0.0,0.0,0.0
<a href=/player/mahlm001>mahlm001</a>,Mickey Mahler,Pittsburgh Pirates,PIRATS,2,3,3,6,1981,1986,5,No,0,0.66,9.75,9.09,117,671,554,351,2696,2345,43.0,0.0,-43.0,0.0,0.0,0.0
<a href=/player/mahlm001>mahlm001</a>,Mickey Mahler,St. Louis Cardinals,CARDS,1,1,1,2,1985,1988,3,No,0,0.28,0.03,-0.25,18,166,148,17,217,200,145.0,0.0,-145.0,0.0,0.0,0.0
<a href=/player/mahob101>mahob101</a>,Bob Mahoney,St.Louis Browns,ORLS,22,50,44,94,1952,1994,42,No,3,83.66,149.23,65.57,4979,8789,3810,10385,25784,15399,18519.0,15968.0,-2551.0,970833.0,0.0,-970833.0
<a href=/player/mahoj101>mahoj101</a>,Jim Mahoney,Los Angeles Angels,ANGELS,1,1,1,2,1960,1960,0,No,0,-0.37,0.0,0.37,43,0,-43,114,0,-114,0.0,0.0,0.0,0.0,0.0,0.0
<a href=/player/mahoj101>mahoj101</a>,Jim Mahoney,Washington Senators,RNGRS,4,7,5,12,1961,1970,9,No,0,4.25,0.29,-3.96,404,337,-67,701,1154,453,1913.0,6.0,-1907.0,0.0,0.0,0.0
<a href=/player/mahoj101>mahoj101</a>,Jim Mahoney,Houston Astros,ASTROS,1,2,1,3,1966,1966,0,No,0,0.0,-0.43,-0.43,0,21,21,0,38,38,0.0,0.0,0.0,0.0,0.0,0.0
<a href=/player/mahop001>mahop001</a>,Pat Mahomes,Minnesota Twins,TWINS,1,1,1,2,1996,1996,0,No,0,-0.22,0.0,0.22,21,0,-21,0,0,0,67.0,0.0,-67.0,202500.0,0.0,-202500.0
<a href=/player/mahop002>mahop002</a>,Paul Maholm,Chicago Cubs,CUBS,3,5,4,9,2012,2018,6,Yes,0,5.31,1.57,-3.74,650,341,-309,761,587,-174,1181.0,55.0,-1126.0,2100000.0,0.0,-2100000.0
<a href=/player/mahtm001>mahtm001</a>,Mikie Mahtook,Tampa Bay Devil Rays,RAYS,2,2,2,4,2017,2017,0,No,0,1.23,0.13,-1.1,304,52,-252,655,200,-455,229.0,0.0,-229.0,0.0,0.0,0.0
<a href=/player/mailw101>mailw101</a>,Duster Mails,Sacramento,Sacramento,1,1,3,4,1920,1920,0,No,0,4.21,0.0,-4.21,138,0,-138,140,0,-140,1087.0,0.0,-1087.0,0.0,0.0,0.0
<a href=/player/mailw101>mailw101</a>,Duster Mails,Oakland,Oakland,1,1,5,6,1924,1927,3,No,0,0.2,0.0,-0.2,44,0,-44,50,0,-50,396.0,0.0,-396.0,0.0,0.0,0.0
<a href=/player/mainj001>mainj001</a>,John Maine,Baltimore Orioles,ORLS,1,2,1,3,2006,2007,1,No,0,4.49,1.83,-2.66,234,33,-201,209,9,-200,1690.0,549.0,-1141.0,0.0,0.0,0.0
<a href=/player/mains001>mains001</a>,Scott Maine,Arizona Diamondbacks,DBACKS,1,2,1,3,2009,2011,2,No,0,-0.04,-1.17,-1.13,79,197,118,2,2,0,122.0,322.0,200.0,0.0,0.0,0.0
<a href=/player/mairo001>mairo001</a>,Oswaldo Mairena,New York Yankees,YANKS,5,7,6,13,2000,2007,7,No,0,-0.77,1.65,2.42,50,219,169,84,143,59,190.0,789.0,599.0,6000000.0,0.0,-6000000.0
<a href=/player/mairo001>mairo001</a>,Oswaldo Mairena,Chicago Cubs,CUBS,2,3,2,5,2001,2002,1,No,0,-0.69,3.07,3.76,85,229,144,73,800,727,101.0,68.0,-33.0,665000.0,0.0,-665000.0
<a href=/player/maisf101>maisf101</a>,Fritz Maisel,New York Yankees,YANKS,5,14,12,26,1918,1931,13,No,0,64.97,61.9,-3.07,2396,2093,-303,7435,5797,-1638,6303.0,6917.0,614.0,44500.0,0.0,-44500.0
<a href=/player/maisf101>maisf101</a>,Fritz Maisel,Baltimore,Baltimore,1,1,3,4,1913,1914,1,No,0,7.77,0.0,-7.77,502,0,-502,2095,0,-2095,0.0,0.0,0.0,0.0,0.0,0.0
<a href=/player/majeg001>majeg001</a>,Gary Majewski,Chicago White Sox,WSOX,5,12,8,20,2001,2010,9,No,2,-3.34,5.43,8.77,321,208,-113,107,7,-100,601.0,1212.0,611.0,0.0,0.0,0.0
<a href=/player/majeg001>majeg001</a>,Gary Majewski,Los Angeles Dodgers,DOGRS,1,3,2,5,2001,2001,0,No,0,0.0,0.96,0.96,0,24,24,0,27,27,0.0,238.0,238.0,0.0,0.0,0.0
<a href=/player/majeg001>majeg001</a>,Gary Majewski,Chicago White Sox,WSOX,1,2,1,3,2004,2005,1,No,0,7.36,0.15,-7.21,749,178,-571,35,716,681,1328.0,0.0,-1328.0,0.0,0.0,0.0
<a href=/player/majeg001>majeg001</a>,Gary Majewski,Washington Nationals,NATEX,1,5,3,8,2006,2009,3,No,0,-0.61,0.43,1.04,705,795,90,181,2860,2679,809.0,139.0,-670.0,1352000.0,0.0,-1352000.0
<a href=/player/majeh101>majeh101</a>,Hank Majeski,Philadelphia Athletics,ATLTCS,1,1,1,2,1949,1950,1,No,0,1.96,-0.18,-2.14,134,10,-124,503,1,-502,0.0,17.0,17.0,0.0,0.0,0.0
<a href=/player/majeh101>majeh101</a>,Hank Majeski,Chicago White Sox,WSOX,28,54,45,99,1951,1969,18,No,0,86.15,62.63,-23.52,7059,5271,-1788,17933,11733,-6200,13187.0,9922.0,-3265.0,288750.0,0.0,-288750.0
<a href=/player/majeh101>majeh101</a>,Hank Majeski,Cleveland Indians,INDINS,1,1,1,2,1955,1957,2,No,0,-0.41,0.18,0.59,16,19,3,43,47,4,0.0,0.0,0.0,0.0,0.0,0.0
<a href=/player/maksm001>maksm001</a>,Mike Maksudian,Chicago White Sox,WSOX,1,2,2,4,1988,1989,1,No,0,0.0,0.5,0.5,0,6,6,0,0,0,0.0,39.0,39.0,0.0,0.0,0.0
<a href=/player/maldc001>maldc001</a>,Candy Maldonado,Los Angeles Dodgers,DOGRS,1,1,1,2,1985,1988,3,No,0,4.89,1.71,-3.18,522,161,-361,1862,389,-1473,0.0,0.0,0.0,140000.0,0.0,-140000.0
<a href=/player/maldc001>maldc001</a>,Candy Maldonado,Milwaukee Brewers,BREWRS,1,1,2,3,1991,1993,2,No,0,3.82,-0.04,-3.86,250,33,-217,958,34,-924,0.0,0.0,0.0,875000.0,0.0,-875000.0
<a href=/player/maldc001>maldc001</a>,Candy Maldonado,Chicago Cubs,CUBS,1,1,1,2,1993,1995,2,No,0,-0.34,2.54,2.88,70,120,50,205,392,187,0.0,0.0,0.0,1650000.0,0.0,-1650000.0
<a href=/player/maldc002>maldc002</a>,Carlos Maldonado,Kansas City Royals,ROYALS,1,1,1,2,1992,1992,0,No,0,0.08,0.0,-0.08,30,0,-30,0,0,0,112.0,0.0,-112.0,0.0,0.0,0.0
<a href=/player/maldc003>maldc003</a>,Carlos Maldonado,Seattle Mariners,MARNRS,1,1,1,2,2000,2000,0,No,0,0.0,-0.12,-0.12,0,2,2,0,1,1,0.0,0.0,0.0,0.0,0.0,0.0
<a href=/player/maldm001>maldm001</a>,Martin Maldonado,Milwaukee Brewers,BREWRS,1,2,1,3,2016,2018,2,No,0,1.97,-1.05,-3.02,216,84,-132,761,259,-502,0.0,0.0,0.0,1125000.0,0.0,-1125000.0
<a href=/player/maldm001>maldm001</a>,Martin Maldonado,Anaheim Angels,ANGELS,1,1,2,3,2018,2018,0,Yes,0,1.45,0.0,-1.45,240,0,-240,803,0,-803,0.0,0.0,0.0,3900000.0,0.0,-3900000.0
<a href=/player/maldm001>maldm001</a>,Martin Maldonado,Kansas City Royals,ROYALS,1,1,1,2,2019,2020,1,No,0,-0.37,0.41,0.78,4,17,13,13,1,-12,0.0,208.0,208.0,2500000.0,0.0,-2500000.0
<a href=/player/maldm001>maldm001</a>,Martin Maldonado,Chicago Cubs,CUBS,2,2,2,4,2019,2020,1,Yes,0,4.51,-0.1,-4.61,379,44,-335,1200,93,-1107,0.0,0.0,0.0,0.0,0.0,0.0
<a href=/player/malej101>malej101</a>,Jim Maler,Seattle Mariners,MARNRS,1,1,1,2,1984,1984,0,No,0,0.0,0.0,0.0,0,0,0,0,0,0,0.0,0.0,0.0,0.0,0.0,0.0
<a href=/player/mallb002>mallb002</a>,Brian Mallette,Milwaukee Brewers,BREWRS,8,15,17,32,2002,2012,10,No,2,36.64,23.05,-13.59,2498,2040,-458,9346,4727,-4619,883.0,6494.0,5611.0,10372000.0,0.0,-10372000.0
<a href=/player/malls101>malls101</a>,Sheldon Mallory,Kansas City Royals,ROYALS,1,1,1,2,1976,1980,4,No,0,0.0,0.79,0.79,0,452,452,0,1214,1214,0.0,0.0,0.0,0.0,0.0,0.0
<a href=/player/malls101>malls101</a>,Sheldon Mallory,Oakland Athletics,ATLTCS,1,1,1,2,1978,1978,0,No,0,0.0,0.7,0.7,0,47,47,0,97,97,0.0,0.0,0.0,0.0,0.0,0.0
<a href=/player/malls101>malls101</a>,Sheldon Mallory,Toronto Blue Jays,BJAYS,1,1,1,2,1979,1979,0,No,0,0.0,-0.32,-0.32,0,42,42,0,0,0,0.0,273.0,273.0,0.0,0.0,0.0
<a href=/player/malob101>malob101</a>,Billy Maloney,Chicago Cubs,CUBS,1,5,1,6,1905,1913,8,No,0,5.14,19.07,13.93,814,1001,187,3290,4393,1103,0.0,0.0,0.0,0.0,0.0,0.0
<a href=/player/maloe101>maloe101</a>,Eddie Malone,St. Louis Cardinals,CARDS,1,1,1,2,1947,1947,0,No,0,0.0,0.0,0.0,0,0,0,0,0,0,0.0,0.0,0.0,0.0,0.0,0.0
<a href=/player/maloe101>maloe101</a>,Eddie Malone,New York Yankees,YANKS,11,30,24,54,1950,1970,20,No,0,23.49,50.63,27.14,3914,4260,346,10162,9994,-168,6791.0,6740.0,-51.0,128000.0,0.0,-128000.0
<a href=/player/maloe101>maloe101</a>,Eddie Malone,New York Yankees,YANKS,1,3,1,4,1951,1955,4,No,0,0.0,0.28,0.28,0,56,56,0,29,29,0.0,270.0,270.0,0.0,0.0,0.0
<a href=/player/maloj102>maloj102</a>,Jim Maloney,Cincinnati Reds,REDS,1,1,1,2,1970,1970,0,No,0,-0.3,0.0,0.3,26,0,-26,5,0,-5,91.0,0.0,-91.0,57500.0,0.0,-57500.0
<a href=/player/malom001>malom001</a>,Matt Maloney,Philadelphia Phillies,PHILS,1,1,1,2,2007,2007,0,No,0,0.05,0.65,0.6,44,26,-18,24,23,-1,240.0,183.0,-57.0,0.0,0.0,0.0
<a href=/player/malop103>malop103</a>,Pat Malone,Chicago Cubs,CUBS,5,9,7,16,1934,1943,9,No,0,18.58,8.45,-10.13,1563,956,-607,5453,3270,-2183,405.0,0.0,-405.0,33000.0,0.0,-33000.0
<a href=/player/mamaa101>mamaa101</a>,Al Mamaux,Pittsburgh Pirates,PIRATS,2,4,3,7,1918,1922,4,No,0,39.97,14.96,-25.01,1164,899,-265,2135,3669,1534,8893.0,0.0,-8893.0,4200.0,0.0,-4200.0
<a href=/player/manas001>manas001</a>,Sean Manaea,Kansas City Royals,ROYALS,1,2,2,4,2015,2015,0,No,0,11.48,1.17,-10.31,167,59,-108,19,264,245,2493.0,0.0,-2493.0,0.0,0.0,0.0
<a href=/player/mancf101>mancf101</a>,Frank Mancuso,St.Louis Browns,ORLS,1,1,1,2,1946,1948,2,No,0,-1.19,1.42,2.61,43,87,44,137,268,131,0.0,0.0,0.0,6500.0,0.0,-6500.0
<a href=/player/mancg101>mancg101</a>,Gus Mancuso,St. Louis Cardinals,CARDS,3,6,6,12,1932,1939,7,No,0,8.47,6.35,-2.12,942,482,-460,3293,766,-2527,60.0,2559.0,2499.0,0.0,0.0,0.0
<a href=/player/mancg101>mancg101</a>,Gus Mancuso,New York Giants,GIANTS,2,7,4,11,1938,1949,11,No,0,11.69,46.84,35.15,813,1845,1032,2964,7276,4312,38.0,0.0,-38.0,0.0,0.0,0.0
<a href=/player/mancg101>mancg101</a>,Gus Mancuso,Chicago Cubs,CUBS,1,2,1,3,1939,1943,4,No,0,1.28,-0.27,-1.55,170,131,-39,187,453,266,378.0,0.0,-378.0,12500.0,0.0,-12500.0
<a href=/player/mancg101>mancg101</a>,Gus Mancuso,Brooklyn Dodgers,DOGRS,1,3,1,4,1940,1949,9,No,0,0.16,3.28,3.12,111,521,410,388,1916,1528,0.0,0.0,0.0,0.0,0.0,0.0
<a href=/player/manga101>manga101</a>,Angel Mangual,Pittsburgh Pirates,PIRATS,1,1,1,2,1970,1971,1,No,0,2.23,0.61,-1.62,444,100,-344,1314,11,-1303,0.0,261.0,261.0,0.0,0.0,0.0
<a href=/player/mangl101>mangl101</a>,Leo Mangum,Minneapolis,Minneapolis,1,2,2,4,1924,1930,6,No,0,-1.39,0.0,1.39,129,0,-129,265,0,-265,183.0,0.0,-183.0,0.0,0.0,0.0
<a href=/player/mangl101>mangl101</a>,Leo Mangum,Chicago White Sox,WSOX,1,2,1,3,1927,1927,0,No,0,2.1,1.22,-0.88,71,68,-3,101,246,145,616.0,0.0,-616.0,0.0,0.0,0.0
<a href=/player/mangl101>mangl101</a>,Leo Mangum,Chicago White Sox,WSOX,4,12,5,17,1926,1936,10,No,0,0.81,1.51,0.7,234,542,308,748,1962,1214,0.0,39.0,39.0,19600.0,0.0,-19600.0
<a href=/player/mangp101>mangp101</a>,Pepe Mangual,Montreal Expos,NATEX,1,2,2,4,1976,1978,2,No,0,-0.15,2.45,2.6,60,488,428,138,1259,1121,0.0,0.0,0.0,0.0,0.0,0.0
<a href=/player/mangp101>mangp101</a>,Pepe Mangual,New York Mets,METS,1,1,1,2,1978,1978,0,No,0,0.0,0.3,0.3,0,11,11,0,33,33,0.0,0.0,0.0,0.0,0.0,0.0
<a href=/player/manic101>manic101</a>,Clyde Manion,St.Louis Browns,ORLS,1,4,1,5,1930,1932,2,No,0,0.0,-0.31,-0.31,0,16,16,0,36,36,0.0,0.0,0.0,10000.0,0.0,-10000.0
<a href=/player/mankp101>mankp101</a>,Phil Mankowski,Detroit Tigers,TIGRS,1,2,1,3,1979,1982,3,No,0,-0.84,3.18,4.02,115,250,135,268,851,583,0.0,0.0,0.0,0.0,0.0,0.0
<a href=/player/mannc001>mannc001</a>,Charlie Manning,New York Yankees,YANKS,1,3,1,4,2003,2004,1,No,0,0.09,1.41,1.32,113,54,-59,110,209,99,929.0,0.0,-929.0,0.0,0.0,0.0
<a href=/player/mannc001>mannc001</a>,Charlie Manning,Cincinnati Reds,REDS,1,2,1,3,2004,2004,0,No,0,0.0,-0.62,-0.62,0,80,80,0,0,0,0.0,117.0,117.0,0.0,0.0,0.0
<a href=/player/manne101>manne101</a>,Ernie Manning,St.Louis Browns,ORLS,1,4,2,6,1915,1924,9,No,0,0.0,-0.32,-0.32,0,2,2,0,1,1,0.0,10.0,10.0,0.0,0.0,0.0
<a href=/player/mannf101>mannf101</a>,Fred Mann,Philadelphia Athletics,ATLTCS,1,4,2,6,1887,1892,5,No,0,4.43,9.58,5.15,169,488,319,668,2210,1542,0.0,3.0,3.0,0.0,0.0,0.0
<a href=/player/mannj001>mannj001</a>,Jim Mann,Toronto Blue Jays,BJAYS,1,1,1,2,2000,2000,0,No,0,-0.07,0.0,0.07,4,0,-4,0,0,0,8.0,0.0,-8.0,0.0,0.0,0.0
<a href=/player/mannk001>mannk001</a>,Kelly Mann,Chicago Cubs,CUBS,2,3,2,5,1989,1995,6,No,0,0.08,5.77,5.69,44,681,637,53,415,362,52.0,994.0,942.0,2665333.0,0.0,-2665333.0
<a href=/player/mannl101>mannl101</a>,Les Mann,Buffalo,Buffalo,1,1,1,2,1913,1913,0,No,0,4.88,0.0,-4.88,572,0,-572,2024,0,-2024,0.0,0.0,0.0,0.0,0.0,0.0
<a href=/player/mannl101>mannl101</a>,Les Mann,Chicago Cubs,CUBS,1,2,1,3,1919,1921,2,No,0,5.35,-0.19,-5.54,455,143,-312,1719,569,-1150,0.0,0.0,0.0,4800.0,0.0,-4800.0
<a href=/player/mannr001>mannr001</a>,Rick Manning,Cleveland Indians,INDINS,4,6,7,13,1983,1989,6,No,0,6.39,10.47,4.08,1149,933,-216,3782,2485,-1297,450.0,1586.0,1136.0,1515000.0,0.0,-1515000.0
<a href=/player/manoj001>manoj001</a>,Julio Manon,Cincinnati Reds,REDS,1,1,1,2,2007,2007,0,No,0,0.0,0.0,0.0,0,0,0,0,0,0,0.0,0.0,0.0,0.0,0.0,0.0
<a href=/player/manrf001>manrf001</a>,Fred Manrique,Montreal Expos,NATEX,10,15,17,32,1986,1996,10,No,0,5.8,0.75,-5.05,1324,1131,-193,2191,1465,-726,2901.0,1691.0,-1210.0,955000.0,0.0,-955000.0
<a href=/player/manrf001>manrf001</a>,Fred Manrique,St. Louis Cardinals,CARDS,1,1,1,2,1986,1987,1,No,0,1.7,0.45,-1.25,320,120,-200,919,15,-904,0.0,290.0,290.0,0.0,0.0,0.0
<a href=/player/manrf001>manrf001</a>,Fred Manrique,Chicago White Sox,WSOX,9,18,22,40,1989,2011,22,No,0,68.5,42.52,-25.98,3028,2464,-564,8796,4720,-4076,3081.0,6620.0,3539.0,22245000.0,0.0,-22245000.0
<a href=/player/manrf001>manrf001</a>,Fred Manrique,Texas Rangers,RNGRS,1,1,2,3,1990,1990,0,No,0,-0.23,0.0,0.23,69,0,-69,237,0,-237,0.0,0.0,0.0,0.0,0.0,0.0
<a href=/player/mantf101>mantf101</a>,Felix Mantilla,New York Mets,METS,2,3,5,8,1962,1964,2,No,0,6.55,1.44,-5.11,469,269,-200,1384,501,-883,740.0,1141.0,401.0,0.0,0.0,0.0
<a href=/player/mantf101>mantf101</a>,Felix Mantilla,Boston Red Sox,RSOX,1,1,1,2,1966,1966,0,No,0,0.02,1.0,0.98,77,58,-19,167,152,-15,0.0,0.0,0.0,0.0,0.0,0.0
<a href=/player/mantj001>mantj001</a>,Jeff Manto,California Angels,ANGELS,1,2,1,3,1990,1992,2,No,0,-0.04,-1.98,-1.94,120,101,-19,352,0,-352,0.0,377.0,377.0,0.0,0.0,0.0
<a href=/player/mantj001>mantj001</a>,Jeff Manto,Boston Red Sox,RSOX,1,1,1,2,1996,1996,0,No,0,-0.31,-0.41,-0.1,21,21,0,63,62,-1,0.0,0.0,0.0,200000.0,0.0,-200000.0
<a href=/player/mantj001>mantj001</a>,Jeff Manto,Toronto Blue Jays,BJAYS,1,1,1,2,1997,1997,0,No,0,-0.08,0.0,0.08,43,0,-43,107,0,-107,0.0,0.0,0.0,0.0,0.0,0.0
<a href=/player/mantm001>mantm001</a>,Matt Mantei,Florida Marlins,MARLNS,12,21,29,50,1999,2019,20,Yes,0,78.04,61.7,-16.34,2887,3608,721,6541,8765,2224,11193.0,8868.0,-2325.0,39603667.0,0.0,-39603667.0
<a href=/player/manuc101>manuc101</a>,Charlie Manuel,Minnesota Twins,TWINS,1,2,2,4,1973,1973,0,No,0,0.0,0.0,0.0,19,0,-19,19,0,-19,0.0,0.0,0.0,0.0,0.0,0.0
<a href=/player/manuh101>manuh101</a>,Heinie Manush,Detroit Tigers,TIGRS,2,5,6,11,1927,1932,5,No,0,22.97,3.43,-19.54,913,569,-344,3930,2101,-1829,97.0,731.0,634.0,36000.0,0.0,-36000.0
<a href=/player/manuh101>manuh101</a>,Heinie Manush,St.Louis Browns,ORLS,21,40,49,89,1930,1952,22,No,0,132.72,109.57,-23.15,6415,9088,2673,21139,29444,8305,12102.0,15510.0,3408.0,207500.0,0.0,-207500.0
<a href=/player/manuh101>manuh101</a>,Heinie Manush,Washington Senators,TWINS,3,6,5,11,1935,1940,5,No,0,3.67,0.85,-2.82,437,550,113,875,1388,513,2260.0,1980.0,-280.0,12000.0,0.0,-12000.0
<a href=/player/manuj101>manuj101</a>,Jerry Manuel,Detroit Tigers,TIGRS,1,1,1,2,1980,1981,1,No,0,0.11,-0.54,-0.65,34,50,16,69,126,57,0.0,0.0,0.0,0.0,0.0,0.0
<a href=/player/manuj101>manuj101</a>,Jerry Manuel,Montreal Expos,NATEX,1,1,1,2,1982,1982,0,No,0,-0.03,0.0,0.03,2,0,-2,6,0,-6,0.0,0.0,0.0,0.0,0.0,0.0
<a href=/player/manuj101>manuj101</a>,Jerry Manuel,San Diego Padres,PADRS,1,1,1,2,1982,1983,1,No,0,0.0,0.04,0.04,0,14,14,0,1,1,0.0,31.0,31.0,0.0,0.0,0.0
<a href=/player/manuj101>manuj101</a>,Jerry Manuel,Montreal Expos,NATEX,1,1,1,2,1983,1983,0,No,0,0.0,0.0,0.0,0,0,0,0,0,0,0.0,0.0,0.0,0.0,0.0,0.0
<a href=/player/manur001>manur001</a>,Robert Manuel,New York Mets,METS,1,1,2,3,2006,2007,1,No,0,0.15,-0.46,-0.61,6,16,10,0,12,12,13.0,100.0,87.0,0.0,0.0,0.0
<a href=/player/manur001>manur001</a>,Robert Manuel,Cincinnati Reds,REDS,1,1,1,2,2009,2010,1,No,0,0.0,0.78,0.78,0,40,40,0,125,125,0.0,0.0,0.0,400000.0,0.0,-400000.0
<a href=/player/manvd101>manvd101</a>,Dick Manville,Chicago Cubs,CUBS,1,2,1,3,1952,1956,4,No,0,0.0,-0.4,-0.4,0,166,166,0,450,450,0.0,0.0,0.0,0.0,0.0,0.0
<a href=/player/manwk001>manwk001</a>,Kirt Manwaring,San Francisco Giants,GIANTS,1,1,2,3,1996,1997,1,No,0,0.4,1.77,1.37,37,118,81,89,393,304,0.0,0.0,0.0,1875000.0,0.0,-1875000.0
<a href=/player/manzj001>manzj001</a>,Josias Manzanillo,Milwaukee Brewers,BREWRS,1,1,1,2,1993,1993,0,No,0,0.61,0.0,-0.61,135,0,-135,7,0,-7,282.0,0.0,-282.0,0.0,0.0,0.0
<a href=/player/mapec101>mapec101</a>,Cliff Mapes,New York Yankees,YANKS,1,1,3,4,1951,1952,1,No,0,0.78,-0.77,-1.55,56,68,12,229,11,-218,0.0,164.0,164.0,0.0,0.0,0.0
<a href=/player/mapec101>mapec101</a>,Cliff Mapes,St.Louis Browns,ORLS,23,51,48,99,1952,1994,42,No,3,84.08,155.33,71.25,5312,9112,3800,11244,26050,14806,18662.0,17928.0,-734.0,984333.0,0.0,-984333.0
<a href=/player/mapec101>mapec101</a>,Cliff Mapes,Detroit Tigers,TIGRS,1,3,1,4,1952,1952,0,No,0,-0.5,0.0,0.5,62,0,-62,121,0,-121,0.0,0.0,0.0,10000.0,0.0,-10000.0
<a href=/player/marag101>marag101</a>,Georges Maranda,Minnesota Twins,TWINS,1,3,1,4,1962,1963,1,No,0,-0.08,-0.13,-0.05,2,12,10,0,6,6,4.0,58.0,54.0,0.0,0.0,0.0
<a href=/player/marar101>marar101</a>,Rabbit Maranville,NewBedford,NewBedford,1,1,2,3,1912,1914,2,No,0,30.45,0.0,-30.45,1795,0,-1795,7536,0,-7536,0.0,0.0,0.0,0.0,0.0,0.0
<a href=/player/marar101>marar101</a>,Rabbit Maranville,Boston Braves,BRAVES,2,3,7,10,1921,1927,6,No,0,12.92,20.52,7.6,874,1440,566,3700,5949,2249,87.0,0.0,-87.0,5000.0,0.0,-5000.0
<a href=/player/marar101>marar101</a>,Rabbit Maranville,Pittsburgh Pirates,PIRATS,4,6,7,13,1924,1932,8,No,0,11.08,42.87,31.79,1606,1347,-259,6101,4357,-1744,1307.0,3847.0,2540.0,22300.0,0.0,-22300.0
<a href=/player/marbf101>marbf101</a>,Firpo Marberry,Washington Senators,TWINS,2,3,2,5,1932,1937,5,No,0,6.78,12.58,5.8,394,270,-124,393,428,35,3029.0,2990.0,-39.0,6500.0,0.0,-6500.0
<a href=/player/marcj101>marcj101</a>,Johnny Marcum,Philadelphia Athletics,ATLTCS,1,2,3,5,1935,1936,1,No,0,40.03,-0.08,-40.11,1089,70,-1019,4170,77,-4093,1354.0,649.0,-705.0,5500.0,0.0,-5500.0
<a href=/player/marcj101>marcj101</a>,Johnny Marcum,Boston Red Sox,RSOX,1,1,1,2,1938,1946,8,No,0,-0.14,-0.26,-0.12,28,126,98,23,263,240,143.0,0.0,-143.0,8500.0,0.0,-8500.0
<a href=/player/marcj101>marcj101</a>,Johnny Marcum,St.Louis Browns,ORLS,1,1,1,2,1939,1939,0,No,0,0.06,0.2,0.14,57,52,-5,62,19,-43,270.0,198.0,-72.0,6000.0,0.0,-6000.0
<a href=/player/marcj101>marcj101</a>,Johnny Marcum,Louisville,Louisville,1,1,2,3,1933,1937,4,No,0,8.5,0.0,-8.5,208,0,-208,263,0,-263,1535.0,0.0,-1535.0,0.0,0.0,0.0
<a href=/player/marcs001>marcs001</a>,Shaun Marcum,Toronto Blue Jays,BJAYS,3,7,3,10,2010,2018,8,Yes,0,11.0,32.15,21.15,456,807,351,1007,3497,2490,2385.0,0.0,-2385.0,24366100.0,0.0,-24366100.0
<a href=/player/marct001>marct001</a>,Tucupita Marcano,San Diego Padres,PADRS,1,3,2,5,2021,2021,0,Yes,0,0.0,0.98,0.98,0,57,57,0,211,211,0.0,0.0,0.0,0.0,0.0,0.0
<a href=/player/marel101>marel101</a>,Leo Marentette,Detroit Tigers,TIGRS,1,2,1,3,1968,1968,0,No,0,1.07,0.21,-0.86,466,31,-435,26,57,31,791.0,0.0,-791.0,0.0,0.0,0.0
<a href=/player/margm001>margm001</a>,Manuel Margot,Boston Red Sox,RSOX,1,4,1,5,2015,2018,3,No,0,5.44,6.73,1.29,670,203,-467,2136,0,-2136,153.0,553.0,400.0,0.0,0.0,0.0
<a href=/player/margm001>margm001</a>,Manuel Margot,San Diego Padres,PADRS,1,2,1,3,2020,2020,0,Yes,0,3.8,0.04,-3.76,172,23,-149,623,0,-623,0.0,66.0,66.0,0.0,0.0,0.0
<a href=/player/marij001>marij001</a>,Jhan Marinez,Florida Marlins,MARLNS,1,2,2,4,2011,2011,0,No,0,0.17,0.0,-0.17,2,0,-2,0,0,0,8.0,0.0,-8.0,0.0,0.0,0.0
<a href=/player/marij002>marij002</a>,Jake Marisnick,Toronto Blue Jays,BJAYS,3,15,11,26,2012,2018,6,No,0,24.75,21.38,-3.37,2099,1087,-1012,5739,3162,-2577,4668.0,4579.0,-89.0,8732900.0,0.0,-8732900.0
<a href=/player/marij002>marij002</a>,Jake Marisnick,Miami Marlins,MARLNS,7,20,18,38,2014,2020,6,Yes,0,36.69,11.6,-25.09,2821,868,-1953,6455,1964,-4491,3539.0,2374.0,-1165.0,18850000.0,0.0,-18850000.0
<a href=/player/marij002>marij002</a>,Jake Marisnick,Houston Astros,ASTROS,1,1,2,3,2019,2019,0,Yes,0,0.19,0.0,-0.19,16,0,-16,34,0,-34,0.0,0.0,0.0,2212000.0,0.0,-2212000.0
<a href=/player/marij002>marij002</a>,Jake Marisnick,Chicago Cubs,CUBS,1,1,1,2,2021,2021,0,Yes,0,-0.19,0.0,0.19,34,0,-34,54,0,-54,0.0,0.0,0.0,1000000.0,0.0,-1000000.0
<a href=/player/marir101>marir101</a>,Roger Maris,Cleveland Indians,INDINS,18,28,30,58,1958,1984,26,No,0,63.62,52.24,-11.38,5094,5420,326,14869,17997,3128,4436.0,3464.0,-972.0,307350.0,0.0,-307350.0
<a href=/player/marir101>marir101</a>,Roger Maris,Kansas City Athletics,ATLTCS,23,46,43,89,1959,1976,17,No,0,99.11,44.56,-54.55,8270,5153,-3117,21179,15408,-5771,8728.0,3756.0,-4972.0,440600.0,0.0,-440600.0
<a href=/player/marir101>marir101</a>,Roger Maris,New York Yankees,YANKS,3,3,3,6,1966,1969,3,No,0,5.57,1.2,-4.37,269,182,-87,861,542,-319,0.0,0.0,0.0,116000.0,0.0,-116000.0
<a href=/player/marjm001>marjm001</a>,Mike Marjama,Tampa Bay Devil Rays,RAYS,3,4,5,9,2017,2018,1,Yes,0,1.01,2.33,1.32,315,140,-175,740,560,-180,268.0,0.0,-268.0,0.0,0.0,0.0
<a href=/player/markc101>markc101</a>,Cliff Markle,StPaul,StPaul,1,1,1,2,1924,1924,0,No,0,-1.0,0.0,1.0,14,0,-14,8,0,-8,70.0,0.0,-70.0,0.0,0.0,0.0
<a href=/player/markd101>markd101</a>,Duke Markell,St.Louis Browns,ORLS,1,2,1,3,1952,1953,1,No,0,0.0,-0.02,-0.02,0,44,44,0,22,22,0.0,196.0,196.0,0.0,0.0,0.0
<a href=/player/markj001>markj001</a>,Justin Marks,Oakland Athletics,ATLTCS,2,3,2,5,2010,2012,2,No,1,-1.02,1.13,2.15,29,131,102,7,506,499,223.0,0.0,-223.0,0.0,0.0,0.0
<a href=/player/marmc001>marmc001</a>,Carlos Marmol,Chicago Cubs,CUBS,1,2,1,3,2013,2013,0,No,0,0.26,0.34,0.08,41,29,-12,1,0,-1,64.0,38.0,-26.0,0.0,0.0,0.0
<a href=/player/marnh101>marnh101</a>,Hal Marnie,Philadelphia Phillies,PHILS,1,2,1,3,1942,1943,1,No,0,0.0,0.0,0.0,0,0,0,0,0,0,0.0,0.0,0.0,0.0,0.0,0.0
<a href=/player/marom001>marom001</a>,Mike Maroth,Boston Red Sox,RSOX,1,1,1,2,1999,2001,2,No,0,6.39,-0.23,-6.62,158,54,-104,25,0,-25,2640.0,264.0,-2376.0,0.0,0.0,0.0
<a href=/player/marom001>marom001</a>,Mike Maroth,Detroit Tigers,TIGRS,1,1,1,2,2007,2009,2,No,0,-2.36,-0.81,1.55,29,10,-19,11,0,-11,114.0,82.0,-32.0,2950000.0,0.0,-2950000.0
<a href=/player/marqb101>marqb101</a>,Bob Marquis,New York Yankees,YANKS,1,5,1,6,1952,1955,3,No,0,5.35,0.52,-4.83,390,26,-364,1419,10,-1409,46.0,107.0,61.0,0.0,0.0,0.0
<a href=/player/marqg001>marqg001</a>,German Marquez,Tampa Bay Devil Rays,RAYS,2,3,5,8,2016,2021,5,Yes,0,22.25,4.27,-17.98,873,307,-566,919,1191,272,3030.0,0.0,-3030.0,0.0,0.0,0.0
<a href=/player/marqg101>marqg101</a>,Gonzalo Marquez,Oakland Athletics,ATLTCS,2,2,2,4,1973,1974,1,No,0,-0.56,-0.09,0.47,53,126,73,148,217,69,0.0,0.0,0.0,17500.0,0.0,-17500.0
<a href=/player/marqi001>marqi001</a>,Isidro Marquez,Los Angeles Dodgers,DOGRS,2,5,3,8,1993,1998,5,No,0,-0.53,1.39,1.92,836,429,-407,2713,30,-2683,638.0,819.0,181.0,218000.0,0.0,-218000.0
<a href=/player/marqj001>marqj001</a>,Jason Marquis,Atlanta Braves,BRAVES,2,5,3,8,2003,2005,2,No,0,48.74,10.63,-38.11,1422,247,-1175,1200,926,-274,9241.0,27.0,-9214.0,3968000.0,0.0,-3968000.0
<a href=/player/marqj001>marqj001</a>,Jason Marquis,Chicago Cubs,CUBS,1,1,1,2,2009,2009,0,No,0,3.48,0.25,-3.23,69,8,-61,75,0,-75,648.0,11.0,-637.0,0.0,0.0,0.0
<a href=/player/marqj001>marqj001</a>,Jason Marquis,Washington Nationals,NATEX,2,2,3,5,2011,2014,3,No,0,-1.36,0.9,2.26,48,89,41,128,252,124,34.0,0.0,-34.0,7500000.0,0.0,-7500000.0
<a href=/player/marqj002>marqj002</a>,Jeffrey Marquez,New York Yankees,YANKS,2,4,3,7,2008,2013,5,Yes,1,-0.72,11.97,12.69,28,599,571,50,2501,2451,20.0,3.0,-17.0,1165000.0,0.0,-1165000.0
<a href=/player/marql101>marql101</a>,Luis Marquez,Chicago Cubs,CUBS,1,1,1,2,1954,1954,0,No,0,0.02,-1.31,-1.33,14,51,37,14,81,67,0.0,0.0,0.0,0.0,0.0,0.0
<a href=/player/marqr102>marqr102</a>,Rube Marquard,Brooklyn Dodgers,DOGRS,1,1,1,2,1920,1924,4,No,0,2.52,11.22,8.7,78,334,256,99,445,346,794.0,2767.0,1973.0,0.0,0.0,0.0
<a href=/player/marqr102>marqr102</a>,Rube Marquard,Cincinnati Reds,REDS,1,2,1,3,1922,1922,0,No,0,0.41,-0.04,-0.45,383,2,-381,879,1,-878,1636.0,3.0,-1633.0,0.0,0.0,0.0
<a href=/player/marrd001>marrd001</a>,Deven Marrero,Boston Red Sox,RSOX,1,1,1,2,2018,2018,0,Yes,0,-0.36,0.0,0.36,49,0,-49,85,0,-85,0.0,0.0,0.0,0.0,0.0,0.0
<a href=/player/marre001>marre001</a>,Eli Marrero,St. Louis Cardinals,CARDS,2,3,5,8,2003,2021,18,Yes,0,10.7,51.54,40.84,366,1812,1446,926,2456,1530,134.0,9250.0,9116.0,7050000.0,0.0,-7050000.0
<a href=/player/marre001>marre001</a>,Eli Marrero,Atlanta Braves,BRAVES,1,2,1,3,2004,2005,1,No,0,-1.05,0.08,1.13,32,12,-20,100,1,-99,0.0,27.0,27.0,3000000.0,0.0,-3000000.0
<a href=/player/marre001>marre001</a>,Eli Marrero,Kansas City Royals,ROYALS,1,2,1,3,2005,2005,0,No,0,0.23,0.0,-0.23,22,0,-22,56,0,-56,0.0,0.0,0.0,3200000.0,0.0,-3200000.0
<a href=/player/marre001>marre001</a>,Eli Marrero,Colorado Rockies,ROCKS,1,1,2,3,2006,2007,1,No,0,0.05,3.93,3.88,25,136,111,41,579,538,0.0,0.0,0.0,350000.0,0.0,-350000.0
<a href=/player/marro001>marro001</a>,Oreste Marrero,Milwaukee Brewers,BREWRS,1,2,2,4,1993,1993,0,No,0,-0.51,0.0,0.51,36,0,-36,100,0,-100,0.0,0.0,0.0,0.0,0.0,0.0
<a href=/player/marsa101>marsa101</a>,Armando Marsans,St.Louis Browns,ORLS,2,2,2,4,1917,1919,2,No,0,2.53,1.06,-1.47,181,124,-57,746,395,-351,0.0,0.0,0.0,4000.0,0.0,-4000.0
<a href=/player/marsc101>marsc101</a>,Cuddles Marshall,Seattle,Seattle,1,1,2,3,1944,1944,0,No,0,-1.41,0.0,1.41,90,0,-90,41,0,-41,394.0,0.0,-394.0,0.0,0.0,0.0
<a href=/player/marsd101>marsd101</a>,Dave Marshall,California Angels,ANGELS,2,2,2,4,1966,1967,1,No,0,-3.71,0.23,3.94,418,26,-392,1234,7,-1227,0.0,91.0,91.0,0.0,0.0,0.0
<a href=/player/marsd101>marsd101</a>,Dave Marshall,San Francisco Giants,GIANTS,2,3,3,6,1969,1971,2,No,0,8.87,-0.91,-9.78,806,89,-717,1416,200,-1216,1801.0,0.0,-1801.0,0.0,0.0,0.0
<a href=/player/marsd101>marsd101</a>,Dave Marshall,New York Mets,METS,1,1,1,2,1972,1972,0,No,0,0.19,0.0,-0.19,39,0,-39,59,0,-59,0.0,0.0,0.0,0.0,0.0,0.0
<a href=/player/marsd102>marsd102</a>,Doc Marshall,New York Giants,GIANTS,1,2,1,3,1906,1908,2,No,0,0.72,1.14,0.42,182,308,126,648,1333,685,0.0,0.0,0.0,0.0,0.0,0.0
<a href=/player/marse101>marse101</a>,Doc Marshall,New York Giants,GIANTS,4,14,6,20,1932,1949,17,No,0,8.76,68.78,60.02,1268,2638,1370,4502,10545,6043,296.0,0.0,-296.0,0.0,0.0,0.0
<a href=/player/marse101>marse101</a>,Doc Marshall,New York Giants,GIANTS,2,3,2,5,1937,1938,1,No,0,0.0,0.73,0.73,0,71,71,0,263,263,0.0,0.0,0.0,0.0,0.0,0.0
<a href=/player/marsf101>marsf101</a>,Fred Marsh,Cleveland Indians,INDINS,1,2,2,4,1951,1951,0,No,0,-2.02,0.66,2.68,326,69,-257,1133,142,-991,0.0,0.0,0.0,0.0,0.0,0.0
<a href=/player/marsf101>marsf101</a>,Fred Marsh,St.Louis Browns,ORLS,1,2,1,3,1952,1952,0,No,0,-0.84,0.79,1.63,38,55,17,46,190,144,171.0,0.0,-171.0,6000.0,0.0,-6000.0
<a href=/player/marsf101>marsf101</a>,Fred Marsh,Washington Senators,TWINS,1,1,1,2,1952,1952,0,No,0,-0.56,0.06,0.62,196,46,-150,650,74,-576,0.0,0.0,0.0,0.0,0.0,0.0
<a href=/player/marsf101>marsf101</a>,Fred Marsh,St.Louis Browns,ORLS,1,1,2,3,1953,1953,0,No,0,1.2,0.0,-1.2,129,9,-120,220,9,-211,0.0,0.0,0.0,0.0,0.0,0.0
<a href=/player/marsf101>marsf101</a>,Fred Marsh,Chicago White Sox,WSOX,29,56,55,111,1954,1971,17,No,0,64.71,122.48,57.77,7633,8254,621,20626,20005,-621,7158.0,13512.0,6354.0,248750.0,0.0,-248750.0
<a href=/player/marsj101>marsj101</a>,Jim Marshall,Chicago White Sox,WSOX,15,26,28,54,1957,1969,12,No,0,18.37,37.27,18.9,2207,3220,1013,3806,5515,1709,4631.0,7668.0,3037.0,148250.0,0.0,-148250.0
<a href=/player/marsj101>marsj101</a>,Jim Marshall,Chicago Cubs,CUBS,1,2,1,3,1959,1960,1,No,0,1.72,-0.14,-1.86,88,52,-36,29,107,78,345.0,0.0,-345.0,0.0,0.0,0.0
<a href=/player/marsj101>marsj101</a>,Jim Marshall,Boston Red Sox,RSOX,3,7,4,11,1960,1966,6,No,0,-0.53,-1.25,-0.72,125,550,425,299,1387,1088,0.0,336.0,336.0,18500.0,0.0,-18500.0
<a href=/player/marsj101>marsj101</a>,Jim Marshall,Boston Red Sox,RSOX,1,1,1,2,1960,1960,0,No,0,0.2,-0.51,-0.71,119,12,-107,176,1,-175,0.0,35.0,35.0,0.0,0.0,0.0
<a href=/player/marsj101>marsj101</a>,Jim Marshall,New York Mets,METS,1,1,1,2,1962,1962,0,No,0,-0.08,-0.78,-0.7,55,34,-21,116,8,-108,0.0,114.0,114.0,0.0,0.0,0.0
<a href=/player/marsl001>marsl001</a>,Lou Marson,Philadelphia Phillies,PHILS,3,6,6,12,2009,2015,6,No,0,27.43,-0.46,-27.89,716,374,-342,1539,630,-909,4038.0,442.0,-3596.0,1175000.0,0.0,-1175000.0
<a href=/player/marsm001>marsm001</a>,Mike Marshall,Los Angeles Dodgers,DOGRS,1,2,1,3,1989,1992,3,No,0,2.0,2.55,0.55,245,343,98,183,1353,1170,417.0,0.0,-417.0,1975000.0,0.0,-1975000.0
<a href=/player/marsm001>marsm001</a>,Mike Marshall,New York Mets,METS,4,5,6,11,1990,1994,4,No,0,3.09,1.07,-2.02,383,342,-41,797,888,91,1125.0,394.0,-731.0,5216666.0,0.0,-5216666.0
<a href=/player/marsm101>marsm101</a>,Mike Marshall,Houston Astros,ASTROS,1,1,1,2,1970,1970,0,No,0,6.99,0.0,-6.99,494,0,-494,100,0,-100,1413.0,0.0,-1413.0,0.0,0.0,0.0
<a href=/player/marsm101>marsm101</a>,Mike Marshall,Montreal Expos,NATEX,4,6,7,13,1973,1986,13,No,1,19.15,15.78,-3.37,1432,1493,61,2872,3108,236,1885.0,4288.0,2403.0,110000.0,0.0,-110000.0
<a href=/player/marsm101>marsm101</a>,Mike Marshall,Los Angeles Dodgers,DOGRS,2,2,3,5,1976,1985,9,No,1,0.61,10.59,9.98,56,830,774,9,669,660,128.0,1278.0,1150.0,135000.0,0.0,-135000.0
<a href=/player/marsm102>marsm102</a>,Max Marshall,St. Louis Cardinals,CARDS,5,12,8,20,1942,1954,12,No,0,11.42,4.84,-6.58,1473,525,-948,4094,1686,-2408,1601.0,388.0,-1213.0,41500.0,0.0,-41500.0
<a href=/player/marss001>marss001</a>,Sam Marsonek,Texas Rangers,RNGRS,1,2,1,3,1999,2001,2,No,0,-0.67,0.61,1.28,13,146,133,0,511,511,62.0,0.0,-62.0,0.0,0.0,0.0
<a href=/player/marss002>marss002</a>,Sean Marshall,Chicago Cubs,CUBS,1,1,3,4,2011,2016,5,No,0,1.09,7.63,6.54,203,509,306,0,388,388,256.0,2074.0,1818.0,1600000.0,0.0,-1600000.0
<a href=/player/marsw101>marsw101</a>,Willard Marshall,New York Giants,GIANTS,14,31,27,58,1949,1968,19,No,0,59.86,70.44,10.58,4286,4168,-118,14522,10114,-4408,1384.0,8678.0,7294.0,127500.0,0.0,-127500.0
<a href=/player/marsw101>marsw101</a>,Willard Marshall,Cincinnati Reds,REDS,1,1,3,4,1953,1954,1,No,0,-0.06,0.0,0.06,69,1,-68,138,1,-137,0.0,0.0,0.0,0.0,0.0,0.0
<a href=/player/marta001>marta001</a>,Al Martin,Pittsburgh Pirates,PIRATS,2,4,5,9,2000,2006,6,No,0,22.88,0.62,-22.26,458,510,52,929,1122,193,3209.0,841.0,-2368.0,5050000.0,0.0,-5050000.0
<a href=/player/marta001>marta001</a>,Al Martin,San Diego Padres,PADRS,1,1,2,3,2000,2002,2,No,0,1.23,0.34,-0.89,142,184,42,469,130,-339,0.0,215.0,215.0,1750000.0,0.0,-1750000.0
<a href=/player/marta002>marta002</a>,Sandy Martinez,Toronto Blue Jays,BJAYS,1,1,1,2,1997,1997,0,No,0,-0.43,0.0,0.43,62,0,-62,132,0,-132,0.0,0.0,0.0,0.0,0.0,0.0
<a href=/player/marta003>marta003</a>,Anastacio Martinez,Boston Red Sox,RSOX,3,9,6,15,2003,2008,5,No,0,19.22,17.72,-1.5,1732,227,-1505,2840,14,-2826,1848.0,2473.0,625.0,943500.0,0.0,-943500.0
<a href=/player/marta003>marta003</a>,Anastacio Martinez,Pittsburgh Pirates,PIRATS,5,8,9,17,2003,2013,10,No,0,4.43,21.03,16.6,571,1401,830,955,4379,3424,773.0,467.0,-306.0,13800000.0,0.0,-13800000.0
<a href=/player/marta004>marta004</a>,Andy Marte,Atlanta Braves,BRAVES,3,5,5,10,2005,2012,7,No,0,-0.89,18.1,18.99,691,766,75,1061,2490,1429,4336.0,2160.0,-2176.0,9000000.0,0.0,-9000000.0
<a href=/player/marta004>marta004</a>,Andy Marte,Boston Red Sox,RSOX,6,12,8,20,2006,2011,5,No,0,15.42,8.9,-6.52,1619,794,-825,3010,1778,-1232,1235.0,750.0,-485.0,8391733.0,0.0,-8391733.0
<a href=/player/marta005>marta005</a>,Alfredo Marte,Baltimore Orioles,ORLS,1,1,1,2,2016,2016,0,No,0,0.0,0.0,0.0,0,0,0,0,0,0,0.0,0.0,0.0,0.0,0.0,0.0
<a href=/player/martb001>martb001</a>,Buck Martinez,Houston Astros,ASTROS,1,3,1,4,1968,1968,0,No,0,0.37,0.0,-0.37,361,0,-361,1073,0,-1073,0.0,0.0,0.0,0.0,0.0,0.0
<a href=/player/martb001>martb001</a>,Buck Martinez,Kansas City Royals,ROYALS,1,2,1,3,1977,1979,2,No,0,2.3,2.25,-0.05,386,116,-270,35,0,-35,783.0,420.0,-363.0,50000.0,0.0,-50000.0
<a href=/player/martb001>martb001</a>,Buck Martinez,St. Louis Cardinals,CARDS,2,2,2,4,1977,1984,7,No,0,5.03,-0.76,-5.79,375,152,-223,738,21,-717,767.0,232.0,-535.0,0.0,0.0,0.0
<a href=/player/martb001>martb001</a>,Buck Martinez,Milwaukee Brewers,BREWRS,1,1,1,2,1981,1981,0,No,0,3.51,0.0,-3.51,454,0,-454,1261,0,-1261,0.0,0.0,0.0,0.0,0.0,0.0
<a href=/player/martb102>martb102</a>,Bob Martyn,New York Yankees,YANKS,3,9,7,16,1957,1962,5,No,0,10.27,3.25,-7.02,1508,714,-794,3698,610,-3088,2854.0,1762.0,-1092.0,12500.0,0.0,-12500.0
<a href=/player/martb102>martb102</a>,Bob Martyn,Kansas City Athletics,ATLTCS,25,53,47,100,1959,1976,17,No,0,93.37,60.18,-33.19,8944,6275,-2669,21756,18191,-3565,9976.0,4965.0,-5011.0,504100.0,0.0,-504100.0
<a href=/player/martb105>martb105</a>,Billy Martin,Oakland,Oakland,1,2,2,4,1949,1951,2,No,0,6.53,0.0,-6.53,635,0,-635,2176,0,-2176,0.0,0.0,0.0,0.0,0.0,0.0
<a href=/player/martb105>martb105</a>,Billy Martin,New York Yankees,YANKS,3,9,7,16,1957,1962,5,No,0,10.27,3.25,-7.02,1508,714,-794,3698,610,-3088,2854.0,1762.0,-1092.0,12500.0,0.0,-12500.0
<a href=/player/martb105>martb105</a>,Billy Martin,Kansas City Athletics,ATLTCS,31,62,61,123,1957,1976,19,No,0,95.85,56.38,-39.47,9593,6643,-2950,23097,19018,-4079,12004.0,6179.0,-5825.0,476100.0,0.0,-476100.0
<a href=/player/martb105>martb105</a>,Billy Martin,Detroit Tigers,TIGRS,1,2,3,5,1958,1964,6,No,0,0.2,14.33,14.13,125,305,180,263,345,82,132.0,2789.0,2657.0,0.0,0.0,0.0
<a href=/player/martb105>martb105</a>,Billy Martin,Cleveland Indians,INDINS,3,5,5,10,1959,1965,6,No,0,6.43,1.26,-5.17,1198,354,-844,3637,1453,-2184,454.0,0.0,-454.0,7500.0,0.0,-7500.0
<a href=/player/martb105>martb105</a>,Billy Martin,Milwaukee Braves,BRAVES,1,1,1,2,1961,1961,0,No,0,-0.89,0.0,0.89,108,0,-108,398,0,-398,0.0,0.0,0.0,0.0,0.0,0.0
<a href=/player/martc001>martc001</a>,Carmelo Martinez,Chicago Cubs,CUBS,2,4,2,6,1983,1989,6,No,1,15.56,10.82,-4.74,1534,321,-1213,2801,249,-2552,1977.0,2213.0,236.0,0.0,0.0,0.0
<a href=/player/martc001>martc001</a>,Carmelo Martinez,Philadelphia Phillies,PHILS,5,8,9,17,1990,2000,10,No,0,9.65,1.55,-8.1,566,1101,535,262,3701,3439,1674.0,703.0,-971.0,1751500.0,0.0,-1751500.0
<a href=/player/martc001>martc001</a>,Carmelo Martinez,Pittsburgh Pirates,PIRATS,1,1,1,2,1991,1991,0,No,0,0.45,0.0,-0.45,44,0,-44,148,0,-148,0.0,0.0,0.0,925000.0,0.0,-925000.0
<a href=/player/martc001>martc001</a>,Carmelo Martinez,Kansas City Royals,ROYALS,2,2,3,5,1991,1994,3,No,0,-0.49,1.03,1.52,174,215,41,469,721,252,0.0,0.0,0.0,0.0,0.0,0.0
<a href=/player/martc002>martc002</a>,Carlos Martinez,New York Yankees,YANKS,2,5,4,9,1986,1992,6,No,0,1.11,3.87,2.76,606,1169,563,1878,3720,1842,0.0,0.0,0.0,400873.0,0.0,-400873.0
<a href=/player/martc007>martc007</a>,Chris Martin,Boston Red Sox,RSOX,1,2,1,3,2013,2014,1,No,0,-0.53,-0.06,0.47,103,42,-61,39,104,65,474.0,0.0,-474.0,1487500.0,0.0,-1487500.0
<a href=/player/martc007>martc007</a>,Chris Martin,Texas Rangers,RNGRS,1,1,1,2,2019,2019,0,Yes,0,1.69,0.79,-0.9,146,10,-136,0,2,2,237.0,136.0,-101.0,2250000.0,0.0,-2250000.0
<a href=/player/martc009>martc009</a>,Corbin Martin,Houston Astros,ASTROS,1,4,2,6,2019,2021,2,No,0,-0.93,3.35,4.28,254,54,-200,791,4,-787,100.0,902.0,802.0,0.0,0.0,0.0
<a href=/player/martd001>martd001</a>,Dennis Martinez,Baltimore Orioles,ORLS,2,3,2,5,1986,1991,5,No,0,29.01,1.13,-27.88,569,267,-302,791,631,-160,4827.0,0.0,-4827.0,630458.0,0.0,-630458.0
<a href=/player/martd002>martd002</a>,Dave Martinez,Chicago Cubs,CUBS,2,2,2,4,1988,1991,3,No,0,9.41,2.09,-7.32,573,252,-321,1968,779,-1189,1.0,0.0,-1.0,685000.0,0.0,-685000.0
<a href=/player/martd002>martd002</a>,Dave Martinez,Montreal Expos,NATEX,2,4,4,8,1991,2001,10,No,0,7.84,6.46,-1.38,825,557,-268,1993,412,-1581,539.0,721.0,182.0,287500.0,0.0,-287500.0
<a href=/player/martd002>martd002</a>,Dave Martinez,Tampa Bay Devil Rays,RAYS,2,3,3,6,2000,2003,3,No,0,0.74,1.14,0.4,52,238,186,56,846,790,251.0,96.0,-155.0,3000000.0,0.0,-3000000.0
<a href=/player/martd002>martd002</a>,Dave Martinez,Chicago Cubs,CUBS,1,1,1,2,2000,2000,0,No,0,0.5,-0.69,-1.19,38,54,16,134,102,-32,0.0,0.0,0.0,0.0,0.0,0.0
<a href=/player/martd002>martd002</a>,Dave Martinez,Texas Rangers,RNGRS,1,1,1,2,2000,2001,1,No,0,0.81,0.0,-0.81,47,0,-47,206,0,-206,0.0,0.0,0.0,0.0,0.0,0.0
<a href=/player/martd003>martd003</a>,Domingo Martinez,Toronto Blue Jays,BJAYS,1,1,1,2,1994,1996,2,No,0,0.0,1.37,1.37,0,152,152,0,435,435,0.0,0.0,0.0,0.0,0.0,0.0
<a href=/player/martd004>martd004</a>,Damaso Marte,New York Yankees,YANKS,1,1,1,2,2001,2004,3,No,0,2.76,-3.12,-5.88,411,264,-147,8,636,628,560.0,0.0,-560.0,0.0,0.0,0.0
<a href=/player/martd004>martd004</a>,Damaso Marte,Pittsburgh Pirates,PIRATS,1,2,1,3,2002,2003,1,No,0,7.99,0.0,-7.99,294,0,-294,1,0,-1,777.0,0.0,-777.0,0.0,0.0,0.0
<a href=/player/martd004>martd004</a>,Damaso Marte,Chicago White Sox,WSOX,3,4,3,7,2005,2011,6,No,0,1.48,0.45,-1.03,460,515,55,101,2003,1902,823.0,0.0,-823.0,4000000.0,0.0,-4000000.0
<a href=/player/martd004>martd004</a>,Damaso Marte,Pittsburgh Pirates,PIRATS,2,3,6,9,2008,2016,8,No,0,0.52,7.02,6.5,146,1139,993,276,2174,1898,148.0,3210.0,3062.0,9500000.0,0.0,-9500000.0
<a href=/player/marte002>marte002</a>,Ethan Martin,Los Angeles Dodgers,DOGRS,1,3,1,4,2012,2012,0,No,0,-1.0,1.11,2.11,86,53,-33,10,235,225,202.0,0.0,-202.0,483000.0,0.0,-483000.0
<a href=/player/martf002>martf002</a>,Fernando Martinez,Houston Astros,ASTROS,1,1,1,2,2013,2013,0,Yes,0,0.0,0.0,0.0,0,0,0,0,0,0,0.0,0.0,0.0,493000.0,0.0,-493000.0
<a href=/player/martf003>martf003</a>,Francis Martes,Miami Marlins,MARLNS,7,20,18,38,2014,2020,6,Yes,0,36.69,11.6,-25.09,2821,868,-1953,6455,1964,-4491,3539.0,2374.0,-1165.0,18850000.0,0.0,-18850000.0
<a href=/player/martg101>martg101</a>,Gene Martin,Washington Senators,RNGRS,8,16,13,29,1970,1982,12,No,0,21.36,8.18,-13.18,1080,728,-352,2708,1819,-889,4391.0,989.0,-3402.0,326500.0,0.0,-326500.0
<a href=/player/marth101>marth101</a>,Hersh Martin,Milwaukee,Milwaukee,2,2,5,7,1944,1944,0,No,0,4.9,0.0,-4.9,202,0,-202,847,0,-847,0.0,0.0,0.0,0.0,0.0,0.0
<a href=/player/martj001>martj001</a>,Jerry Martin,Philadelphia Phillies,PHILS,7,17,13,30,1979,1999,20,No,0,25.6,38.01,12.41,2807,3562,755,9986,9588,-398,522.0,1259.0,737.0,2950000.0,0.0,-2950000.0
<a href=/player/martj001>martj001</a>,Jerry Martin,Chicago Cubs,CUBS,1,3,2,5,1980,1980,0,No,0,-0.93,0.0,0.93,72,0,-72,267,0,-267,0.0,0.0,0.0,0.0,0.0,0.0
<a href=/player/martj001>martj001</a>,Jerry Martin,San Francisco Giants,GIANTS,4,5,5,10,1981,1986,5,No,0,-1.3,6.67,7.97,316,383,67,745,545,-200,372.0,2489.0,2117.0,552000.0,0.0,-552000.0
<a href=/player/martj002>martj002</a>,Jose Martinez,Florida Marlins,MARLNS,16,36,40,76,1993,2019,26,Yes,0,141.98,107.88,-34.1,6566,6100,-466,15461,18577,3116,13532.0,10298.0,-3234.0,68689667.0,0.0,-68689667.0
<a href=/player/martj004>martj004</a>,Joe Martinez,San Francisco Giants,GIANTS,1,2,1,3,2010,2016,6,No,0,0.17,5.3,5.13,55,867,812,96,4,-92,26.0,753.0,727.0,410000.0,0.0,-410000.0
<a href=/player/martj006>martj006</a>,J.D. Martinez,Detroit Tigers,TIGRS,1,1,3,4,2017,2021,4,Yes,0,2.41,-1.37,-3.78,62,123,61,257,423,166,0.0,0.0,0.0,0.0,0.0,0.0
<a href=/player/martj007>martj007</a>,Jefry Marte,New York Mets,METS,2,2,2,4,2012,2013,1,Yes,0,2.7,-0.46,-3.16,211,23,-188,466,63,-403,0.0,0.0,0.0,493520.0,0.0,-493520.0
<a href=/player/martj007>martj007</a>,Jefry Marte,Detroit Tigers,TIGRS,1,1,1,2,2016,2016,0,Yes,0,0.25,0.0,-0.25,223,0,-223,638,0,-638,0.0,0.0,0.0,0.0,0.0,0.0
<a href=/player/martj008>martj008</a>,Jose Martinez,St. Louis Cardinals,CARDS,1,3,3,6,2020,2020,0,Yes,0,5.13,0.0,-5.13,188,0,-188,756,0,-756,0.0,0.0,0.0,0.0,0.0,0.0
<a href=/player/martj008>martj008</a>,Jose Martinez,Tampa Bay Devil Rays,RAYS,1,1,2,3,2020,2020,0,Yes,0,-0.6,0.0,0.6,10,0,-10,22,0,-22,0.0,0.0,0.0,0.0,0.0,0.0
<a href=/player/martj009>martj009</a>,Jason Martin,Houston Astros,ASTROS,1,4,1,5,2018,2019,1,No,0,3.26,12.09,8.83,813,71,-742,1676,16,-1660,1316.0,1238.0,-78.0,0.0,0.0,0.0
<a href=/player/martj010>martj010</a>,Jose Marte,San Francisco Giants,GIANTS,1,3,1,4,2021,2021,0,No,0,-0.36,0.65,1.01,27,52,25,0,0,0,63.0,73.0,10.0,0.0,0.0,0.0
<a href=/player/martj101>martj101</a>,John Martin,Detroit Tigers,TIGRS,1,2,1,3,1980,1981,1,No,0,1.37,0.54,-0.83,153,67,-86,89,195,106,831.0,0.0,-831.0,0.0,0.0,0.0
<a href=/player/martj102>martj102</a>,Joe Marty,SanFrancisco,SanFrancisco,1,1,4,5,1936,1939,3,No,0,-0.58,0.0,0.58,187,0,-187,664,0,-664,0.0,0.0,0.0,0.0,0.0,0.0
<a href=/player/martj102>martj102</a>,Joe Marty,Chicago Cubs,CUBS,1,3,1,4,1939,1947,8,No,0,6.07,34.45,28.38,546,585,39,1567,751,-816,1708.0,5741.0,4033.0,9500.0,0.0,-9500.0
<a href=/player/martj105>martj105</a>,Joe Martin,New York Giants,GIANTS,4,6,4,10,1936,1945,9,No,0,3.9,-0.67,-4.57,337,256,-81,591,680,89,1753.0,409.0,-1344.0,0.0,0.0,0.0
<a href=/player/martj107>martj107</a>,J.C. Martin,Chicago White Sox,WSOX,3,5,5,10,1967,1971,4,No,0,9.67,-0.45,-10.12,1085,468,-617,4072,1523,-2549,79.0,0.0,-79.0,35500.0,0.0,-35500.0
<a href=/player/martj107>martj107</a>,J.C. Martin,New York Mets,METS,1,1,1,2,1970,1970,0,No,0,-0.66,0.0,0.66,112,0,-112,299,0,-299,0.0,0.0,0.0,0.0,0.0,0.0
<a href=/player/martj108>martj108</a>,Joe Martin,Washington Senators,TWINS,1,1,1,2,1903,1903,0,No,0,-0.42,-0.01,0.41,44,63,19,189,234,45,0.0,0.0,0.0,0.0,0.0,0.0
<a href=/player/martj109>martj109</a>,Jack Martin,New York Yankees,YANKS,1,2,1,3,1912,1912,0,No,0,0.0,-0.21,-0.21,0,41,41,0,175,175,0.0,0.0,0.0,0.0,0.0,0.0
<a href=/player/martj109>martj109</a>,Jack Martin,Boston Braves,BRAVES,1,1,1,2,1914,1915,1,No,0,-0.56,-0.55,0.01,83,51,-32,333,152,-181,0.0,0.0,0.0,0.0,0.0,0.0
<a href=/player/martj109>martj109</a>,Jack Martin,Philadelphia Phillies,PHILS,1,1,1,2,1916,1916,0,No,0,0.0,0.0,0.0,0,0,0,0,0,0,0.0,0.0,0.0,0.0,0.0,0.0
<a href=/player/martk001>martk001</a>,Ketel Marte,Seattle Mariners,MARNRS,4,9,8,17,2016,2019,3,Yes,0,31.56,9.44,-22.12,1249,337,-912,4632,1487,-3145,656.0,14.0,-642.0,18394000.0,0.0,-18394000.0
<a href=/player/martl001>martl001</a>,Luis Martinez,St. Louis Cardinals,CARDS,1,3,1,4,2004,2005,1,No,0,0.0,3.28,3.28,0,144,144,0,545,545,0.0,0.0,0.0,0.0,0.0,0.0
<a href=/player/martl002>martl002</a>,Luis Martinez,San Diego Padres,PADRS,1,1,1,2,2011,2013,2,No,0,-0.3,0.0,0.3,10,0,-10,19,0,-19,0.0,0.0,0.0,0.0,0.0,0.0
<a href=/player/martl004>martl004</a>,Leonys Martin,Texas Rangers,RNGRS,2,3,4,7,2015,2020,5,Yes,0,1.97,-1.24,-3.21,224,21,-203,698,0,-698,144.0,64.0,-80.0,5475000.0,0.0,-5475000.0
<a href=/player/martl004>martl004</a>,Leonys Martin,Seattle Mariners,MARNRS,1,2,1,3,2017,2017,0,No,0,0.18,0.0,-0.18,16,0,-16,16,0,-16,2.0,0.0,-2.0,4850000.0,0.0,-4850000.0
<a href=/player/martl004>martl004</a>,Leonys Martin,Detroit Tigers,TIGRS,1,2,1,3,2018,2018,0,Yes,0,0.14,0.0,-0.14,71,0,-71,281,0,-281,0.0,0.0,0.0,1750000.0,0.0,-1750000.0
<a href=/player/martm001>martm001</a>,Mike Martin,Milwaukee Brewers,BREWRS,1,1,2,3,1986,1986,0,No,0,-0.31,0.0,0.31,8,0,-8,15,0,-15,0.0,0.0,0.0,0.0,0.0,0.0
<a href=/player/martm003>martm003</a>,Michael Martinez,Cleveland Indians,INDINS,1,1,1,2,2017,2017,0,No,0,-0.29,0.0,0.29,13,0,-13,29,0,-29,0.0,0.0,0.0,0.0,0.0,0.0
<a href=/player/martm101>martm101</a>,Morrie Martin,Philadelphia Athletics,ATLTCS,3,5,7,12,1954,1956,2,No,0,1.85,3.26,1.41,238,491,253,141,1005,864,434.0,737.0,303.0,0.0,0.0,0.0
<a href=/player/martm101>martm101</a>,Morrie Martin,Cleveland Indians,INDINS,2,4,3,7,1959,1960,1,No,0,-1.11,0.25,1.36,167,69,-98,374,39,-335,7.0,147.0,140.0,0.0,0.0,0.0
<a href=/player/martm101>martm101</a>,Morrie Martin,Houston Astros,ASTROS,1,1,1,2,1961,1963,2,No,0,0.0,-0.21,-0.21,0,82,82,0,264,264,0.0,0.0,0.0,0.0,0.0,0.0
<a href=/player/martm102>martm102</a>,Marty Martinez,Atlanta Braves,BRAVES,2,2,2,4,1968,1972,4,No,0,-2.29,-1.21,1.08,290,194,-96,814,368,-446,2.0,155.0,153.0,0.0,0.0,0.0
<a href=/player/martm102>martm102</a>,Marty Martinez,Houston Astros,ASTROS,1,1,1,2,1971,1973,2,No,0,0.02,-0.52,-0.54,9,27,18,7,38,31,0.0,0.0,0.0,0.0,0.0,0.0
<a href=/player/martm102>martm102</a>,Marty Martinez,St. Louis Cardinals,CARDS,1,1,1,2,1972,1972,0,No,0,-0.48,-0.26,0.22,22,13,-9,44,19,-25,0.0,0.0,0.0,0.0,0.0,0.0
<a href=/player/martm102>martm102</a>,Marty Martinez,Oakland Athletics,ATLTCS,2,4,3,7,1972,1975,3,No,0,-3.14,2.17,5.31,448,341,-107,1329,643,-686,48.0,183.0,135.0,42500.0,0.0,-42500.0
<a href=/player/marto001>marto001</a>,Osvaldo Martinez,Florida Marlins,MARLNS,1,2,2,4,2011,2011,0,No,0,0.17,0.0,-0.17,2,0,-2,0,0,0,8.0,0.0,-8.0,0.0,0.0,0.0
<a href=/player/marto001>marto001</a>,Osvaldo Martinez,Los Angeles Dodgers,DOGRS,1,1,1,2,2014,2014,0,Yes,0,0.0,0.0,0.0,0,0,0,0,0,0,0.0,0.0,0.0,0.0,0.0,0.0
<a href=/player/martp001>martp001</a>,Pedro Martinez,Los Angeles Dodgers,DOGRS,4,4,4,8,1993,2006,13,No,1,18.42,3.83,-14.59,281,418,137,296,1552,1256,2488.0,59.0,-2429.0,446500.0,0.0,-446500.0
<a href=/player/martp001>martp001</a>,Pedro Martinez,Montreal Expos,NATEX,3,7,8,15,1997,2006,9,No,0,60.76,10.18,-50.58,703,769,66,669,669,0,5870.0,5152.0,-718.0,8427500.0,0.0,-8427500.0
<a href=/player/martp002>martp002</a>,Pedro Martinez,San Diego Padres,PADRS,16,32,32,64,1994,2010,16,No,6,18.63,52.35,33.72,3699,4432,733,12670,15324,2654,1244.0,1789.0,545.0,25389800.0,0.0,-25389800.0
<a href=/player/martp002>martp002</a>,Pedro Martinez,Houston Astros,ASTROS,1,1,1,2,1995,1996,1,No,0,0.0,0.0,0.0,0,0,0,0,0,0,0.0,0.0,0.0,175000.0,0.0,-175000.0
<a href=/player/martp002>martp002</a>,Pedro Martinez,San Diego Padres,PADRS,1,1,1,2,1995,1996,1,No,0,-0.24,0.0,0.24,10,0,-10,0,0,0,21.0,0.0,-21.0,0.0,0.0,0.0
<a href=/player/martp003>martp003</a>,Pablo Martinez,San Diego Padres,PADRS,2,4,3,7,1993,2000,7,No,0,-0.42,-0.7,-0.28,28,54,26,3,11,8,67.0,168.0,101.0,326000.0,0.0,-326000.0
<a href=/player/martr001>martr001</a>,Renie Martin,Kansas City Royals,ROYALS,3,7,5,12,1982,1990,8,No,0,15.6,24.69,9.09,1105,393,-712,1343,512,-831,5715.0,4650.0,-1065.0,1318000.0,0.0,-1318000.0
<a href=/player/martr001>martr001</a>,Renie Martin,San Francisco Giants,GIANTS,2,4,3,7,1984,1992,8,No,0,-0.69,5.26,5.95,80,443,363,148,292,144,73.0,2798.0,2725.0,0.0,0.0,0.0
<a href=/player/martr003>martr003</a>,Ramon Martinez,Kansas City Royals,ROYALS,2,2,2,4,1996,1997,1,No,0,3.32,0.0,-3.32,368,0,-368,1045,0,-1045,0.0,0.0,0.0,0.0,0.0,0.0
<a href=/player/martr003>martr003</a>,Ramon Martinez,Detroit Tigers,TIGRS,1,2,1,3,2005,2009,4,No,0,-0.18,19.15,19.33,143,632,489,65,2819,2754,157.0,0.0,-157.0,5025000.0,0.0,-5025000.0
<a href=/player/martr004>martr004</a>,Russell Martin,Toronto Blue Jays,BJAYS,1,2,2,4,2019,2019,0,Yes,0,0.72,0.0,-0.72,87,0,-87,249,0,-249,12.0,0.0,-12.0,0.0,0.0,0.0
<a href=/player/martr101>martr101</a>,Randy Martz,Chicago Cubs,CUBS,3,6,6,12,1983,1990,7,No,0,9.95,11.91,1.96,748,630,-118,2292,307,-1985,429.0,3028.0,2599.0,890000.0,0.0,-890000.0
<a href=/player/marts001>marts001</a>,Shairon Martis,San Francisco Giants,GIANTS,3,3,4,7,2006,2015,9,No,1,-1.3,4.45,5.75,180,251,71,372,852,480,319.0,70.0,-249.0,0.0,0.0,0.0
<a href=/player/marts002>marts002</a>,Starling Marte,Pittsburgh Pirates,PIRATS,1,2,3,5,2020,2020,0,Yes,0,1.09,0.0,-1.09,33,0,-33,138,0,-138,0.0,0.0,0.0,0.0,0.0,0.0
<a href=/player/marts002>marts002</a>,Starling Marte,Arizona Diamondbacks,DBACKS,1,1,3,4,2020,2020,0,Yes,0,3.3,0.27,-3.03,92,4,-88,387,0,-387,0.0,33.0,33.0,0.0,0.0,0.0
<a href=/player/marts002>marts002</a>,Starling Marte,Miami Marlins,MARLNS,1,1,1,2,2021,2021,0,Yes,0,1.92,-0.51,-2.43,56,23,-33,251,19,-232,0.0,172.0,172.0,0.0,0.0,0.0
<a href=/player/marts101>marts101</a>,Silvio Martinez,Pittsburgh Pirates,PIRATS,3,7,4,11,1976,1986,10,No,1,2.54,8.92,6.38,174,586,412,599,933,334,146.0,661.0,515.0,0.0,0.0,0.0
<a href=/player/marts101>marts101</a>,Silvio Martinez,Chicago White Sox,WSOX,1,3,1,4,1977,1978,1,No,0,1.03,-0.14,-1.17,221,8,-213,205,0,-205,1727.0,34.0,-1693.0,0.0,0.0,0.0
<a href=/player/marts101>marts101</a>,Silvio Martinez,St. Louis Cardinals,CARDS,2,3,2,5,1981,1990,9,No,0,6.11,11.74,5.63,370,733,363,1263,2386,1123,1236.0,0.0,-1236.0,740000.0,0.0,-740000.0
<a href=/player/marts103>marts103</a>,Stu Martin,Minneapolis,Minneapolis,1,1,1,2,1943,1943,0,No,0,0.36,0.0,-0.36,64,0,-64,136,0,-136,0.0,0.0,0.0,0.0,0.0,0.0
<a href=/player/martt001>martt001</a>,Tippy Martinez,New York Yankees,YANKS,14,28,25,53,1976,2001,25,No,1,121.7,35.26,-86.44,6187,2228,-3959,13911,5384,-8527,21228.0,6192.0,-15036.0,4415000.0,0.0,-4415000.0
<a href=/player/martt002>martt002</a>,Tino Martinez,Seattle Mariners,MARNRS,3,7,5,12,1995,1999,4,No,0,28.82,-1.18,-30.0,1743,533,-1210,4473,1676,-2797,3491.0,1076.0,-2415.0,2835000.0,0.0,-2835000.0
<a href=/player/martt002>martt002</a>,Tino Martinez,St. Louis Cardinals,CARDS,1,1,2,3,2003,2003,0,No,0,2.35,0.0,-2.35,138,0,-138,538,0,-538,0.0,0.0,0.0,7500000.0,0.0,-7500000.0
<a href=/player/martt003>martt003</a>,Tom Martin,Baltimore Orioles,ORLS,1,2,2,4,1992,1992,0,No,0,0.0,0.0,0.0,0,0,0,0,0,0,0.0,0.0,0.0,0.0,0.0,0.0
<a href=/player/martt003>martt003</a>,Tom Martin,Arizona Diamondbacks,DBACKS,1,3,1,4,1997,2003,6,No,0,6.04,8.29,2.25,656,595,-61,2425,2462,37,172.0,0.0,-172.0,0.0,0.0,0.0
<a href=/player/martt003>martt003</a>,Tom Martin,Cleveland Indians,INDINS,1,1,1,2,2001,2001,0,No,0,-0.92,0.0,0.92,28,0,-28,3,0,-3,51.0,0.0,-51.0,0.0,0.0,0.0
<a href=/player/martt003>martt003</a>,Tom Martin,Los Angeles Dodgers,DOGRS,1,1,1,2,2004,2004,0,No,0,-0.11,0.0,0.11,66,0,-66,0,0,0,58.0,0.0,-58.0,1400000.0,0.0,-1400000.0
<a href=/player/martt101>martt101</a>,Tony Martinez,St. Louis Cardinals,CARDS,1,3,3,6,1967,1967,0,No,0,-0.52,-0.9,-0.38,197,52,-145,651,76,-575,0.0,0.0,0.0,0.0,0.0,0.0
<a href=/player/martt102>martt102</a>,Ted Martinez,New York Mets,METS,2,2,3,5,1974,1978,4,No,0,-1.26,-0.69,0.57,90,265,175,188,805,617,0.0,0.0,0.0,0.0,0.0,0.0
<a href=/player/martt102>martt102</a>,Ted Martinez,St. Louis Cardinals,CARDS,3,3,4,7,1975,1977,2,No,0,-1.08,-0.15,0.93,139,18,-121,159,0,-159,66.0,23.0,-43.0,0.0,0.0,0.0
<a href=/player/martv001>martv001</a>,Victor Martinez,Cleveland Indians,INDINS,2,2,4,6,2009,2015,6,Yes,0,4.14,7.67,3.53,200,322,122,784,19,-765,92.0,3207.0,3115.0,5900000.0,0.0,-5900000.0
<a href=/player/masao001>masao001</a>,Onan Masaoka,Los Angeles Dodgers,DOGRS,1,3,2,5,2001,2001,0,No,0,0.0,0.96,0.96,0,24,24,0,27,27,0.0,238.0,238.0,0.0,0.0,0.0
<a href=/player/mashc101>mashc101</a>,Clyde Mashore,Cincinnati Reds,REDS,1,1,1,2,1970,1972,2,No,0,-1.18,0.77,1.95,239,117,-122,483,196,-287,0.0,0.0,0.0,0.0,0.0,0.0
<a href=/player/masip101>masip101</a>,Phil Masi,Boston Braves,BRAVES,2,4,2,6,1949,1949,0,No,0,1.49,-0.18,-1.67,141,79,-62,419,234,-185,0.0,0.0,0.0,0.0,0.0,0.0
<a href=/player/masod101>masod101</a>,Don Mason,San Francisco Giants,GIANTS,2,3,2,5,1970,1971,1,No,0,-1.33,0.72,2.05,165,78,-87,493,2,-491,0.0,134.0,134.0,0.0,0.0,0.0
<a href=/player/masoj101>masoj101</a>,Jim Mason,Toronto Blue Jays,BJAYS,2,4,2,6,1977,1990,13,No,1,-0.59,16.43,17.02,97,707,610,181,2168,1987,37.0,2317.0,2280.0,0.0,0.0,0.0
<a href=/player/masoj101>masoj101</a>,Jim Mason,Texas Rangers,RNGRS,1,1,1,2,1978,1978,0,No,0,-0.43,0.0,0.43,40,0,-40,78,0,-78,0.0,0.0,0.0,0.0,0.0,0.0
<a href=/player/masom001>masom001</a>,Mike Mason,Texas Rangers,RNGRS,1,1,1,2,1987,1990,3,No,0,0.17,0.0,-0.17,35,0,-35,13,0,-13,114.0,0.0,-114.0,0.0,0.0,0.0
<a href=/player/masor001>masor001</a>,Roger Mason,Detroit Tigers,TIGRS,2,3,2,5,1985,1986,1,No,0,-1.22,-0.38,0.84,75,106,31,94,226,132,347.0,0.0,-347.0,0.0,0.0,0.0
<a href=/player/masor001>masor001</a>,Roger Mason,New York Mets,METS,1,2,1,3,1992,1994,2,No,0,1.1,0.52,-0.58,68,170,102,3,6,3,150.0,357.0,207.0,0.0,0.0,0.0
<a href=/player/masor001>masor001</a>,Roger Mason,San Diego Padres,PADRS,1,1,1,2,1993,1995,2,No,0,-0.22,1.33,1.55,80,136,56,3,9,6,175.0,277.0,102.0,300000.0,0.0,-300000.0
<a href=/player/massn001>massn001</a>,Nick Masset,Texas Rangers,RNGRS,1,3,2,5,2006,2010,4,No,0,19.87,1.7,-18.17,323,47,-276,31,7,-24,4762.0,663.0,-4099.0,0.0,0.0,0.0
<a href=/player/massn001>massn001</a>,Nick Masset,Chicago White Sox,WSOX,1,2,2,4,2008,2008,0,No,0,3.05,0.44,-2.61,495,41,-454,49,150,101,721.0,0.0,-721.0,396000.0,0.0,-396000.0
<a href=/player/mastj001>mastj001</a>,Justin Masterson,Boston Red Sox,RSOX,2,4,3,7,2009,2017,8,No,2,7.47,5.01,-2.46,325,200,-125,19,777,758,3215.0,255.0,-2960.0,415500.0,0.0,-415500.0
<a href=/player/mastj001>mastj001</a>,Justin Masterson,Cleveland Indians,INDINS,1,1,1,2,2014,2014,0,Yes,0,-0.77,0.0,0.77,17,0,-17,9,0,-9,92.0,0.0,-92.0,0.0,0.0,0.0
<a href=/player/mastt001>mastt001</a>,Tom Mastny,Toronto Blue Jays,BJAYS,1,1,1,2,2004,2005,1,No,0,-0.67,1.16,1.83,86,37,-49,0,106,106,282.0,0.0,-282.0,0.0,0.0,0.0
<a href=/player/mastw101>mastw101</a>,Walt Masterson,Washington Senators,TWINS,8,10,14,24,1949,1962,13,No,0,-0.51,10.55,11.06,754,2784,2030,1851,8045,6194,1009.0,3394.0,2385.0,39500.0,0.0,-39500.0
<a href=/player/mastw101>mastw101</a>,Walt Masterson,Boston Red Sox,RSOX,1,2,1,3,1952,1955,3,No,0,3.27,3.29,0.02,146,168,22,161,116,-45,1293.0,1085.0,-208.0,12000.0,0.0,-12000.0
<a href=/player/matct101>matct101</a>,Tommy Matchick,Detroit Tigers,TIGRS,4,7,4,11,1969,1975,6,No,0,-1.28,-0.46,0.82,179,375,196,373,892,519,4.0,0.0,-4.0,118300.0,0.0,-118300.0
<a href=/player/matct101>matct101</a>,Tommy Matchick,Boston Red Sox,RSOX,2,2,2,4,1970,1972,2,No,0,-0.02,-1.44,-1.42,72,137,65,178,218,40,0.0,0.0,0.0,22000.0,0.0,-22000.0
<a href=/player/matct101>matct101</a>,Tommy Matchick,Kansas City Royals,ROYALS,1,1,1,2,1971,1971,0,No,0,0.12,-0.39,-0.51,42,19,-23,122,32,-90,0.0,0.0,0.0,0.0,0.0,0.0
<a href=/player/matct101>matct101</a>,Tommy Matchick,Milwaukee Brewers,BREWRS,2,3,3,6,1971,1973,2,No,0,-0.12,-0.77,-0.65,3,126,123,9,406,397,0.0,22.0,22.0,18000.0,0.0,-18000.0
<a href=/player/matct101>matct101</a>,Tommy Matchick,Baltimore Orioles,ORLS,1,1,1,2,1973,1973,0,No,0,0.0,0.11,0.11,0,44,44,0,71,71,0.0,0.0,0.0,0.0,0.0,0.0
<a href=/player/matej001>matej001</a>,Julio Mateo,Seattle Mariners,MARNRS,1,1,1,2,2007,2011,4,No,0,0.0,0.0,0.0,0,0,0,0,0,0,0.0,0.0,0.0,1075000.0,0.0,-1075000.0
<a href=/player/matej003>matej003</a>,Jorge Mateo,New York Yankees,YANKS,4,8,7,15,2017,2021,4,No,0,10.37,1.61,-8.76,335,144,-191,733,363,-370,1504.0,587.0,-917.0,0.0,0.0,0.0
<a href=/player/matej003>matej003</a>,Jorge Mateo,Oakland Athletics,ATLTCS,1,1,1,2,2020,2020,0,Yes,0,-0.18,0.0,0.18,79,0,-79,121,0,-121,0.0,0.0,0.0,0.0,0.0,0.0
<a href=/player/matem001>matem001</a>,Marcos Mateo,Cincinnati Reds,REDS,2,2,2,4,2007,2009,2,No,0,-0.01,-0.15,-0.14,96,20,-76,10,38,28,134.0,0.0,-134.0,0.0,0.0,0.0
<a href=/player/mater001>mater001</a>,Ruben Mateo,Texas Rangers,RNGRS,1,2,1,3,2001,2003,2,No,0,2.17,-0.72,-2.89,634,36,-598,2326,2,-2324,0.0,598.0,598.0,300000.0,0.0,-300000.0
<a href=/player/mathc102>mathc102</a>,Christy Mathewson,Cincinnati Reds,REDS,1,1,1,2,1900,1900,0,No,0,106.61,0.0,-106.61,1281,0,-1281,1886,0,-1886,14339.0,0.0,-14339.0,0.0,0.0,0.0
<a href=/player/mathc102>mathc102</a>,Christy Mathewson,New York Giants,GIANTS,3,6,6,12,1916,1923,7,No,0,51.71,19.99,-31.72,1982,727,-1255,7625,1751,-5874,2062.0,3773.0,1711.0,15800.0,0.0,-15800.0
<a href=/player/mathe101>mathe101</a>,Eddie Mathews,Houston Astros,ASTROS,1,1,2,3,1967,1973,6,No,0,1.09,1.07,-0.02,67,466,399,185,26,-159,0.0,791.0,791.0,57500.0,0.0,-57500.0
<a href=/player/mathe101>mathe101</a>,Eddie Mathews,Atlanta Braves,BRAVES,1,3,2,5,1966,1968,2,No,0,0.94,-0.28,-1.22,101,10,-91,383,29,-354,0.0,0.0,0.0,57500.0,0.0,-57500.0
<a href=/player/mathj001>mathj001</a>,Jeff Mathis,Anaheim Angels,ANGELS,1,1,1,2,2011,2013,2,No,0,0.67,0.3,-0.37,72,1,-71,227,0,-227,6.0,15.0,9.0,1700000.0,0.0,-1700000.0
<a href=/player/mathj001>mathj001</a>,Jeff Mathis,Toronto Blue Jays,BJAYS,3,15,11,26,2012,2018,6,No,0,24.75,21.38,-3.37,2099,1087,-1012,5739,3162,-2577,4668.0,4579.0,-89.0,8732900.0,0.0,-8732900.0
<a href=/player/mathm002>mathm002</a>,Mark Mathias,Cleveland Indians,INDINS,1,1,1,2,2019,2019,0,Yes,0,0.04,0.0,-0.04,16,0,-16,36,0,-36,0.0,0.0,0.0,0.0,0.0,0.0
<a href=/player/mathn101>mathn101</a>,Nelson Mathews,Chicago Cubs,CUBS,2,2,2,4,1963,1967,4,No,0,-1.1,-0.87,0.23,284,24,-260,842,13,-829,186.0,123.0,-63.0,0.0,0.0,0.0
<a href=/player/matht001>matht001</a>,Terry Mathews,Florida Marlins,MARLNS,1,1,1,2,1996,1998,2,No,0,0.38,0.01,-0.37,95,174,79,0,545,545,307.0,0.0,-307.0,292500.0,0.0,-292500.0
<a href=/player/matht002>matht002</a>,T.J. Mathews,St. Louis Cardinals,CARDS,1,3,1,4,1997,1997,0,No,0,-0.38,2.04,2.42,256,51,-205,9,224,215,1161.0,0.0,-1161.0,395000.0,0.0,-395000.0
<a href=/player/matij101>matij101</a>,John Matias,Baltimore Orioles,ORLS,2,4,4,8,1967,1973,6,No,0,9.46,19.82,10.36,579,770,191,2185,2951,766,146.0,306.0,160.0,72000.0,0.0,-72000.0
<a href=/player/matij101>matij101</a>,John Matias,Chicago White Sox,WSOX,2,3,3,6,1970,1977,7,No,0,5.23,5.15,-0.08,607,692,85,1743,2721,978,0.0,0.0,0.0,15000.0,0.0,-15000.0
<a href=/player/matlj101>matlj101</a>,Jon Matlack,New York Mets,METS,26,52,48,100,1977,2019,42,No,4,56.33,112.66,56.33,4151,7728,3577,7970,17107,9137,11489.0,13190.0,1701.0,33115923.0,0.0,-33115923.0
<a href=/player/matoj001>matoj001</a>,Julius Matos,Montreal Expos,NATEX,1,1,1,2,2004,2004,0,No,0,0.0,0.0,0.0,0,0,0,0,0,0,0.0,0.0,0.0,0.0,0.0,0.0
<a href=/player/matop002>matop002</a>,Phil Maton,San Diego Padres,PADRS,1,1,1,2,2019,2019,0,No,0,0.14,0.0,-0.14,76,0,-76,1,0,-1,226.0,0.0,-226.0,562900.0,0.0,-562900.0
<a href=/player/matop002>matop002</a>,Phil Maton,Cleveland Indians,INDINS,1,2,1,3,2021,2021,0,Yes,0,-0.24,1.78,2.02,31,60,29,0,268,268,76.0,0.0,-76.0,975000.0,0.0,-975000.0
<a href=/player/matsk001>matsk001</a>,Kazuo Matsui,New York Mets,METS,1,2,1,3,2006,2006,0,No,0,3.93,0.05,-3.88,136,25,-111,579,41,-538,0.0,0.0,0.0,8033333.0,0.0,-8033333.0
<a href=/player/mattb101>mattb101</a>,Bobby Mattick,Chicago Cubs,CUBS,1,2,1,3,1940,1940,0,No,0,0.59,0.0,-0.59,137,0,-137,458,0,-458,0.0,0.0,0.0,0.0,0.0,0.0
<a href=/player/matte101>matte101</a>,Earl Mattingly,Brooklyn Dodgers,DOGRS,3,7,4,11,1932,1944,12,No,0,2.72,9.15,6.43,227,1029,802,615,3670,3055,390.0,469.0,79.0,10000.0,0.0,-10000.0
<a href=/player/mattg001>mattg001</a>,Gary Matthews,Atlanta Braves,BRAVES,1,1,1,2,1981,1984,3,No,0,4.79,-0.95,-5.74,395,90,-305,1644,74,-1570,0.0,634.0,634.0,0.0,0.0,0.0
<a href=/player/mattg001>mattg001</a>,Gary Matthews,Philadelphia Phillies,PHILS,3,6,4,10,1984,1986,2,No,0,8.36,-0.43,-8.79,1292,232,-1060,3847,16,-3831,227.0,557.0,330.0,0.0,0.0,0.0
<a href=/player/mattg001>mattg001</a>,Gary Matthews,Chicago Cubs,CUBS,1,1,1,2,1987,1987,0,No,0,-0.82,0.0,0.82,45,0,-45,135,0,-135,0.0,0.0,0.0,880000.0,0.0,-880000.0
<a href=/player/mattg002>mattg002</a>,Gary Matthews,San Diego Padres,PADRS,1,1,1,2,2000,2002,2,No,0,-0.01,-1.1,-1.09,186,104,-82,477,3,-474,0.0,212.0,212.0,0.0,0.0,0.0
<a href=/player/mattg002>mattg002</a>,Gary Matthews,New York Mets,METS,1,1,1,2,2002,2003,1,No,0,1.85,0.0,-1.85,150,0,-150,569,0,-569,0.0,0.0,0.0,237500.0,0.0,-237500.0
<a href=/player/mattg002>mattg002</a>,Gary Matthews,Anaheim Angels,ANGELS,1,2,1,3,2010,2010,0,No,0,-0.59,-0.59,0.0,36,16,-20,65,0,-65,0.0,50.0,50.0,0.0,0.0,0.0
<a href=/player/matti001>matti001</a>,Isaac Mattson,Anaheim Angels,ANGELS,1,4,1,5,2019,2021,2,No,0,0.0,1.39,1.39,4,37,33,0,4,4,13.0,469.0,456.0,0.0,0.0,0.0
<a href=/player/mattm001>mattm001</a>,Mike Matthews,Cleveland Indians,INDINS,1,1,1,2,1999,1999,0,No,0,0.0,0.0,0.0,0,0,0,0,0,0,0.0,0.0,0.0,0.0,0.0,0.0
<a href=/player/mattm001>mattm001</a>,Mike Matthews,Boston Red Sox,RSOX,1,2,1,3,1999,1999,0,No,0,1.49,0.53,-0.96,212,5,-207,24,0,-24,420.0,77.0,-343.0,0.0,0.0,0.0
<a href=/player/mattm001>mattm001</a>,Mike Matthews,St. Louis Cardinals,CARDS,1,2,2,4,2002,2002,0,No,0,0.04,0.01,-0.03,8,8,0,1,6,5,12.0,45.0,33.0,300000.0,0.0,-300000.0
<a href=/player/mattr001>mattr001</a>,Ryan Mattheus,Colorado Rockies,ROCKS,1,2,1,3,2009,2010,1,No,0,1.26,1.09,-0.17,282,192,-90,1,1,0,427.0,182.0,-245.0,0.0,0.0,0.0
<a href=/player/mattw103>mattw103</a>,Wid Matthews,Milwaukee,Milwaukee,1,1,2,3,1922,1922,0,No,0,-0.66,0.0,0.66,129,0,-129,543,0,-543,0.0,0.0,0.0,0.0,0.0,0.0
<a href=/player/mattw103>mattw103</a>,Wid Matthews,Philadelphia Athletics,ATLTCS,1,4,1,5,1923,1932,9,No,0,0.0,51.22,51.22,0,1240,1240,0,5473,5473,0.0,0.0,0.0,9900.0,0.0,-9900.0
<a href=/player/mattw103>mattw103</a>,Wid Matthews,Milwaukee,Milwaukee,4,4,9,13,1924,1927,3,No,0,7.22,0.0,-7.22,846,0,-846,3377,0,-3377,0.0,0.0,0.0,0.0,0.0,0.0
<a href=/player/mattw103>mattw103</a>,Wid Matthews,Washington Senators,TWINS,7,18,11,29,1924,1941,17,No,0,54.71,70.39,15.68,4079,2979,-1100,12814,11128,-1686,8820.0,3821.0,-4999.0,95600.0,0.0,-95600.0
<a href=/player/matub001>matub001</a>,Brian Matusz,Baltimore Orioles,ORLS,1,2,2,4,2016,2016,0,Yes,0,0.0,0.0,0.0,0,0,0,0,0,0,0.0,0.0,0.0,0.0,0.0,0.0
<a href=/player/matuh101>matuh101</a>,Harry Matuzak,Memphis,Memphis,1,1,1,2,1941,1941,0,No,0,0.0,0.0,0.0,0,0,0,0,0,0,0.0,0.0,0.0,0.0,0.0,0.0
<a href=/player/matul001>matul001</a>,Len Matuszek,Philadelphia Phillies,PHILS,1,1,3,4,1985,1985,0,No,0,-0.68,0.42,1.1,62,52,-10,166,3,-163,0.0,109.0,109.0,0.0,0.0,0.0
<a href=/player/matul001>matul001</a>,Len Matuszek,Toronto Blue Jays,BJAYS,1,1,1,2,1985,1985,0,No,0,0.99,-0.63,-1.62,150,61,-89,314,195,-119,0.0,0.0,0.0,185000.0,0.0,-185000.0
<a href=/player/matzs001>matzs001</a>,Steven Matz,New York Mets,METS,2,3,4,7,2021,2021,0,Yes,0,2.02,-0.87,-2.89,30,74,44,2,21,19,452.0,137.0,-315.0,0.0,0.0,0.0
<a href=/player/maucg101>maucg101</a>,Gene Mauch,Brooklyn Dodgers,DOGRS,1,5,2,7,1947,1947,0,No,0,3.3,-0.19,-3.49,337,37,-300,419,81,-338,1285.0,0.0,-1285.0,17500.0,0.0,-17500.0
<a href=/player/maucg101>maucg101</a>,Gene Mauch,Pittsburgh Pirates,PIRATS,1,3,3,6,1947,1950,3,No,0,26.56,1.84,-24.72,1156,287,-869,3340,710,-2630,3832.0,295.0,-3537.0,0.0,0.0,0.0
<a href=/player/maucg101>maucg101</a>,Gene Mauch,Chicago Cubs,CUBS,1,2,1,3,1949,1949,0,No,0,-0.08,0.0,0.08,67,0,-67,165,0,-165,0.0,0.0,0.0,0.0,0.0,0.0
<a href=/player/maurb001>maurb001</a>,Brandon Maurer,Seattle Mariners,MARNRS,2,2,3,5,2014,2017,3,No,0,0.4,2.01,1.61,429,302,-127,373,892,519,480.0,392.0,-88.0,504600.0,0.0,-504600.0
<a href=/player/maurb001>maurb001</a>,Brandon Maurer,San Diego Padres,PADRS,1,3,4,7,2017,2017,0,Yes,0,-1.51,-0.81,0.7,107,22,-85,1,17,16,304.0,157.0,-147.0,4194700.0,0.0,-4194700.0
<a href=/player/maurc101>maurc101</a>,Carmen Mauro,Chicago Cubs,CUBS,8,19,17,36,1951,1965,14,No,0,5.38,23.07,17.69,1413,1956,543,3848,2666,-1182,1451.0,4951.0,3500.0,82000.0,0.0,-82000.0
<a href=/player/maurc101>maurc101</a>,Carmen Mauro,Brooklyn Dodgers,DOGRS,1,1,1,2,1953,1953,0,No,0,-0.08,0.0,0.08,17,0,-17,24,0,-24,0.0,0.0,0.0,0.0,0.0,0.0
<a href=/player/maurc101>maurc101</a>,Carmen Mauro,Philadelphia Athletics,ATLTCS,46,109,116,225,1953,1976,23,No,0,189.08,109.39,-79.69,16486,13560,-2926,40867,38903,-1964,20759.0,16429.0,-4330.0,546100.0,0.0,-546100.0
<a href=/player/maust001>maust001</a>,Tim Mauser,Philadelphia Phillies,PHILS,1,1,1,2,1993,1994,1,No,0,1.33,-0.22,-1.55,136,80,-56,9,3,-6,277.0,175.0,-102.0,0.0,0.0,0.0
<a href=/player/maxcb001>maxcb001</a>,Brian Maxcy,Detroit Tigers,TIGRS,1,2,2,4,1996,1996,0,No,0,0.33,-0.3,-0.63,17,16,-1,37,0,-37,0.0,71.0,71.0,0.0,0.0,0.0
<a href=/player/maxvd101>maxvd101</a>,Dal Maxvill,St. Louis Cardinals,CARDS,2,3,4,7,1972,1974,2,No,0,0.42,0.24,-0.18,172,16,-156,196,0,-196,0.0,24.0,24.0,0.0,0.0,0.0
<a href=/player/maxwc101>maxwc101</a>,Charlie Maxwell,Detroit Tigers,TIGRS,1,1,1,2,1962,1962,0,No,0,1.73,-0.53,-2.26,142,36,-106,409,65,-344,0.0,0.0,0.0,0.0,0.0,0.0
<a href=/player/maxwj002>maxwj002</a>,Justin Maxwell,Washington Nationals,NATEX,1,1,1,2,2011,2011,0,No,0,0.0,0.0,0.0,0,0,0,0,0,0,0.0,0.0,0.0,0.0,0.0,0.0
<a href=/player/maxwj002>maxwj002</a>,Justin Maxwell,Houston Astros,ASTROS,1,1,1,2,2013,2013,0,Yes,0,-0.56,0.0,0.56,55,0,-55,156,0,-156,0.0,0.0,0.0,0.0,0.0,0.0
<a href=/player/may-b101>may-b101</a>,Buckshot May,Pittsburgh Pirates,PIRATS,1,1,2,3,1924,1927,3,No,0,0.0,0.53,0.53,0,98,98,0,46,46,0.0,457.0,457.0,2400.0,0.0,-2400.0
<a href=/player/may-c101>may-c101</a>,Carlos May,Chicago White Sox,WSOX,4,4,7,11,1976,1982,6,No,0,0.32,4.9,4.58,277,635,358,733,1658,925,726.0,1007.0,281.0,70000.0,0.0,-70000.0
<a href=/player/may-d001>may-d001</a>,Derrick May,Milwaukee Brewers,BREWRS,1,1,1,2,1995,1995,0,No,0,2.93,0.0,-2.93,187,0,-187,523,0,-523,0.0,0.0,0.0,0.0,0.0,0.0
<a href=/player/may-d002>may-d002</a>,Darrell May,Kansas City Royals,ROYALS,1,2,3,5,2004,2005,1,No,0,-0.35,0.13,0.48,40,137,97,10,489,479,178.0,0.0,-178.0,1750000.0,0.0,-1750000.0
<a href=/player/may-d002>may-d002</a>,Darrell May,San Diego Padres,PADRS,1,3,1,4,2005,2005,0,No,0,-0.82,0.3,1.12,3,44,41,0,1,1,24.0,95.0,71.0,3975000.0,0.0,-3975000.0
<a href=/player/may-d101>may-d101</a>,Dave May,Baltimore Orioles,ORLS,1,1,2,3,1970,1971,1,No,0,11.37,0.0,-11.37,717,0,-717,2798,0,-2798,0.0,0.0,0.0,14000.0,0.0,-14000.0
<a href=/player/may-d101>may-d101</a>,Dave May,Milwaukee Brewers,BREWRS,1,2,1,3,1974,1974,0,No,0,1.37,0.0,-1.37,187,0,-187,473,0,-473,0.0,0.0,0.0,0.0,0.0,0.0
<a href=/player/may-d101>may-d101</a>,Dave May,Atlanta Braves,BRAVES,3,8,3,11,1976,1983,7,No,0,3.71,6.12,2.41,495,566,71,1015,2078,1063,923.0,87.0,-836.0,33500.0,0.0,-33500.0
<a href=/player/may-j101>may-j101</a>,Jerry May,Pittsburgh Pirates,PIRATS,3,5,5,10,1970,1974,4,No,0,25.46,1.32,-24.14,1582,453,-1129,5382,666,-4716,1881.0,1147.0,-734.0,76500.0,0.0,-76500.0
<a href=/player/may-l001>may-l001</a>,Lucas May,Los Angeles Dodgers,DOGRS,1,2,1,3,2010,2010,0,No,0,-0.45,-0.69,-0.24,12,39,27,39,160,121,0.0,0.0,0.0,0.0,0.0,0.0
<a href=/player/may-l001>may-l001</a>,Lucas May,Kansas City Royals,ROYALS,1,1,1,2,2011,2011,0,No,0,0.0,0.0,0.0,0,0,0,0,0,0,0.0,0.0,0.0,0.0,0.0,0.0
<a href=/player/may-l101>may-l101</a>,Lee May,Cincinnati Reds,REDS,7,9,14,23,1971,1982,11,No,1,32.36,75.99,43.63,1555,3237,1682,4173,10169,5996,5915.0,4444.0,-1471.0,0.0,0.0,0.0
<a href=/player/may-l101>may-l101</a>,Lee May,Houston Astros,ASTROS,6,9,10,19,1974,1989,15,No,0,0.9,31.67,30.77,1396,3000,1604,4891,8483,3592,0.0,5622.0,5622.0,705000.0,0.0,-705000.0
<a href=/player/may-m001>may-m001</a>,Milt May,Pittsburgh Pirates,PIRATS,5,7,8,15,1973,2001,28,No,2,29.24,55.22,25.98,976,1588,612,1462,2520,1058,5981.0,12549.0,6568.0,1290000.0,0.0,-1290000.0
<a href=/player/may-m001>may-m001</a>,Milt May,Houston Astros,ASTROS,6,11,9,20,1975,1989,14,No,0,10.73,12.05,1.32,1452,1687,235,3403,4505,1102,3386.0,1859.0,-1527.0,22500.0,0.0,-22500.0
<a href=/player/may-m001>may-m001</a>,Milt May,San Francisco Giants,GIANTS,1,2,1,3,1983,1984,1,No,0,-0.33,0.32,0.65,57,63,6,120,181,61,0.0,0.0,0.0,280000.0,0.0,-280000.0
<a href=/player/may-r101>may-r101</a>,Rudy May,Chicago White Sox,WSOX,2,3,5,8,1964,1967,3,No,0,2.05,-0.33,-2.38,164,75,-89,481,41,-440,0.0,379.0,379.0,13000.0,0.0,-13000.0
<a href=/player/may-r101>may-r101</a>,Rudy May,Philadelphia Phillies,PHILS,1,2,1,3,1964,1966,2,No,0,4.55,-0.7,-5.25,450,79,-371,427,37,-390,3416.0,375.0,-3041.0,5400.0,0.0,-5400.0
<a href=/player/may-r101>may-r101</a>,Rudy May,New York Yankees,YANKS,14,28,25,53,1976,2001,25,No,1,121.7,35.26,-86.44,6187,2228,-3959,13911,5384,-8527,21228.0,6192.0,-15036.0,4415000.0,0.0,-4415000.0
<a href=/player/may-r101>may-r101</a>,Rudy May,Baltimore Orioles,ORLS,6,10,10,20,1977,1994,17,No,1,25.87,32.91,7.04,988,1932,944,938,5757,4819,6735.0,2646.0,-4089.0,713333.0,0.0,-713333.0
<a href=/player/may-s001>may-s001</a>,Scott May,Los Angeles Dodgers,DOGRS,2,2,2,4,1987,1989,2,No,0,0.39,0.0,-0.39,80,0,-80,187,0,-187,22.0,0.0,-22.0,0.0,0.0,0.0
<a href=/player/may-s001>may-s001</a>,Scott May,Texas Rangers,RNGRS,1,2,2,4,1989,1989,0,No,0,0.0,0.0,0.0,0,0,0,0,0,0,0.0,0.0,0.0,0.0,0.0,0.0
<a href=/player/may-t001>may-t001</a>,Trevor May,Philadelphia Phillies,PHILS,3,4,4,8,2012,2016,4,Yes,0,1.59,4.92,3.33,336,335,-1,250,1350,1100,1151.0,0.0,-1151.0,4595000.0,0.0,-4595000.0
<a href=/player/maybc001>maybc001</a>,Cameron Maybin,Detroit Tigers,TIGRS,2,8,3,11,2007,2010,3,No,0,-0.1,-1.19,-1.09,705,27,-678,1077,3,-1074,1506.0,303.0,-1203.0,12380000.0,0.0,-12380000.0
<a href=/player/maybc001>maybc001</a>,Cameron Maybin,Florida Marlins,MARLNS,2,2,3,5,2010,2013,3,No,0,9.26,4.23,-5.03,576,566,-10,1460,5,-1455,273.0,919.0,646.0,2030000.0,0.0,-2030000.0
<a href=/player/maybc001>maybc001</a>,Cameron Maybin,San Diego Padres,PADRS,6,17,12,29,2015,2021,6,Yes,0,17.57,11.2,-6.37,1317,971,-346,3711,2795,-916,1719.0,362.0,-1357.0,9570500.0,0.0,-9570500.0
<a href=/player/maybc001>maybc001</a>,Cameron Maybin,Atlanta Braves,BRAVES,2,3,5,8,2015,2021,6,Yes,0,0.33,8.0,7.67,166,860,694,484,2433,1949,417.0,519.0,102.0,7535000.0,0.0,-7535000.0
<a href=/player/maybc001>maybc001</a>,Cameron Maybin,Detroit Tigers,TIGRS,1,1,1,2,2016,2019,3,No,0,1.49,1.15,-0.34,93,87,-6,387,0,-387,0.0,240.0,240.0,8000000.0,0.0,-8000000.0
<a href=/player/maybc001>maybc001</a>,Cameron Maybin,Miami Marlins,MARLNS,1,1,2,3,2018,2018,0,Yes,0,-0.16,0.0,0.16,30,0,-30,97,0,-97,0.0,0.0,0.0,3250000.0,0.0,-3250000.0
<a href=/player/maybc001>maybc001</a>,Cameron Maybin,Detroit Tigers,TIGRS,1,1,1,2,2020,2020,0,Yes,0,-0.02,0.0,0.02,18,0,-18,56,0,-56,0.0,0.0,0.0,1500000.0,0.0,-1500000.0
<a href=/player/maybj001>maybj001</a>,John Mayberry,Texas Rangers,RNGRS,2,2,3,5,2008,2010,2,No,0,1.66,-0.03,-1.69,533,1,-532,1405,1,-1404,0.0,0.0,0.0,0.0,0.0,0.0
<a href=/player/maybj001>maybj001</a>,John Mayberry,Philadelphia Phillies,PHILS,1,1,1,2,2014,2014,0,Yes,0,-0.02,0.0,0.02,15,0,-15,30,0,-30,0.0,0.0,0.0,1587500.0,0.0,-1587500.0
<a href=/player/maybj101>maybj101</a>,John Mayberry,Houston Astros,ASTROS,9,16,13,29,1971,1989,18,No,0,44.32,17.37,-26.95,2726,2302,-424,7585,5583,-2002,6887.0,3796.0,-3091.0,35500.0,0.0,-35500.0
<a href=/player/maybj101>maybj101</a>,John Mayberry,Toronto Blue Jays,BJAYS,6,12,13,25,1982,2002,20,No,2,26.63,54.05,27.42,1850,2853,1003,5767,11202,5435,3160.0,1213.0,-1947.0,6187500.0,0.0,-6187500.0
<a href=/player/mayee101>mayee101</a>,Erskine Mayer,Philadelphia Phillies,PHILS,4,7,8,15,1918,1925,7,No,0,16.24,19.61,3.37,917,710,-207,2074,1819,-255,5086.0,3795.0,-1291.0,8500.0,0.0,-8500.0
<a href=/player/mayee102>mayee102</a>,Ed Mayer,St. Louis Cardinals,CARDS,2,3,2,5,1957,1958,1,No,0,0.52,-0.27,-0.79,98,41,-57,124,86,-38,94.0,0.0,-94.0,0.0,0.0,0.0
<a href=/player/mayel101>mayel101</a>,Lee Maye,Milwaukee Braves,BRAVES,2,4,3,7,1965,1969,4,No,0,0.56,7.28,6.72,456,395,-61,1230,669,-561,170.0,2309.0,2139.0,0.0,0.0,0.0
<a href=/player/mayel101>mayel101</a>,Lee Maye,Houston Astros,ASTROS,4,5,6,11,1967,1978,11,No,0,2.92,1.17,-1.75,377,1322,945,888,4912,4024,159.0,122.0,-37.0,0.0,0.0,0.0
<a href=/player/mayel101>mayel101</a>,Lee Maye,Cleveland Indians,INDINS,1,1,2,3,1969,1969,0,No,0,1.6,0.0,-1.6,167,0,-167,535,0,-535,0.0,0.0,0.0,0.0,0.0,0.0
<a href=/player/maynb001>maynb001</a>,Brent Mayne,Kansas City Royals,ROYALS,1,1,1,2,1995,1995,0,No,0,-0.13,0.0,0.13,70,0,-70,113,0,-113,0.0,0.0,0.0,675000.0,0.0,-675000.0
<a href=/player/maynb001>maynb001</a>,Brent Mayne,Colorado Rockies,ROCKS,1,1,2,3,2001,2001,0,No,0,-0.5,-0.28,0.22,265,31,-234,964,74,-890,0.0,19.0,19.0,2150000.0,0.0,-2150000.0
<a href=/player/maynb001>maynb001</a>,Brent Mayne,Arizona Diamondbacks,DBACKS,1,2,3,5,2004,2008,4,No,0,1.02,-0.45,-1.47,105,67,-38,363,129,-234,0.0,19.0,19.0,7800000.0,0.0,-7800000.0
<a href=/player/mayoe101>mayoe101</a>,Eddie Mayo,Baltimore,Baltimore,1,1,1,2,1936,1937,1,No,0,-0.46,0.0,0.46,46,0,-46,152,0,-152,0.0,0.0,0.0,0.0,0.0,0.0
<a href=/player/mayoe101>mayoe101</a>,Eddie Mayo,New York Giants,GIANTS,3,5,3,8,1936,1945,9,No,0,3.9,-0.21,-4.11,337,210,-127,591,528,-63,1753.0,409.0,-1344.0,0.0,0.0,0.0
<a href=/player/mayoe101>mayoe101</a>,Eddie Mayo,Philadelphia Athletics,ATLTCS,1,2,2,4,1943,1943,0,No,0,0.0,-0.05,-0.05,0,2,2,0,3,3,0.0,21.0,21.0,9500.0,0.0,-9500.0
<a href=/player/maysc101>maysc101</a>,Carl Mays,Boston Red Sox,RSOX,6,8,10,18,1919,1929,10,No,0,39.74,22.45,-17.29,1556,1599,43,4170,5625,1455,4261.0,1664.0,-2597.0,10750.0,0.0,-10750.0
<a href=/player/maysj001>maysj001</a>,Joe Mays,Seattle Mariners,MARNRS,1,2,1,3,1997,1997,0,No,0,10.83,1.1,-9.73,203,30,-173,21,129,108,2839.0,0.0,-2839.0,0.0,0.0,0.0
<a href=/player/maysw101>maysw101</a>,Willie Mays,San Francisco Giants,GIANTS,1,1,2,3,1972,1972,0,No,0,1.61,-0.39,-2.0,135,6,-129,481,2,-479,0.0,28.0,28.0,165000.0,0.0,-165000.0
<a href=/player/mazan001>mazan001</a>,Nomar Mazara,Texas Rangers,RNGRS,1,1,1,2,2019,2019,0,Yes,0,-0.13,0.0,0.13,42,0,-42,149,0,-149,0.0,0.0,0.0,3300000.0,0.0,-3300000.0
<a href=/player/mazzc001>mazzc001</a>,Cory Mazzoni,New York Mets,METS,1,2,1,3,2015,2015,0,No,0,-1.89,0.09,1.98,94,76,-18,2,1,-1,145.0,103.0,-42.0,0.0,0.0,0.0
<a href=/player/mazzc002>mazzc002</a>,Chris Mazza,Boston Red Sox,RSOX,1,3,2,5,2021,2021,0,Yes,0,0.11,0.0,-0.11,61,0,-61,0,0,0,216.0,0.0,-216.0,0.0,0.0,0.0
<a href=/player/mazzl001>mazzl001</a>,Lee Mazzilli,New York Mets,METS,5,6,6,12,1982,1993,11,No,1,6.85,42.11,35.26,305,1983,1678,231,5329,5098,4118.0,6313.0,2195.0,4344334.0,0.0,-4344334.0
<a href=/player/mazzl001>mazzl001</a>,Lee Mazzilli,Texas Rangers,RNGRS,1,1,1,2,1982,1984,2,No,0,0.27,0.7,0.43,37,177,140,144,614,470,0.0,0.0,0.0,400000.0,0.0,-400000.0
<a href=/player/mazzl001>mazzl001</a>,Lee Mazzilli,New York Yankees,YANKS,2,2,5,7,1982,1983,1,No,0,14.44,0.0,-14.44,1223,0,-1223,927,0,-927,1801.0,0.0,-1801.0,0.0,0.0,0.0
<a href=/player/mazzv001>mazzv001</a>,Vin Mazzaro,Oakland Athletics,ATLTCS,2,3,2,5,2010,2012,2,No,1,-1.02,1.13,2.15,29,131,102,7,506,499,223.0,0.0,-223.0,0.0,0.0,0.0
<a href=/player/mazzv001>mazzv001</a>,Vin Mazzaro,Kansas City Royals,ROYALS,1,2,2,4,2012,2015,3,No,0,1.15,0.0,-1.15,120,0,-120,7,0,-7,252.0,0.0,-252.0,0.0,0.0,0.0
<a href=/player/mcafb101>mcafb101</a>,Bill McAfee,Chicago Cubs,CUBS,3,9,5,14,1930,1941,11,No,0,5.24,32.0,26.76,900,1038,138,2126,2153,27,2562.0,5533.0,2971.0,3600.0,0.0,-3600.0
<a href=/player/mcafb101>mcafb101</a>,Bill McAfee,Boston Braves,BRAVES,1,3,1,4,1932,1937,5,No,0,0.0,10.04,10.04,0,601,601,0,2506,2506,0.0,0.0,0.0,0.0,0.0,0.0
<a href=/player/mcafb101>mcafb101</a>,Bill McAfee,Washington Senators,TWINS,3,6,4,10,1933,1939,6,No,0,1.0,0.24,-0.76,49,144,95,167,448,281,0.0,29.0,29.0,9750.0,0.0,-9750.0
<a href=/player/mcalb101>mcalb101</a>,Bill McAllester,Montgomery,Montgomery,1,3,2,5,1912,1913,1,No,0,-0.14,0.0,0.14,252,0,-252,843,0,-843,0.0,0.0,0.0,0.0,0.0,0.0
<a href=/player/mcals101>mcals101</a>,Sport McAllister,Detroit Tigers,TIGRS,1,4,2,6,1903,1911,8,No,0,0.0,16.79,16.79,0,801,801,0,3453,3453,0.0,39.0,39.0,0.0,0.0,0.0
<a href=/player/mcalz001>mcalz001</a>,Zach McAllister,New York Yankees,YANKS,1,1,1,2,2010,2010,0,No,0,2.96,-0.03,-2.99,296,36,-260,6,119,113,1765.0,0.0,-1765.0,0.0,0.0,0.0
<a href=/player/mcanj001>mcanj001</a>,Jamie McAndrew,Florida Marlins,MARLNS,1,1,1,2,1993,1996,3,No,0,-0.11,0.0,0.11,15,0,-15,0,0,0,167.0,0.0,-167.0,0.0,0.0,0.0
<a href=/player/mcanj101>mcanj101</a>,Jim McAndrew,New York Mets,METS,1,1,1,2,1973,1973,0,No,0,-0.44,0.0,0.44,30,0,-30,10,0,-10,125.0,0.0,-125.0,0.0,0.0,0.0
<a href=/player/mcanj102>mcanj102</a>,Jim McAnany,Los Angeles Angels,ANGELS,4,4,6,10,1961,1970,9,No,0,4.24,10.06,5.82,788,882,94,2492,2911,419,542.0,509.0,-33.0,20000.0,0.0,-20000.0
<a href=/player/mcaud101>mcaud101</a>,Dick McAuliffe,Detroit Tigers,TIGRS,3,3,4,7,1973,1978,5,No,1,21.48,7.23,-14.25,1256,474,-782,4991,1468,-3523,0.0,701.0,701.0,60000.0,0.0,-60000.0
<a href=/player/mcaui101>mcaui101</a>,Ike McAuley,Pittsburgh Pirates,PIRATS,1,3,2,5,1917,1919,2,No,0,0.0,0.0,0.0,0,175,175,0,676,676,0.0,0.0,0.0,0.0,0.0,0.0
<a href=/player/mcavw101>mcavw101</a>,Wickey McAvoy,Baltimore,Baltimore,1,2,5,7,1917,1920,3,No,0,0.91,0.0,-0.91,304,0,-304,1098,0,-1098,1.0,0.0,-1.0,0.0,0.0,0.0
<a href=/player/mcbea101>mcbea101</a>,Al McBean,San Diego Padres,PADRS,1,1,2,3,1969,1969,0,No,0,0.06,-2.15,-2.21,64,112,48,4,312,308,148.0,47.0,-101.0,0.0,0.0,0.0
<a href=/player/mcbem001>mcbem001</a>,Marcus McBeth,Oakland Athletics,ATLTCS,1,2,1,3,2007,2009,2,No,0,-0.06,0.33,0.39,44,33,-11,0,73,73,59.0,0.0,-59.0,0.0,0.0,0.0
<a href=/player/mcbrb101>mcbrb101</a>,Bake McBride,St. Louis Cardinals,CARDS,12,25,23,48,1977,1998,21,No,4,86.36,129.83,43.47,6625,5322,-1303,21245,17737,-3508,7151.0,5142.0,-2009.0,1613333.0,0.0,-1613333.0
<a href=/player/mcbrb101>mcbrb101</a>,Bake McBride,Philadelphia Phillies,PHILS,2,2,2,4,1982,1983,1,No,0,0.27,1.43,1.16,217,223,6,343,308,-35,251.0,251.0,0.0,300000.0,0.0,-300000.0
<a href=/player/mcbrg101>mcbrg101</a>,George McBride,Pittsburgh Pirates,PIRATS,2,4,2,6,1905,1910,5,No,0,7.6,22.84,15.24,902,405,-497,2899,798,-2101,2702.0,3628.0,926.0,0.0,0.0,0.0
<a href=/player/mcbrg101>mcbrg101</a>,George McBride,St. Louis Cardinals,CARDS,1,2,1,3,1906,1907,1,No,0,0.0,-0.14,-0.14,0,22,22,0,79,79,0.0,0.0,0.0,0.0,0.0,0.0
<a href=/player/mcbrm001>mcbrm001</a>,Macay McBride,Atlanta Braves,BRAVES,2,3,2,5,2007,2008,1,No,0,-0.55,-1.48,-0.93,88,127,39,14,0,-14,259.0,110.0,-149.0,400000.0,0.0,-400000.0
<a href=/player/mcbrm002>mcbrm002</a>,Matt McBride,Cleveland Indians,INDINS,1,4,1,5,2011,2013,2,No,0,-0.32,1.97,2.29,204,79,-125,247,10,-237,813.0,1274.0,461.0,0.0,0.0,0.0
<a href=/player/mcbrr001>mcbrr001</a>,Ryan McBroom,Toronto Blue Jays,BJAYS,1,1,1,2,2017,2017,0,No,0,0.0,-0.2,-0.2,0,32,32,0,58,58,0.0,0.0,0.0,0.0,0.0,0.0
<a href=/player/mccaa103>mccaa103</a>,Alex McCarthy,Pittsburgh Pirates,PIRATS,1,3,2,5,1917,1919,2,No,0,0.0,0.0,0.0,0,175,175,0,676,676,0.0,0.0,0.0,0.0,0.0,0.0
<a href=/player/mccab001>mccab001</a>,Brandon McCarthy,Chicago White Sox,WSOX,2,4,5,9,2006,2016,10,No,0,4.75,20.31,15.56,542,364,-178,56,181,125,1384.0,4762.0,3378.0,728000.0,0.0,-728000.0
<a href=/player/mccab001>mccab001</a>,Brandon McCarthy,Arizona Diamondbacks,DBACKS,2,4,5,9,2014,2018,4,No,0,4.41,4.31,-0.1,204,280,76,363,795,432,671.0,386.0,-285.0,0.0,0.0,0.0
<a href=/player/mccab001>mccab001</a>,Brandon McCarthy,Los Angeles Dodgers,DOGRS,4,17,9,26,2017,2021,4,Yes,0,6.07,9.48,3.41,927,279,-648,2727,1007,-1720,545.0,229.0,-316.0,71371000.0,0.0,-71371000.0
<a href=/player/mccab002>mccab002</a>,Brian McCann,New York Yankees,YANKS,2,5,3,8,2016,2017,1,Yes,0,4.0,0.0,-4.0,502,0,-502,1984,0,-1984,8.0,0.0,-8.0,26857143.0,0.0,-26857143.0
<a href=/player/mccab106>mccab106</a>,Bill McCahan,Philadelphia Athletics,ATLTCS,2,3,2,5,1949,1952,3,No,0,0.0,2.06,2.06,0,232,232,0,892,892,0.0,0.0,0.0,0.0,0.0,0.0
<a href=/player/mccad001>mccad001</a>,Dave McCarty,Minnesota Twins,TWINS,1,1,1,2,1995,1995,0,No,0,0.0,0.0,0.0,0,0,0,0,0,0,0.0,0.0,0.0,150000.0,0.0,-150000.0
<a href=/player/mccad001>mccad001</a>,Dave McCarty,Cincinnati Reds,REDS,5,11,7,18,1995,2010,15,No,0,11.19,26.95,15.76,438,1436,998,728,5040,4312,2595.0,2089.0,-506.0,13266667.0,0.0,-13266667.0
<a href=/player/mccad001>mccad001</a>,Dave McCarty,San Francisco Giants,GIANTS,1,1,2,3,1998,1998,0,No,0,0.32,0.0,-0.32,8,0,-8,23,0,-23,0.0,0.0,0.0,0.0,0.0,0.0
<a href=/player/mccae101>mccae101</a>,Emmet McCann,Detroit Tigers,TIGRS,1,9,2,11,1921,1941,20,No,0,0.0,3.03,3.03,0,202,202,0,144,144,0.0,1168.0,1168.0,0.0,0.0,0.0
<a href=/player/mccae101>mccae101</a>,Emmet McCann,Portland,Portland,2,3,3,6,1925,1926,1,No,0,-0.61,0.0,0.61,23,0,-23,16,0,-16,63.0,0.0,-63.0,0.0,0.0,0.0
<a href=/player/mccaj002>mccaj002</a>,Joe McCarthy,Tampa Bay Devil Rays,RAYS,1,1,1,2,2019,2019,0,Yes,0,-0.37,0.0,0.37,4,0,-4,10,0,-10,0.0,0.0,0.0,0.0,0.0,0.0
<a href=/player/mccaj104>mccaj104</a>,Johnny McCarthy,Brooklyn Dodgers,DOGRS,2,5,3,8,1936,1940,4,No,0,2.67,4.3,1.63,454,607,153,1715,2060,345,0.0,317.0,317.0,0.0,0.0,0.0
<a href=/player/mccaj104>mccaj104</a>,Johnny McCarthy,New York Giants,GIANTS,1,4,1,5,1941,1949,8,No,0,5.95,28.96,23.01,346,655,309,1181,2815,1634,38.0,0.0,-38.0,0.0,0.0,0.0
<a href=/player/mccaj105>mccaj105</a>,Jack McCarthy,Cincinnati Reds,REDS,1,5,3,8,1897,1900,3,No,0,8.1,12.35,4.25,718,395,-323,2747,1335,-1412,936.0,1747.0,811.0,0.0,0.0,0.0
<a href=/player/mccaj105>mccaj105</a>,Jack McCarthy,Chicago Cubs,CUBS,1,5,1,6,1905,1913,8,No,0,5.14,19.07,13.93,814,1001,187,3290,4393,1103,0.0,0.0,0.0,0.0,0.0,0.0
<a href=/player/mccaj108>mccaj108</a>,Joe McCabe,Minnesota Twins,TWINS,2,2,2,4,1964,1967,3,No,0,0.15,0.11,-0.04,14,10,-4,32,20,-12,0.0,0.0,0.0,7000.0,0.0,-7000.0
<a href=/player/mccal101>mccal101</a>,Larry McCall,New York Yankees,YANKS,25,56,45,101,1978,2001,23,No,2,104.42,67.09,-37.33,6884,4113,-2771,17114,10039,-7075,21429.0,9704.0,-11725.0,5628333.0,0.0,-5628333.0
<a href=/player/mccal101>mccal101</a>,Larry McCall,Texas Rangers,RNGRS,1,3,2,5,1980,1980,0,No,0,-0.55,-1.43,-0.88,28,119,91,57,205,148,0.0,0.0,0.0,0.0,0.0,0.0
<a href=/player/mccal102>mccal102</a>,Lew McCarty,Brooklyn Dodgers,DOGRS,1,1,1,2,1916,1917,1,No,0,2.34,-0.18,-2.52,288,25,-263,820,86,-734,0.0,0.0,0.0,4250.0,0.0,-4250.0
<a href=/player/mccam001>mccam001</a>,Tom McCarthy,Boston Red Sox,RSOX,7,15,13,28,1985,1993,8,No,0,20.97,19.79,-1.18,2048,1909,-139,3771,4732,961,4874.0,3574.0,-1300.0,3550000.0,0.0,-3550000.0
<a href=/player/mccam001>mccam001</a>,Tom McCarthy,New York Mets,METS,1,2,2,4,1988,1989,1,No,0,0.86,0.0,-0.86,37,0,-37,0,0,0,239.0,0.0,-239.0,0.0,0.0,0.0
<a href=/player/mccar101>mccar101</a>,Roger McCardell,San Francisco Giants,GIANTS,5,9,7,16,1959,1968,9,No,0,13.15,7.42,-5.73,1312,848,-464,3499,1107,-2392,1130.0,3244.0,2114.0,43000.0,0.0,-43000.0
<a href=/player/mccat101>mccat101</a>,Tim McCarver,St. Louis Cardinals,CARDS,30,57,53,110,1969,1998,29,No,7,115.3,176.27,60.97,11163,8552,-2611,30164,29400,-764,12224.0,4453.0,-7771.0,3323333.0,0.0,-3323333.0
<a href=/player/mccat101>mccat101</a>,Tim McCarver,Philadelphia Phillies,PHILS,1,1,1,2,1972,1973,1,No,0,0.44,-1.21,-1.65,77,82,5,259,265,6,0.0,0.0,0.0,0.0,0.0,0.0
<a href=/player/mccat101>mccat101</a>,Tim McCarver,Montreal Expos,NATEX,1,1,1,2,1972,1972,0,No,0,0.03,0.0,-0.03,204,0,-204,518,0,-518,0.0,0.0,0.0,0.0,0.0,0.0
<a href=/player/mccat102>mccat102</a>,Tom McCarthy,Pittsburgh Pirates,PIRATS,1,2,1,3,1908,1909,1,No,0,1.07,0.43,-0.64,57,32,-25,69,31,-38,500.0,269.0,-231.0,1500.0,0.0,-1500.0
<a href=/player/mccat102>mccat102</a>,Tom McCarthy,Boston Braves,BRAVES,1,1,1,2,1909,1909,0,No,0,0.0,-0.72,-0.72,0,8,8,0,9,9,0.0,65.0,65.0,0.0,0.0,0.0
<a href=/player/mccaw102>mccaw102</a>,Windy McCall,SanFrancisco,SanFrancisco,1,1,4,5,1953,1953,0,No,0,2.61,0.0,-2.61,252,0,-252,49,0,-49,709.0,0.0,-709.0,0.0,0.0,0.0
<a href=/player/mcclb001>mcclb001</a>,Bob McClure,Kansas City Royals,ROYALS,4,7,5,12,1977,1997,20,No,1,3.48,61.02,57.54,709,1258,549,973,3160,2187,2893.0,7458.0,4565.0,1600000.0,0.0,-1600000.0
<a href=/player/mcclb001>mcclb001</a>,Bob McClure,Milwaukee Brewers,BREWRS,1,1,1,2,1986,1986,0,No,0,0.9,0.0,-0.9,246,0,-246,8,0,-8,402.0,0.0,-402.0,487500.0,0.0,-487500.0
<a href=/player/mccll001>mccll001</a>,Lloyd McClendon,New York Mets,METS,1,3,1,4,1982,1984,2,No,0,-1.57,2.55,4.12,181,68,-113,297,77,-220,497.0,693.0,196.0,0.0,0.0,0.0
<a href=/player/mccll001>mccll001</a>,Lloyd McClendon,Cincinnati Reds,REDS,1,1,1,2,1988,1990,2,No,0,-0.43,0.61,1.04,141,137,-4,427,395,-32,0.0,0.0,0.0,75000.0,0.0,-75000.0
<a href=/player/mccll001>mccll001</a>,Lloyd McClendon,Chicago Cubs,CUBS,1,1,1,2,1990,1990,0,No,0,0.42,0.0,-0.42,312,0,-312,714,0,-714,0.0,0.0,0.0,210000.0,0.0,-210000.0
<a href=/player/mccls001>mccls001</a>,Scott McClain,Baltimore Orioles,ORLS,1,2,1,3,1997,1998,1,No,0,0.7,0.0,-0.7,54,0,-54,161,0,-161,0.0,0.0,0.0,0.0,0.0,0.0
<a href=/player/mccls002>mccls002</a>,Seth McClung,Tampa Bay Devil Rays,RAYS,2,2,3,5,2007,2010,3,No,2,1.11,3.84,2.73,179,219,40,29,1,-28,538.0,609.0,71.0,0.0,0.0,0.0
<a href=/player/mcclz001>mcclz001</a>,Zach McClellan,Kansas City Royals,ROYALS,1,3,1,4,2004,2006,2,No,0,-0.1,-0.25,-0.15,24,15,-9,1,0,-1,42.0,75.0,33.0,0.0,0.0,0.0
<a href=/player/mccoa101>mccoa101</a>,Amby McConnell,Boston Red Sox,RSOX,10,27,25,52,1910,1935,25,No,0,63.77,27.05,-36.72,4436,3125,-1311,17821,11484,-6337,0.0,1291.0,1291.0,45050.0,0.0,-45050.0
<a href=/player/mccob101>mccob101</a>,Barney McCosky,Detroit Tigers,TIGRS,19,42,44,86,1946,1964,18,No,0,57.99,76.58,18.59,5043,5483,440,13086,16231,3145,8483.0,9258.0,775.0,157700.0,0.0,-157700.0
<a href=/player/mccob102>mccob102</a>,Benny McCoy,Detroit Tigers,TIGRS,1,1,1,2,1939,1952,13,No,0,4.33,0.0,-4.33,275,0,-275,1183,0,-1183,0.0,0.0,0.0,4200.0,0.0,-4200.0
<a href=/player/mccob104>mccob104</a>,Barry McCormick,St.Louis Browns,ORLS,1,1,1,2,1903,1903,0,No,0,-1.12,-0.42,0.7,176,44,-132,679,189,-490,0.0,0.0,0.0,0.0,0.0,0.0
<a href=/player/mccob105>mccob105</a>,Billy McCool,San Diego Padres,PADRS,2,2,3,5,1970,1970,0,No,0,-0.28,1.52,1.8,36,106,70,5,427,422,65.0,0.0,-65.0,0.0,0.0,0.0
<a href=/player/mccob105>mccob105</a>,Billy McCool,St. Louis Cardinals,CARDS,1,1,1,2,1970,1970,0,No,0,0.0,0.0,0.0,0,0,0,0,0,0,0.0,0.0,0.0,0.0,0.0,0.0
<a href=/player/mccob105>mccob105</a>,Billy McCool,Boston Red Sox,RSOX,1,1,1,2,1971,1971,0,No,0,0.0,0.0,0.0,0,0,0,0,0,0,0.0,0.0,0.0,0.0,0.0,0.0
<a href=/player/mccoj103>mccoj103</a>,Jim McCormick,Chicago Cubs,CUBS,1,1,2,3,1887,1893,6,No,0,2.8,5.98,3.18,72,310,238,138,1158,1020,967.0,1220.0,253.0,0.0,0.0,0.0
<a href=/player/mccom001>mccom001</a>,Mike McCoy,Baltimore Orioles,ORLS,1,1,1,2,2008,2008,0,No,0,-0.02,-1.17,-1.15,12,54,42,6,166,160,0.0,0.0,0.0,0.0,0.0,0.0
<a href=/player/mccom101>mccom101</a>,Mike McCormick,Buffalo,Buffalo,1,1,3,4,1937,1937,0,No,0,0.0,0.0,0.0,0,0,0,0,0,0,0.0,0.0,0.0,0.0,0.0,0.0
<a href=/player/mccom101>mccom101</a>,Mike McCormick,Boston Braves,BRAVES,1,2,1,3,1948,1950,2,No,0,-0.55,1.6,2.15,55,137,82,158,356,198,0.0,0.0,0.0,0.0,0.0,0.0
<a href=/player/mccom101>mccom101</a>,Mike McCormick,Chicago White Sox,WSOX,1,1,1,2,1950,1954,4,No,0,0.53,2.29,1.76,81,258,177,272,600,328,0.0,0.0,0.0,0.0,0.0,0.0
<a href=/player/mccom103>mccom103</a>,Mike McCormick,San Francisco Giants,GIANTS,10,18,16,34,1962,1972,10,No,0,36.27,10.66,-25.61,2635,1445,-1190,6319,1774,-4545,3135.0,5237.0,2102.0,50000.0,0.0,-50000.0
<a href=/player/mccom103>mccom103</a>,Mike McCormick,Baltimore Orioles,ORLS,1,1,2,3,1965,1965,0,No,0,4.02,0.0,-4.02,171,0,-171,125,0,-125,1122.0,0.0,-1122.0,0.0,0.0,0.0
<a href=/player/mccom103>mccom103</a>,Mike McCormick,Washington Senators,RNGRS,14,29,24,53,1966,1988,22,No,0,51.82,50.93,-0.89,3334,4606,1272,9827,13245,3418,6092.0,7154.0,1062.0,551000.0,0.0,-551000.0
<a href=/player/mccom103>mccom103</a>,Mike McCormick,San Francisco Giants,GIANTS,2,2,2,4,1970,1972,2,No,0,-1.18,1.35,2.53,46,122,76,11,71,60,127.0,663.0,536.0,0.0,0.0,0.0
<a href=/player/mccom104>mccom104</a>,Moose McCormick,New York Giants,GIANTS,1,1,1,2,1904,1911,7,No,0,0.67,13.71,13.04,66,396,330,260,1628,1368,0.0,0.0,0.0,0.0,0.0,0.0
<a href=/player/mccom104>mccom104</a>,Moose McCormick,Pittsburgh Pirates,PIRATS,2,6,3,9,1904,1910,6,No,0,14.45,22.9,8.45,1603,573,-1030,5618,1466,-4152,2702.0,3643.0,941.0,0.0,0.0,0.0
<a href=/player/mccow101>mccow101</a>,Willie McCovey,San Francisco Giants,GIANTS,4,8,7,15,1973,1979,6,No,1,5.12,0.53,-4.59,507,876,369,1563,1384,-179,25.0,2162.0,2137.0,125000.0,0.0,-125000.0
<a href=/player/mccra001>mccra001</a>,Adam McCreery,Anaheim Angels,ANGELS,1,1,1,2,2016,2016,0,No,0,-0.08,0.37,0.45,2,30,28,0,2,2,3.0,352.0,349.0,0.0,0.0,0.0
<a href=/player/mccrj101>mccrj101</a>,Judge McCredie,Brooklyn Dodgers,DOGRS,1,4,1,5,1903,1908,5,No,0,0.0,0.0,0.0,0,0,0,0,0,0,0.0,0.0,0.0,0.0,0.0,0.0
<a href=/player/mccrq001>mccrq001</a>,Quinton McCracken,Arizona Diamondbacks,DBACKS,1,1,2,3,2003,2004,1,No,0,-0.37,-0.58,-0.21,19,20,1,23,28,5,0.0,0.0,0.0,1750000.0,0.0,-1750000.0
<a href=/player/mccrt101>mccrt101</a>,Tom McCreery,Louisville Colonels,LS3,1,1,2,3,1897,1897,0,No,0,0.35,0.73,0.38,84,14,-70,348,22,-326,0.0,164.0,164.0,0.0,0.0,0.0
<a href=/player/mccrt102>mccrt102</a>,Tommy McCraw,Chicago White Sox,WSOX,1,1,1,2,1971,1971,0,No,0,-0.26,-1.28,-1.02,122,53,-69,234,153,-81,0.0,0.0,0.0,0.0,0.0,0.0
<a href=/player/mccrt102>mccrt102</a>,Tommy McCraw,Texas Rangers,RNGRS,4,7,4,11,1972,1977,5,No,0,0.46,2.24,1.78,334,178,-156,834,481,-353,759.0,568.0,-191.0,0.0,0.0,0.0
<a href=/player/mccrt102>mccrt102</a>,Tommy McCraw,Cleveland Indians,INDINS,3,6,3,9,1973,1974,1,No,0,2.93,-1.31,-4.24,422,87,-335,1042,273,-769,0.0,0.0,0.0,19750.0,0.0,-19750.0
<a href=/player/mccua001>mccua001</a>,Andrew McCutchen,Pittsburgh Pirates,PIRATS,1,2,3,5,2018,2021,3,Yes,0,1.55,1.11,-0.44,130,285,155,568,0,-568,0.0,418.0,418.0,0.0,0.0,0.0
<a href=/player/mccua001>mccua001</a>,Andrew McCutchen,San Francisco Giants,GIANTS,2,5,3,8,2018,2020,2,No,0,0.55,0.73,0.18,105,166,61,162,647,485,182.0,0.0,-182.0,14750000.0,0.0,-14750000.0
<a href=/player/mccuc101>mccuc101</a>,Clyde McCullough,Chicago Cubs,CUBS,1,2,2,4,1948,1955,7,No,0,10.4,0.75,-9.65,514,154,-360,1252,339,-913,1459.0,506.0,-953.0,6500.0,0.0,-6500.0
<a href=/player/mccuc101>mccuc101</a>,Clyde McCullough,Pittsburgh Pirates,PIRATS,1,1,2,3,1952,1952,0,No,0,-0.4,0.0,0.4,166,0,-166,450,0,-450,0.0,0.0,0.0,0.0,0.0,0.0
<a href=/player/mccud001>mccud001</a>,Daniel McCutchen,New York Yankees,YANKS,1,4,2,6,2008,2011,3,No,0,7.23,0.52,-6.71,1088,146,-942,2084,276,-1808,3210.0,148.0,-3062.0,391425.0,0.0,-391425.0
<a href=/player/mccuh101>mccuh101</a>,Harry McCurdy,St. Louis Cardinals,CARDS,1,2,2,4,1929,1932,3,No,0,0.24,-1.21,-1.45,299,26,-273,578,77,-501,65.0,0.0,-65.0,7500.0,0.0,-7500.0
<a href=/player/mccul001>mccul001</a>,Lance McCullers,Philadelphia Phillies,PHILS,4,7,5,12,1983,1992,9,No,1,3.32,3.9,0.58,591,613,22,223,793,570,1674.0,2750.0,1076.0,375000.0,0.0,-375000.0
<a href=/player/mccul001>mccul001</a>,Lance McCullers,San Diego Padres,PADRS,2,4,3,7,1988,1992,4,No,1,-2.09,7.62,9.71,105,399,294,12,1044,1032,593.0,270.0,-323.0,375000.0,0.0,-375000.0
<a href=/player/mccul001>mccul001</a>,Lance McCullers,New York Yankees,YANKS,3,8,3,11,1990,2001,11,No,1,24.45,11.94,-12.51,1197,991,-206,4014,3988,-26,3220.0,0.0,-3220.0,800000.0,0.0,-800000.0
<a href=/player/mcdal101>mcdal101</a>,Lindy McDaniel,St. Louis Cardinals,CARDS,15,32,26,58,1962,1972,10,No,0,54.99,16.45,-38.54,4551,1419,-3132,9818,4107,-5711,7592.0,1574.0,-6018.0,32500.0,0.0,-32500.0
<a href=/player/mcdal101>mcdal101</a>,Lindy McDaniel,Chicago Cubs,CUBS,4,8,5,13,1965,1977,12,No,0,12.44,36.7,24.26,637,2096,1459,244,5232,4988,3515.0,5246.0,1731.0,122500.0,0.0,-122500.0
<a href=/player/mcdal101>mcdal101</a>,Lindy McDaniel,San Francisco Giants,GIANTS,1,1,1,2,1968,1968,0,No,0,9.86,-0.29,-10.15,484,14,-470,71,0,-71,1635.0,36.0,-1599.0,0.0,0.0,0.0
<a href=/player/mcdal101>mcdal101</a>,Lindy McDaniel,New York Yankees,YANKS,2,2,3,5,1973,2002,29,No,0,0.87,9.84,8.97,79,1066,987,0,3577,3577,554.0,187.0,-367.0,68000.0,0.0,-68000.0
<a href=/player/mcded101>mcded101</a>,Danny McDevitt,New York Yankees,YANKS,2,2,3,5,1961,1962,1,No,0,0.28,-0.04,-0.32,121,45,-76,304,110,-194,80.0,0.0,-80.0,0.0,0.0,0.0
<a href=/player/mcdem102>mcdem102</a>,Mickey McDermott,Boston Red Sox,RSOX,1,2,1,3,1953,1953,0,No,0,2.57,0.0,-2.57,409,0,-409,921,0,-921,1057.0,0.0,-1057.0,0.0,0.0,0.0
<a href=/player/mcdem102>mcdem102</a>,Mickey McDermott,Washington Senators,TWINS,6,9,11,20,1956,1962,6,No,0,3.55,-3.94,-7.49,344,1439,1095,915,4243,3328,381.0,450.0,69.0,21000.0,0.0,-21000.0
<a href=/player/mcdem102>mcdem102</a>,Mickey McDermott,New York Yankees,YANKS,6,15,13,28,1957,1970,13,No,0,5.72,32.98,27.26,1633,2423,790,4235,5558,1323,2553.0,4978.0,2425.0,115500.0,0.0,-115500.0
<a href=/player/mcdem102>mcdem102</a>,Mickey McDermott,Kansas City Athletics,ATLTCS,31,62,61,123,1957,1976,19,No,0,95.85,56.38,-39.47,9593,6643,-2950,23097,19018,-4079,12004.0,6179.0,-5825.0,476100.0,0.0,-476100.0
<a href=/player/mcdia001>mcdia001</a>,Allen McDill,New York Mets,METS,3,5,6,11,1995,1999,4,No,0,0.09,-0.09,-0.18,89,38,-51,0,0,0,470.0,74.0,-396.0,125000.0,0.0,-125000.0
<a href=/player/mcdob001>mcdob001</a>,Ben McDonald,Milwaukee Brewers,BREWRS,2,5,3,8,1997,2001,4,No,0,0.99,0.01,-0.98,271,614,343,839,2349,1510,81.0,415.0,334.0,6930000.0,0.0,-6930000.0
<a href=/player/mcdob001>mcdob001</a>,Ben McDonald,Cleveland Indians,INDINS,1,1,1,2,1998,2000,2,No,0,0.0,-0.18,-0.18,0,8,8,0,0,0,0.0,19.0,19.0,0.0,0.0,0.0
<a href=/player/mcdod002>mcdod002</a>,Darnell McDonald,Washington Nationals,NATEX,1,1,1,2,2007,2008,1,No,0,-0.22,-1.69,-1.47,4,50,46,11,8,-3,0.0,144.0,144.0,0.0,0.0,0.0
<a href=/player/mcdod102>mcdod102</a>,Dave McDonald,New York Yankees,YANKS,1,1,1,2,1970,1972,2,No,0,-0.5,1.23,1.73,24,100,76,45,12,-33,0.0,272.0,272.0,0.0,0.0,0.0
<a href=/player/mcdod102>mcdod102</a>,Dave McDonald,Montreal Expos,NATEX,1,1,1,2,1970,1974,4,No,0,0.0,12.72,12.72,0,509,509,0,2140,2140,0.0,0.0,0.0,0.0,0.0,0.0
<a href=/player/mcdod102>mcdod102</a>,Dave McDonald,Montreal Expos,NATEX,1,1,1,2,1972,1972,0,No,0,0.0,0.0,0.0,0,0,0,0,0,0,0.0,0.0,0.0,0.0,0.0,0.0
<a href=/player/mcdoj001>mcdoj001</a>,Jack McDowell,Chicago White Sox,WSOX,1,1,2,3,1994,1997,3,No,0,4.02,1.86,-2.16,30,233,203,0,702,702,653.0,0.0,-653.0,5300000.0,0.0,-5300000.0
<a href=/player/mcdoj003>mcdoj003</a>,John McDonald,Cleveland Indians,INDINS,1,1,1,2,2004,2008,4,No,0,5.2,-0.67,-5.87,549,86,-463,1453,0,-1453,0.0,282.0,282.0,324400.0,0.0,-324400.0
<a href=/player/mcdoj003>mcdoj003</a>,John McDonald,Toronto Blue Jays,BJAYS,1,2,1,3,2011,2012,1,No,0,8.13,2.83,-5.3,614,175,-439,2342,713,-1629,0.0,0.0,0.0,6500000.0,0.0,-6500000.0
<a href=/player/mcdoj003>mcdoj003</a>,John McDonald,Philadelphia Phillies,PHILS,1,1,1,2,2013,2015,2,No,0,-0.08,-0.15,-0.07,6,8,2,9,0,-9,0.0,12.0,12.0,0.0,0.0,0.0
<a href=/player/mcdoj004>mcdoj004</a>,James McDonald,Los Angeles Dodgers,DOGRS,2,3,3,6,2010,2010,0,No,0,2.04,0.31,-1.73,235,38,-197,259,1,-258,1323.0,56.0,-1267.0,0.0,0.0,0.0
<a href=/player/mcdoj101>mcdoj101</a>,Jim McDonnell,Cleveland Indians,INDINS,1,1,1,2,1946,1946,0,No,0,0.0,-0.01,-0.01,0,3,3,0,3,3,0.0,0.0,0.0,0.0,0.0,0.0
<a href=/player/mcdoj104>mcdoj104</a>,Jim McDonald,Boston Red Sox,RSOX,3,7,4,11,1951,1954,3,No,0,1.03,-2.94,-3.97,539,149,-390,1347,410,-937,675.0,0.0,-675.0,8500.0,0.0,-8500.0
<a href=/player/mcdoj104>mcdoj104</a>,Jim McDonald,St.Louis Browns,ORLS,5,8,10,18,1951,1960,9,No,0,15.63,13.98,-1.65,885,1228,343,1766,3784,2018,3101.0,1208.0,-1893.0,0.0,0.0,0.0
<a href=/player/mcdoj104>mcdoj104</a>,Jim McDonald,New York Yankees,YANKS,12,33,27,60,1954,1970,16,No,0,40.55,76.98,36.43,5201,4368,-833,16466,10777,-5689,3212.0,10751.0,7539.0,302500.0,0.0,-302500.0
<a href=/player/mcdoj104>mcdoj104</a>,Jim McDonald,Baltimore Orioles,ORLS,1,1,1,2,1955,1955,0,No,0,0.0,0.39,0.39,0,20,20,0,18,18,0.0,147.0,147.0,0.0,0.0,0.0
<a href=/player/mcdom001>mcdom001</a>,Marshall McDougall,Oakland Athletics,ATLTCS,1,1,1,2,2002,2005,3,No,0,0.0,2.72,2.72,0,233,233,0,0,0,0.0,471.0,471.0,0.0,0.0,0.0
<a href=/player/mcdoo001>mcdoo001</a>,Oddibe McDowell,Texas Rangers,RNGRS,1,3,1,4,1988,1993,5,No,0,6.72,20.24,13.52,624,632,8,2545,2680,135,0.0,0.0,0.0,930000.0,0.0,-930000.0
<a href=/player/mcdoo001>mcdoo001</a>,Oddibe McDowell,Cleveland Indians,INDINS,1,1,1,2,1989,1990,1,No,0,1.89,0.94,-0.95,189,158,-31,637,551,-86,0.0,0.0,0.0,375000.0,0.0,-375000.0
<a href=/player/mcdor001>mcdor001</a>,Roger McDowell,New York Mets,METS,14,22,24,46,1989,1999,10,No,1,42.74,12.21,-30.53,2762,1749,-1013,6221,1744,-4477,4175.0,4730.0,555.0,13614666.0,0.0,-13614666.0
<a href=/player/mcdor001>mcdor001</a>,Roger McDowell,Philadelphia Phillies,PHILS,2,2,3,5,1991,1996,5,No,0,2.71,3.43,0.72,422,429,7,10,199,189,949.0,999.0,50.0,2225000.0,0.0,-2225000.0
<a href=/player/mcdos101>mcdos101</a>,Sam McDowell,Cleveland Indians,INDINS,8,10,15,25,1971,1989,18,No,0,20.02,90.97,70.95,1507,3544,2037,4040,10458,6418,4102.0,11030.0,6928.0,1747000.0,0.0,-1747000.0
<a href=/player/mcdot101>mcdot101</a>,Tex McDonald,Cincinnati Reds,REDS,1,2,1,3,1913,1913,0,No,0,1.26,1.29,0.03,62,80,18,167,226,59,0.0,0.0,0.0,1500.0,0.0,-1500.0
<a href=/player/mcelc001>mcelc001</a>,Chuck McElroy,Philadelphia Phillies,PHILS,3,5,4,9,1991,1996,5,No,0,0.9,5.94,5.04,864,567,-297,60,158,98,1703.0,1127.0,-576.0,3609000.0,0.0,-3609000.0
<a href=/player/mcelc001>mcelc001</a>,Chuck McElroy,Chicago Cubs,CUBS,1,1,3,4,1993,1995,2,No,0,1.08,0.0,-1.08,216,0,-216,11,0,-11,331.0,0.0,-331.0,312500.0,0.0,-312500.0
<a href=/player/mcelc001>mcelc001</a>,Chuck McElroy,Cincinnati Reds,REDS,1,1,1,2,1996,1996,0,No,0,1.51,0.61,-0.9,53,86,33,0,0,0,157.0,133.0,-24.0,817000.0,0.0,-817000.0
<a href=/player/mcelc001>mcelc001</a>,Chuck McElroy,Anaheim Angels,ANGELS,1,2,2,4,1997,1998,1,No,0,1.16,1.24,0.08,151,175,24,342,727,385,178.0,0.0,-178.0,1092000.0,0.0,-1092000.0
<a href=/player/mcelc001>mcelc001</a>,Chuck McElroy,Arizona Diamondbacks,DBACKS,1,1,1,2,1997,1997,0,No,0,3.41,0.0,-3.41,232,0,-232,8,0,-8,327.0,0.0,-327.0,0.0,0.0,0.0
<a href=/player/mcelc001>mcelc001</a>,Chuck McElroy,Colorado Rockies,ROCKS,2,3,4,7,1999,2000,1,No,0,0.73,-0.11,-0.84,211,33,-178,561,29,-532,40.0,37.0,-3.0,4663333.0,0.0,-4663333.0
<a href=/player/mcelc001>mcelc001</a>,Chuck McElroy,New York Mets,METS,2,2,2,4,1999,2005,6,No,0,0.3,0.53,0.23,77,502,425,0,1169,1169,333.0,0.0,-333.0,0.0,0.0,0.0
<a href=/player/mcenw101>mcenw101</a>,Will McEnaney,Cincinnati Reds,REDS,3,5,4,9,1976,1981,5,No,0,8.77,1.11,-7.66,1082,372,-710,1854,353,-1501,1843.0,1635.0,-208.0,85000.0,0.0,-85000.0
<a href=/player/mcenw101>mcenw101</a>,Will McEnaney,Montreal Expos,NATEX,1,1,1,2,1978,1978,0,No,0,-0.68,0.0,0.68,12,0,-12,0,0,0,26.0,0.0,-26.0,0.0,0.0,0.0
<a href=/player/mcevl101>mcevl101</a>,Lou McEvoy,New York Yankees,YANKS,1,5,2,7,1931,1947,16,No,0,0.0,15.3,15.3,0,992,992,0,1098,1098,0.0,2971.0,2971.0,19500.0,0.0,-19500.0
<a href=/player/mcewj001>mcewj001</a>,Joe McEwing,St. Louis Cardinals,CARDS,1,1,1,2,2000,2000,0,No,0,0.53,-0.25,-0.78,502,12,-490,1169,0,-1169,0.0,7.0,7.0,0.0,0.0,0.0
<a href=/player/mcfac102>mcfac102</a>,Chappie McFarland,St. Louis Cardinals,CARDS,3,6,3,9,1906,1912,6,No,0,24.88,17.32,-7.56,1485,464,-1021,4288,1239,-3049,4216.0,1939.0,-2277.0,0.0,0.0,0.0
<a href=/player/mcfad101>mcfad101</a>,Dan McFarlan,Brooklyn Dodgers,DOGRS,1,4,2,6,1899,1903,4,No,0,0.67,6.33,5.66,113,445,332,291,1743,1452,635.0,0.0,-635.0,0.0,0.0,0.0
<a href=/player/mcfae101>mcfae101</a>,Ed McFarland,Cincinnati Reds,REDS,4,11,5,16,1895,1906,11,No,0,8.81,24.47,15.66,1114,1079,-35,4520,3525,-995,393.0,2208.0,1815.0,1500.0,0.0,-1500.0
<a href=/player/mcfae101>mcfae101</a>,Ed McFarland,St. Louis Cardinals,CARDS,3,5,7,12,1897,1899,2,No,0,23.25,0.71,-22.54,1111,436,-675,4512,1666,-2846,0.0,668.0,668.0,0.0,0.0,0.0
<a href=/player/mcfae101>mcfae101</a>,Ed McFarland,Chicago White Sox,WSOX,1,1,1,2,1908,1909,1,No,0,0.34,-0.98,-1.32,19,32,13,50,53,3,0.0,0.0,0.0,0.0,0.0,0.0
<a href=/player/mcfal101>mcfal101</a>,Leon McFadden,Houston Astros,ASTROS,1,2,1,3,1970,1973,3,No,0,-0.36,4.11,4.47,121,272,151,243,41,-202,0.0,713.0,713.0,0.0,0.0,0.0
<a href=/player/mcgaa001>mcgaa001</a>,Andy McGaffigan,New York Yankees,YANKS,1,2,1,3,1982,1983,1,No,0,0.43,-1.33,-1.76,102,24,-78,34,0,-34,441.0,285.0,-156.0,0.0,0.0,0.0
<a href=/player/mcgaa001>mcgaa001</a>,Andy McGaffigan,Montreal Expos,NATEX,5,6,7,13,1984,1990,6,No,0,0.99,-0.06,-1.05,232,245,13,372,641,269,776.0,129.0,-647.0,0.0,0.0,0.0
<a href=/player/mcgaa001>mcgaa001</a>,Andy McGaffigan,Cincinnati Reds,REDS,3,6,4,10,1985,1988,3,No,0,12.45,4.93,-7.52,892,228,-664,620,336,-284,4251.0,1549.0,-2702.0,1777500.0,0.0,-1777500.0
<a href=/player/mcgaa001>mcgaa001</a>,Andy McGaffigan,Montreal Expos,NATEX,1,1,1,2,1990,1990,0,No,0,-0.34,0.0,0.34,8,0,-8,0,0,0,14.0,0.0,-14.0,0.0,0.0,0.0
<a href=/player/mcgac101>mcgac101</a>,Chippy McGarr,Philadelphia Athletics,ATLTCS,1,4,2,6,1887,1892,5,No,0,4.43,9.58,5.15,169,488,319,668,2210,1542,0.0,3.0,3.0,0.0,0.0,0.0
<a href=/player/mcgad102>mcgad102</a>,Dan McGann,Washington Senators,WSN,2,4,6,10,1897,1900,3,No,0,18.96,3.72,-15.24,481,583,102,1837,2412,575,1122.0,0.0,-1122.0,0.0,0.0,0.0
<a href=/player/mcgad102>mcgad102</a>,Dan McGann,Brooklyn Dodgers,DOGRS,1,2,1,3,1899,1902,3,No,0,2.44,3.21,0.77,77,202,125,321,766,445,0.0,0.0,0.0,0.0,0.0,0.0
<a href=/player/mcgad102>mcgad102</a>,Dan McGann,New York Giants,GIANTS,4,11,6,17,1907,1921,14,No,0,45.64,34.38,-11.26,2445,1600,-845,8369,5323,-3046,1733.0,2915.0,1182.0,6400.0,0.0,-6400.0
<a href=/player/mcgad102>mcgad102</a>,Dan McGann,Cincinnati Reds,REDS,1,2,1,3,1909,1909,0,No,0,0.0,-0.02,-0.02,0,56,56,0,162,162,0.0,0.0,0.0,0.0,0.0,0.0
<a href=/player/mcgeb101>mcgeb101</a>,Bill McGee,St. Louis Cardinals,CARDS,1,1,3,4,1941,1944,3,No,0,-0.79,6.28,7.07,106,205,99,63,186,123,632.0,1502.0,870.0,0.0,0.0,0.0
<a href=/player/mcgec001>mcgec001</a>,Casey McGehee,Pittsburgh Pirates,PIRATS,1,1,1,2,2012,2012,0,No,0,-0.66,-0.3,0.36,22,34,12,59,0,-59,0.0,41.0,41.0,2537500.0,0.0,-2537500.0
<a href=/player/mcgec001>mcgec001</a>,Casey McGehee,Milwaukee Brewers,BREWRS,1,1,1,2,2011,2012,1,No,0,0.38,0.53,0.15,92,139,47,293,0,-293,0.0,201.0,201.0,478000.0,0.0,-478000.0
<a href=/player/mcgec001>mcgec001</a>,Casey McGehee,Miami Marlins,MARLNS,4,9,8,17,2014,2019,5,No,0,11.45,0.0,-11.45,589,369,-220,738,128,-610,2851.0,1439.0,-1412.0,1650000.0,0.0,-1650000.0
<a href=/player/mcgef101>mcgef101</a>,Frank McGee,Peoria,Peoria,1,1,1,2,1925,1925,0,No,0,-0.08,0.0,0.08,2,0,-2,3,0,-3,0.0,0.0,0.0,0.0,0.0,0.0
<a href=/player/mcgej001>mcgej001</a>,Jake McGee,Tampa Bay Devil Rays,RAYS,2,3,5,8,2016,2021,5,Yes,0,22.25,4.27,-17.98,873,307,-566,919,1191,272,3030.0,0.0,-3030.0,0.0,0.0,0.0
<a href=/player/mcgek001>mcgek001</a>,Kevin McGehee,San Francisco Giants,GIANTS,1,1,1,2,1993,1993,0,No,0,-0.02,-0.34,-0.32,5,18,13,0,29,29,50.0,0.0,-50.0,0.0,0.0,0.0
<a href=/player/mcgew001>mcgew001</a>,Willie McGee,New York Yankees,YANKS,1,1,1,2,1981,1981,0,No,0,25.57,0.0,-25.57,1661,0,-1661,6100,0,-6100,0.0,0.0,0.0,0.0,0.0,0.0
<a href=/player/mcgew001>mcgew001</a>,Willie McGee,St. Louis Cardinals,CARDS,3,4,7,11,1990,1994,4,No,2,1.02,11.85,10.83,307,640,333,1154,2488,1334,0.0,0.0,0.0,1500000.0,0.0,-1500000.0
<a href=/player/mcghe101>mcghe101</a>,Ed McGhee,Chicago White Sox,WSOX,4,11,8,19,1953,1961,8,No,0,18.88,11.66,-7.22,2482,1258,-1224,8241,3866,-4375,2246.0,488.0,-1758.0,62000.0,0.0,-62000.0
<a href=/player/mcghe101>mcghe101</a>,Ed McGhee,Philadelphia Athletics,ATLTCS,3,5,7,12,1954,1956,2,No,0,1.85,3.26,1.41,238,491,253,141,1005,864,434.0,737.0,303.0,0.0,0.0,0.0
<a href=/player/mcgid101>mcgid101</a>,Dan McGinn,Montreal Expos,NATEX,1,2,2,4,1972,1973,1,No,0,-1.6,-1.59,0.01,85,126,41,8,295,287,188.0,2.0,-186.0,0.0,0.0,0.0
<a href=/player/mcgij104>mcgij104</a>,John McGillen,Philadelphia Athletics,ATLTCS,1,3,1,4,1944,1946,2,No,0,0.0,0.0,0.0,0,0,0,0,0,0,0.0,0.0,0.0,0.0,0.0,0.0
<a href=/player/mcgir001>mcgir001</a>,Russ McGinnis,Milwaukee Brewers,BREWRS,1,1,1,2,1987,1987,0,No,0,0.0,0.0,0.0,0,0,0,0,0,0,0.0,0.0,0.0,0.0,0.0,0.0
<a href=/player/mcgir101>mcgir101</a>,Randy McGilberry,Kansas City Royals,ROYALS,1,1,1,2,1980,1980,0,No,0,0.0,0.0,0.0,0,0,0,0,0,0,0.0,0.0,0.0,0.0,0.0,0.0
<a href=/player/mcglj101>mcglj101</a>,Jim McGlothlin,California Angels,ANGELS,3,6,7,13,1969,1974,5,No,0,8.36,4.59,-3.77,1680,510,-1170,1673,1948,275,4531.0,88.0,-4443.0,15000.0,0.0,-15000.0
<a href=/player/mcglj101>mcglj101</a>,Jim McGlothlin,Cincinnati Reds,REDS,1,1,1,2,1973,1973,0,No,0,0.33,0.0,-0.33,5,0,-5,0,0,0,55.0,0.0,-55.0,0.0,0.0,0.0
<a href=/player/mcgll101>mcgll101</a>,Lynn McGlothen,Boston Red Sox,RSOX,1,3,3,6,1973,1978,5,No,0,14.84,4.69,-10.15,678,283,-395,435,79,-356,3953.0,2795.0,-1158.0,53000.0,0.0,-53000.0
<a href=/player/mcgll101>mcgll101</a>,Lynn McGlothen,St. Louis Cardinals,CARDS,3,5,3,8,1976,1984,8,No,1,12.93,6.84,-6.09,1102,1115,13,4070,2441,-1629,278.0,1190.0,912.0,0.0,0.0,0.0
<a href=/player/mcgll101>mcgll101</a>,Lynn McGlothen,San Francisco Giants,GIANTS,2,2,2,4,1978,1980,2,No,0,7.21,-0.85,-8.06,428,155,-273,463,251,-212,1587.0,138.0,-1449.0,0.0,0.0,0.0
<a href=/player/mcgll101>mcgll101</a>,Lynn McGlothen,Chicago Cubs,CUBS,1,1,1,2,1981,1982,1,No,0,0.02,-0.31,-0.33,11,65,54,0,72,72,65.0,0.0,-65.0,0.0,0.0,0.0
<a href=/player/mcgob101>mcgob101</a>,Beauty McGowan,Newark,Newark,1,1,1,2,1922,1922,0,No,0,-0.47,0.0,0.47,194,0,-194,689,0,-689,0.0,0.0,0.0,0.0,0.0,0.0
<a href=/player/mcgob101>mcgob101</a>,Beauty McGowan,Philadelphia Athletics,ATLTCS,1,4,1,5,1923,1932,9,No,0,0.0,51.22,51.22,0,1240,1240,0,5473,5473,0.0,0.0,0.0,9900.0,0.0,-9900.0
<a href=/player/mcgob101>mcgob101</a>,Beauty McGowan,KansasCity,KansasCity,1,1,1,2,1928,1928,0,No,0,2.78,0.0,-2.78,172,0,-172,725,0,-725,0.0,0.0,0.0,0.0,0.0,0.0
<a href=/player/mcgob101>mcgob101</a>,Beauty McGowan,St.Louis Browns,ORLS,2,5,2,7,1929,1932,3,No,0,0.0,-1.46,-1.46,0,66,66,0,56,56,0.0,187.0,187.0,15500.0,0.0,-15500.0
<a href=/player/mcgok002>mcgok002</a>,Kyle McGowin,Anaheim Angels,ANGELS,1,2,1,3,2016,2017,1,No,0,-0.03,-0.47,-0.44,104,77,-27,6,254,248,215.0,0.0,-215.0,0.0,0.0,0.0
<a href=/player/mcgos001>mcgos001</a>,Scott McGough,Los Angeles Dodgers,DOGRS,1,2,2,4,2012,2014,2,No,0,2.73,9.76,7.03,137,350,213,121,1120,999,1127.0,40.0,-1087.0,0.0,0.0,0.0
<a href=/player/mcgrb101>mcgrb101</a>,Bob McGraw,New York Yankees,YANKS,1,3,1,4,1919,1923,4,No,0,4.53,19.1,14.57,242,331,89,205,452,247,1664.0,3271.0,1607.0,4800.0,0.0,-4800.0
<a href=/player/mcgrb101>mcgrb101</a>,Bob McGraw,Minneapolis,Minneapolis,1,1,3,4,1925,1925,0,No,0,0.71,0.0,-0.71,72,0,-72,74,0,-74,591.0,0.0,-591.0,0.0,0.0,0.0
<a href=/player/mcgrb101>mcgrb101</a>,Bob McGraw,Brooklyn Dodgers,DOGRS,1,1,1,2,1927,1931,4,No,0,-1.16,1.1,2.26,36,327,291,37,1148,1111,282.0,0.0,-282.0,7500.0,0.0,-7500.0
<a href=/player/mcgrb101>mcgrb101</a>,Bob McGraw,Philadelphia Phillies,PHILS,1,2,2,4,1929,1933,4,No,0,-1.21,0.77,1.98,26,281,255,77,572,495,0.0,0.0,0.0,6000.0,0.0,-6000.0
<a href=/player/mcgrb101>mcgrb101</a>,Bob McGraw,New York Yankees,YANKS,3,12,4,16,1921,1928,7,No,0,-3.56,9.03,12.59,367,917,550,1242,3654,2412,159.0,0.0,-159.0,15750.0,0.0,-15750.0
<a href=/player/mcgrf001>mcgrf001</a>,Fred McGriff,New York Yankees,YANKS,1,4,2,6,1982,1985,3,No,0,24.16,-0.71,-24.87,840,62,-778,3265,0,-3265,136.0,360.0,224.0,650000.0,0.0,-650000.0
<a href=/player/mcgrf001>mcgrf001</a>,Fred McGriff,Toronto Blue Jays,BJAYS,3,6,5,11,1990,2002,12,No,2,20.28,30.05,9.77,1139,1849,710,3266,7778,4512,2800.0,760.0,-2040.0,4737500.0,0.0,-4737500.0
<a href=/player/mcgrf001>mcgrf001</a>,Fred McGriff,San Diego Padres,PADRS,3,5,7,12,1993,1998,5,No,0,12.75,-1.51,-14.26,1185,414,-771,4165,455,-3710,1084.0,742.0,-342.0,4300000.0,0.0,-4300000.0
<a href=/player/mcgrf001>mcgrf001</a>,Fred McGriff,Tampa Bay Devil Rays,RAYS,1,1,2,3,2001,2003,2,No,0,3.26,-0.39,-3.65,195,27,-168,796,73,-723,0.0,0.0,0.0,6500000.0,0.0,-6500000.0
<a href=/player/mcgrs001>mcgrs001</a>,Scott McGregor,New York Yankees,YANKS,14,28,25,53,1976,2001,25,No,1,121.7,35.26,-86.44,6187,2228,-3959,13911,5384,-8527,21228.0,6192.0,-15036.0,4415000.0,0.0,-4415000.0
<a href=/player/mcgrt001>mcgrt001</a>,Tug McGraw,New York Mets,METS,6,9,10,19,1974,1984,10,No,0,10.05,22.43,12.38,1462,1185,-277,1334,4141,2807,2280.0,196.0,-2084.0,90000.0,0.0,-90000.0
<a href=/player/mcgrt002>mcgrt002</a>,Terry McGriff,Cincinnati Reds,REDS,1,3,1,4,1990,1993,3,No,0,-0.24,2.7,2.94,60,260,200,65,933,868,497.0,0.0,-497.0,104000.0,0.0,-104000.0
<a href=/player/mcgrt003>mcgrt003</a>,Tom McGraw,Milwaukee Brewers,BREWRS,1,1,1,2,1993,1997,4,No,0,0.0,-0.11,-0.11,0,15,15,0,0,0,0.0,167.0,167.0,0.0,0.0,0.0
<a href=/player/mcguc001>mcguc001</a>,Chris McGuiness,Boston Red Sox,RSOX,1,4,1,5,2010,2013,3,No,0,0.81,5.19,4.38,55,355,300,34,1329,1295,134.0,0.0,-134.0,0.0,0.0,0.0
<a href=/player/mcguc001>mcguc001</a>,Chris McGuiness,Texas Rangers,RNGRS,1,1,1,2,2013,2014,1,No,0,0.0,-0.85,-0.85,0,11,11,0,2,2,0.0,172.0,172.0,0.0,0.0,0.0
<a href=/player/mcgud101>mcgud101</a>,Deacon McGuire,Washington Senators,WSN,1,1,2,3,1899,1900,1,No,0,3.21,2.44,-0.77,202,77,-125,766,321,-445,0.0,0.0,0.0,0.0,0.0,0.0
<a href=/player/mcgum101>mcgum101</a>,Mickey McGuire,Baltimore Orioles,ORLS,1,1,1,2,1970,1973,3,No,0,0.0,0.33,0.33,0,31,31,0,3,3,0.0,74.0,74.0,0.0,0.0,0.0
<a href=/player/mcgur001>mcgur001</a>,Ryan McGuire,Boston Red Sox,RSOX,2,4,3,7,1996,1997,1,No,0,-1.72,2.82,4.54,535,239,-296,705,937,232,864.0,0.0,-864.0,0.0,0.0,0.0
<a href=/player/mcgur002>mcgur002</a>,Reese McGuire,Pittsburgh Pirates,PIRATS,1,3,1,4,2016,2017,1,No,0,1.56,-0.04,-1.6,169,12,-157,400,1,-399,396.0,34.0,-362.0,0.0,0.0,0.0
<a href=/player/mcgwm001>mcgwm001</a>,Mark McGwire,Oakland Athletics,ATLTCS,12,17,19,36,1997,2009,12,No,2,35.21,15.3,-19.91,1840,1242,-598,4553,3398,-1155,7127.0,2558.0,-4569.0,9298500.0,0.0,-9298500.0
<a href=/player/mcham101>mcham101</a>,Marty McHale,Boston Red Sox,RSOX,9,25,23,48,1912,1935,23,No,0,51.77,27.05,-24.72,3792,3039,-753,15081,11185,-3896,0.0,1203.0,1203.0,45050.0,0.0,-45050.0
<a href=/player/mchea101>mchea101</a>,Austin McHenry,Milwaukee,Milwaukee,1,1,4,5,1918,1918,0,No,0,10.1,0.0,-10.1,543,0,-543,2143,0,-2143,0.0,0.0,0.0,0.0,0.0,0.0
<a href=/player/mchev101>mchev101</a>,Vance McHenry,Seattle Mariners,MARNRS,1,1,1,2,1983,1983,0,No,0,0.0,0.0,0.0,0,0,0,0,0,0,0.0,0.0,0.0,0.0,0.0,0.0
<a href=/player/mchuc001>mchuc001</a>,Collin McHugh,New York Mets,METS,1,1,1,2,2013,2014,1,No,0,-0.62,2.01,2.63,8,191,183,4,734,730,57.0,0.0,-57.0,0.0,0.0,0.0
<a href=/player/mcinh101>mcinh101</a>,Harry McIntire,Brooklyn Dodgers,DOGRS,1,1,3,4,1910,1910,0,No,0,2.43,-1.28,-3.71,121,277,156,145,1042,897,1039.0,0.0,-1039.0,0.0,0.0,0.0
<a href=/player/mcinj101>mcinj101</a>,Joe McIntosh,San Diego Padres,PADRS,1,2,1,3,1975,1977,2,No,0,-0.91,4.82,5.73,30,191,161,2,745,743,65.0,0.0,-65.0,0.0,0.0,0.0
<a href=/player/mcinm101>mcinm101</a>,Matty McIntyre,Buffalo,Buffalo,1,2,4,6,1903,1904,1,No,0,16.79,0.0,-16.79,801,0,-801,3453,0,-3453,39.0,0.0,-39.0,0.0,0.0,0.0
<a href=/player/mcinm101>mcinm101</a>,Matty McIntyre,Chicago White Sox,WSOX,1,5,1,6,1912,1928,16,No,0,0.0,33.22,33.22,0,1757,1757,0,6239,6239,0.0,0.0,0.0,0.0,0.0,0.0
<a href=/player/mcins101>mcins101</a>,Stuffy McInnis,Philadelphia Athletics,ATLTCS,3,6,7,13,1918,1923,5,No,0,45.65,20.16,-25.49,2920,1028,-1892,11909,4219,-7690,678.0,0.0,-678.0,2400.0,0.0,-2400.0
<a href=/player/mcins101>mcins101</a>,Stuffy McInnis,Boston Red Sox,RSOX,7,16,21,37,1921,1935,14,No,0,33.5,17.21,-16.29,2930,2181,-749,11538,8048,-3490,0.0,1203.0,1203.0,45050.0,0.0,-45050.0
<a href=/player/mcjad101>mcjad101</a>,Doc McJames,Washington Senators,WSN,2,4,6,10,1897,1900,3,No,0,18.96,3.72,-15.24,481,583,102,1837,2412,575,1122.0,0.0,-1122.0,0.0,0.0,0.0
<a href=/player/mckaa101>mckaa101</a>,Archie McKain,Boston Red Sox,RSOX,1,2,3,5,1938,1940,2,No,0,15.76,-0.33,-16.09,1005,102,-903,3681,69,-3612,671.0,596.0,-75.0,16000.0,0.0,-16000.0
<a href=/player/mckaa101>mckaa101</a>,Archie McKain,St.Louis Browns,ORLS,1,2,1,3,1943,1943,0,No,0,0.96,-1.44,-2.4,36,20,-16,28,16,-12,207.0,157.0,-50.0,12000.0,0.0,-12000.0
<a href=/player/mckah101>mckah101</a>,Hal McKain,Chicago White Sox,WSOX,1,1,1,2,1932,1932,0,No,0,0.0,-0.57,-0.57,0,6,6,0,1,1,0.0,21.0,21.0,5000.0,0.0,-5000.0
<a href=/player/mckeb101>mckeb101</a>,Bill McKechnie,Pittsburgh Pirates,PIRATS,2,6,5,11,1912,1915,3,No,0,18.03,4.57,-13.46,1733,358,-1375,6155,1366,-4789,795.0,0.0,-795.0,13500.0,0.0,-13500.0
<a href=/player/mckeb101>mckeb101</a>,Bill McKechnie,New York Giants,GIANTS,3,6,6,12,1916,1923,7,No,0,51.71,19.99,-31.72,1982,727,-1255,7625,1751,-5874,2062.0,3773.0,1711.0,15800.0,0.0,-15800.0
<a href=/player/mckej001>mckej001</a>,Joel McKeon,Chicago White Sox,WSOX,2,3,2,5,1988,1989,1,No,0,0.24,0.81,0.57,9,66,57,0,229,229,99.0,0.0,-99.0,0.0,0.0,0.0
<a href=/player/mckem001>mckem001</a>,Michael McKenry,Colorado Rockies,ROCKS,3,4,3,7,2011,2012,1,No,0,0.0,0.09,0.09,0,4,4,0,0,0,0.0,6.0,6.0,0.0,0.0,0.0
<a href=/player/mcker103>mcker103</a>,Red McKee,New York Yankees,YANKS,1,1,1,2,1912,1913,1,No,0,1.49,0.22,-1.27,189,23,-166,508,73,-435,0.0,0.0,0.0,0.0,0.0,0.0
<a href=/player/mckia001>mckia001</a>,Andrew McKirahan,Atlanta Braves,BRAVES,2,3,3,6,2017,2017,0,Yes,0,-0.1,1.0,1.1,24,121,97,105,500,395,0.0,0.0,0.0,0.0,0.0,0.0
<a href=/player/mckia101>mckia101</a>,Alex McKinnon,St. Louis Maroons,SL5,1,1,2,3,1886,1887,1,No,0,1.5,0.0,-1.5,48,0,-48,208,0,-208,0.0,0.0,0.0,0.0,0.0,0.0
<a href=/player/mckib001>mckib001</a>,Billy McKinney,Oakland Athletics,ATLTCS,2,6,6,12,2014,2020,6,Yes,0,10.93,24.37,13.44,708,1106,398,2216,4232,2016,860.0,540.0,-320.0,5345000.0,0.0,-5345000.0
<a href=/player/mckib001>mckib001</a>,Billy McKinney,Chicago Cubs,CUBS,1,4,1,5,2016,2016,0,No,0,9.71,1.2,-8.51,545,54,-491,1768,0,-1768,353.0,80.0,-273.0,0.0,0.0,0.0
<a href=/player/mckib001>mckib001</a>,Billy McKinney,New York Yankees,YANKS,1,2,1,3,2018,2020,2,No,0,-1.13,4.31,5.44,271,53,-218,932,4,-928,0.0,823.0,823.0,621900.0,0.0,-621900.0
<a href=/player/mckib001>mckib001</a>,Billy McKinney,Milwaukee Brewers,BREWRS,1,1,1,2,2021,2021,0,Yes,0,0.31,0.0,-0.31,39,0,-39,102,0,-102,0.0,0.0,0.0,0.0,0.0,0.0
<a href=/player/mckib001>mckib001</a>,Billy McKinney,New York Mets,METS,1,1,1,2,2021,2021,0,Yes,0,-0.22,0.0,0.22,37,0,-37,98,0,-98,0.0,0.0,0.0,0.0,0.0,0.0
<a href=/player/mckir101>mckir101</a>,Rich McKinney,Chicago White Sox,WSOX,6,10,7,17,1971,1989,18,No,1,34.29,41.82,7.53,1540,1379,-161,5010,4203,-807,2621.0,3914.0,1293.0,9000.0,0.0,-9000.0
<a href=/player/mckir101>mckir101</a>,Rich McKinney,New York Yankees,YANKS,1,2,1,3,1972,1973,1,No,0,-1.68,1.39,3.07,150,123,-27,306,538,232,22.0,0.0,-22.0,35500.0,0.0,-35500.0
<a href=/player/mcknj101>mcknj101</a>,Jim McKnight,St. Louis Cardinals,CARDS,1,1,1,2,1960,1961,1,No,0,-0.83,-0.33,0.5,63,92,29,93,254,161,0.0,0.0,0.0,0.0,0.0,0.0
<a href=/player/mcknj101>mcknj101</a>,Jim McKnight,Chicago Cubs,CUBS,1,1,1,2,1962,1964,2,No,0,0.0,0.03,0.03,0,20,20,0,38,38,0.0,0.0,0.0,0.0,0.0,0.0
<a href=/player/mcknt001>mcknt001</a>,Tony McKnight,Houston Astros,ASTROS,1,1,1,2,2001,2001,0,No,0,0.08,0.27,0.19,24,50,26,23,0,-23,208.0,67.0,-141.0,0.0,0.0,0.0
<a href=/player/mclab101>mclab101</a>,Bo McLaughlin,Houston Astros,ASTROS,2,2,2,4,1979,1983,4,No,1,-0.34,-1.78,-1.44,74,392,318,6,30,24,149.0,845.0,696.0,0.0,0.0,0.0
<a href=/player/mclab102>mclab102</a>,Byron McLaughlin,Seattle Mariners,MARNRS,1,1,1,2,1980,1981,1,No,0,0.0,0.0,0.0,0,0,0,0,0,0,0.0,0.0,0.0,0.0,0.0,0.0
<a href=/player/mclad101>mclad101</a>,Denny McLain,Detroit Tigers,TIGRS,3,8,7,15,1970,1979,9,No,0,1.68,25.88,24.2,545,2212,1667,1182,7310,6128,747.0,4256.0,3509.0,232600.0,0.0,-232600.0
<a href=/player/mclad101>mclad101</a>,Denny McLain,Texas Rangers,RNGRS,4,5,6,11,1972,1976,4,No,0,2.75,-2.07,-4.82,623,350,-273,1485,570,-915,1225.0,962.0,-263.0,23900.0,0.0,-23900.0
<a href=/player/mclad101>mclad101</a>,Denny McLain,Oakland Athletics,ATLTCS,1,1,1,2,1972,1972,0,No,0,-0.92,0.0,0.92,30,3,-27,16,3,-13,162.0,0.0,-162.0,75000.0,0.0,-75000.0
<a href=/player/mclaj001>mclaj001</a>,Joey McLaughlin,Atlanta Braves,BRAVES,1,3,2,5,1979,1986,7,No,0,6.25,5.96,-0.29,653,1043,390,1647,3360,1713,1023.0,3.0,-1020.0,0.0,0.0,0.0
<a href=/player/mclej101>mclej101</a>,Jim McLeod,Philadelphia Phillies,PHILS,1,3,1,4,1933,1934,1,No,0,0.0,-0.02,-0.02,0,6,6,0,21,21,0.0,0.0,0.0,0.0,0.0,0.0
<a href=/player/mclej101>mclej101</a>,Jim McLeod,Albany,Albany,1,1,1,2,1933,1933,0,No,0,-2.05,0.0,2.05,67,0,-67,251,0,-251,0.0,0.0,0.0,0.0,0.0,0.0
<a href=/player/mclel101>mclel101</a>,Larry McLean,Chicago Cubs,CUBS,2,4,3,7,1903,1912,9,No,0,14.83,52.1,37.27,532,1045,513,1056,2195,1139,4091.0,6835.0,2744.0,0.0,0.0,0.0
<a href=/player/mclel101>mclel101</a>,Larry McLean,St. Louis Cardinals,CARDS,1,1,1,2,1913,1913,0,No,0,-0.02,0.0,0.02,122,2,-120,275,2,-273,0.0,0.0,0.0,0.0,0.0,0.0
<a href=/player/mclem001>mclem001</a>,Mark McLemore,California Angels,ANGELS,1,1,1,2,1990,1993,3,No,0,-0.22,0.7,0.92,8,179,171,12,383,371,0.0,0.0,0.0,175000.0,0.0,-175000.0
<a href=/player/mclem002>mclem002</a>,Marty McLeary,Florida Marlins,MARLNS,1,1,1,2,2004,2004,0,No,0,-0.18,0.0,0.18,6,0,-6,0,0,0,11.0,0.0,-11.0,0.0,0.0,0.0
<a href=/player/mclew101>mclew101</a>,Wayne McLeland,Seattle,Seattle,2,3,6,9,1951,1954,3,No,0,0.2,0.0,-0.2,158,0,-158,88,0,-88,781.0,0.0,-781.0,0.0,0.0,0.0
<a href=/player/mclic101>mclic101</a>,Cal McLish,Brooklyn Dodgers,DOGRS,1,5,2,7,1947,1947,0,No,0,3.3,-0.19,-3.49,337,37,-300,419,81,-338,1285.0,0.0,-1285.0,17500.0,0.0,-17500.0
<a href=/player/mclic101>mclic101</a>,Cal McLish,Pittsburgh Pirates,PIRATS,22,40,53,93,1948,1973,25,No,0,26.59,60.08,33.49,3582,5165,1583,9869,14610,4741,4211.0,5429.0,1218.0,216500.0,0.0,-216500.0
<a href=/player/mclic101>mclic101</a>,Cal McLish,Cleveland Indians,INDINS,3,5,5,10,1959,1965,6,No,0,6.43,1.26,-5.17,1198,354,-844,3637,1453,-2184,454.0,0.0,-454.0,7500.0,0.0,-7500.0
<a href=/player/mclic101>mclic101</a>,Cal McLish,Cincinnati Reds,REDS,1,2,1,3,1960,1963,3,No,0,15.36,2.72,-12.64,449,236,-213,454,894,440,3599.0,0.0,-3599.0,0.0,0.0,0.0
<a href=/player/mclon001>mclon001</a>,Nate McLouth,Pittsburgh Pirates,PIRATS,4,4,7,11,2009,2016,7,Yes,0,-1.1,-1.11,-0.01,303,854,551,1159,1249,90,52.0,4336.0,4284.0,10500000.0,0.0,-10500000.0
<a href=/player/mcmad102>mcmad102</a>,Don McMahon,Cleveland Indians,INDINS,3,6,4,10,1966,1968,2,No,0,5.05,0.29,-4.76,824,214,-610,588,274,-314,3146.0,179.0,-2967.0,27000.0,0.0,-27000.0
<a href=/player/mcmad102>mcmad102</a>,Don McMahon,Boston Red Sox,RSOX,1,2,1,3,1967,1968,1,No,0,3.8,1.35,-2.45,154,163,9,14,561,547,413.0,0.0,-413.0,0.0,0.0,0.0
<a href=/player/mcmad102>mcmad102</a>,Don McMahon,Chicago White Sox,WSOX,1,1,1,2,1968,1968,0,No,0,0.72,-1.22,-1.94,108,34,-74,10,7,-3,218.0,94.0,-124.0,0.0,0.0,0.0
<a href=/player/mcmad102>mcmad102</a>,Don McMahon,Detroit Tigers,TIGRS,1,1,1,2,1969,1972,3,No,0,5.26,-1.81,-7.07,420,190,-230,35,548,513,915.0,0.0,-915.0,0.0,0.0,0.0
<a href=/player/mcmaj102>mcmaj102</a>,Jack McMahan,Pittsburgh Pirates,PIRATS,1,2,1,3,1956,1956,0,No,0,-0.27,-0.37,-0.1,46,11,-35,14,41,27,185.0,0.0,-185.0,0.0,0.0,0.0
<a href=/player/mcmaj102>mcmaj102</a>,Jack McMahan,Kansas City Athletics,ATLTCS,38,80,81,161,1957,1976,19,No,0,137.3,59.64,-77.66,12943,8836,-4107,29783,24655,-5128,18720.0,9434.0,-9286.0,506100.0,0.0,-506100.0
<a href=/player/mcmaj103>mcmaj103</a>,Jack McMahon,New York Giants,GIANTS,2,6,3,9,1894,1899,5,No,0,4.47,33.12,28.65,259,755,496,879,2015,1136,369.0,5250.0,4881.0,0.0,0.0,0.0
<a href=/player/mcmaj105>mcmaj105</a>,Jim McManus,Detroit Tigers,TIGRS,4,12,12,24,1957,1964,7,No,0,6.47,14.38,7.91,1197,947,-250,3186,1303,-1883,1459.0,3692.0,2233.0,0.0,0.0,0.0
<a href=/player/mcmam101>mcmam101</a>,Marty McManus,St.Louis Browns,ORLS,25,52,60,112,1927,1952,25,No,0,169.13,172.17,3.04,8392,11292,2900,28367,37730,9363,13765.0,19339.0,5574.0,243500.0,0.0,-243500.0
<a href=/player/mcmam101>mcmam101</a>,Marty McManus,Detroit Tigers,TIGRS,1,1,1,2,1931,1934,3,No,0,3.49,-0.44,-3.93,216,65,-151,840,211,-629,0.0,0.0,0.0,12500.0,0.0,-12500.0
<a href=/player/mcmib001>mcmib001</a>,Billy McMillon,Florida Marlins,MARLNS,1,1,1,2,1997,1997,0,No,0,0.53,0.48,-0.05,24,52,28,81,152,71,0.0,0.0,0.0,0.0,0.0,0.0
<a href=/player/mcmig001>mcmig001</a>,Greg McMichael,Atlanta Braves,BRAVES,1,1,2,3,1996,1998,2,No,0,1.08,-0.7,-1.78,284,64,-220,4,9,5,480.0,165.0,-315.0,460000.0,0.0,-460000.0
<a href=/player/mcmig001>mcmig001</a>,Greg McMichael,New York Mets,METS,1,2,2,4,1998,1999,1,No,0,1.17,0.6,-0.57,64,36,-28,46,33,-13,438.0,278.0,-160.0,3150000.0,0.0,-3150000.0
<a href=/player/mcmig001>mcmig001</a>,Greg McMichael,Los Angeles Dodgers,DOGRS,2,3,2,5,1998,2010,12,No,1,-0.35,2.59,2.94,141,28,-113,1,35,34,217.0,292.0,75.0,0.0,0.0,0.0
<a href=/player/mcmig001>mcmig001</a>,Greg McMichael,New York Mets,METS,1,2,1,3,1999,1999,0,No,0,4.14,-0.38,-4.52,174,36,-138,0,0,0,542.0,40.0,-502.0,1950000.0,0.0,-1950000.0
<a href=/player/mcmin101>mcmin101</a>,Norm McMillan,New York Yankees,YANKS,1,4,1,5,1923,1934,11,No,0,-1.25,33.68,34.93,272,692,420,598,908,310,765.0,6610.0,5845.0,0.0,0.0,0.0
<a href=/player/mcmin101>mcmin101</a>,Norm McMillan,Boston Red Sox,RSOX,2,3,2,5,1924,1927,3,No,0,-0.11,2.38,2.49,76,333,257,226,1222,996,0.0,0.0,0.0,7200.0,0.0,-7200.0
<a href=/player/mcmin101>mcmin101</a>,Norm McMillan,St.Louis Browns,ORLS,1,4,1,5,1925,1928,3,No,0,0.0,-0.47,-0.47,0,145,145,0,462,462,0.0,0.0,0.0,0.0,0.0,0.0
<a href=/player/mcmir101>mcmir101</a>,Roy McMillan,Cincinnati Reds,REDS,4,5,7,12,1960,1966,6,No,0,21.4,13.65,-7.75,896,630,-266,1971,1304,-667,3861.0,3422.0,-439.0,0.0,0.0,0.0
<a href=/player/mcmir101>mcmir101</a>,Roy McMillan,Milwaukee Braves,BRAVES,1,1,2,3,1964,1969,5,No,0,0.23,-0.08,-0.31,346,4,-342,1225,3,-1222,0.0,0.0,0.0,0.0,0.0,0.0
<a href=/player/mcmit101>mcmit101</a>,Tommy McMillan,Rochester,Rochester,1,1,2,3,1912,1913,1,No,0,-0.21,0.0,0.21,41,0,-41,175,0,-175,0.0,0.0,0.0,0.0,0.0,0.0
<a href=/player/mcmit102>mcmit102</a>,Tom McMillan,Seattle Mariners,MARNRS,5,14,13,27,1978,1985,7,No,0,13.7,0.35,-13.35,1053,894,-159,693,2333,1640,4377.0,1863.0,-2514.0,175000.0,0.0,-175000.0
<a href=/player/mcmuc001>mcmuc001</a>,Craig McMurtry,Atlanta Braves,BRAVES,1,1,2,3,1987,1988,1,No,0,0.0,-0.66,-0.66,0,21,21,0,64,64,0.0,0.0,0.0,0.0,0.0,0.0
<a href=/player/mcmuh101>mcmuh101</a>,Hugh McMullen,Chicago Cubs,CUBS,2,8,3,11,1933,1946,13,No,0,22.35,18.34,-4.01,627,903,276,2568,3781,1213,0.0,0.0,0.0,0.0,0.0,0.0
<a href=/player/mcmuk101>mcmuk101</a>,Ken McMullen,Los Angeles Dodgers,DOGRS,4,12,9,21,1964,1984,20,No,0,57.0,60.48,3.48,4290,2463,-1827,14544,7259,-7285,4034.0,7191.0,3157.0,163000.0,0.0,-163000.0
<a href=/player/mcmuk101>mcmuk101</a>,Ken McMullen,Washington Senators,RNGRS,8,12,14,26,1970,1976,6,No,0,41.95,6.2,-35.75,3496,1129,-2367,11326,2648,-8678,5481.0,1797.0,-3684.0,75900.0,0.0,-75900.0
<a href=/player/mcmuk101>mcmuk101</a>,Ken McMullen,California Angels,ANGELS,9,14,19,33,1972,1977,5,No,0,23.23,20.03,-3.2,1306,1112,-194,3665,3424,-241,3213.0,1843.0,-1370.0,313500.0,0.0,-313500.0
<a href=/player/mcnad102>mcnad102</a>,Dave McNally,Baltimore Orioles,ORLS,12,27,24,51,1974,1994,20,No,3,56.05,125.48,69.43,2623,5978,3355,5494,17245,11751,12340.0,14796.0,2456.0,860333.0,0.0,-860333.0
<a href=/player/mcnae101>mcnae101</a>,Eric McNair,Philadelphia Athletics,ATLTCS,1,2,3,5,1936,1936,0,No,0,2.69,-1.63,-4.32,1023,75,-948,4530,240,-4290,12.0,35.0,23.0,0.0,0.0,0.0
<a href=/player/mcnae101>mcnae101</a>,Eric McNair,Boston Red Sox,RSOX,1,1,1,2,1938,1939,1,No,0,1.32,0.03,-1.29,195,20,-175,793,33,-760,0.0,0.0,0.0,10500.0,0.0,-10500.0
<a href=/player/mcnam101>mcnam101</a>,Mike McNally,Boston Red Sox,RSOX,11,21,24,45,1920,1937,17,No,0,85.68,51.32,-34.36,3377,2671,-706,8411,9094,683,11819.0,4939.0,-6880.0,73300.0,0.0,-73300.0
<a href=/player/mcnam101>mcnam101</a>,Mike McNally,New York Yankees,YANKS,1,1,1,2,1924,1925,1,No,0,0.0,0.11,0.11,0,66,66,0,184,184,0.0,0.0,0.0,5500.0,0.0,-5500.0
<a href=/player/mcnam101>mcnam101</a>,Mike McNally,Boston Red Sox,RSOX,2,3,2,5,1924,1925,1,No,0,-0.33,2.0,2.33,12,119,107,22,474,452,0.0,0.0,0.0,4250.0,0.0,-4250.0
<a href=/player/mcnat101>mcnat101</a>,Tim McNamara,Boston Braves,BRAVES,1,1,1,2,1925,1926,1,No,0,-0.24,-2.55,-2.31,12,89,77,0,45,45,18.0,425.0,407.0,3300.0,0.0,-3300.0
<a href=/player/mcnee101>mcnee101</a>,Earl McNeely,Sacramento,Sacramento,1,1,2,3,1924,1924,0,No,0,3.52,0.0,-3.52,362,0,-362,1353,0,-1353,0.0,0.0,0.0,0.0,0.0,0.0
<a href=/player/mcnee101>mcnee101</a>,Earl McNeely,Washington Senators,TWINS,6,16,10,26,1927,1941,14,No,0,54.71,66.87,12.16,4079,2617,-1462,12814,9775,-3039,8820.0,3821.0,-4999.0,91600.0,0.0,-91600.0
<a href=/player/mcnej001>mcnej001</a>,Jeff McNeely,Boston Red Sox,RSOX,1,2,1,3,1994,1996,2,No,0,0.0,2.28,2.28,0,132,132,0,511,511,0.0,0.0,0.0,122000.0,0.0,-122000.0
<a href=/player/mcnej101>mcnej101</a>,Jerry McNertney,Milwaukee Brewers,BREWRS,5,11,10,21,1970,1978,8,No,0,8.62,9.79,1.17,793,534,-259,2099,1479,-620,524.0,1634.0,1110.0,180301.0,0.0,-180301.0
<a href=/player/mcner101>mcner101</a>,Rusty McNealy,Seattle Mariners,MARNRS,1,2,1,3,1981,1986,5,No,0,-0.02,2.62,2.64,15,104,89,4,0,-4,0.0,696.0,696.0,0.0,0.0,0.0
<a href=/player/mcner101>mcner101</a>,Rusty McNealy,Oakland Athletics,ATLTCS,3,6,4,10,1983,1985,2,No,0,5.99,6.32,0.33,113,66,-47,0,0,0,1871.0,1218.0,-653.0,600000.0,0.0,-600000.0
<a href=/player/mcnub101>mcnub101</a>,Bill McNulty,Oakland Athletics,ATLTCS,1,2,1,3,1972,1977,5,No,0,0.0,3.91,3.91,0,223,223,0,1,1,0.0,1247.0,1247.0,36400.0,0.0,-36400.0
<a href=/player/mcnub101>mcnub101</a>,Bill McNulty,Texas Rangers,RNGRS,1,1,1,2,1973,1973,0,No,0,0.0,1.38,1.38,0,82,82,0,263,263,0.0,0.0,0.0,0.0,0.0,0.0
<a href=/player/mcnup101>mcnup101</a>,Pat McNulty,Cleveland Indians,INDINS,1,5,1,6,1922,1935,13,No,0,0.0,5.93,5.93,0,850,850,0,2604,2604,0.0,0.0,0.0,0.0,0.0,0.0
<a href=/player/mcqug101>mcqug101</a>,George McQuinn,St.Louis Browns,ORLS,1,1,1,2,1945,1945,0,No,0,-0.74,0.0,0.74,136,0,-136,556,0,-556,0.0,0.0,0.0,10000.0,0.0,-10000.0
<a href=/player/mcqug103>mcqug103</a>,George McQuillan,Philadelphia Phillies,PHILS,12,24,28,52,1910,1931,21,No,0,100.95,91.27,-9.68,4848,5202,354,15981,18765,2784,10753.0,6282.0,-4471.0,25000.0,0.0,-25000.0
<a href=/player/mcqug103>mcqug103</a>,George McQuillan,Cincinnati Reds,REDS,1,2,1,3,1911,1911,0,No,0,0.0,0.0,0.0,0,0,0,0,0,0,0.0,0.0,0.0,0.0,0.0,0.0
<a href=/player/mcqug103>mcqug103</a>,George McQuillan,Columbus,Columbus,1,1,2,3,1913,1913,0,No,0,3.36,0.0,-3.36,200,0,-200,183,0,-183,1648.0,0.0,-1648.0,0.0,0.0,0.0
<a href=/player/mcquh101>mcquh101</a>,Hugh McQuillan,Boston Braves,BRAVES,8,14,15,29,1922,1938,16,No,0,24.55,24.58,0.03,1430,2750,1320,3384,9349,5965,5737.0,3676.0,-2061.0,46500.0,0.0,-46500.0
<a href=/player/mcquh101>mcquh101</a>,Hugh McQuillan,New York Giants,GIANTS,2,4,4,8,1927,1930,3,No,0,-1.4,7.13,8.53,721,460,-261,1415,1177,-238,3501.0,2253.0,-1248.0,8500.0,0.0,-8500.0
<a href=/player/mcquh102>mcquh102</a>,Herb McQuaid,StPaul,StPaul,1,1,1,2,1925,1925,0,No,0,-0.82,0.0,0.82,34,0,-34,8,0,-8,115.0,0.0,-115.0,0.0,0.0,0.0
<a href=/player/mcqum103>mcqum103</a>,Mike McQueen,Atlanta Braves,BRAVES,1,1,1,2,1974,1974,0,No,0,0.0,0.0,0.0,0,0,0,0,0,0,0.0,0.0,0.0,0.0,0.0,0.0
<a href=/player/mcrab001>mcrab001</a>,Brian McRae,Kansas City Royals,ROYALS,3,7,6,13,1995,1999,4,No,0,9.1,-0.12,-9.22,478,162,-316,1831,0,-1831,148.0,890.0,742.0,0.0,0.0,0.0
<a href=/player/mcrab001>mcrab001</a>,Brian McRae,Chicago Cubs,CUBS,2,4,4,8,1997,2001,4,No,0,3.27,3.1,-0.17,1097,717,-380,1379,2198,819,1191.0,830.0,-361.0,9308333.0,0.0,-9308333.0
<a href=/player/mcrab001>mcrab001</a>,Brian McRae,New York Mets,METS,3,5,4,9,1999,2005,6,No,0,0.19,1.57,1.38,110,682,572,29,1629,1600,370.0,40.0,-330.0,3750000.0,0.0,-3750000.0
<a href=/player/mcrab001>mcrab001</a>,Brian McRae,Colorado Rockies,ROCKS,1,1,1,2,1999,1999,0,No,0,-0.31,0.0,0.31,31,0,-31,101,0,-101,0.0,0.0,0.0,0.0,0.0,0.0
<a href=/player/mcrah001>mcrah001</a>,Hal McRae,Cincinnati Reds,REDS,2,3,4,7,1972,1974,2,No,0,29.0,0.89,-28.11,1940,85,-1855,7657,116,-7541,179.0,420.0,241.0,68500.0,0.0,-68500.0
<a href=/player/mcran101>mcran101</a>,Norm McRae,Detroit Tigers,TIGRS,3,8,7,15,1970,1979,9,No,0,1.68,25.88,24.2,545,2212,1667,1182,7310,6128,747.0,4256.0,3509.0,232600.0,0.0,-232600.0
<a href=/player/mcran101>mcran101</a>,Norm McRae,Texas Rangers,RNGRS,1,1,1,2,1972,1973,1,No,0,0.0,-0.96,-0.96,0,72,72,0,166,166,0.0,0.0,0.0,0.0,0.0,0.0
<a href=/player/mcran101>mcran101</a>,Norm McRae,Detroit Tigers,TIGRS,2,5,2,7,1972,1975,3,No,0,-0.09,-0.55,-0.46,97,196,99,191,508,317,4.0,0.0,-4.0,88300.0,0.0,-88300.0
<a href=/player/mcrek001>mcrek001</a>,Kevin McReynolds,San Diego Padres,PADRS,11,19,22,41,1986,2002,16,No,3,34.86,29.08,-5.78,2329,2441,112,6347,4213,-2134,2952.0,6040.0,3088.0,11083333.0,0.0,-11083333.0
<a href=/player/mcrek001>mcrek001</a>,Kevin McReynolds,New York Mets,METS,12,26,22,48,1991,2019,28,No,2,36.29,81.8,45.51,2523,4623,2100,5539,10481,4942,4638.0,5281.0,643.0,28212657.0,0.0,-28212657.0
<a href=/player/mcrek001>mcrek001</a>,Kevin McReynolds,Kansas City Royals,ROYALS,2,2,3,5,1994,1997,3,No,0,0.55,-1.51,-2.06,91,191,100,377,801,424,0.0,52.0,52.0,250000.0,0.0,-250000.0
<a href=/player/mctib101>mctib101</a>,Bill McTigue,Boston Braves,BRAVES,1,1,1,2,1913,1913,0,No,0,0.0,-0.46,-0.46,0,73,73,0,247,247,0.0,0.0,0.0,0.0,0.0,0.0
<a href=/player/mcwed101>mcwed101</a>,Doug McWeeny,Chicago White Sox,WSOX,2,5,2,7,1922,1931,9,No,0,8.34,28.43,20.09,522,1292,770,2094,5360,3266,0.0,0.0,0.0,22100.0,0.0,-22100.0
<a href=/player/mcwed101>mcwed101</a>,Doug McWeeny,Chicago White Sox,WSOX,6,16,8,24,1924,1936,12,No,0,0.32,2.24,1.92,474,816,342,1478,2777,1299,0.0,222.0,222.0,28700.0,0.0,-28700.0
<a href=/player/mcwed101>mcwed101</a>,Doug McWeeny,Brooklyn Dodgers,DOGRS,1,1,1,2,1930,1932,2,No,0,-0.24,3.36,3.6,16,100,84,8,123,115,77.0,911.0,834.0,0.0,0.0,0.0
<a href=/player/mcwil001>mcwil001</a>,Larry McWilliams,Atlanta Braves,BRAVES,1,1,2,3,1982,1986,4,No,0,8.17,6.94,-1.23,340,204,-136,296,222,-74,2507.0,1805.0,-702.0,90000.0,0.0,-90000.0
<a href=/player/mcwil001>mcwil001</a>,Larry McWilliams,Philadelphia Phillies,PHILS,1,1,1,2,1989,1989,0,No,0,0.1,0.0,-0.1,21,0,-21,0,0,0,123.0,0.0,-123.0,68000.0,0.0,-68000.0
<a href=/player/meacb001>meacb001</a>,Bob Meacham,St. Louis Cardinals,CARDS,1,2,3,5,1982,1982,0,No,0,3.76,0.0,-3.76,464,0,-464,1598,0,-1598,0.0,0.0,0.0,0.0,0.0,0.0
<a href=/player/meacb001>meacb001</a>,Bob Meacham,New York Yankees,YANKS,1,1,1,2,1988,1988,0,No,0,0.0,0.0,0.0,0,0,0,0,0,0,0.0,0.0,0.0,212500.0,0.0,-212500.0
<a href=/player/meacr001>meacr001</a>,Rusty Meacham,Kansas City Royals,ROYALS,1,1,1,2,1996,1996,0,No,0,-0.15,0.0,0.15,15,0,-15,0,0,0,127.0,0.0,-127.0,0.0,0.0,0.0
<a href=/player/meada001>meada001</a>,Austin Meadows,Pittsburgh Pirates,PIRATS,1,3,1,4,2018,2020,2,No,0,12.58,1.43,-11.15,379,64,-315,1364,58,-1306,825.0,516.0,-309.0,556500.0,0.0,-556500.0
<a href=/player/meadb001>meadb001</a>,Brian Meadows,Florida Marlins,MARLNS,1,1,1,2,1999,2001,2,No,0,-0.24,-0.34,-0.1,43,148,105,44,0,-44,374.0,220.0,-154.0,265000.0,0.0,-265000.0
<a href=/player/meadb001>meadb001</a>,Brian Meadows,San Diego Padres,PADRS,5,7,7,14,2000,2005,5,No,0,1.18,0.5,-0.68,503,354,-149,1468,844,-624,511.0,486.0,-25.0,5375000.0,0.0,-5375000.0
<a href=/player/meadl101>meadl101</a>,Lee Meadows,St. Louis Cardinals,CARDS,1,2,3,5,1919,1926,7,No,0,13.87,-0.32,-14.19,461,130,-331,1191,116,-1075,2559.0,705.0,-1854.0,6650.0,0.0,-6650.0
<a href=/player/meadl101>meadl101</a>,Lee Meadows,Philadelphia Phillies,PHILS,2,3,5,8,1923,1925,2,No,0,15.64,3.41,-12.23,721,322,-399,1877,1147,-730,3746.0,484.0,-3262.0,5500.0,0.0,-5500.0
<a href=/player/mecij001>mecij001</a>,Jim Mecir,Seattle Mariners,MARNRS,3,7,5,12,1995,1999,4,No,0,28.82,-1.18,-30.0,1743,533,-1210,4473,1676,-2797,3491.0,1076.0,-2415.0,2835000.0,0.0,-2835000.0
<a href=/player/mecij001>mecij001</a>,Jim Mecir,New York Yankees,YANKS,1,2,2,4,1997,1997,0,No,0,0.0,0.17,0.17,0,28,28,0,103,103,0.0,0.0,0.0,0.0,0.0,0.0
<a href=/player/mecij001>mecij001</a>,Jim Mecir,Tampa Bay Devil Rays,RAYS,1,2,1,3,2000,2006,6,No,0,2.82,0.05,-2.77,267,200,-67,0,2,2,762.0,753.0,-9.0,350000.0,0.0,-350000.0
<a href=/player/medid101>medid101</a>,Doc Medich,New York Yankees,YANKS,4,7,6,13,1975,1988,13,No,1,1.27,58.36,57.09,482,1914,1432,1065,8000,6935,1466.0,1352.0,-114.0,0.0,0.0,0.0
<a href=/player/medid101>medid101</a>,Doc Medich,Pittsburgh Pirates,PIRATS,5,10,11,21,1977,1988,11,No,0,53.71,31.99,-21.72,2929,1675,-1254,9660,6568,-3092,5429.0,149.0,-5280.0,807000.0,0.0,-807000.0
<a href=/player/medir001>medir001</a>,Rafael Medina,New York Yankees,YANKS,11,24,18,42,1997,2013,16,Yes,1,32.6,51.23,18.63,1993,1981,-12,3061,4822,1761,8275.0,6854.0,-1421.0,22173073.0,0.0,-22173073.0
<a href=/player/medir001>medir001</a>,Rafael Medina,San Diego Padres,PADRS,3,8,6,14,1997,2004,7,No,2,9.3,8.56,-0.74,1047,116,-931,3508,178,-3330,311.0,814.0,503.0,0.0,0.0,0.0
<a href=/player/mediy001>mediy001</a>,Yoervis Medina,Seattle Mariners,MARNRS,4,8,5,13,2015,2017,2,Yes,0,4.45,2.99,-1.46,664,250,-414,2424,536,-1888,119.0,403.0,284.0,9532900.0,0.0,-9532900.0
<a href=/player/mediy001>mediy001</a>,Yoervis Medina,Pittsburgh Pirates,PIRATS,1,1,1,2,2016,2016,0,No,0,0.0,0.0,0.0,0,0,0,0,0,0,0.0,0.0,0.0,0.0,0.0,0.0
<a href=/player/medvs001>medvs001</a>,Scott Medvin,Detroit Tigers,TIGRS,5,7,8,15,1985,1991,6,No,0,13.23,9.61,-3.62,999,888,-111,2374,2066,-308,1829.0,1754.0,-75.0,1440000.0,0.0,-1440000.0
<a href=/player/medvs001>medvs001</a>,Scott Medvin,San Francisco Giants,GIANTS,1,2,1,3,1987,1991,4,No,0,-1.33,7.08,8.41,332,192,-140,71,229,158,980.0,1803.0,823.0,0.0,0.0,0.0
<a href=/player/medvs001>medvs001</a>,Scott Medvin,Pittsburgh Pirates,PIRATS,1,1,1,2,1990,1996,6,No,0,-0.11,-0.19,-0.08,5,48,43,0,0,0,13.0,97.0,84.0,0.0,0.0,0.0
<a href=/player/medwj101>medwj101</a>,Joe Medwick,St. Louis Cardinals,CARDS,1,2,5,7,1940,1942,2,No,0,22.71,2.24,-20.47,811,200,-611,2272,485,-1787,3020.0,487.0,-2533.0,0.0,0.0,0.0
<a href=/player/medwj101>medwj101</a>,Joe Medwick,New York Giants,GIANTS,2,3,2,5,1945,1946,1,No,0,-0.4,0.68,1.08,74,93,19,237,277,40,41.0,0.0,-41.0,0.0,0.0,0.0
<a href=/player/meeke001>meeke001</a>,Evan Meek,San Diego Padres,PADRS,1,2,1,3,2006,2007,1,No,0,-0.26,0.94,1.2,13,88,75,1,235,234,47.0,0.0,-47.0,0.0,0.0,0.0
<a href=/player/meekj101>meekj101</a>,Jouett Meekin,Washington Senators,WSN,1,2,3,5,1894,1894,0,No,0,30.33,-0.6,-30.93,706,32,-674,1804,50,-1754,5250.0,309.0,-4941.0,0.0,0.0,0.0
<a href=/player/meekr101>meekr101</a>,Roy Meeker,Philadelphia Athletics,ATLTCS,1,4,1,5,1925,1925,0,No,0,0.0,0.15,0.15,0,133,133,0,522,522,0.0,0.0,0.0,4850.0,0.0,-4850.0
<a href=/player/meekr101>meekr101</a>,Roy Meeker,Portland,Portland,1,2,1,3,1926,1926,0,No,0,-0.58,0.0,0.58,17,0,-17,12,0,-12,63.0,0.0,-63.0,0.0,0.0,0.0
<a href=/player/meeks101>meeks101</a>,Sammy Meeks,Cincinnati Reds,REDS,1,1,2,3,1952,1952,0,No,0,0.0,0.0,0.0,0,0,0,0,0,0,0.0,0.0,0.0,0.0,0.0,0.0
<a href=/player/meied001>meied001</a>,Dave Meier,Texas Rangers,RNGRS,1,2,1,3,1988,1988,0,No,0,-0.02,-0.74,-0.72,2,12,10,5,0,-5,0.0,188.0,188.0,0.0,0.0,0.0
<a href=/player/mejia001>mejia001</a>,Adalberto Mejia,San Francisco Giants,GIANTS,3,3,4,7,2016,2021,5,Yes,0,-0.83,2.17,3.0,274,306,32,850,926,76,443.0,334.0,-109.0,4200000.0,0.0,-4200000.0
<a href=/player/mejie001>mejie001</a>,Erick Mejia,Seattle Mariners,MARNRS,2,2,2,4,2016,2016,0,No,0,0.0,-0.23,-0.23,0,1,1,0,0,0,0.0,15.0,15.0,590000.0,0.0,-590000.0
<a href=/player/mejie001>mejie001</a>,Erick Mejia,Los Angeles Dodgers,DOGRS,1,4,2,6,2018,2021,3,Yes,0,-0.68,0.86,1.54,21,242,221,43,6,-37,41.0,333.0,292.0,0.0,0.0,0.0
<a href=/player/mejif001>mejif001</a>,Francisco Mejia,Cleveland Indians,INDINS,1,1,2,3,2018,2020,2,No,0,0.25,2.92,2.67,116,229,113,344,0,-344,0.0,585.0,585.0,0.0,0.0,0.0
<a href=/player/mejif001>mejif001</a>,Francisco Mejia,San Diego Padres,PADRS,1,4,1,5,2020,2020,0,Yes,0,1.51,0.0,-1.51,105,0,-105,277,0,-277,238.0,0.0,-238.0,0.0,0.0,0.0
<a href=/player/mejih001>mejih001</a>,Humberto Mejia,Miami Marlins,MARLNS,2,4,2,6,2020,2021,1,Yes,0,2.61,2.79,0.18,160,115,-45,284,406,122,441.0,172.0,-269.0,0.0,0.0,0.0
<a href=/player/mejij002>mejij002</a>,Jean Carlos Mejia,Cleveland Indians,INDINS,1,1,1,2,2021,2021,0,No,0,0.0,0.0,0.0,0,0,0,0,0,0,0.0,0.0,0.0,0.0,0.0,0.0
<a href=/player/mejim001>mejim001</a>,Miguel Mejia,Kansas City Royals,ROYALS,1,1,1,2,1995,1996,1,No,0,-0.39,0.0,0.39,45,0,-45,23,0,-23,0.0,0.0,0.0,0.0,0.0,0.0
<a href=/player/mejir001>mejir001</a>,Roberto Mejia,Cincinnati Reds,REDS,1,2,1,3,1996,1996,0,No,0,0.0,1.33,1.33,0,37,37,0,141,141,0.0,0.0,0.0,0.0,0.0,0.0
<a href=/player/mejir101>mejir101</a>,Roman Mejias,Houston Astros,ASTROS,1,1,1,2,1962,1964,2,No,0,-0.35,0.46,0.81,173,146,-27,490,508,18,0.0,0.0,0.0,0.0,0.0,0.0
<a href=/player/mejis101>mejis101</a>,Sam Mejias,Milwaukee Brewers,BREWRS,1,1,1,2,1976,1976,0,No,0,-0.02,1.05,1.07,18,32,14,23,0,-23,0.0,148.0,148.0,0.0,0.0,0.0
<a href=/player/mejis101>mejis101</a>,Sam Mejias,St. Louis Cardinals,CARDS,7,10,11,21,1976,1992,16,No,0,18.25,16.78,-1.47,1455,1377,-78,2974,3172,198,3388.0,4921.0,1533.0,1943333.0,0.0,-1943333.0
<a href=/player/mejis101>mejis101</a>,Sam Mejias,Montreal Expos,NATEX,1,1,2,3,1978,1983,5,No,0,-0.08,3.97,4.05,31,798,767,14,2458,2444,0.0,0.0,0.0,0.0,0.0,0.0
<a href=/player/melam001>melam001</a>,Mark Melancon,New York Yankees,YANKS,1,2,1,3,2010,2010,0,No,0,-0.72,-0.33,0.39,296,37,-259,397,123,-274,275.0,0.0,-275.0,0.0,0.0,0.0
<a href=/player/melam001>melam001</a>,Mark Melancon,Houston Astros,ASTROS,3,4,7,11,2011,2020,9,Yes,0,12.85,10.28,-2.57,1115,873,-242,3907,2456,-1451,460.0,1629.0,1169.0,1011100.0,0.0,-1011100.0
<a href=/player/melam001>melam001</a>,Mark Melancon,Boston Red Sox,RSOX,1,4,2,6,2012,2019,7,No,0,7.63,8.07,0.44,566,624,58,6,2223,2217,907.0,22.0,-885.0,521000.0,0.0,-521000.0
<a href=/player/melam001>melam001</a>,Mark Melancon,Pittsburgh Pirates,PIRATS,2,3,3,6,2016,2020,4,Yes,0,0.57,1.75,1.18,126,151,25,21,0,-21,455.0,223.0,-232.0,0.0,0.0,0.0
<a href=/player/melam001>melam001</a>,Mark Melancon,San Francisco Giants,GIANTS,1,1,2,3,2019,2019,0,Yes,0,1.32,0.0,-1.32,68,0,-68,0,0,0,131.0,0.0,-131.0,14000000.0,0.0,-14000000.0
<a href=/player/melef001>melef001</a>,Francisco Melendez,San Francisco Giants,GIANTS,1,1,1,2,1989,1989,0,No,0,-0.06,0.0,0.06,9,0,-9,13,0,-13,0.0,0.0,0.0,0.0,0.0,0.0
<a href=/player/melej001>melej001</a>,Jose Melendez,San Diego Padres,PADRS,17,33,33,66,1992,2010,18,No,6,19.29,53.59,34.3,3718,4666,948,12670,16245,3575,1341.0,1789.0,448.0,25539800.0,0.0,-25539800.0
<a href=/player/melel101>melel101</a>,Luis Melendez,St. Louis Cardinals,CARDS,8,11,12,23,1976,1992,16,No,0,17.83,16.54,-1.29,1535,1471,-64,3101,3178,77,3388.0,5085.0,1697.0,1943333.0,0.0,-1943333.0
<a href=/player/meles101>meles101</a>,Sam Mele,Boston Red Sox,RSOX,2,4,2,6,1949,1955,6,No,0,5.69,3.6,-2.09,738,340,-398,1644,197,-1447,2239.0,1844.0,-395.0,22000.0,0.0,-22000.0
<a href=/player/meles101>meles101</a>,Sam Mele,Washington Senators,TWINS,7,9,12,21,1952,1962,10,No,0,-0.82,8.13,8.95,582,2192,1610,1770,6562,4792,250.0,2448.0,2198.0,39500.0,0.0,-39500.0
<a href=/player/meles101>meles101</a>,Sam Mele,Chicago White Sox,WSOX,22,41,37,78,1954,1969,15,No,0,45.6,54.96,9.36,4683,4529,-154,11508,9881,-1627,7275.0,8147.0,872.0,218750.0,0.0,-218750.0
<a href=/player/melis101>melis101</a>,Ski Melillo,St.Louis Browns,ORLS,13,24,34,58,1935,1952,17,No,0,53.1,59.51,6.41,2966,6743,3777,8865,20779,11914,6789.0,12669.0,5880.0,136500.0,0.0,-136500.0
<a href=/player/mellk001>mellk001</a>,Keury Mella,San Francisco Giants,GIANTS,1,2,1,3,2015,2015,0,No,0,6.27,0.49,-5.78,455,19,-436,1700,17,-1683,51.0,166.0,115.0,0.0,0.0,0.0
<a href=/player/meloj001>meloj001</a>,Juan Melo,San Diego Padres,PADRS,1,1,1,2,1999,1999,0,No,0,0.0,0.0,0.0,0,0,0,0,0,0,0.0,0.0,0.0,0.0,0.0,0.0
<a href=/player/meloj001>meloj001</a>,Juan Melo,Toronto Blue Jays,BJAYS,1,1,1,2,1999,1999,0,No,0,0.0,0.0,0.0,0,0,0,0,0,0,0.0,0.0,0.0,0.0,0.0,0.0
<a href=/player/meloj001>meloj001</a>,Juan Melo,New York Yankees,YANKS,2,2,2,4,2000,2000,0,No,0,0.35,-0.01,-0.36,58,31,-27,131,51,-80,0.0,0.0,0.0,213000.0,0.0,-213000.0
<a href=/player/meloj002>meloj002</a>,Jon Meloan,Los Angeles Dodgers,DOGRS,1,2,2,4,2008,2011,3,No,0,29.84,9.15,-20.69,1336,406,-930,5723,1608,-4115,6.0,0.0,-6.0,0.0,0.0,0.0
<a href=/player/meloj002>meloj002</a>,Jon Meloan,Cleveland Indians,INDINS,1,1,1,2,2009,2009,0,No,0,0.0,-0.25,-0.25,0,3,3,0,0,0,0.0,7.0,7.0,0.0,0.0,0.0
<a href=/player/meltb101>meltb101</a>,Bill Melton,Chicago White Sox,WSOX,2,5,5,10,1975,1978,3,No,0,1.08,-0.17,-1.25,421,278,-143,1261,1093,-168,18.0,0.0,-18.0,70000.0,0.0,-70000.0
<a href=/player/meltb101>meltb101</a>,Bill Melton,California Angels,ANGELS,1,1,2,3,1976,1977,1,No,0,0.05,0.0,-0.05,50,0,-50,154,0,-154,0.0,0.0,0.0,0.0,0.0,0.0
<a href=/player/meltd101>meltd101</a>,Dave Melton,Kansas City Athletics,ATLTCS,1,1,1,2,1958,1959,1,No,0,0.0,0.0,0.0,0,0,0,0,0,0,0.0,0.0,0.0,0.0,0.0,0.0
<a href=/player/meltr101>meltr101</a>,Rube Melton,Philadelphia Phillies,PHILS,1,1,2,3,1942,1943,1,No,0,3.54,0.0,-3.54,190,0,-190,142,0,-142,1234.0,0.0,-1234.0,0.0,0.0,0.0
<a href=/player/melum001>melum001</a>,Mitch Meluskey,Cleveland Indians,INDINS,1,2,2,4,1995,1995,0,No,0,1.75,0.0,-1.75,147,0,-147,459,0,-459,0.0,0.0,0.0,0.0,0.0,0.0
<a href=/player/melum001>melum001</a>,Mitch Meluskey,Houston Astros,ASTROS,2,4,4,8,2000,2008,8,No,0,0.51,2.1,1.59,210,1212,1002,625,3536,2911,615.0,482.0,-133.0,4015000.0,0.0,-4015000.0
<a href=/player/melvb001>melvb001</a>,Bob Melvin,Detroit Tigers,TIGRS,5,7,8,15,1985,1991,6,No,0,13.23,9.61,-3.62,999,888,-111,2374,2066,-308,1829.0,1754.0,-75.0,1440000.0,0.0,-1440000.0
<a href=/player/melvb001>melvb001</a>,Bob Melvin,San Francisco Giants,GIANTS,1,1,1,2,1989,1991,2,No,0,0.98,3.55,2.57,257,301,44,864,918,54,0.0,0.0,0.0,0.0,0.0,0.0
<a href=/player/melvb001>melvb001</a>,Bob Melvin,Baltimore Orioles,ORLS,1,1,1,2,1991,1992,1,No,0,0.32,1.4,1.08,32,48,16,77,0,-77,0.0,268.0,268.0,650000.0,0.0,-650000.0
<a href=/player/melvb001>melvb001</a>,Bob Melvin,California Angels,ANGELS,1,1,1,2,1994,1994,0,No,0,-0.26,0.1,0.36,11,4,-7,21,0,-21,0.0,20.0,20.0,0.0,0.0,0.0
<a href=/player/menck001>menck001</a>,Kevin Mench,Texas Rangers,RNGRS,4,10,8,18,2006,2013,7,No,4,5.26,17.27,12.01,930,1182,252,2448,4181,1733,1247.0,588.0,-659.0,7270260.0,0.0,-7270260.0
<a href=/player/mendl001>mendl001</a>,Luis Mendoza,Boston Red Sox,RSOX,1,1,1,2,2006,2008,2,No,0,-2.25,0.28,2.53,34,32,-2,2,0,-2,241.0,111.0,-130.0,0.0,0.0,0.0
<a href=/player/mendm101>mendm101</a>,Mario Mendoza,Pittsburgh Pirates,PIRATS,1,3,3,6,1978,1978,0,No,0,-3.43,0.0,3.43,296,0,-296,706,0,-706,404.0,0.0,-404.0,0.0,0.0,0.0
<a href=/player/mendm101>mendm101</a>,Mario Mendoza,Seattle Mariners,MARNRS,2,7,7,14,1980,1985,5,No,0,8.79,3.61,-5.18,489,434,-55,632,1358,726,2623.0,1017.0,-1606.0,175000.0,0.0,-175000.0
<a href=/player/mendr002>mendr002</a>,Roman Mendez,Boston Red Sox,RSOX,1,4,1,5,2010,2013,3,No,0,0.81,5.19,4.38,55,355,300,34,1329,1295,134.0,0.0,-134.0,0.0,0.0,0.0
<a href=/player/menej101>menej101</a>,Jock Menefee,Louisville Colonels,LS3,1,1,2,3,1894,1894,0,No,0,0.41,-0.65,-1.06,30,30,0,52,117,65,340.0,51.0,-289.0,0.0,0.0,0.0
<a href=/player/mengd001>mengd001</a>,Daniel Mengden,Houston Astros,ASTROS,1,2,1,3,2015,2015,0,No,0,2.02,-0.15,-2.17,65,14,-51,15,2,-13,908.0,220.0,-688.0,0.0,0.0,0.0
<a href=/player/menhp001>menhp001</a>,Paul Menhart,Toronto Blue Jays,BJAYS,2,3,3,6,1995,1996,1,No,0,-1.74,0.08,1.82,122,9,-113,179,30,-149,326.0,0.0,-326.0,218000.0,0.0,-218000.0
<a href=/player/menhp001>menhp001</a>,Paul Menhart,Seattle Mariners,MARNRS,1,1,1,2,1997,1997,0,No,0,0.45,0.0,-0.45,17,0,-17,14,0,-14,132.0,0.0,-132.0,0.0,0.0,0.0
<a href=/player/menkd101>menkd101</a>,Denis Menke,Atlanta Braves,BRAVES,1,2,2,4,1967,1974,7,No,0,20.12,0.7,-19.42,938,637,-301,2766,2102,-664,2072.0,0.0,-2072.0,0.0,0.0,0.0
<a href=/player/menkd101>menkd101</a>,Denis Menke,Houston Astros,ASTROS,8,15,14,29,1971,1989,18,No,0,76.39,55.08,-21.31,4763,4769,6,15346,14810,-536,3810.0,5622.0,1812.0,705000.0,0.0,-705000.0
<a href=/player/menkd101>menkd101</a>,Denis Menke,Cincinnati Reds,REDS,3,3,5,8,1974,1977,3,No,0,17.28,0.57,-16.71,269,116,-153,34,72,38,4814.0,634.0,-4180.0,0.0,0.0,0.0
<a href=/player/menom101>menom101</a>,Mike Menosky,Washington Senators,TWINS,3,6,5,11,1919,1926,7,No,0,13.31,20.32,7.01,1029,562,-467,3656,1370,-2286,534.0,3052.0,2518.0,16400.0,0.0,-16400.0
<a href=/player/meolm101>meolm101</a>,Mike Meola,Chicago Cubs,CUBS,1,1,1,2,1935,1935,0,No,0,-0.2,0.0,0.2,18,0,-18,2,0,-2,58.0,0.0,-58.0,0.0,0.0,0.0
<a href=/player/meolr101>meolr101</a>,Rudy Meoli,California Angels,ANGELS,1,2,1,3,1975,1975,0,No,0,0.37,0.02,-0.35,66,1,-65,152,0,-152,0.0,15.0,15.0,0.0,0.0,0.0
<a href=/player/meolr101>meolr101</a>,Rudy Meoli,San Diego Padres,PADRS,2,2,2,4,1976,1984,8,No,1,0.0,1.54,1.54,0,262,262,0,461,461,0.0,0.0,0.0,0.0,0.0,0.0
<a href=/player/merch002>merch002</a>,Hector Mercado,Philadelphia Phillies,PHILS,1,1,1,2,1997,1997,0,No,0,0.0,0.0,0.0,0,0,0,0,0,0,0.0,0.0,0.0,0.0,0.0,0.0
<a href=/player/merch002>merch002</a>,Hector Mercado,Cincinnati Reds,REDS,1,1,1,2,2002,2004,2,No,0,-0.39,-0.16,0.23,87,235,148,6,505,499,173.0,0.0,-173.0,0.0,0.0,0.0
<a href=/player/merck001>merck001</a>,Kent Mercker,Atlanta Braves,BRAVES,1,1,2,3,1995,1997,2,No,0,-1.07,-0.03,1.04,14,84,70,0,3,3,174.0,150.0,-24.0,2250000.0,0.0,-2250000.0
<a href=/player/merck001>merck001</a>,Kent Mercker,Baltimore Orioles,ORLS,1,1,1,2,1996,1996,0,No,0,0.32,0.17,-0.15,10,64,54,0,263,263,35.0,0.0,-35.0,2825000.0,0.0,-2825000.0
<a href=/player/merck001>merck001</a>,Kent Mercker,St. Louis Cardinals,CARDS,2,3,4,7,1999,2002,3,No,0,0.57,1.5,0.93,13,220,207,1,30,29,89.0,465.0,376.0,2800000.0,0.0,-2800000.0
<a href=/player/merck001>merck001</a>,Kent Mercker,Cincinnati Reds,REDS,1,1,1,2,2003,2008,5,No,0,0.54,0.56,0.02,36,262,226,1,88,87,51.0,1025.0,974.0,550000.0,0.0,-550000.0
<a href=/player/mercl001>mercl001</a>,Luis Mercedes,Baltimore Orioles,ORLS,1,1,1,2,1993,1993,0,No,0,-0.34,-0.02,0.32,18,5,-13,29,0,-29,0.0,50.0,50.0,120000.0,0.0,-120000.0
<a href=/player/merco001>merco001</a>,Orlando Mercado,Seattle Mariners,MARNRS,1,1,1,2,1985,1986,1,No,0,-0.41,-0.22,0.19,46,80,34,112,205,93,0.0,0.0,0.0,0.0,0.0,0.0
<a href=/player/merco001>merco001</a>,Orlando Mercado,Texas Rangers,RNGRS,1,1,1,2,1987,1987,0,No,0,-0.31,0.0,0.31,10,0,-10,24,0,-24,0.0,0.0,0.0,0.0,0.0,0.0
<a href=/player/merco001>merco001</a>,Orlando Mercado,Detroit Tigers,TIGRS,2,2,2,4,1987,1988,1,No,0,0.2,0.01,-0.19,7,6,-1,6,6,0,0.0,0.0,0.0,0.0,0.0,0.0
<a href=/player/merco002>merco002</a>,Orlando Merced,Pittsburgh Pirates,PIRATS,3,5,8,13,1996,2007,11,No,0,2.44,5.98,3.54,539,1682,1143,911,3950,3039,615.0,1633.0,1018.0,9245000.0,0.0,-9245000.0
<a href=/player/merco002>merco002</a>,Orlando Merced,Minnesota Twins,TWINS,2,4,5,9,1998,2002,4,No,0,-0.39,0.81,1.2,167,43,-124,84,66,-18,831.0,325.0,-506.0,2100000.0,0.0,-2100000.0
<a href=/player/merco003>merco003</a>,Oscar Mercado,St. Louis Cardinals,CARDS,1,1,2,3,2018,2018,0,Yes,0,2.75,0.0,-2.75,223,0,-223,813,0,-813,0.0,0.0,0.0,0.0,0.0,0.0
<a href=/player/merec001>merec001</a>,Cla Meredith,Boston Red Sox,RSOX,1,3,1,4,2006,2008,2,No,0,5.93,-0.85,-6.78,724,107,-617,907,303,-604,712.0,0.0,-712.0,353400.0,0.0,-353400.0
<a href=/player/merec001>merec001</a>,Cla Meredith,San Diego Padres,PADRS,1,1,1,2,2009,2011,2,No,0,0.5,-0.35,-0.85,52,140,88,0,269,269,131.0,0.0,-131.0,430900.0,0.0,-430900.0
<a href=/player/merir001>merir001</a>,Ron Meridith,Houston Astros,ASTROS,1,1,1,2,1984,1984,0,No,0,0.0,0.0,0.0,0,0,0,0,0,0,0.0,0.0,0.0,0.0,0.0,0.0
<a href=/player/merir001>merir001</a>,Ron Meridith,Atlanta Braves,BRAVES,1,1,1,2,1984,1984,0,No,0,0.14,0.0,-0.14,70,0,-70,5,0,-5,155.0,0.0,-155.0,0.0,0.0,0.0
<a href=/player/merir001>merir001</a>,Ron Meridith,Chicago Cubs,CUBS,1,1,2,3,1986,1986,0,No,0,-0.29,0.0,0.29,16,0,-16,0,0,0,71.0,0.0,-71.0,0.0,0.0,0.0
<a href=/player/merkf101>merkf101</a>,Fred Merkle,New York Giants,GIANTS,1,1,1,2,1916,1920,4,No,0,-0.18,2.34,2.52,25,288,263,86,820,734,0.0,0.0,0.0,6000.0,0.0,-6000.0
<a href=/player/merll001>merll001</a>,Lou Merloni,San Diego Padres,PADRS,1,1,1,2,2003,2003,0,No,0,0.05,0.0,-0.05,15,0,-15,34,0,-34,0.0,0.0,0.0,560000.0,0.0,-560000.0
<a href=/player/merrb001>merrb001</a>,Brett Merriman,Colorado Rockies,ROCKS,1,1,2,3,1993,1993,0,No,0,-1.18,0.21,1.39,34,130,96,0,1,1,132.0,187.0,55.0,0.0,0.0,0.0
<a href=/player/merrj001>merrj001</a>,Julian Merryweather,Cleveland Indians,INDINS,1,1,2,3,2018,2018,0,No,0,0.45,0.4,-0.05,21,16,-5,0,60,60,78.0,0.0,-78.0,0.0,0.0,0.0
<a href=/player/merrj102>merrj102</a>,Jim Merritt,Minnesota Twins,TWINS,3,3,5,8,1968,1976,8,No,0,4.61,19.31,14.7,558,760,202,861,1953,1092,2239.0,2568.0,329.0,93000.0,0.0,-93000.0
<a href=/player/merrj102>merrj102</a>,Jim Merritt,Cincinnati Reds,REDS,1,1,2,3,1972,1972,0,No,0,2.11,0.0,-2.11,66,0,-66,0,0,0,589.0,0.0,-589.0,0.0,0.0,0.0
<a href=/player/merrl101>merrl101</a>,Lloyd Merritt,St. Louis Cardinals,CARDS,17,32,26,58,1959,1972,13,No,0,32.69,16.32,-16.37,3575,2596,-979,8857,7912,-945,2795.0,1167.0,-1628.0,42500.0,0.0,-42500.0
<a href=/player/merrl101>merrl101</a>,Lloyd Merritt,Los Angeles Dodgers,DOGRS,1,3,2,5,1959,1959,0,No,0,0.0,0.0,0.0,0,0,0,0,0,0,0.0,0.0,0.0,0.0,0.0,0.0
<a href=/player/merts101>merts101</a>,Sam Mertes,Columbus,Columbus,1,2,2,4,1898,1905,7,No,0,6.83,0.0,-6.83,327,0,-327,1338,0,-1338,0.0,0.0,0.0,0.0,0.0,0.0
<a href=/player/merts101>merts101</a>,Sam Mertes,New York Giants,GIANTS,1,2,1,3,1906,1908,2,No,0,0.72,1.14,0.42,182,308,126,648,1333,685,0.0,0.0,0.0,0.0,0.0,0.0
<a href=/player/merum001>merum001</a>,Matt Merullo,Chicago White Sox,WSOX,1,1,1,2,1994,1994,0,No,0,-0.27,0.0,0.27,4,0,-4,13,0,-13,0.0,0.0,0.0,0.0,0.0,0.0
<a href=/player/mesaj001>mesaj001</a>,Jose Mesa,Toronto Blue Jays,BJAYS,1,2,1,3,1987,1990,3,No,0,-2.03,4.09,6.12,69,76,7,0,0,0,1066.0,1357.0,291.0,0.0,0.0,0.0
<a href=/player/mesaj001>mesaj001</a>,Jose Mesa,Baltimore Orioles,ORLS,1,1,1,2,1992,1992,0,No,0,10.38,0.0,-10.38,348,0,-348,0,0,0,1942.0,0.0,-1942.0,0.0,0.0,0.0
<a href=/player/mesaj001>mesaj001</a>,Jose Mesa,Cleveland Indians,INDINS,7,12,14,26,1998,2011,13,No,0,4.4,12.56,8.16,1064,1445,381,2423,3925,1502,442.0,1477.0,1035.0,9756200.0,0.0,-9756200.0
<a href=/player/mesns101>mesns101</a>,Steve Mesner,Chicago Cubs,CUBS,2,4,3,7,1939,1947,8,No,0,5.18,0.94,-4.24,213,106,-107,268,37,-231,1599.0,395.0,-1204.0,7800.0,0.0,-7800.0
<a href=/player/mesod001>mesod001</a>,Devin Mesoraco,Cincinnati Reds,REDS,1,2,1,3,2018,2018,0,No,0,0.75,0.95,0.2,66,48,-18,229,50,-179,0.0,384.0,384.0,0.0,0.0,0.0
<a href=/player/messa101>messa101</a>,Andy Messersmith,California Angels,ANGELS,9,14,19,33,1972,1977,5,No,0,23.23,20.03,-3.2,1306,1112,-194,3665,3424,-241,3213.0,1843.0,-1370.0,313500.0,0.0,-313500.0
<a href=/player/messr001>messr001</a>,Randy Messenger,Florida Marlins,MARLNS,1,1,2,3,2007,2007,0,No,0,0.01,-0.9,-0.91,73,70,-3,0,0,0,122.0,99.0,-23.0,380000.0,0.0,-380000.0
<a href=/player/messt101>messt101</a>,Tom Messitt,Louisville Colonels,LS3,1,12,5,17,1899,1900,1,No,0,267.1,0.0,-267.1,7388,0,-7388,29004,0,-29004,7568.0,0.0,-7568.0,4350.0,0.0,-4350.0
<a href=/player/metkg101>metkg101</a>,George Metkovich,SanFrancisco,SanFrancisco,1,1,2,3,1943,1943,0,No,0,2.88,0.0,-2.88,436,0,-436,1857,0,-1857,0.0,0.0,0.0,0.0,0.0,0.0
<a href=/player/metkg101>metkg101</a>,George Metkovich,Cleveland Indians,INDINS,1,2,1,3,1947,1950,3,No,0,0.0,-0.23,-0.23,0,120,120,0,319,319,0.0,0.0,0.0,0.0,0.0,0.0
<a href=/player/metkg101>metkg101</a>,George Metkovich,Cleveland Indians,INDINS,1,3,1,4,1948,1948,0,No,0,0.0,0.0,0.0,0,0,0,0,0,0,0.0,0.0,0.0,0.0,0.0,0.0
<a href=/player/metkg101>metkg101</a>,George Metkovich,Oakland,Oakland,2,2,4,6,1949,1951,2,No,0,-0.16,0.0,0.16,106,0,-106,394,0,-394,0.0,0.0,0.0,0.0,0.0,0.0
<a href=/player/metkg101>metkg101</a>,George Metkovich,Pittsburgh Pirates,PIRATS,7,12,15,27,1953,1962,9,No,0,9.43,3.47,-5.96,1075,1271,196,3095,3842,747,1449.0,56.0,-1393.0,86000.0,0.0,-86000.0
<a href=/player/metrc101>metrc101</a>,Charlie Metro,Philadelphia Athletics,ATLTCS,2,7,2,9,1945,1954,9,No,0,0.34,26.52,26.18,48,961,913,112,4308,4196,0.0,0.0,0.0,15000.0,0.0,-15000.0
<a href=/player/metza101>metza101</a>,Alex Metzler,WichitaFalls,WichitaFalls,1,1,1,2,1926,1926,0,No,0,-0.21,0.0,0.21,20,0,-20,74,0,-74,0.0,0.0,0.0,0.0,0.0,0.0
<a href=/player/metza101>metza101</a>,Alex Metzler,St.Louis Browns,ORLS,1,4,1,5,1930,1932,2,No,0,0.0,-0.31,-0.31,0,16,16,0,36,36,0.0,0.0,0.0,10000.0,0.0,-10000.0
<a href=/player/metzb101>metzb101</a>,Butch Metzger,San Francisco Giants,GIANTS,10,13,17,30,1974,1998,24,No,0,12.0,28.62,16.62,1215,2851,1636,2939,9682,6743,2410.0,443.0,-1967.0,7402778.0,0.0,-7402778.0
<a href=/player/metzb101>metzb101</a>,Butch Metzger,San Diego Padres,PADRS,2,3,3,6,1977,1982,5,No,0,1.33,-0.97,-2.3,138,452,314,6,464,458,340.0,1013.0,673.0,0.0,0.0,0.0
<a href=/player/metzr101>metzr101</a>,Roger Metzger,Chicago Cubs,CUBS,2,3,3,6,1970,1972,2,No,0,4.59,-1.64,-6.23,1356,116,-1240,4944,71,-4873,2.0,188.0,186.0,0.0,0.0,0.0
<a href=/player/meusi101>meusi101</a>,Irish Meusel,Washington Senators,TWINS,1,1,1,2,1915,1915,0,No,0,0.0,-0.12,-0.12,0,14,14,0,47,47,0.0,0.0,0.0,0.0,0.0,0.0
<a href=/player/meusi101>meusi101</a>,Irish Meusel,Philadelphia Phillies,PHILS,9,18,18,36,1921,1941,20,No,0,54.03,48.35,-5.68,3445,4318,873,13677,14163,486,324.0,6217.0,5893.0,26500.0,0.0,-26500.0
<a href=/player/meyea001>meyea001</a>,Alex Meyer,Washington Nationals,NATEX,1,1,1,2,2012,2015,3,No,0,-0.41,8.42,8.83,6,361,355,0,1605,1605,19.0,0.0,-19.0,0.0,0.0,0.0
<a href=/player/meyea001>meyea001</a>,Alex Meyer,Minnesota Twins,TWINS,1,3,2,5,2016,2018,2,No,0,3.27,-0.15,-3.42,67,80,13,11,0,-11,1029.0,566.0,-463.0,0.0,0.0,0.0
<a href=/player/meyeb101>meyeb101</a>,Billy Meyer,Philadelphia Athletics,ATLTCS,2,7,4,11,1917,1920,3,No,0,0.98,1.52,0.54,143,229,86,582,916,334,0.0,0.0,0.0,2400.0,0.0,-2400.0
<a href=/player/meyeb102>meyeb102</a>,Bob Meyer,Oakland Athletics,ATLTCS,1,2,1,3,1969,1969,0,No,0,-0.03,-0.27,-0.24,41,24,-17,30,3,-27,153.0,57.0,-96.0,0.0,0.0,0.0
<a href=/player/meyeb103>meyeb103</a>,Benny Meyer,Toronto,Toronto,1,1,1,2,1912,1912,0,No,0,-0.42,0.0,0.42,38,0,-38,102,0,-102,0.0,0.0,0.0,0.0,0.0,0.0
<a href=/player/meyed001>meyed001</a>,Dan Meyer,Seattle Mariners,MARNRS,3,3,3,6,1981,1985,4,No,1,-1.58,1.24,2.82,307,237,-70,659,848,189,326.0,39.0,-287.0,0.0,0.0,0.0
<a href=/player/meyed002>meyed002</a>,Dan Meyer,Atlanta Braves,BRAVES,1,3,1,4,2004,2013,9,No,0,-3.0,25.61,28.61,78,476,398,55,578,523,230.0,4719.0,4489.0,370000.0,0.0,-370000.0
<a href=/player/meyed101>meyed101</a>,Dutch Meyer,New York Giants,GIANTS,1,1,1,2,1940,1940,0,No,0,-0.67,0.0,0.67,83,0,-83,283,0,-283,0.0,0.0,0.0,0.0,0.0,0.0
<a href=/player/meyed101>meyed101</a>,Dutch Meyer,Detroit Tigers,TIGRS,1,2,1,3,1945,1947,2,No,0,5.36,14.82,9.46,363,401,38,1392,1659,267,0.0,0.0,0.0,0.0,0.0,0.0
<a href=/player/meyed101>meyed101</a>,Dutch Meyer,Cleveland Indians,INDINS,1,2,1,3,1946,1948,2,No,0,0.0,0.17,0.17,0,46,46,0,71,71,0.0,0.0,0.0,0.0,0.0,0.0
<a href=/player/meyej001>meyej001</a>,Joey Meyer,Minnesota Twins,TWINS,1,1,1,2,1991,1991,0,No,0,0.0,0.0,0.0,0,0,0,0,0,0,0.0,0.0,0.0,0.0,0.0,0.0
<a href=/player/meyer101>meyer101</a>,Russ Meyer,Philadelphia Phillies,PHILS,1,2,1,3,1953,1955,2,No,0,-0.66,5.25,5.91,176,293,117,180,1204,1024,1334.0,0.0,-1334.0,0.0,0.0,0.0
<a href=/player/meyer101>meyer101</a>,Russ Meyer,Brooklyn Dodgers,DOGRS,2,4,4,8,1955,1961,6,No,0,18.38,2.09,-16.29,1649,196,-1453,2986,562,-2424,2426.0,26.0,-2400.0,0.0,0.0,0.0
<a href=/player/meyes101>meyes101</a>,Scott Meyer,Oakland Athletics,ATLTCS,1,2,3,5,1982,1982,0,No,0,0.0,-0.02,-0.02,0,8,8,0,20,20,0.0,0.0,0.0,0.0,0.0,0.0
<a href=/player/miadb001>miadb001</a>,Bart Miadich,Boston Red Sox,RSOX,1,1,1,2,1998,1999,1,No,0,0.0,-0.14,-0.14,0,4,4,0,0,0,0.0,20.0,20.0,0.0,0.0,0.0
<a href=/player/miced001>miced001</a>,Dan Miceli,Kansas City Royals,ROYALS,1,2,1,3,1993,1994,1,No,0,4.73,-0.04,-4.77,577,61,-516,244,0,-244,2577.0,229.0,-2348.0,0.0,0.0,0.0
<a href=/player/miced001>miced001</a>,Dan Miceli,Pittsburgh Pirates,PIRATS,1,1,1,2,1996,1997,1,No,0,0.34,1.0,0.66,73,89,16,0,2,2,248.0,156.0,-92.0,220000.0,0.0,-220000.0
<a href=/player/miced001>miced001</a>,Dan Miceli,Detroit Tigers,TIGRS,2,5,3,8,1997,1998,1,No,0,5.42,-0.93,-6.35,622,96,-526,194,193,-1,1023.0,185.0,-838.0,1475000.0,0.0,-1475000.0
<a href=/player/miced001>miced001</a>,Dan Miceli,San Diego Padres,PADRS,6,8,8,16,1999,2005,6,No,0,0.84,0.26,-0.58,651,397,-254,1468,888,-580,731.0,860.0,129.0,6475000.0,0.0,-6475000.0
<a href=/player/michc101>michc101</a>,Cass Michaels,Chicago White Sox,WSOX,10,25,21,46,1950,1963,13,No,0,23.73,52.01,28.28,4184,3652,-532,12734,11891,-843,4692.0,2309.0,-2383.0,109500.0,0.0,-109500.0
<a href=/player/michc101>michc101</a>,Cass Michaels,Washington Senators,TWINS,2,2,3,5,1952,1954,2,No,0,0.23,-0.78,-1.01,251,84,-167,840,120,-720,0.0,171.0,171.0,14500.0,0.0,-14500.0
<a href=/player/michg101>michg101</a>,Gene Michael,Pittsburgh Pirates,PIRATS,1,2,1,3,1966,1968,2,No,0,-0.49,7.77,8.26,319,302,-17,982,1350,368,0.0,0.0,0.0,0.0,0.0,0.0
<a href=/player/michj001>michj001</a>,Jason Michaels,Philadelphia Phillies,PHILS,1,1,1,2,2006,2006,0,No,0,1.3,0.06,-1.24,249,107,-142,910,0,-910,0.0,137.0,137.0,0.0,0.0,0.0
<a href=/player/michj102>michj102</a>,John Michaels,Buffalo,Buffalo,1,1,2,3,1931,1938,7,No,0,0.01,0.0,-0.01,57,0,-57,22,0,-22,242.0,0.0,-242.0,0.0,0.0,0.0
<a href=/player/mickk001>mickk001</a>,Kameron Mickolio,Seattle Mariners,MARNRS,4,9,5,14,2008,2013,5,No,0,43.53,3.71,-39.82,1975,169,-1806,6859,413,-6446,3908.0,766.0,-3142.0,1000000.0,0.0,-1000000.0
<a href=/player/mickk001>mickk001</a>,Kameron Mickolio,Baltimore Orioles,ORLS,1,2,2,4,2010,2012,2,No,0,1.15,1.04,-0.11,541,290,-251,2,1158,1156,777.0,0.0,-777.0,402500.0,0.0,-402500.0
<a href=/player/middj001>middj001</a>,Jason Middlebrook,San Diego Padres,PADRS,2,5,4,9,2002,2009,7,No,0,20.01,17.43,-2.58,923,844,-79,3191,3702,511,1341.0,29.0,-1312.0,805000.0,0.0,-805000.0
<a href=/player/middj102>middj102</a>,Jim Middleton,Detroit Tigers,TIGRS,1,9,2,11,1921,1941,20,No,0,0.0,3.03,3.03,0,202,202,0,144,144,0.0,1168.0,1168.0,3000.0,0.0,-3000.0
<a href=/player/middw001>middw001</a>,Will Middlebrooks,Boston Red Sox,RSOX,1,1,1,2,2014,2016,2,No,0,-0.81,-0.09,0.72,83,89,6,270,314,44,0.0,0.0,0.0,540000.0,0.0,-540000.0
<a href=/player/midke101>midke101</a>,Ezra Midkiff,New York Yankees,YANKS,6,17,13,30,1913,1931,18,No,0,64.97,69.67,4.7,2396,2595,199,7435,7892,457,6303.0,6917.0,614.0,44500.0,0.0,-44500.0
<a href=/player/miend001>miend001</a>,Doug Mientkiewicz,Minnesota Twins,TWINS,1,1,1,2,2004,2004,0,No,0,-0.34,0.0,0.34,49,0,-49,119,0,-119,0.0,0.0,0.0,2800000.0,0.0,-2800000.0
<a href=/player/miend001>miend001</a>,Doug Mientkiewicz,Boston Red Sox,RSOX,1,2,1,3,2005,2005,0,No,0,1.08,0.0,-1.08,87,0,-87,313,0,-313,0.0,0.0,0.0,0.0,0.0,0.0
<a href=/player/miesm001>miesm001</a>,Matt Mieske,San Diego Padres,PADRS,3,6,6,12,1992,2008,16,No,0,33.52,31.92,-1.6,1981,2091,110,6462,948,-5514,2787.0,3132.0,345.0,3375000.0,0.0,-3375000.0
<a href=/player/miesm001>miesm001</a>,Matt Mieske,Seattle Mariners,MARNRS,1,1,1,2,1999,1999,0,No,0,-0.77,0.0,0.77,116,0,-116,207,0,-207,0.0,0.0,0.0,500000.0,0.0,-500000.0
<a href=/player/mikkp101>mikkp101</a>,Pete Mikkelsen,New York Yankees,YANKS,1,2,1,3,1965,1966,1,No,0,1.61,-0.56,-2.17,206,24,-182,30,14,-16,547.0,134.0,-413.0,11000.0,0.0,-11000.0
<a href=/player/mikkp101>mikkp101</a>,Pete Mikkelsen,Chicago Cubs,CUBS,3,5,5,10,1968,1976,8,No,0,1.41,-2.65,-4.06,244,580,336,611,1135,524,48.0,653.0,605.0,0.0,0.0,0.0
<a href=/player/mikkp101>mikkp101</a>,Pete Mikkelsen,St. Louis Cardinals,CARDS,2,3,4,7,1968,1972,4,No,0,-0.2,0.93,1.13,310,99,-211,33,204,171,825.0,16.0,-809.0,17500.0,0.0,-17500.0
<a href=/player/mikom001>mikom001</a>,Miles Mikolas,San Diego Padres,PADRS,2,3,2,5,2013,2019,6,Yes,0,1.1,0.61,-0.49,248,107,-141,694,312,-382,3.0,0.0,-3.0,0.0,0.0,0.0
<a href=/player/mikom001>mikom001</a>,Miles Mikolas,Pittsburgh Pirates,PIRATS,1,1,1,2,2013,2014,1,No,0,-0.85,0.0,0.85,11,0,-11,2,0,-2,172.0,0.0,-172.0,0.0,0.0,0.0
<a href=/player/mikse101>mikse101</a>,Eddie Miksis,Brooklyn Dodgers,DOGRS,3,6,7,13,1951,1958,7,No,0,4.28,2.12,-2.16,1667,685,-982,5534,2062,-3472,435.0,267.0,-168.0,50000.0,0.0,-50000.0
<a href=/player/mikse101>mikse101</a>,Eddie Miksis,Chicago Cubs,CUBS,5,10,9,19,1956,1965,9,No,0,7.39,7.94,0.55,637,1087,450,1408,195,-1213,1395.0,2758.0,1363.0,0.0,0.0,0.0
<a href=/player/milab001>milab001</a>,Bob Milacki,Kansas City Royals,ROYALS,1,1,1,2,1995,1995,0,No,0,-0.46,0.36,0.82,7,9,2,0,0,0,63.0,96.0,33.0,0.0,0.0,0.0
<a href=/player/milbl001>milbl001</a>,Larry Milbourne,Houston Astros,ASTROS,1,1,1,2,1977,1978,1,No,0,-0.7,0.11,0.81,487,8,-479,1420,0,-1420,0.0,19.0,19.0,0.0,0.0,0.0
<a href=/player/milbl001>milbl001</a>,Larry Milbourne,Seattle Mariners,MARNRS,1,2,2,4,1980,1986,6,No,0,0.82,-0.08,-0.9,108,8,-100,284,16,-268,0.0,0.0,0.0,0.0,0.0,0.0
<a href=/player/milbl001>milbl001</a>,Larry Milbourne,New York Yankees,YANKS,4,8,8,16,1982,1992,10,No,0,8.27,12.89,4.62,1161,565,-596,2474,1712,-762,2564.0,669.0,-1895.0,913333.0,0.0,-913333.0
<a href=/player/milbl001>milbl001</a>,Larry Milbourne,Minnesota Twins,TWINS,1,1,1,2,1982,1982,0,No,0,-0.36,0.0,0.36,82,0,-82,319,0,-319,0.0,0.0,0.0,0.0,0.0,0.0
<a href=/player/milbl001>milbl001</a>,Larry Milbourne,New York Yankees,YANKS,4,9,6,15,1984,2001,17,No,1,21.26,19.8,-1.46,1261,1214,-47,4249,4655,406,3177.0,234.0,-2943.0,0.0,0.0,0.0
<a href=/player/milea001>milea001</a>,Aaron Miles,Chicago White Sox,WSOX,1,1,1,2,2003,2008,5,No,0,0.28,7.33,7.05,233,672,439,913,2504,1591,0.0,0.0,0.0,0.0,0.0,0.0
<a href=/player/milea001>milea001</a>,Aaron Miles,Colorado Rockies,ROCKS,1,2,1,3,2005,2006,1,No,0,1.78,0.15,-1.63,503,131,-372,1507,1,-1506,15.0,134.0,119.0,326000.0,0.0,-326000.0
<a href=/player/milea001>milea001</a>,Aaron Miles,Chicago Cubs,CUBS,1,2,3,5,2009,2010,1,No,0,-0.2,-0.27,-0.07,39,14,-25,106,0,-106,0.0,28.0,28.0,2601500.0,0.0,-2601500.0
<a href=/player/milea001>milea001</a>,Aaron Miles,Oakland Athletics,ATLTCS,1,2,2,4,2010,2013,3,No,0,0.0,1.78,1.78,0,197,197,0,612,612,0.0,0.0,0.0,0.0,0.0,0.0
<a href=/player/miled101>miled101</a>,Dee Miles,Philadelphia Athletics,ATLTCS,1,1,1,2,1942,1944,2,No,0,0.0,1.01,1.01,0,224,224,0,889,889,0.0,0.0,0.0,6000.0,0.0,-6000.0
<a href=/player/miled101>miled101</a>,Dee Miles,Boston Red Sox,RSOX,1,2,1,3,1943,1947,4,No,0,0.0,2.88,2.88,0,436,436,0,1857,1857,0.0,0.0,0.0,6500.0,0.0,-6500.0
<a href=/player/miled101>miled101</a>,Dee Miles,Chattanooga,Chattanooga,1,1,2,3,1938,1939,1,No,0,0.45,0.0,-0.45,373,0,-373,1127,0,-1127,0.0,0.0,0.0,0.0,0.0,0.0
<a href=/player/milew001>milew001</a>,Wade Miley,Arizona Diamondbacks,DBACKS,1,1,3,4,2014,2017,3,Yes,0,2.29,-0.45,-2.74,33,125,92,2,96,94,581.0,834.0,253.0,523500.0,0.0,-523500.0
<a href=/player/milew001>milew001</a>,Wade Miley,Boston Red Sox,RSOX,2,3,3,6,2015,2019,4,Yes,0,1.53,0.12,-1.41,94,36,-58,9,0,-9,632.0,95.0,-537.0,3666000.0,0.0,-3666000.0
<a href=/player/milew001>milew001</a>,Wade Miley,Seattle Mariners,MARNRS,1,1,1,2,2016,2018,2,No,0,-0.59,1.69,2.28,48,47,-1,9,6,-3,634.0,663.0,29.0,0.0,0.0,0.0
<a href=/player/milla001>milla001</a>,Alan Mills,California Angels,ANGELS,1,2,1,3,1987,1988,1,No,0,0.09,0.46,0.37,42,58,16,0,167,167,174.0,0.0,-174.0,0.0,0.0,0.0
<a href=/player/milla001>milla001</a>,Alan Mills,New York Yankees,YANKS,1,1,2,3,1992,1992,0,No,0,5.57,0.0,-5.57,357,0,-357,0,0,0,1440.0,0.0,-1440.0,0.0,0.0,0.0
<a href=/player/milla001>milla001</a>,Alan Mills,Los Angeles Dodgers,DOGRS,1,2,1,3,2000,2001,1,No,0,-0.89,0.51,1.4,42,48,6,0,4,4,113.0,97.0,-16.0,2250000.0,0.0,-2250000.0
<a href=/player/milla002>milla002</a>,Andrew Miller,Detroit Tigers,TIGRS,2,8,3,11,2007,2010,3,No,0,-0.1,-1.19,-1.09,705,27,-678,1077,3,-1074,1506.0,303.0,-1203.0,12380000.0,0.0,-12380000.0
<a href=/player/milla002>milla002</a>,Andrew Miller,Florida Marlins,MARLNS,1,1,1,2,2010,2011,1,No,0,1.45,0.0,-1.45,164,0,-164,4,0,-4,535.0,0.0,-535.0,1790219.0,0.0,-1790219.0
<a href=/player/milla002>milla002</a>,Andrew Miller,Boston Red Sox,RSOX,1,1,1,2,2014,2021,7,No,0,0.96,15.37,14.41,24,172,148,0,29,29,60.0,2570.0,2510.0,1900000.0,0.0,-1900000.0
<a href=/player/milla002>milla002</a>,Andrew Miller,New York Yankees,YANKS,3,5,6,11,2016,2021,5,No,0,3.3,2.69,-0.61,294,299,5,8,815,807,1281.0,615.0,-666.0,0.0,0.0,0.0
<a href=/player/milla003>milla003</a>,Alec Mills,Kansas City Royals,ROYALS,2,2,2,4,2017,2020,3,No,0,0.64,0.0,-0.64,107,0,-107,54,0,-54,706.0,0.0,-706.0,0.0,0.0,0.0
<a href=/player/millb001>millb001</a>,Brad Mills,Toronto Blue Jays,BJAYS,4,16,12,28,2011,2018,7,No,0,25.05,22.05,-3.0,2100,1159,-941,5739,3389,-2350,4683.0,4585.0,-98.0,8732900.0,0.0,-8732900.0
<a href=/player/millb002>millb002</a>,Brad Miller,Seattle Mariners,MARNRS,4,7,6,13,2015,2017,2,Yes,0,9.3,3.09,-6.21,1092,200,-892,3957,584,-3373,347.0,283.0,-64.0,10679600.0,0.0,-10679600.0
<a href=/player/millb002>millb002</a>,Brad Miller,Tampa Bay Devil Rays,RAYS,1,2,1,3,2018,2018,0,Yes,0,-0.1,1.13,1.23,27,49,22,80,189,109,0.0,0.0,0.0,0.0,0.0,0.0
<a href=/player/millb101>millb101</a>,Brad Mills,Montreal Expos,NATEX,1,1,1,2,1984,1984,0,No,0,0.0,0.0,0.0,0,0,0,0,0,0,0.0,0.0,0.0,0.0,0.0,0.0
<a href=/player/millb102>millb102</a>,Bob Miller,Cincinnati Reds,REDS,2,3,2,5,1962,1963,1,No,0,-1.36,0.31,1.67,146,63,-83,266,207,-59,61.0,0.0,-61.0,0.0,0.0,0.0
<a href=/player/millb104>millb104</a>,Bill Miller,New York Yankees,YANKS,12,33,27,60,1954,1970,16,No,0,40.55,76.98,36.43,5201,4368,-833,16466,10777,-5689,3212.0,10751.0,7539.0,302500.0,0.0,-302500.0
<a href=/player/millb106>millb106</a>,Bob Miller,New York Mets,METS,3,5,4,9,1962,1966,4,No,0,4.79,1.88,-2.91,560,368,-192,149,1217,1068,1793.0,0.0,-1793.0,0.0,0.0,0.0
<a href=/player/millb106>millb106</a>,Bob Miller,Los Angeles Dodgers,DOGRS,1,3,2,5,1967,1968,1,No,0,7.85,0.27,-7.58,924,202,-722,948,467,-481,1656.0,285.0,-1371.0,122000.0,0.0,-122000.0
<a href=/player/millb106>millb106</a>,Bob Miller,Minnesota Twins,TWINS,2,5,4,9,1969,1971,2,No,0,19.42,3.86,-15.56,887,264,-623,3069,67,-3002,587.0,852.0,265.0,120000.0,0.0,-120000.0
<a href=/player/millb106>millb106</a>,Bob Miller,Cleveland Indians,INDINS,4,5,5,10,1970,1974,4,No,0,-1.97,-1.79,0.18,296,169,-127,575,413,-162,422.0,0.0,-422.0,83000.0,0.0,-83000.0
<a href=/player/millb106>millb106</a>,Bob Miller,San Diego Padres,PADRS,2,2,3,5,1971,1975,4,No,0,0.01,0.46,0.45,193,350,157,320,469,149,247.0,614.0,367.0,17000.0,0.0,-17000.0
<a href=/player/millb107>millb107</a>,Bruce Miller,Chicago White Sox,WSOX,1,2,1,3,1972,1973,1,No,0,0.0,0.54,0.54,0,38,38,0,7,7,0.0,399.0,399.0,0.0,0.0,0.0
<a href=/player/millb107>millb107</a>,Bruce Miller,California Angels,ANGELS,1,1,1,2,1973,1973,0,No,0,-0.92,0.85,1.77,196,110,-86,593,352,-241,0.0,0.0,0.0,0.0,0.0,0.0
<a href=/player/millb108>millb108</a>,Buster Mills,Boston Red Sox,RSOX,1,3,1,4,1937,1940,3,No,0,5.49,2.22,-3.27,408,291,-117,1388,1330,-58,1283.0,0.0,-1283.0,4000.0,0.0,-4000.0
<a href=/player/millb108>millb108</a>,Buster Mills,St.Louis Browns,ORLS,1,2,2,4,1938,1941,3,No,0,3.15,-0.79,-3.94,102,295,193,121,1044,923,438.0,3.0,-435.0,6000.0,0.0,-6000.0
<a href=/player/millb108>millb108</a>,Buster Mills,New York Yankees,YANKS,1,1,1,2,1942,1944,2,No,0,0.66,-0.23,-0.89,89,36,-53,246,120,-126,0.0,0.0,0.0,0.0,0.0,0.0
<a href=/player/millb110>millb110</a>,Bing Miller,Washington Senators,TWINS,3,6,4,10,1922,1933,11,No,0,25.21,14.57,-10.64,1580,710,-870,6114,2665,-3449,0.0,616.0,616.0,0.0,0.0,0.0
<a href=/player/millb110>millb110</a>,Bing Miller,Philadelphia Athletics,ATLTCS,2,4,2,6,1926,1930,4,No,0,8.5,8.68,0.18,610,175,-435,1746,208,-1538,1683.0,1623.0,-60.0,18500.0,0.0,-18500.0
<a href=/player/millb110>millb110</a>,Bing Miller,St.Louis Browns,ORLS,1,1,1,2,1927,1933,6,No,0,12.57,15.15,2.58,820,476,-344,3078,478,-2600,0.0,3927.0,3927.0,8000.0,0.0,-8000.0
<a href=/player/millb110>millb110</a>,Bing Miller,LittleRock,LittleRock,1,2,2,4,1920,1920,0,No,0,1.39,0.0,-1.39,118,0,-118,471,0,-471,0.0,0.0,0.0,0.0,0.0,0.0
<a href=/player/millb115>millb115</a>,Bill Mills,Philadelphia Athletics,ATLTCS,1,2,1,3,1944,1946,2,No,0,0.0,-0.08,-0.08,0,9,9,0,16,16,0.0,0.0,0.0,0.0,0.0,0.0
<a href=/player/millc001>millc001</a>,Corky Miller,Chicago White Sox,WSOX,1,1,1,2,2009,2009,0,No,0,0.57,0.0,-0.57,70,0,-70,189,0,-189,0.0,0.0,0.0,450000.0,0.0,-450000.0
<a href=/player/milld002>milld002</a>,Damian Miller,Arizona Diamondbacks,DBACKS,1,1,2,3,2002,2002,0,No,0,0.29,0.0,-0.29,114,0,-114,400,0,-400,0.0,0.0,0.0,2650000.0,0.0,-2650000.0
<a href=/player/milld002>milld002</a>,Damian Miller,Chicago Cubs,CUBS,4,7,6,13,2003,2011,8,No,1,3.71,5.06,1.35,539,498,-41,838,1870,1032,801.0,0.0,-801.0,7233333.0,0.0,-7233333.0
<a href=/player/milld101>milld101</a>,Dyar Miller,Baltimore Orioles,ORLS,2,2,2,4,1977,1977,0,No,1,4.21,0.01,-4.2,96,36,-60,0,0,0,637.0,119.0,-518.0,0.0,0.0,0.0
<a href=/player/milld101>milld101</a>,Dyar Miller,Toronto Blue Jays,BJAYS,1,1,1,2,1979,1979,0,No,0,0.0,0.55,0.55,0,36,36,0,121,121,0.0,0.0,0.0,0.0,0.0,0.0
<a href=/player/milld102>milld102</a>,Dots Miller,Pittsburgh Pirates,PIRATS,1,5,3,8,1913,1915,2,No,0,18.03,3.31,-14.72,1733,233,-1500,6155,938,-5217,795.0,0.0,-795.0,11400.0,0.0,-11400.0
<a href=/player/milld106>milld106</a>,Doc Miller,Chicago Cubs,CUBS,2,2,2,4,1910,1913,3,No,0,2.4,8.58,6.18,327,256,-71,1391,268,-1123,0.0,2226.0,2226.0,2500.0,0.0,-2500.0
<a href=/player/milld106>milld106</a>,Doc Miller,Boston Braves,BRAVES,1,1,1,2,1912,1913,1,No,0,0.46,3.7,3.24,136,183,47,285,734,449,0.0,0.0,0.0,3600.0,0.0,-3600.0
<a href=/player/mille001>mille001</a>,Eddie Miller,Texas Rangers,RNGRS,4,9,7,16,1977,1988,11,No,0,9.87,29.07,19.2,738,2027,1289,1844,7192,5348,1774.0,2974.0,1200.0,330000.0,0.0,-330000.0
<a href=/player/mille001>mille001</a>,Eddie Miller,Atlanta Braves,BRAVES,1,1,1,2,1982,1982,0,No,0,-0.76,0.0,0.76,14,0,-14,33,0,-33,0.0,0.0,0.0,0.0,0.0,0.0
<a href=/player/mille001>mille001</a>,Eddie Miller,Detroit Tigers,TIGRS,1,1,1,2,1983,1983,0,No,0,0.0,0.0,0.0,0,0,0,0,0,0,0.0,0.0,0.0,0.0,0.0,0.0
<a href=/player/mille102>mille102</a>,Elmer Miller,New York Yankees,YANKS,2,7,3,10,1922,1928,6,No,0,-3.56,9.12,12.68,367,900,533,1242,3603,2361,159.0,0.0,-159.0,15750.0,0.0,-15750.0
<a href=/player/mille104>mille104</a>,Eddie Miller,Cincinnati Reds,REDS,1,2,1,3,1937,1937,0,No,0,0.0,0.0,0.0,0,0,0,0,0,0,0.0,0.0,0.0,0.0,0.0,0.0
<a href=/player/mille104>mille104</a>,Eddie Miller,New York Yankees,YANKS,2,2,10,12,1938,1943,5,No,0,11.55,-0.14,-11.69,534,36,-498,2161,81,-2080,0.0,0.0,0.0,0.0,0.0,0.0
<a href=/player/mille104>mille104</a>,Eddie Miller,Boston Braves,BRAVES,5,11,9,20,1942,1952,10,No,0,22.0,21.77,-0.23,1506,1101,-405,5516,3280,-2236,0.0,2449.0,2449.0,12500.0,0.0,-12500.0
<a href=/player/mille104>mille104</a>,Eddie Miller,Cincinnati Reds,REDS,4,5,6,11,1948,1958,10,No,0,1.43,11.14,9.71,666,768,102,1969,2530,561,552.0,1210.0,658.0,0.0,0.0,0.0
<a href=/player/millf105>millf105</a>,Felix Millan,Atlanta Braves,BRAVES,2,3,3,6,1972,1978,6,No,0,10.9,-1.86,-12.76,922,458,-464,3059,568,-2491,1139.0,600.0,-539.0,0.0,0.0,0.0
<a href=/player/millh103>millh103</a>,Hack Miller,LosAngeles,LosAngeles,1,1,1,2,1922,1922,0,No,0,5.85,0.0,-5.85,334,0,-334,1258,0,-1258,0.0,0.0,0.0,0.0,0.0,0.0
<a href=/player/millj002>millj002</a>,Justin Miller,Colorado Rockies,ROCKS,5,7,10,17,1999,2015,16,Yes,2,-0.9,20.39,21.29,392,1883,1491,842,1378,536,294.0,2932.0,2638.0,6840000.0,0.0,-6840000.0
<a href=/player/millj002>millj002</a>,Justin Miller,Oakland Athletics,ATLTCS,5,10,9,19,2001,2012,11,No,2,21.78,5.23,-16.55,1503,359,-1144,3041,656,-2385,5533.0,556.0,-4977.0,2433333.0,0.0,-2433333.0
<a href=/player/millj005>millj005</a>,Jim Miller,Colorado Rockies,ROCKS,1,2,1,3,2007,2007,0,No,0,0.16,0.74,0.58,8,27,19,0,24,24,23.0,238.0,215.0,0.0,0.0,0.0
<a href=/player/millj006>millj006</a>,Justin Miller,Toronto Blue Jays,BJAYS,1,1,1,2,2020,2020,0,No,0,0.0,0.0,0.0,0,0,0,0,0,0,0.0,0.0,0.0,0.0,0.0,0.0
<a href=/player/millj104>millj104</a>,John Miller,New York Yankees,YANKS,1,3,1,4,1967,1968,1,No,0,-0.17,-0.55,-0.38,26,78,52,40,208,168,0.0,0.0,0.0,0.0,0.0,0.0
<a href=/player/millj107>millj107</a>,Jack Mills,Cleveland Indians,INDINS,1,3,1,4,1912,1915,3,No,0,0.0,1.09,1.09,0,280,280,0,1151,1151,0.0,0.0,0.0,0.0,0.0,0.0
<a href=/player/millj108>millj108</a>,Jocko Milligan,Philadelphia Athletics,ATLTCS,1,4,2,6,1887,1892,5,No,0,4.43,9.58,5.15,169,488,319,668,2210,1542,0.0,3.0,3.0,0.0,0.0,0.0
<a href=/player/millj109>millj109</a>,Jake Miller,St. Louis Cardinals,CARDS,1,2,1,3,1932,1932,0,No,0,-0.57,0.0,0.57,56,0,-56,40,0,-40,317.0,0.0,-317.0,0.0,0.0,0.0
<a href=/player/millj110>millj110</a>,John Milligan,Philadelphia Phillies,PHILS,1,2,1,3,1933,1933,0,No,0,0.0,0.68,0.68,0,40,40,0,31,31,0.0,246.0,246.0,0.0,0.0,0.0
<a href=/player/millj110>millj110</a>,John Milligan,Albany,Albany,1,1,1,2,1934,1934,0,No,0,-0.04,0.0,0.04,4,0,-4,0,0,0,8.0,0.0,-8.0,0.0,0.0,0.0
<a href=/player/millk001>millk001</a>,Keith Miller,New York Mets,METS,12,26,22,48,1991,2019,28,No,2,36.29,81.8,45.51,2523,4623,2100,5539,10481,4942,4638.0,5281.0,643.0,28212657.0,0.0,-28212657.0
<a href=/player/millk003>millk003</a>,Kurt Miller,Pittsburgh Pirates,PIRATS,2,3,2,5,1991,1992,1,No,0,2.39,2.58,0.19,362,141,-221,1290,483,-807,354.0,265.0,-89.0,2600000.0,0.0,-2600000.0
<a href=/player/millk003>millk003</a>,Kurt Miller,Texas Rangers,RNGRS,1,2,1,3,1993,1994,1,No,0,2.51,0.73,-1.78,607,75,-532,25,0,-25,1163.0,273.0,-890.0,109000.0,0.0,-109000.0
<a href=/player/millk004>millk004</a>,Kevin Millwood,Atlanta Braves,BRAVES,4,4,5,9,2002,2009,7,No,0,2.72,3.38,0.66,375,585,210,751,1130,379,1202.0,864.0,-338.0,5285000.0,0.0,-5285000.0
<a href=/player/millk004>millk004</a>,Kevin Millwood,Texas Rangers,RNGRS,2,4,3,7,2009,2010,1,No,0,0.32,-0.15,-0.47,89,98,9,5,195,190,644.0,95.0,-549.0,13843892.0,0.0,-13843892.0
<a href=/player/milll002>milll002</a>,Lastings Milledge,New York Mets,METS,3,4,4,8,2007,2010,3,No,0,0.57,5.46,4.89,204,547,343,813,1980,1167,0.0,0.0,0.0,8183000.0,0.0,-8183000.0
<a href=/player/milll002>milll002</a>,Lastings Milledge,Washington Nationals,NATEX,2,3,4,7,2009,2012,3,No,0,9.27,5.6,-3.67,881,663,-218,1403,793,-610,688.0,605.0,-83.0,872000.0,0.0,-872000.0
<a href=/player/milll101>milll101</a>,Larry Miller,Los Angeles Dodgers,DOGRS,2,2,2,4,1964,1967,3,No,0,-0.41,-0.22,0.19,64,10,-54,13,7,-6,197.0,0.0,-197.0,0.0,0.0,0.0
<a href=/player/milln101>milln101</a>,Norm Miller,Houston Astros,ASTROS,2,2,2,4,1973,1974,1,No,0,0.07,-0.62,-0.69,58,138,80,60,3,-57,24.0,250.0,226.0,0.0,0.0,0.0
<a href=/player/millo001>millo001</a>,Orlando Miller,New York Yankees,YANKS,2,2,3,5,1990,1995,5,No,0,0.51,0.29,-0.22,372,43,-329,1178,89,-1089,0.0,0.0,0.0,116000.0,0.0,-116000.0
<a href=/player/millo001>millo001</a>,Orlando Miller,Houston Astros,ASTROS,6,12,18,30,1996,2004,8,No,0,25.8,6.98,-18.82,2221,1542,-679,3937,2959,-978,4263.0,3434.0,-829.0,7155000.0,0.0,-7155000.0
<a href=/player/millo002>millo002</a>,Owen Miller,San Diego Padres,PADRS,2,7,4,11,2020,2021,1,Yes,0,3.34,0.62,-2.72,311,5,-306,892,4,-888,493.0,57.0,-436.0,3000000.0,0.0,-3000000.0
<a href=/player/millo101>millo101</a>,Ox Miller,Washington Senators,TWINS,1,3,2,5,1943,1946,3,No,0,0.45,8.73,8.28,110,267,157,206,710,504,209.0,1415.0,1206.0,3000.0,0.0,-3000.0
<a href=/player/millo102>millo102</a>,Otis Miller,Detroit Tigers,TIGRS,2,5,4,9,1927,1934,7,No,0,25.64,16.62,-9.02,1182,957,-225,3618,3579,-39,3712.0,0.0,-3712.0,12500.0,0.0,-12500.0
<a href=/player/millo102>millo102</a>,Otis Miller,St.Louis Browns,ORLS,23,46,52,98,1927,1952,25,No,0,139.77,131.99,-7.78,6854,9855,3001,22708,32907,10199,12609.0,15510.0,2901.0,218500.0,0.0,-218500.0
<a href=/player/millr001>millr001</a>,Rick Miller,California Angels,ANGELS,2,4,3,7,1980,1986,6,No,0,8.12,4.18,-3.94,957,338,-619,2329,1304,-1025,1201.0,0.0,-1201.0,233333.0,0.0,-233333.0
<a href=/player/millr002>millr002</a>,Randy Milligan,New York Mets,METS,3,8,5,13,1988,1992,4,No,2,34.6,11.89,-22.71,847,584,-263,103,1206,1103,6852.0,1699.0,-5153.0,378000.0,0.0,-378000.0
<a href=/player/millr002>millr002</a>,Randy Milligan,Pittsburgh Pirates,PIRATS,1,1,1,2,1988,1988,0,No,0,11.1,0.0,-11.1,511,0,-511,2048,0,-2048,0.0,0.0,0.0,62500.0,0.0,-62500.0
<a href=/player/millr002>millr002</a>,Randy Milligan,Cincinnati Reds,REDS,1,1,1,2,1993,1996,3,No,0,1.09,0.39,-0.7,19,355,336,61,1036,975,0.0,0.0,0.0,635000.0,0.0,-635000.0
<a href=/player/millr002>millr002</a>,Randy Milligan,Cleveland Indians,INDINS,2,2,2,4,1993,1994,1,No,0,-0.11,-0.13,-0.02,57,6,-51,98,0,-98,15.0,40.0,25.0,0.0,0.0,0.0
<a href=/player/millr003>millr003</a>,Ralph Milliard,Florida Marlins,MARLNS,13,17,28,45,1998,2013,15,No,2,104.01,35.0,-69.01,4242,2819,-1423,12260,4200,-8060,7601.0,10460.0,2859.0,18420219.0,0.0,-18420219.0
<a href=/player/millr003>millr003</a>,Ralph Milliard,New York Mets,METS,3,5,4,9,1999,2002,3,No,0,4.04,-0.88,-4.92,267,50,-217,904,26,-878,36.0,198.0,162.0,362500.0,0.0,-362500.0
<a href=/player/millr107>millr107</a>,Ray Miller,Pittsburgh Pirates,PIRATS,1,3,2,5,1917,1919,2,No,0,0.0,0.0,0.0,0,175,175,0,676,676,0.0,0.0,0.0,0.0,0.0,0.0
<a href=/player/millr109>millr109</a>,Randy Miller,Baltimore Orioles,ORLS,6,10,10,20,1977,1994,17,No,1,25.87,32.91,7.04,988,1932,944,938,5757,4819,6735.0,2646.0,-4089.0,713333.0,0.0,-713333.0
<a href=/player/mills001>mills001</a>,Shelby Miller,St. Louis Cardinals,CARDS,1,2,2,4,2014,2016,2,No,0,3.49,7.42,3.93,93,178,85,88,610,522,772.0,31.0,-741.0,521000.0,0.0,-521000.0
<a href=/player/mills001>mills001</a>,Shelby Miller,Atlanta Braves,BRAVES,1,2,3,5,2015,2021,6,Yes,0,-1.25,7.57,8.82,58,639,581,48,2431,2383,417.0,219.0,-198.0,535000.0,0.0,-535000.0
<a href=/player/mills101>mills101</a>,Stu Miller,St. Louis Cardinals,CARDS,1,3,2,5,1956,1958,2,No,0,5.63,6.28,0.65,262,246,-16,209,231,22,1575.0,1837.0,262.0,0.0,0.0,0.0
<a href=/player/mills101>mills101</a>,Stu Miller,Philadelphia Phillies,PHILS,1,1,1,2,1956,1959,3,No,0,13.01,0.61,-12.4,617,162,-455,223,37,-186,2413.0,475.0,-1938.0,0.0,0.0,0.0
<a href=/player/mills101>mills101</a>,Stu Miller,San Francisco Giants,GIANTS,10,18,16,34,1962,1972,10,No,0,36.27,10.66,-25.61,2635,1445,-1190,6319,1774,-4545,3135.0,5237.0,2102.0,50000.0,0.0,-50000.0
<a href=/player/millt002>millt002</a>,Trever Miller,Detroit Tigers,TIGRS,6,13,15,28,1996,2010,14,No,1,13.89,24.32,10.43,4127,1434,-2693,10052,2196,-7856,4562.0,6757.0,2195.0,11529000.0,0.0,-11529000.0
<a href=/player/millt002>millt002</a>,Trever Miller,Houston Astros,ASTROS,1,1,1,2,2000,2000,0,No,0,-0.49,-0.27,0.22,28,65,37,0,1,1,42.0,68.0,26.0,0.0,0.0,0.0
<a href=/player/millt002>millt002</a>,Trever Miller,St. Louis Cardinals,CARDS,5,8,8,16,2011,2019,8,Yes,2,7.33,0.78,-6.55,586,381,-205,1627,154,-1473,283.0,547.0,264.0,3193000.0,0.0,-3193000.0
<a href=/player/millw104>millw104</a>,Ward Miller,Pittsburgh Pirates,PIRATS,1,2,1,3,1909,1909,0,No,0,0.92,0.0,-0.92,124,1,-123,278,0,-278,0.0,0.0,0.0,0.0,0.0,0.0
<a href=/player/milne001>milne001</a>,Eddie Milner,Cincinnati Reds,REDS,1,1,3,4,1987,1988,1,No,0,0.95,2.82,1.87,101,290,189,239,7,-232,0.0,505.0,505.0,0.0,0.0,0.0
<a href=/player/milnj101>milnj101</a>,John Milner,New York Mets,METS,26,52,48,100,1977,2019,42,No,4,46.39,112.66,66.27,4410,7728,3318,9079,17107,8028,8744.0,13190.0,4446.0,33115923.0,0.0,-33115923.0
<a href=/player/milnj101>milnj101</a>,John Milner,Pittsburgh Pirates,PIRATS,1,1,1,2,1981,1982,1,No,0,0.08,-0.4,-0.48,57,65,8,121,74,-47,0.0,0.0,0.0,0.0,0.0,0.0
<a href=/player/milot001>milot001</a>,Tom Milone,Washington Nationals,NATEX,2,6,4,10,2011,2018,7,Yes,0,12.32,19.68,7.36,414,407,-7,1035,430,-605,1666.0,3760.0,2094.0,12000000.0,0.0,-12000000.0
<a href=/player/milot001>milot001</a>,Tom Milone,Oakland Athletics,ATLTCS,1,1,1,2,2014,2016,2,No,0,0.26,1.8,1.54,51,180,129,4,532,528,659.0,0.0,-659.0,510000.0,0.0,-510000.0
<a href=/player/milot001>milot001</a>,Tom Milone,Baltimore Orioles,ORLS,1,1,2,3,2020,2020,0,Yes,0,-0.65,0.0,0.65,3,0,-3,0,0,0,29.0,0.0,-29.0,100000.0,0.0,-100000.0
<a href=/player/milte001>milte001</a>,Eric Milton,New York Yankees,YANKS,1,5,1,6,1998,2001,3,No,0,22.8,7.48,-15.32,1163,539,-624,4014,2478,-1536,2978.0,0.0,-2978.0,0.0,0.0,0.0
<a href=/player/milte001>milte001</a>,Eric Milton,Minnesota Twins,TWINS,1,1,3,4,2003,2010,7,No,0,1.44,19.34,17.9,67,901,834,75,2722,2647,603.0,2374.0,1771.0,6000000.0,0.0,-6000000.0
<a href=/player/mincd101>mincd101</a>,Don Mincher,Chicago White Sox,WSOX,3,5,6,11,1960,1967,7,No,0,32.09,12.95,-19.14,2200,685,-1515,7735,1568,-6167,0.0,2599.0,2599.0,44000.0,0.0,-44000.0
<a href=/player/mincd101>mincd101</a>,Don Mincher,Minnesota Twins,TWINS,3,8,6,14,1966,1971,5,No,0,25.4,14.58,-10.82,1429,584,-845,4690,560,-4130,873.0,2844.0,1971.0,153000.0,0.0,-153000.0
<a href=/player/mincd101>mincd101</a>,Don Mincher,Milwaukee Brewers,BREWRS,13,32,32,64,1970,1984,14,No,0,47.88,123.46,75.58,3414,6405,2991,8076,20920,12844,14309.0,8780.0,-5529.0,506701.0,0.0,-506701.0
<a href=/player/mincd101>mincd101</a>,Don Mincher,Oakland Athletics,ATLTCS,5,12,6,18,1971,1976,5,No,0,13.14,12.72,-0.42,2868,1140,-1728,6939,2992,-3947,2263.0,1076.0,-1187.0,223600.0,0.0,-223600.0
<a href=/player/mincd101>mincd101</a>,Don Mincher,Texas Rangers,RNGRS,12,24,23,47,1972,1992,20,No,2,55.26,25.52,-29.74,2860,1710,-1150,5732,4604,-1128,9799.0,4191.0,-5608.0,214000.0,0.0,-214000.0
<a href=/player/mincn001>mincn001</a>,Nate Minchey,Montreal Expos,NATEX,6,12,13,25,1989,2001,12,No,3,21.4,30.38,8.98,1830,1831,1,4276,2869,-1407,3122.0,2278.0,-844.0,1435000.0,0.0,-1435000.0
<a href=/player/mincn001>mincn001</a>,Nate Minchey,Atlanta Braves,BRAVES,1,2,1,3,1992,1992,0,No,0,-0.49,0.67,1.16,13,28,15,0,0,0,186.0,47.0,-139.0,0.0,0.0,0.0
<a href=/player/mincn001>mincn001</a>,Nate Minchey,Boston Red Sox,RSOX,1,2,1,3,1994,1996,2,No,0,0.0,2.28,2.28,0,132,132,0,511,511,0.0,0.0,0.0,122000.0,0.0,-122000.0
<a href=/player/minec101>minec101</a>,Craig Minetto,Oakland Athletics,ATLTCS,1,1,1,2,1982,1982,0,No,0,0.0,0.0,0.0,0,0,0,0,0,0,0.0,0.0,0.0,0.0,0.0,0.0
<a href=/player/minec101>minec101</a>,Craig Minetto,Baltimore Orioles,ORLS,1,1,1,2,1983,1983,0,No,0,0.0,0.0,0.0,0,0,0,0,0,0,0.0,0.0,0.0,0.0,0.0,0.0
<a href=/player/minez001>minez001</a>,Zach Miner,Atlanta Braves,BRAVES,4,6,5,11,2005,2013,8,No,2,5.24,1.06,-4.18,591,125,-466,1015,0,-1015,1611.0,173.0,-1438.0,318500.0,0.0,-318500.0
<a href=/player/mings101>mings101</a>,Steve Mingori,Cincinnati Reds,REDS,1,1,1,2,1970,1970,0,No,0,2.85,0.05,-2.8,238,6,-232,11,5,-6,437.0,0.0,-437.0,0.0,0.0,0.0
<a href=/player/mings101>mings101</a>,Steve Mingori,Cleveland Indians,INDINS,1,1,1,2,1973,1973,0,No,0,5.57,0.02,-5.55,271,1,-270,1,0,-1,1317.0,2.0,-1315.0,0.0,0.0,0.0
<a href=/player/minob001>minob001</a>,Blas Minor,New York Mets,METS,1,1,1,2,1996,1996,0,No,0,0.05,0.0,-0.05,11,0,-11,0,0,0,76.0,0.0,-76.0,198000.0,0.0,-198000.0
<a href=/player/minod001>minod001</a>,Damon Minor,San Francisco Giants,GIANTS,1,1,1,2,2003,2003,0,No,0,0.0,0.0,0.0,0,0,0,0,0,0,0.0,0.0,0.0,0.0,0.0,0.0
<a href=/player/minom001>minom001</a>,Mike Minor,Texas Rangers,RNGRS,1,2,3,5,2020,2020,0,Yes,0,0.01,0.0,-0.01,5,0,-5,0,0,0,64.0,0.0,-64.0,9833333.0,0.0,-9833333.0
<a href=/player/minom101>minom101</a>,Minnie Minoso,Cleveland Indians,INDINS,1,3,1,4,1951,1951,0,No,0,41.46,1.96,-39.5,1373,108,-1265,5916,24,-5892,0.0,338.0,338.0,0.0,0.0,0.0
<a href=/player/minom101>minom101</a>,Minnie Minoso,Chicago White Sox,WSOX,9,15,19,34,1957,1971,14,No,0,41.54,76.26,34.72,3085,4270,1185,10587,11970,1383,740.0,5807.0,5067.0,72500.0,0.0,-72500.0
<a href=/player/minom101>minom101</a>,Minnie Minoso,Cleveland Indians,INDINS,6,11,11,22,1959,1968,9,No,0,95.02,18.27,-76.75,3674,1436,-2238,12659,5344,-7315,4502.0,50.0,-4452.0,0.0,0.0,0.0
<a href=/player/minom101>minom101</a>,Minnie Minoso,Chicago White Sox,WSOX,4,5,6,11,1961,1969,8,No,0,-2.09,10.93,13.02,366,606,240,692,2313,1621,492.0,0.0,-492.0,70250.0,0.0,-70250.0
<a href=/player/minor001>minor001</a>,Ryan Minor,Baltimore Orioles,ORLS,2,3,2,5,2000,2007,7,No,0,3.08,3.19,0.11,289,330,41,316,9,-307,1690.0,1424.0,-266.0,0.0,0.0,0.0
<a href=/player/mintg001>mintg001</a>,Greg Minton,Kansas City Royals,ROYALS,2,2,2,4,1973,1985,12,No,0,13.17,23.55,10.38,1180,610,-570,327,1060,733,2611.0,5104.0,2493.0,0.0,0.0,0.0
<a href=/player/miraa002>miraa002</a>,Ariel Miranda,Baltimore Orioles,ORLS,1,1,1,2,2016,2017,1,No,0,1.69,-0.59,-2.28,47,48,1,6,9,3,663.0,634.0,-29.0,0.0,0.0,0.0
<a href=/player/mirad001>mirad001</a>,Doug Mirabelli,Texas Rangers,RNGRS,3,3,3,6,2001,2002,1,No,0,15.45,-0.64,-16.09,1058,5,-1053,1159,0,-1159,1966.0,44.0,-1922.0,295000.0,0.0,-295000.0
<a href=/player/mirad001>mirad001</a>,Doug Mirabelli,Boston Red Sox,RSOX,1,1,1,2,2005,2006,1,No,0,-0.24,0.54,0.78,14,155,141,26,703,677,0.0,0.0,0.0,1500000.0,0.0,-1500000.0
<a href=/player/mirad001>mirad001</a>,Doug Mirabelli,San Diego Padres,PADRS,2,2,4,6,2006,2011,5,No,0,-0.35,5.58,5.93,159,864,705,303,1176,873,131.0,712.0,581.0,1930900.0,0.0,-1930900.0
<a href=/player/miraj001>miraj001</a>,Juan Miranda,New York Yankees,YANKS,1,1,1,2,2010,2010,0,No,0,-0.38,0.0,0.38,65,0,-65,202,0,-202,0.0,0.0,0.0,400000.0,0.0,-400000.0
<a href=/player/mirap001>mirap001</a>,Paul Mirabella,Texas Rangers,RNGRS,9,19,16,35,1978,1992,14,No,2,37.88,13.17,-24.71,1966,942,-1024,3128,2227,-901,8593.0,2130.0,-6463.0,0.0,0.0,0.0
<a href=/player/mirap001>mirap001</a>,Paul Mirabella,New York Yankees,YANKS,15,29,25,54,1979,2001,22,No,1,62.96,24.19,-38.77,3819,2347,-1472,10447,5998,-4449,11315.0,5150.0,-6165.0,4715000.0,0.0,-4715000.0
<a href=/player/mirap001>mirap001</a>,Paul Mirabella,Toronto Blue Jays,BJAYS,1,1,1,2,1981,1983,2,No,0,0.0,0.54,0.54,0,63,63,0,0,0,0.0,252.0,252.0,0.0,0.0,0.0
<a href=/player/mirap001>mirap001</a>,Paul Mirabella,Chicago Cubs,CUBS,1,3,1,4,1982,1982,0,No,0,-0.09,0.93,1.02,40,128,88,0,477,477,152.0,0.0,-152.0,0.0,0.0,0.0
<a href=/player/miraw101>miraw101</a>,Willie Miranda,Washington Senators,TWINS,1,1,1,2,1951,1953,2,No,0,0.27,0.52,0.25,70,88,18,172,307,135,0.0,0.0,0.0,0.0,0.0,0.0
<a href=/player/miraw101>miraw101</a>,Willie Miranda,Chicago White Sox,WSOX,2,3,3,6,1952,1954,2,No,0,-0.05,0.64,0.69,740,156,-584,2104,332,-1772,0.0,0.0,0.0,20000.0,0.0,-20000.0
<a href=/player/miraw101>miraw101</a>,Willie Miranda,Chicago White Sox,WSOX,5,13,10,23,1952,1961,9,No,0,17.5,10.87,-6.63,3154,1282,-1872,10106,3886,-6220,2246.0,536.0,-1710.0,62000.0,0.0,-62000.0
<a href=/player/miraw101>miraw101</a>,Willie Miranda,New York Yankees,YANKS,12,33,27,60,1954,1970,16,No,0,40.55,76.98,36.43,5201,4368,-833,16466,10777,-5689,3212.0,10751.0,7539.0,302500.0,0.0,-302500.0
<a href=/player/miraw101>miraw101</a>,Willie Miranda,Baltimore Orioles,ORLS,15,32,27,59,1960,1994,34,No,3,59.45,138.89,79.44,3220,6231,3011,6254,17432,11178,12746.0,15470.0,2724.0,942833.0,0.0,-942833.0
<a href=/player/misia001>misia001</a>,Anthony Misiewicz,Seattle Mariners,MARNRS,1,3,2,5,2017,2019,2,No,0,0.0,0.36,0.36,0,30,30,0,38,38,0.0,44.0,44.0,0.0,0.0,0.0
<a href=/player/misia001>misia001</a>,Anthony Misiewicz,Tampa Bay Devil Rays,RAYS,1,1,1,2,2017,2017,0,No,0,0.33,0.0,-0.33,90,0,-90,0,0,0,224.0,0.0,-224.0,0.0,0.0,0.0
<a href=/player/mitcb001>mitcb001</a>,Bryan Mitchell,New York Yankees,YANKS,2,4,2,6,2017,2018,1,No,0,-1.8,0.0,1.8,81,0,-81,124,0,-124,219.0,0.0,-219.0,13550625.0,0.0,-13550625.0
<a href=/player/mitcb101>mitcb101</a>,Bobby Mitchell,Los Angeles Dodgers,DOGRS,1,2,2,4,1982,1984,2,No,0,5.49,0.0,-5.49,260,0,-260,694,0,-694,1207.0,0.0,-1207.0,0.0,0.0,0.0
<a href=/player/mitcb102>mitcb102</a>,Bobby Mitchell,New York Yankees,YANKS,16,31,27,58,1971,2001,30,No,1,121.02,35.99,-85.03,6582,2374,-4208,14853,5748,-9105,21228.0,6192.0,-15036.0,4415000.0,0.0,-4415000.0
<a href=/player/mitcc001>mitcc001</a>,Charlie Mitchell,Boston Red Sox,RSOX,1,1,1,2,1985,1986,1,No,0,0.0,-0.11,-0.11,0,21,21,0,34,34,0.0,0.0,0.0,0.0,0.0,0.0
<a href=/player/mitcc102>mitcc102</a>,Clarence Mitchell,Brooklyn Dodgers,DOGRS,1,1,1,2,1923,1924,1,No,0,9.33,0.11,-9.22,371,50,-321,424,27,-397,2366.0,273.0,-2093.0,0.0,0.0,0.0
<a href=/player/mitcc102>mitcc102</a>,Clarence Mitchell,St. Louis Cardinals,CARDS,1,1,1,2,1930,1930,0,No,0,1.22,0.0,-1.22,118,0,-118,137,0,-137,1047.0,0.0,-1047.0,0.0,0.0,0.0
<a href=/player/mitcd001>mitcd001</a>,D.J. Mitchell,New York Yankees,YANKS,1,2,1,3,2012,2014,2,No,0,0.38,3.31,2.93,163,360,197,0,1180,1180,533.0,0.0,-533.0,0.0,0.0,0.0
<a href=/player/mitcf101>mitcf101</a>,Fred Mitchell,Boston Braves,BRAVES,1,2,2,4,1916,1919,3,No,0,0.0,-1.02,-1.02,2,181,179,2,722,720,0.0,0.0,0.0,1950.0,0.0,-1950.0
<a href=/player/mitcj001>mitcj001</a>,John Mitchell,Boston Red Sox,RSOX,7,15,13,28,1985,1993,8,No,0,20.97,19.79,-1.18,2048,1909,-139,3771,4732,961,4874.0,3574.0,-1300.0,3550000.0,0.0,-3550000.0
<a href=/player/mitcj001>mitcj001</a>,John Mitchell,New York Mets,METS,1,2,2,4,1989,1990,1,No,0,0.07,-0.15,-0.22,24,8,-16,0,9,9,343.0,0.0,-343.0,0.0,0.0,0.0
<a href=/player/mitcj101>mitcj101</a>,Johnny Mitchell,New York Yankees,YANKS,2,7,3,10,1922,1928,6,No,0,-3.56,9.12,12.68,367,900,533,1242,3603,2361,159.0,0.0,-159.0,15750.0,0.0,-15750.0
<a href=/player/mitcj101>mitcj101</a>,Johnny Mitchell,Vernon,Vernon,1,1,5,6,1920,1929,9,No,0,-0.09,0.0,0.09,17,0,-17,51,0,-51,0.0,0.0,0.0,0.0,0.0,0.0
<a href=/player/mitck001>mitck001</a>,Kevin Mitchell,New York Mets,METS,14,32,26,58,1986,2019,33,No,2,34.33,97.35,63.02,3020,5459,2439,6919,13501,6582,4717.0,5432.0,715.0,28384257.0,0.0,-28384257.0
<a href=/player/mitck001>mitck001</a>,Kevin Mitchell,San Diego Padres,PADRS,7,11,13,24,1987,2002,15,No,2,21.85,22.61,0.76,1316,1503,187,3009,1610,-1399,2250.0,5770.0,3520.0,10183333.0,0.0,-10183333.0
<a href=/player/mitck001>mitck001</a>,Kevin Mitchell,San Francisco Giants,GIANTS,4,7,11,18,1991,1998,7,No,0,10.32,12.82,2.5,410,1133,723,849,798,-51,1958.0,3071.0,1113.0,9577778.0,0.0,-9577778.0
<a href=/player/mitck001>mitck001</a>,Kevin Mitchell,Seattle Mariners,MARNRS,1,1,1,2,1992,1993,1,No,0,7.66,1.01,-6.65,225,35,-190,874,0,-874,0.0,104.0,104.0,3750000.0,0.0,-3750000.0
<a href=/player/mitck001>mitck001</a>,Kevin Mitchell,Boston Red Sox,RSOX,1,1,2,3,1996,1997,1,No,0,1.33,0.0,-1.33,37,0,-37,141,0,-141,0.0,0.0,0.0,1135000.0,0.0,-1135000.0
<a href=/player/mitcm102>mitcm102</a>,Mike Mitchell,Cincinnati Reds,REDS,3,8,5,13,1912,1913,1,No,0,9.38,6.71,-2.67,842,270,-572,2287,704,-1583,1567.0,500.0,-1067.0,11280.0,0.0,-11280.0
<a href=/player/mitcp101>mitcp101</a>,Paul Mitchell,Baltimore Orioles,ORLS,11,24,22,46,1976,1994,18,No,3,56.21,91.98,35.77,2586,4496,1910,5425,11173,5748,12108.0,13984.0,1876.0,713333.0,0.0,-713333.0
<a href=/player/mitcp101>mitcp101</a>,Paul Mitchell,Seattle Mariners,MARNRS,1,1,1,2,1979,1982,3,No,0,0.72,-0.94,-1.66,35,28,-7,0,0,0,493.0,152.0,-341.0,0.0,0.0,0.0
<a href=/player/mitrs001>mitrs001</a>,Sergio Mitre,Chicago Cubs,CUBS,3,8,4,12,2005,2009,4,No,1,27.92,6.53,-21.39,1518,286,-1232,2540,824,-1716,5153.0,718.0,-4435.0,0.0,0.0,0.0
<a href=/player/mitrs001>mitrs001</a>,Sergio Mitre,New York Yankees,YANKS,1,1,1,2,2011,2013,2,No,0,0.18,0.49,0.31,43,85,42,2,72,70,99.0,0.0,-99.0,0.0,0.0,0.0
<a href=/player/mittg101>mittg101</a>,George Mitterwald,Minnesota Twins,TWINS,1,1,1,2,1973,1974,1,No,0,0.12,-0.15,-0.27,373,32,-341,1169,93,-1076,0.0,0.0,0.0,22500.0,0.0,-22500.0
<a href=/player/mizej101>mizej101</a>,Johnny Mize,St. Louis Cardinals,CARDS,1,1,4,5,1941,1948,7,No,0,28.96,5.95,-23.01,655,346,-309,2815,1181,-1634,0.0,38.0,38.0,0.0,0.0,0.0
<a href=/player/mizew101>mizew101</a>,Vinegar Bend Mizell,St. Louis Cardinals,CARDS,16,30,25,55,1960,1972,12,No,0,32.35,16.26,-16.09,3499,2551,-948,8719,7845,-874,2795.0,1167.0,-1628.0,32500.0,0.0,-32500.0
<a href=/player/mizew101>mizew101</a>,Vinegar Bend Mizell,Pittsburgh Pirates,PIRATS,1,1,1,2,1962,1962,0,No,0,-0.78,-0.08,0.7,34,55,21,8,116,108,114.0,0.0,-114.0,0.0,0.0,0.0
<a href=/player/mlicd001>mlicd001</a>,Dave Mlicki,Cleveland Indians,INDINS,5,11,9,20,1994,2001,7,No,0,59.36,5.4,-53.96,3537,380,-3157,10591,1129,-9462,3110.0,195.0,-2915.0,7871666.0,0.0,-7871666.0
<a href=/player/mlicd001>mlicd001</a>,Dave Mlicki,New York Mets,METS,1,2,2,4,1998,1999,1,No,0,1.17,0.6,-0.57,64,36,-28,46,33,-13,438.0,278.0,-160.0,3150000.0,0.0,-3150000.0
<a href=/player/mlicd001>mlicd001</a>,Dave Mlicki,Los Angeles Dodgers,DOGRS,1,2,3,5,1999,1999,0,No,0,0.03,-0.71,-0.74,81,18,-63,9,4,-5,1195.0,47.0,-1148.0,6833334.0,0.0,-6833334.0
<a href=/player/mlicd001>mlicd001</a>,Dave Mlicki,Detroit Tigers,TIGRS,1,1,1,2,2001,2002,1,No,0,0.15,-0.43,-0.58,80,39,-41,57,1,-56,518.0,543.0,25.0,5300000.0,0.0,-5300000.0
<a href=/player/mockg001>mockg001</a>,Garrett Mock,Arizona Diamondbacks,DBACKS,3,4,6,10,2006,2017,11,Yes,1,2.26,8.21,5.95,227,419,192,110,431,321,1648.0,3571.0,1923.0,523500.0,0.0,-523500.0
<a href=/player/moehb001>moehb001</a>,Brian Moehler,Detroit Tigers,TIGRS,2,5,4,9,2002,2005,3,No,0,-0.66,0.33,0.99,20,180,160,16,775,759,130.0,0.0,-130.0,2400000.0,0.0,-2400000.0
<a href=/player/moelc001>moelc001</a>,Chad Moeller,Minnesota Twins,TWINS,2,2,2,4,2001,2001,0,No,0,1.41,0.0,-1.41,140,0,-140,455,0,-455,0.0,0.0,0.0,0.0,0.0,0.0
<a href=/player/moelc001>moelc001</a>,Chad Moeller,Arizona Diamondbacks,DBACKS,3,10,7,17,2003,2008,5,No,2,15.65,2.42,-13.23,2019,225,-1794,5161,413,-4748,3052.0,809.0,-2243.0,3950667.0,0.0,-3950667.0
<a href=/player/moeld001>moeld001</a>,Dennis Moeller,Kansas City Royals,ROYALS,1,2,1,3,1992,1995,3,No,0,-0.61,-1.65,-1.04,94,250,156,7,880,873,219.0,0.0,-219.0,113500.0,0.0,-113500.0
<a href=/player/moeld101>moeld101</a>,Danny Moeller,Washington Senators,TWINS,1,2,2,4,1916,1917,1,No,0,-0.1,0.72,0.82,82,122,40,78,517,439,360.0,0.0,-360.0,5000.0,0.0,-5000.0
<a href=/player/moeld101>moeld101</a>,Danny Moeller,Rochester,Rochester,2,4,5,9,1911,1913,2,No,0,29.68,0.0,-29.68,1807,0,-1807,7810,0,-7810,0.0,0.0,0.0,0.0,0.0,0.0
<a href=/player/mofoh101>mofoh101</a>,Herb Moford,St. Louis Cardinals,CARDS,1,1,1,2,1957,1957,0,No,0,1.06,0.0,-1.06,50,0,-50,41,0,-41,328.0,0.0,-328.0,0.0,0.0,0.0
<a href=/player/mofoh101>mofoh101</a>,Herb Moford,Detroit Tigers,TIGRS,1,1,1,2,1958,1958,0,No,0,-0.68,0.0,0.68,8,0,-8,1,0,-1,26.0,0.0,-26.0,0.0,0.0,0.0
<a href=/player/mofoh101>mofoh101</a>,Herb Moford,Boston Red Sox,RSOX,1,1,2,3,1960,1960,0,No,0,0.0,0.0,0.0,0,0,0,0,0,0,0.0,0.0,0.0,0.0,0.0,0.0
<a href=/player/mogrg101>mogrg101</a>,George Mogridge,New York Yankees,YANKS,1,2,1,3,1920,1920,0,No,0,16.01,0.0,-16.01,317,0,-317,510,0,-510,3052.0,0.0,-3052.0,11500.0,0.0,-11500.0
<a href=/player/mogrg101>mogrg101</a>,George Mogridge,Washington Senators,TWINS,1,2,1,3,1925,1926,1,No,0,2.26,0.7,-1.56,163,72,-91,505,162,-343,46.0,0.0,-46.0,3200.0,0.0,-3200.0
<a href=/player/mogrg101>mogrg101</a>,George Mogridge,St.Louis Browns,ORLS,2,3,3,6,1926,1929,3,No,0,-0.56,11.12,11.68,45,385,340,116,1302,1186,0.0,0.0,0.0,10000.0,0.0,-10000.0
<a href=/player/mohod001>mohod001</a>,Dale Mohorcic,Texas Rangers,RNGRS,1,1,1,2,1988,1989,1,No,0,-0.46,0.31,0.77,47,58,11,0,0,0,241.0,221.0,-20.0,157500.0,0.0,-157500.0
<a href=/player/mohrd001>mohrd001</a>,Dustan Mohr,Minnesota Twins,TWINS,1,1,1,2,2003,2003,0,No,0,0.3,0.0,-0.3,117,0,-117,324,0,-324,0.0,0.0,0.0,315000.0,0.0,-315000.0
<a href=/player/mokaj101>mokaj101</a>,Johnny Mokan,Philadelphia Phillies,PHILS,1,3,2,5,1927,1929,2,No,0,-0.72,-1.19,-0.47,18,135,117,33,192,159,0.0,529.0,529.0,8850.0,0.0,-8850.0
<a href=/player/molib001>molib001</a>,Bengie Molina,San Francisco Giants,GIANTS,1,1,2,3,2010,2010,0,No,0,-0.8,0.12,0.92,57,56,-1,195,0,-195,0.0,72.0,72.0,4500000.0,0.0,-4500000.0
<a href=/player/molib101>molib101</a>,Bob Molinaro,Chicago White Sox,WSOX,1,1,1,2,1982,1982,0,No,0,-0.31,0.0,0.31,65,0,-65,72,0,-72,0.0,0.0,0.0,0.0,0.0,0.0
<a href=/player/molig001>molig001</a>,Gabe Molina,Baltimore Orioles,ORLS,1,2,3,5,2000,2002,2,No,0,1.16,-0.42,-1.58,214,107,-107,759,224,-535,6.0,2.0,-4.0,4146789.0,0.0,-4146789.0
<a href=/player/molii001>molii001</a>,Izzy Molina,Arizona Diamondbacks,DBACKS,1,2,2,4,1999,2000,1,No,0,-0.22,0.28,0.5,4,102,98,0,2,2,33.0,165.0,132.0,0.0,0.0,0.0
<a href=/player/molij001>molij001</a>,Jose Molina,Anaheim Angels,ANGELS,1,1,1,2,2007,2007,0,No,0,1.07,0.0,-1.07,181,0,-181,523,0,-523,0.0,0.0,0.0,1350000.0,0.0,-1350000.0
<a href=/player/mollf101>mollf101</a>,Fritz Mollwitz,Chicago Cubs,CUBS,1,1,1,2,1914,1914,0,No,0,-2.49,-0.41,2.08,250,28,-222,875,105,-770,0.0,0.0,0.0,0.0,0.0,0.0
<a href=/player/mollf101>mollf101</a>,Fritz Mollwitz,KansasCity,KansasCity,1,2,3,5,1917,1918,1,No,0,0.77,0.0,-0.77,267,0,-267,890,0,-890,475.0,0.0,-475.0,0.0,0.0,0.0
<a href=/player/monab101>monab101</a>,Blas Monaco,Cleveland Indians,INDINS,1,3,1,4,1937,1938,1,No,0,0.0,0.0,0.0,0,0,0,0,0,0,0.0,0.0,0.0,0.0,0.0,0.0
<a href=/player/monac001>monac001</a>,Carlos Monasterios,New York Yankees,YANKS,1,4,2,6,2006,2008,2,No,0,0.06,7.5,7.44,46,382,336,0,1631,1631,38.0,136.0,98.0,0.0,0.0,0.0
<a href=/player/monbb101>monbb101</a>,Bill Monbouquette,Boston Red Sox,RSOX,1,1,3,4,1965,1971,6,No,0,-0.68,1.36,2.04,64,222,158,31,488,457,314.0,0.0,-314.0,33000.0,0.0,-33000.0
<a href=/player/monbb101>monbb101</a>,Bill Monbouquette,New York Yankees,YANKS,3,3,4,7,1968,2002,34,No,0,0.58,19.7,19.12,93,1550,1457,0,3648,3648,590.0,1822.0,1232.0,68000.0,0.0,-68000.0
<a href=/player/moncy001>moncy001</a>,Yoan Moncada,Boston Red Sox,RSOX,1,4,1,5,2016,2016,0,Yes,0,14.34,0.0,-14.34,583,0,-583,2288,0,-2288,251.0,0.0,-251.0,0.0,0.0,0.0
<a href=/player/mondr001>mondr001</a>,Rick Monday,Oakland Athletics,ATLTCS,3,5,7,12,1971,1978,7,No,0,20.59,17.1,-3.49,880,660,-220,3530,1399,-2131,944.0,4676.0,3732.0,130000.0,0.0,-130000.0
<a href=/player/mondr001>mondr001</a>,Rick Monday,Chicago Cubs,CUBS,6,9,14,23,1977,1996,19,No,0,23.01,95.54,72.53,2449,4520,2071,6237,18161,11924,2336.0,1723.0,-613.0,0.0,0.0,0.0
<a href=/player/mondr002>mondr002</a>,Raul Mondesi,Los Angeles Dodgers,DOGRS,6,14,16,30,1999,2008,9,No,0,11.13,39.67,28.54,2076,1867,-209,6047,4980,-1067,1264.0,3315.0,2051.0,19163667.0,0.0,-19163667.0
<a href=/player/mondr002>mondr002</a>,Raul Mondesi,Toronto Blue Jays,BJAYS,1,1,1,2,2002,2003,1,No,0,2.07,0.04,-2.03,169,3,-166,705,0,-705,0.0,8.0,8.0,11000000.0,0.0,-11000000.0
<a href=/player/mondr002>mondr002</a>,Raul Mondesi,New York Yankees,YANKS,2,3,4,7,2003,2007,4,No,0,0.52,-0.76,-1.28,48,88,40,183,134,-49,9.0,91.0,82.0,13000000.0,0.0,-13000000.0
<a href=/player/moned101>moned101</a>,Don Money,Pittsburgh Pirates,PIRATS,2,5,4,9,1967,1973,6,No,0,15.42,-1.44,-16.86,860,110,-750,2406,119,-2287,2691.0,948.0,-1743.0,75000.0,0.0,-75000.0
<a href=/player/moned101>moned101</a>,Don Money,Philadelphia Phillies,PHILS,3,7,6,13,1972,1979,7,No,0,31.4,20.05,-11.35,1669,1025,-644,5610,3103,-2507,2357.0,4062.0,1705.0,29500.0,0.0,-29500.0
<a href=/player/mongs001>mongs001</a>,Sid Monge,California Angels,ANGELS,1,3,2,5,1977,1982,5,No,0,9.5,4.45,-5.05,371,221,-150,444,0,-444,1221.0,1215.0,-6.0,0.0,0.0,0.0
<a href=/player/mongs001>mongs001</a>,Sid Monge,Cleveland Indians,INDINS,1,1,1,2,1982,1983,1,No,0,-0.45,-0.04,0.41,122,97,-25,13,331,318,251.0,0.0,-251.0,0.0,0.0,0.0
<a href=/player/mongs001>mongs001</a>,Sid Monge,Philadelphia Phillies,PHILS,1,1,1,2,1983,1983,0,No,0,0.31,1.88,1.57,120,101,-19,12,295,283,251.0,0.0,-251.0,300000.0,0.0,-300000.0
<a href=/player/monrc001>monrc001</a>,Craig Monroe,Detroit Tigers,TIGRS,1,2,1,3,2007,2009,2,No,0,-0.36,0.16,0.52,23,33,10,55,0,-55,0.0,81.0,81.0,4775000.0,0.0,-4775000.0
<a href=/player/monrj101>monrj101</a>,John Monroe,New York Giants,GIANTS,2,7,2,9,1921,1924,3,No,0,-1.56,-0.07,1.49,187,154,-33,261,191,-70,992.0,253.0,-739.0,6000.0,0.0,-6000.0
<a href=/player/monrj101>monrj101</a>,John Monroe,Philadelphia Phillies,PHILS,5,11,9,20,1921,1936,15,No,0,25.37,1.11,-24.26,1352,2193,841,5364,9288,3924,77.0,0.0,-77.0,43100.0,0.0,-43100.0
<a href=/player/monrz101>monrz101</a>,Zach Monroe,New York Yankees,YANKS,2,3,4,7,1960,1963,3,No,0,0.32,3.3,2.98,35,426,391,37,78,41,0.0,912.0,912.0,0.0,0.0,0.0
<a href=/player/monta101>monta101</a>,Al Montreuil,Boston Red Sox,RSOX,1,3,1,4,1969,1972,3,No,0,-0.13,8.46,8.59,5,232,227,13,323,310,0.0,2477.0,2477.0,0.0,0.0,0.0
<a href=/player/monta103>monta103</a>,Aurelio Monteagudo,Cincinnati Reds,REDS,2,2,2,4,1969,1970,1,No,0,0.0,0.0,0.0,0,20,20,0,2,2,0.0,49.0,49.0,0.0,0.0,0.0
<a href=/player/monta103>monta103</a>,Aurelio Monteagudo,San Diego Padres,PADRS,2,2,2,4,1973,1973,0,No,0,-0.31,0.0,0.31,16,0,-16,1,0,-1,90.0,0.0,-90.0,0.0,0.0,0.0
<a href=/player/monta103>monta103</a>,Aurelio Monteagudo,California Angels,ANGELS,2,4,3,7,1973,1976,3,No,0,2.26,3.34,1.08,402,155,-247,1412,564,-848,0.0,0.0,0.0,38500.0,0.0,-38500.0
<a href=/player/montc001>montc001</a>,Charlie Montoyo,Milwaukee Brewers,BREWRS,1,2,2,4,1993,1993,0,No,0,-0.51,0.0,0.51,36,0,-36,100,0,-100,0.0,0.0,0.0,0.0,0.0,0.0
<a href=/player/monte101>monte101</a>,Ed Montague,Cleveland Indians,INDINS,2,6,4,10,1930,1939,9,No,0,6.18,20.8,14.62,372,942,570,1331,2752,1421,1093.0,2939.0,1846.0,2400.0,0.0,-2400.0
<a href=/player/montf001>montf001</a>,Frankie Montas,Boston Red Sox,RSOX,3,8,6,14,2013,2020,7,Yes,0,1.74,3.1,1.36,152,304,152,96,10,-86,1036.0,1375.0,339.0,5113000.0,0.0,-5113000.0
<a href=/player/montf001>montf001</a>,Frankie Montas,Chicago White Sox,WSOX,3,7,6,13,2015,2017,2,Yes,0,4.46,5.75,1.29,441,251,-190,564,1001,437,693.0,30.0,-663.0,12535000.0,0.0,-12535000.0
<a href=/player/montf001>montf001</a>,Frankie Montas,Los Angeles Dodgers,DOGRS,1,3,2,5,2016,2019,3,No,0,5.79,5.89,0.1,131,179,48,13,293,280,1774.0,1084.0,-690.0,0.0,0.0,0.0
<a href=/player/montj001>montj001</a>,John Montefusco,San Francisco Giants,GIANTS,2,3,3,6,1980,1984,4,No,0,-0.65,4.3,4.95,76,142,66,15,92,77,517.0,884.0,367.0,0.0,0.0,0.0
<a href=/player/montj001>montj001</a>,John Montefusco,San Diego Padres,PADRS,2,3,4,7,1983,1986,3,No,0,7.55,6.05,-1.5,127,402,275,0,1397,1397,2130.0,41.0,-2089.0,0.0,0.0,0.0
<a href=/player/montj002>montj002</a>,Jeff Montgomery,Cincinnati Reds,REDS,2,3,3,6,1988,1997,9,No,0,21.37,12.59,-8.78,775,929,154,0,3608,3608,3825.0,0.0,-3825.0,0.0,0.0,0.0
<a href=/player/montj003>montj003</a>,Jesus Montero,New York Yankees,YANKS,3,7,6,13,2012,2020,8,No,0,-1.73,11.1,12.83,260,478,218,802,248,-554,452.0,2363.0,1911.0,6150000.0,0.0,-6150000.0
<a href=/player/montj101>montj101</a>,John Montague,Baltimore Orioles,ORLS,1,1,1,2,1973,1973,0,No,0,0.54,-0.01,-0.55,125,1,-124,14,0,-14,324.0,5.0,-319.0,0.0,0.0,0.0
<a href=/player/montj101>montj101</a>,John Montague,Seattle Mariners,MARNRS,1,1,1,2,1979,1982,3,No,0,-0.93,0.29,1.22,51,186,135,0,536,536,274.0,0.0,-274.0,0.0,0.0,0.0
<a href=/player/montm001>montm001</a>,Miguel Montero,Arizona Diamondbacks,DBACKS,2,2,3,5,2014,2019,5,No,0,1.66,0.8,-0.86,245,268,23,799,258,-541,7.0,1562.0,1555.0,10000000.0,0.0,-10000000.0
<a href=/player/montm001>montm001</a>,Miguel Montero,Chicago Cubs,CUBS,1,2,1,3,2017,2017,0,No,0,-0.61,0.0,0.61,32,0,-32,101,0,-101,0.0,0.0,0.0,14000000.0,0.0,-14000000.0
<a href=/player/montm002>montm002</a>,Mike Montgomery,Kansas City Royals,ROYALS,3,6,5,11,2012,2021,9,Yes,0,12.05,17.51,5.46,480,779,299,994,1767,773,2270.0,2321.0,51.0,16050000.0,0.0,-16050000.0
<a href=/player/montm002>montm002</a>,Mike Montgomery,Tampa Bay Devil Rays,RAYS,2,2,3,5,2015,2017,2,No,0,2.35,3.54,1.19,77,159,82,9,2,-7,778.0,1044.0,266.0,3125000.0,0.0,-3125000.0
<a href=/player/montm002>montm002</a>,Mike Montgomery,Seattle Mariners,MARNRS,2,3,3,6,2016,2020,4,No,0,3.31,0.75,-2.56,262,353,91,86,1268,1182,1374.0,0.0,-1374.0,0.0,0.0,0.0
<a href=/player/montm002>montm002</a>,Mike Montgomery,Chicago Cubs,CUBS,3,3,3,6,2019,2020,1,Yes,0,4.92,-0.47,-5.39,396,48,-348,1201,106,-1095,208.0,0.0,-208.0,2440000.0,0.0,-2440000.0
<a href=/player/montm101>montm101</a>,Manny Montejo,Detroit Tigers,TIGRS,1,2,1,3,1961,1962,1,No,0,12.08,0.99,-11.09,318,60,-258,331,21,-310,2721.0,244.0,-2477.0,0.0,0.0,0.0
<a href=/player/montr001>montr001</a>,Rafael Montalvo,Los Angeles Dodgers,DOGRS,1,2,1,3,1985,1986,1,No,0,-0.17,0.39,0.56,15,164,149,41,506,465,3.0,0.0,-3.0,0.0,0.0,0.0
<a href=/player/montr002>montr002</a>,Rich Monteleone,Detroit Tigers,TIGRS,2,3,2,5,1985,1988,3,No,0,0.0,0.71,0.71,141,253,112,389,952,563,80.0,0.0,-80.0,170000.0,0.0,-170000.0
<a href=/player/montr002>montr002</a>,Rich Monteleone,California Angels,ANGELS,1,2,1,3,1990,1993,3,No,0,0.54,2.38,1.84,153,560,407,83,2347,2264,698.0,0.0,-698.0,675000.0,0.0,-675000.0
<a href=/player/montr002>montr002</a>,Rich Monteleone,New York Yankees,YANKS,1,1,1,2,1996,1996,0,No,0,-0.12,0.02,0.14,12,33,21,0,77,77,46.0,3.0,-43.0,0.0,0.0,0.0
<a href=/player/montr004>montr004</a>,Rafael Montero,Texas Rangers,RNGRS,1,1,2,3,2020,2021,1,Yes,0,-1.75,0.0,1.75,41,0,-41,0,0,0,130.0,0.0,-130.0,785000.0,0.0,-785000.0
<a href=/player/montr004>montr004</a>,Rafael Montero,Seattle Mariners,MARNRS,1,2,2,4,2021,2021,0,Yes,0,0.78,1.64,0.86,33,83,50,0,253,253,87.0,54.0,-33.0,3500000.0,0.0,-3500000.0
<a href=/player/monts001>monts001</a>,Steve Montgomery,St. Louis Cardinals,CARDS,2,2,3,5,1996,2005,9,No,2,-0.62,0.59,1.21,12,237,225,0,1,1,60.0,339.0,279.0,0.0,0.0,0.0
<a href=/player/monts001>monts001</a>,Steve Montgomery,Philadelphia Phillies,PHILS,3,6,5,11,1999,2003,4,No,0,6.55,1.13,-5.42,362,281,-81,360,99,-261,2958.0,1114.0,-1844.0,6615000.0,0.0,-6615000.0
<a href=/player/montw101>montw101</a>,Willie Montanez,Philadelphia Phillies,PHILS,1,1,1,2,1975,1985,10,No,0,1.12,28.99,27.87,195,1322,1127,826,5030,4204,0.0,0.0,0.0,0.0,0.0,0.0
<a href=/player/montw101>montw101</a>,Willie Montanez,San Francisco Giants,GIANTS,5,10,8,18,1976,1995,19,No,1,14.15,26.8,12.65,1367,2042,675,3556,6654,3098,4215.0,726.0,-3489.0,1545000.0,0.0,-1545000.0
<a href=/player/montw101>montw101</a>,Willie Montanez,Atlanta Braves,BRAVES,4,5,9,14,1977,1983,6,No,0,-1.12,5.01,6.13,459,628,169,1458,837,-621,541.0,2701.0,2160.0,480000.0,0.0,-480000.0
<a href=/player/montw101>montw101</a>,Willie Montanez,New York Mets,METS,2,2,4,6,1979,1990,11,No,0,2.33,5.34,3.01,200,698,498,205,900,695,630.0,2191.0,1561.0,530000.0,0.0,-530000.0
<a href=/player/montw101>montw101</a>,Willie Montanez,Texas Rangers,RNGRS,7,14,16,30,1980,1987,7,No,0,8.43,11.62,3.19,827,472,-355,2107,666,-1441,2873.0,3278.0,405.0,1017500.0,0.0,-1017500.0
<a href=/player/montw101>montw101</a>,Willie Montanez,San Diego Padres,PADRS,3,5,5,10,1980,1984,4,No,0,14.59,2.85,-11.74,999,296,-703,3588,1221,-2367,64.0,0.0,-64.0,0.0,0.0,0.0
<a href=/player/montw101>montw101</a>,Willie Montanez,Montreal Expos,NATEX,1,1,1,2,1981,1982,1,No,0,-0.4,0.08,0.48,65,57,-8,74,121,47,0.0,0.0,0.0,0.0,0.0,0.0
<a href=/player/monzd101>monzd101</a>,Dan Monzon,Minnesota Twins,TWINS,1,1,1,2,1974,1974,0,No,0,0.0,0.0,0.0,0,0,0,0,0,0,0.0,0.0,0.0,0.0,0.0,0.0
<a href=/player/moonb001>moonb001</a>,Bill Mooneyham,Oakland Athletics,ATLTCS,1,1,1,2,1987,1990,3,No,0,0.0,0.0,0.0,0,0,0,0,0,0,0.0,0.0,0.0,0.0,0.0,0.0
<a href=/player/moonj101>moonj101</a>,Jim Mooney,New York Giants,GIANTS,3,11,6,17,1932,1949,17,No,0,15.21,55.77,40.56,1303,2528,1225,3690,9780,6090,2269.0,40.0,-2229.0,0.0,0.0,0.0
<a href=/player/moonw101>moonw101</a>,Wally Moon,St. Louis Cardinals,CARDS,2,4,2,6,1958,1961,3,No,0,12.54,-1.35,-13.89,901,211,-690,3090,605,-2485,156.0,353.0,197.0,0.0,0.0,0.0
<a href=/player/moora002>moora002</a>,Andrew Moore,Seattle Mariners,MARNRS,3,4,6,10,2018,2019,1,Yes,0,3.4,4.58,1.18,251,276,25,571,810,239,250.0,139.0,-111.0,581200.0,0.0,-581200.0
<a href=/player/moora102>moora102</a>,Anse Moore,Detroit Tigers,TIGRS,1,3,1,4,1949,1950,1,No,0,0.0,0.0,0.0,0,0,0,0,0,0,0.0,0.0,0.0,0.0,0.0,0.0
<a href=/player/moorb001>moorb001</a>,Bobby Moore,Oakland Athletics,ATLTCS,1,1,1,2,1982,1982,0,No,0,0.0,0.0,0.0,0,0,0,0,0,0,0.0,0.0,0.0,0.0,0.0,0.0
<a href=/player/moorb004>moorb004</a>,Bobby Moore,Kansas City Royals,ROYALS,1,1,1,2,1991,1994,3,No,0,0.0,1.07,1.07,0,105,105,0,275,275,0.0,0.0,0.0,0.0,0.0,0.0
<a href=/player/moorb105>moorb105</a>,Barry Moore,Washington Senators,RNGRS,10,23,17,40,1969,1988,19,No,0,45.59,49.51,3.92,2709,3553,844,8910,11036,2126,3519.0,6237.0,2718.0,494000.0,0.0,-494000.0
<a href=/player/moorb105>moorb105</a>,Barry Moore,Cleveland Indians,INDINS,4,5,5,10,1970,1974,4,No,0,-1.97,-1.79,0.18,296,169,-127,575,413,-162,422.0,0.0,-422.0,83000.0,0.0,-83000.0
<a href=/player/moorb105>moorb105</a>,Barry Moore,Chicago White Sox,WSOX,2,2,2,4,1970,1971,1,No,0,2.12,0.0,-2.12,351,0,-351,1072,0,-1072,0.0,0.0,0.0,0.0,0.0,0.0
<a href=/player/moorc101>moorc101</a>,Cy Moore,Brooklyn Dodgers,DOGRS,6,13,10,23,1932,1948,16,No,0,22.8,18.44,-4.36,1723,1313,-410,5249,4047,-1202,2633.0,2535.0,-98.0,0.0,0.0,0.0
<a href=/player/moord001>moord001</a>,Donnie Moore,Chicago Cubs,CUBS,1,1,1,2,1979,1982,3,No,0,-0.16,-1.51,-1.35,22,173,151,6,466,460,65.0,0.0,-65.0,0.0,0.0,0.0
<a href=/player/moord001>moord001</a>,Donnie Moore,St. Louis Cardinals,CARDS,1,1,1,2,1982,1982,0,No,0,1.73,0.0,-1.73,212,0,-212,13,0,-13,482.0,0.0,-482.0,0.0,0.0,0.0
<a href=/player/moord002>moord002</a>,Dylan Moore,Texas Rangers,RNGRS,1,1,1,2,2016,2016,0,No,0,0.0,0.0,0.0,0,0,0,0,0,0,0.0,0.0,0.0,0.0,0.0,0.0
<a href=/player/moore101>moore101</a>,Euel Moore,Baltimore,Baltimore,1,1,2,3,1934,1934,0,No,0,0.14,0.0,-0.14,110,0,-110,81,0,-81,663.0,0.0,-663.0,0.0,0.0,0.0
<a href=/player/moore102>moore102</a>,Eddie Moore,Brooklyn Dodgers,DOGRS,8,19,13,32,1931,1948,17,No,0,60.59,33.88,-26.71,3224,2883,-341,11104,10453,-651,2159.0,791.0,-1368.0,10000.0,0.0,-10000.0
<a href=/player/moore102>moore102</a>,Eddie Moore,New York Giants,GIANTS,1,2,1,3,1932,1933,1,No,0,0.0,-0.06,-0.06,0,60,60,0,136,136,0.0,0.0,0.0,0.0,0.0,0.0
<a href=/player/moore103>moore103</a>,Earl Moore,Cleveland Indians,INDINS,1,1,2,3,1907,1907,0,No,0,-1.19,-0.55,0.64,24,49,25,22,87,65,180.0,278.0,98.0,0.0,0.0,0.0
<a href=/player/moorg104>moorg104</a>,Gene Moore,Brooklyn Dodgers,DOGRS,2,3,2,5,1936,1939,3,No,0,16.05,5.67,-10.38,637,216,-421,2368,193,-2175,132.0,1522.0,1390.0,0.0,0.0,0.0
<a href=/player/moorg104>moorg104</a>,Gene Moore,Boston Braves,BRAVES,2,4,3,7,1938,1952,14,No,0,0.98,38.76,37.78,331,1743,1412,987,7238,6251,317.0,0.0,-317.0,7500.0,0.0,-7500.0
<a href=/player/moorg104>moorg104</a>,Gene Moore,Boston Braves,BRAVES,1,2,1,3,1942,1952,10,No,0,1.7,36.09,34.39,132,1289,1157,581,5523,4942,0.0,0.0,0.0,0.0,0.0,0.0
<a href=/player/moorj102>moorj102</a>,Jackie Moore,Detroit Tigers,TIGRS,1,3,1,4,1966,1967,1,No,0,0.26,-0.68,-0.94,350,64,-286,935,31,-904,0.0,314.0,314.0,0.0,0.0,0.0
<a href=/player/moorj104>moorj104</a>,Johnny Moore,Chicago Cubs,CUBS,2,7,3,10,1932,1941,9,No,0,3.2,27.52,24.32,621,896,275,1233,2014,781,2473.0,4458.0,1985.0,0.0,0.0,0.0
<a href=/player/moorj104>moorj104</a>,Johnny Moore,Cincinnati Reds,REDS,2,4,4,8,1934,1937,3,No,0,22.67,0.0,-22.67,911,236,-675,2270,656,-1614,2379.0,321.0,-2058.0,0.0,0.0,0.0
<a href=/player/moorj106>moorj106</a>,Jimmy Moore,Philadelphia Athletics,ATLTCS,3,6,4,10,1931,1936,5,No,0,2.31,4.79,2.48,270,523,253,676,1095,419,552.0,1925.0,1373.0,12000.0,0.0,-12000.0
<a href=/player/moorj107>moorj107</a>,Jim Moore,Chicago White Sox,WSOX,4,13,7,20,1932,1936,4,No,0,4.13,0.06,-4.07,711,272,-439,2521,849,-1672,0.0,39.0,39.0,28700.0,0.0,-28700.0
<a href=/player/moork001>moork001</a>,Kerwin Moore,Florida Marlins,MARLNS,2,2,2,4,1993,1998,5,No,0,-0.62,0.81,1.43,57,450,393,154,1468,1314,0.0,98.0,98.0,650000.0,0.0,-650000.0
<a href=/player/moork101>moork101</a>,Kelvin Moore,Oakland Athletics,ATLTCS,1,1,1,2,1983,1983,0,No,0,0.0,0.0,0.0,0,0,0,0,0,0,0.0,0.0,0.0,0.0,0.0,0.0
<a href=/player/moork101>moork101</a>,Kelvin Moore,New York Mets,METS,1,1,1,2,1984,1984,0,No,0,0.0,0.0,0.0,0,0,0,0,0,0,0.0,0.0,0.0,0.0,0.0,0.0
<a href=/player/moorm002>moorm002</a>,Marcus Moore,California Angels,ANGELS,2,4,5,9,1990,1993,3,No,0,21.39,3.93,-17.46,688,442,-246,3033,1668,-1365,79.0,0.0,-79.0,1180000.0,0.0,-1180000.0
<a href=/player/moorm002>moorm002</a>,Marcus Moore,Colorado Rockies,ROCKS,1,1,1,2,1995,1999,4,No,0,-0.52,-0.24,0.28,46,35,-11,3,70,67,79.0,0.0,-79.0,0.0,0.0,0.0
<a href=/player/moorm003>moorm003</a>,Matt Moore,Tampa Bay Devil Rays,RAYS,2,2,4,6,2016,2020,4,Yes,0,0.39,3.13,2.74,87,216,129,81,834,753,728.0,0.0,-728.0,0.0,0.0,0.0
<a href=/player/moorm003>moorm003</a>,Matt Moore,San Francisco Giants,GIANTS,1,2,2,4,2017,2017,0,Yes,0,-1.31,0.0,1.31,42,0,-42,0,0,0,306.0,0.0,-306.0,7000000.0,0.0,-7000000.0
<a href=/player/moorr101>moorr101</a>,Ray Moore,Brooklyn Dodgers,DOGRS,1,1,1,2,1954,1954,0,No,0,5.5,0.0,-5.5,224,0,-224,211,0,-211,1692.0,0.0,-1692.0,0.0,0.0,0.0
<a href=/player/moorr101>moorr101</a>,Ray Moore,Baltimore Orioles,ORLS,23,44,43,87,1957,1994,37,No,3,72.27,127.67,55.4,4749,6987,2238,10212,15857,5645,16859.0,18781.0,1922.0,880833.0,0.0,-880833.0
<a href=/player/moorr103>moorr103</a>,Randy Moore,Boston Braves,BRAVES,9,22,18,40,1935,1952,17,No,0,30.65,55.97,25.32,2386,3342,956,8192,10691,2499,702.0,5153.0,4451.0,12500.0,0.0,-12500.0
<a href=/player/moorr103>moorr103</a>,Randy Moore,Brooklyn Dodgers,DOGRS,2,4,2,6,1937,1938,1,No,0,-0.18,-1.09,-0.91,8,96,88,7,228,221,0.0,0.0,0.0,0.0,0.0,0.0
<a href=/player/moors001>moors001</a>,Scott Moore,Detroit Tigers,TIGRS,3,5,4,9,2005,2010,5,No,0,1.05,4.48,3.43,399,254,-145,54,7,-47,685.0,1390.0,705.0,1975000.0,0.0,-1975000.0
<a href=/player/moors001>moors001</a>,Scott Moore,Chicago Cubs,CUBS,1,2,1,3,2007,2007,0,No,0,-1.45,-0.48,0.97,90,8,-82,155,7,-148,100.0,52.0,-48.0,0.0,0.0,0.0
<a href=/player/moort001>moort001</a>,Trey Moore,Seattle Mariners,MARNRS,2,4,3,7,1996,1999,3,No,0,0.25,7.02,6.77,475,103,-372,1514,15,-1499,341.0,1794.0,1453.0,5016667.0,0.0,-5016667.0
<a href=/player/moort002>moort002</a>,Tyler Moore,Washington Nationals,NATEX,1,1,1,2,2016,2016,0,No,0,0.0,0.0,0.0,0,0,0,0,0,0,0.0,0.0,0.0,0.0,0.0,0.0
<a href=/player/moort101>moort101</a>,Tommy Moore,New York Mets,METS,1,2,1,3,1974,1977,3,No,0,0.04,1.83,1.79,36,254,218,2,794,792,89.0,0.0,-89.0,0.0,0.0,0.0
<a href=/player/moort101>moort101</a>,Tommy Moore,St. Louis Cardinals,CARDS,3,4,3,7,1975,1976,1,No,0,0.91,1.54,0.63,156,98,-58,524,376,-148,63.0,0.0,-63.0,0.0,0.0,0.0
<a href=/player/moort101>moort101</a>,Tommy Moore,Seattle Mariners,MARNRS,2,3,2,5,1977,1982,5,No,0,-0.28,1.01,1.29,129,138,9,207,50,-157,0.0,1472.0,1472.0,0.0,0.0,0.0
<a href=/player/moorw101>moorw101</a>,Wilcy Moore,New York Yankees,YANKS,1,3,1,4,1929,1930,1,No,0,0.0,0.05,0.05,0,45,45,0,121,121,0.0,0.0,0.0,15000.0,0.0,-15000.0
<a href=/player/moorw101>moorw101</a>,Wilcy Moore,Boston Red Sox,RSOX,3,5,4,9,1932,1946,14,No,0,-1.19,45.83,47.02,188,1466,1278,125,4680,4555,1053.0,3384.0,2331.0,22000.0,0.0,-22000.0
<a href=/player/moorw102>moorw102</a>,Whitey Moore,Cincinnati Reds,REDS,1,1,2,3,1942,1947,5,No,0,-0.02,5.25,5.27,18,308,290,2,155,153,37.0,1547.0,1510.0,0.0,0.0,0.0
<a href=/player/moraa102>moraa102</a>,Al Moran,Boston Red Sox,RSOX,2,4,2,6,1963,1966,3,No,0,1.63,7.14,5.51,379,407,28,759,1449,690,1141.0,0.0,-1141.0,0.0,0.0,0.0
<a href=/player/morab101>morab101</a>,Billy Moran,Toronto,Toronto,1,1,2,3,1961,1961,0,No,0,5.03,0.0,-5.03,417,0,-417,1787,0,-1787,0.0,0.0,0.0,0.0,0.0,0.0
<a href=/player/morab101>morab101</a>,Billy Moran,Los Angeles Angels,ANGELS,4,6,6,12,1964,1968,4,No,0,-0.68,3.52,4.2,319,392,73,434,716,282,443.0,1270.0,827.0,44000.0,0.0,-44000.0
<a href=/player/morac001>morac001</a>,Colin Moran,Miami Marlins,MARLNS,7,20,18,38,2014,2020,6,Yes,0,36.69,11.6,-25.09,2821,868,-1953,6455,1964,-4491,3539.0,2374.0,-1165.0,18850000.0,0.0,-18850000.0
<a href=/player/morac001>morac001</a>,Colin Moran,Houston Astros,ASTROS,1,4,1,5,2018,2019,1,No,0,3.26,12.09,8.83,813,71,-742,1676,16,-1660,1316.0,1238.0,-78.0,0.0,0.0,0.0
<a href=/player/morac101>morac101</a>,Charles Moran,Washington Senators,TWINS,1,1,2,3,1904,1904,0,No,0,-0.25,-0.9,-0.65,109,161,52,405,656,251,0.0,0.0,0.0,0.0,0.0,0.0
<a href=/player/moraf001>moraf001</a>,Franklin Morales,Boston Red Sox,RSOX,1,2,1,3,2013,2014,1,No,0,-0.53,-0.06,0.47,103,42,-61,39,104,65,474.0,0.0,-474.0,1487500.0,0.0,-1487500.0
<a href=/player/morah101>morah101</a>,Herbie Moran,Boston Braves,BRAVES,1,2,1,3,1915,1917,2,No,0,0.0,0.67,0.67,0,170,170,0,638,638,0.0,0.0,0.0,6800.0,0.0,-6800.0
<a href=/player/moraj001>moraj001</a>,Jose Morales,Baltimore Orioles,ORLS,2,3,3,6,1982,1987,5,No,0,-0.12,-1.04,-0.92,180,144,-36,296,240,-56,0.0,321.0,321.0,558333.0,0.0,-558333.0
<a href=/player/moraj002>moraj002</a>,Jose Morales,Minnesota Twins,TWINS,1,1,1,2,2010,2010,0,No,0,-0.17,0.0,0.17,22,0,-22,71,0,-71,0.0,0.0,0.0,412500.0,0.0,-412500.0
<a href=/player/moraj101>moraj101</a>,Jerry Morales,San Diego Padres,PADRS,1,1,2,3,1973,1975,2,No,0,-1.06,-0.81,0.25,792,73,-719,2848,201,-2647,0.0,0.0,0.0,0.0,0.0,0.0
<a href=/player/moraj101>moraj101</a>,Jerry Morales,Chicago Cubs,CUBS,12,22,23,45,1977,1990,13,No,0,19.55,19.15,-0.4,3026,1816,-1210,7924,3345,-4579,1137.0,4804.0,3667.0,1020000.0,0.0,-1020000.0
<a href=/player/moraj101>moraj101</a>,Jerry Morales,St. Louis Cardinals,CARDS,5,7,10,17,1978,1994,16,No,2,8.24,37.26,29.02,800,1928,1128,1636,7432,5796,2139.0,691.0,-1448.0,1500000.0,0.0,-1500000.0
<a href=/player/moraj101>moraj101</a>,Jerry Morales,Detroit Tigers,TIGRS,1,2,1,3,1979,1982,3,No,0,-0.84,3.18,4.02,115,250,135,268,851,583,0.0,0.0,0.0,0.0,0.0,0.0
<a href=/player/morak001>morak001</a>,Kendrys Morales,Anaheim Angels,ANGELS,1,1,1,2,2012,2013,1,No,0,2.64,1.95,-0.69,215,24,-191,896,0,-896,0.0,450.0,450.0,2975000.0,0.0,-2975000.0
<a href=/player/morak001>morak001</a>,Kendrys Morales,Minnesota Twins,TWINS,1,1,1,2,2014,2015,1,No,0,-0.22,0.0,0.22,59,0,-59,239,0,-239,0.0,0.0,0.0,0.0,0.0,0.0
<a href=/player/morak001>morak001</a>,Kendrys Morales,Toronto Blue Jays,BJAYS,1,2,2,4,2019,2019,0,Yes,0,-0.53,0.0,0.53,35,0,-35,126,0,-126,3.0,0.0,-3.0,0.0,0.0,0.0
<a href=/player/morak001>morak001</a>,Kendrys Morales,Oakland Athletics,ATLTCS,1,1,1,2,2019,2019,0,No,0,-0.39,0.0,0.39,19,0,-19,75,0,-75,0.0,0.0,0.0,12000000.0,0.0,-12000000.0
<a href=/player/moram001>moram001</a>,Mickey Morandini,Philadelphia Phillies,PHILS,1,1,1,2,1997,2002,5,No,0,2.76,9.41,6.65,298,753,455,1190,3250,2060,0.0,0.0,0.0,1850000.0,0.0,-1850000.0
<a href=/player/moram001>moram001</a>,Mickey Morandini,Philadelphia Phillies,PHILS,1,1,1,2,2000,2001,1,No,0,-0.22,-0.11,0.11,35,142,107,116,217,101,0.0,0.0,0.0,750000.0,0.0,-750000.0
<a href=/player/moram002>moram002</a>,Melvin Mora,New York Mets,METS,1,4,1,5,2000,2000,0,No,0,28.33,0.16,-28.17,1330,56,-1274,5573,211,-5362,33.0,0.0,-33.0,210000.0,0.0,-210000.0
<a href=/player/morap101>morap101</a>,Pat Moran,Boston Braves,BRAVES,1,1,2,3,1905,1909,4,No,0,3.49,2.44,-1.05,262,144,-118,905,239,-666,0.0,1361.0,1361.0,0.0,0.0,0.0
<a href=/player/mordm001>mordm001</a>,Mike Mordecai,Montreal Expos,NATEX,2,6,6,12,2002,2005,3,No,0,7.25,0.27,-6.98,492,319,-173,648,239,-409,1719.0,1333.0,-386.0,4812500.0,0.0,-4812500.0
<a href=/player/mored001>mored001</a>,Diego Moreno,Pittsburgh Pirates,PIRATS,1,2,2,4,2012,2013,1,No,0,0.0,3.95,3.95,4,119,115,0,138,138,31.0,1180.0,1149.0,0.0,0.0,0.0
<a href=/player/morej001>morej001</a>,Juan Moreno,Texas Rangers,RNGRS,1,1,1,2,2002,2002,0,No,0,-0.14,0.0,0.14,8,0,-8,0,0,0,18.0,0.0,-18.0,0.0,0.0,0.0
<a href=/player/morej101>morej101</a>,Jose Moreno,Philadelphia Phillies,PHILS,1,2,1,3,1979,1981,2,No,0,1.99,1.3,-0.69,173,122,-51,601,132,-469,0.0,1086.0,1086.0,0.0,0.0,0.0
<a href=/player/morej101>morej101</a>,Jose Moreno,New York Mets,METS,1,2,1,3,1980,1982,2,No,0,-0.04,-2.0,-1.96,34,82,48,50,50,0,0.0,501.0,501.0,0.0,0.0,0.0
<a href=/player/morek001>morek001</a>,Keith Moreland,Philadelphia Phillies,PHILS,3,8,5,13,1981,1988,7,No,0,16.51,17.82,1.31,2071,1049,-1022,4347,608,-3739,6629.0,2308.0,-4321.0,0.0,0.0,0.0
<a href=/player/morek001>morek001</a>,Keith Moreland,Chicago Cubs,CUBS,2,3,4,7,1988,1989,1,No,0,-1.95,-0.22,1.73,155,94,-61,562,6,-556,188.0,131.0,-57.0,0.0,0.0,0.0
<a href=/player/morek001>morek001</a>,Keith Moreland,San Diego Padres,PADRS,2,4,3,7,1988,1990,2,No,0,-0.11,0.47,0.58,120,230,110,406,663,257,249.0,443.0,194.0,2283333.0,0.0,-2283333.0
<a href=/player/morek001>morek001</a>,Keith Moreland,Detroit Tigers,TIGRS,1,1,1,2,1989,1990,1,No,0,-0.74,0.82,1.56,33,18,-15,111,0,-111,0.0,283.0,283.0,1483333.0,0.0,-1483333.0
<a href=/player/morel101>morel101</a>,Lew Moren,Philadelphia Phillies,PHILS,12,24,28,52,1910,1931,21,No,0,100.95,91.27,-9.68,4848,5202,354,15981,18765,2784,10753.0,6282.0,-4471.0,25000.0,0.0,-25000.0
<a href=/player/morem001>morem001</a>,Mitch Moreland,Boston Red Sox,RSOX,1,1,2,3,2020,2020,0,Yes,0,0.02,0.0,-0.02,20,0,-20,73,0,-73,0.0,0.0,0.0,2500000.0,0.0,-2500000.0
<a href=/player/moreo001>moreo001</a>,Omar Moreno,Houston Astros,ASTROS,3,3,4,7,1983,1990,7,No,0,1.5,10.94,9.44,518,992,474,1458,3853,2395,0.0,0.0,0.0,700000.0,0.0,-700000.0
<a href=/player/morer101>morer101</a>,Roger Moret,Boston Red Sox,RSOX,1,1,1,2,1975,1977,2,No,0,0.13,-0.17,-0.3,54,45,-9,26,0,-26,232.0,154.0,-78.0,30000.0,0.0,-30000.0
<a href=/player/morer101>morer101</a>,Roger Moret,Atlanta Braves,BRAVES,3,8,3,11,1976,1983,7,No,0,3.71,6.12,2.41,495,566,71,1015,2078,1063,923.0,87.0,-836.0,33500.0,0.0,-33500.0
<a href=/player/morer102>morer102</a>,Ray Morehart,Chicago White Sox,WSOX,1,2,1,3,1927,1928,1,No,0,-0.49,2.12,2.61,240,145,-95,730,550,-180,0.0,0.0,0.0,0.0,0.0,0.0
<a href=/player/mores101>mores101</a>,Seth Morehead,Philadelphia Phillies,PHILS,2,3,3,6,1959,1962,3,No,0,0.29,0.05,-0.24,209,84,-125,180,12,-168,468.0,231.0,-237.0,0.0,0.0,0.0
<a href=/player/mores101>mores101</a>,Seth Morehead,Chicago Cubs,CUBS,7,13,11,24,1961,1977,16,No,0,12.22,41.5,29.28,942,3000,2058,716,8425,7709,3637.0,5246.0,1609.0,122500.0,0.0,-122500.0
<a href=/player/morgb102>morgb102</a>,Bobby Morgan,Brooklyn Dodgers,DOGRS,1,1,2,3,1954,1954,0,No,0,4.71,0.0,-4.71,281,0,-281,1133,0,-1133,0.0,0.0,0.0,0.0,0.0,0.0
<a href=/player/morgb102>morgb102</a>,Bobby Morgan,Philadelphia Phillies,PHILS,7,11,11,22,1956,1984,28,No,0,31.81,59.85,28.04,1931,3646,1715,6995,9141,2146,0.0,2963.0,2963.0,0.0,0.0,0.0
<a href=/player/morgb102>morgb102</a>,Bobby Morgan,St. Louis Cardinals,CARDS,3,7,6,13,1956,1963,7,No,0,8.24,1.4,-6.84,1198,700,-498,4161,1883,-2278,89.0,111.0,22.0,0.0,0.0,0.0
<a href=/player/morgc102>morgc102</a>,Cy Morgan,St.Louis Browns,ORLS,3,4,4,8,1905,1907,2,No,0,-1.04,4.18,5.22,52,223,171,153,810,657,0.0,0.0,0.0,0.0,0.0,0.0
<a href=/player/morgc103>morgc103</a>,Chet Morgan,Detroit Tigers,TIGRS,1,3,2,5,1938,1946,8,No,0,-0.33,15.76,16.09,102,1005,903,69,3681,3612,596.0,671.0,75.0,19500.0,0.0,-19500.0
<a href=/player/morge101>morge101</a>,Eddie Morgan,St. Louis Cardinals,CARDS,1,1,1,2,1936,1936,0,No,0,-0.28,-0.49,-0.21,31,40,9,59,18,-41,0.0,173.0,173.0,0.0,0.0,0.0
<a href=/player/morge101>morge101</a>,Eddie Morgan,Brooklyn Dodgers,DOGRS,4,9,6,15,1938,1947,9,No,0,-0.39,36.06,36.45,76,1426,1350,39,5780,5741,380.0,123.0,-257.0,0.0,0.0,0.0
<a href=/player/morgj001>morgj001</a>,Joe Morgan,Houston Astros,ASTROS,8,15,14,29,1971,1989,18,No,0,76.39,55.08,-21.31,4763,4769,6,15346,14810,-536,3810.0,5622.0,1812.0,705000.0,0.0,-705000.0
<a href=/player/morgj001>morgj001</a>,Joe Morgan,San Francisco Giants,GIANTS,8,15,20,35,1982,1998,16,No,2,28.69,49.55,20.86,1722,3178,1456,1946,4612,2666,4662.0,9275.0,4613.0,10379278.0,0.0,-10379278.0
<a href=/player/morgj101>morgj101</a>,Joe Morgan,Milwaukee Braves,BRAVES,3,4,4,8,1960,1961,1,No,0,2.41,-0.26,-2.67,525,106,-419,1975,157,-1818,0.0,122.0,122.0,0.0,0.0,0.0
<a href=/player/morgj101>morgj101</a>,Joe Morgan,Cleveland Indians,INDINS,1,3,1,4,1961,1962,1,No,0,0.0,0.7,0.7,3,41,38,3,74,71,0.0,0.0,0.0,0.0,0.0,0.0
<a href=/player/morgk001>morgk001</a>,Kevin Morgan,Detroit Tigers,TIGRS,1,1,1,2,1994,1994,0,No,0,-0.02,0.0,0.02,1,0,-1,1,0,-1,0.0,0.0,0.0,0.0,0.0,0.0
<a href=/player/morgm001>morgm001</a>,Mike Morgan,Oakland Athletics,ATLTCS,1,1,1,2,1980,1982,2,No,0,1.96,-0.89,-2.85,30,167,137,0,427,427,451.0,0.0,-451.0,0.0,0.0,0.0
<a href=/player/morgm001>morgm001</a>,Mike Morgan,New York Yankees,YANKS,1,4,2,6,1982,1985,3,No,0,24.16,-0.71,-24.87,840,62,-778,3265,0,-3265,136.0,360.0,224.0,650000.0,0.0,-650000.0
<a href=/player/morgm001>morgm001</a>,Mike Morgan,Seattle Mariners,MARNRS,1,1,1,2,1987,1987,0,No,0,-0.34,0.0,0.34,22,0,-22,0,0,0,214.0,0.0,-214.0,185000.0,0.0,-185000.0
<a href=/player/morgm001>morgm001</a>,Mike Morgan,Baltimore Orioles,ORLS,1,1,1,2,1989,1994,5,No,0,8.5,13.3,4.8,214,751,537,205,3122,2917,1800.0,0.0,-1800.0,0.0,0.0,0.0
<a href=/player/morgm001>morgm001</a>,Mike Morgan,Chicago Cubs,CUBS,1,3,2,5,1995,1995,0,No,0,0.22,-1.32,-1.54,70,79,9,79,325,246,629.0,0.0,-629.0,0.0,0.0,0.0
<a href=/player/morgm001>morgm001</a>,Mike Morgan,Minnesota Twins,TWINS,3,4,5,9,1998,2006,8,No,0,2.45,7.1,4.65,298,208,-90,106,24,-82,1216.0,2925.0,1709.0,9550000.0,0.0,-9550000.0
<a href=/player/morgn001>morgn001</a>,Nyjer Morgan,Pittsburgh Pirates,PIRATS,4,7,9,16,2009,2020,11,Yes,0,14.34,15.86,1.52,1433,1357,-76,3037,658,-2379,1099.0,1818.0,719.0,4920000.0,0.0,-4920000.0
<a href=/player/morgn001>morgn001</a>,Nyjer Morgan,Washington Nationals,NATEX,1,1,2,3,2011,2011,0,No,0,2.79,0.0,-2.79,241,0,-241,751,0,-751,0.0,0.0,0.0,0.0,0.0,0.0
<a href=/player/morgt101>morgt101</a>,Tom Morgan,New York Yankees,YANKS,6,15,13,28,1957,1970,13,No,0,5.72,32.98,27.26,1633,2423,790,4235,5558,1323,2553.0,4978.0,2425.0,115500.0,0.0,-115500.0
<a href=/player/morgt101>morgt101</a>,Tom Morgan,Kansas City Athletics,ATLTCS,31,62,61,123,1957,1976,19,No,0,95.85,56.38,-39.47,9593,6643,-2950,23097,19018,-4079,12004.0,6179.0,-5825.0,476100.0,0.0,-476100.0
<a href=/player/morgt101>morgt101</a>,Tom Morgan,Detroit Tigers,TIGRS,2,3,3,6,1960,1961,1,No,0,2.45,0.7,-1.75,227,142,-85,90,74,-16,805.0,344.0,-461.0,0.0,0.0,0.0
<a href=/player/morma001>morma001</a>,Alvin Morman,Houston Astros,ASTROS,1,1,1,2,1997,2001,4,No,0,-0.21,1.48,1.69,73,181,108,1,3,2,121.0,325.0,204.0,0.0,0.0,0.0
<a href=/player/morma001>morma001</a>,Alvin Morman,Cleveland Indians,INDINS,7,12,14,26,1998,2011,13,No,0,4.4,12.56,8.16,1064,1445,381,2423,3925,1502,442.0,1477.0,1035.0,9756200.0,0.0,-9756200.0
<a href=/player/mornj001>mornj001</a>,Justin Morneau,Minnesota Twins,TWINS,2,2,3,5,2013,2014,1,No,0,0.01,0.0,-0.01,27,32,5,92,123,31,4.0,40.0,36.0,0.0,0.0,0.0
<a href=/player/morod101>morod101</a>,Dan Morogiello,Atlanta Braves,BRAVES,1,1,1,2,1982,1985,3,No,0,0.0,1.73,1.73,0,212,212,0,13,13,0.0,482.0,482.0,0.0,0.0,0.0
<a href=/player/moroj001>moroj001</a>,Jeff Moronko,Cleveland Indians,INDINS,1,1,1,2,1985,1987,2,No,0,0.0,0.0,0.0,0,0,0,0,0,0,0.0,0.0,0.0,0.0,0.0,0.0
<a href=/player/morom001>morom001</a>,Max Moroff,Pittsburgh Pirates,PIRATS,1,2,3,5,2018,2021,3,Yes,0,1.8,0.18,-1.62,170,174,4,509,578,69,0.0,0.0,0.0,0.0,0.0,0.0
<a href=/player/morra001>morra001</a>,Akeel Morris,New York Mets,METS,1,1,2,3,2016,2016,0,No,0,0.3,0.78,0.48,16,82,66,0,201,201,22.0,0.0,-22.0,0.0,0.0,0.0
<a href=/player/morra001>morra001</a>,Akeel Morris,Atlanta Braves,BRAVES,1,1,1,2,2018,2018,0,No,0,-0.05,0.0,0.05,10,0,-10,0,0,0,42.0,0.0,-42.0,0.0,0.0,0.0
<a href=/player/morra002>morra002</a>,A.J. Morris,Washington Nationals,NATEX,1,3,1,4,2011,2012,1,No,0,0.0,1.64,1.64,0,148,148,0,40,40,0.0,531.0,531.0,0.0,0.0,0.0
<a href=/player/morrb001>morrb001</a>,Brandon Morrow,Seattle Mariners,MARNRS,2,2,4,6,2009,2012,3,No,0,5.47,0.98,-4.49,395,193,-202,14,0,-14,2048.0,555.0,-1493.0,5425000.0,0.0,-5425000.0
<a href=/player/morrb002>morrb002</a>,Bryan Morris,Los Angeles Dodgers,DOGRS,1,2,1,3,2008,2010,2,No,0,0.68,6.26,5.58,458,223,-235,1050,892,-158,281.0,0.0,-281.0,392500.0,0.0,-392500.0
<a href=/player/morrb002>morrb002</a>,Bryan Morris,Pittsburgh Pirates,PIRATS,1,1,1,2,2014,2014,0,No,0,2.59,0.0,-2.59,253,0,-253,1,0,-1,364.0,0.0,-364.0,511500.0,0.0,-511500.0
<a href=/player/morrb103>morrb103</a>,Bugs Bennett,Tulsa,Tulsa,1,1,1,2,1921,1921,0,No,0,-0.35,0.0,0.35,6,0,-6,1,0,-1,17.0,0.0,-17.0,0.0,0.0,0.0
<a href=/player/morrh001>morrh001</a>,Hal Morris,New York Yankees,YANKS,2,4,3,7,1989,1992,3,No,0,13.18,0.48,-12.7,1091,78,-1013,3762,0,-3762,640.0,1277.0,637.0,2175000.0,0.0,-2175000.0
<a href=/player/morrj002>morrj002</a>,Jim Morrison,Philadelphia Phillies,PHILS,1,1,1,2,1979,1979,0,No,0,4.69,-0.11,-4.8,370,8,-362,1430,0,-1430,0.0,13.0,13.0,0.0,0.0,0.0
<a href=/player/morrj002>morrj002</a>,Jim Morrison,Chicago White Sox,WSOX,1,1,1,2,1982,1982,0,No,0,8.2,-0.05,-8.25,552,6,-546,1833,0,-1833,0.0,22.0,22.0,0.0,0.0,0.0
<a href=/player/morrj002>morrj002</a>,Jim Morrison,Pittsburgh Pirates,PIRATS,5,5,7,12,1987,1993,6,No,0,1.03,3.46,2.43,777,318,-459,2768,983,-1785,0.0,77.0,77.0,1442500.0,0.0,-1442500.0
<a href=/player/morrj003>morrj003</a>,John Morris,Kansas City Royals,ROYALS,1,1,1,2,1985,1987,2,No,0,0.07,3.36,3.29,274,302,28,462,1263,801,0.0,0.0,0.0,0.0,0.0,0.0
<a href=/player/morrj106>morrj106</a>,John Morris,Philadelphia Phillies,PHILS,1,1,1,2,1967,1968,1,No,0,0.06,1.58,1.52,38,160,122,6,20,14,95.0,396.0,301.0,0.0,0.0,0.0
<a href=/player/morrj106>morrj106</a>,John Morris,Milwaukee Brewers,BREWRS,4,8,9,17,1971,1978,7,No,0,7.01,0.21,-6.8,608,258,-350,1535,355,-1180,624.0,2009.0,1385.0,168301.0,0.0,-168301.0
<a href=/player/morrl001>morrl001</a>,Logan Morrison,Miami Marlins,MARLNS,4,9,7,16,2013,2019,6,No,0,13.58,1.36,-12.22,785,446,-339,1476,128,-1348,2851.0,1546.0,-1305.0,1041500.0,0.0,-1041500.0
<a href=/player/morrl001>morrl001</a>,Logan Morrison,Seattle Mariners,MARNRS,4,7,6,13,2015,2017,2,Yes,0,9.3,3.09,-6.21,1092,200,-892,3957,584,-3373,347.0,283.0,-64.0,10679600.0,0.0,-10679600.0
<a href=/player/morrm001>morrm001</a>,Matt Morris,San Francisco Giants,GIANTS,1,1,2,3,2007,2008,1,No,0,-1.2,0.22,1.42,32,63,31,31,181,150,253.0,0.0,-253.0,10037283.0,0.0,-10037283.0
<a href=/player/morrw001>morrw001</a>,Warren Morris,Texas Rangers,RNGRS,6,10,9,19,1998,2015,17,No,0,5.51,25.74,20.23,761,2021,1260,2144,8331,6187,1539.0,1259.0,-280.0,19651100.0,0.0,-19651100.0
<a href=/player/morrw001>morrw001</a>,Warren Morris,Minnesota Twins,TWINS,1,1,1,2,2002,2002,0,No,0,0.0,0.0,0.0,0,0,0,0,0,0,0.0,0.0,0.0,275000.0,0.0,-275000.0
<a href=/player/morsm001>morsm001</a>,Michael Morse,Chicago White Sox,WSOX,4,9,8,17,2004,2013,9,No,0,26.28,24.52,-1.76,2038,506,-1532,7101,844,-6257,1892.0,4790.0,2898.0,12920000.0,0.0,-12920000.0
<a href=/player/morsm001>morsm001</a>,Michael Morse,Seattle Mariners,MARNRS,1,1,1,2,2009,2011,2,No,0,5.58,0.86,-4.72,378,117,-261,1353,318,-1035,0.0,0.0,0.0,0.0,0.0,0.0
<a href=/player/morsm001>morsm001</a>,Michael Morse,Washington Nationals,NATEX,4,8,7,15,2013,2020,7,Yes,0,3.23,12.15,8.92,436,987,551,372,153,-219,1207.0,2502.0,1295.0,8731616.0,0.0,-8731616.0
<a href=/player/morsm001>morsm001</a>,Michael Morse,Seattle Mariners,MARNRS,1,1,1,2,2013,2014,1,No,0,-0.49,0.0,0.49,12,0,-12,30,0,-30,0.0,0.0,0.0,0.0,0.0,0.0
<a href=/player/morsm001>morsm001</a>,Michael Morse,Miami Marlins,MARLNS,1,3,3,6,2015,2015,0,Yes,0,-0.52,0.0,0.52,12,0,-12,7,0,-7,73.0,0.0,-73.0,9400000.0,0.0,-9400000.0
<a href=/player/morsm001>morsm001</a>,Michael Morse,Los Angeles Dodgers,DOGRS,1,2,1,3,2015,2016,1,No,0,-0.21,0.0,0.21,51,0,-51,90,0,-90,0.0,0.0,0.0,0.0,0.0,0.0
<a href=/player/mortb101>mortb101</a>,Bubba Morton,Cleveland Indians,INDINS,5,9,8,17,1965,1973,8,No,0,26.02,3.2,-22.82,1968,411,-1557,6884,1010,-5874,0.0,78.0,78.0,7000.0,0.0,-7000.0
<a href=/player/mortc002>mortc002</a>,Charlie Morton,Atlanta Braves,BRAVES,1,3,1,4,2009,2011,2,No,0,-2.0,-0.61,1.39,553,250,-303,514,1005,491,4336.0,0.0,-4336.0,0.0,0.0,0.0
<a href=/player/mortc002>mortc002</a>,Charlie Morton,Pittsburgh Pirates,PIRATS,1,1,1,2,2015,2015,0,Yes,0,0.26,0.0,-0.26,8,0,-8,7,0,-7,52.0,0.0,-52.0,8000000.0,0.0,-8000000.0
<a href=/player/mortc003>mortc003</a>,Clayton Mortensen,St. Louis Cardinals,CARDS,1,3,1,4,2009,2016,7,No,0,-0.87,23.07,23.94,9,982,973,8,4121,4113,101.0,0.0,-101.0,0.0,0.0,0.0
<a href=/player/mortc003>mortc003</a>,Clayton Mortensen,Oakland Athletics,ATLTCS,2,2,2,4,2011,2012,1,No,0,0.27,-0.16,-0.43,31,39,8,15,139,124,175.0,0.0,-175.0,0.0,0.0,0.0
<a href=/player/mortc003>mortc003</a>,Clayton Mortensen,Colorado Rockies,ROCKS,2,3,2,5,2012,2015,3,No,0,4.38,-1.84,-6.22,246,237,-9,830,752,-78,217.0,0.0,-217.0,6000000.0,0.0,-6000000.0
<a href=/player/mortc003>mortc003</a>,Clayton Mortensen,Boston Red Sox,RSOX,1,1,1,2,2013,2013,0,No,0,0.0,0.39,0.39,0,13,13,0,9,9,0.0,0.0,0.0,504500.0,0.0,-504500.0
<a href=/player/mortc102>mortc102</a>,Carl Morton,Montreal Expos,NATEX,4,5,4,9,1973,1978,5,No,0,34.93,-0.01,-34.94,2168,359,-1809,7237,726,-6511,3495.0,675.0,-2820.0,40000.0,0.0,-40000.0
<a href=/player/mortc102>mortc102</a>,Carl Morton,Atlanta Braves,BRAVES,3,8,3,11,1976,1983,7,No,0,3.71,6.12,2.41,495,566,71,1015,2078,1063,923.0,87.0,-836.0,33500.0,0.0,-33500.0
<a href=/player/moryw101>moryw101</a>,Walt Moryn,Brooklyn Dodgers,DOGRS,2,4,4,8,1955,1961,6,No,0,18.38,2.09,-16.29,1649,196,-1453,2986,562,-2424,2426.0,26.0,-2400.0,0.0,0.0,0.0
<a href=/player/moryw101>moryw101</a>,Walt Moryn,Chicago Cubs,CUBS,2,2,2,4,1960,1964,4,No,0,-0.33,-0.8,-0.47,92,83,-9,254,131,-123,0.0,0.0,0.0,0.0,0.0,0.0
<a href=/player/moscg001>moscg001</a>,Guillermo Moscoso (Corredor),Detroit Tigers,TIGRS,1,2,1,3,2008,2010,2,No,0,0.07,0.88,0.81,11,224,213,0,776,776,44.0,0.0,-44.0,0.0,0.0,0.0
<a href=/player/moscg001>moscg001</a>,Guillermo Moscoso (Corredor),Texas Rangers,RNGRS,2,2,2,4,2011,2013,2,No,0,1.84,-0.3,-2.14,24,10,-14,3,19,16,384.0,0.0,-384.0,0.0,0.0,0.0
<a href=/player/moscg001>moscg001</a>,Guillermo Moscoso (Corredor),Oakland Athletics,ATLTCS,2,3,2,5,2012,2014,2,No,0,3.45,4.02,0.57,352,317,-35,551,851,300,434.0,217.0,-217.0,3675000.0,0.0,-3675000.0
<a href=/player/mosea101>mosea101</a>,Arnie Moser,Brooklyn Dodgers,DOGRS,1,3,1,4,1941,1946,5,No,0,0.0,0.04,0.04,0,2,2,0,5,5,0.0,0.0,0.0,0.0,0.0,0.0
<a href=/player/mosed001>mosed001</a>,Dustin Moseley,Cincinnati Reds,REDS,1,1,1,2,2004,2005,1,No,0,0.56,-0.5,-1.06,69,60,-9,0,61,61,504.0,514.0,10.0,0.0,0.0,0.0
<a href=/player/mosej101>mosej101</a>,Jerry Moses,Boston Red Sox,RSOX,6,13,11,24,1970,1987,17,No,0,23.72,33.07,9.35,1247,1904,657,3411,5540,2129,3997.0,6601.0,2604.0,192500.0,0.0,-192500.0
<a href=/player/mosej101>mosej101</a>,Jerry Moses,California Angels,ANGELS,2,3,5,8,1971,1974,3,No,0,-0.38,1.97,2.35,378,289,-89,1313,1028,-285,0.0,88.0,88.0,15000.0,0.0,-15000.0
<a href=/player/mosej101>mosej101</a>,Jerry Moses,Cleveland Indians,INDINS,6,9,10,19,1972,1984,12,No,0,43.46,8.37,-35.09,2118,2287,169,7743,7713,-30,0.0,317.0,317.0,82750.0,0.0,-82750.0
<a href=/player/mosej101>mosej101</a>,Jerry Moses,New York Yankees,YANKS,2,2,4,6,1974,1976,2,No,0,0.35,-1.55,-1.9,212,143,-69,273,290,17,578.0,23.0,-555.0,0.0,0.0,0.0
<a href=/player/mosew101>mosew101</a>,Wally Moses,Philadelphia Athletics,ATLTCS,1,1,1,2,1939,1946,7,No,0,0.0,4.33,4.33,0,275,275,0,1183,1183,0.0,0.0,0.0,12500.0,0.0,-12500.0
<a href=/player/mosew101>mosew101</a>,Wally Moses,Philadelphia Athletics,ATLTCS,1,1,2,3,1941,1942,1,No,0,12.57,0.52,-12.05,628,116,-512,2724,494,-2230,0.0,0.0,0.0,12500.0,0.0,-12500.0
<a href=/player/moskp101>moskp101</a>,Paul Moskau,Cincinnati Reds,REDS,2,2,2,4,1982,1983,1,No,0,0.75,0.87,0.12,59,145,86,149,292,143,0.0,0.0,0.0,0.0,0.0,0.0
<a href=/player/mosoj101>mosoj101</a>,Jim Mosolf,KansasCity,KansasCity,1,1,1,2,1933,1933,0,No,0,0.17,0.0,-0.17,31,0,-31,92,0,-92,0.0,0.0,0.0,0.0,0.0,0.0
<a href=/player/mossb001>mossb001</a>,Brandon Moss,Boston Red Sox,RSOX,4,7,6,13,2008,2020,12,Yes,2,-3.37,12.23,15.6,269,548,279,630,858,228,190.0,1387.0,1197.0,24042923.0,0.0,-24042923.0
<a href=/player/mossb001>mossb001</a>,Brandon Moss,Oakland Athletics,ATLTCS,3,5,5,10,2014,2021,7,Yes,0,9.97,0.89,-9.08,598,227,-371,2214,794,-1420,0.0,0.0,0.0,4635000.0,0.0,-4635000.0
<a href=/player/mossb001>mossb001</a>,Brandon Moss,Cleveland Indians,INDINS,1,1,1,2,2015,2019,4,No,0,0.63,0.0,-0.63,179,0,-179,615,0,-615,0.0,0.0,0.0,6500000.0,0.0,-6500000.0
<a href=/player/mossb001>mossb001</a>,Brandon Moss,Kansas City Royals,ROYALS,1,3,2,5,2018,2021,3,No,0,1.28,0.62,-0.66,124,62,-62,0,5,5,254.0,390.0,136.0,0.0,0.0,0.0
<a href=/player/mossd001>mossd001</a>,Damian Moss,Atlanta Braves,BRAVES,1,2,1,3,2002,2004,2,No,0,0.14,4.84,4.7,172,133,-39,38,153,115,546.0,1251.0,705.0,215000.0,0.0,-215000.0
<a href=/player/mossd001>mossd001</a>,Damian Moss,San Francisco Giants,GIANTS,1,3,1,4,2003,2003,0,No,0,-1.54,0.88,2.42,20,20,0,0,25,25,251.0,204.0,-47.0,1852000.0,0.0,-1852000.0
<a href=/player/mossd101>mossd101</a>,Don Mossi,Cleveland Indians,INDINS,4,8,7,15,1958,1965,7,No,0,18.0,1.46,-16.54,1595,479,-1116,4009,1716,-2293,3556.0,132.0,-3424.0,7500.0,0.0,-7500.0
<a href=/player/mossl101>mossl101</a>,Les Moss,St.Louis Browns,ORLS,29,60,62,122,1951,1994,43,No,3,98.07,178.27,80.2,6268,10965,4697,13242,31714,18472,21763.0,19811.0,-1952.0,984333.0,0.0,-984333.0
<a href=/player/mossl101>mossl101</a>,Les Moss,Boston Red Sox,RSOX,2,3,3,6,1951,1954,3,No,0,0.76,-1.3,-2.06,327,78,-249,1005,178,-827,0.0,0.0,0.0,0.0,0.0,0.0
<a href=/player/mossl101>mossl101</a>,Les Moss,Baltimore Orioles,ORLS,1,1,1,2,1955,1956,1,No,0,1.01,1.53,0.52,132,96,-36,354,11,-343,0.0,256.0,256.0,0.0,0.0,0.0
<a href=/player/mossm101>mossm101</a>,Mal Moss,Chicago Cubs,CUBS,1,2,1,3,1930,1931,1,No,0,0.0,0.38,0.38,0,39,39,0,178,178,0.0,0.0,0.0,10500.0,0.0,-10500.0
<a href=/player/motad001>motad001</a>,Danny Mota,New York Yankees,YANKS,1,5,1,6,1998,2001,3,No,0,22.8,7.48,-15.32,1163,539,-624,4014,2478,-1536,2978.0,0.0,-2978.0,0.0,0.0,0.0
<a href=/player/motag001>motag001</a>,Guillermo Mota,Montreal Expos,NATEX,4,7,10,17,2002,2004,2,No,0,14.79,-4.81,-19.6,572,445,-127,87,268,181,2398.0,643.0,-1755.0,370000.0,0.0,-370000.0
<a href=/player/motag001>motag001</a>,Guillermo Mota,Los Angeles Dodgers,DOGRS,2,6,5,11,2004,2008,4,No,0,2.71,12.71,10.0,623,499,-124,1632,1049,-583,321.0,2036.0,1715.0,9106667.0,0.0,-9106667.0
<a href=/player/motag001>motag001</a>,Guillermo Mota,Florida Marlins,MARLNS,7,14,19,33,2005,2019,14,Yes,0,61.63,50.29,-11.34,1841,2297,456,4569,6863,2294,8636.0,5082.0,-3554.0,29867000.0,0.0,-29867000.0
<a href=/player/motag001>motag001</a>,Guillermo Mota,Boston Red Sox,RSOX,6,12,8,20,2006,2011,5,No,0,15.42,8.9,-6.52,1619,794,-825,3010,1778,-1232,1235.0,750.0,-485.0,8391733.0,0.0,-8391733.0
<a href=/player/motag001>motag001</a>,Guillermo Mota,New York Mets,METS,1,1,1,2,2007,2007,0,No,0,0.21,0.0,-0.21,115,0,-115,0,0,0,171.0,0.0,-171.0,1800000.0,0.0,-1800000.0
<a href=/player/motaj001>motaj001</a>,Jose Mota,Chicago White Sox,WSOX,2,6,5,11,1985,1991,6,No,0,14.64,2.56,-12.08,1223,446,-777,4038,1366,-2672,817.0,277.0,-540.0,640000.0,0.0,-640000.0
<a href=/player/motaj001>motaj001</a>,Jose Mota,Texas Rangers,RNGRS,1,1,1,2,1987,1988,1,No,0,0.0,-0.44,-0.44,0,13,13,0,25,25,0.0,0.0,0.0,0.0,0.0,0.0
<a href=/player/motaj001>motaj001</a>,Jose Mota,Oakland Athletics,ATLTCS,1,1,1,2,1989,1989,0,No,0,-0.39,0.0,0.39,17,0,-17,41,0,-41,0.0,0.0,0.0,0.0,0.0,0.0
<a href=/player/motam101>motam101</a>,Manny Mota,San Francisco Giants,GIANTS,1,2,1,3,1962,1964,2,No,0,0.0,-0.41,-0.41,0,54,54,0,153,153,0.0,0.0,0.0,0.0,0.0,0.0
<a href=/player/motam101>motam101</a>,Manny Mota,Houston Astros,ASTROS,1,1,2,3,1963,1963,0,No,0,6.61,0.36,-6.25,642,133,-509,1858,448,-1410,0.0,0.0,0.0,0.0,0.0,0.0
<a href=/player/motam101>motam101</a>,Manny Mota,Montreal Expos,NATEX,4,5,7,12,1969,1978,9,No,0,18.8,19.12,0.32,1836,868,-968,5544,3116,-2428,0.0,0.0,0.0,0.0,0.0,0.0
<a href=/player/motld001>motld001</a>,Darryl Motley,Kansas City Royals,ROYALS,5,9,8,17,1986,1994,8,No,2,21.74,13.54,-8.2,1174,873,-301,1102,3196,2094,6286.0,326.0,-5960.0,1438000.0,0.0,-1438000.0
<a href=/player/mottc101>mottc101</a>,Curt Motton,Baltimore Orioles,ORLS,4,4,5,9,1971,1979,8,No,0,-0.08,4.3,4.38,77,137,60,22,2,-20,299.0,750.0,451.0,0.0,0.0,0.0
<a href=/player/mottc101>mottc101</a>,Curt Motton,Milwaukee Brewers,BREWRS,1,1,1,2,1972,1972,0,No,0,0.01,-0.86,-0.87,42,10,-32,44,4,-40,0.0,56.0,56.0,20500.0,0.0,-20500.0
<a href=/player/mottt001>mottt001</a>,Taylor Motter,Tampa Bay Devil Rays,RAYS,1,2,3,5,2016,2021,5,Yes,0,-0.63,1.91,2.54,100,161,61,297,1,-296,3.0,549.0,546.0,0.0,0.0,0.0
<a href=/player/moulg101>moulg101</a>,Glen Moulder,Brooklyn Dodgers,DOGRS,1,1,1,2,1950,1951,1,No,0,0.0,0.0,0.0,0,0,0,0,0,0,0.0,0.0,0.0,0.0,0.0,0.0
<a href=/player/mousm001>mousm001</a>,Mike Moustakas,Kansas City Royals,ROYALS,2,2,3,5,2018,2020,2,Yes,0,5.78,-0.83,-6.61,333,134,-199,1119,238,-881,3.0,475.0,472.0,0.0,0.0,0.0
<a href=/player/moutj001>moutj001</a>,James Mouton,Houston Astros,ASTROS,1,1,1,2,1998,1999,1,No,0,-1.01,1.9,2.91,55,98,43,71,97,26,0.0,813.0,813.0,0.0,0.0,0.0
<a href=/player/moutl001>moutl001</a>,Lyle Mouton,New York Yankees,YANKS,1,2,1,3,1995,1995,0,No,0,1.86,4.02,2.16,233,30,-203,702,0,-702,0.0,653.0,653.0,0.0,0.0,0.0
<a href=/player/moutl001>moutl001</a>,Lyle Mouton,Baltimore Orioles,ORLS,1,1,1,2,1999,1999,0,No,0,0.16,0.0,-0.16,56,0,-56,128,0,-128,0.0,0.0,0.0,0.0,0.0,0.0
<a href=/player/moutl001>moutl001</a>,Lyle Mouton,Philadelphia Phillies,PHILS,1,1,1,2,2003,2003,0,No,0,0.0,0.0,0.0,0,0,0,0,0,0,0.0,0.0,0.0,0.0,0.0,0.0
<a href=/player/mowrj101>mowrj101</a>,Joe Mowry,Minneapolis,Minneapolis,1,1,3,4,1933,1933,0,No,0,-0.78,0.0,0.78,192,0,-192,511,0,-511,0.0,0.0,0.0,0.0,0.0,0.0
<a href=/player/mowrj101>mowrj101</a>,Joe Mowry,Boston Braves,BRAVES,1,2,1,3,1936,1940,4,No,0,0.0,8.2,8.2,0,205,205,0,253,253,0.0,2031.0,2031.0,0.0,0.0,0.0
<a href=/player/mowrm101>mowrm101</a>,Mike Mowrey,Cincinnati Reds,REDS,1,1,1,2,1909,1909,0,No,0,10.32,0.19,-10.13,538,13,-525,2171,49,-2122,0.0,0.0,0.0,0.0,0.0,0.0
<a href=/player/mowrm101>mowrm101</a>,Mike Mowrey,St. Louis Cardinals,CARDS,1,3,5,8,1913,1920,7,No,0,9.94,10.5,0.56,493,813,320,1225,2891,1666,2306.0,795.0,-1511.0,13500.0,0.0,-13500.0
<a href=/player/moyag001>moyag001</a>,Gabriel Moya,Arizona Diamondbacks,DBACKS,1,1,1,2,2017,2019,2,No,0,0.14,-0.48,-0.62,43,119,76,0,299,299,128.0,9.0,-119.0,0.0,0.0,0.0
<a href=/player/moyej001>moyej001</a>,Jamie Moyer,Chicago Cubs,CUBS,6,8,15,23,1988,1995,7,No,0,50.51,3.13,-47.38,2529,1449,-1080,6791,543,-6248,2650.0,3110.0,460.0,1193000.0,0.0,-1193000.0
<a href=/player/moyej001>moyej001</a>,Jamie Moyer,Boston Red Sox,RSOX,1,1,1,2,1996,1998,2,No,0,34.44,6.2,-28.24,337,340,3,31,1315,1284,6279.0,0.0,-6279.0,825000.0,0.0,-825000.0
<a href=/player/moyej001>moyej001</a>,Jamie Moyer,Seattle Mariners,MARNRS,1,1,2,3,2006,2006,0,No,0,4.31,0.0,-4.31,239,0,-239,269,0,-269,2162.0,0.0,-2162.0,5500000.0,0.0,-5500000.0
<a href=/player/muelb001>muelb001</a>,Bill Mueller,San Francisco Giants,GIANTS,1,1,1,2,2000,2003,3,No,0,3.59,2.59,-1.0,173,451,278,670,9,-661,0.0,686.0,686.0,1325000.0,0.0,-1325000.0
<a href=/player/muelb001>muelb001</a>,Bill Mueller,Chicago Cubs,CUBS,1,2,1,3,2002,2002,0,No,0,-0.13,0.0,0.13,8,0,-8,14,0,-14,0.0,0.0,0.0,3450000.0,0.0,-3450000.0
<a href=/player/muelh102>muelh102</a>,Heinie Mueller,St. Louis Cardinals,CARDS,1,1,1,2,1926,1926,0,No,0,0.3,3.22,2.92,169,99,-70,554,439,-115,0.0,0.0,0.0,4875.0,0.0,-4875.0
<a href=/player/muelh102>muelh102</a>,Heinie Mueller,Toledo,Toledo,1,2,1,3,1928,1928,0,No,0,-1.24,0.0,1.24,94,0,-94,291,0,-291,20.0,0.0,-20.0,0.0,0.0,0.0
<a href=/player/muelr101>muelr101</a>,Ray Mueller,Boston Braves,BRAVES,2,2,4,6,1938,1946,8,No,0,1.07,0.29,-0.78,243,210,-33,646,200,-446,0.0,1618.0,1618.0,0.0,0.0,0.0
<a href=/player/muelr101>muelr101</a>,Ray Mueller,Cincinnati Reds,REDS,10,18,24,42,1949,1965,16,No,0,91.56,26.25,-65.31,5002,2400,-2602,16123,6124,-9999,2749.0,1025.0,-1724.0,63000.0,0.0,-63000.0
<a href=/player/muffb101>muffb101</a>,Billy Muffett,St. Louis Cardinals,CARDS,2,6,5,11,1958,1965,7,No,0,0.78,23.86,23.08,573,513,-60,1253,888,-365,694.0,3387.0,2693.0,0.0,0.0,0.0
<a href=/player/muffb101>muffb101</a>,Billy Muffett,San Francisco Giants,GIANTS,1,2,1,3,1959,1959,0,No,0,1.57,0.59,-0.98,124,22,-102,73,0,-73,725.0,39.0,-686.0,0.0,0.0,0.0
<a href=/player/mujie001>mujie001</a>,Edward Mujica,San Diego Padres,PADRS,7,19,13,32,2010,2021,11,Yes,0,21.8,17.69,-4.11,1883,1364,-519,3716,4253,537,2638.0,362.0,-2276.0,9990300.0,0.0,-9990300.0
<a href=/player/mujie001>mujie001</a>,Edward Mujica,Miami Marlins,MARLNS,1,1,1,2,2012,2012,0,No,0,2.77,0.0,-2.77,183,0,-183,2,0,-2,273.0,0.0,-273.0,1625000.0,0.0,-1625000.0
<a href=/player/mujie001>mujie001</a>,Edward Mujica,Boston Red Sox,RSOX,1,2,1,3,2015,2015,0,No,0,-0.49,0.0,0.49,41,0,-41,0,0,0,101.0,0.0,-101.0,0.0,0.0,0.0
<a href=/player/muldm001>muldm001</a>,Mark Mulder,Oakland Athletics,ATLTCS,16,29,29,58,2004,2018,14,Yes,0,108.62,49.4,-59.22,6127,2964,-3163,18338,8301,-10037,6576.0,6023.0,-553.0,37067500.0,0.0,-37067500.0
<a href=/player/mulht001>mulht001</a>,Terry Mulholland,San Francisco Giants,GIANTS,2,4,4,8,1989,1995,6,No,0,14.97,0.18,-14.79,1080,283,-797,2467,146,-2321,4215.0,391.0,-3824.0,1545000.0,0.0,-1545000.0
<a href=/player/mulht001>mulht001</a>,Terry Mulholland,Philadelphia Phillies,PHILS,1,2,3,5,1994,2002,8,No,0,-0.95,-1.6,-0.65,27,666,639,0,1569,1569,372.0,587.0,215.0,0.0,0.0,0.0
<a href=/player/mulht001>mulht001</a>,Terry Mulholland,Philadelphia Phillies,PHILS,2,2,2,4,1996,2001,5,No,0,0.74,-1.66,-2.4,57,337,280,189,1216,1027,208.0,0.0,-208.0,1045000.0,0.0,-1045000.0
<a href=/player/mulht001>mulht001</a>,Terry Mulholland,Chicago Cubs,CUBS,3,5,7,12,1999,2001,2,No,2,0.04,-3.17,-3.21,294,120,-174,362,46,-316,1366.0,490.0,-876.0,5325000.0,0.0,-5325000.0
<a href=/player/mulht001>mulht001</a>,Terry Mulholland,Pittsburgh Pirates,PIRATS,4,5,5,10,2001,2006,5,No,0,-2.39,-0.22,2.17,239,214,-25,117,329,212,377.0,169.0,-208.0,6500000.0,0.0,-6500000.0
<a href=/player/mulht001>mulht001</a>,Terry Mulholland,Los Angeles Dodgers,DOGRS,1,3,1,4,2002,2004,2,No,0,-0.33,0.6,0.93,92,177,85,4,5,1,830.0,299.0,-531.0,3250000.0,0.0,-3250000.0
<a href=/player/mullb101>mullb101</a>,Billy Mullen,Detroit Tigers,TIGRS,2,5,4,9,1927,1934,7,No,0,25.64,16.62,-9.02,1182,957,-225,3618,3579,-39,3712.0,0.0,-3712.0,12500.0,0.0,-12500.0
<a href=/player/mullb101>mullb101</a>,Billy Mullen,Brooklyn Dodgers,DOGRS,1,2,1,3,1925,1927,2,No,0,0.0,0.0,0.0,0,40,40,0,13,13,0.0,139.0,139.0,0.0,0.0,0.0
<a href=/player/mullb101>mullb101</a>,Billy Mullen,FortWorth,FortWorth,1,2,2,4,1925,1925,0,No,0,-0.54,0.0,0.54,83,0,-83,54,0,-54,341.0,0.0,-341.0,0.0,0.0,0.0
<a href=/player/mullc101>mullc101</a>,Charlie Mullen,Lincoln,Lincoln,1,1,2,3,1914,1914,0,No,0,0.94,0.0,-0.94,192,0,-192,644,0,-644,0.0,0.0,0.0,0.0,0.0,0.0
<a href=/player/mullf001>mullf001</a>,Fran Mullins,Chicago White Sox,WSOX,1,1,1,2,1983,1984,1,No,0,0.0,0.18,0.18,0,12,12,0,11,11,0.0,0.0,0.0,0.0,0.0,0.0
<a href=/player/mullf101>mullf101</a>,Freddie Muller,Boston Red Sox,RSOX,2,4,2,6,1934,1946,12,No,0,-0.53,28.3,28.83,39,1263,1224,121,5085,4964,0.0,0.0,0.0,0.0,0.0,0.0
<a href=/player/mullg101>mullg101</a>,Greg Mulleavy,Toledo,Toledo,1,1,2,3,1930,1934,4,No,0,-0.54,0.0,0.54,78,0,-78,324,0,-324,0.0,0.0,0.0,0.0,0.0,0.0
<a href=/player/mullg101>mullg101</a>,Greg Mulleavy,Chicago White Sox,WSOX,2,7,3,10,1932,1936,4,No,0,0.81,-0.11,-0.92,234,49,-185,748,93,-655,0.0,39.0,39.0,8600.0,0.0,-8600.0
<a href=/player/mullj103>mullj103</a>,Eddie Mulligan,Chicago White Sox,WSOX,2,5,2,7,1922,1931,9,No,0,8.34,28.43,20.09,522,1292,770,2094,5360,3266,0.0,0.0,0.0,22100.0,0.0,-22100.0
<a href=/player/mullj103>mullj103</a>,Eddie Mulligan,Chicago Cubs,CUBS,1,1,2,3,1916,1916,0,No,0,0.0,-0.68,-0.68,0,69,69,0,256,256,0.0,0.0,0.0,1350.0,0.0,-1350.0
<a href=/player/mullr001>mullr001</a>,Rance Mulliniks,California Angels,ANGELS,4,5,7,12,1979,1983,4,No,0,17.81,3.93,-13.88,1525,241,-1284,5870,846,-5024,0.0,43.0,43.0,0.0,0.0,0.0
<a href=/player/mullr001>mullr001</a>,Rance Mulliniks,Kansas City Royals,ROYALS,1,1,1,2,1982,1983,1,No,0,15.83,0.0,-15.83,1115,0,-1115,3470,0,-3470,0.0,0.0,0.0,0.0,0.0,0.0
<a href=/player/mulls002>mulls002</a>,Scott Mullen,Kansas City Royals,ROYALS,2,3,2,5,2003,2004,1,No,0,-0.09,-0.19,-0.1,2,17,15,1,19,18,9.0,0.0,-9.0,0.0,0.0,0.0
<a href=/player/mullt101>mullt101</a>,Tony Mullane,Cincinnati Reds,REDS,1,1,2,3,1893,1893,0,No,0,3.4,0.84,-2.56,114,42,-72,180,193,13,1102.0,0.0,-1102.0,2100.0,0.0,-2100.0
<a href=/player/mullt101>mullt101</a>,Tony Mullane,Baltimore Orioles,BLN,1,1,1,2,1894,1894,0,No,0,-0.28,0.0,0.28,8,0,-8,18,0,-18,99.0,0.0,-99.0,0.0,0.0,0.0
<a href=/player/mulrf101>mulrf101</a>,Frank Mulroney,Boston Red Sox,RSOX,2,6,4,10,1930,1937,7,No,0,1.87,7.56,5.69,361,744,383,1356,1842,486,119.0,1357.0,1238.0,15100.0,0.0,-15100.0
<a href=/player/mulvk001>mulvk001</a>,Kevin Mulvey,New York Mets,METS,1,4,1,5,2008,2013,5,No,0,2.31,15.63,13.32,305,210,-95,963,247,-716,66.0,2151.0,2085.0,0.0,0.0,0.0
<a href=/player/mulvk001>mulvk001</a>,Kevin Mulvey,Minnesota Twins,TWINS,1,1,1,2,2009,2010,1,No,0,-0.41,1.94,2.35,16,78,62,7,1,-6,78.0,220.0,142.0,0.0,0.0,0.0
<a href=/player/mumpj001>mumpj001</a>,Jerry Mumphrey,St. Louis Cardinals,CARDS,1,2,1,3,1979,1980,1,No,0,5.72,-0.43,-6.15,56,86,30,0,270,270,1178.0,0.0,-1178.0,0.0,0.0,0.0
<a href=/player/mumpj001>mumpj001</a>,Jerry Mumphrey,Cleveland Indians,INDINS,7,12,14,26,1980,2011,31,No,2,38.83,55.66,16.83,1690,2720,1030,6276,9199,2923,2682.0,4713.0,2031.0,1767500.0,0.0,-1767500.0
<a href=/player/mumpj001>mumpj001</a>,Jerry Mumphrey,San Diego Padres,PADRS,5,10,10,20,1981,1989,8,No,1,31.59,15.32,-16.27,2540,1209,-1331,8500,2443,-6057,1963.0,4252.0,2289.0,0.0,0.0,0.0
<a href=/player/mumpj001>mumpj001</a>,Jerry Mumphrey,New York Yankees,YANKS,1,1,1,2,1983,1985,2,No,0,4.93,0.17,-4.76,325,199,-126,1241,613,-628,0.0,0.0,0.0,0.0,0.0,0.0
<a href=/player/mumpj001>mumpj001</a>,Jerry Mumphrey,Houston Astros,ASTROS,2,2,3,5,1985,1990,5,No,0,1.33,6.01,4.68,319,667,348,845,2612,1767,0.0,0.0,0.0,0.0,0.0,0.0
<a href=/player/muncb101>muncb101</a>,Bob Muncrief,St.Louis Browns,ORLS,6,12,14,26,1947,1960,13,No,0,15.93,14.55,-1.38,866,1429,563,1976,4545,2569,2508.0,1208.0,-1300.0,30000.0,0.0,-30000.0
<a href=/player/mungr101>mungr101</a>,Red Munger,St. Louis Cardinals,CARDS,1,1,1,2,1952,1952,0,No,0,0.21,-0.28,-0.49,80,38,-42,41,9,-32,400.0,117.0,-283.0,0.0,0.0,0.0
<a href=/player/mungv101>mungv101</a>,Van Mungo,Brooklyn Dodgers,DOGRS,4,8,8,16,1941,1958,17,No,0,4.28,10.97,6.69,1667,1086,-581,5534,2416,-3118,435.0,3148.0,2713.0,50000.0,0.0,-50000.0
<a href=/player/munnl101>munnl101</a>,Les Munns,StPaul,StPaul,1,1,4,5,1933,1933,0,No,0,-1.36,0.0,1.36,110,0,-110,47,0,-47,473.0,0.0,-473.0,0.0,0.0,0.0
<a href=/player/munns101>munns101</a>,Scott Munninghoff,Philadelphia Phillies,PHILS,5,9,9,18,1981,1988,7,No,0,7.67,6.22,-1.45,1238,579,-659,3588,1540,-2048,737.0,444.0,-293.0,1380000.0,0.0,-1380000.0
<a href=/player/munoa002>munoa002</a>,Andres Munoz,San Diego Padres,PADRS,1,4,3,7,2020,2021,1,Yes,0,5.43,0.42,-5.01,353,36,-317,1365,75,-1290,2.0,42.0,40.0,0.0,0.0,0.0
<a href=/player/munob001>munob001</a>,Bobby Munoz,New York Yankees,YANKS,1,3,2,5,1994,1995,1,No,0,-1.6,-0.95,0.65,666,27,-639,1569,0,-1569,587.0,372.0,-215.0,0.0,0.0,0.0
<a href=/player/munom001>munom001</a>,Mike Munoz,Los Angeles Dodgers,DOGRS,1,1,1,2,1990,1990,0,No,0,0.81,0.0,-0.81,80,0,-80,0,0,0,181.0,0.0,-181.0,0.0,0.0,0.0
<a href=/player/munoo001>munoo001</a>,Oscar Munoz,Cleveland Indians,INDINS,1,2,1,3,1992,1995,3,No,0,-0.31,3.9,4.21,10,487,477,0,1779,1779,106.0,0.0,-106.0,0.0,0.0,0.0
<a href=/player/munop001>munop001</a>,Pedro Munoz,Toronto Blue Jays,BJAYS,1,2,1,3,1990,1990,0,No,0,0.48,-0.21,-0.69,536,13,-523,1913,0,-1913,0.0,64.0,64.0,255000.0,0.0,-255000.0
<a href=/player/munoy001>munoy001</a>,Yairo Munoz,Oakland Athletics,ATLTCS,1,2,1,3,2017,2017,0,Yes,0,-0.26,0.0,0.26,208,0,-208,527,0,-527,3.0,0.0,-3.0,0.0,0.0,0.0
<a href=/player/munrp001>munrp001</a>,Peter Munro,Boston Red Sox,RSOX,1,2,1,3,1998,2000,2,No,0,-0.36,2.97,3.33,41,241,200,1,918,917,243.0,0.0,-243.0,0.0,0.0,0.0
<a href=/player/munrp001>munrp001</a>,Peter Munro,Toronto Blue Jays,BJAYS,1,1,1,2,2000,2000,0,No,0,0.0,0.81,0.81,0,47,47,0,206,206,0.0,0.0,0.0,220000.0,0.0,-220000.0
<a href=/player/munsj101>munsj101</a>,Joe Munson,Chicago Cubs,CUBS,2,4,3,7,1926,1934,8,No,0,0.0,24.0,24.0,0,988,988,0,3984,3984,0.0,0.0,0.0,12967.0,0.0,-12967.0
<a href=/player/muras001>muras001</a>,Steve Mura,San Diego Padres,PADRS,7,12,13,25,1981,1993,12,No,1,64.79,33.72,-31.07,2384,3112,728,8892,7842,-1050,1163.0,2653.0,1490.0,905000.0,0.0,-905000.0
<a href=/player/murcb101>murcb101</a>,Bobby Murcer,New York Yankees,YANKS,22,50,41,91,1974,2001,27,No,2,85.65,95.73,10.08,5899,5684,-215,17528,18205,677,12396.0,7138.0,-5258.0,3804706.0,0.0,-3804706.0
<a href=/player/murcb101>murcb101</a>,Bobby Murcer,San Francisco Giants,GIANTS,15,30,32,62,1977,1998,21,No,2,51.49,73.51,22.02,3614,5339,1725,8817,8462,-355,5201.0,15628.0,10427.0,10639278.0,0.0,-10639278.0
<a href=/player/murcb101>murcb101</a>,Bobby Murcer,Chicago Cubs,CUBS,2,4,2,6,1979,1982,3,No,0,0.19,0.93,0.74,338,128,-210,948,477,-471,152.0,0.0,-152.0,320000.0,0.0,-320000.0
<a href=/player/murct101>murct101</a>,Tim Murchison,St. Louis Cardinals,CARDS,1,4,1,5,1918,1918,0,No,0,0.0,0.57,0.57,0,80,80,0,312,312,0.0,0.0,0.0,0.0,0.0,0.0
<a href=/player/murfr101>murfr101</a>,Red Murff,New York Giants,GIANTS,1,1,1,2,1955,1957,2,No,0,-0.36,0.0,0.36,52,0,-52,12,0,-12,151.0,0.0,-151.0,0.0,0.0,0.0
<a href=/player/murpb001>murpb001</a>,Bill Murphy,Oakland Athletics,ATLTCS,6,10,8,18,2003,2017,14,Yes,0,-1.4,14.82,16.22,291,1017,726,344,2748,2404,719.0,1374.0,655.0,18058194.0,0.0,-18058194.0
<a href=/player/murpb001>murpb001</a>,Bill Murphy,Florida Marlins,MARLNS,10,19,25,44,2004,2019,15,Yes,0,75.87,54.29,-21.58,2478,2882,404,6294,8326,2032,10672.0,5424.0,-5248.0,38568667.0,0.0,-38568667.0
<a href=/player/murpb001>murpb001</a>,Bill Murphy,Los Angeles Dodgers,DOGRS,1,3,2,5,2004,2004,0,No,0,-0.45,1.02,1.47,67,105,38,129,363,234,19.0,0.0,-19.0,0.0,0.0,0.0
<a href=/player/murpd001>murpd001</a>,Dale Murphy,Atlanta Braves,BRAVES,3,4,5,9,1990,1991,1,No,0,7.07,0.22,-6.85,460,126,-334,1122,43,-1079,1808.0,218.0,-1590.0,2100000.0,0.0,-2100000.0
<a href=/player/murpd003>murpd003</a>,Dan Murphy,Milwaukee Brewers,BREWRS,2,3,4,7,1989,1993,4,No,0,-0.17,2.11,2.28,14,83,69,0,0,0,19.0,300.0,281.0,0.0,0.0,0.0
<a href=/player/murpd005>murpd005</a>,David Murphy,Boston Red Sox,RSOX,4,8,6,14,2007,2017,10,No,3,18.18,4.77,-13.41,1196,220,-976,3031,777,-2254,3507.0,311.0,-3196.0,415500.0,0.0,-415500.0
<a href=/player/murpd005>murpd005</a>,David Murphy,Cleveland Indians,INDINS,1,1,1,2,2015,2019,4,No,0,-0.3,-0.71,-0.41,48,15,-33,162,48,-114,0.0,0.0,0.0,0.0,0.0,0.0
<a href=/player/murpd006>murpd006</a>,Daniel Murphy,Washington Nationals,NATEX,3,7,6,13,2018,2021,3,Yes,0,0.11,4.3,4.19,169,190,21,579,712,133,140.0,0.0,-140.0,24500000.0,0.0,-24500000.0
<a href=/player/murpd105>murpd105</a>,Danny Murphy,Chicago Cubs,CUBS,6,9,11,20,1963,1968,5,No,0,-0.05,-1.18,-1.13,253,592,339,665,1006,341,220.0,727.0,507.0,0.0,0.0,0.0
<a href=/player/murpd105>murpd105</a>,Danny Murphy,Houston Astros,ASTROS,1,3,1,4,1963,1964,1,No,0,0.82,1.37,0.55,136,133,-3,10,502,492,336.0,0.0,-336.0,0.0,0.0,0.0
<a href=/player/murpd105>murpd105</a>,Danny Murphy,Chicago White Sox,WSOX,5,7,6,13,1971,1976,5,No,0,-2.36,0.03,2.39,667,792,125,1044,1819,775,489.0,881.0,392.0,27000.0,0.0,-27000.0
<a href=/player/murpe102>murpe102</a>,Eddie Murphy,Baltimore,Baltimore,2,3,5,8,1912,1914,2,No,0,9.51,0.0,-9.51,886,0,-886,3679,0,-3679,0.0,0.0,0.0,0.0,0.0,0.0
<a href=/player/murpj001>murpj001</a>,John Ryan Murphy,New York Yankees,YANKS,1,1,1,2,2015,2015,0,Yes,0,-0.53,0.0,0.53,26,0,-26,90,0,-90,0.0,0.0,0.0,518700.0,0.0,-518700.0
<a href=/player/murpj001>murpj001</a>,John Ryan Murphy,Minnesota Twins,TWINS,1,1,1,2,2017,2019,2,No,0,-0.48,0.14,0.62,119,43,-76,299,0,-299,9.0,128.0,119.0,0.0,0.0,0.0
<a href=/player/murpj103>murpj103</a>,Johnny Murphy,StPaul,StPaul,1,2,5,7,1931,1932,1,No,0,15.3,0.0,-15.3,992,0,-992,1098,0,-1098,2971.0,0.0,-2971.0,0.0,0.0,0.0
<a href=/player/murpm101>murpm101</a>,Morgan Murphy,Cincinnati Reds,REDS,4,11,5,16,1895,1906,11,No,0,8.81,24.47,15.66,1114,1079,-35,4520,3525,-995,393.0,2208.0,1815.0,1500.0,0.0,-1500.0
<a href=/player/murpm101>murpm101</a>,Morgan Murphy,St. Louis Cardinals,CARDS,1,1,1,2,1897,1899,2,No,0,-0.06,0.64,0.7,5,89,84,18,320,302,0.0,0.0,0.0,0.0,0.0,0.0
<a href=/player/murpr001>murpr001</a>,Rob Murphy,Cincinnati Reds,REDS,2,3,4,7,1988,1991,3,No,0,5.15,-2.88,-8.03,374,383,9,948,1386,438,486.0,0.0,-486.0,1340000.0,0.0,-1340000.0
<a href=/player/murpr001>murpr001</a>,Rob Murphy,Boston Red Sox,RSOX,2,3,2,5,1991,1993,2,No,0,0.62,0.09,-0.53,106,123,17,5,239,234,258.0,782.0,524.0,177000.0,0.0,-177000.0
<a href=/player/murpt002>murpt002</a>,Tom Murphy,San Francisco Giants,GIANTS,1,1,1,2,2019,2019,0,Yes,0,3.56,0.0,-3.56,175,0,-175,606,0,-606,9.0,0.0,-9.0,0.0,0.0,0.0
<a href=/player/murpt101>murpt101</a>,Tom Murphy,California Angels,ANGELS,3,3,4,7,1972,1978,6,No,0,0.67,2.83,2.16,48,493,445,39,1512,1473,211.0,370.0,159.0,55000.0,0.0,-55000.0
<a href=/player/murpt101>murpt101</a>,Tom Murphy,Kansas City Royals,ROYALS,1,1,1,2,1973,1973,0,No,0,0.89,0.0,-0.89,38,0,-38,27,0,-27,266.0,0.0,-266.0,0.0,0.0,0.0
<a href=/player/murpt101>murpt101</a>,Tom Murphy,St. Louis Cardinals,CARDS,3,3,3,6,1973,1976,3,No,0,2.97,-0.18,-3.15,208,36,-172,184,81,-103,641.0,0.0,-641.0,34000.0,0.0,-34000.0
<a href=/player/murpt101>murpt101</a>,Tom Murphy,Milwaukee Brewers,BREWRS,2,4,2,6,1976,1976,0,No,0,3.64,0.57,-3.07,542,69,-473,1808,219,-1589,335.0,0.0,-335.0,150000.0,0.0,-150000.0
<a href=/player/murrd001>murrd001</a>,Dale Murray,Montreal Expos,NATEX,3,4,4,8,1976,1990,14,No,1,-2.11,10.28,12.39,198,921,723,45,1873,1828,656.0,1567.0,911.0,0.0,0.0,0.0
<a href=/player/murrd001>murrd001</a>,Dale Murray,Cincinnati Reds,REDS,1,1,1,2,1978,1979,1,No,0,-0.76,-1.12,-0.36,222,74,-148,17,182,165,550.0,0.0,-550.0,0.0,0.0,0.0
<a href=/player/murrd001>murrd001</a>,Dale Murray,Toronto Blue Jays,BJAYS,5,11,10,21,1982,2002,20,No,2,27.04,54.84,27.8,1781,2798,1017,5518,11043,5525,3160.0,1213.0,-1947.0,5387500.0,0.0,-5387500.0
<a href=/player/murrd002>murrd002</a>,Dan Murray,New York Mets,METS,12,25,27,52,1999,2021,22,Yes,0,23.9,25.99,2.09,988,1828,840,1624,4624,3000,6089.0,4666.0,-1423.0,30731467.0,0.0,-30731467.0
<a href=/player/murre001>murre001</a>,Eddie Murray,Baltimore Orioles,ORLS,5,6,7,13,1988,1993,5,No,0,13.19,1.07,-12.12,985,444,-541,3313,1296,-2017,944.0,523.0,-421.0,3292904.0,0.0,-3292904.0
<a href=/player/murre001>murre001</a>,Eddie Murray,Cleveland Indians,INDINS,1,1,1,2,1996,1996,0,No,0,0.17,0.32,0.15,64,10,-54,263,0,-263,0.0,35.0,35.0,2000000.0,0.0,-2000000.0
<a href=/player/murrg001>murrg001</a>,Glenn Murray,Montreal Expos,NATEX,1,1,1,2,1994,1994,0,No,0,0.0,0.0,0.0,0,0,0,0,0,0,0.0,0.0,0.0,0.0,0.0,0.0
<a href=/player/murrg001>murrg001</a>,Glenn Murray,Boston Red Sox,RSOX,8,14,15,29,1996,2020,24,Yes,4,-2.56,56.84,59.4,788,2785,1997,802,6826,6024,1145.0,5281.0,4136.0,26826923.0,0.0,-26826923.0
<a href=/player/murrg101>murrg101</a>,George Murray,New York Yankees,YANKS,1,4,1,5,1923,1934,11,No,0,-1.25,33.68,34.93,272,692,420,598,908,310,765.0,6610.0,5845.0,0.0,0.0,0.0
<a href=/player/murrg101>murrg101</a>,George Murray,Boston Braves,BRAVES,2,5,2,7,1933,1940,7,No,0,0.0,7.42,7.42,0,397,397,0,764,764,0.0,2031.0,2031.0,0.0,0.0,0.0
<a href=/player/murrj102>murrj102</a>,Joe Murray,New York Yankees,YANKS,1,4,1,5,1947,1947,0,No,0,0.0,0.0,0.0,0,0,0,0,0,0,0.0,0.0,0.0,0.0,0.0,0.0
<a href=/player/murrl101>murrl101</a>,Larry Murray,New York Yankees,YANKS,2,4,2,6,1977,1985,8,No,1,-3.76,2.42,6.18,344,31,-313,885,0,-885,78.0,651.0,573.0,0.0,0.0,0.0
<a href=/player/murrm001>murrm001</a>,Matt Murray,Atlanta Braves,BRAVES,2,3,3,6,1995,1997,2,No,0,1.44,0.0,-1.44,84,28,-56,0,58,58,245.0,0.0,-245.0,1500000.0,0.0,-1500000.0
<a href=/player/murrr102>murrr102</a>,Ray Murray,Cleveland Indians,INDINS,1,3,1,4,1951,1951,0,No,0,2.32,1.96,-0.36,252,108,-144,644,24,-620,610.0,338.0,-272.0,0.0,0.0,0.0
<a href=/player/murrr103>murrr103</a>,Red Murray,St. Louis Cardinals,CARDS,1,3,1,4,1908,1912,4,No,0,13.84,10.02,-3.82,1179,290,-889,3934,993,-2941,1350.0,10.0,-1340.0,0.0,0.0,0.0
<a href=/player/murtd101>murtd101</a>,Danny Murtaugh,Boston Braves,BRAVES,3,8,5,13,1947,1952,5,No,0,11.92,5.66,-6.26,840,490,-350,2908,1370,-1538,0.0,414.0,414.0,0.0,0.0,0.0
<a href=/player/murtm001>murtm001</a>,Matt Murton,Boston Red Sox,RSOX,5,11,8,19,2004,2019,15,No,2,17.0,33.45,16.45,1239,1746,507,2378,6714,4336,960.0,157.0,-803.0,12471000.0,0.0,-12471000.0
<a href=/player/murtm001>murtm001</a>,Matt Murton,Chicago Cubs,CUBS,1,4,2,6,2008,2009,1,No,0,13.08,4.54,-8.54,545,124,-421,2047,74,-1973,213.0,718.0,505.0,0.0,0.0,0.0
<a href=/player/murtm001>murtm001</a>,Matt Murton,Oakland Athletics,ATLTCS,5,6,5,11,2009,2014,5,No,0,3.4,5.86,2.46,381,341,-40,607,854,247,434.0,601.0,167.0,3675000.0,0.0,-3675000.0
<a href=/player/muset101>muset101</a>,Tony Muser,Boston Red Sox,RSOX,1,2,2,4,1971,1971,0,No,0,2.81,0.28,-2.53,456,91,-365,786,331,-455,371.0,0.0,-371.0,0.0,0.0,0.0
<a href=/player/muset101>muset101</a>,Tony Muser,Chicago White Sox,WSOX,1,1,1,2,1975,1976,1,No,0,-1.06,-2.47,-1.41,336,41,-295,581,0,-581,0.0,510.0,510.0,0.0,0.0,0.0
<a href=/player/musgj001>musgj001</a>,Joe Musgrove,Toronto Blue Jays,BJAYS,4,12,6,18,2012,2016,4,No,0,10.83,2.99,-7.84,1068,309,-759,3494,605,-2889,904.0,1431.0,527.0,11237500.0,0.0,-11237500.0
<a href=/player/musgj001>musgj001</a>,Joe Musgrove,Houston Astros,ASTROS,1,4,1,5,2018,2019,1,No,0,3.26,12.09,8.83,813,71,-742,1676,16,-1660,1316.0,1238.0,-78.0,0.0,0.0,0.0
<a href=/player/musgj001>musgj001</a>,Joe Musgrove,Pittsburgh Pirates,PIRATS,1,1,5,6,2021,2021,0,Yes,0,3.49,2.1,-1.39,68,119,51,57,1,-56,544.0,182.0,-362.0,0.0,0.0,0.0
<a href=/player/mussj001>mussj001</a>,Jeff Musselman,Toronto Blue Jays,BJAYS,1,2,1,3,1989,1991,2,No,0,-0.46,1.54,2.0,96,287,191,2,1134,1132,175.0,0.0,-175.0,200000.0,0.0,-200000.0
<a href=/player/mussr001>mussr001</a>,Ron Musselman,Seattle Mariners,MARNRS,2,2,2,4,1982,1984,2,No,0,-0.7,-0.23,0.47,14,208,194,43,686,643,0.0,0.0,0.0,280000.0,0.0,-280000.0
<a href=/player/mussr001>mussr001</a>,Ron Musselman,Minnesota Twins,TWINS,1,1,1,2,1987,1987,0,No,0,0.0,0.0,0.0,0,0,0,0,0,0,0.0,0.0,0.0,0.0,0.0,0.0
<a href=/player/myatg101>myatg101</a>,Glenn Myatt,Philadelphia Athletics,ATLTCS,1,5,1,6,1922,1929,7,No,0,0.0,12.22,12.22,0,592,592,0,2318,2318,0.0,0.0,0.0,0.0,0.0,0.0
<a href=/player/myatg101>myatg101</a>,Glenn Myatt,Milwaukee,Milwaukee,1,1,5,6,1922,1938,16,No,0,5.93,0.0,-5.93,850,0,-850,2604,0,-2604,0.0,0.0,0.0,0.0,0.0,0.0
<a href=/player/myatg101>myatg101</a>,Glenn Myatt,Montreal,Montreal,1,1,0,1,1936,1936,0,No,0,-0.36,0.0,0.36,27,0,-27,89,0,-89,0.0,0.0,0.0,0.0,0.0,0.0
<a href=/player/myerb001>myerb001</a>,Brett Myers,Houston Astros,ASTROS,1,2,3,5,2012,2020,8,No,0,0.83,4.38,3.55,35,242,207,0,1,1,104.0,927.0,823.0,0.0,0.0,0.0
<a href=/player/myerb101>myerb101</a>,Billy Myers,New York Giants,GIANTS,1,2,2,4,1934,1943,9,No,0,13.89,0.64,-13.25,714,229,-485,2652,503,-2149,0.0,264.0,264.0,0.0,0.0,0.0
<a href=/player/myerb101>myerb101</a>,Billy Myers,Cincinnati Reds,REDS,2,2,3,5,1940,1942,2,No,0,0.14,0.55,0.41,24,242,218,74,956,882,0.0,0.0,0.0,9500.0,0.0,-9500.0
<a href=/player/myerb102>myerb102</a>,Bert Myers,St. Louis Cardinals,CARDS,3,5,6,11,1897,1899,2,No,0,11.69,3.06,-8.63,688,394,-294,2803,1695,-1108,0.0,0.0,0.0,0.0,0.0,0.0
<a href=/player/myerb103>myerb103</a>,Buddy Myer,Washington Senators,TWINS,1,1,1,2,1927,1927,0,No,0,6.06,0.71,-5.35,280,45,-235,1161,157,-1004,0.0,0.0,0.0,6000.0,0.0,-6000.0
<a href=/player/myerb103>myerb103</a>,Buddy Myer,Boston Red Sox,RSOX,6,12,13,25,1928,1945,17,No,0,68.04,54.79,-13.25,3392,1677,-1715,12887,3868,-9019,4146.0,8828.0,4682.0,58000.0,0.0,-58000.0
<a href=/player/myere101>myere101</a>,Elmer Myers,Philadelphia Athletics,ATLTCS,2,5,4,9,1919,1920,1,No,0,39.26,1.89,-37.37,2383,166,-2217,9666,676,-8990,678.0,0.0,-678.0,2400.0,0.0,-2400.0
<a href=/player/myerg001>myerg001</a>,Greg Myers,Toronto Blue Jays,BJAYS,1,2,1,3,1992,1993,1,No,0,0.36,1.7,1.34,277,77,-200,834,0,-834,0.0,311.0,311.0,725000.0,0.0,-725000.0
<a href=/player/myerg001>myerg001</a>,Greg Myers,Minnesota Twins,TWINS,1,1,1,2,1997,1997,0,No,0,0.09,0.0,-0.09,43,0,-43,96,0,-96,0.0,0.0,0.0,575000.0,0.0,-575000.0
<a href=/player/myerg001>myerg001</a>,Greg Myers,San Diego Padres,PADRS,1,1,1,2,1999,1999,0,No,0,0.21,0.0,-0.21,34,0,-34,86,0,-86,0.0,0.0,0.0,850000.0,0.0,-850000.0
<a href=/player/myerh101>myerh101</a>,Hap Myers,Boston Red Sox,RSOX,9,25,23,48,1912,1935,23,No,0,51.77,27.05,-24.72,3792,3039,-753,15081,11185,-3896,0.0,1203.0,1203.0,45050.0,0.0,-45050.0
<a href=/player/myerh102>myerh102</a>,Hi Myers,Brooklyn Dodgers,DOGRS,1,2,1,3,1923,1926,3,No,0,0.02,18.82,18.8,141,519,378,488,2176,1688,0.0,0.0,0.0,0.0,0.0,0.0
<a href=/player/myerm001>myerm001</a>,Mike Myers,Florida Marlins,MARLNS,1,1,1,2,1995,1995,0,No,0,-0.09,-0.36,-0.27,186,28,-158,0,0,0,374.0,45.0,-329.0,109000.0,0.0,-109000.0
<a href=/player/myerm001>myerm001</a>,Mike Myers,Detroit Tigers,TIGRS,3,5,3,8,1997,2009,12,No,0,-1.75,6.44,8.19,380,244,-136,75,32,-43,652.0,3275.0,2623.0,4485000.0,0.0,-4485000.0
<a href=/player/myerm001>myerm001</a>,Mike Myers,Milwaukee Brewers,BREWRS,3,3,4,7,1999,2006,7,No,0,4.5,4.26,-0.24,345,551,206,0,86,86,381.0,1411.0,1030.0,4842000.0,0.0,-4842000.0
<a href=/player/myerm001>myerm001</a>,Mike Myers,Colorado Rockies,ROCKS,2,2,3,5,2002,2006,4,No,0,1.19,-0.89,-2.08,286,214,-72,85,616,531,220.0,0.0,-220.0,0.0,0.0,0.0
<a href=/player/myerm001>myerm001</a>,Mike Myers,St. Louis Cardinals,CARDS,1,1,2,3,2005,2005,0,No,0,1.03,0.0,-1.03,68,0,-68,0,0,0,112.0,0.0,-112.0,0.0,0.0,0.0
<a href=/player/myerr001>myerr001</a>,Randy Myers,New York Mets,METS,1,2,2,4,1989,2004,15,No,0,4.69,11.0,6.31,316,1372,1056,62,15,-47,932.0,2108.0,1176.0,300000.0,0.0,-300000.0
<a href=/player/myerr001>myerr001</a>,Randy Myers,Cincinnati Reds,REDS,1,1,2,3,1991,1993,2,No,0,-1.3,4.78,6.08,174,230,56,8,937,929,282.0,0.0,-282.0,2000000.0,0.0,-2000000.0
<a href=/player/myerr001>myerr001</a>,Randy Myers,Toronto Blue Jays,BJAYS,1,1,1,2,1998,1998,0,No,0,-0.33,0.0,0.33,42,0,-42,0,0,0,43.0,0.0,-43.0,4416667.0,0.0,-4416667.0
<a href=/player/myerr002>myerr002</a>,Rodney Myers,Chicago Cubs,CUBS,1,1,1,2,2000,2001,1,No,0,-1.1,-0.01,1.09,104,186,82,3,477,474,212.0,0.0,-212.0,0.0,0.0,0.0
<a href=/player/myerr101>myerr101</a>,Richie Myers,Sacramento,Sacramento,1,2,3,5,1955,1959,4,No,0,0.4,0.0,-0.4,56,0,-56,37,0,-37,317.0,0.0,-317.0,0.0,0.0,0.0
<a href=/player/myerw001>myerw001</a>,Wil Myers,Kansas City Royals,ROYALS,3,6,5,11,2012,2021,9,Yes,0,12.05,17.51,5.46,480,779,299,994,1767,773,2270.0,2321.0,51.0,16050000.0,0.0,-16050000.0
<a href=/player/myerw001>myerw001</a>,Wil Myers,Tampa Bay Devil Rays,RAYS,4,8,12,20,2014,2020,6,Yes,0,10.52,4.14,-6.38,1388,617,-771,4818,2218,-2600,195.0,136.0,-59.0,3254200.0,0.0,-3254200.0
<a href=/player/myeta001>myeta001</a>,Aaron Myette,Chicago White Sox,WSOX,1,2,1,3,2000,2002,2,No,0,-2.48,2.74,5.22,35,247,212,0,861,861,387.0,0.0,-387.0,200000.0,0.0,-200000.0
<a href=/player/myeta001>myeta001</a>,Aaron Myette,Texas Rangers,RNGRS,3,7,7,14,2002,2007,5,No,0,52.47,11.45,-41.02,2261,315,-1946,8496,371,-8125,1660.0,2044.0,384.0,0.0,0.0,0.0
<a href=/player/myeta001>myeta001</a>,Aaron Myette,Cleveland Indians,INDINS,1,1,1,2,2003,2003,0,No,0,0.0,0.0,0.0,0,0,0,0,0,0,0.0,0.0,0.0,307500.0,0.0,-307500.0
<a href=/player/myrib101>myrib101</a>,Bob Myrick,New York Mets,METS,1,2,1,3,1979,1979,0,No,0,0.0,-1.27,-1.27,0,34,34,0,28,28,0.0,255.0,255.0,0.0,0.0,0.0
<a href=/player/myrob001>myrob001</a>,Brian Myrow,New York Yankees,YANKS,1,1,1,2,2004,2006,2,No,0,0.01,0.61,0.6,19,117,98,25,3,-22,0.0,498.0,498.0,0.0,0.0,0.0
<a href=/player/nabhc001>nabhc001</a>,Chris Nabholz,Montreal Expos,NATEX,1,1,2,3,1994,1995,1,No,0,-0.65,-0.08,0.57,6,8,2,0,0,0,33.0,12.0,-21.0,0.0,0.0,0.0
<a href=/player/nabhc001>nabhc001</a>,Chris Nabholz,Cleveland Indians,INDINS,1,2,1,3,1994,1994,0,No,0,-0.23,-0.01,0.22,19,13,-6,0,0,0,165.0,38.0,-127.0,1850000.0,0.0,-1850000.0
<a href=/player/naboj101>naboj101</a>,Jack Nabors,Philadelphia Athletics,ATLTCS,1,2,1,3,1917,1917,0,No,0,0.0,-1.12,-1.12,0,30,30,0,29,29,0.0,242.0,242.0,0.0,0.0,0.0
<a href=/player/nadyx001>nadyx001</a>,Xavier Nady,San Diego Padres,PADRS,1,1,1,2,2005,2007,2,No,0,0.61,7.59,6.98,75,292,217,292,1285,993,0.0,0.0,0.0,488000.0,0.0,-488000.0
<a href=/player/nadyx001>nadyx001</a>,Xavier Nady,New York Mets,METS,3,3,5,8,2006,2014,8,No,2,2.89,1.27,-1.62,269,250,-19,1050,179,-871,0.0,1630.0,1630.0,427000.0,0.0,-427000.0
<a href=/player/nadyx001>nadyx001</a>,Xavier Nady,Pittsburgh Pirates,PIRATS,2,3,6,9,2008,2016,8,No,0,0.52,7.02,6.5,146,1139,993,276,2174,1898,148.0,3210.0,3062.0,9500000.0,0.0,-9500000.0
<a href=/player/nageb101>nageb101</a>,Bill Nagel,Chicago White Sox,WSOX,1,3,1,4,1943,1943,0,No,0,0.0,0.0,0.0,0,0,0,0,0,0,0.0,0.0,0.0,8600.0,0.0,-8600.0
<a href=/player/nageb101>nageb101</a>,Bill Nagel,Milwaukee,Milwaukee,1,1,1,2,1944,1944,0,No,0,-0.85,0.0,0.85,67,0,-67,241,0,-241,0.0,0.0,0.0,0.0,0.0,0.0
<a href=/player/nager101>nager101</a>,Russ Nagelson,Cleveland Indians,INDINS,1,2,1,3,1970,1970,0,No,0,-0.16,-0.64,-0.48,28,86,58,38,9,-29,0.0,173.0,173.0,8070.0,0.0,-8070.0
<a href=/player/nagym101>nagym101</a>,Mike Nagy,Boston Red Sox,RSOX,1,1,1,2,1973,1973,0,No,0,-0.07,0.0,0.07,18,0,-18,11,0,-11,122.0,0.0,-122.0,0.0,0.0,0.0
<a href=/player/nagym101>nagym101</a>,Mike Nagy,St. Louis Cardinals,CARDS,1,2,1,3,1973,1974,1,No,0,0.06,-0.23,-0.29,25,42,17,0,9,9,187.0,127.0,-60.0,0.0,0.0,0.0
<a href=/player/nagym101>nagym101</a>,Mike Nagy,Texas Rangers,RNGRS,3,7,4,11,1973,1978,5,No,0,27.61,17.12,-10.49,555,168,-387,197,0,-197,7626.0,3555.0,-4071.0,60000.0,0.0,-60000.0
<a href=/player/nagym101>nagym101</a>,Mike Nagy,St. Louis Cardinals,CARDS,1,1,1,2,1973,1974,1,No,0,-0.56,0.0,0.56,18,0,-18,1,0,-1,38.0,0.0,-38.0,0.0,0.0,0.0
<a href=/player/nagys101>nagys101</a>,Steve Nagy,Washington Senators,TWINS,1,1,1,2,1950,1950,0,No,0,0.0,0.3,0.3,0,42,42,0,8,8,0.0,109.0,109.0,0.0,0.0,0.0
<a href=/player/nagys101>nagys101</a>,Steve Nagy,Pittsburgh Pirates,PIRATS,2,4,2,6,1948,1956,8,No,0,-0.28,3.82,4.1,38,374,336,9,242,233,117.0,2170.0,2053.0,0.0,0.0,0.0
<a href=/player/nahes101>nahes101</a>,Sam Nahem,Brooklyn Dodgers,DOGRS,1,5,2,7,1940,1946,6,No,0,2.24,22.24,20.0,200,770,570,485,2187,1702,487.0,3020.0,2533.0,0.0,0.0,0.0
<a href=/player/nahob001>nahob001</a>,Bill Nahorodny,Chicago White Sox,WSOX,1,1,1,2,1979,1979,0,No,0,-0.03,0.0,0.03,73,0,-73,181,0,-181,0.0,0.0,0.0,0.0,0.0,0.0
<a href=/player/nancs001>nancs001</a>,Shane Nance,Los Angeles Dodgers,DOGRS,1,2,2,4,2002,2003,1,No,0,-0.76,-0.63,0.13,70,35,-35,11,67,56,164.0,0.0,-164.0,0.0,0.0,0.0
<a href=/player/nancs001>nancs001</a>,Shane Nance,Milwaukee Brewers,BREWRS,7,13,15,28,2003,2012,9,No,2,37.27,23.81,-13.46,2463,1970,-493,9279,4716,-4563,883.0,6330.0,5447.0,8747000.0,0.0,-8747000.0
<a href=/player/napod101>napod101</a>,Danny Napoleon,New York Mets,METS,2,4,4,8,1967,1969,2,No,0,-0.9,-0.52,0.38,52,197,145,76,651,575,0.0,0.0,0.0,0.0,0.0,0.0
<a href=/player/napom001>napom001</a>,Mike Napoli,Anaheim Angels,ANGELS,2,3,3,6,2011,2013,2,Yes,0,-0.32,-0.07,0.25,200,208,8,733,791,58,0.0,0.0,0.0,0.0,0.0,0.0
<a href=/player/napom001>napom001</a>,Mike Napoli,Toronto Blue Jays,BJAYS,2,2,2,4,2011,2011,0,No,1,7.43,1.11,-6.32,380,58,-322,1425,0,-1425,0.0,152.0,152.0,0.0,0.0,0.0
<a href=/player/napom001>napom001</a>,Mike Napoli,Boston Red Sox,RSOX,1,2,1,3,2015,2015,0,No,0,0.14,0.0,-0.14,159,0,-159,576,0,-576,0.0,0.0,0.0,16000000.0,0.0,-16000000.0
<a href=/player/narah101>narah101</a>,Hal Naragon,Cleveland Indians,INDINS,1,2,1,3,1959,1960,1,No,0,-2.61,0.95,3.56,330,49,-281,541,143,-398,528.0,0.0,-528.0,0.0,0.0,0.0
<a href=/player/narlb101>narlb101</a>,Bill Narleski,Boston Red Sox,RSOX,2,6,4,10,1930,1937,7,No,0,1.87,7.56,5.69,361,744,383,1356,1842,486,119.0,1357.0,1238.0,15100.0,0.0,-15100.0
<a href=/player/narlr101>narlr101</a>,Ray Narleski,Cleveland Indians,INDINS,4,8,7,15,1958,1965,7,No,0,18.0,1.46,-16.54,1595,479,-1116,4009,1716,-2293,3556.0,132.0,-3424.0,7500.0,0.0,-7500.0
<a href=/player/narrj001>narrj001</a>,Jerry Narron,New York Yankees,YANKS,7,17,13,30,1979,1992,13,No,0,39.2,19.95,-19.25,2768,1137,-1631,6569,3883,-2686,8301.0,701.0,-7600.0,913333.0,0.0,-913333.0
<a href=/player/narub101>narub101</a>,Buster Narum,Baltimore Orioles,ORLS,2,2,2,4,1964,1966,2,No,0,-1.06,0.23,1.29,184,8,-176,136,13,-123,1163.0,0.0,-1163.0,0.0,0.0,0.0
<a href=/player/narub101>narub101</a>,Buster Narum,Washington Senators,RNGRS,12,27,21,48,1968,1988,20,No,0,46.51,51.95,5.44,2991,4295,1304,9420,12528,3108,3885.0,6824.0,2939.0,527000.0,0.0,-527000.0
<a href=/player/narvc001>narvc001</a>,Chris Narveson,St. Louis Cardinals,CARDS,1,3,1,4,2004,2005,1,No,0,0.0,3.28,3.28,0,144,144,0,545,545,0.0,0.0,0.0,0.0,0.0,0.0
<a href=/player/narvc001>narvc001</a>,Chris Narveson,Colorado Rockies,ROCKS,2,3,3,6,2005,2007,2,No,0,-0.15,1.77,1.92,44,250,206,39,105,66,329.0,1085.0,756.0,2500000.0,0.0,-2500000.0
<a href=/player/narvo001>narvo001</a>,Omar Narvaez,Chicago White Sox,WSOX,1,1,1,2,2018,2020,2,No,0,2.23,2.06,-0.17,132,88,-44,482,0,-482,0.0,250.0,250.0,560000.0,0.0,-560000.0
<a href=/player/narvo001>narvo001</a>,Omar Narvaez,Seattle Mariners,MARNRS,1,1,2,3,2019,2019,0,Yes,0,1.34,0.0,-1.34,163,0,-163,571,0,-571,0.0,0.0,0.0,581200.0,0.0,-581200.0
<a href=/player/nashb101>nashb101</a>,Billy Nash,Boston Braves,BRAVES,1,1,1,2,1895,1902,7,No,0,2.12,23.74,21.62,189,690,501,760,3208,2448,0.0,0.0,0.0,0.0,0.0,0.0
<a href=/player/nashc101>nashc101</a>,Cotton Nash,California Angels,ANGELS,1,2,1,3,1967,1967,0,No,0,-0.11,-0.88,-0.77,3,62,59,4,131,127,0.0,0.0,0.0,0.0,0.0,0.0
<a href=/player/nashc101>nashc101</a>,Cotton Nash,Chicago White Sox,WSOX,1,1,1,2,1969,1969,0,No,0,0.0,0.0,0.0,0,0,0,0,0,0,0.0,0.0,0.0,0.0,0.0,0.0
<a href=/player/nashc101>nashc101</a>,Cotton Nash,Chicago White Sox,WSOX,1,1,1,2,1969,1970,1,No,0,0.07,0.19,0.12,10,64,54,15,26,11,0.0,273.0,273.0,0.0,0.0,0.0
<a href=/player/nashj101>nashj101</a>,Jim Nash,Oakland Athletics,ATLTCS,4,7,5,12,1969,1972,3,No,0,1.75,3.32,1.57,627,294,-333,1441,825,-616,1443.0,159.0,-1284.0,54250.0,0.0,-54250.0
<a href=/player/nashj101>nashj101</a>,Jim Nash,Atlanta Braves,BRAVES,2,3,3,6,1972,1973,1,No,0,3.67,-1.47,-5.14,307,93,-214,995,16,-979,168.0,108.0,-60.0,0.0,0.0,0.0
<a href=/player/nastp101>nastp101</a>,Phil Nastu,San Francisco Giants,GIANTS,5,7,8,15,1980,1986,6,No,0,-0.94,5.74,6.68,341,455,114,825,812,-13,372.0,2489.0,2117.0,552000.0,0.0,-552000.0
<a href=/player/nathj001>nathj001</a>,Joe Nathan,San Francisco Giants,GIANTS,1,3,2,5,2003,2004,1,No,0,27.51,0.25,-27.26,760,131,-629,32,510,478,4915.0,0.0,-4915.0,300000.0,0.0,-300000.0
<a href=/player/natij001>natij001</a>,Joey Nation,Atlanta Braves,BRAVES,3,6,5,11,1999,2009,10,No,2,-4.19,8.84,13.03,73,1044,971,54,2148,2094,486.0,1194.0,708.0,0.0,0.0,0.0
<a href=/player/naugp001>naugp001</a>,Packy Naughton,Cincinnati Reds,REDS,1,2,1,3,2020,2020,0,No,0,-0.21,-0.49,-0.28,9,20,11,1,55,54,68.0,0.0,-68.0,0.0,0.0,0.0
<a href=/player/nauld001>nauld001</a>,Dan Naulty,Minnesota Twins,TWINS,1,1,1,2,1998,1998,0,No,0,0.58,0.0,-0.58,36,0,-36,0,0,0,148.0,0.0,-148.0,185000.0,0.0,-185000.0
<a href=/player/nauld001>nauld001</a>,Dan Naulty,New York Yankees,YANKS,1,1,1,2,1999,1999,0,No,0,0.0,0.0,0.0,0,0,0,0,0,0,0.0,0.0,0.0,300000.0,0.0,-300000.0
<a href=/player/navad001>navad001</a>,Dioner Navarro,New York Yankees,YANKS,7,16,12,28,2005,2014,9,Yes,2,13.28,19.25,5.97,1549,974,-575,2912,2867,-45,5079.0,1808.0,-3271.0,1556425.0,0.0,-1556425.0
<a href=/player/navad001>navad001</a>,Dioner Navarro,Arizona Diamondbacks,DBACKS,2,6,2,8,2005,2009,4,No,0,0.95,0.24,-0.71,303,273,-30,1104,1118,14,0.0,0.0,0.0,10213898.0,0.0,-10213898.0
<a href=/player/navad001>navad001</a>,Dioner Navarro,Los Angeles Dodgers,DOGRS,1,3,3,6,2006,2007,1,No,0,1.99,-0.07,-2.06,586,130,-456,1881,113,-1768,426.0,593.0,167.0,682000.0,0.0,-682000.0
<a href=/player/navad001>navad001</a>,Dioner Navarro,Chicago White Sox,WSOX,1,1,1,2,2016,2016,0,Yes,0,-0.17,0.0,0.17,16,0,-16,36,0,-36,0.0,0.0,0.0,0.0,0.0,0.0
<a href=/player/navad002>navad002</a>,Daniel Nava,Anaheim Angels,ANGELS,1,1,1,2,2016,2016,0,No,0,-0.12,0.0,0.12,9,0,-9,12,0,-12,0.0,0.0,0.0,0.0,0.0,0.0
<a href=/player/navaj001>navaj001</a>,Jaime Navarro,Chicago White Sox,WSOX,1,2,2,4,2000,2004,4,No,0,-2.6,18.62,21.22,55,696,641,47,2756,2709,437.0,354.0,-83.0,0.0,0.0,0.0
<a href=/player/navaj101>navaj101</a>,Julio Navarro,Los Angeles Angels,ANGELS,2,2,2,4,1964,1966,2,No,0,-1.19,2.44,3.63,140,359,219,90,1087,997,228.0,95.0,-133.0,28500.0,0.0,-28500.0
<a href=/player/navaj101>navaj101</a>,Julio Navarro,Detroit Tigers,TIGRS,1,2,2,4,1966,1970,4,No,0,1.01,15.29,14.28,93,323,230,284,412,128,0.0,2887.0,2887.0,0.0,0.0,0.0
<a href=/player/navaj101>navaj101</a>,Julio Navarro,Boston Red Sox,RSOX,1,2,2,4,1966,1967,1,No,0,-0.2,0.0,0.2,68,0,-68,16,0,-16,197.0,0.0,-197.0,0.0,0.0,0.0
<a href=/player/navar001>navar001</a>,Rey Navarro,Arizona Diamondbacks,DBACKS,1,1,1,2,2010,2011,1,No,0,0.0,0.06,0.06,0,44,44,0,0,0,0.0,60.0,60.0,0.0,0.0,0.0
<a href=/player/navay001>navay001</a>,Yamaico Navarro,Boston Red Sox,RSOX,2,3,3,6,2011,2012,1,No,0,0.07,2.71,2.64,6,174,168,26,653,627,0.0,0.0,0.0,1200000.0,0.0,-1200000.0
<a href=/player/navay001>navay001</a>,Yamaico Navarro,Pittsburgh Pirates,PIRATS,1,1,1,2,2012,2012,0,No,0,0.15,0.0,-0.15,8,0,-8,31,0,-31,0.0,0.0,0.0,483000.0,0.0,-483000.0
<a href=/player/navay001>navay001</a>,Yamaico Navarro,Kansas City Royals,ROYALS,2,2,3,5,2011,2016,5,Yes,0,-0.55,-0.58,-0.03,40,13,-27,56,0,-56,31.0,38.0,7.0,0.0,0.0,0.0
<a href=/player/nayle101>nayle101</a>,Earl Naylor,Philadelphia Phillies,PHILS,3,4,6,10,1943,1946,3,No,0,9.8,8.3,-1.5,880,637,-243,3396,2656,-740,0.0,0.0,0.0,0.0,0.0,0.0
<a href=/player/naylj001>naylj001</a>,Josh Naylor,Miami Marlins,MARLNS,3,8,6,14,2016,2019,3,No,0,12.29,-0.08,-12.37,540,354,-186,600,126,-474,2851.0,1392.0,-1459.0,550000.0,0.0,-550000.0
<a href=/player/naylj001>naylj001</a>,Josh Naylor,San Diego Padres,PADRS,2,7,4,11,2020,2021,1,Yes,0,3.34,0.62,-2.72,311,5,-306,892,4,-888,493.0,57.0,-436.0,3000000.0,0.0,-3000000.0
<a href=/player/naylr101>naylr101</a>,Rollie Naylor,Philadelphia Athletics,ATLTCS,1,3,1,4,1924,1927,3,No,0,0.0,4.07,4.07,0,425,425,0,1818,1818,0.0,0.0,0.0,12000.0,0.0,-12000.0
<a href=/player/neagd001>neagd001</a>,Denny Neagle,Minnesota Twins,TWINS,3,4,5,9,1992,2007,15,No,4,7.13,32.16,25.03,551,1268,717,733,4894,4161,2091.0,723.0,-1368.0,0.0,0.0,0.0
<a href=/player/neagd001>neagd001</a>,Denny Neagle,Pittsburgh Pirates,PIRATS,2,3,5,8,1996,2006,10,No,0,29.65,7.0,-22.65,505,530,25,727,585,-142,4656.0,3240.0,-1416.0,7350000.0,0.0,-7350000.0
<a href=/player/neagd001>neagd001</a>,Denny Neagle,Atlanta Braves,BRAVES,9,20,18,38,1998,2015,17,No,3,84.77,19.25,-65.52,4465,2071,-2394,14759,4939,-9820,5099.0,1624.0,-3475.0,29165000.0,0.0,-29165000.0
<a href=/player/neagd001>neagd001</a>,Denny Neagle,Cincinnati Reds,REDS,3,5,7,12,2000,2013,13,No,0,-0.66,18.6,19.26,193,851,658,524,1522,998,274.0,5192.0,4918.0,4750000.0,0.0,-4750000.0
<a href=/player/nealb001>nealb001</a>,Blaine Neal,Florida Marlins,MARLNS,1,1,1,2,2004,2005,1,No,0,0.26,-0.35,-0.61,79,60,-19,0,3,3,126.0,113.0,-13.0,0.0,0.0,0.0
<a href=/player/nealb001>nealb001</a>,Blaine Neal,San Diego Padres,PADRS,2,2,2,4,2005,2007,2,No,0,0.0,-0.35,-0.35,20,119,99,18,28,10,24.0,165.0,141.0,375000.0,0.0,-375000.0
<a href=/player/nealc101>nealc101</a>,Charlie Neal,Los Angeles Dodgers,DOGRS,1,2,2,4,1961,1964,3,No,0,2.26,0.33,-1.93,344,161,-183,877,245,-632,336.0,0.0,-336.0,26000.0,0.0,-26000.0
<a href=/player/nealc101>nealc101</a>,Charlie Neal,New York Mets,METS,3,5,4,9,1963,1970,7,No,0,0.13,2.94,2.81,256,564,308,368,1104,736,516.0,1427.0,911.0,0.0,0.0,0.0
<a href=/player/nealg101>nealg101</a>,Greasy Neale,Cincinnati Reds,REDS,1,2,1,3,1920,1920,0,No,0,12.54,0.0,-12.54,460,0,-460,635,0,-635,4385.0,0.0,-4385.0,11000.0,0.0,-11000.0
<a href=/player/nealt001>nealt001</a>,Thomas Neal,San Francisco Giants,GIANTS,1,1,1,2,2011,2011,0,No,0,-0.32,-0.03,0.29,9,39,30,24,133,109,0.0,0.0,0.0,0.0,0.0,0.0
<a href=/player/nealz001>nealz001</a>,Zach Neal,Los Angeles Dodgers,DOGRS,1,2,1,3,2018,2018,0,No,0,0.0,0.0,0.0,0,0,0,0,0,0,0.0,0.0,0.0,0.0,0.0,0.0
<a href=/player/nealz001>nealz001</a>,Zach Neal,Cincinnati Reds,REDS,1,3,2,5,2018,2018,0,Yes,0,1.09,0.0,-1.09,176,0,-176,2,0,-2,299.0,0.0,-299.0,0.0,0.0,0.0
<a href=/player/needt101>needt101</a>,Tom Needham,Boston Braves,BRAVES,2,4,6,10,1907,1911,4,No,0,19.52,11.83,-7.69,821,855,34,3252,2714,-538,0.0,1733.0,1733.0,0.0,0.0,0.0
<a href=/player/needt101>needt101</a>,Tom Needham,StPaul,StPaul,1,1,1,2,1909,1909,0,No,0,0.4,0.0,-0.4,133,0,-133,367,0,-367,0.0,0.0,0.0,0.0,0.0,0.0
<a href=/player/neelt001>neelt001</a>,Troy Neel,Cleveland Indians,INDINS,1,1,1,2,1991,1991,0,No,0,3.73,0.0,-3.73,230,0,-230,861,0,-861,0.0,0.0,0.0,0.0,0.0,0.0
<a href=/player/neemc101>neemc101</a>,Cal Neeman,Chicago Cubs,CUBS,17,29,28,57,1960,1982,22,No,0,71.82,137.22,65.4,4054,6789,2735,10993,16906,5913,10563.0,17980.0,7417.0,552500.0,0.0,-552500.0
<a href=/player/neemc101>neemc101</a>,Cal Neeman,Pittsburgh Pirates,PIRATS,2,3,2,5,1963,1965,2,No,0,0.03,0.41,0.38,287,60,-227,312,157,-155,304.0,0.0,-304.0,0.0,0.0,0.0
<a href=/player/negrk001>negrk001</a>,Kristopher Negron,Boston Red Sox,RSOX,1,1,2,3,2009,2009,0,No,0,1.65,0.3,-1.35,96,44,-52,270,159,-111,0.0,0.0,0.0,0.0,0.0,0.0
<a href=/player/negrk001>negrk001</a>,Kristopher Negron,Seattle Mariners,MARNRS,1,1,1,2,2019,2019,0,No,0,0.14,0.0,-0.14,30,0,-30,57,0,-57,0.0,0.0,0.0,0.0,0.0,0.0
<a href=/player/negrr101>negrr101</a>,Ron Negray,Brooklyn Dodgers,DOGRS,1,1,2,3,1955,1955,0,No,0,1.27,0.0,-1.27,116,0,-116,36,0,-36,415.0,0.0,-415.0,0.0,0.0,0.0
<a href=/player/negrr101>negrr101</a>,Ron Negray,Philadelphia Phillies,PHILS,2,8,4,12,1957,1962,5,No,0,1.07,-3.22,-4.29,707,621,-86,1985,2063,78,115.0,0.0,-115.0,9000.0,0.0,-9000.0
<a href=/player/nehfa101>nehfa101</a>,Art Nehf,Boston Braves,BRAVES,10,19,22,41,1919,1938,19,No,0,31.15,38.82,7.67,2310,4271,1961,5947,14932,8985,8433.0,4626.0,-3807.0,58026.0,0.0,-58026.0
<a href=/player/neibg101>neibg101</a>,Gary Neibauer,Atlanta Braves,BRAVES,2,3,3,6,1972,1973,1,No,0,3.67,-1.47,-5.14,307,93,-214,995,16,-979,168.0,108.0,-60.0,0.0,0.0,0.0
<a href=/player/neidj001>neidj001</a>,Jim Neidlinger,Pittsburgh Pirates,PIRATS,1,1,1,2,1988,1989,1,No,0,1.19,0.0,-1.19,24,0,-24,27,0,-27,222.0,0.0,-222.0,0.0,0.0,0.0
<a href=/player/neidn001>neidn001</a>,Nick Neidert,Seattle Mariners,MARNRS,1,3,2,5,2017,2020,3,No,0,-0.89,1.81,2.7,38,291,253,23,1091,1068,267.0,0.0,-267.0,0.0,0.0,0.0
<a href=/player/neilt101>neilt101</a>,Tommy Neill,Boston Braves,BRAVES,1,3,1,4,1948,1952,4,No,0,0.0,-0.21,-0.21,0,104,104,0,35,35,0.0,376.0,376.0,0.0,0.0,0.0
<a href=/player/neisb101>neisb101</a>,Bernie Neis,Brooklyn Dodgers,DOGRS,4,10,4,14,1925,1934,9,No,0,1.75,8.14,6.39,236,915,679,602,3320,2718,677.0,0.0,-677.0,30000.0,0.0,-30000.0
<a href=/player/nelsb001>nelsb001</a>,Bry Nelson,Arizona Diamondbacks,DBACKS,1,1,1,2,2001,2001,0,No,0,0.0,0.0,0.0,0,0,0,0,0,0,0.0,0.0,0.0,0.0,0.0,0.0
<a href=/player/nelsd101>nelsd101</a>,Dave Nelson,Cleveland Indians,INDINS,5,8,7,15,1969,1974,5,No,0,5.0,-0.41,-5.41,1218,311,-907,2882,450,-2432,1036.0,482.0,-554.0,104000.0,0.0,-104000.0
<a href=/player/nelsd101>nelsd101</a>,Dave Nelson,Texas Rangers,RNGRS,1,1,1,2,1975,1977,2,No,0,-0.07,3.4,3.47,105,60,-45,226,0,-226,0.0,955.0,955.0,0.0,0.0,0.0
<a href=/player/nelsg001>nelsg001</a>,Gene Nelson,Texas Rangers,RNGRS,1,4,4,8,1979,1985,6,No,0,12.8,8.35,-4.45,488,521,33,1323,2076,753,918.0,0.0,-918.0,475000.0,0.0,-475000.0
<a href=/player/nelsg001>nelsg001</a>,Gene Nelson,New York Yankees,YANKS,3,6,4,10,1982,1987,5,No,0,15.14,5.21,-9.93,593,176,-417,734,188,-546,3682.0,1574.0,-2108.0,62500.0,0.0,-62500.0
<a href=/player/nelsg001>nelsg001</a>,Gene Nelson,Seattle Mariners,MARNRS,1,2,1,3,1984,1985,1,No,0,2.78,0.75,-2.03,163,36,-127,1,0,-1,1149.0,444.0,-705.0,0.0,0.0,0.0
<a href=/player/nelsg001>nelsg001</a>,Gene Nelson,Chicago White Sox,WSOX,1,2,1,3,1986,1989,3,No,0,3.34,0.37,-2.97,291,194,-97,0,702,702,1471.0,0.0,-1471.0,240000.0,0.0,-240000.0
<a href=/player/nelsj001>nelsj001</a>,Jeff Nelson,Seattle Mariners,MARNRS,3,7,5,12,1995,1999,4,No,0,28.82,-1.18,-30.0,1743,533,-1210,4473,1676,-2797,3491.0,1076.0,-2415.0,2835000.0,0.0,-2835000.0
<a href=/player/nelsj001>nelsj001</a>,Jeff Nelson,Seattle Mariners,MARNRS,1,1,1,2,2003,2003,0,No,0,0.18,0.32,0.14,24,15,-9,0,0,0,53.0,43.0,-10.0,3983333.0,0.0,-3983333.0
<a href=/player/nelsl101>nelsl101</a>,Lynn Nelson,Memphis,Memphis,1,1,4,5,1937,1939,2,No,0,6.28,0.0,-6.28,278,0,-278,321,0,-321,1514.0,0.0,-1514.0,0.0,0.0,0.0
<a href=/player/nelsm101>nelsm101</a>,Mel Nelson,St. Louis Cardinals,CARDS,1,2,1,3,1969,1969,0,No,0,0.0,0.0,0.0,0,0,0,0,0,0,0.0,0.0,0.0,0.0,0.0,0.0
<a href=/player/nelsn001>nelsn001</a>,Nick Nelson,New York Yankees,YANKS,1,2,2,4,2021,2021,0,Yes,0,0.0,0.0,0.0,0,0,0,0,0,0,0.0,0.0,0.0,0.0,0.0,0.0
<a href=/player/nelsr001>nelsr001</a>,Ricky Nelson,Seattle Mariners,MARNRS,1,1,1,2,1986,1986,0,No,0,0.0,0.0,0.0,0,0,0,0,0,0,0.0,0.0,0.0,0.0,0.0,0.0
<a href=/player/nelsr001>nelsr001</a>,Ricky Nelson,New York Mets,METS,1,1,1,2,1987,1987,0,No,0,0.0,-0.25,-0.25,0,10,10,0,5,5,0.0,65.0,65.0,0.0,0.0,0.0
<a href=/player/nelsr002>nelsr002</a>,Rob Nelson,Oakland Athletics,ATLTCS,2,3,3,6,1987,1992,5,No,2,0.04,3.46,3.42,202,69,-133,145,0,-145,296.0,1204.0,908.0,73133.0,0.0,-73133.0
<a href=/player/nelsr101>nelsr101</a>,Roger Nelson,Chicago White Sox,WSOX,6,9,10,19,1967,1977,10,No,0,29.24,13.29,-15.95,1920,1924,4,6795,7037,242,306.0,62.0,-244.0,134800.0,0.0,-134800.0
<a href=/player/nelsr101>nelsr101</a>,Roger Nelson,Kansas City Royals,ROYALS,2,3,3,6,1972,1986,14,No,0,0.89,27.33,26.44,85,1835,1750,116,7325,7209,420.0,179.0,-241.0,31000.0,0.0,-31000.0
<a href=/player/nelsr103>nelsr103</a>,Rocky Nelson,St. Louis Cardinals,CARDS,1,2,1,3,1951,1952,1,No,0,2.13,0.47,-1.66,381,51,-330,862,202,-660,20.0,0.0,-20.0,0.0,0.0,0.0
<a href=/player/nelsr103>nelsr103</a>,Rocky Nelson,Chicago White Sox,WSOX,31,58,57,115,1951,1971,20,No,0,64.42,124.88,60.46,7701,8470,769,20774,20512,-262,7158.0,13944.0,6786.0,248750.0,0.0,-248750.0
<a href=/player/nelsr103>nelsr103</a>,Rocky Nelson,Brooklyn Dodgers,DOGRS,1,1,2,3,1953,1953,0,No,0,-0.16,0.0,0.16,4,0,-4,4,0,-4,0.0,0.0,0.0,0.0,0.0,0.0
<a href=/player/nelsr103>nelsr103</a>,Rocky Nelson,St. Louis Cardinals,CARDS,1,3,1,4,1957,1960,3,No,0,0.0,-0.55,-0.55,0,36,36,0,11,11,0.0,110.0,110.0,0.0,0.0,0.0
<a href=/player/nelst101>nelst101</a>,Tommy Nelson,Milwaukee,Milwaukee,1,2,2,4,1944,1945,1,No,0,2.0,0.0,-2.0,395,0,-395,1542,0,-1542,0.0,0.0,0.0,0.0,0.0,0.0
<a href=/player/nen-d101>nen-d101</a>,Dick Nen,Los Angeles Dodgers,DOGRS,4,12,9,21,1964,1984,20,No,0,57.0,60.48,3.48,4290,2463,-1827,14544,7259,-7285,4034.0,7191.0,3157.0,163000.0,0.0,-163000.0
<a href=/player/nen-r001>nen-r001</a>,Robb Nen,Texas Rangers,RNGRS,1,2,1,3,1993,1994,1,No,0,2.51,0.73,-1.78,607,75,-532,25,0,-25,1163.0,273.0,-890.0,109000.0,0.0,-109000.0
<a href=/player/nen-r001>nen-r001</a>,Robb Nen,Florida Marlins,MARLNS,1,1,3,4,1997,1997,0,No,0,10.35,0.0,-10.35,712,0,-712,6,0,-6,1135.0,0.0,-1135.0,3080000.0,0.0,-3080000.0
<a href=/player/neshp001>neshp001</a>,Pat Neshek,Houston Astros,ASTROS,1,1,1,2,2016,2016,0,No,0,2.83,0.0,-2.83,183,0,-183,0,0,0,248.0,0.0,-248.0,6500000.0,0.0,-6500000.0
<a href=/player/neshp001>neshp001</a>,Pat Neshek,Philadelphia Phillies,PHILS,1,1,3,4,2017,2017,0,Yes,0,0.69,0.0,-0.69,53,0,-53,0,0,0,66.0,0.0,-66.0,6500000.0,0.0,-6500000.0
<a href=/player/nessj101>nessj101</a>,Jack Ness,Detroit Tigers,TIGRS,1,2,1,3,1911,1915,4,No,0,0.0,0.64,0.64,0,95,95,0,385,385,0.0,0.0,0.0,0.0,0.0,0.0
<a href=/player/nettg001>nettg001</a>,Graig Nettles,Minnesota Twins,TWINS,2,5,4,9,1969,1971,2,No,0,19.42,3.86,-15.56,887,264,-623,3069,67,-3002,587.0,852.0,265.0,120000.0,0.0,-120000.0
<a href=/player/nettg001>nettg001</a>,Graig Nettles,Cleveland Indians,INDINS,6,9,10,19,1972,1984,12,No,0,43.46,8.37,-35.09,2118,2287,169,7743,7713,-30,0.0,317.0,317.0,82750.0,0.0,-82750.0
<a href=/player/nettg001>nettg001</a>,Graig Nettles,New York Yankees,YANKS,2,2,3,5,1984,1987,3,No,0,5.7,5.8,0.1,423,111,-312,1418,0,-1418,305.0,1936.0,1631.0,175000.0,0.0,-175000.0
<a href=/player/nettj101>nettj101</a>,Jim Nettles,Minnesota Twins,TWINS,1,1,1,2,1973,1973,0,No,0,0.28,0.0,-0.28,43,0,-43,159,0,-159,0.0,0.0,0.0,0.0,0.0,0.0
<a href=/player/nettm101>nettm101</a>,Morris Nettles,California Angels,ANGELS,2,3,4,7,1975,1977,2,No,0,-0.12,-0.47,-0.35,328,122,-206,1247,392,-855,0.0,18.0,18.0,0.0,0.0,0.0
<a href=/player/neu-m001>neu-m001</a>,Michael Neu,Oakland Athletics,ATLTCS,6,10,8,18,2003,2017,14,Yes,0,-1.4,14.82,16.22,291,1017,726,344,2748,2404,719.0,1374.0,655.0,18058194.0,0.0,-18058194.0
<a href=/player/neumd101>neumd101</a>,Dan Neumeier,Chicago White Sox,WSOX,1,1,1,2,1973,1975,2,No,0,0.0,0.0,0.0,0,0,0,0,0,0,0.0,0.0,0.0,0.0,0.0,0.0
<a href=/player/neuss001>neuss001</a>,Sheldon Neuse,Washington Nationals,NATEX,2,4,3,7,2017,2020,3,Yes,0,5.92,4.82,-1.1,246,410,164,62,3,-59,883.0,620.0,-263.0,8230366.0,0.0,-8230366.0
<a href=/player/neuss001>neuss001</a>,Sheldon Neuse,Oakland Athletics,ATLTCS,1,2,2,4,2021,2021,0,Yes,0,-0.48,-0.38,0.1,33,13,-20,66,0,-66,0.0,27.0,27.0,0.0,0.0,0.0
<a href=/player/nevee102>nevee102</a>,Ernie Nevel,New York Yankees,YANKS,1,5,1,6,1952,1955,3,No,0,5.35,0.52,-4.83,390,26,-364,1419,10,-1409,46.0,107.0,61.0,0.0,0.0,0.0
<a href=/player/nevee102>nevee102</a>,Ernie Nevel,Detroit Tigers,TIGRS,5,14,10,24,1954,1961,7,No,0,12.9,0.88,-12.02,615,749,134,406,2092,1686,3228.0,40.0,-3188.0,13200.0,0.0,-13200.0
<a href=/player/nevip001>nevip001</a>,Phil Nevin,Houston Astros,ASTROS,1,1,1,2,1995,1995,0,No,0,0.07,0.49,0.42,160,42,-118,518,0,-518,0.0,63.0,63.0,109000.0,0.0,-109000.0
<a href=/player/nevip001>nevip001</a>,Phil Nevin,Detroit Tigers,TIGRS,1,2,1,3,1997,1997,0,No,0,-0.94,0.0,0.94,337,0,-337,1117,0,-1117,0.0,0.0,0.0,728000.0,0.0,-728000.0
<a href=/player/nevip001>nevip001</a>,Phil Nevin,Anaheim Angels,ANGELS,1,2,2,4,1999,1999,0,No,0,17.78,-1.12,-18.9,806,87,-719,3297,269,-3028,0.0,0.0,0.0,0.0,0.0,0.0
<a href=/player/nevip001>nevip001</a>,Phil Nevin,San Diego Padres,PADRS,2,2,3,5,2005,2006,1,No,1,-0.87,-0.78,0.09,75,68,-7,307,66,-241,0.0,547.0,547.0,9625000.0,0.0,-9625000.0
<a href=/player/nevip001>nevip001</a>,Phil Nevin,Texas Rangers,RNGRS,1,2,1,3,2006,2007,1,No,0,0.09,-0.23,-0.32,67,136,69,197,284,87,0.0,0.0,0.0,10472409.0,0.0,-10472409.0
<a href=/player/nevip001>nevip001</a>,Phil Nevin,Chicago Cubs,CUBS,1,2,1,3,2006,2006,0,No,0,-0.1,0.0,0.1,16,0,-16,54,0,-54,0.0,0.0,0.0,0.0,0.0,0.0
<a href=/player/nevit001>nevit001</a>,Tyler Nevin,Colorado Rockies,ROCKS,2,4,3,7,2020,2021,1,Yes,0,0.45,0.91,0.46,52,72,20,18,0,-18,64.0,117.0,53.0,4050000.0,0.0,-4050000.0
<a href=/player/newcd101>newcd101</a>,Don Newcombe,Los Angeles Dodgers,DOGRS,1,1,4,5,1958,1961,3,No,0,9.64,0.85,-8.79,190,265,75,233,151,-82,1314.0,590.0,-724.0,30000.0,0.0,-30000.0
<a href=/player/newcs001>newcs001</a>,Sean Newcomb,Anaheim Angels,ANGELS,1,4,2,6,2015,2020,5,No,0,2.92,20.49,17.57,366,607,241,466,2409,1943,1135.0,0.0,-1135.0,8500000.0,0.0,-8500000.0
<a href=/player/newfm001>newfm001</a>,Marc Newfield,Seattle Mariners,MARNRS,1,2,2,4,1995,1995,0,No,0,0.73,0.19,-0.54,185,12,-173,270,0,-270,132.0,189.0,57.0,224000.0,0.0,-224000.0
<a href=/player/newfm001>newfm001</a>,Marc Newfield,San Diego Padres,PADRS,5,11,11,22,1996,2006,10,No,1,7.75,31.03,23.28,1053,1823,770,3065,7183,4118,514.0,4.0,-510.0,9096680.0,0.0,-9096680.0
<a href=/player/newhd001>newhd001</a>,David Newhan,Oakland Athletics,ATLTCS,3,5,4,9,1997,2006,9,No,0,-1.08,-1.24,-0.16,199,140,-59,175,236,61,192.0,0.0,-192.0,392000.0,0.0,-392000.0
<a href=/player/newhd001>newhd001</a>,David Newhan,San Diego Padres,PADRS,1,1,1,2,2000,2000,0,No,0,0.11,-0.07,-0.18,17,45,28,27,189,162,0.0,0.0,0.0,203000.0,0.0,-203000.0
<a href=/player/newkf101>newkf101</a>,Floyd Newkirk,New York Yankees,YANKS,1,5,1,6,1934,1934,0,No,0,0.0,0.0,0.0,0,0,0,0,0,0,0.0,0.0,0.0,2000.0,0.0,-2000.0
<a href=/player/newma001>newma001</a>,Al Newman,Montreal Expos,NATEX,2,3,3,6,1983,1986,3,No,0,0.47,0.58,0.11,75,208,133,0,9,9,360.0,362.0,2.0,513500.0,0.0,-513500.0
<a href=/player/newma001>newma001</a>,Al Newman,San Diego Padres,PADRS,1,1,1,2,1984,1985,1,No,0,-0.67,0.44,1.11,120,38,-82,244,8,-236,0.0,110.0,110.0,0.0,0.0,0.0
<a href=/player/newma001>newma001</a>,Al Newman,Montreal Expos,NATEX,1,1,1,2,1987,1987,0,No,0,2.06,0.0,-2.06,618,0,-618,1876,0,-1876,0.0,0.0,0.0,0.0,0.0,0.0
<a href=/player/newma002>newma002</a>,Alan Newman,Minnesota Twins,TWINS,1,2,1,3,1993,1993,0,No,0,0.0,0.0,0.0,0,0,0,0,0,0,0.0,0.0,0.0,0.0,0.0,0.0
<a href=/player/newmj001>newmj001</a>,Jeff Newman,Oakland Athletics,ATLTCS,2,3,4,7,1982,1991,9,No,0,1.92,23.98,22.06,609,1229,620,2373,4812,2439,0.0,48.0,48.0,0.0,0.0,0.0
<a href=/player/newmr101>newmr101</a>,Ray Newman,Chicago Cubs,CUBS,1,1,2,3,1972,1972,0,No,0,0.87,0.0,-0.87,19,0,-19,1,0,-1,76.0,0.0,-76.0,0.0,0.0,0.0
<a href=/player/newmr101>newmr101</a>,Ray Newman,Milwaukee Brewers,BREWRS,1,1,1,2,1973,1974,1,No,0,0.0,0.0,0.0,0,0,0,0,0,0,0.0,0.0,0.0,0.0,0.0,0.0
<a href=/player/newsb101>newsb101</a>,Bobo Newsom,Washington Senators,TWINS,3,4,5,9,1937,1942,5,No,0,10.77,13.4,2.63,718,1031,313,2678,3529,851,623.0,1269.0,646.0,39500.0,0.0,-39500.0
<a href=/player/newsb101>newsb101</a>,Bobo Newsom,Boston Red Sox,RSOX,1,3,1,4,1937,1940,3,No,0,5.49,2.22,-3.27,408,291,-117,1388,1330,-58,1283.0,0.0,-1283.0,4000.0,0.0,-4000.0
<a href=/player/newsb101>newsb101</a>,Bobo Newsom,St.Louis Browns,ORLS,6,10,14,24,1939,1952,13,No,0,23.39,27.61,4.22,1164,2723,1559,2963,7190,4227,3417.0,6493.0,3076.0,67500.0,0.0,-67500.0
<a href=/player/newsb101>newsb101</a>,Bobo Newsom,Brooklyn Dodgers,DOGRS,2,4,3,7,1943,1946,3,No,0,-1.79,7.1,8.89,24,273,249,16,997,981,162.0,207.0,45.0,15000.0,0.0,-15000.0
<a href=/player/newsb101>newsb101</a>,Bobo Newsom,Washington Senators,TWINS,2,2,2,4,1943,1947,4,No,0,7.32,4.34,-2.98,242,210,-32,242,289,47,2049.0,1581.0,-468.0,15000.0,0.0,-15000.0
<a href=/player/newss101>newss101</a>,Skeeter Newsome,Philadelphia Phillies,PHILS,1,1,2,3,1940,1940,0,No,0,4.64,0.0,-4.64,497,0,-497,1845,0,-1845,0.0,0.0,0.0,0.0,0.0,0.0
<a href=/player/newsw001>newsw001</a>,Warren Newson,San Diego Padres,PADRS,2,4,3,7,1991,1994,3,No,0,4.76,-1.77,-6.53,685,201,-484,2072,489,-1583,0.0,199.0,199.0,130000.0,0.0,-130000.0
<a href=/player/newsw001>newsw001</a>,Warren Newson,Chicago White Sox,WSOX,1,1,1,2,1995,1997,2,No,0,0.36,0.71,0.35,33,38,5,88,0,-88,0.0,133.0,133.0,200000.0,0.0,-200000.0
<a href=/player/niarg101>niarg101</a>,Gus Niarhos,Chicago White Sox,WSOX,2,6,4,10,1951,1963,12,No,0,1.43,25.02,23.59,363,1422,1059,910,5079,4169,614.0,0.0,-614.0,0.0,0.0,0.0
<a href=/player/niarg101>niarg101</a>,Gus Niarhos,St.Louis Browns,ORLS,3,5,5,10,1951,1956,5,No,0,0.5,2.1,1.6,348,405,57,823,914,91,0.0,256.0,256.0,0.0,0.0,0.0
<a href=/player/nicaj001>nicaj001</a>,Juan Nicasio,Colorado Rockies,ROCKS,1,1,1,2,2014,2019,5,No,0,0.28,-1.35,-1.63,105,76,-29,1,155,154,175.0,0.0,-175.0,2025000.0,0.0,-2025000.0
<a href=/player/nicaj001>nicaj001</a>,Juan Nicasio,Philadelphia Phillies,PHILS,1,1,1,2,2017,2017,0,Yes,0,0.44,0.0,-0.44,18,0,-18,1,0,-1,33.0,0.0,-33.0,0.0,0.0,0.0
<a href=/player/nicaj001>nicaj001</a>,Juan Nicasio,Seattle Mariners,MARNRS,3,7,5,12,2018,2019,1,Yes,0,12.9,2.05,-10.85,683,65,-618,2542,289,-2253,142.0,0.0,-142.0,17350000.0,0.0,-17350000.0
<a href=/player/nichb001>nichb001</a>,Brett Nicholas,Texas Rangers,RNGRS,2,3,3,6,2018,2020,2,No,0,2.79,0.96,-1.83,113,23,-90,120,0,-120,209.0,73.0,-136.0,1400000.0,0.0,-1400000.0
<a href=/player/nichb101>nichb101</a>,Bill Nicholson,Chicago Cubs,CUBS,5,9,8,17,1948,1958,10,No,0,14.64,25.44,10.8,1431,1747,316,4282,6565,2283,130.0,197.0,67.0,0.0,0.0,0.0
<a href=/player/nichb101>nichb101</a>,Bill Nicholson,Philadelphia Athletics,ATLTCS,2,3,2,5,1938,1944,6,No,0,0.0,1.46,1.46,0,597,597,0,2016,2016,0.0,0.0,0.0,6000.0,0.0,-6000.0
<a href=/player/nichc001>nichc001</a>,Carl Nichols,Baltimore Orioles,ORLS,1,1,2,3,1989,1991,2,No,0,-0.34,0.47,0.81,60,66,6,130,0,-130,0.0,1060.0,1060.0,0.0,0.0,0.0
<a href=/player/nichd101>nichd101</a>,Dave Nicholson,Baltimore Orioles,ORLS,4,10,7,17,1963,1973,10,No,0,64.06,37.52,-26.54,3307,1677,-1630,9685,6745,-2940,2176.0,306.0,-1870.0,108500.0,0.0,-108500.0
<a href=/player/nichd101>nichd101</a>,Dave Nicholson,Chicago White Sox,WSOX,1,2,3,5,1965,1967,2,No,0,2.05,-0.33,-2.38,164,74,-90,481,40,-441,0.0,379.0,379.0,13000.0,0.0,-13000.0
<a href=/player/nichd101>nichd101</a>,Dave Nicholson,Houston Astros,ASTROS,4,6,8,14,1966,1973,7,No,0,0.01,-1.36,-1.37,310,801,491,266,544,278,544.0,2019.0,1475.0,57500.0,0.0,-57500.0
<a href=/player/nichd102>nichd102</a>,Dolan Nichols,Cleveland Indians,INDINS,1,1,1,2,1957,1957,0,No,0,-0.48,-0.32,0.16,48,10,-38,5,1,-4,124.0,21.0,-103.0,0.0,0.0,0.0
<a href=/player/nichf101>nichf101</a>,Fred Nicholson,Pittsburgh Pirates,PIRATS,5,10,8,18,1921,1932,11,No,0,20.59,54.57,33.98,2344,1948,-396,9152,7061,-2091,1307.0,3847.0,2540.0,22300.0,0.0,-22300.0
<a href=/player/nichr001>nichr001</a>,Reid Nichols,Boston Red Sox,RSOX,1,1,1,2,1985,1987,2,No,0,0.29,-0.43,-0.72,125,50,-75,286,2,-284,0.0,330.0,330.0,260000.0,0.0,-260000.0
<a href=/player/nichs101>nichs101</a>,Simon Nicholls,Philadelphia Athletics,ATLTCS,1,1,1,2,1909,1910,1,No,0,0.0,0.0,0.0,3,0,-3,0,0,0,0.0,0.0,0.0,0.0,0.0,0.0
<a href=/player/nickd001>nickd001</a>,Doug Nickle,Anaheim Angels,ANGELS,1,1,1,2,1998,1998,0,No,0,-0.13,0.36,0.49,19,19,0,1,72,71,27.0,0.0,-27.0,0.0,0.0,0.0
<a href=/player/nickd001>nickd001</a>,Doug Nickle,Philadelphia Phillies,PHILS,2,4,5,9,2002,2005,3,No,0,45.06,10.26,-34.8,1293,547,-746,5556,1575,-3981,0.0,264.0,264.0,13200000.0,0.0,-13200000.0
<a href=/player/nickd001>nickd001</a>,Doug Nickle,Anaheim Angels,ANGELS,1,2,3,5,2003,2006,3,No,0,0.32,0.04,-0.28,41,21,-20,2,0,-2,416.0,90.0,-326.0,1425000.0,0.0,-1425000.0
<a href=/player/nickm001>nickm001</a>,Mike Nickeas,Texas Rangers,RNGRS,1,1,1,2,2006,2007,1,No,0,-0.93,0.26,1.19,73,37,-36,191,108,-83,0.0,0.0,0.0,0.0,0.0,0.0
<a href=/player/nickm001>nickm001</a>,Mike Nickeas,New York Mets,METS,5,10,9,19,2012,2021,9,Yes,0,5.89,21.61,15.72,446,1069,623,898,3007,2109,2473.0,2300.0,-173.0,18229800.0,0.0,-18229800.0
<a href=/player/nicog101>nicog101</a>,George Nicol,Pittsburgh Pirates,PIRATS,1,2,1,3,1894,1894,0,No,0,-0.65,0.82,1.47,30,26,-4,117,52,-65,51.0,335.0,284.0,0.0,0.0,0.0
<a href=/player/nicoh101>nicoh101</a>,Hugh Nicol,St.Louis Cardinals,CARDS,1,1,2,3,1886,1898,12,No,0,1.51,1.15,-0.36,432,379,-53,1926,1510,-416,0.0,0.0,0.0,1800.0,0.0,-1800.0
<a href=/player/nicoj001>nicoj001</a>,Justin Nicolino,Toronto Blue Jays,BJAYS,3,15,11,26,2012,2018,6,No,0,24.75,21.38,-3.37,2099,1087,-1012,5739,3162,-2577,4668.0,4579.0,-89.0,8732900.0,0.0,-8732900.0
<a href=/player/nicos001>nicos001</a>,Steve Nicosia,Pittsburgh Pirates,PIRATS,1,1,2,3,1983,1984,1,No,0,0.32,-0.33,-0.65,63,57,-6,181,120,-61,0.0,0.0,0.0,0.0,0.0,0.0
<a href=/player/niedt001>niedt001</a>,Tom Niedenfuer,Los Angeles Dodgers,DOGRS,1,1,2,3,1987,1990,3,No,0,0.79,3.02,2.23,97,473,376,0,1461,1461,334.0,135.0,-199.0,731250.0,0.0,-731250.0
<a href=/player/nieha101>nieha101</a>,Al Niehaus,Chicago Cubs,CUBS,1,3,3,6,1924,1926,2,No,0,29.39,2.01,-27.38,1120,155,-965,4097,410,-3687,1929.0,802.0,-1127.0,13500.0,0.0,-13500.0
<a href=/player/nieha101>nieha101</a>,Al Niehaus,Pittsburgh Pirates,PIRATS,1,1,1,2,1925,1925,0,No,0,0.21,0.98,0.77,51,47,-4,164,21,-143,0.0,172.0,172.0,3600.0,0.0,-3600.0
<a href=/player/nieha101>nieha101</a>,Al Niehaus,Cincinnati Reds,REDS,1,2,1,3,1925,1925,0,No,0,0.0,0.0,0.0,0,0,0,0,0,0,0.0,0.0,0.0,0.0,0.0,0.0
<a href=/player/niehb101>niehb101</a>,Bert Niehoff,Cincinnati Reds,REDS,1,1,1,2,1915,1915,0,No,0,3.34,-0.14,-3.48,408,10,-398,1592,33,-1559,0.0,0.0,0.0,0.0,0.0,0.0
<a href=/player/niehb101>niehb101</a>,Bert Niehoff,Philadelphia Phillies,PHILS,1,2,1,3,1918,1918,0,No,0,-0.43,0.37,0.8,22,46,24,90,41,-49,0.0,338.0,338.0,0.0,0.0,0.0
<a href=/player/niehd101>niehd101</a>,Dick Niehaus,StPaul,StPaul,1,2,1,3,1920,1920,0,No,0,0.73,0.0,-0.73,38,0,-38,11,0,-11,127.0,0.0,-127.0,0.0,0.0,0.0
<a href=/player/niehd101>niehd101</a>,Dick Niehaus,Cleveland Indians,INDINS,1,3,1,4,1920,1922,2,No,0,0.0,4.21,4.21,0,138,138,0,140,140,0.0,1087.0,1087.0,0.0,0.0,0.0
<a href=/player/niekj001>niekj001</a>,Joe Niekro,Chicago Cubs,CUBS,3,6,4,10,1969,1974,5,No,0,4.19,2.65,-1.54,1200,512,-688,1393,950,-443,2550.0,898.0,-1652.0,19000.0,0.0,-19000.0
<a href=/player/niekj001>niekj001</a>,Joe Niekro,San Diego Padres,PADRS,5,6,9,15,1969,1978,9,No,0,9.09,3.38,-5.71,399,1422,1023,375,4203,3828,2914.0,1444.0,-1470.0,35500.0,0.0,-35500.0
<a href=/player/niekj001>niekj001</a>,Joe Niekro,Houston Astros,ASTROS,1,1,3,4,1985,1991,6,No,0,0.05,10.61,10.56,36,363,327,0,398,398,566.0,3306.0,2740.0,825000.0,0.0,-825000.0
<a href=/player/niekj001>niekj001</a>,Joe Niekro,New York Yankees,YANKS,3,5,4,9,1987,1989,2,No,0,5.79,-1.58,-7.37,806,113,-693,2351,144,-2207,918.0,729.0,-189.0,1022000.0,0.0,-1022000.0
<a href=/player/niekp001>niekp001</a>,Phil Niekro,Cleveland Indians,INDINS,1,1,2,3,1987,1987,0,No,0,-0.32,-0.49,-0.17,3,21,18,0,0,0,36.0,119.0,83.0,0.0,0.0,0.0
<a href=/player/nielj001>nielj001</a>,Jerry Nielsen,New York Yankees,YANKS,1,3,1,4,1992,1994,2,No,0,-1.97,3.42,5.39,549,56,-493,1984,0,-1984,509.0,1123.0,614.0,0.0,0.0,0.0
<a href=/player/niels001>niels001</a>,Scott Nielsen,Seattle Mariners,MARNRS,1,2,1,3,1984,1985,1,No,0,0.07,-0.68,-0.75,20,79,59,0,235,235,229.0,0.0,-229.0,0.0,0.0,0.0
<a href=/player/niels001>niels001</a>,Scott Nielsen,New York Yankees,YANKS,3,8,4,12,1987,2001,14,No,1,21.94,19.23,-2.71,1182,1204,22,4014,4655,641,3177.0,66.0,-3111.0,0.0,0.0,0.0
<a href=/player/niels001>niels001</a>,Scott Nielsen,Chicago White Sox,WSOX,3,5,7,12,1987,1997,10,No,0,-1.68,12.63,14.31,132,1505,1373,105,4423,4318,928.0,727.0,-201.0,1340000.0,0.0,-1340000.0
<a href=/player/niels001>niels001</a>,Scott Nielsen,New York Yankees,YANKS,1,1,1,2,1989,1989,0,No,0,0.0,-0.46,-0.46,0,10,10,0,14,14,0.0,0.0,0.0,0.0,0.0,0.0
<a href=/player/niema101>niema101</a>,Al Niemiec,Boston Red Sox,RSOX,7,17,15,32,1936,1956,20,No,0,19.89,33.66,13.77,2712,2773,61,8706,8806,100,4863.0,6247.0,1384.0,147000.0,0.0,-147000.0
<a href=/player/niema101>niema101</a>,Al Niemiec,Boston Red Sox,RSOX,1,4,1,5,1937,1937,0,No,0,0.0,0.0,0.0,0,0,0,0,0,0,0.0,0.0,0.0,3000.0,0.0,-3000.0
<a href=/player/niemb101>niemb101</a>,Bob Nieman,St.Louis Browns,ORLS,29,63,61,124,1952,1994,42,No,3,108.88,170.74,61.86,6500,10285,3785,14305,30002,15697,22658.0,18329.0,-4329.0,980833.0,0.0,-980833.0
<a href=/player/niemb101>niemb101</a>,Bob Nieman,Detroit Tigers,TIGRS,6,11,11,22,1954,1964,10,No,0,2.44,17.09,14.65,689,625,-64,1873,996,-877,460.0,3101.0,2641.0,37500.0,0.0,-37500.0
<a href=/player/niemb101>niemb101</a>,Bob Nieman,Chicago White Sox,WSOX,2,5,3,8,1956,1961,5,No,0,20.82,6.19,-14.63,1000,561,-439,2990,1443,-1547,2136.0,479.0,-1657.0,62000.0,0.0,-62000.0
<a href=/player/niemb101>niemb101</a>,Bob Nieman,Baltimore Orioles,ORLS,1,1,2,3,1959,1960,1,No,0,1.14,-0.1,-1.24,87,1,-86,232,4,-228,0.0,0.0,0.0,0.0,0.0,0.0
<a href=/player/niemb101>niemb101</a>,Bob Nieman,St. Louis Cardinals,CARDS,1,1,3,4,1961,1962,1,No,0,0.7,0.0,-0.7,41,0,-41,74,0,-74,0.0,0.0,0.0,0.0,0.0,0.0
<a href=/player/niemr001>niemr001</a>,Randy Niemann,New York Yankees,YANKS,2,4,2,6,1977,1979,2,No,0,-0.57,3.2,3.77,493,187,-306,951,449,-502,300.0,202.0,-98.0,0.0,0.0,0.0
<a href=/player/niemr001>niemr001</a>,Randy Niemann,Houston Astros,ASTROS,2,4,2,6,1981,1987,6,No,0,18.26,12.31,-5.95,1057,753,-304,4016,2821,-1195,147.0,0.0,-147.0,450000.0,0.0,-450000.0
<a href=/player/niemr001>niemr001</a>,Randy Niemann,Pittsburgh Pirates,PIRATS,1,1,2,3,1983,1983,0,No,0,0.15,0.0,-0.15,5,7,2,0,0,0,16.0,0.0,-16.0,0.0,0.0,0.0
<a href=/player/niemr001>niemr001</a>,Randy Niemann,Chicago White Sox,WSOX,1,1,2,3,1985,1985,0,No,0,0.33,0.0,-0.33,70,0,-70,7,0,-7,121.0,0.0,-121.0,0.0,0.0,0.0
<a href=/player/niesj001>niesj001</a>,Jon Niese,New York Mets,METS,2,3,2,5,2015,2019,4,No,0,0.99,3.46,2.47,82,192,110,182,757,575,330.0,7.0,-323.0,24200000.0,0.0,-24200000.0
<a href=/player/niesj001>niesj001</a>,Jon Niese,Pittsburgh Pirates,PIRATS,1,1,2,3,2016,2017,1,No,0,-0.56,-0.74,-0.18,11,73,62,1,1,0,33.0,99.0,66.0,0.0,0.0,0.0
<a href=/player/niett001>niett001</a>,Tom Nieto,St. Louis Cardinals,CARDS,2,2,2,4,1986,1987,1,No,0,0.8,0.35,-0.45,350,133,-217,991,33,-958,0.0,290.0,290.0,0.0,0.0,0.0
<a href=/player/niett001>niett001</a>,Tom Nieto,Montreal Expos,NATEX,9,14,16,30,1987,1996,9,No,0,5.9,1.65,-4.25,1311,1101,-210,2173,1393,-780,2901.0,1691.0,-1210.0,955000.0,0.0,-955000.0
<a href=/player/niett001>niett001</a>,Tom Nieto,Minnesota Twins,TWINS,1,3,2,5,1988,1989,1,No,0,2.78,0.41,-2.37,304,27,-277,1185,0,-1185,0.0,435.0,435.0,103500.0,0.0,-103500.0
<a href=/player/nievj002>nievj002</a>,Jose Nieves,Chicago Cubs,CUBS,2,2,3,5,2001,2001,0,No,0,0.57,0.08,-0.49,94,30,-64,159,2,-157,161.0,45.0,-116.0,240000.0,0.0,-240000.0
<a href=/player/nievm001>nievm001</a>,Melvin Nieves,Atlanta Braves,BRAVES,1,3,1,4,1993,1997,4,No,0,-0.25,11.08,11.33,189,636,447,337,2705,2368,105.0,0.0,-105.0,0.0,0.0,0.0
<a href=/player/nievm001>nievm001</a>,Melvin Nieves,San Diego Padres,PADRS,2,4,4,8,1996,1998,2,No,0,1.67,-1.26,-2.93,549,225,-324,1460,118,-1342,1084.0,637.0,-447.0,0.0,0.0,0.0
<a href=/player/nievm001>nievm001</a>,Melvin Nieves,Detroit Tigers,TIGRS,7,17,12,29,1997,2002,5,No,1,8.91,7.34,-1.57,2198,844,-1354,4138,2268,-1870,1884.0,1349.0,-535.0,8560000.0,0.0,-8560000.0
<a href=/player/nievw001>nievw001</a>,Wil Nieves,Anaheim Angels,ANGELS,1,1,1,2,2005,2005,0,No,0,-0.56,0.04,0.6,35,3,-32,76,0,-76,0.0,9.0,9.0,0.0,0.0,0.0
<a href=/player/niggj101>niggj101</a>,Johnny Niggeling,St.Louis Browns,ORLS,1,2,3,5,1943,1943,0,No,0,8.73,-0.17,-8.9,267,27,-240,710,82,-628,1415.0,18.0,-1397.0,19000.0,0.0,-19000.0
<a href=/player/nileh101>nileh101</a>,Harry Niles,St.Louis Browns,ORLS,1,3,3,6,1907,1907,0,No,0,6.22,0.0,-6.22,491,0,-491,1891,0,-1891,92.0,0.0,-92.0,0.0,0.0,0.0
<a href=/player/nileh101>nileh101</a>,Harry Niles,New York Yankees,YANKS,2,3,3,6,1908,1911,3,No,0,25.79,7.0,-18.79,1708,396,-1312,6883,1614,-5269,0.0,0.0,0.0,0.0,0.0,0.0
<a href=/player/nillr101>nillr101</a>,Rabbit Nill,Washington Senators,TWINS,1,1,2,3,1907,1907,0,No,0,-0.19,-0.05,0.14,23,39,16,74,151,77,0.0,0.0,0.0,0.0,0.0,0.0
<a href=/player/nippa001>nippa001</a>,Al Nipper,Boston Red Sox,RSOX,2,3,2,5,1987,1992,5,No,0,5.91,6.0,0.09,700,548,-152,106,1578,1472,1775.0,506.0,-1269.0,1675000.0,0.0,-1675000.0
<a href=/player/nippd001>nippd001</a>,Dustin Nippert,Arizona Diamondbacks,DBACKS,1,1,1,2,2008,2008,0,No,0,1.4,0.0,-1.4,80,0,-80,1,0,-1,594.0,0.0,-594.0,0.0,0.0,0.0
<a href=/player/niscr101>niscr101</a>,Ron Nischwitz,Detroit Tigers,TIGRS,1,2,1,3,1962,1965,3,No,0,-0.2,-1.2,-1.0,38,174,136,3,601,598,79.0,0.0,-79.0,0.0,0.0,0.0
<a href=/player/nitkc001>nitkc001</a>,C.J. Nitkowski,Cincinnati Reds,REDS,3,5,4,9,1995,1998,3,No,0,1.13,-0.21,-1.34,524,176,-348,786,483,-303,1638.0,269.0,-1369.0,299000.0,0.0,-299000.0
<a href=/player/nitkc001>nitkc001</a>,C.J. Nitkowski,Detroit Tigers,TIGRS,6,13,15,28,1996,2010,14,No,1,13.89,24.32,10.43,4127,1434,-2693,10052,2196,-7856,4562.0,6757.0,2195.0,11529000.0,0.0,-11529000.0
<a href=/player/nitkc001>nitkc001</a>,C.J. Nitkowski,Houston Astros,ASTROS,1,2,5,7,1999,2001,2,No,0,6.68,0.38,-6.3,481,94,-387,1132,260,-872,710.0,103.0,-607.0,0.0,0.0,0.0
<a href=/player/nitkc001>nitkc001</a>,C.J. Nitkowski,Detroit Tigers,TIGRS,1,2,1,3,2001,2001,0,No,0,0.22,0.0,-0.22,10,0,-10,0,0,0,17.0,0.0,-17.0,1200000.0,0.0,-1200000.0
<a href=/player/nivar001>nivar001</a>,Ramon Nivar,Texas Rangers,RNGRS,1,1,1,2,2005,2005,0,No,0,0.16,-0.55,-0.71,7,7,0,15,0,-15,0.0,38.0,38.0,0.0,0.0,0.0
<a href=/player/nix-l001>nix-l001</a>,Laynce Nix,Texas Rangers,RNGRS,4,10,8,18,2006,2013,7,No,4,5.26,17.27,12.01,930,1182,252,2448,4181,1733,1247.0,588.0,-659.0,7270260.0,0.0,-7270260.0
<a href=/player/nixoa101>nixoa101</a>,Al Nixon,Beaumont,Beaumont,1,1,2,3,1921,1921,0,No,0,-0.51,0.0,0.51,229,0,-229,841,0,-841,0.0,0.0,0.0,0.0,0.0,0.0
<a href=/player/nixod001>nixod001</a>,Donell Nixon,Seattle Mariners,MARNRS,1,1,1,2,1988,1988,0,No,0,1.05,0.23,-0.82,154,39,-115,266,0,-266,0.0,94.0,94.0,0.0,0.0,0.0
<a href=/player/nixoo001>nixoo001</a>,Otis Nixon,New York Yankees,YANKS,3,5,5,10,1984,1985,1,No,0,4.69,0.8,-3.89,612,147,-465,1490,453,-1037,133.0,0.0,-133.0,435000.0,0.0,-435000.0
<a href=/player/nixoo001>nixoo001</a>,Otis Nixon,Montreal Expos,NATEX,1,2,2,4,1991,1993,2,No,0,8.18,0.0,-8.18,462,0,-462,1670,0,-1670,0.0,0.0,0.0,0.0,0.0,0.0
<a href=/player/nixoo001>nixoo001</a>,Otis Nixon,Boston Red Sox,RSOX,4,8,8,16,1994,2002,8,No,0,1.6,9.74,8.14,416,630,214,1358,1420,62,371.0,1801.0,1430.0,6625000.0,0.0,-6625000.0
<a href=/player/nixoo001>nixoo001</a>,Otis Nixon,Toronto Blue Jays,BJAYS,1,1,1,2,1997,1997,0,No,0,0.16,0.0,-0.16,42,0,-42,191,0,-191,0.0,0.0,0.0,2500000.0,0.0,-2500000.0
<a href=/player/nixor101>nixor101</a>,Russ Nixon,Cleveland Indians,INDINS,1,1,2,3,1960,1962,2,No,0,-1.37,0.0,1.37,499,0,-499,1450,0,-1450,0.0,0.0,0.0,0.0,0.0,0.0
<a href=/player/nixor101>nixor101</a>,Russ Nixon,Cleveland Indians,INDINS,1,2,2,4,1960,1960,0,No,0,-2.2,-1.2,1.0,772,87,-685,2350,176,-2174,0.0,122.0,122.0,0.0,0.0,0.0
<a href=/player/nixor101>nixor101</a>,Russ Nixon,Boston Red Sox,RSOX,2,5,3,8,1966,1966,0,No,0,-0.53,-0.7,-0.17,125,80,-45,299,29,-270,0.0,336.0,336.0,18500.0,0.0,-18500.0
<a href=/player/noblr101>noblr101</a>,Ray Noble,Oakland,Oakland,1,3,5,8,1950,1951,1,No,0,-0.44,0.0,0.44,186,0,-186,308,0,-308,172.0,0.0,-172.0,0.0,0.0,0.0
<a href=/player/noblr101>noblr101</a>,Ray Noble,Cincinnati Reds,REDS,1,1,1,2,1955,1955,0,No,0,0.0,0.0,0.0,0,0,0,0,0,0,0.0,0.0,0.0,0.0,0.0,0.0
<a href=/player/noboj001>noboj001</a>,Junior Noboa,Cleveland Indians,INDINS,1,1,1,2,1988,1988,0,No,0,-0.33,0.0,0.33,21,0,-21,16,0,-16,0.0,0.0,0.0,0.0,0.0,0.0
<a href=/player/nocep001>nocep001</a>,Paul Noce,San Diego Padres,PADRS,1,1,1,2,1984,1984,0,No,0,-0.24,0.0,0.24,70,0,-70,192,0,-192,0.0,0.0,0.0,0.0,0.0,0.0
<a href=/player/nocep001>nocep001</a>,Paul Noce,Chicago Cubs,CUBS,1,1,1,2,1988,1988,0,No,0,0.0,0.0,0.0,0,0,0,0,0,0,0.0,0.0,0.0,0.0,0.0,0.0
<a href=/player/noesh001>noesh001</a>,Hector Noesi,New York Yankees,YANKS,3,7,6,13,2012,2020,8,No,0,-1.73,11.1,12.83,260,478,218,802,248,-554,452.0,2363.0,1911.0,6150000.0,0.0,-6150000.0
<a href=/player/nogos001>nogos001</a>,Stephen Nogosek,Boston Red Sox,RSOX,1,3,1,4,2017,2017,0,No,0,-0.57,0.56,1.13,43,31,-12,1,0,-1,62.0,81.0,19.0,0.0,0.0,0.0
<a href=/player/nokem001>nokem001</a>,Matt Nokes,San Francisco Giants,GIANTS,3,6,5,11,1985,1991,6,No,0,8.16,14.64,6.48,1129,850,-279,2301,1999,-302,2390.0,2023.0,-367.0,0.0,0.0,0.0
<a href=/player/nokem001>nokem001</a>,Matt Nokes,Detroit Tigers,TIGRS,1,1,2,3,1990,1991,1,No,0,4.46,1.65,-2.81,452,34,-418,1510,0,-1510,0.0,242.0,242.0,650000.0,0.0,-650000.0
<a href=/player/nolaa002>nolaa002</a>,Austin Nola,Seattle Mariners,MARNRS,1,3,4,7,2020,2020,0,Yes,0,1.48,0.43,-1.05,218,41,-177,269,159,-110,200.0,0.0,-200.0,0.0,0.0,0.0
<a href=/player/nolag101>nolag101</a>,Gary Nolan,Cincinnati Reds,REDS,1,1,1,2,1977,1977,0,No,0,-0.62,0.0,0.62,6,0,-6,0,0,0,55.0,0.0,-55.0,52000.0,0.0,-52000.0
<a href=/player/nolaj001>nolaj001</a>,Joe Nolan,New York Mets,METS,2,2,2,4,1975,1978,3,No,0,-0.77,-0.05,0.72,267,60,-207,635,148,-487,0.0,0.0,0.0,0.0,0.0,0.0
<a href=/player/nolaj001>nolaj001</a>,Joe Nolan,Cincinnati Reds,REDS,2,2,3,5,1982,1984,2,No,0,0.87,-0.67,-1.54,216,18,-198,563,41,-522,0.0,0.0,0.0,0.0,0.0,0.0
<a href=/player/nolar001>nolar001</a>,Ricky Nolasco,Chicago Cubs,CUBS,3,8,4,12,2005,2009,4,No,1,27.92,6.53,-21.39,1518,286,-1232,2540,824,-1716,5153.0,718.0,-4435.0,0.0,0.0,0.0
<a href=/player/nolar001>nolar001</a>,Ricky Nolasco,Miami Marlins,MARLNS,1,2,3,5,2013,2015,2,No,0,0.91,0.0,-0.91,31,8,-23,30,0,-30,261.0,12.0,-249.0,0.0,0.0,0.0
<a href=/player/nolar001>nolar001</a>,Ricky Nolasco,Minnesota Twins,TWINS,1,3,2,5,2016,2018,2,No,0,3.27,-0.15,-3.42,67,80,13,11,0,-11,1029.0,566.0,-463.0,0.0,0.0,0.0
<a href=/player/noled001>noled001</a>,Dickie Noles,Chicago Cubs,CUBS,1,1,1,2,1987,1987,0,No,0,0.07,0.0,-0.07,5,0,-5,0,0,0,6.0,0.0,-6.0,75000.0,0.0,-75000.0
<a href=/player/noled001>noled001</a>,Dickie Noles,Philadelphia Phillies,PHILS,3,8,5,13,1981,1988,7,No,0,16.51,17.82,1.31,2071,1049,-1022,4347,608,-3739,6629.0,2308.0,-4321.0,0.0,0.0,0.0
<a href=/player/noled001>noled001</a>,Dickie Noles,Chicago Cubs,CUBS,1,1,2,3,1984,1984,0,No,0,0.08,0.0,-0.08,46,0,-46,0,0,0,504.0,0.0,-504.0,0.0,0.0,0.0
<a href=/player/nolis001>nolis001</a>,Sean Nolin,Toronto Blue Jays,BJAYS,2,6,2,8,2014,2018,4,Yes,0,6.54,19.48,12.94,350,462,112,887,2066,1179,1411.0,0.0,-1411.0,23516100.0,0.0,-23516100.0
<a href=/player/nomoh001>nomoh001</a>,Hideo Nomo,Los Angeles Dodgers,DOGRS,4,7,7,14,1998,2010,12,No,1,0.28,3.05,2.77,258,110,-148,43,85,42,1690.0,777.0,-913.0,9633334.0,0.0,-9633334.0
<a href=/player/noonp101>noonp101</a>,Pete Noonan,Chicago Cubs,CUBS,1,3,1,4,1906,1906,0,No,0,1.84,2.12,0.28,366,34,-332,716,57,-659,2561.0,440.0,-2121.0,0.0,0.0,0.0
<a href=/player/nopsj101>nopsj101</a>,Jerry Nops,Baltimore Orioles,BLN,1,2,1,3,1899,1906,7,No,0,-0.36,0.13,0.49,87,2,-85,281,8,-273,204.0,0.0,-204.0,0.0,0.0,0.0
<a href=/player/norbj001>norbj001</a>,Jordan Norberto,Arizona Diamondbacks,DBACKS,2,3,3,6,2011,2016,5,Yes,0,1.57,7.2,5.63,125,680,555,165,7,-158,265.0,1007.0,742.0,0.0,0.0,0.0
<a href=/player/nordt101>nordt101</a>,Tim Nordbrook,Toronto Blue Jays,BJAYS,1,1,1,2,1978,1979,1,No,0,-0.07,-0.35,-0.28,4,111,107,10,188,178,0.0,0.0,0.0,0.0,0.0,0.0
<a href=/player/nordw101>nordw101</a>,Wayne Nordhagen,New York Yankees,YANKS,6,12,9,21,1973,1983,10,No,0,29.7,21.37,-8.33,2028,936,-1092,2549,2957,408,5698.0,1893.0,-3805.0,79000.0,0.0,-79000.0
<a href=/player/nordw101>nordw101</a>,Wayne Nordhagen,Atlanta Braves,BRAVES,3,6,6,12,1975,1977,2,No,0,7.21,1.02,-6.19,424,370,-54,701,70,-631,842.0,1041.0,199.0,0.0,0.0,0.0
<a href=/player/nordw101>nordw101</a>,Wayne Nordhagen,Philadelphia Phillies,PHILS,1,1,1,2,1976,1976,0,No,0,0.39,0.0,-0.39,408,0,-408,1262,0,-1262,6.0,0.0,-6.0,0.0,0.0,0.0
<a href=/player/nordw101>nordw101</a>,Wayne Nordhagen,Chicago White Sox,WSOX,1,1,1,2,1982,1982,0,No,0,-1.26,0.28,1.54,72,118,46,197,277,80,0.0,0.0,0.0,0.0,0.0,0.0
<a href=/player/nordw101>nordw101</a>,Wayne Nordhagen,Toronto Blue Jays,BJAYS,2,2,2,4,1982,1982,0,No,0,-0.62,-1.18,-0.56,39,75,36,86,205,119,0.0,0.0,0.0,0.0,0.0,0.0
<a href=/player/nordw101>nordw101</a>,Wayne Nordhagen,Philadelphia Phillies,PHILS,1,1,1,2,1982,1983,1,No,0,0.04,-0.15,-0.19,1,45,44,4,86,82,0.0,0.0,0.0,0.0,0.0,0.0
<a href=/player/nordw101>nordw101</a>,Wayne Nordhagen,Pittsburgh Pirates,PIRATS,1,1,1,2,1982,1983,1,No,0,-1.26,-0.62,0.64,72,39,-33,197,86,-111,0.0,0.0,0.0,0.0,0.0,0.0
<a href=/player/norei101>norei101</a>,Irv Noren,Washington Senators,TWINS,17,30,33,63,1952,1963,11,No,0,45.18,4.68,-40.5,3039,4336,1297,10601,11469,868,1213.0,4683.0,3470.0,38500.0,0.0,-38500.0
<a href=/player/norei101>norei101</a>,Irv Noren,New York Yankees,YANKS,6,15,13,28,1957,1970,13,No,0,5.72,32.98,27.26,1633,2423,790,4235,5558,1323,2553.0,4978.0,2425.0,115500.0,0.0,-115500.0
<a href=/player/norei101>norei101</a>,Irv Noren,St. Louis Cardinals,CARDS,1,1,1,2,1959,1959,0,No,0,1.9,0.02,-1.88,77,5,-72,186,8,-178,0.0,0.0,0.0,0.0,0.0,0.0
<a href=/player/normd101>normd101</a>,Dan Norman,Cincinnati Reds,REDS,3,6,5,11,1977,1990,13,No,0,13.19,18.54,5.35,1751,636,-1115,5361,1105,-4256,2918.0,3754.0,836.0,450000.0,0.0,-450000.0
<a href=/player/normd101>normd101</a>,Dan Norman,New York Mets,METS,1,2,1,3,1981,1982,1,No,0,8.04,-0.11,-8.15,771,159,-612,125,526,401,1519.0,0.0,-1519.0,0.0,0.0,0.0
<a href=/player/normf101>normf101</a>,Fred Norman,Kansas City Athletics,ATLTCS,1,1,1,2,1963,1963,0,No,0,-0.74,0.0,0.74,22,0,-22,11,0,-11,110.0,0.0,-110.0,0.0,0.0,0.0
<a href=/player/normf101>normf101</a>,Fred Norman,Chicago Cubs,CUBS,1,1,1,2,1967,1967,0,No,0,-0.47,-0.13,0.34,60,2,-58,11,2,-9,186.0,13.0,-173.0,0.0,0.0,0.0
<a href=/player/normf101>normf101</a>,Fred Norman,St. Louis Cardinals,CARDS,5,6,5,11,1971,1976,5,No,0,12.13,1.76,-10.37,660,184,-476,1378,165,-1213,1880.0,841.0,-1039.0,34000.0,0.0,-34000.0
<a href=/player/normf101>normf101</a>,Fred Norman,San Diego Padres,PADRS,2,2,4,6,1973,1977,4,No,0,11.55,2.33,-9.22,476,387,-89,523,651,128,3945.0,578.0,-3367.0,0.0,0.0,0.0
<a href=/player/normn001>normn001</a>,Nelson Norman,Pittsburgh Pirates,PIRATS,6,9,12,21,1977,1984,7,No,0,35.51,9.96,-25.55,1400,772,-628,4253,1476,-2777,2781.0,2392.0,-389.0,465000.0,0.0,-465000.0
<a href=/player/normn001>normn001</a>,Nelson Norman,Texas Rangers,RNGRS,1,1,1,2,1982,1982,0,No,0,-0.08,0.0,0.08,3,0,-3,3,0,-3,0.0,0.0,0.0,0.0,0.0,0.0
<a href=/player/normn001>normn001</a>,Nelson Norman,Baltimore Orioles,ORLS,1,1,1,2,1985,1985,0,No,0,-0.2,0.0,0.2,1,0,-1,4,0,-4,0.0,0.0,0.0,0.0,0.0,0.0
<a href=/player/norrb001>norrb001</a>,Bud Norris,Houston Astros,ASTROS,2,5,6,11,2013,2017,4,No,0,19.5,0.29,-19.21,1049,307,-742,1482,820,-662,2670.0,1153.0,-1517.0,0.0,0.0,0.0
<a href=/player/norrb001>norrb001</a>,Bud Norris,Atlanta Braves,BRAVES,1,4,2,6,2016,2016,0,Yes,0,-0.57,0.0,0.57,26,0,-26,16,0,-16,128.0,0.0,-128.0,0.0,0.0,0.0
<a href=/player/norrd001>norrd001</a>,Derek Norris,Washington Nationals,NATEX,2,6,4,10,2011,2018,7,Yes,0,12.32,19.68,7.36,414,407,-7,1035,430,-605,1666.0,3760.0,2094.0,12000000.0,0.0,-12000000.0
<a href=/player/norrd001>norrd001</a>,Derek Norris,Oakland Athletics,ATLTCS,2,5,5,10,2014,2019,5,No,0,3.37,0.99,-2.38,334,186,-148,1020,4,-1016,390.0,952.0,562.0,505000.0,0.0,-505000.0
<a href=/player/norrd001>norrd001</a>,Derek Norris,San Diego Padres,PADRS,1,1,1,2,2016,2019,3,Yes,0,0.0,0.26,0.26,0,2,2,0,2,2,0.0,16.0,16.0,2925000.0,0.0,-2925000.0
<a href=/player/norrd002>norrd002</a>,Daniel Norris,Toronto Blue Jays,BJAYS,1,3,1,4,2015,2015,0,No,0,13.77,2.5,-11.27,310,12,-298,26,4,-22,3733.0,223.0,-3510.0,508700.0,0.0,-508700.0
<a href=/player/norrd002>norrd002</a>,Daniel Norris,Detroit Tigers,TIGRS,1,1,1,2,2021,2021,0,Yes,0,-0.35,0.0,0.35,34,0,-34,2,0,-2,61.0,0.0,-61.0,3475000.0,0.0,-3475000.0
<a href=/player/norrj101>norrj101</a>,Jim Norris,Cleveland Indians,INDINS,1,2,3,5,1980,1980,0,No,0,-1.43,-0.55,0.88,119,28,-91,205,57,-148,0.0,0.0,0.0,0.0,0.0,0.0
<a href=/player/norrl101>norrl101</a>,Leo Norris,Minneapolis,Minneapolis,1,1,1,2,1935,1936,1,No,0,-0.66,0.0,0.66,270,0,-270,1055,0,-1055,0.0,0.0,0.0,0.0,0.0,0.0
<a href=/player/norta001>norta001</a>,Aaron Northcraft,Atlanta Braves,BRAVES,2,4,6,10,2014,2019,5,Yes,0,3.78,1.55,-2.23,316,457,141,1233,1449,216,47.0,147.0,100.0,14250000.0,0.0,-14250000.0
<a href=/player/nortb101>nortb101</a>,Bill North,Chicago Cubs,CUBS,4,4,4,8,1972,1978,6,No,0,20.43,3.49,-16.94,680,219,-461,2859,77,-2782,35.0,461.0,426.0,80000.0,0.0,-80000.0
<a href=/player/nortb101>nortb101</a>,Bill North,Oakland Athletics,ATLTCS,1,1,1,2,1978,1978,0,No,0,1.8,-0.59,-2.39,110,78,-32,377,217,-160,0.0,0.0,0.0,0.0,0.0,0.0
<a href=/player/nortg001>nortg001</a>,Greg Norton,Seattle Mariners,MARNRS,1,1,1,2,2008,2008,0,No,0,-0.37,0.0,0.37,206,0,-206,299,0,-299,0.0,0.0,0.0,0.0,0.0,0.0
<a href=/player/north101>north101</a>,Hub Northen,Brooklyn Dodgers,DOGRS,1,1,1,2,1912,1914,2,No,0,0.0,-0.42,-0.42,0,38,38,0,102,102,0.0,0.0,0.0,2150.0,0.0,-2150.0
<a href=/player/nortl101>nortl101</a>,Lou North,St. Louis Cardinals,CARDS,1,5,1,6,1917,1917,0,No,0,0.0,0.36,0.36,0,28,28,0,29,29,0.0,256.0,256.0,9800.0,0.0,-9800.0
<a href=/player/nortp001>nortp001</a>,Phil Norton,Chicago Cubs,CUBS,5,8,8,16,2003,2013,10,No,0,13.93,0.71,-13.22,1338,461,-877,3303,226,-3077,1366.0,1109.0,-257.0,732500.0,0.0,-732500.0
<a href=/player/nortr101>nortr101</a>,Ron Northey,Philadelphia Phillies,PHILS,2,2,3,5,1947,1953,6,No,0,4.66,11.24,6.58,338,617,279,1118,1748,630,0.0,230.0,230.0,0.0,0.0,0.0
<a href=/player/nortr101>nortr101</a>,Ron Northey,St. Louis Cardinals,CARDS,1,2,1,3,1949,1952,3,No,0,0.18,-0.58,-0.76,27,68,41,92,195,103,0.0,0.0,0.0,9000.0,0.0,-9000.0
<a href=/player/nortr101>nortr101</a>,Ron Northey,Cincinnati Reds,REDS,1,1,1,2,1950,1951,1,No,0,0.35,0.02,-0.33,54,68,14,126,190,64,0.0,0.0,0.0,0.0,0.0,0.0
<a href=/player/nortr101>nortr101</a>,Ron Northey,Detroit Tigers,TIGRS,1,1,2,3,1955,1955,0,No,0,0.0,0.0,0.0,0,0,0,0,0,0,0.0,0.0,0.0,0.0,0.0,0.0
<a href=/player/nortr101>nortr101</a>,Ron Northey,Charleston,Charleston,1,2,1,3,1955,1955,0,No,0,0.0,0.0,0.0,0,0,0,0,0,0,0.0,0.0,0.0,0.0,0.0,0.0
<a href=/player/nortr101>nortr101</a>,Ron Northey,New York Giants,GIANTS,1,1,1,2,1955,1955,0,No,0,0.73,-0.19,-0.92,107,9,-98,116,13,-103,0.0,0.0,0.0,0.0,0.0,0.0
<a href=/player/norwj001>norwj001</a>,James Norwood,Chicago Cubs,CUBS,1,1,1,2,2021,2021,0,Yes,0,0.22,0.0,-0.22,10,0,-10,0,0,0,15.0,0.0,-15.0,0.0,0.0,0.0
<a href=/player/norww101>norww101</a>,Willie Norwood,Minnesota Twins,TWINS,1,1,1,2,1980,1981,1,No,0,0.0,0.0,0.0,0,0,0,0,0,0,0.0,0.0,0.0,0.0,0.0,0.0
<a href=/player/nossj101>nossj101</a>,Joe Nossek,Oakland Athletics,ATLTCS,1,1,1,2,1969,1970,1,No,0,0.02,0.47,0.45,10,81,71,6,123,117,0.0,0.0,0.0,0.0,0.0,0.0
<a href=/player/nottd101>nottd101</a>,Don Nottebart,Milwaukee Braves,BRAVES,1,3,1,4,1962,1963,1,No,0,3.88,-0.09,-3.97,176,64,-112,179,177,-2,1524.0,0.0,-1524.0,0.0,0.0,0.0
<a href=/player/nottd101>nottd101</a>,Don Nottebart,Cincinnati Reds,REDS,1,1,2,3,1969,1969,0,No,0,-0.25,0.0,0.25,32,0,-32,2,0,-2,54.0,0.0,-54.0,0.0,0.0,0.0
<a href=/player/nottj001>nottj001</a>,Jacob Nottingham,Houston Astros,ASTROS,1,2,1,3,2015,2015,0,No,0,2.02,-0.15,-2.17,65,14,-51,15,2,-13,908.0,220.0,-688.0,0.0,0.0,0.0
<a href=/player/nottj001>nottj001</a>,Jacob Nottingham,Oakland Athletics,ATLTCS,2,5,4,9,2016,2021,5,Yes,0,0.49,7.5,7.01,147,815,668,445,3236,2791,0.0,0.0,0.0,0.0,0.0,0.0
<a href=/player/novai001>novai001</a>,Ivan Nova,New York Yankees,YANKS,3,6,7,13,2016,2020,4,Yes,0,3.17,4.11,0.94,162,341,179,140,241,101,1301.0,752.0,-549.0,6150000.0,0.0,-6150000.0
<a href=/player/novai001>novai001</a>,Ivan Nova,Pittsburgh Pirates,PIRATS,1,1,2,3,2018,2018,0,Yes,0,2.34,0.0,-2.34,37,0,-37,5,0,-5,561.0,0.0,-561.0,9167000.0,0.0,-9167000.0
<a href=/player/novor001>novor001</a>,Rafael Novoa,Milwaukee Brewers,BREWRS,1,2,1,3,1993,1995,2,No,0,0.0,1.19,1.19,0,47,47,0,0,0,0.0,559.0,559.0,0.0,0.0,0.0
<a href=/player/novor002>novor002</a>,Roberto Novoa,Pittsburgh Pirates,PIRATS,2,3,2,5,2002,2006,4,No,0,0.18,-0.22,-0.4,49,94,45,110,329,219,63.0,0.0,-63.0,1475000.0,0.0,-1475000.0
<a href=/player/novor002>novor002</a>,Roberto Novoa,Detroit Tigers,TIGRS,3,5,4,9,2005,2010,5,No,0,1.05,4.48,3.43,399,254,-145,54,7,-47,685.0,1390.0,705.0,1975000.0,0.0,-1975000.0
<a href=/player/nunal101>nunal101</a>,Les Nunamaker,New York Yankees,YANKS,5,14,12,26,1918,1931,13,No,0,64.97,61.9,-3.07,2396,2093,-303,7435,5797,-1638,6303.0,6917.0,614.0,44500.0,0.0,-44500.0
<a href=/player/nunal101>nunal101</a>,Les Nunamaker,St.Louis Browns,ORLS,1,1,1,2,1919,1919,0,No,0,0.22,-0.15,-0.37,131,38,-93,316,82,-234,0.0,0.0,0.0,0.0,0.0,0.0
<a href=/player/nunea001>nunea001</a>,Abraham Nunez,Toronto Blue Jays,BJAYS,2,7,5,12,1996,2001,5,No,0,5.42,8.51,3.09,1726,826,-900,3923,2165,-1758,1392.0,748.0,-644.0,1500000.0,0.0,-1500000.0
<a href=/player/nunea002>nunea002</a>,Abraham Nunez,Arizona Diamondbacks,DBACKS,1,3,1,4,1999,2004,5,No,0,6.5,2.69,-3.81,696,350,-346,447,0,-447,3453.0,521.0,-2932.0,0.0,0.0,0.0
<a href=/player/nunea002>nunea002</a>,Abraham Nunez,Florida Marlins,MARLNS,1,1,1,2,2004,2004,0,No,0,-0.52,0.52,1.04,59,46,-13,247,0,-247,0.0,69.0,69.0,300000.0,0.0,-300000.0
<a href=/player/nunee001>nunee001</a>,Ed Nunez,Seattle Mariners,MARNRS,1,1,1,2,1988,1988,0,No,0,0.04,-0.1,-0.14,20,16,-4,0,0,0,42.0,79.0,37.0,320000.0,0.0,-320000.0
<a href=/player/nunee001>nunee001</a>,Ed Nunez,Milwaukee Brewers,BREWRS,1,1,1,2,1992,1992,0,No,0,-0.49,0.0,0.49,39,0,-39,0,0,0,137.0,0.0,-137.0,1075000.0,0.0,-1075000.0
<a href=/player/nunee002>nunee002</a>,Eduardo Nunez,New York Yankees,YANKS,1,1,1,2,2014,2014,0,Yes,0,1.91,0.0,-1.91,235,0,-235,813,0,-813,0.0,0.0,0.0,0.0,0.0,0.0
<a href=/player/nunee002>nunee002</a>,Eduardo Nunez,Minnesota Twins,TWINS,1,1,1,2,2016,2019,3,No,0,1.23,1.18,-0.05,126,44,-82,517,1,-516,0.0,414.0,414.0,0.0,0.0,0.0
<a href=/player/nunee002>nunee002</a>,Eduardo Nunez,San Francisco Giants,GIANTS,2,2,3,5,2017,2021,4,Yes,0,-2.01,0.94,2.95,230,180,-50,849,409,-440,29.0,334.0,305.0,4200000.0,0.0,-4200000.0
<a href=/player/nunef001>nunef001</a>,Franklin Nunez,Boston Red Sox,RSOX,1,1,1,2,2006,2006,0,No,0,0.0,0.0,0.0,0,0,0,0,0,0,0.0,0.0,0.0,0.0,0.0,0.0
<a href=/player/nunej001>nunej001</a>,Jose Nunez,Toronto Blue Jays,BJAYS,2,2,2,4,1989,1991,2,No,0,-1.64,-0.11,1.53,80,13,-67,15,0,-15,368.0,55.0,-313.0,417500.0,0.0,-417500.0
<a href=/player/nunej003>nunej003</a>,Jhonny Nunez,Los Angeles Dodgers,DOGRS,1,1,1,2,2006,2007,1,No,0,0.0,0.64,0.64,0,48,48,0,102,102,0.0,0.0,0.0,0.0,0.0,0.0
<a href=/player/nunej003>nunej003</a>,Jhonny Nunez,Washington Nationals,NATEX,2,2,3,5,2008,2016,8,No,0,-0.13,0.37,0.5,102,256,154,267,568,301,0.0,26.0,26.0,0.0,0.0,0.0
<a href=/player/nunej003>nunej003</a>,Jhonny Nunez,New York Yankees,YANKS,2,4,3,7,2008,2013,5,Yes,1,-0.72,11.97,12.69,28,599,571,50,2501,2451,20.0,3.0,-17.0,1165000.0,0.0,-1165000.0
<a href=/player/nunel001>nunel001</a>,Leo Nunez,Pittsburgh Pirates,PIRATS,1,1,2,3,2004,2005,1,No,0,1.16,-0.14,-1.3,112,6,-106,0,23,23,477.0,0.0,-477.0,0.0,0.0,0.0
<a href=/player/nunel001>nunel001</a>,Leo Nunez,Kansas City Royals,ROYALS,1,1,1,2,2008,2009,1,No,0,2.33,-0.34,-2.67,412,128,-284,1,478,477,594.0,0.0,-594.0,405000.0,0.0,-405000.0
<a href=/player/nunev001>nunev001</a>,Vladimir Nunez,Arizona Diamondbacks,DBACKS,1,3,1,4,1999,2004,5,No,0,6.5,2.69,-3.81,696,350,-346,447,0,-447,3453.0,521.0,-2932.0,0.0,0.0,0.0
<a href=/player/nunnj001>nunnj001</a>,Jon Nunnally,Kansas City Royals,ROYALS,1,2,2,4,1997,1999,2,No,0,7.45,1.22,-6.23,503,193,-310,1598,1,-1597,0.0,629.0,629.0,0.0,0.0,0.0
<a href=/player/nunnj001>nunnj001</a>,Jon Nunnally,Cincinnati Reds,REDS,1,1,1,2,1999,1999,0,No,0,-0.13,0.0,0.13,10,0,-10,14,0,-14,0.0,0.0,0.0,0.0,0.0,0.0
<a href=/player/nunnj001>nunnj001</a>,Jon Nunnally,Boston Red Sox,RSOX,1,1,1,2,1999,1999,0,No,0,-0.02,0.0,0.02,48,0,-48,92,0,-92,0.0,0.0,0.0,0.0,0.0,0.0
<a href=/player/nunov001>nunov001</a>,Vidal Nuno,New York Yankees,YANKS,1,1,2,3,2014,2014,0,No,0,1.46,1.56,0.1,32,14,-18,30,0,-30,294.0,271.0,-23.0,0.0,0.0,0.0
<a href=/player/nunov001>nunov001</a>,Vidal Nuno,Arizona Diamondbacks,DBACKS,1,2,4,6,2015,2018,3,No,0,2.85,2.85,0.0,190,248,58,363,765,402,400.0,92.0,-308.0,0.0,0.0,0.0
<a href=/player/nunov001>nunov001</a>,Vidal Nuno,Seattle Mariners,MARNRS,1,1,1,2,2016,2017,1,No,0,0.0,0.48,0.48,0,54,54,0,145,145,0.0,3.0,3.0,532900.0,0.0,-532900.0
<a href=/player/nunov001>nunov001</a>,Vidal Nuno,Los Angeles Dodgers,DOGRS,1,1,1,2,2017,2017,0,Yes,0,-0.53,0.0,0.53,13,0,-13,1,0,-1,44.0,0.0,-44.0,0.0,0.0,0.0
<a href=/player/nuxhj101>nuxhj101</a>,Joe Nuxhall,Cincinnati Reds,REDS,1,1,2,3,1961,1961,0,No,0,1.04,0.0,-1.04,93,0,-93,76,0,-76,384.0,0.0,-384.0,0.0,0.0,0.0
<a href=/player/nye-r101>nye-r101</a>,Rich Nye,Chicago Cubs,CUBS,2,2,2,4,1969,1970,1,No,0,1.99,0.27,-1.72,461,77,-384,1277,223,-1054,24.0,0.0,-24.0,0.0,0.0,0.0
<a href=/player/nymaj101>nymaj101</a>,Jerry Nyman,Chicago White Sox,WSOX,4,5,5,10,1970,1971,1,No,0,1.79,-1.3,-3.09,451,113,-338,1303,52,-1251,16.0,522.0,506.0,40000.0,0.0,-40000.0
<a href=/player/nyman101>nyman101</a>,Nyls Nyman,Chicago White Sox,WSOX,1,3,1,4,1977,1978,1,No,0,1.03,-0.14,-1.17,221,8,-213,205,0,-205,1727.0,34.0,-1693.0,0.0,0.0,0.0
<a href=/player/oaker101>oaker101</a>,Rebel Oakes,LosAngeles,LosAngeles,1,1,2,3,1909,1914,5,No,0,1.62,0.0,-1.62,120,0,-120,478,0,-478,0.0,0.0,0.0,0.0,0.0,0.0
<a href=/player/oaker101>oaker101</a>,Rebel Oakes,Cincinnati Reds,REDS,3,9,7,16,1910,1914,4,No,0,44.03,8.35,-35.68,2926,785,-2141,11991,2646,-9345,753.0,872.0,119.0,0.0,0.0,0.0
<a href=/player/oakst001>oakst001</a>,Trevor Oaks,Los Angeles Dodgers,DOGRS,1,4,2,6,2018,2021,3,Yes,0,-0.68,0.86,1.54,21,242,221,43,6,-37,41.0,333.0,292.0,0.0,0.0,0.0
<a href=/player/oanap101>oanap101</a>,Prince Oana,Portland,Portland,1,1,3,4,1933,1933,0,No,0,-0.02,0.0,0.02,6,0,-6,21,0,-21,0.0,0.0,0.0,0.0,0.0,0.0
<a href=/player/oatej101>oatej101</a>,Johnny Oates,Baltimore Orioles,ORLS,12,27,22,49,1972,1994,22,No,3,53.13,90.0,36.87,3098,4599,1501,7090,11622,4532,12003.0,13691.0,1688.0,846833.0,0.0,-846833.0
<a href=/player/oatej101>oatej101</a>,Johnny Oates,Atlanta Braves,BRAVES,3,7,6,13,1975,1986,11,No,0,13.14,5.38,-7.76,1203,1387,184,3551,4502,951,1023.0,3.0,-1020.0,0.0,0.0,0.0
<a href=/player/oatej101>oatej101</a>,Johnny Oates,Philadelphia Phillies,PHILS,8,19,14,33,1976,1999,23,No,0,25.71,38.98,13.27,2933,3822,889,10288,10555,267,522.0,1259.0,737.0,2950000.0,0.0,-2950000.0
<a href=/player/obans001>obans001</a>,Sherman Obando,Baltimore Orioles,ORLS,1,1,1,2,1996,1998,2,No,0,-0.47,-0.19,0.28,130,131,1,256,285,29,0.0,0.0,0.0,0.0,0.0,0.0
<a href=/player/oberb001>oberb001</a>,Brett Oberholtzer,Atlanta Braves,BRAVES,2,5,3,8,2011,2019,8,No,1,1.07,6.63,5.56,249,230,-19,481,952,471,1075.0,36.0,-1039.0,0.0,0.0,0.0
<a href=/player/oberb001>oberb001</a>,Brett Oberholtzer,Houston Astros,ASTROS,2,8,3,11,2015,2020,5,No,0,7.89,4.62,-3.27,397,276,-121,183,0,-183,2153.0,753.0,-1400.0,5115800.0,0.0,-5115800.0
<a href=/player/oberk001>oberk001</a>,Ken Oberkfell,St. Louis Cardinals,CARDS,1,1,2,3,1984,1986,2,No,0,5.5,-0.25,-5.75,590,314,-276,2296,266,-2030,0.0,327.0,327.0,0.0,0.0,0.0
<a href=/player/oberk001>oberk001</a>,Ken Oberkfell,Atlanta Braves,BRAVES,1,2,1,3,1988,1992,4,No,0,-0.67,-0.18,0.49,34,327,293,104,730,626,0.0,0.0,0.0,725000.0,0.0,-725000.0
<a href=/player/oberk001>oberk001</a>,Ken Oberkfell,Pittsburgh Pirates,PIRATS,1,1,1,2,1989,1989,0,No,0,0.91,-0.32,-1.23,83,10,-73,129,0,-129,0.0,11.0,11.0,725000.0,0.0,-725000.0
<a href=/player/oberm001>oberm001</a>,Mike O'Berry,Boston Red Sox,RSOX,1,2,1,3,1979,1980,1,No,0,0.0,-0.08,-0.08,19,35,16,57,116,59,0.0,0.0,0.0,0.0,0.0,0.0
<a href=/player/oberm001>oberm001</a>,Mike O'Berry,Chicago Cubs,CUBS,5,9,8,17,1980,1990,10,No,0,12.61,11.46,-1.15,911,675,-236,2475,406,-2069,1070.0,3095.0,2025.0,890000.0,0.0,-890000.0
<a href=/player/oberm001>oberm001</a>,Mike O'Berry,Cincinnati Reds,REDS,1,1,1,2,1983,1983,0,No,0,-0.21,0.0,0.21,26,0,-26,65,0,-65,0.0,0.0,0.0,0.0,0.0,0.0
<a href=/player/oberw001>oberw001</a>,Wes Obermueller,Kansas City Royals,ROYALS,1,2,1,3,2003,2004,1,No,0,0.42,0.53,0.11,118,46,-72,83,0,-83,746.0,125.0,-621.0,0.0,0.0,0.0
<a href=/player/oberw001>oberw001</a>,Wes Obermueller,Milwaukee Brewers,BREWRS,1,1,1,2,2005,2006,1,No,0,0.0,-0.04,-0.04,0,105,105,0,0,0,0.0,145.0,145.0,342000.0,0.0,-342000.0
<a href=/player/obrib103>obrib103</a>,Bob O'Brien,Los Angeles Dodgers,DOGRS,3,10,5,15,1971,1976,5,No,0,18.58,22.72,4.14,838,611,-227,2013,960,-1053,3623.0,2900.0,-723.0,259900.0,0.0,-259900.0
<a href=/player/obric001>obric001</a>,Charlie O'Brien,Oakland Athletics,ATLTCS,1,4,1,5,1986,1987,1,No,0,2.24,1.63,-0.61,195,21,-174,688,0,-688,0.0,339.0,339.0,0.0,0.0,0.0
<a href=/player/obric001>obric001</a>,Charlie O'Brien,Milwaukee Brewers,BREWRS,1,2,2,4,1990,1992,2,No,0,2.24,1.3,-0.94,232,30,-202,659,0,-659,0.0,293.0,293.0,150000.0,0.0,-150000.0
<a href=/player/obric001>obric001</a>,Charlie O'Brien,Chicago White Sox,WSOX,1,1,2,3,1998,1998,0,No,0,-0.83,0.0,0.83,32,0,-32,79,0,-79,0.0,0.0,0.0,700000.0,0.0,-700000.0
<a href=/player/obrij101>obrij101</a>,Johnny O'Brien,Pittsburgh Pirates,PIRATS,2,3,3,6,1958,1972,14,No,0,-0.99,11.73,12.72,187,1201,1014,644,3448,2804,6.0,0.0,-6.0,0.0,0.0,0.0
<a href=/player/obrij101>obrij101</a>,Johnny O'Brien,Philadelphia Phillies,PHILS,9,18,19,37,1959,1979,20,No,0,39.51,86.58,47.07,2824,3643,819,7602,10419,2817,7676.0,11796.0,4120.0,74500.0,0.0,-74500.0
<a href=/player/obrij103>obrij103</a>,Jack O'Brien,Pittsburgh Pirates,PIRATS,2,4,2,6,1898,1901,3,No,0,1.28,0.36,-0.92,408,35,-373,1684,149,-1535,0.0,0.0,0.0,0.0,0.0,0.0
<a href=/player/obrij104>obrij104</a>,John O'Brien,Louisville Colonels,LS3,1,1,3,4,1896,1897,1,No,0,0.18,-1.24,-1.42,159,153,-6,662,636,-26,0.0,0.0,0.0,0.0,0.0,0.0
<a href=/player/obrij104>obrij104</a>,John O'Brien,Pittsburgh Pirates,PIRATS,4,11,16,27,1899,1914,15,No,0,23.91,73.99,50.08,1271,3182,1911,4723,12859,8136,1693.0,797.0,-896.0,5000.0,0.0,-5000.0
<a href=/player/obrip001>obrip001</a>,Pete O'Brien,Texas Rangers,RNGRS,1,3,1,4,1988,1993,5,No,0,6.72,20.24,13.52,624,632,8,2545,2680,135,0.0,0.0,0.0,930000.0,0.0,-930000.0
<a href=/player/obrip002>obrip002</a>,Peter O'Brien,New York Yankees,YANKS,2,5,4,9,2014,2016,2,Yes,0,8.2,5.08,-3.12,772,152,-620,1958,301,-1657,737.0,839.0,102.0,11541425.0,0.0,-11541425.0
<a href=/player/obrip002>obrip002</a>,Peter O'Brien,Arizona Diamondbacks,DBACKS,1,1,1,2,2017,2017,0,Yes,0,0.0,0.0,0.0,0,0,0,0,0,0,0.0,0.0,0.0,0.0,0.0,0.0
<a href=/player/obrip102>obrip102</a>,Pete O'Brien,St.Louis Browns,ORLS,1,1,1,2,1907,1907,0,No,0,0.52,0.13,-0.39,43,26,-17,159,78,-81,0.0,0.0,0.0,0.0,0.0,0.0
<a href=/player/obrip102>obrip102</a>,Pete O'Brien,Cleveland Indians,INDINS,1,2,1,3,1907,1907,0,No,0,-0.05,-0.01,0.04,39,12,-27,151,47,-104,0.0,0.0,0.0,0.0,0.0,0.0
<a href=/player/obrir001>obrir001</a>,Riley O'Brien,Tampa Bay Devil Rays,RAYS,1,1,1,2,2020,2021,1,No,0,-0.1,0.1,0.2,1,14,13,0,0,0,4.0,37.0,33.0,0.0,0.0,0.0
<a href=/player/obris101>obris101</a>,Syd O'Brien,Kansas City Athletics,ATLTCS,1,3,2,5,1966,1966,0,No,0,0.6,0.0,-0.6,100,0,-100,283,0,-283,0.0,0.0,0.0,0.0,0.0,0.0
<a href=/player/obris101>obris101</a>,Syd O'Brien,Boston Red Sox,RSOX,6,12,12,24,1969,1977,8,No,0,34.7,14.03,-20.67,1690,1006,-684,5095,2431,-2664,3846.0,3907.0,61.0,155000.0,0.0,-155000.0
<a href=/player/obris101>obris101</a>,Syd O'Brien,Chicago White Sox,WSOX,8,16,13,29,1970,1985,15,No,1,24.79,26.84,2.05,2093,1635,-458,4791,5459,668,4811.0,2182.0,-2629.0,87700.0,0.0,-87700.0
<a href=/player/obris101>obris101</a>,Syd O'Brien,California Angels,ANGELS,4,7,6,13,1972,1976,4,No,0,1.77,3.03,1.26,444,170,-274,1491,564,-927,0.0,90.0,90.0,63500.0,0.0,-63500.0
<a href=/player/obrit101>obrit101</a>,Tom O'Brien,Pittsburgh Pirates,PIRATS,1,4,2,6,1896,1898,2,No,0,3.6,0.48,-3.12,234,186,-48,984,763,-221,0.0,0.0,0.0,0.0,0.0,0.0
<a href=/player/obrit103>obrit103</a>,Tommy O'Brien,Boston Red Sox,RSOX,1,2,1,3,1950,1953,3,No,0,0.17,2.98,2.81,40,263,223,137,929,792,0.0,0.0,0.0,0.0,0.0,0.0
<a href=/player/ochoa001>ochoa001</a>,Alex Ochoa,Baltimore Orioles,ORLS,1,2,2,4,1995,1996,1,No,0,2.13,2.23,0.1,250,220,-30,767,956,189,0.0,0.0,0.0,0.0,0.0,0.0
<a href=/player/ochoa001>ochoa001</a>,Alex Ochoa,New York Mets,METS,1,1,1,2,1997,1998,1,No,0,-1.81,0.1,1.91,94,49,-45,260,123,-137,0.0,0.0,0.0,152000.0,0.0,-152000.0
<a href=/player/ochoa001>ochoa001</a>,Alex Ochoa,Minnesota Twins,TWINS,1,1,1,2,1998,1998,0,No,0,3.11,0.0,-3.11,204,0,-204,579,0,-579,0.0,0.0,0.0,182500.0,0.0,-182500.0
<a href=/player/ochoa001>ochoa001</a>,Alex Ochoa,Milwaukee Brewers,BREWRS,3,8,8,16,2000,2004,4,No,0,4.53,1.77,-2.76,522,512,-10,1583,851,-732,437.0,1049.0,612.0,2750000.0,0.0,-2750000.0
<a href=/player/ochoa001>ochoa001</a>,Alex Ochoa,Cincinnati Reds,REDS,2,2,4,6,2001,2004,3,No,0,0.61,2.43,1.82,202,248,46,861,1046,185,0.0,0.0,0.0,3650000.0,0.0,-3650000.0
<a href=/player/ochoa001>ochoa001</a>,Alex Ochoa,Colorado Rockies,ROCKS,1,3,3,6,2002,2002,0,No,0,1.08,0.1,-0.98,85,193,108,250,708,458,0.0,3.0,3.0,0.0,0.0,0.0
<a href=/player/ochoa001>ochoa001</a>,Alex Ochoa,Milwaukee Brewers,BREWRS,1,2,3,5,2002,2004,2,No,0,0.27,-0.5,-0.77,39,52,13,76,74,-2,0.0,47.0,47.0,2750000.0,0.0,-2750000.0
<a href=/player/ocond101>ocond101</a>,Danny O'Connell,Brooklyn Dodgers,DOGRS,1,1,2,3,1949,1949,0,No,0,3.87,0.0,-3.87,228,0,-228,999,0,-999,0.0,0.0,0.0,0.0,0.0,0.0
<a href=/player/ocond101>ocond101</a>,Danny O'Connell,Pittsburgh Pirates,PIRATS,3,3,9,12,1953,1958,5,No,0,6.64,2.5,-4.14,487,431,-56,1903,671,-1232,58.0,1608.0,1550.0,0.0,0.0,0.0
<a href=/player/ocond101>ocond101</a>,Danny O'Connell,Milwaukee Braves,BRAVES,1,3,1,4,1957,1960,3,No,0,3.25,5.66,2.41,395,272,-123,1122,1140,18,434.0,0.0,-434.0,0.0,0.0,0.0
<a href=/player/oconj001>oconj001</a>,Jack O'Connor,Minnesota Twins,TWINS,2,2,2,4,1985,1985,0,No,0,-0.43,0.02,0.45,61,81,20,34,209,175,71.0,0.0,-71.0,0.0,0.0,0.0
<a href=/player/oconj104>oconj104</a>,Jack O'Connor,New York Yankees,YANKS,1,1,1,2,1903,1905,2,No,0,-0.78,3.02,3.8,95,175,80,330,705,375,0.0,0.0,0.0,0.0,0.0,0.0
<a href=/player/oconp101>oconp101</a>,Pat O'Connell,Lawrence,Lawrence,1,3,1,4,1886,1886,0,No,0,0.0,0.0,0.0,0,0,0,0,0,0,0.0,0.0,0.0,0.0,0.0,0.0
<a href=/player/odayd001>odayd001</a>,Darren O'Day,Baltimore Orioles,ORLS,1,2,5,7,2018,2021,3,Yes,0,0.72,-0.48,-1.2,86,45,-41,50,0,-50,484.0,143.0,-341.0,5600000.0,0.0,-5600000.0
<a href=/player/odeak101>odeak101</a>,Ken O'Dea,St. Louis Cardinals,CARDS,1,1,2,3,1934,1935,1,No,0,3.55,0.0,-3.55,325,0,-325,971,0,-971,0.0,0.0,0.0,0.0,0.0,0.0
<a href=/player/odeak101>odeak101</a>,Ken O'Dea,Chicago Cubs,CUBS,4,7,6,13,1938,1943,5,No,0,18.58,4.9,-13.68,1563,631,-932,5453,2299,-3154,405.0,0.0,-405.0,33000.0,0.0,-33000.0
<a href=/player/odeak101>odeak101</a>,Ken O'Dea,New York Giants,GIANTS,1,4,1,5,1941,1949,8,No,0,5.95,28.96,23.01,346,655,309,1181,2815,1634,38.0,0.0,-38.0,0.0,0.0,0.0
<a href=/player/odelb101>odelb101</a>,Billy O'Dell,Baltimore Orioles,ORLS,14,30,28,58,1959,1994,35,No,3,64.68,130.52,65.84,3731,6258,2527,5785,17265,11480,16291.0,15650.0,-641.0,940333.0,0.0,-940333.0
<a href=/player/odelb101>odelb101</a>,Billy O'Dell,San Francisco Giants,GIANTS,4,6,5,11,1965,1968,3,No,0,2.15,-0.27,-2.42,446,274,-172,431,733,302,950.0,0.0,-950.0,33000.0,0.0,-33000.0
<a href=/player/odelb101>odelb101</a>,Billy O'Dell,Atlanta Braves,BRAVES,1,1,1,2,1966,1967,1,No,0,-0.39,0.04,0.43,129,24,-105,46,13,-33,474.0,138.0,-336.0,0.0,0.0,0.0
<a href=/player/odomj101>odomj101</a>,Blue Moon Odom,Oakland Athletics,ATLTCS,1,2,2,4,1975,1977,2,No,0,0.33,1.23,0.9,3,66,63,0,0,0,31.0,907.0,876.0,35000.0,0.0,-35000.0
<a href=/player/odomj101>odomj101</a>,Blue Moon Odom,Cleveland Indians,INDINS,2,3,2,5,1975,1976,1,No,0,-3.18,0.49,3.67,111,22,-89,203,0,-203,168.0,399.0,231.0,0.0,0.0,0.0
<a href=/player/odomj101>odomj101</a>,Blue Moon Odom,Atlanta Braves,BRAVES,1,1,1,2,1976,1976,0,No,0,-0.38,-0.29,0.09,8,5,-3,0,10,10,84.0,0.0,-84.0,0.0,0.0,0.0
<a href=/player/odonh101>odonh101</a>,Harry O'Donnell,Philadelphia Phillies,PHILS,1,3,1,4,1928,1928,0,No,0,0.0,1.31,1.31,0,96,96,0,292,292,0.0,0.0,0.0,0.0,0.0,0.0
<a href=/player/odonj001>odonj001</a>,John O'Donoghue,Baltimore Orioles,ORLS,1,1,1,2,1994,1995,1,No,0,0.0,-0.12,-0.12,0,2,2,0,0,0,0.0,26.0,26.0,0.0,0.0,0.0
<a href=/player/odonj101>odonj101</a>,John O'Donoghue,Kansas City Athletics,ATLTCS,1,2,1,3,1966,1966,0,No,0,2.7,-0.09,-2.79,130,30,-100,77,17,-60,716.0,192.0,-524.0,0.0,0.0,0.0
<a href=/player/odonj101>odonj101</a>,John O'Donoghue,Cleveland Indians,INDINS,3,4,5,9,1967,1969,2,No,0,0.08,0.41,0.33,486,148,-338,67,15,-52,1385.0,377.0,-1008.0,75600.0,0.0,-75600.0
<a href=/player/odonj101>odonj101</a>,John O'Donoghue,Baltimore Orioles,ORLS,3,6,5,11,1969,1973,4,No,0,0.65,-0.01,-0.66,284,47,-237,424,80,-344,279.0,0.0,-279.0,0.0,0.0,0.0
<a href=/player/odonj101>odonj101</a>,John O'Donoghue,Milwaukee Brewers,BREWRS,2,3,2,5,1970,1971,1,No,0,-0.36,-0.75,-0.39,44,42,-2,5,3,-2,119.0,97.0,-22.0,17500.0,0.0,-17500.0
<a href=/player/odorj001>odorj001</a>,Jake Odorizzi,Milwaukee Brewers,BREWRS,8,16,16,32,2010,2020,10,Yes,0,33.31,23.99,-9.32,2772,1309,-1463,10420,3997,-6423,777.0,2948.0,2171.0,20405500.0,0.0,-20405500.0
<a href=/player/odorj001>odorj001</a>,Jake Odorizzi,Kansas City Royals,ROYALS,3,6,5,11,2012,2021,9,Yes,0,12.05,17.51,5.46,480,779,299,994,1767,773,2270.0,2321.0,51.0,16050000.0,0.0,-16050000.0
<a href=/player/odorj001>odorj001</a>,Jake Odorizzi,Tampa Bay Devil Rays,RAYS,1,1,1,2,2018,2018,0,Yes,0,4.28,0.0,-4.28,73,0,-73,11,0,-11,1011.0,0.0,-1011.0,0.0,0.0,0.0
<a href=/player/odorr001>odorr001</a>,Rougned Odor,Texas Rangers,RNGRS,1,2,2,4,2021,2021,0,Yes,0,0.33,0.0,-0.33,102,0,-102,361,0,-361,0.0,0.0,0.0,0.0,0.0,0.0
<a href=/player/odoul101>odoul101</a>,Lefty O'Doul,New York Yankees,YANKS,2,7,3,10,1922,1928,6,No,0,-3.56,9.12,12.68,367,900,533,1242,3603,2361,159.0,0.0,-159.0,15750.0,0.0,-15750.0
<a href=/player/odoul101>odoul101</a>,Lefty O'Doul,New York Giants,GIANTS,1,2,1,3,1928,1932,4,No,0,12.12,3.02,-9.1,294,368,74,1338,1574,236,0.0,0.0,0.0,7500.0,0.0,-7500.0
<a href=/player/odoul101>odoul101</a>,Lefty O'Doul,Philadelphia Phillies,PHILS,5,12,10,22,1930,1941,11,No,0,17.23,29.97,12.74,1414,1700,286,5405,4168,-1237,324.0,4825.0,4501.0,17000.0,0.0,-17000.0
<a href=/player/odoul101>odoul101</a>,Lefty O'Doul,Brooklyn Dodgers,DOGRS,1,2,1,3,1933,1936,3,No,0,2.63,7.41,4.78,203,384,181,478,1597,1119,188.0,0.0,-188.0,0.0,0.0,0.0
<a href=/player/odwef101>odwef101</a>,Fred Odwell,Cincinnati Reds,REDS,1,2,1,3,1906,1906,0,No,0,0.0,-1.63,-1.63,0,80,80,0,329,329,0.0,0.0,0.0,0.0,0.0,0.0
<a href=/player/oelkb001>oelkb001</a>,Bryan Oelkers,Minnesota Twins,TWINS,1,2,2,4,1986,1986,0,No,0,-0.02,-0.18,-0.16,101,5,-96,0,0,0,1286.0,31.0,-1255.0,0.0,0.0,0.0
<a href=/player/oelkb001>oelkb001</a>,Bryan Oelkers,Montreal Expos,NATEX,1,1,1,2,1988,1988,0,No,0,0.0,0.0,0.0,0,0,0,0,0,0,0.0,0.0,0.0,0.0,0.0,0.0
<a href=/player/oescj101>oescj101</a>,Joe Oeschger,Philadelphia Phillies,PHILS,2,2,3,5,1919,1928,9,No,0,-0.05,9.95,10.0,80,742,662,35,917,882,384.0,4915.0,4531.0,3429.0,0.0,-3429.0
<a href=/player/oescj101>oescj101</a>,Joe Oeschger,New York Giants,GIANTS,1,5,1,6,1919,1926,7,No,0,8.66,14.34,5.68,964,460,-504,2314,555,-1759,3291.0,4306.0,1015.0,5412.0,0.0,-5412.0
<a href=/player/oescj101>oescj101</a>,Joe Oeschger,Boston Braves,BRAVES,1,2,3,5,1923,1927,4,No,0,1.22,11.01,9.79,273,702,429,996,2898,1902,87.0,0.0,-87.0,5000.0,0.0,-5000.0
<a href=/player/ofarb101>ofarb101</a>,Bob O'Farrell,Chicago Cubs,CUBS,1,1,2,3,1925,1928,3,No,0,4.96,2.73,-2.23,387,357,-30,1394,1405,11,0.0,0.0,0.0,10500.0,0.0,-10500.0
<a href=/player/ofarb101>ofarb101</a>,Bob O'Farrell,St. Louis Cardinals,CARDS,1,1,1,2,1928,1928,0,No,0,1.73,2.57,0.84,395,99,-296,1022,337,-685,0.0,0.0,0.0,25000.0,0.0,-25000.0
<a href=/player/ofarb101>ofarb101</a>,Bob O'Farrell,New York Giants,GIANTS,3,11,6,17,1932,1949,17,No,0,15.21,55.77,40.56,1303,2528,1225,3690,9780,6090,2269.0,40.0,-2229.0,0.0,0.0,0.0
<a href=/player/ofarb101>ofarb101</a>,Bob O'Farrell,St. Louis Cardinals,CARDS,1,2,1,3,1934,1934,0,No,0,0.4,0.0,-0.4,48,0,-48,141,0,-141,20.0,0.0,-20.0,0.0,0.0,0.0
<a href=/player/offej001>offej001</a>,Jose Offerman,Los Angeles Dodgers,DOGRS,2,2,2,4,1995,2001,6,No,0,9.56,-0.91,-10.47,419,32,-387,1825,13,-1812,17.0,138.0,121.0,1600000.0,0.0,-1600000.0
<a href=/player/oflae001>oflae001</a>,Eric O'Flaherty,Oakland Athletics,ATLTCS,1,2,1,3,2015,2015,0,Yes,0,-0.66,0.0,0.66,30,0,-30,0,0,0,26.0,0.0,-26.0,5500000.0,0.0,-5500000.0
<a href=/player/ogann001>ogann001</a>,Nefi Ogando,Boston Red Sox,RSOX,1,1,1,2,2013,2013,0,No,0,-0.15,-0.08,0.07,8,6,-2,0,9,9,12.0,0.0,-12.0,0.0,0.0,0.0
<a href=/player/ogdej101>ogdej101</a>,Jack Ogden,New York Giants,GIANTS,2,8,3,11,1919,1923,4,No,0,10.49,7.89,-2.6,305,402,97,539,1094,555,2035.0,323.0,-1712.0,12500.0,0.0,-12500.0
<a href=/player/ogdej101>ogdej101</a>,Jack Ogden,Cincinnati Reds,REDS,4,7,8,15,1933,1943,10,No,0,2.09,48.62,46.53,936,2007,1071,3163,5265,2102,264.0,8479.0,8215.0,23000.0,0.0,-23000.0
<a href=/player/ogeac001>ogeac001</a>,Chad Ogea,Cleveland Indians,INDINS,2,2,3,5,1998,1999,1,No,0,0.06,-0.21,-0.27,184,4,-180,56,0,-56,678.0,9.0,-669.0,1720833.0,0.0,-1720833.0
<a href=/player/oglib001>oglib001</a>,Ben Oglivie,Boston Red Sox,RSOX,1,1,1,2,1973,1974,1,No,0,5.4,0.36,-5.04,439,100,-339,1468,316,-1152,0.0,0.0,0.0,16500.0,0.0,-16500.0
<a href=/player/oglib001>oglib001</a>,Ben Oglivie,Detroit Tigers,TIGRS,2,2,3,5,1977,1978,1,No,1,21.52,1.83,-19.69,1149,35,-1114,4658,0,-4658,0.0,701.0,701.0,60000.0,0.0,-60000.0
<a href=/player/ograb001>ograb001</a>,Brian O'Grady,Cincinnati Reds,REDS,1,1,1,2,2019,2019,0,No,0,0.09,0.0,-0.09,2,0,-2,5,0,-5,0.0,0.0,0.0,0.0,0.0,0.0
<a href=/player/oh--s001>oh--s001</a>,Seung Hwan Oh,Toronto Blue Jays,BJAYS,2,2,4,6,2018,2021,3,Yes,0,0.16,-0.4,-0.56,90,11,-79,0,0,0,119.0,104.0,-15.0,0.0,0.0,0.0
<a href=/player/ohkat001>ohkat001</a>,Tomo Ohka,Boston Red Sox,RSOX,1,2,1,3,2001,2002,1,No,0,9.01,2.21,-6.8,198,82,-116,193,0,-193,1755.0,240.0,-1515.0,225000.0,0.0,-225000.0
<a href=/player/ohkat001>ohkat001</a>,Tomo Ohka,Washington Nationals,NATEX,1,1,1,2,2005,2005,0,No,0,1.34,0.61,-0.73,79,28,-51,78,91,13,670.0,0.0,-670.0,2750000.0,0.0,-2750000.0
<a href=/player/ohler001>ohler001</a>,Ross Ohlendorf,Arizona Diamondbacks,DBACKS,1,4,2,6,2007,2008,1,No,0,-0.71,4.28,4.99,171,78,-93,110,78,-32,366.0,722.0,356.0,0.0,0.0,0.0
<a href=/player/ohler001>ohler001</a>,Ross Ohlendorf,New York Yankees,YANKS,1,4,2,6,2008,2011,3,No,0,7.23,0.52,-6.71,1088,146,-942,2084,276,-1808,3210.0,148.0,-3062.0,391425.0,0.0,-391425.0
<a href=/player/ohmaw001>ohmaw001</a>,Will Ohman,Chicago Cubs,CUBS,3,6,6,12,2007,2013,6,No,0,21.27,0.88,-20.39,1494,347,-1147,4156,61,-4095,895.0,926.0,31.0,1305000.0,0.0,-1305000.0
<a href=/player/ohmaw001>ohmaw001</a>,Will Ohman,Baltimore Orioles,ORLS,1,1,1,2,2010,2012,2,No,0,0.05,-0.24,-0.29,34,11,-23,0,0,0,36.0,76.0,40.0,1350000.0,0.0,-1350000.0
<a href=/player/ojeda001>ojeda001</a>,Augie Ojeda,Baltimore Orioles,ORLS,1,1,1,2,1999,1999,0,No,0,-0.39,0.0,0.39,148,0,-148,359,0,-359,0.0,0.0,0.0,0.0,0.0,0.0
<a href=/player/ojedb001>ojedb001</a>,Bob Ojeda,Boston Red Sox,RSOX,7,15,13,28,1985,1993,8,No,0,20.97,19.79,-1.18,2048,1909,-139,3771,4732,961,4874.0,3574.0,-1300.0,3550000.0,0.0,-3550000.0
<a href=/player/ojedb001>ojedb001</a>,Bob Ojeda,New York Mets,METS,3,4,3,7,1990,1994,4,No,0,2.55,1.07,-1.48,331,342,11,618,888,270,1125.0,394.0,-731.0,4116666.0,0.0,-4116666.0
<a href=/player/ojedm001>ojedm001</a>,Miguel Ojeda,San Diego Padres,PADRS,1,2,1,3,2005,2005,0,No,0,0.04,0.91,0.87,16,37,21,37,124,87,0.0,0.0,0.0,325000.0,0.0,-325000.0
<a href=/player/okril101>okril101</a>,Len Okrie,Washington Senators,TWINS,1,2,1,3,1951,1951,0,No,0,-0.03,-1.31,-1.28,1,72,71,1,231,230,0.0,0.0,0.0,0.0,0.0,0.0
<a href=/player/olerj001>olerj001</a>,John Olerud,Toronto Blue Jays,BJAYS,5,8,10,18,1996,2001,5,No,0,26.41,-1.92,-28.33,768,398,-370,2308,479,-1829,2704.0,1150.0,-1554.0,15479000.0,0.0,-15479000.0
<a href=/player/oliva001>oliva001</a>,Al Oliver,Pittsburgh Pirates,PIRATS,6,9,12,21,1977,1984,7,No,0,35.51,9.96,-25.55,1400,772,-628,4253,1476,-2777,2781.0,2392.0,-389.0,465000.0,0.0,-465000.0
<a href=/player/oliva001>oliva001</a>,Al Oliver,Texas Rangers,RNGRS,2,2,3,5,1982,1988,6,No,0,6.69,5.48,-1.21,317,1141,824,1351,4462,3111,0.0,229.0,229.0,0.0,0.0,0.0
<a href=/player/oliva001>oliva001</a>,Al Oliver,Montreal Expos,NATEX,3,4,5,9,1984,1992,8,No,0,-0.33,3.06,3.39,385,762,377,699,1970,1271,201.0,164.0,-37.0,415000.0,0.0,-415000.0
<a href=/player/oliva001>oliva001</a>,Al Oliver,San Francisco Giants,GIANTS,2,4,3,7,1984,1992,8,No,0,-0.69,5.26,5.95,80,443,363,148,292,144,73.0,2798.0,2725.0,0.0,0.0,0.0
<a href=/player/oliva001>oliva001</a>,Al Oliver,Philadelphia Phillies,PHILS,1,1,1,2,1985,1985,0,No,0,-0.47,-0.03,0.44,35,20,-15,85,1,-84,0.0,38.0,38.0,0.0,0.0,0.0
<a href=/player/oliva001>oliva001</a>,Al Oliver,Los Angeles Dodgers,DOGRS,1,1,1,2,1985,1985,0,No,0,-0.63,0.62,1.25,61,43,-18,195,76,-119,0.0,0.0,0.0,750000.0,0.0,-750000.0
<a href=/player/oliva002>oliva002</a>,Andy Oliver,Detroit Tigers,TIGRS,1,1,1,2,2012,2014,2,No,0,0.0,0.0,0.0,0,0,0,0,0,0,0.0,0.0,0.0,0.0,0.0,0.0
<a href=/player/olivb101>olivb101</a>,Bob Oliver,Pittsburgh Pirates,PIRATS,2,2,2,4,1967,1970,3,No,0,-0.01,1.87,1.88,14,304,290,0,34,34,33.0,708.0,675.0,0.0,0.0,0.0
<a href=/player/olivb101>olivb101</a>,Bob Oliver,Kansas City Royals,ROYALS,2,2,2,4,1972,1973,1,No,0,3.99,0.78,-3.21,433,39,-394,1539,19,-1520,266.0,211.0,-55.0,27500.0,0.0,-27500.0
<a href=/player/olivb101>olivb101</a>,Bob Oliver,California Angels,ANGELS,2,2,3,5,1974,1978,4,No,0,-0.11,-0.27,-0.16,9,98,89,20,0,-20,0.0,370.0,370.0,55000.0,0.0,-55000.0
<a href=/player/olivc101>olivc101</a>,Chi-Chi Olivo,Atlanta Braves,BRAVES,1,2,1,3,1966,1971,5,No,0,-2.04,8.56,10.6,310,533,223,998,2105,1107,0.0,0.0,0.0,5500.0,0.0,-5500.0
<a href=/player/olivd001>olivd001</a>,Darren Oliver,Texas Rangers,RNGRS,10,22,21,43,1998,2013,15,No,6,69.97,35.86,-34.11,3830,2430,-1400,13190,7848,-5342,3667.0,3730.0,63.0,14990260.0,0.0,-14990260.0
<a href=/player/olivd001>olivd001</a>,Darren Oliver,Texas Rangers,RNGRS,3,3,5,8,2001,2012,11,No,0,3.77,14.53,10.76,325,775,450,1006,1580,574,326.0,1248.0,922.0,16150000.0,0.0,-16150000.0
<a href=/player/olivd101>olivd101</a>,Diomedes Olivo,Pittsburgh Pirates,PIRATS,4,6,6,12,1962,1968,6,No,0,15.1,3.94,-11.16,878,326,-552,2528,282,-2246,1540.0,2303.0,763.0,46000.0,0.0,-46000.0
<a href=/player/olivd102>olivd102</a>,Dave Oliver,Cleveland Indians,INDINS,1,1,1,2,1980,1981,1,No,0,0.0,-1.41,-1.41,0,14,14,0,0,0,0.0,224.0,224.0,0.0,0.0,0.0
<a href=/player/olive001>olive001</a>,Edward Olivares,Toronto Blue Jays,BJAYS,1,2,1,3,2018,2018,0,No,0,-0.5,-0.25,0.25,13,122,109,36,506,470,0.0,0.0,0.0,0.0,0.0,0.0
<a href=/player/olive001>olive001</a>,Edward Olivares,San Diego Padres,PADRS,1,2,1,3,2020,2020,0,No,0,0.01,0.64,0.63,62,10,-52,176,0,-176,19.0,30.0,11.0,0.0,0.0,0.0
<a href=/player/olivf001>olivf001</a>,Francisco Oliveras,Minnesota Twins,TWINS,1,1,1,2,1990,1990,0,No,0,0.88,0.0,-0.88,208,0,-208,23,0,-23,538.0,0.0,-538.0,0.0,0.0,0.0
<a href=/player/olivg101>olivg101</a>,Gene Oliver,St. Louis Cardinals,CARDS,3,6,4,10,1963,1965,2,No,0,5.52,0.29,-5.23,682,84,-598,1519,49,-1470,1673.0,458.0,-1215.0,0.0,0.0,0.0
<a href=/player/olivg101>olivg101</a>,Gene Oliver,Atlanta Braves,BRAVES,1,1,1,2,1967,1967,0,No,0,0.69,-2.01,-2.7,85,62,-23,298,180,-118,0.0,0.0,0.0,0.0,0.0,0.0
<a href=/player/olivg101>olivg101</a>,Gene Oliver,Philadelphia Phillies,PHILS,2,3,3,6,1967,1974,7,No,0,0.86,0.9,0.04,97,392,295,157,1287,1130,624.0,0.0,-624.0,32000.0,0.0,-32000.0
<a href=/player/olivh001>olivh001</a>,Hector Olivera,Los Angeles Dodgers,DOGRS,9,31,24,55,2015,2021,6,Yes,0,13.41,18.97,5.56,1905,1113,-792,5768,1311,-4457,2200.0,3323.0,1123.0,37486500.0,0.0,-37486500.0
<a href=/player/olivh001>olivh001</a>,Hector Olivera,Atlanta Braves,BRAVES,2,2,7,9,2016,2020,4,No,0,1.15,-0.95,-2.1,146,435,289,506,1212,706,0.0,246.0,246.0,21750000.0,0.0,-21750000.0
<a href=/player/olivj001>olivj001</a>,Joe Oliver,Tampa Bay Devil Rays,RAYS,1,2,2,4,1999,2001,2,No,0,-1.06,1.13,2.19,241,216,-25,708,680,-28,0.0,91.0,91.0,0.0,0.0,0.0
<a href=/player/olivj002>olivj002</a>,Jose Oliva,Texas Rangers,RNGRS,2,2,3,5,1992,1993,1,No,0,0.04,1.17,1.13,122,26,-96,187,0,-187,95.0,451.0,356.0,0.0,0.0,0.0
<a href=/player/olivj002>olivj002</a>,Jose Oliva,Atlanta Braves,BRAVES,2,2,2,4,1995,1999,4,No,0,-0.86,0.37,1.23,22,163,141,82,291,209,0.0,0.0,0.0,111500.0,0.0,-111500.0
<a href=/player/olivl001>olivl001</a>,Lester Oliveros,Detroit Tigers,TIGRS,1,2,1,3,2011,2012,1,No,0,0.02,-0.57,-0.59,18,191,173,0,786,786,64.0,0.0,-64.0,0.0,0.0,0.0
<a href=/player/olivm001>olivm001</a>,Miguel Olivo,Oakland Athletics,ATLTCS,2,2,3,5,2000,2006,6,No,0,2.64,8.41,5.77,197,479,282,523,879,356,70.0,744.0,674.0,0.0,0.0,0.0
<a href=/player/olivm001>olivm001</a>,Miguel Olivo,Chicago White Sox,WSOX,4,9,8,17,2004,2013,9,No,0,26.28,24.52,-1.76,2038,506,-1532,7101,844,-6257,1892.0,4790.0,2898.0,12920000.0,0.0,-12920000.0
<a href=/player/olivm001>olivm001</a>,Miguel Olivo,Seattle Mariners,MARNRS,1,1,2,3,2005,2005,0,No,0,0.91,0.04,-0.87,37,16,-21,124,37,-87,0.0,0.0,0.0,400000.0,0.0,-400000.0
<a href=/player/olivn101>olivn101</a>,Nate Oliver,Los Angeles Dodgers,DOGRS,2,3,4,7,1968,1972,4,No,0,9.28,10.09,0.81,488,474,-14,1876,1637,-239,0.0,0.0,0.0,55000.0,0.0,-55000.0
<a href=/player/olivn101>olivn101</a>,Nate Oliver,San Francisco Giants,GIANTS,1,1,1,2,1968,1969,1,No,0,0.0,0.0,0.0,1,0,-1,1,0,-1,0.0,0.0,0.0,16000.0,0.0,-16000.0
<a href=/player/olivn101>olivn101</a>,Nate Oliver,New York Yankees,YANKS,1,1,1,2,1969,1969,0,No,0,-0.33,0.0,0.33,44,0,-44,49,0,-49,0.0,0.0,0.0,18000.0,0.0,-18000.0
<a href=/player/olivo001>olivo001</a>,Omar Olivares,San Diego Padres,PADRS,2,2,3,5,1990,1993,3,No,0,7.2,0.15,-7.05,514,73,-441,1026,152,-874,1818.0,0.0,-1818.0,0.0,0.0,0.0
<a href=/player/olivo001>olivo001</a>,Omar Olivares,Detroit Tigers,TIGRS,7,19,13,32,1997,2002,5,No,1,3.14,14.72,11.58,1662,1186,-476,4060,2874,-1186,1346.0,2263.0,917.0,9860000.0,0.0,-9860000.0
<a href=/player/olivo001>olivo001</a>,Omar Olivares,Anaheim Angels,ANGELS,1,2,3,5,1999,2005,6,No,0,5.25,4.59,-0.66,273,402,129,988,1145,157,548.0,0.0,-548.0,3425000.0,0.0,-3425000.0
<a href=/player/olmer001>olmer001</a>,Ray Olmedo,Texas Rangers,RNGRS,1,1,1,2,2010,2011,1,No,0,0.0,-0.58,-0.58,0,89,89,0,284,284,0.0,0.0,0.0,0.0,0.0,0.0
<a href=/player/olmoe001>olmoe001</a>,Edgar Olmos,Chicago Cubs,CUBS,1,1,1,2,2016,2016,0,No,0,0.0,0.0,0.0,0,0,0,0,0,0,0.0,0.0,0.0,0.0,0.0,0.0
<a href=/player/olmol101>olmol101</a>,Luis Olmo,Brooklyn Dodgers,DOGRS,1,1,3,4,1949,1949,0,No,0,-0.88,0.0,0.88,90,0,-90,233,0,-233,0.0,0.0,0.0,0.0,0.0,0.0
<a href=/player/olmsa101>olmsa101</a>,Al Olmsted,St. Louis Cardinals,CARDS,12,29,23,52,1980,1998,18,No,5,83.63,121.95,38.32,6733,4994,-1739,20851,17148,-3703,6532.0,3025.0,-3507.0,1533333.0,0.0,-1533333.0
<a href=/player/olmsa101>olmsa101</a>,Al Olmsted,San Diego Padres,PADRS,7,12,13,25,1982,1993,11,No,1,64.79,33.72,-31.07,2384,3112,728,8892,7842,-1050,1163.0,2653.0,1490.0,905000.0,0.0,-905000.0
<a href=/player/olseb101>olseb101</a>,Barney Olsen,Chicago Cubs,CUBS,1,1,1,2,1947,1949,2,No,0,0.0,0.0,0.0,0,0,0,0,0,0,0.0,0.0,0.0,0.0,0.0,0.0
<a href=/player/olses001>olses001</a>,Scott Olsen,Florida Marlins,MARLNS,13,35,35,70,2008,2020,12,Yes,0,62.26,28.41,-33.85,4300,3021,-1279,10993,9069,-1924,7970.0,4278.0,-3692.0,67010000.0,0.0,-67010000.0
<a href=/player/olsog001>olsog001</a>,Gregg Olson,Cincinnati Reds,REDS,2,2,2,4,1996,1998,2,No,0,0.5,0.52,0.02,43,34,-9,0,79,79,129.0,0.0,-129.0,0.0,0.0,0.0
<a href=/player/olsog001>olsog001</a>,Gregg Olson,Detroit Tigers,TIGRS,1,1,2,3,1996,2001,5,No,0,-0.01,0.0,0.01,18,1,-17,0,0,0,28.0,0.0,-28.0,400000.0,0.0,-400000.0
<a href=/player/olsog003>olsog003</a>,Garrett Olson,Baltimore Orioles,ORLS,1,2,1,3,2009,2011,2,No,0,0.0,-1.12,-1.12,0,268,268,0,764,764,0.0,0.0,0.0,0.0,0.0,0.0
<a href=/player/olsog003>olsog003</a>,Garrett Olson,Chicago Cubs,CUBS,2,3,3,6,2009,2012,3,No,0,-3.45,0.86,4.31,326,217,-109,212,3,-209,676.0,339.0,-337.0,1625000.0,0.0,-1625000.0
<a href=/player/olsok101>olsok101</a>,Karl Olson,Boston Red Sox,RSOX,2,7,5,12,1955,1963,8,No,0,0.69,2.88,2.19,731,424,-307,812,1170,358,1712.0,707.0,-1005.0,7000.0,0.0,-7000.0
<a href=/player/olsok101>olsok101</a>,Karl Olson,Boston Red Sox,RSOX,1,1,1,2,1957,1957,0,No,0,-0.28,0.0,0.28,8,0,-8,15,0,-15,0.0,0.0,0.0,0.0,0.0,0.0
<a href=/player/olsom101>olsom101</a>,Marv Olson,Boston Red Sox,RSOX,1,3,1,4,1933,1937,4,No,0,0.0,5.56,5.56,0,404,404,0,1495,1495,0.0,0.0,0.0,8250.0,0.0,-8250.0
<a href=/player/olsom101>olsom101</a>,Marv Olson,New York Yankees,YANKS,3,7,3,10,1933,1948,15,No,0,-3.37,1.52,4.89,613,291,-322,2436,971,-1465,0.0,0.0,0.0,9000.0,0.0,-9000.0
<a href=/player/olsot001>olsot001</a>,Tim Olson,Texas Rangers,RNGRS,1,1,1,2,2006,2006,0,No,0,0.0,0.0,0.0,0,0,0,0,0,0,0.0,0.0,0.0,0.0,0.0,0.0
<a href=/player/olsot002>olsot002</a>,Tyler Olson,Seattle Mariners,MARNRS,1,1,1,2,2015,2015,0,No,0,0.0,0.0,0.0,0,0,0,0,0,0,0.0,0.0,0.0,0.0,0.0,0.0
<a href=/player/olsot002>olsot002</a>,Tyler Olson,Los Angeles Dodgers,DOGRS,1,2,2,4,2016,2016,0,Yes,0,1.39,0.0,-1.39,222,40,-182,607,83,-524,8.0,0.0,-8.0,0.0,0.0,0.0
<a href=/player/olt-m001>olt-m001</a>,Mike Olt,Texas Rangers,RNGRS,1,4,1,5,2013,2013,0,No,0,4.33,-0.09,-4.42,1129,13,-1116,283,0,-283,1426.0,253.0,-1173.0,0.0,0.0,0.0
<a href=/player/olwie001>olwie001</a>,Ed Olwine,New York Mets,METS,2,3,4,7,1986,1988,2,No,0,-0.58,0.0,0.58,247,0,-247,342,0,-342,269.0,0.0,-269.0,650000.0,0.0,-650000.0
<a href=/player/omalt001>omalt001</a>,Tom O'Malley,San Francisco Giants,GIANTS,1,1,2,3,1984,1984,0,No,0,-0.28,0.0,0.28,12,0,-12,16,0,-16,0.0,0.0,0.0,0.0,0.0,0.0
<a href=/player/omalt001>omalt001</a>,Tom O'Malley,Detroit Tigers,TIGRS,1,1,1,2,1985,1985,0,No,0,0.22,0.0,-0.22,64,0,-64,214,0,-214,0.0,0.0,0.0,0.0,0.0,0.0
<a href=/player/omalt001>omalt001</a>,Tom O'Malley,Texas Rangers,RNGRS,1,1,1,2,1988,1992,4,No,0,0.08,0.89,0.81,14,294,280,31,775,744,0.0,0.0,0.0,0.0,0.0,0.0
<a href=/player/omalt001>omalt001</a>,Tom O'Malley,Montreal Expos,NATEX,1,2,1,3,1989,1992,3,No,0,0.25,-0.1,-0.35,91,204,113,144,4,-140,0.0,350.0,350.0,0.0,0.0,0.0
<a href=/player/onear001>onear001</a>,Randy O'Neal,Detroit Tigers,TIGRS,2,3,4,7,1987,1987,0,No,0,-0.06,-0.17,-0.11,109,31,-78,95,74,-21,258.0,0.0,-258.0,425000.0,0.0,-425000.0
<a href=/player/onear001>onear001</a>,Randy O'Neal,Atlanta Braves,BRAVES,2,2,2,4,1987,1993,6,No,0,1.72,1.87,0.15,226,502,276,25,16,-9,607.0,945.0,338.0,215000.0,0.0,-215000.0
<a href=/player/oneas101>oneas101</a>,Skinny O'Neal,Beaumont,Beaumont,1,2,1,3,1924,1924,0,No,0,-0.96,0.0,0.96,36,0,-36,13,0,-13,104.0,0.0,-104.0,0.0,0.0,0.0
<a href=/player/oneib101>oneib101</a>,John O'Neill,Boston Red Sox,RSOX,1,1,1,2,1904,1904,0,No,0,-1.37,2.29,3.66,95,98,3,397,437,40,0.0,0.0,0.0,0.0,0.0,0.0
<a href=/player/oneih101>oneih101</a>,Harry O'Neill,Philadelphia Athletics,ATLTCS,2,7,2,9,1923,1927,4,No,0,0.0,2.68,2.68,0,472,472,0,1997,1997,0.0,0.0,0.0,12000.0,0.0,-12000.0
<a href=/player/oneij102>oneij102</a>,Jack O'Neill,St. Louis Cardinals,CARDS,4,6,9,15,1903,1914,11,No,0,50.1,19.67,-30.43,1069,1341,272,1762,4083,2321,8426.0,5469.0,-2957.0,2400.0,0.0,-2400.0
<a href=/player/oneij102>oneij102</a>,Jack O'Neill,Chicago Cubs,CUBS,1,2,1,3,1905,1910,5,No,0,1.88,3.49,1.61,264,262,-2,476,905,429,1653.0,0.0,-1653.0,0.0,0.0,0.0
<a href=/player/oneij104>oneij104</a>,Jim O'Neill,Washington Senators,TWINS,2,4,2,6,1924,1927,3,No,0,1.24,9.31,8.07,60,188,128,31,206,175,281.0,1671.0,1390.0,2100.0,0.0,-2100.0
<a href=/player/oneim102>oneim102</a>,Mickey O'Neil,New York Giants,GIANTS,1,5,1,6,1919,1926,7,No,0,8.66,14.34,5.68,964,460,-504,2314,555,-1759,3291.0,4306.0,1015.0,5412.0,0.0,-5412.0
<a href=/player/oneim102>oneim102</a>,Mickey O'Neil,Boston Braves,BRAVES,8,16,14,30,1925,1938,13,No,0,15.59,19.03,3.44,1577,2611,1034,4396,9724,5328,4040.0,1364.0,-2676.0,46800.0,0.0,-46800.0
<a href=/player/oneip001>oneip001</a>,Paul O'Neill,Cincinnati Reds,REDS,7,15,9,24,1992,2010,18,No,0,38.5,29.57,-8.93,1755,1640,-115,6377,5925,-452,2595.0,2089.0,-506.0,19233333.0,0.0,-19233333.0
<a href=/player/oneis101>oneis101</a>,Steve O'Neill,Cleveland Indians,INDINS,1,4,3,7,1924,1928,4,No,0,0.12,9.37,9.25,387,855,468,1555,3344,1789,0.0,0.0,0.0,0.0,0.0,0.0
<a href=/player/oneit001>oneit001</a>,Tyler O'Neill,Seattle Mariners,MARNRS,1,1,1,2,2017,2017,0,Yes,0,8.58,0.0,-8.58,309,11,-298,987,2,-985,0.0,110.0,110.0,0.0,0.0,0.0
<a href=/player/ontis001>ontis001</a>,Steve Ontiveros,Minnesota Twins,TWINS,1,1,1,2,1993,1993,0,No,0,0.82,0.0,-0.82,14,0,-14,0,0,0,54.0,0.0,-54.0,0.0,0.0,0.0
<a href=/player/ontis101>ontis101</a>,Steve Ontiveros,San Francisco Giants,GIANTS,15,30,32,62,1977,1998,21,No,2,51.49,73.51,22.02,3614,5339,1725,8817,8462,-355,5201.0,15628.0,10427.0,10639278.0,0.0,-10639278.0
<a href=/player/oquej001>oquej001</a>,Jose Oquendo,New York Mets,METS,2,3,3,6,1985,1986,1,No,0,15.41,0.0,-15.41,1225,0,-1225,3818,0,-3818,18.0,0.0,-18.0,0.0,0.0,0.0
<a href=/player/orave101>orave101</a>,Ernie Oravetz,Minnesota Twins,TWINS,1,2,2,4,1961,1961,0,No,0,0.0,-0.97,-0.97,0,59,59,0,114,114,0.0,63.0,63.0,0.0,0.0,0.0
<a href=/player/ordal001>ordal001</a>,Luis Ordaz,Cincinnati Reds,REDS,1,2,1,3,1995,1995,0,No,0,-0.85,0.0,0.85,79,0,-79,203,0,-203,0.0,0.0,0.0,0.0,0.0,0.0
<a href=/player/ordal001>ordal001</a>,Luis Ordaz,St. Louis Cardinals,CARDS,1,1,1,2,1999,2000,1,No,0,0.0,0.0,0.0,0,0,0,0,0,0,0.0,0.0,0.0,210000.0,0.0,-210000.0
<a href=/player/ordor001>ordor001</a>,Rey Ordonez,New York Mets,METS,1,1,2,3,2002,2003,1,No,0,0.68,0.0,-0.68,34,0,-34,124,0,-124,0.0,0.0,0.0,6250000.0,0.0,-6250000.0
<a href=/player/orenj101>orenj101</a>,Joe Orengo,New York Giants,GIANTS,2,4,3,7,1943,1945,2,No,0,-0.25,-0.04,0.21,36,72,36,28,39,11,123.0,375.0,252.0,0.0,0.0,0.0
<a href=/player/orenj101>orenj101</a>,Joe Orengo,Detroit Tigers,TIGRS,1,1,1,2,1944,1947,3,No,0,-0.17,-0.96,-0.79,17,232,215,19,719,700,0.0,0.0,0.0,3600.0,0.0,-3600.0
<a href=/player/orenj101>orenj101</a>,Joe Orengo,Brooklyn Dodgers,DOGRS,1,2,1,3,1943,1947,4,No,0,0.0,0.43,0.43,0,314,314,0,1177,1177,0.0,0.0,0.0,0.0,0.0,0.0
<a href=/player/oriek001>oriek001</a>,Kevin Orie,Chicago Cubs,CUBS,4,13,7,20,1998,2009,11,No,0,13.03,10.6,-2.43,859,1301,442,2754,2788,34,471.0,1208.0,737.0,7140000.0,0.0,-7140000.0
<a href=/player/orild101>orild101</a>,Don O'Riley,Kansas City Royals,ROYALS,1,2,2,4,1970,1974,4,No,0,5.15,1.5,-3.65,692,230,-462,2721,588,-2133,0.0,0.0,0.0,26000.0,0.0,-26000.0
<a href=/player/orlap001>orlap001</a>,Paulo Orlando,Chicago White Sox,WSOX,1,1,1,2,2008,2008,0,No,0,1.69,-0.27,-1.96,278,17,-261,918,0,-918,0.0,39.0,39.0,0.0,0.0,0.0
<a href=/player/orosj001>orosj001</a>,Jesse Orosco,Minnesota Twins,TWINS,4,6,7,13,1979,1985,6,No,0,15.63,11.86,-3.77,831,317,-514,71,727,656,2897.0,1804.0,-1093.0,0.0,0.0,0.0
<a href=/player/orosj001>orosj001</a>,Jesse Orosco,New York Mets,METS,6,16,9,25,1987,1993,6,No,2,82.7,21.53,-61.17,2390,667,-1723,1638,781,-857,14501.0,4350.0,-10151.0,4216000.0,0.0,-4216000.0
<a href=/player/orosj001>orosj001</a>,Jesse Orosco,Baltimore Orioles,ORLS,1,1,1,2,1999,2001,2,No,0,0.0,0.55,0.55,0,65,65,0,0,0,0.0,326.0,326.0,800000.0,0.0,-800000.0
<a href=/player/orosj001>orosj001</a>,Jesse Orosco,New York Mets,METS,1,1,1,2,2000,2005,5,No,0,-0.25,0.53,0.78,12,502,490,0,1169,1169,7.0,0.0,-7.0,0.0,0.0,0.0
<a href=/player/orosj001>orosj001</a>,Jesse Orosco,New York Yankees,YANKS,1,1,1,2,2003,2004,1,No,0,-0.03,0.23,0.26,8,6,-2,0,0,0,14.0,34.0,20.0,0.0,0.0,0.0
<a href=/player/orouf101>orouf101</a>,Frank O'Rourke,Toronto,Toronto,1,1,3,4,1920,1920,0,No,0,-1.21,0.0,1.21,137,0,-137,546,0,-546,0.0,0.0,0.0,0.0,0.0,0.0
<a href=/player/orouf101>orouf101</a>,Frank O'Rourke,Washington Senators,TWINS,2,3,3,6,1922,1933,11,No,0,2.2,14.57,12.37,219,710,491,852,2665,1813,0.0,616.0,616.0,0.0,0.0,0.0
<a href=/player/orouf101>orouf101</a>,Frank O'Rourke,Detroit Tigers,TIGRS,2,5,4,9,1927,1934,7,No,0,25.64,16.62,-9.02,1182,957,-225,3618,3579,-39,3712.0,0.0,-3712.0,12500.0,0.0,-12500.0
<a href=/player/orout101>orout101</a>,Tim O'Rourke,Baltimore Orioles,BLN,1,1,2,3,1893,1899,6,No,0,1.66,35.58,33.92,147,755,608,687,3472,2785,0.0,0.0,0.0,0.0,0.0,0.0
<a href=/player/orsij101>orsij101</a>,John Orsino,San Francisco Giants,GIANTS,10,18,16,34,1962,1972,10,No,0,36.27,10.66,-25.61,2635,1445,-1190,6319,1774,-4545,3135.0,5237.0,2102.0,50000.0,0.0,-50000.0
<a href=/player/orsij101>orsij101</a>,John Orsino,Baltimore Orioles,ORLS,15,30,27,57,1965,1994,29,No,3,51.7,93.7,42.0,3269,4873,1604,7351,11827,4476,12206.0,14416.0,2210.0,861833.0,0.0,-861833.0
<a href=/player/orsij101>orsij101</a>,John Orsino,New York Yankees,YANKS,2,3,2,5,1969,1973,4,No,0,0.33,1.09,0.76,63,350,287,8,1148,1140,181.0,31.0,-150.0,0.0,0.0,0.0
<a href=/player/orsuj001>orsuj001</a>,Joe Orsulak,Pittsburgh Pirates,PIRATS,2,2,3,5,1987,1992,5,No,0,7.97,0.0,-7.97,637,0,-637,2277,0,-2277,0.0,0.0,0.0,0.0,0.0,0.0
<a href=/player/orsuj001>orsuj001</a>,Joe Orsulak,Florida Marlins,MARLNS,4,9,9,18,1997,2012,15,No,2,8.19,25.06,16.87,569,1421,852,623,4127,3504,3020.0,2057.0,-963.0,6500000.0,0.0,-6500000.0
<a href=/player/ortaj001>ortaj001</a>,Jorge Orta,Cleveland Indians,INDINS,18,31,36,67,1981,2001,20,No,1,116.55,78.96,-37.59,6988,5496,-1492,21431,20127,-1304,7765.0,4126.0,-3639.0,20493332.0,0.0,-20493332.0
<a href=/player/ortaj001>ortaj001</a>,Jorge Orta,Los Angeles Dodgers,DOGRS,3,3,3,6,1982,1985,3,No,0,-0.66,1.56,2.22,81,274,193,196,171,-25,38.0,432.0,394.0,1000000.0,0.0,-1000000.0
<a href=/player/ortaj001>ortaj001</a>,Jorge Orta,New York Mets,METS,2,3,3,6,1983,1984,1,No,0,-2.31,-1.63,0.68,463,108,-355,1748,288,-1460,0.0,0.0,0.0,0.0,0.0,0.0
<a href=/player/ortaj001>ortaj001</a>,Jorge Orta,Toronto Blue Jays,BJAYS,1,1,1,2,1983,1985,2,No,0,1.28,-0.87,-2.15,359,105,-254,1182,289,-893,0.0,0.0,0.0,250000.0,0.0,-250000.0
<a href=/player/ortef101>ortef101</a>,Frank Ortenzio,Kansas City Royals,ROYALS,1,1,1,2,1976,1976,0,No,0,0.0,0.0,0.0,0,0,0,0,0,0,0.0,0.0,0.0,0.0,0.0,0.0
<a href=/player/ortep101>ortep101</a>,Phil Ortega,Los Angeles Dodgers,DOGRS,4,12,9,21,1964,1984,20,No,0,57.0,60.48,3.48,4290,2463,-1827,14544,7259,-7285,4034.0,7191.0,3157.0,163000.0,0.0,-163000.0
<a href=/player/ortha101>ortha101</a>,Al Orth,Washington Senators,TWINS,1,1,2,3,1904,1909,5,No,0,20.8,10.94,-9.86,393,470,77,575,592,17,3508.0,4615.0,1107.0,0.0,0.0,0.0
<a href=/player/ortid001>ortid001</a>,David Ortiz,Seattle Mariners,MARNRS,2,2,2,4,1996,1996,0,No,1,2.59,1.11,-1.48,455,28,-427,1693,113,-1580,0.0,0.0,0.0,0.0,0.0,0.0
<a href=/player/ortij001>ortij001</a>,Junior Ortiz,Pittsburgh Pirates,PIRATS,2,3,3,6,1983,1992,9,No,0,-1.54,-0.56,0.98,576,774,198,1492,1540,48,0.0,993.0,993.0,0.0,0.0,0.0
<a href=/player/ortij001>ortij001</a>,Junior Ortiz,Pittsburgh Pirates,PIRATS,2,3,2,5,1990,1994,4,No,0,1.68,0.42,-1.26,132,312,180,338,714,376,0.0,0.0,0.0,0.0,0.0,0.0
<a href=/player/ortij001>ortij001</a>,Junior Ortiz,Cleveland Indians,INDINS,1,1,2,3,1994,1994,0,No,0,0.29,0.0,-0.29,29,0,-29,86,0,-86,0.0,0.0,0.0,0.0,0.0,0.0
<a href=/player/ortij002>ortij002</a>,Javier Ortiz,Texas Rangers,RNGRS,2,3,3,6,1987,1989,2,No,0,0.0,-0.18,-0.18,0,3,3,0,0,0,0.0,22.0,22.0,0.0,0.0,0.0
<a href=/player/ortij002>ortij002</a>,Javier Ortiz,Los Angeles Dodgers,DOGRS,1,1,1,2,1989,1989,0,No,0,0.57,0.0,-0.57,77,0,-77,187,0,-187,0.0,0.0,0.0,0.0,0.0,0.0
<a href=/player/ortij003>ortij003</a>,Jose Ortiz,Oakland Athletics,ATLTCS,1,3,1,4,2001,2004,3,No,0,0.03,2.82,2.79,154,394,240,507,1663,1156,28.0,0.0,-28.0,201000.0,0.0,-201000.0
<a href=/player/ortij101>ortij101</a>,Jose Ortiz,Chicago White Sox,WSOX,4,5,7,12,1970,1975,5,No,0,0.12,0.95,0.83,86,167,81,189,439,250,0.0,6.0,6.0,9500.0,0.0,-9500.0
<a href=/player/ortil001>ortil001</a>,Luis Ortiz,Boston Red Sox,RSOX,4,8,8,16,1994,2002,8,No,0,1.6,9.74,8.14,416,630,214,1358,1420,62,371.0,1801.0,1430.0,6625000.0,0.0,-6625000.0
<a href=/player/ortil002>ortil002</a>,Luis Ortiz,Texas Rangers,RNGRS,3,5,4,9,2016,2018,2,Yes,0,3.83,1.66,-2.17,343,178,-165,233,474,241,460.0,162.0,-298.0,7350000.0,0.0,-7350000.0
<a href=/player/ortil002>ortil002</a>,Luis Ortiz,Milwaukee Brewers,BREWRS,1,3,1,4,2018,2018,0,No,0,5.49,-0.04,-5.53,219,46,-173,950,134,-816,17.0,0.0,-17.0,2550000.0,0.0,-2550000.0
<a href=/player/ortir001>ortir001</a>,Russ Ortiz,San Francisco Giants,GIANTS,2,4,3,7,2002,2010,8,No,0,3.3,1.02,-2.28,153,192,39,153,63,-90,1502.0,750.0,-752.0,4714500.0,0.0,-4714500.0
<a href=/player/ortir002>ortir002</a>,Ramon Ortiz,Anaheim Angels,ANGELS,1,1,1,2,2004,2009,5,No,0,-0.5,0.56,1.06,60,69,9,61,0,-61,514.0,504.0,-10.0,3266667.0,0.0,-3266667.0
<a href=/player/ortir002>ortir002</a>,Ramon Ortiz,Minnesota Twins,TWINS,1,1,1,2,2007,2010,3,No,0,-0.05,-0.07,-0.02,20,18,-2,2,36,34,39.0,0.0,-39.0,3100000.0,0.0,-3100000.0
<a href=/player/ortir101>ortir101</a>,Roberto Ortiz,Washington Senators,TWINS,1,1,2,3,1942,1946,4,No,0,0.0,0.0,0.0,0,0,0,0,0,0,0.0,0.0,0.0,0.0,0.0,0.0
<a href=/player/ortir101>ortir101</a>,Roberto Ortiz,Brooklyn Dodgers,DOGRS,1,1,1,2,1943,1945,2,No,0,-0.38,-0.33,0.05,165,56,-109,573,126,-447,0.0,0.0,0.0,0.0,0.0,0.0
<a href=/player/orwoo101>orwoo101</a>,Ossie Orwoll,Milwaukee,Milwaukee,2,2,4,6,1927,1929,2,No,0,0.9,0.0,-0.9,133,0,-133,244,0,-244,407.0,0.0,-407.0,0.0,0.0,0.0
<a href=/player/orwoo101>orwoo101</a>,Ossie Orwoll,Philadelphia Athletics,ATLTCS,1,2,1,3,1930,1930,0,No,0,0.0,0.0,0.0,0,0,0,0,0,0,0.0,0.0,0.0,0.0,0.0,0.0
<a href=/player/osbob101>osbob101</a>,Bobo Osborne,Detroit Tigers,TIGRS,1,1,1,2,1963,1968,5,No,0,-0.15,-0.6,-0.45,125,52,-73,416,54,-362,0.0,0.0,0.0,0.0,0.0,0.0
<a href=/player/osbob102>osbob102</a>,Bob Osborn,Pittsburgh Pirates,PIRATS,2,4,2,6,1932,1940,8,No,0,-0.39,22.08,22.47,8,680,672,3,632,629,28.0,4937.0,4909.0,7000.0,0.0,-7000.0
<a href=/player/osboo101>osboo101</a>,Ozzie Osborn,Cincinnati Reds,REDS,1,1,1,2,1974,1974,0,No,0,0.41,0.0,-0.41,24,0,-24,0,0,0,174.0,0.0,-174.0,0.0,0.0,0.0
<a href=/player/osboo101>osboo101</a>,Ozzie Osborn,Chicago White Sox,WSOX,5,8,7,15,1975,1985,10,No,1,12.65,5.98,-6.67,638,673,35,1614,2532,918,1538.0,16.0,-1522.0,0.0,0.0,0.0
<a href=/player/osbop101>osbop101</a>,Pat Osburn,Cincinnati Reds,REDS,4,4,4,8,1974,1979,5,No,0,3.77,-0.17,-3.94,356,130,-226,980,246,-734,35.0,0.0,-35.0,0.0,0.0,0.0
<a href=/player/osbop101>osbop101</a>,Pat Osburn,Milwaukee Brewers,BREWRS,1,1,1,2,1975,1975,0,No,0,0.0,0.0,0.0,0,0,0,0,0,0,0.0,0.0,0.0,16000.0,0.0,-16000.0
<a href=/player/osicj001>osicj001</a>,Josh Osich,Boston Red Sox,RSOX,1,1,1,2,2020,2021,1,Yes,0,-0.47,0.0,0.47,4,0,-4,0,0,0,8.0,0.0,-8.0,850000.0,0.0,-850000.0
<a href=/player/osind101>osind101</a>,Dan Osinski,Kansas City Athletics,ATLTCS,1,1,2,3,1962,1962,0,No,0,2.17,0.0,-2.17,254,0,-254,84,0,-84,920.0,0.0,-920.0,0.0,0.0,0.0
<a href=/player/osind101>osind101</a>,Dan Osinski,California Angels,ANGELS,2,2,4,6,1964,1965,1,No,0,1.41,-0.88,-2.29,165,37,-128,66,24,-42,250.0,59.0,-191.0,12500.0,0.0,-12500.0
<a href=/player/osind101>osind101</a>,Dan Osinski,Atlanta Braves,BRAVES,5,10,8,18,1965,1968,3,No,0,-0.38,-0.18,0.2,622,407,-215,842,564,-278,716.0,549.0,-167.0,15000.0,0.0,-15000.0
<a href=/player/ostec103>ostec103</a>,Claude Osteen,Cincinnati Reds,REDS,1,1,2,3,1961,1961,0,No,0,9.22,0.0,-9.22,237,0,-237,239,0,-239,1914.0,0.0,-1914.0,0.0,0.0,0.0
<a href=/player/ostec103>ostec103</a>,Claude Osteen,Washington Senators,RNGRS,26,45,52,97,1964,1992,28,No,2,142.7,104.34,-38.36,8431,6607,-1824,19421,19320,-101,25577.0,10933.0,-14644.0,342900.0,0.0,-342900.0
<a href=/player/ostec103>ostec103</a>,Claude Osteen,Los Angeles Dodgers,DOGRS,2,6,3,9,1973,1984,11,No,0,-0.05,31.52,31.57,1550,1541,-9,5211,5934,723,415.0,0.0,-415.0,100000.0,0.0,-100000.0
<a href=/player/ostec103>ostec103</a>,Claude Osteen,Houston Astros,ASTROS,3,3,4,7,1974,1979,5,No,0,0.06,-0.71,-0.77,58,102,44,39,65,26,349.0,602.0,253.0,100000.0,0.0,-100000.0
<a href=/player/osted101>osted101</a>,Darrell Osteen,Cincinnati Reds,REDS,1,2,1,3,1967,1968,1,No,0,0.17,0.0,-0.17,59,0,-59,90,0,-90,17.0,0.0,-17.0,0.0,0.0,0.0
<a href=/player/osted101>osted101</a>,Darrell Osteen,Oakland Athletics,ATLTCS,2,5,2,7,1971,1972,1,No,0,-0.2,0.7,0.9,128,78,-50,155,190,35,313.0,0.0,-313.0,33250.0,0.0,-33250.0
<a href=/player/ostef101>ostef101</a>,Fritz Ostermueller,St.Louis Browns,ORLS,1,2,1,3,1943,1943,0,No,0,0.96,-1.44,-2.4,36,20,-16,28,16,-12,207.0,157.0,-50.0,12000.0,0.0,-12000.0
<a href=/player/ostef101>ostef101</a>,Fritz Ostermueller,Brooklyn Dodgers,DOGRS,1,3,1,4,1944,1946,2,No,0,-0.35,6.14,6.49,4,237,233,0,969,969,5.0,0.0,-5.0,0.0,0.0,0.0
<a href=/player/oster101>oster101</a>,Red Ostergard,Chicago White Sox,WSOX,1,4,1,5,1924,1924,0,No,0,0.0,-0.04,-0.04,0,6,6,0,5,5,0.0,0.0,0.0,0.0,0.0,0.0
<a href=/player/ostij001>ostij001</a>,Jimmy Osting,Atlanta Braves,BRAVES,6,11,8,19,2000,2013,13,No,2,-2.19,26.51,28.7,234,947,713,131,621,490,1036.0,5596.0,4560.0,977500.0,0.0,-977500.0
<a href=/player/ostrb101>ostrb101</a>,Brian Ostrosser,New York Mets,METS,1,1,1,2,1974,1974,0,No,0,0.0,0.0,0.0,0,0,0,0,0,0,0.0,0.0,0.0,0.0,0.0,0.0
<a href=/player/ostrj101>ostrj101</a>,Joe Ostrowski,Boston Red Sox,RSOX,2,8,5,13,1947,1955,8,No,0,6.5,21.93,15.43,835,962,127,1487,3127,1640,2844.0,2066.0,-778.0,10000.0,0.0,-10000.0
<a href=/player/ostrj101>ostrj101</a>,Joe Ostrowski,St.Louis Browns,ORLS,11,21,24,45,1950,1960,10,No,0,30.8,26.53,-4.27,2470,2935,465,5868,7663,1795,6528.0,5672.0,-856.0,55500.0,0.0,-55500.0
<a href=/player/ostrj102>ostrj102</a>,Johnny Ostrowski,Chicago Cubs,CUBS,1,1,2,3,1949,1949,0,No,0,0.26,0.0,-0.26,71,0,-71,235,0,-235,0.0,0.0,0.0,0.0,0.0,0.0
<a href=/player/ostrj102>ostrj102</a>,Johnny Ostrowski,Chicago White Sox,WSOX,10,25,21,46,1950,1963,13,No,0,23.73,52.01,28.28,4184,3652,-532,12734,11891,-843,4692.0,2309.0,-2383.0,109500.0,0.0,-109500.0
<a href=/player/osuls001>osuls001</a>,Sean O'Sullivan,Anaheim Angels,ANGELS,2,3,2,5,2010,2015,5,No,0,-1.93,6.97,8.9,238,527,289,631,1904,1273,756.0,0.0,-756.0,0.0,0.0,0.0
<a href=/player/osuna001>osuna001</a>,Al Osuna,Houston Astros,ASTROS,1,1,1,2,1994,1994,0,No,0,-0.08,0.0,0.08,30,0,-30,0,0,0,26.0,0.0,-26.0,0.0,0.0,0.0
<a href=/player/osuna002>osuna002</a>,Antonio Osuna,Los Angeles Dodgers,DOGRS,2,5,5,10,2001,2001,0,No,0,0.16,0.96,0.8,66,24,-42,0,27,27,216.0,238.0,22.0,0.0,0.0,0.0
<a href=/player/osuna002>osuna002</a>,Antonio Osuna,Chicago White Sox,WSOX,4,9,6,15,2003,2010,7,No,2,-3.34,5.27,8.61,321,142,-179,107,7,-100,601.0,996.0,395.0,0.0,0.0,0.0
<a href=/player/osunr001>osunr001</a>,Roberto Osuna,Toronto Blue Jays,BJAYS,2,2,4,6,2018,2021,3,Yes,0,2.96,2.45,-0.51,98,92,-6,0,0,0,276.0,254.0,-22.0,5300000.0,0.0,-5300000.0
<a href=/player/oswar001>oswar001</a>,Roy Oswalt,Houston Astros,ASTROS,7,13,15,28,2010,2020,10,No,0,28.48,11.63,-16.85,1879,903,-976,4452,2193,-2259,4887.0,2930.0,-1957.0,23335000.0,0.0,-23335000.0
<a href=/player/otanw001>otanw001</a>,Willis Otanez,Los Angeles Dodgers,DOGRS,1,2,1,3,1995,1996,1,No,0,0.25,-0.12,-0.37,108,92,-16,250,358,108,0.0,0.0,0.0,0.0,0.0,0.0
<a href=/player/oterr001>oterr001</a>,Ricky Otero,New York Mets,METS,1,1,1,2,1995,1995,0,No,0,-0.42,0.0,0.42,154,0,-154,623,0,-623,0.0,0.0,0.0,109000.0,0.0,-109000.0
<a href=/player/otisa001>otisa001</a>,Amos Otis,New York Mets,METS,1,2,1,3,1969,1970,1,No,0,49.09,1.86,-47.23,1971,99,-1872,8041,399,-7642,642.0,0.0,-642.0,0.0,0.0,0.0
<a href=/player/otood101>otood101</a>,Denny O'Toole,Chicago White Sox,WSOX,2,5,2,7,1973,1973,0,No,0,6.5,0.0,-6.5,800,0,-800,1477,0,-1477,2061.0,0.0,-2061.0,32700.0,0.0,-32700.0
<a href=/player/otood101>otood101</a>,Denny O'Toole,St. Louis Cardinals,CARDS,1,1,1,2,1973,1973,0,No,0,0.0,0.0,0.0,0,0,0,0,0,0,0.0,0.0,0.0,0.0,0.0,0.0
<a href=/player/otooj101>otooj101</a>,Jim O'Toole,Cincinnati Reds,REDS,2,3,2,5,1966,1968,2,No,0,0.22,-0.72,-0.94,89,55,-34,104,145,41,180.0,0.0,-180.0,29000.0,0.0,-29000.0
<a href=/player/otsua001>otsua001</a>,Akinori Otsuka,San Diego Padres,PADRS,9,21,20,41,2006,2021,15,Yes,0,51.12,29.32,-21.8,2292,1830,-462,7839,5012,-2827,1512.0,4191.0,2679.0,15535200.0,0.0,-15535200.0
<a href=/player/ott-e101>ott-e101</a>,Ed Ott,Pittsburgh Pirates,PIRATS,2,3,3,6,1981,1986,5,No,0,0.66,9.75,9.09,117,671,554,351,2696,2345,43.0,0.0,-43.0,0.0,0.0,0.0
<a href=/player/ottaa001>ottaa001</a>,Adam Ottavino,New York Yankees,YANKS,1,2,1,3,2021,2021,0,No,0,0.83,0.0,-0.83,75,0,-75,0,0,0,186.0,0.0,-186.0,0.0,0.0,0.0
<a href=/player/ottej101>ottej101</a>,Jim Otten,Chicago White Sox,WSOX,1,1,1,2,1977,1977,0,No,0,-1.69,0.0,1.69,110,0,-110,8,0,-8,273.0,0.0,-273.0,0.0,0.0,0.0
<a href=/player/ottog001>ottog001</a>,Glenn Otto,New York Yankees,YANKS,1,4,3,7,2021,2021,0,Yes,0,-0.87,0.78,1.65,6,82,76,0,228,228,70.0,57.0,-13.0,0.0,0.0,0.0
<a href=/player/outlj101>outlj101</a>,Jimmy Outlaw,St. Louis Cardinals,CARDS,1,1,2,3,1938,1938,0,No,0,0.0,0.0,0.0,0,0,0,0,0,0,0.0,0.0,0.0,0.0,0.0,0.0
<a href=/player/outlj101>outlj101</a>,Jimmy Outlaw,Brooklyn Dodgers,DOGRS,1,2,2,4,1938,1940,2,No,0,2.67,-0.72,-3.39,454,199,-255,1715,406,-1309,0.0,317.0,317.0,0.0,0.0,0.0
<a href=/player/outmj001>outmj001</a>,Josh Outman,Philadelphia Phillies,PHILS,2,4,2,6,2008,2012,4,No,0,4.22,2.37,-1.85,203,206,3,28,216,188,867.0,1849.0,982.0,8500000.0,0.0,-8500000.0
<a href=/player/outmj001>outmj001</a>,Josh Outman,Oakland Athletics,ATLTCS,2,3,2,5,2012,2014,2,No,0,3.45,4.02,0.57,352,317,-35,551,851,300,434.0,217.0,-217.0,3675000.0,0.0,-3675000.0
<a href=/player/outmj001>outmj001</a>,Josh Outman,Colorado Rockies,ROCKS,1,1,1,2,2013,2015,2,No,0,0.36,2.15,1.79,33,183,150,0,538,538,74.0,0.0,-74.0,675000.0,0.0,-675000.0
<a href=/player/outmj001>outmj001</a>,Josh Outman,Cleveland Indians,INDINS,1,1,1,2,2014,2014,0,No,0,0.24,0.0,-0.24,9,0,-9,0,0,0,11.0,0.0,-11.0,1250000.0,0.0,-1250000.0
<a href=/player/overd001>overd001</a>,Dillon Overton,Oakland Athletics,ATLTCS,1,1,1,2,2017,2017,0,Yes,0,-0.27,0.0,0.27,10,0,-10,0,0,0,55.0,0.0,-55.0,0.0,0.0,0.0
<a href=/player/overl001>overl001</a>,Lyle Overbay,Arizona Diamondbacks,DBACKS,3,10,7,17,2003,2008,5,No,2,15.65,2.42,-13.23,2019,225,-1794,5161,413,-4748,3052.0,809.0,-2243.0,3950667.0,0.0,-3950667.0
<a href=/player/overl001>overl001</a>,Lyle Overbay,Milwaukee Brewers,BREWRS,4,8,7,15,2005,2012,7,No,2,36.63,9.25,-27.38,2335,589,-1746,9079,878,-8201,310.0,3140.0,2830.0,860000.0,0.0,-860000.0
<a href=/player/overo101>overo101</a>,Orval Overall,Cincinnati Reds,REDS,1,2,1,3,1906,1906,0,No,0,19.28,0.58,-18.7,329,40,-289,440,54,-386,3405.0,448.0,-2957.0,0.0,0.0,0.0
<a href=/player/overs101>overs101</a>,Stubby Overmire,St.Louis Browns,ORLS,2,3,4,7,1951,1954,3,No,0,-1.09,2.85,3.94,54,211,157,29,293,264,182.0,956.0,774.0,19250.0,0.0,-19250.0
<a href=/player/owchb001>owchb001</a>,Bob Owchinko,San Diego Padres,PADRS,6,12,11,23,1980,1989,9,No,1,32.03,18.95,-13.08,2570,1369,-1201,8500,3065,-5435,2306.0,4252.0,1946.0,0.0,0.0,0.0
<a href=/player/owchb001>owchb001</a>,Bob Owchinko,Cleveland Indians,INDINS,6,11,12,23,1980,2011,31,No,2,35.2,55.22,20.02,1530,2690,1160,5654,9199,3545,2682.0,4370.0,1688.0,1767500.0,0.0,-1767500.0
<a href=/player/owchb001>owchb001</a>,Bob Owchinko,Pittsburgh Pirates,PIRATS,2,3,4,7,1981,1983,2,No,0,3.29,-0.91,-4.2,493,38,-455,1402,17,-1385,424.0,197.0,-227.0,0.0,0.0,0.0
<a href=/player/owend001>owend001</a>,Dave Owen,Chicago Cubs,CUBS,1,1,1,2,1985,1988,3,No,0,0.0,0.74,0.74,0,265,265,0,593,593,0.0,0.0,0.0,0.0,0.0,0.0
<a href=/player/owend001>owend001</a>,Dave Owen,Texas Rangers,RNGRS,1,1,1,2,1987,1987,0,No,0,-0.22,0.0,0.22,7,0,-7,5,0,-5,0.0,0.0,0.0,0.0,0.0,0.0
<a href=/player/owene001>owene001</a>,Eric Owens,Cincinnati Reds,REDS,1,1,1,2,1998,1998,0,No,0,0.6,0.0,-0.6,250,0,-250,860,0,-860,0.0,0.0,0.0,0.0,0.0,0.0
<a href=/player/owene001>owene001</a>,Eric Owens,San Diego Padres,PADRS,7,14,12,26,2001,2010,9,No,2,6.07,13.68,7.61,986,984,-2,3612,3250,-362,532.0,273.0,-259.0,12382300.0,0.0,-12382300.0
<a href=/player/owenh001>owenh001</a>,Henry Owens,New York Mets,METS,2,9,5,14,2006,2010,4,No,0,11.2,-1.8,-13.0,974,362,-612,1347,182,-1165,2746.0,356.0,-2390.0,3398000.0,0.0,-3398000.0
<a href=/player/owenj002>owenj002</a>,Jerry Owens,Washington Nationals,NATEX,1,1,1,2,2005,2008,3,No,0,0.79,0.37,-0.42,129,33,-96,430,99,-331,0.0,0.0,0.0,0.0,0.0,0.0
<a href=/player/owenj101>owenj101</a>,Jim Owens,Philadelphia Phillies,PHILS,6,10,12,22,1962,1977,15,No,0,1.53,9.25,7.72,412,1621,1209,897,4956,4059,448.0,628.0,180.0,70000.0,0.0,-70000.0
<a href=/player/owenm101>owenm101</a>,Mickey Owen,St. Louis Cardinals,CARDS,1,1,3,4,1940,1942,2,No,0,3.28,0.16,-3.12,521,111,-410,1916,388,-1528,0.0,0.0,0.0,0.0,0.0,0.0
<a href=/player/owenm102>owenm102</a>,Marv Owen,Detroit Tigers,TIGRS,5,17,11,28,1937,1952,15,No,0,24.1,51.38,27.28,3640,2564,-1076,12152,7653,-4499,3951.0,7313.0,3362.0,74300.0,0.0,-74300.0
<a href=/player/owenr001>owenr001</a>,Rudy Owens,Pittsburgh Pirates,PIRATS,1,3,1,4,2012,2014,2,No,0,1.62,0.18,-1.44,191,63,-128,764,59,-705,17.0,493.0,476.0,0.0,0.0,0.0
<a href=/player/owens001>owens001</a>,Spike Owen,Boston Red Sox,RSOX,1,2,2,4,1988,1993,5,No,0,6.42,6.16,-0.26,552,597,45,1976,1669,-307,0.0,1455.0,1455.0,525000.0,0.0,-525000.0
<a href=/player/owens001>owens001</a>,Spike Owen,New York Yankees,YANKS,1,2,1,3,1993,1993,0,No,0,1.15,0.0,-1.15,164,0,-164,558,0,-558,0.0,0.0,0.0,2250000.0,0.0,-2250000.0
<a href=/player/owens001>owens001</a>,Spike Owen,Seattle Mariners,MARNRS,3,5,8,13,1986,1989,3,No,0,0.54,-0.06,-0.6,445,432,-13,1461,1346,-115,0.0,625.0,625.0,215000.0,0.0,-215000.0
<a href=/player/owinm001>owinm001</a>,Micah Owings,Arizona Diamondbacks,DBACKS,1,3,2,5,2008,2008,0,No,0,-0.17,-0.36,-0.19,138,44,-94,113,187,74,459.0,0.0,-459.0,402000.0,0.0,-402000.0
<a href=/player/ownbr001>ownbr001</a>,Rick Ownbey,New York Mets,METS,1,2,1,3,1983,1989,6,No,0,-0.78,26.61,27.39,253,880,627,88,3684,3596,994.0,0.0,-994.0,0.0,0.0,0.0
<a href=/player/oyler101>oyler101</a>,Ray Oyler,Milwaukee Brewers,BREWRS,16,29,31,60,1969,1986,17,No,0,56.11,55.7,-0.41,3782,3364,-418,9776,9018,-758,7371.0,9266.0,1895.0,829901.0,0.0,-829901.0
<a href=/player/ozunm001>ozunm001</a>,Marcell Ozuna,Miami Marlins,MARLNS,2,2,5,7,2017,2021,4,Yes,0,10.61,0.21,-10.4,351,224,-127,1232,487,-745,711.0,109.0,-602.0,3500000.0,0.0,-3500000.0
<a href=/player/ozunp001>ozunp001</a>,Pablo Ozuna,St. Louis Cardinals,CARDS,7,12,11,23,1998,2019,21,Yes,4,10.35,24.54,14.19,1808,1669,-139,1715,5353,3638,2044.0,547.0,-1497.0,3363000.0,0.0,-3363000.0
<a href=/player/ozunp001>ozunp001</a>,Pablo Ozuna,Florida Marlins,MARLNS,4,9,11,20,2002,2015,13,No,0,11.51,22.72,11.21,893,1533,640,2983,2710,-273,1797.0,5078.0,3281.0,13177000.0,0.0,-13177000.0
<a href=/player/pacej001>pacej001</a>,John Pacella,New York Mets,METS,1,2,1,3,1980,1982,2,No,0,-0.04,-2.0,-1.96,34,82,48,50,50,0,0.0,501.0,501.0,0.0,0.0,0.0
<a href=/player/pacej001>pacej001</a>,John Pacella,San Diego Padres,PADRS,5,10,10,20,1981,1989,8,No,1,31.59,15.32,-16.27,2540,1209,-1331,8500,2443,-6057,1963.0,4252.0,2289.0,0.0,0.0,0.0
<a href=/player/pacej001>pacej001</a>,John Pacella,New York Yankees,YANKS,4,8,8,16,1982,1992,10,No,0,8.27,12.89,4.62,1161,565,-596,2474,1712,-762,2564.0,669.0,-1895.0,913333.0,0.0,-913333.0
<a href=/player/pacej001>pacej001</a>,John Pacella,Minnesota Twins,TWINS,1,1,1,2,1982,1985,3,No,0,0.0,0.93,0.93,0,95,95,0,0,0,0.0,337.0,337.0,0.0,0.0,0.0
<a href=/player/pacha001>pacha001</a>,Alex Pacheco,Montreal Expos,NATEX,4,7,8,15,1996,2015,19,No,2,7.51,27.66,20.15,330,1142,812,781,3109,2328,1820.0,3591.0,1771.0,7545000.0,0.0,-7545000.0
<a href=/player/pacip001>pacip001</a>,Pat Pacillo,Cincinnati Reds,REDS,1,2,3,5,1988,1992,4,No,0,0.54,1.86,1.32,53,699,646,157,1778,1621,0.0,41.0,41.0,157500.0,0.0,-157500.0
<a href=/player/pacip001>pacip001</a>,Pat Pacillo,Montreal Expos,NATEX,1,1,1,2,1990,1992,2,No,0,0.0,-0.62,-0.62,0,55,55,0,144,144,0.0,0.0,0.0,0.0,0.0,0.0
<a href=/player/pacit001>pacit001</a>,Tom Paciorek,Los Angeles Dodgers,DOGRS,1,4,2,6,1975,1984,9,No,0,-0.88,19.14,20.02,1504,1261,-243,5163,4749,-414,0.0,0.0,0.0,0.0,0.0,0.0
<a href=/player/pacit001>pacit001</a>,Tom Paciorek,Seattle Mariners,MARNRS,2,2,4,6,1981,1983,2,No,0,2.36,-0.03,-2.39,424,260,-164,1520,924,-596,0.0,0.0,0.0,85000.0,0.0,-85000.0
<a href=/player/pacit001>pacit001</a>,Tom Paciorek,Chicago White Sox,WSOX,5,8,8,16,1985,1994,9,No,0,14.44,7.13,-7.31,431,523,92,125,827,702,4103.0,4503.0,400.0,1263333.0,0.0,-1263333.0
<a href=/player/packg101>packg101</a>,Gene Packard,St. Louis Cardinals,CARDS,4,7,6,13,1919,1928,9,No,0,6.49,22.08,15.59,1385,1345,-40,4793,5431,638,403.0,0.0,-403.0,33500.0,0.0,-33500.0
<a href=/player/paddc001>paddc001</a>,Chris Paddack,Miami Marlins,MARLNS,1,1,1,2,2016,2016,0,No,0,1.91,-0.78,-2.69,109,77,-32,88,0,-88,924.0,110.0,-814.0,0.0,0.0,0.0
<a href=/player/paddd102>paddd102</a>,Dick Padden,Pittsburgh Pirates,PIRATS,2,4,2,6,1898,1901,3,No,0,1.28,0.36,-0.92,408,35,-373,1684,149,-1535,0.0,0.0,0.0,0.0,0.0,0.0
<a href=/player/paddt101>paddt101</a>,Tom Padden,Baltimore,Baltimore,1,2,3,5,1930,1930,0,No,0,-0.48,0.0,0.48,34,0,-34,24,0,-24,173.0,0.0,-173.0,0.0,0.0,0.0
<a href=/player/paddt101>paddt101</a>,Tom Padden,Pittsburgh Pirates,PIRATS,4,7,4,11,1937,1946,9,No,0,3.24,18.29,15.05,164,1051,887,641,3703,3062,0.0,666.0,666.0,0.0,0.0,0.0
<a href=/player/paddt101>paddt101</a>,Tom Padden,New York Giants,GIANTS,3,10,6,16,1939,1954,15,No,0,0.0,7.09,7.09,0,765,765,0,2631,2631,0.0,172.0,172.0,6000.0,0.0,-6000.0
<a href=/player/padgd101>padgd101</a>,Don Padgett,St. Louis Cardinals,CARDS,1,1,3,4,1941,1941,0,No,0,-0.17,0.0,0.17,19,0,-19,34,0,-34,0.0,0.0,0.0,8000.0,0.0,-8000.0
<a href=/player/padgd101>padgd101</a>,Don Padgett,Boston Braves,BRAVES,1,1,1,2,1947,1947,0,No,0,-0.21,0.26,0.47,111,54,-57,254,6,-248,0.0,105.0,105.0,0.0,0.0,0.0
<a href=/player/padij001>padij001</a>,Juan Padilla,Minnesota Twins,TWINS,1,1,1,2,2003,2003,0,No,0,0.23,-0.03,-0.26,6,8,2,0,0,0,34.0,14.0,-20.0,0.0,0.0,0.0
<a href=/player/padij002>padij002</a>,Jorge Padilla,Toronto Blue Jays,BJAYS,1,1,1,2,2010,2010,0,No,0,0.0,0.0,0.0,0,0,0,0,0,0,0.0,0.0,0.0,0.0,0.0,0.0
<a href=/player/padiv001>padiv001</a>,Vicente Padilla,Arizona Diamondbacks,DBACKS,9,20,18,38,2000,2012,12,No,3,42.56,26.41,-16.15,3086,1039,-2047,7001,1054,-5947,9526.0,4276.0,-5250.0,24075667.0,0.0,-24075667.0
<a href=/player/padiv001>padiv001</a>,Vicente Padilla,Philadelphia Phillies,PHILS,1,1,1,2,2005,2006,1,No,0,4.08,0.0,-4.08,107,0,-107,10,0,-10,1798.0,0.0,-1798.0,3200000.0,0.0,-3200000.0
<a href=/player/padlk001>padlk001</a>,Kevin Padlo,Colorado Rockies,ROCKS,1,2,2,4,2016,2020,4,Yes,0,4.27,1.19,-3.08,307,448,141,1191,8,-1183,0.0,649.0,649.0,0.0,0.0,0.0
<a href=/player/paepd101>paepd101</a>,Dennis Paepke,California Angels,ANGELS,4,9,7,16,1968,1990,22,No,0,52.18,61.82,9.64,2063,2537,474,5135,9859,4724,8249.0,1533.0,-6716.0,230000.0,0.0,-230000.0
<a href=/player/pafka101>pafka101</a>,Andy Pafko,Chicago Cubs,CUBS,9,26,24,50,1951,1965,14,No,0,14.31,21.74,7.43,2452,2862,410,6527,5620,-907,3090.0,5461.0,2371.0,143500.0,0.0,-143500.0
<a href=/player/pafka101>pafka101</a>,Andy Pafko,Brooklyn Dodgers,DOGRS,1,1,2,3,1953,1953,0,No,0,4.62,0.0,-4.62,658,0,-658,2087,0,-2087,0.0,0.0,0.0,0.0,0.0,0.0
<a href=/player/pagaa001>pagaa001</a>,Angel Pagan,Chicago Cubs,CUBS,1,1,2,3,2008,2008,0,No,0,10.81,0.0,-10.81,393,0,-393,1646,0,-1646,0.0,0.0,0.0,0.0,0.0,0.0
<a href=/player/pagaa001>pagaa001</a>,Angel Pagan,New York Mets,METS,1,1,2,3,2011,2012,1,No,0,6.46,1.51,-4.95,583,247,-336,2471,434,-2037,0.0,191.0,191.0,3500000.0,0.0,-3500000.0
<a href=/player/pagad101>pagad101</a>,Dave Pagan,New York Yankees,YANKS,14,28,25,53,1976,2001,25,No,1,121.7,35.26,-86.44,6187,2228,-3959,13911,5384,-8527,21228.0,6192.0,-15036.0,4415000.0,0.0,-4415000.0
<a href=/player/pagad101>pagad101</a>,Dave Pagan,Seattle Mariners,MARNRS,3,8,8,16,1977,1985,8,No,0,8.88,8.95,0.07,491,533,42,632,1358,726,2632.0,2699.0,67.0,175000.0,0.0,-175000.0
<a href=/player/pagae001>pagae001</a>,Emilio Pagan,Seattle Mariners,MARNRS,1,2,1,3,2017,2019,2,No,0,0.24,-0.47,-0.71,59,180,121,0,711,711,186.0,0.0,-186.0,0.0,0.0,0.0
<a href=/player/pagae001>pagae001</a>,Emilio Pagan,Oakland Athletics,ATLTCS,2,4,3,7,2018,2019,1,Yes,0,3.56,-0.15,-3.71,264,139,-125,615,518,-97,210.0,0.0,-210.0,4147500.0,0.0,-4147500.0
<a href=/player/pagae001>pagae001</a>,Emilio Pagan,Tampa Bay Devil Rays,RAYS,1,1,2,3,2020,2020,0,Yes,0,-0.32,1.05,1.37,154,47,-107,2,159,157,256.0,0.0,-256.0,0.0,0.0,0.0
<a href=/player/pagaj101>pagaj101</a>,Jose Pagan,San Francisco Giants,GIANTS,1,1,1,2,1965,1966,1,No,0,3.44,-0.4,-3.84,625,112,-513,1710,439,-1271,0.0,0.0,0.0,0.0,0.0,0.0
<a href=/player/pagek101>pagek101</a>,Karl Pagel,Chicago Cubs,CUBS,3,5,3,8,1980,1982,2,No,0,1.93,-0.08,-2.01,233,68,-165,710,227,-483,0.0,0.0,0.0,0.0,0.0,0.0
<a href=/player/pagem001>pagem001</a>,Mitchell Page,Pittsburgh Pirates,PIRATS,5,10,11,21,1977,1988,11,No,0,53.71,31.99,-21.72,2929,1675,-1254,9660,6568,-3092,5429.0,149.0,-5280.0,807000.0,0.0,-807000.0
<a href=/player/pagep101>pagep101</a>,Phil Page,Seattle,Seattle,1,1,1,2,1934,1934,0,No,0,-0.05,0.0,0.05,12,0,-12,1,0,-1,30.0,0.0,-30.0,0.0,0.0,0.0
<a href=/player/pages101>pages101</a>,Sam Page,Philadelphia Athletics,ATLTCS,1,4,1,5,1939,1939,0,No,0,0.0,0.0,0.0,0,0,0,0,0,0,0.0,0.0,0.0,3000.0,0.0,-3000.0
<a href=/player/pagev101>pagev101</a>,Vance Page,Washington Senators,TWINS,1,1,2,3,1938,1945,7,No,0,1.28,0.0,-1.28,191,0,-191,103,0,-103,947.0,0.0,-947.0,0.0,0.0,0.0
<a href=/player/paglj101>paglj101</a>,Jim Pagliaroni,Boston Red Sox,RSOX,5,6,7,13,1962,1974,12,No,0,12.31,8.2,-4.11,890,1047,157,2393,1626,-767,1125.0,3389.0,2264.0,80500.0,0.0,-80500.0
<a href=/player/paglm001>paglm001</a>,Mike Pagliarulo,New York Yankees,YANKS,2,3,3,6,1989,1996,7,No,1,-0.39,-0.58,-0.19,192,33,-159,619,38,-581,73.0,249.0,176.0,575000.0,0.0,-575000.0
<a href=/player/paglm001>paglm001</a>,Mike Pagliarulo,Minnesota Twins,TWINS,1,1,1,2,1993,1995,2,No,0,1.35,-0.25,-1.6,33,46,13,126,0,-126,0.0,180.0,180.0,450000.0,0.0,-450000.0
<a href=/player/painl001>painl001</a>,Lance Painter,St. Louis Cardinals,CARDS,1,3,2,5,1999,2000,1,No,0,0.12,1.62,1.5,212,64,-148,357,72,-285,353.0,583.0,230.0,1025000.0,0.0,-1025000.0
<a href=/player/painp101>painp101</a>,Phil Paine,St. Louis Cardinals,CARDS,2,4,2,6,1958,1961,3,No,0,12.54,-1.35,-13.89,901,211,-690,3090,605,-2485,156.0,353.0,197.0,0.0,0.0,0.0
<a href=/player/painp101>painp101</a>,Phil Paine,Los Angeles Dodgers,DOGRS,1,3,2,5,1959,1959,0,No,0,0.0,0.0,0.0,0,0,0,0,0,0,0.0,0.0,0.0,0.0,0.0,0.0
<a href=/player/palar001>palar001</a>,Rey Palacios,Detroit Tigers,TIGRS,1,2,1,3,1988,1989,1,No,0,-0.33,-0.3,0.03,105,4,-101,125,0,-125,15.0,56.0,41.0,0.0,0.0,0.0
<a href=/player/palie101>palie101</a>,Erv Palica,Brooklyn Dodgers,DOGRS,1,1,2,3,1955,1955,0,No,0,2.14,0.69,-1.45,125,39,-86,93,91,-2,858.0,0.0,-858.0,0.0,0.0,0.0
<a href=/player/palie101>palie101</a>,Erv Palica,Baltimore Orioles,ORLS,1,2,1,3,1960,1961,1,No,0,0.0,0.0,0.0,0,0,0,0,0,0,0.0,0.0,0.0,0.0,0.0,0.0
<a href=/player/palkd001>palkd001</a>,Daniel Palka,Arizona Diamondbacks,DBACKS,1,1,1,2,2015,2018,3,No,0,0.0,0.47,0.47,0,162,162,0,422,422,0.0,0.0,0.0,0.0,0.0,0.0
<a href=/player/palld001>palld001</a>,Donn Pall,Chicago White Sox,WSOX,1,1,1,2,1993,1993,0,No,0,0.28,-0.03,-0.31,16,2,-14,0,1,1,53.0,0.0,-53.0,500000.0,0.0,-500000.0
<a href=/player/palmd002>palmd002</a>,Dean Palmer,Texas Rangers,RNGRS,1,1,1,2,1997,1999,2,No,0,2.36,3.01,0.65,201,316,115,845,1298,453,0.0,0.0,0.0,4800000.0,0.0,-4800000.0
<a href=/player/palme101>palme101</a>,Ed Palmquist,Los Angeles Dodgers,DOGRS,1,2,2,4,1961,1961,0,No,0,-0.97,0.0,0.97,59,0,-59,114,0,-114,63.0,0.0,-63.0,0.0,0.0,0.0
<a href=/player/palme102>palme102</a>,Emilio Palmero,Toledo,Toledo,1,2,1,3,1928,1928,0,No,0,-1.24,0.0,1.24,94,0,-94,291,0,-291,20.0,0.0,-20.0,0.0,0.0,0.0
<a href=/player/palme102>palme102</a>,Emilio Palmero,St.Louis Browns,ORLS,1,6,1,7,1921,1921,0,No,0,0.0,0.0,0.0,0,0,0,0,0,0,0.0,0.0,0.0,6600.0,0.0,-6600.0
<a href=/player/palmj101>palmj101</a>,Joe Palmisano,Philadelphia Athletics,ATLTCS,3,6,4,10,1931,1936,5,No,0,2.31,4.79,2.48,270,523,253,676,1095,419,552.0,1925.0,1373.0,12000.0,0.0,-12000.0
<a href=/player/palml101>palml101</a>,Lowell Palmer,Chicago White Sox,WSOX,1,1,1,2,1972,1972,0,No,0,0.08,0.0,-0.08,33,0,-33,5,0,-5,104.0,0.0,-104.0,0.0,0.0,0.0
<a href=/player/palml101>palml101</a>,Lowell Palmer,Cleveland Indians,INDINS,1,1,1,2,1973,1974,1,No,0,0.0,-1.15,-1.15,0,19,19,0,0,0,0.0,150.0,150.0,0.0,0.0,0.0
<a href=/player/palml101>palml101</a>,Lowell Palmer,Philadelphia Phillies,PHILS,1,1,2,3,1971,1971,0,No,0,0.0,0.0,0.0,0,0,0,0,0,0,0.0,0.0,0.0,0.0,0.0,0.0
<a href=/player/palmm101>palmm101</a>,Mike Palm,Boston Red Sox,RSOX,1,2,1,3,1950,1950,0,No,0,0.0,0.0,0.0,0,0,0,0,0,0,0.0,0.0,0.0,0.0,0.0,0.0
<a href=/player/palmr001>palmr001</a>,Rafael Palmeiro,Chicago Cubs,CUBS,6,8,15,23,1988,1995,7,No,0,50.51,3.13,-47.38,2529,1449,-1080,6791,543,-6248,2650.0,3110.0,460.0,1193000.0,0.0,-1193000.0
<a href=/player/palys101>palys101</a>,Stan Palys,Philadelphia Phillies,PHILS,2,4,4,8,1955,1957,2,No,0,8.43,2.22,-6.21,540,413,-127,1547,1258,-289,90.0,0.0,-90.0,15500.0,0.0,-15500.0
<a href=/player/panij001>panij001</a>,Jose Paniagua,Seattle Mariners,MARNRS,3,7,6,13,2001,2008,7,No,0,8.61,1.58,-7.03,1096,337,-759,200,984,784,2142.0,123.0,-2019.0,1587500.0,0.0,-1587500.0
<a href=/player/panij001>panij001</a>,Jose Paniagua,Colorado Rockies,ROCKS,1,1,2,3,2002,2002,0,No,0,-0.52,-1.27,-0.75,45,48,3,0,2,2,125.0,78.0,-47.0,0.0,0.0,0.0
<a href=/player/panij002>panij002</a>,Joe Panik,Toronto Blue Jays,BJAYS,1,2,3,5,2021,2021,0,Yes,0,-1.03,1.51,2.54,53,88,35,134,140,6,0.0,112.0,112.0,100000.0,0.0,-100000.0
<a href=/player/pankj001>pankj001</a>,Jim Pankovits,Houston Astros,ASTROS,1,1,1,2,1982,1982,0,No,0,0.0,0.0,0.0,0,0,0,0,0,0,0.0,0.0,0.0,0.0,0.0,0.0
<a href=/player/pannt001>pannt001</a>,Thomas Pannone,Cleveland Indians,INDINS,1,2,1,3,2017,2017,0,No,0,0.5,0.32,-0.18,52,21,-31,0,0,0,348.0,55.0,-293.0,0.0,0.0,0.0
<a href=/player/pantj101>pantj101</a>,Jim Panther,Oakland Athletics,ATLTCS,2,3,2,5,1972,1972,0,No,0,-1.73,-0.85,0.88,237,13,-224,63,9,-54,1061.0,67.0,-994.0,75000.0,0.0,-75000.0
<a href=/player/pantj101>pantj101</a>,Jim Panther,Texas Rangers,RNGRS,1,1,1,2,1972,1973,1,No,0,-1.0,-0.76,0.24,46,86,40,0,347,347,92.0,0.0,-92.0,9900.0,0.0,-9900.0
<a href=/player/papej001>papej001</a>,Jonathan Papelbon,Philadelphia Phillies,PHILS,2,4,3,7,2015,2020,5,No,0,3.07,-0.27,-3.34,151,202,51,2,120,118,680.0,1256.0,576.0,0.0,0.0,0.0
<a href=/player/papif101>papif101</a>,Frank Papish,Chicago White Sox,WSOX,11,26,23,49,1948,1963,15,No,0,24.59,52.66,28.07,4234,3736,-498,12747,11973,-774,4878.0,2927.0,-1951.0,119500.0,0.0,-119500.0
<a href=/player/papis101>papis101</a>,Stan Papi,Houston Astros,ASTROS,1,1,1,2,1973,1973,0,No,0,-0.05,-0.29,-0.24,8,15,7,4,18,14,0.0,0.0,0.0,0.0,0.0,0.0
<a href=/player/papis101>papis101</a>,Stan Papi,St. Louis Cardinals,CARDS,1,1,1,2,1975,1975,0,No,0,-0.67,0.0,0.67,80,0,-80,211,0,-211,0.0,0.0,0.0,0.0,0.0,0.0
<a href=/player/papis101>papis101</a>,Stan Papi,Montreal Expos,NATEX,1,1,1,2,1978,1982,4,No,0,-0.34,3.39,3.73,51,191,140,126,144,18,0.0,1323.0,1323.0,0.0,0.0,0.0
<a href=/player/papis101>papis101</a>,Stan Papi,Boston Red Sox,RSOX,1,2,1,3,1980,1980,0,No,0,0.0,1.12,1.12,0,50,50,0,152,152,0.0,0.0,0.0,0.0,0.0,0.0
<a href=/player/pappe001>pappe001</a>,Erik Pappas,Kansas City Royals,ROYALS,1,1,1,2,1992,1992,0,No,0,0.0,0.0,0.0,0,0,0,0,0,0,0.0,0.0,0.0,0.0,0.0,0.0
<a href=/player/pappm101>pappm101</a>,Milt Pappas,Baltimore Orioles,ORLS,12,26,24,50,1965,1994,29,No,3,56.78,119.52,62.74,2921,5392,2471,5189,14197,9008,12746.0,15470.0,2724.0,912833.0,0.0,-912833.0
<a href=/player/pappm101>pappm101</a>,Milt Pappas,Cincinnati Reds,REDS,3,5,6,11,1968,1977,9,No,0,4.56,11.78,7.22,256,1321,1065,307,585,278,1267.0,4200.0,2933.0,0.0,0.0,0.0
<a href=/player/paquc001>paquc001</a>,Craig Paquette,New York Mets,METS,1,1,1,2,1999,1999,0,No,0,0.85,0.26,-0.59,305,42,-263,956,97,-859,0.0,0.0,0.0,0.0,0.0,0.0
<a href=/player/paref101>paref101</a>,Freddy Parent,Boston Red Sox,RSOX,2,2,2,4,1907,1910,3,No,0,12.48,1.49,-10.99,591,243,-348,2337,883,-1454,0.0,0.0,0.0,4250.0,0.0,-4250.0
<a href=/player/parei001>parei001</a>,Isaac Paredes,Chicago Cubs,CUBS,1,3,2,5,2017,2018,1,No,0,6.56,1.19,-5.37,523,218,-305,2136,113,-2023,0.0,217.0,217.0,0.0,0.0,0.0
<a href=/player/parej002>parej002</a>,Jimmy Paredes,New York Yankees,YANKS,1,2,1,3,2010,2010,0,No,0,-0.72,-0.33,0.39,296,37,-259,397,123,-274,275.0,0.0,-275.0,0.0,0.0,0.0
<a href=/player/parem001>parem001</a>,Mark Parent,San Diego Padres,PADRS,2,2,2,4,1990,1992,2,No,0,-0.03,-0.69,-0.66,3,60,57,1,205,204,0.0,0.0,0.0,190000.0,0.0,-190000.0
<a href=/player/parik001>parik001</a>,Kelly Paris,St. Louis Cardinals,CARDS,2,3,2,5,1983,1985,2,No,0,-0.43,0.1,0.53,60,16,-44,138,0,-138,19.0,30.0,11.0,0.0,0.0,0.0
<a href=/player/parka101>parka101</a>,Art Parks,Brooklyn Dodgers,DOGRS,1,3,1,4,1938,1938,0,No,0,0.0,-0.02,-0.02,0,54,54,0,147,147,0.0,0.0,0.0,0.0,0.0,0.0
<a href=/player/parka101>parka101</a>,Art Parks,Brooklyn Dodgers,DOGRS,1,3,1,4,1940,1958,18,No,0,0.0,68.5,68.5,0,2166,2166,0,9470,9470,0.0,0.0,0.0,0.0,0.0,0.0
<a href=/player/parka102>parka102</a>,Ace Parker,Philadelphia Athletics,ATLTCS,1,2,1,3,1938,1939,1,No,0,0.0,-0.27,-0.27,0,16,16,0,15,15,0.0,119.0,119.0,1500.0,0.0,-1500.0
<a href=/player/parkc001>parkc001</a>,Clay Parker,Seattle Mariners,MARNRS,4,7,6,13,1987,1995,8,No,0,7.57,0.25,-7.32,518,728,210,671,2089,1418,1950.0,271.0,-1679.0,982500.0,0.0,-982500.0
<a href=/player/parkc001>parkc001</a>,Clay Parker,New York Yankees,YANKS,3,8,3,11,1990,2001,11,No,1,24.45,11.94,-12.51,1197,991,-206,4014,3988,-26,3220.0,0.0,-3220.0,800000.0,0.0,-800000.0
<a href=/player/parkc002>parkc002</a>,Chan Ho Park,Texas Rangers,RNGRS,2,4,2,6,2005,2007,2,No,0,-0.69,-1.1,-0.41,135,211,76,263,591,328,547.0,0.0,-547.0,25472409.0,0.0,-25472409.0
<a href=/player/parkc003>parkc003</a>,Christian Parker,Montreal Expos,NATEX,1,3,1,4,2000,2001,1,No,0,1.49,-0.32,-1.81,57,27,-30,6,21,15,645.0,214.0,-431.0,0.0,0.0,0.0
<a href=/player/parkd001>parkd001</a>,Dave Parker,Cincinnati Reds,REDS,1,1,2,3,1987,2003,16,No,0,0.55,38.12,37.57,245,775,530,1011,532,-479,0.0,4990.0,4990.0,1100000.0,0.0,-1100000.0
<a href=/player/parkd001>parkd001</a>,Dave Parker,Milwaukee Brewers,BREWRS,2,2,2,4,1991,1993,2,No,0,3.53,-0.67,-4.2,1137,371,-766,4853,1363,-3490,0.0,0.0,0.0,230000.0,0.0,-230000.0
<a href=/player/parkf101>parkf101</a>,Frank Parkinson,Philadelphia Phillies,PHILS,1,2,1,3,1924,1924,0,No,0,0.0,0.0,0.0,0,0,0,0,0,0,0.0,0.0,0.0,3000.0,0.0,-3000.0
<a href=/player/parkh001>parkh001</a>,Hoy Jun Park,New York Yankees,YANKS,1,2,1,3,2021,2021,0,Yes,0,-0.22,1.27,1.49,44,30,-14,149,0,-149,0.0,84.0,84.0,0.0,0.0,0.0
<a href=/player/parkh101>parkh101</a>,Harry Parker,St. Louis Cardinals,CARDS,9,16,14,30,1971,1976,5,No,0,14.55,3.01,-11.54,1564,430,-1134,3017,530,-2487,3834.0,1012.0,-2822.0,0.0,0.0,0.0
<a href=/player/parkh101>parkh101</a>,Harry Parker,St. Louis Cardinals,CARDS,1,1,1,2,1976,1977,1,No,0,0.27,0.0,-0.27,3,0,-3,0,0,0,21.0,0.0,-21.0,0.0,0.0,0.0
<a href=/player/parkj001>parkj001</a>,Jarrod Parker,Arizona Diamondbacks,DBACKS,6,12,12,24,2011,2021,10,Yes,0,55.85,12.58,-43.27,1986,909,-1077,2819,1176,-1643,7668.0,4077.0,-3591.0,13397833.0,0.0,-13397833.0
<a href=/player/parkr001>parkr001</a>,Rick Parker,Philadelphia Phillies,PHILS,5,8,9,17,1989,2002,13,No,0,6.14,8.58,2.44,1265,1614,349,3340,3565,225,859.0,4310.0,3451.0,1570000.0,0.0,-1570000.0
<a href=/player/parks102>parks102</a>,Salty Parker,Detroit Tigers,TIGRS,19,44,45,89,1936,1964,28,No,0,49.33,102.41,53.08,4601,5659,1058,11266,13498,2232,8483.0,17035.0,8552.0,157700.0,0.0,-157700.0
<a href=/player/parmr101>parmr101</a>,Roy Parmelee,New York Giants,GIANTS,1,3,1,4,1935,1947,12,No,0,0.93,6.58,5.65,74,650,576,80,2704,2624,660.0,0.0,-660.0,0.0,0.0,0.0
<a href=/player/parmr101>parmr101</a>,Roy Parmelee,St. Louis Cardinals,CARDS,1,2,1,3,1936,1942,6,No,0,2.86,15.14,12.28,328,366,38,1111,461,-650,437.0,3473.0,3036.0,0.0,0.0,0.0
<a href=/player/parnr101>parnr101</a>,Rube Parnham,Philadelphia Athletics,ATLTCS,2,7,4,11,1917,1920,3,No,0,0.98,1.52,0.54,143,229,86,582,916,334,0.0,0.0,0.0,2400.0,0.0,-2400.0
<a href=/player/parra001>parra001</a>,Andy Parrino,San Diego Padres,PADRS,1,2,2,4,2012,2016,4,No,0,-0.78,7.91,8.69,52,195,143,95,168,73,0.0,1566.0,1566.0,481000.0,0.0,-481000.0
<a href=/player/parrg001>parrg001</a>,Gerardo Parra,Arizona Diamondbacks,DBACKS,3,8,6,14,2014,2019,5,Yes,0,22.93,2.58,-20.35,956,182,-774,3750,459,-3291,246.0,591.0,345.0,7450000.0,0.0,-7450000.0
<a href=/player/parrg001>parrg001</a>,Gerardo Parra,Milwaukee Brewers,BREWRS,2,3,4,7,2015,2019,4,Yes,0,6.67,8.07,1.4,258,223,-35,1017,218,-799,208.0,1843.0,1635.0,8837500.0,0.0,-8837500.0
<a href=/player/parrj001>parrj001</a>,Jeff Parrett,Montreal Expos,NATEX,3,5,3,8,1988,1994,6,No,1,-0.06,0.65,0.71,294,172,-122,31,225,194,762.0,1094.0,332.0,250000.0,0.0,-250000.0
<a href=/player/parrj001>parrj001</a>,Jeff Parrett,Philadelphia Phillies,PHILS,1,3,2,5,1990,1996,6,No,0,0.28,7.71,7.43,106,447,341,38,1122,1084,145.0,1741.0,1596.0,750000.0,0.0,-750000.0
<a href=/player/parrj002>parrj002</a>,Jose Parra,Los Angeles Dodgers,DOGRS,1,4,2,6,1995,1998,3,No,0,-0.49,1.39,1.88,829,429,-400,2713,30,-2683,618.0,819.0,201.0,218000.0,0.0,-218000.0
<a href=/player/parrj003>parrj003</a>,John Parrish,Baltimore Orioles,ORLS,1,1,1,2,2007,2007,0,No,0,-0.07,0.0,0.07,8,0,-8,0,0,0,31.0,0.0,-31.0,575000.0,0.0,-575000.0
<a href=/player/parrl001>parrl001</a>,Lance Parrish,Philadelphia Phillies,PHILS,1,1,1,2,1988,1991,3,No,0,7.6,0.0,-7.6,400,0,-400,1540,0,-1540,0.0,0.0,0.0,1000000.0,0.0,-1000000.0
<a href=/player/parrl002>parrl002</a>,Larry Parrish,Montreal Expos,NATEX,4,6,6,12,1982,1992,10,No,0,4.42,9.75,5.33,1501,1079,-422,5161,3321,-1840,201.0,164.0,-37.0,415000.0,0.0,-415000.0
<a href=/player/parrm101>parrm101</a>,Mike Parrott,Baltimore Orioles,ORLS,1,1,2,3,1977,1978,1,No,0,1.92,0.0,-1.92,116,0,-116,0,0,0,1472.0,0.0,-1472.0,0.0,0.0,0.0
<a href=/player/parrm101>parrm101</a>,Mike Parrott,Seattle Mariners,MARNRS,1,1,1,2,1982,1982,0,No,0,0.0,-0.91,-0.91,0,22,22,0,50,50,0.0,0.0,0.0,0.0,0.0,0.0
<a href=/player/parrs001>parrs001</a>,Steve Parris,Cincinnati Reds,REDS,1,1,2,3,2000,2003,3,No,0,0.91,0.0,-0.91,36,0,-36,6,0,-6,543.0,0.0,-543.0,1400000.0,0.0,-1400000.0
<a href=/player/parrs101>parrs101</a>,Sam Parrilla,Philadelphia Phillies,PHILS,4,9,7,16,1970,1984,14,No,0,35.07,12.55,-22.52,1678,1480,-198,5343,1739,-3604,1000.0,2166.0,1166.0,0.0,0.0,0.0
<a href=/player/parrt101>parrt101</a>,Tom Parrott,Cincinnati Reds,REDS,4,11,5,16,1895,1906,11,No,0,8.81,24.47,15.66,1114,1079,-35,4520,3525,-995,393.0,2208.0,1815.0,1500.0,0.0,-1500.0
<a href=/player/parsb101>parsb101</a>,Bill Parsons,Milwaukee Brewers,BREWRS,1,2,1,3,1974,1974,0,No,0,0.11,-0.96,-1.07,4,49,45,0,174,174,6.0,0.0,-6.0,0.0,0.0,0.0
<a href=/player/parsb101>parsb101</a>,Bill Parsons,St. Louis Cardinals,CARDS,2,4,2,6,1975,1976,1,No,0,0.63,-0.25,-0.88,80,116,36,258,190,-68,0.0,0.0,0.0,0.0,0.0,0.0
<a href=/player/parst101>parst101</a>,Tom Parsons,Pittsburgh Pirates,PIRATS,1,1,1,2,1964,1964,0,No,0,0.0,0.0,0.0,0,0,0,0,0,0,0.0,0.0,0.0,0.0,0.0,0.0
<a href=/player/parst101>parst101</a>,Tom Parsons,New York Mets,METS,3,5,4,9,1965,1983,18,No,0,-0.2,16.37,16.57,61,1252,1191,115,4388,4273,0.0,0.0,0.0,0.0,0.0,0.0
<a href=/player/partr101>partr101</a>,Roy Partee,Boston Red Sox,RSOX,2,8,5,13,1947,1955,8,No,0,6.5,21.93,15.43,835,962,127,1487,3127,1640,2844.0,2066.0,-778.0,10000.0,0.0,-10000.0
<a href=/player/partr101>partr101</a>,Roy Partee,St.Louis Browns,ORLS,44,106,109,215,1948,1994,46,No,3,173.64,220.75,47.11,11733,18932,7199,27283,56805,29522,35289.0,22275.0,-13014.0,1054583.0,0.0,-1054583.0
<a href=/player/parts101>parts101</a>,Stan Partenheimer,Boston Red Sox,RSOX,1,1,1,2,1944,1946,2,No,0,-0.16,1.31,1.47,16,150,134,3,51,48,40.0,529.0,489.0,0.0,0.0,0.0
<a href=/player/pascb102>pascb102</a>,Ben Paschal,New York Yankees,YANKS,1,3,1,4,1929,1930,1,No,0,0.0,0.05,0.05,0,45,45,0,121,121,0.0,0.0,0.0,15000.0,0.0,-15000.0
<a href=/player/pascc102>pascc102</a>,Camilo Pascual,Minnesota Twins,TWINS,2,3,2,5,1966,1968,2,No,0,10.51,0.41,-10.1,831,108,-723,1841,6,-1835,1694.0,215.0,-1479.0,90000.0,0.0,-90000.0
<a href=/player/pasej101>pasej101</a>,Johnny Pasek,Detroit Tigers,TIGRS,1,2,1,3,1933,1933,0,No,0,0.0,0.0,0.0,0,0,0,0,0,0,0.0,0.0,0.0,2400.0,0.0,-2400.0
<a href=/player/pasej101>pasej101</a>,Johnny Pasek,Philadelphia Athletics,ATLTCS,1,2,2,4,1933,1935,2,No,0,3.62,0.35,-3.27,76,161,85,105,502,397,735.0,0.0,-735.0,7500.0,0.0,-7500.0
<a href=/player/pashl001>pashl001</a>,Larry Pashnick,Detroit Tigers,TIGRS,1,1,1,2,1983,1985,2,No,0,0.1,-0.24,-0.34,13,89,76,0,175,175,115.0,0.0,-115.0,0.0,0.0,0.0
<a href=/player/paskd101>paskd101</a>,Dode Paskert,Cincinnati Reds,REDS,2,6,5,11,1910,1914,4,No,0,23.79,7.43,-16.36,1495,715,-780,6220,2571,-3649,283.0,231.0,-52.0,0.0,0.0,0.0
<a href=/player/paskd101>paskd101</a>,Dode Paskert,Philadelphia Phillies,PHILS,1,1,1,2,1917,1931,14,No,0,4.03,30.63,26.6,354,1463,1109,1419,5786,4367,0.0,0.0,0.0,4000.0,0.0,-4000.0
<a href=/player/pasqd001>pasqd001</a>,Dan Pasqua,New York Yankees,YANKS,2,4,3,7,1987,1989,2,No,0,7.16,-1.48,-8.64,782,63,-719,2351,14,-2337,594.0,729.0,135.0,247000.0,0.0,-247000.0
<a href=/player/passc101>passc101</a>,Claude Passeau,Pittsburgh Pirates,PIRATS,2,5,2,7,1935,1941,6,No,0,11.48,3.57,-7.91,470,432,-38,813,1543,730,2406.0,0.0,-2406.0,0.0,0.0,0.0
<a href=/player/passc101>passc101</a>,Claude Passeau,Philadelphia Phillies,PHILS,4,4,9,13,1939,1946,7,No,0,44.18,9.02,-35.16,1135,1038,-97,1735,2532,797,8600.0,3353.0,-5247.0,8000.0,0.0,-8000.0
<a href=/player/pastt001>pastt001</a>,Tyler Pastornicky,Toronto Blue Jays,BJAYS,4,18,13,31,2010,2018,8,No,0,25.98,29.42,3.44,2444,1447,-997,6892,4630,-2262,4668.0,4909.0,241.0,11482900.0,0.0,-11482900.0
<a href=/player/patef101>patef101</a>,Freddie Patek,Pittsburgh Pirates,PIRATS,3,5,5,10,1970,1974,4,No,0,25.46,1.32,-24.14,1582,453,-1129,5382,666,-4716,1881.0,1147.0,-734.0,76500.0,0.0,-76500.0
<a href=/player/patil001>patil001</a>,Luis Patino,San Diego Padres,PADRS,1,4,1,5,2020,2020,0,Yes,0,1.51,0.0,-1.51,105,0,-105,277,0,-277,238.0,0.0,-238.0,0.0,0.0,0.0
<a href=/player/pattb001>pattb001</a>,Bob Patterson,San Diego Padres,PADRS,19,36,38,74,1986,2010,24,No,6,18.58,62.07,43.49,4613,5790,1177,14314,19177,4863,2237.0,2171.0,-66.0,26139800.0,0.0,-26139800.0
<a href=/player/pattc001>pattc001</a>,Corey Patterson,Chicago Cubs,CUBS,1,1,2,3,2006,2006,0,No,0,7.19,0.0,-7.19,357,0,-357,1343,0,-1343,0.0,0.0,0.0,0.0,0.0,0.0
<a href=/player/pattc001>pattc001</a>,Corey Patterson,Toronto Blue Jays,BJAYS,1,4,4,8,2011,2014,3,No,0,0.4,6.43,6.03,344,416,72,89,1599,1510,547.0,15.0,-532.0,4329600.0,0.0,-4329600.0
<a href=/player/pattc101>pattc101</a>,Casey Patten,Washington Senators,TWINS,1,1,1,2,1908,1911,3,No,0,-0.31,0.2,0.51,2,55,53,1,87,86,9.0,278.0,269.0,0.0,0.0,0.0
<a href=/player/pattd001>pattd001</a>,Danny Patterson,Texas Rangers,RNGRS,6,16,16,32,1999,2013,14,No,4,10.07,37.12,27.05,1336,2425,1089,3189,7223,4034,1798.0,1911.0,113.0,18360260.0,0.0,-18360260.0
<a href=/player/pattd102>pattd102</a>,Daryl Patterson,Detroit Tigers,TIGRS,2,2,2,4,1971,1972,1,No,0,-0.15,0.0,0.15,8,0,-8,1,0,-1,17.0,0.0,-17.0,18200.0,0.0,-18200.0
<a href=/player/patte001>patte001</a>,Eric Patterson,Chicago Cubs,CUBS,1,4,2,6,2008,2009,1,No,0,13.08,4.54,-8.54,545,124,-421,2047,74,-1973,213.0,718.0,505.0,0.0,0.0,0.0
<a href=/player/patte001>patte001</a>,Eric Patterson,Oakland Athletics,ATLTCS,1,1,1,2,2010,2010,0,No,0,0.49,0.0,-0.49,45,0,-45,93,0,-93,0.0,0.0,0.0,405000.0,0.0,-405000.0
<a href=/player/patte001>patte001</a>,Eric Patterson,Boston Red Sox,RSOX,8,26,15,41,2010,2019,9,Yes,0,35.43,29.06,-6.37,2876,1721,-1155,5076,5808,732,4841.0,1908.0,-2933.0,4708000.0,0.0,-4708000.0
<a href=/player/pattj002>pattj002</a>,Jeff Patterson,Philadelphia Phillies,PHILS,1,2,3,5,1994,2002,8,No,0,-0.95,-1.6,-0.65,27,666,639,0,1569,1569,372.0,587.0,215.0,0.0,0.0,0.0
<a href=/player/pattj003>pattj003</a>,Jarrod Patterson,Pittsburgh Pirates,PIRATS,1,1,1,2,2000,2000,0,No,0,0.0,-0.6,-0.6,0,16,16,0,2,2,0.0,28.0,28.0,0.0,0.0,0.0
<a href=/player/pattj004>pattj004</a>,John Patterson,Arizona Diamondbacks,DBACKS,1,1,1,2,2004,2005,1,No,0,4.39,0.16,-4.23,127,159,32,127,1,-126,1106.0,173.0,-933.0,0.0,0.0,0.0
<a href=/player/pattk001>pattk001</a>,Ken Patterson,New York Yankees,YANKS,1,2,2,4,1987,1988,1,No,0,1.62,0.02,-1.6,145,18,-127,0,47,47,649.0,0.0,-649.0,0.0,0.0,0.0
<a href=/player/pattk001>pattk001</a>,Ken Patterson,Chicago White Sox,WSOX,1,2,1,3,1992,1993,1,No,0,58.16,-2.67,-60.83,1875,257,-1618,7900,1106,-6794,125.0,0.0,-125.0,0.0,0.0,0.0
<a href=/player/pattm101>pattm101</a>,Marty Pattin,Milwaukee Brewers,BREWRS,9,23,22,45,1971,1984,13,No,0,35.91,84.88,48.97,2475,4171,1696,6161,14852,8691,10247.0,5331.0,-4916.0,466901.0,0.0,-466901.0
<a href=/player/pattm101>pattm101</a>,Marty Pattin,Boston Red Sox,RSOX,3,3,5,8,1973,1977,4,No,0,7.69,3.41,-4.28,316,73,-243,25,0,-25,2778.0,745.0,-2033.0,65000.0,0.0,-65000.0
<a href=/player/pattm102>pattm102</a>,Mike Patterson,Oakland Athletics,ATLTCS,1,3,2,5,1981,1983,2,No,0,-0.62,1.11,1.73,74,210,136,201,288,87,0.0,1046.0,1046.0,0.0,0.0,0.0
<a href=/player/pattr001>pattr001</a>,Reggie Patterson,Chicago White Sox,WSOX,1,1,1,2,1982,1983,1,No,0,0.79,0.0,-0.79,32,0,-32,23,0,-23,191.0,0.0,-191.0,0.0,0.0,0.0
<a href=/player/patts002>patts002</a>,Spencer Patton,Kansas City Royals,ROYALS,1,1,1,2,2014,2015,1,No,0,-0.24,1.35,1.59,83,53,-30,0,0,0,227.0,123.0,-104.0,0.0,0.0,0.0
<a href=/player/patts002>patts002</a>,Spencer Patton,Texas Rangers,RNGRS,1,1,1,2,2015,2015,0,Yes,0,-0.48,0.0,0.48,32,0,-32,2,0,-2,64.0,0.0,-64.0,0.0,0.0,0.0
<a href=/player/pattt001>pattt001</a>,Troy Patton,Houston Astros,ASTROS,1,5,1,6,2007,2009,2,No,0,11.62,3.81,-7.81,860,316,-544,1797,1340,-457,1330.0,0.0,-1330.0,382000.0,0.0,-382000.0
<a href=/player/pattt001>pattt001</a>,Troy Patton,Baltimore Orioles,ORLS,1,1,2,3,2014,2014,0,No,0,0.1,0.16,0.06,16,50,34,0,174,174,22.0,0.0,-22.0,0.0,0.0,0.0
<a href=/player/pauld001>pauld001</a>,David Pauley,San Diego Padres,PADRS,3,7,4,11,2004,2011,7,No,2,31.04,4.47,-26.57,314,404,90,240,1711,1471,4110.0,0.0,-4110.0,1842500.0,0.0,-1842500.0
<a href=/player/pauld001>pauld001</a>,David Pauley,Boston Red Sox,RSOX,1,1,1,2,2009,2010,1,No,0,0.0,0.0,0.0,0,0,0,0,0,0,0.0,0.0,0.0,0.0,0.0,0.0
<a href=/player/pauld001>pauld001</a>,David Pauley,Seattle Mariners,MARNRS,1,2,4,6,2011,2016,5,No,0,9.61,3.11,-6.5,89,386,297,9,432,423,1381.0,727.0,-654.0,858500.0,0.0,-858500.0
<a href=/player/pauld002>pauld002</a>,David Paulino,Detroit Tigers,TIGRS,1,2,1,3,2013,2013,0,No,0,-0.35,0.29,0.64,9,28,19,0,0,0,108.0,59.0,-49.0,0.0,0.0,0.0
<a href=/player/pauld002>pauld002</a>,David Paulino,Houston Astros,ASTROS,1,3,1,4,2018,2020,2,No,0,2.45,2.96,0.51,92,98,6,0,0,0,254.0,276.0,22.0,4600000.0,0.0,-4600000.0
<a href=/player/paulf001>paulf001</a>,Felipe Paulino,Houston Astros,ASTROS,2,2,2,4,2010,2012,2,No,1,-0.44,3.38,3.82,36,123,87,0,495,495,44.0,0.0,-44.0,415000.0,0.0,-415000.0
<a href=/player/paulg102>paulg102</a>,Gene Paulette,St. Louis Cardinals,CARDS,1,2,3,5,1919,1926,7,No,0,13.87,-0.32,-14.19,461,130,-331,1191,116,-1075,2559.0,705.0,-1854.0,6650.0,0.0,-6650.0
<a href=/player/paulg102>paulg102</a>,Gene Paulette,Nashville,Nashville,1,1,3,4,1915,1915,0,No,0,-0.08,0.0,0.08,17,0,-17,34,0,-34,0.0,0.0,0.0,0.0,0.0,0.0
<a href=/player/paulj001>paulj001</a>,Josh Paul,Anaheim Angels,ANGELS,1,1,1,2,2005,2007,2,No,0,0.21,0.0,-0.21,93,0,-93,280,0,-280,0.0,0.0,0.0,450000.0,0.0,-450000.0
<a href=/player/paulm101>paulm101</a>,Mike Paul,Cleveland Indians,INDINS,6,11,10,21,1971,1978,7,No,0,26.06,8.28,-17.78,1542,586,-956,3690,1786,-1904,2427.0,1183.0,-1244.0,83000.0,0.0,-83000.0
<a href=/player/paulm101>paulm101</a>,Mike Paul,Texas Rangers,RNGRS,2,3,2,5,1973,1975,2,No,0,2.88,-0.38,-3.26,60,39,-21,4,118,114,681.0,0.0,-681.0,30000.0,0.0,-30000.0
<a href=/player/paulr001>paulr001</a>,Ronny Paulino,Pittsburgh Pirates,PIRATS,1,1,1,2,2008,2011,3,No,0,0.0,-0.81,-0.81,0,119,119,0,366,366,0.0,0.0,0.0,423500.0,0.0,-423500.0
<a href=/player/paulr001>paulr001</a>,Ronny Paulino,Philadelphia Phillies,PHILS,1,1,1,2,2009,2009,0,No,0,0.0,-0.18,-0.18,0,47,47,0,2,2,0.0,88.0,88.0,0.0,0.0,0.0
<a href=/player/paulr001>paulr001</a>,Ronny Paulino,San Francisco Giants,GIANTS,1,1,1,2,2009,2009,0,No,0,2.09,0.0,-2.09,171,0,-171,610,0,-610,0.0,0.0,0.0,0.0,0.0,0.0
<a href=/player/pavac001>pavac001</a>,Carl Pavano,Boston Red Sox,RSOX,3,4,4,8,1997,2016,19,Yes,2,9.5,68.59,59.09,454,428,-26,432,36,-396,3841.0,7654.0,3813.0,13000000.0,0.0,-13000000.0
<a href=/player/pavac001>pavac001</a>,Carl Pavano,Montreal Expos,NATEX,2,6,6,12,2002,2005,3,No,0,7.25,0.27,-6.98,492,319,-173,648,239,-409,1719.0,1333.0,-386.0,4812500.0,0.0,-4812500.0
<a href=/player/pavac001>pavac001</a>,Carl Pavano,Cleveland Indians,INDINS,1,1,1,2,2009,2011,2,No,0,5.79,0.0,-5.79,93,0,-93,16,0,-16,1739.0,0.0,-1739.0,1500000.0,0.0,-1500000.0
<a href=/player/pavld001>pavld001</a>,Dave Pavlas,Chicago Cubs,CUBS,1,1,1,2,1987,1988,1,No,0,0.0,0.17,0.17,0,35,35,0,13,13,0.0,114.0,114.0,0.0,0.0,0.0
<a href=/player/pavld101>pavld101</a>,Don Pavletich,Cincinnati Reds,REDS,2,3,3,6,1968,1970,2,No,0,-0.45,-1.78,-1.33,134,68,-66,227,36,-191,164.0,339.0,175.0,21500.0,0.0,-21500.0
<a href=/player/pavld101>pavld101</a>,Don Pavletich,Chicago White Sox,WSOX,9,18,15,33,1969,1985,16,No,1,26.9,26.12,-0.78,2363,1756,-607,5130,5926,796,6374.0,2182.0,-4192.0,150950.0,0.0,-150950.0
<a href=/player/pavld101>pavld101</a>,Don Pavletich,Boston Red Sox,RSOX,5,10,10,20,1971,1977,6,No,0,35.42,11.92,-23.5,1569,736,-833,4628,2092,-2536,3846.0,2344.0,-1502.0,155000.0,0.0,-155000.0
<a href=/player/paxtj001>paxtj001</a>,James Paxton,Seattle Mariners,MARNRS,1,1,3,4,2018,2018,0,Yes,0,1.84,0.0,-1.84,37,0,-37,8,0,-8,513.0,0.0,-513.0,4900000.0,0.0,-4900000.0
<a href=/player/paxtm101>paxtm101</a>,Mike Paxton,Boston Red Sox,RSOX,2,6,3,9,1978,1987,9,No,0,14.86,20.93,6.07,699,715,16,1362,2220,858,3997.0,3996.0,-1.0,0.0,0.0,0.0
<a href=/player/paytj001>paytj001</a>,Jay Payton,New York Mets,METS,2,4,3,7,2002,2002,0,No,0,4.04,-0.58,-4.62,267,21,-246,904,25,-879,36.0,163.0,127.0,362500.0,0.0,-362500.0
<a href=/player/paytj001>paytj001</a>,Jay Payton,San Diego Padres,PADRS,3,7,4,11,2004,2011,7,No,2,31.04,4.47,-26.57,314,404,90,240,1711,1471,4110.0,0.0,-4110.0,1842500.0,0.0,-1842500.0
<a href=/player/paytj001>paytj001</a>,Jay Payton,Boston Red Sox,RSOX,1,2,1,3,2005,2005,0,No,0,3.53,0.44,-3.09,211,31,-180,879,0,-879,0.0,70.0,70.0,3500000.0,0.0,-3500000.0
<a href=/player/paytm001>paytm001</a>,Mark Payton,Oakland Athletics,ATLTCS,1,1,1,2,2020,2020,0,No,0,-0.51,0.0,0.51,32,0,-32,44,0,-44,0.0,0.0,0.0,0.0,0.0,0.0
<a href=/player/pazim101>pazim101</a>,Mike Pazik,New York Yankees,YANKS,2,3,2,5,1974,1975,1,No,0,-0.48,-0.46,0.02,13,8,-5,0,0,0,140.0,84.0,-56.0,0.0,0.0,0.0
<a href=/player/pazoj001>pazoj001</a>,James Pazos,New York Yankees,YANKS,2,3,2,5,2016,2017,1,No,0,0.79,-0.11,-0.9,173,9,-164,2,2,0,514.0,112.0,-402.0,0.0,0.0,0.0
<a href=/player/pazoj001>pazoj001</a>,James Pazos,Seattle Mariners,MARNRS,3,7,5,12,2018,2019,1,Yes,0,12.9,2.05,-10.85,683,65,-618,2542,289,-2253,142.0,0.0,-142.0,17350000.0,0.0,-17350000.0
<a href=/player/pazoj001>pazoj001</a>,James Pazos,Philadelphia Phillies,PHILS,1,1,1,2,2019,2019,0,Yes,0,0.18,0.0,-0.18,30,0,-30,0,0,0,47.0,0.0,-47.0,0.0,0.0,0.0
<a href=/player/peacb001>peacb001</a>,Brad Peacock,Washington Nationals,NATEX,2,6,4,10,2011,2018,7,Yes,0,12.32,19.68,7.36,414,407,-7,1035,430,-605,1666.0,3760.0,2094.0,12000000.0,0.0,-12000000.0
<a href=/player/peacb001>peacb001</a>,Brad Peacock,Oakland Athletics,ATLTCS,1,3,2,5,2013,2016,3,No,0,8.06,4.16,-3.9,776,397,-379,2069,1228,-841,1629.0,325.0,-1304.0,0.0,0.0,0.0
<a href=/player/peacj101>peacj101</a>,Johnny Peacock,Philadelphia Phillies,PHILS,1,1,1,2,1945,1946,1,No,0,0.41,-0.26,-0.67,48,29,-19,134,54,-80,0.0,26.0,26.0,0.0,0.0,0.0
<a href=/player/peara102>peara102</a>,Albie Pearson,Boston Red Sox,RSOX,2,3,2,5,1958,1962,4,No,0,0.48,20.28,19.8,432,732,300,1643,3004,1361,0.0,0.0,0.0,0.0,0.0,0.0
<a href=/player/peara102>peara102</a>,Albie Pearson,Washington Senators,TWINS,2,3,3,6,1959,1966,7,No,0,-1.09,5.54,6.63,359,946,587,803,3000,2197,0.0,0.0,0.0,15000.0,0.0,-15000.0
<a href=/player/pearf101>pearf101</a>,Frank Pearce,Nashville,Nashville,1,1,2,3,1933,1934,1,No,0,0.43,0.0,-0.43,64,0,-64,38,0,-38,345.0,0.0,-345.0,0.0,0.0,0.0
<a href=/player/peari101>peari101</a>,Ike Pearson,Chicago White Sox,WSOX,3,5,3,8,1949,1955,6,No,0,0.66,10.32,9.66,71,314,243,61,435,374,448.0,2293.0,1845.0,7000.0,0.0,-7000.0
<a href=/player/pearj101>pearj101</a>,Jim Pearce,St. Louis Cardinals,CARDS,1,3,1,4,1956,1960,4,No,0,0.0,-0.55,-0.55,0,36,36,0,11,11,0.0,110.0,110.0,0.0,0.0,0.0
<a href=/player/pearm101>pearm101</a>,Monte Pearson,Cleveland Indians,INDINS,1,2,1,3,1935,1940,5,No,0,14.33,18.91,4.58,396,307,-89,481,384,-97,3424.0,2789.0,-635.0,0.0,0.0,0.0
<a href=/player/pearm101>pearm101</a>,Monte Pearson,New York Yankees,YANKS,1,1,2,3,1940,1942,2,No,0,-0.31,0.0,0.31,15,0,-15,6,0,-6,73.0,0.0,-73.0,13500.0,0.0,-13500.0
<a href=/player/pears001>pears001</a>,Steve Pearce,Tampa Bay Devil Rays,RAYS,2,2,2,4,2016,2017,1,Yes,0,0.04,0.0,-0.04,38,0,-38,111,0,-111,0.0,0.0,0.0,0.0,0.0,0.0
<a href=/player/pears001>pears001</a>,Steve Pearce,Toronto Blue Jays,BJAYS,1,2,1,3,2018,2018,0,Yes,0,0.48,0.0,-0.48,79,0,-79,264,0,-264,0.0,0.0,0.0,0.0,0.0,0.0
<a href=/player/peavj001>peavj001</a>,Jake Peavy,San Diego Padres,PADRS,2,5,5,10,2009,2013,4,No,0,10.78,-0.73,-11.51,527,446,-81,73,939,866,2883.0,2001.0,-882.0,11401300.0,0.0,-11401300.0
<a href=/player/peavj001>peavj001</a>,Jake Peavy,Chicago White Sox,WSOX,5,10,11,21,2013,2018,5,Yes,0,6.26,13.31,7.05,575,937,362,573,3743,3170,1595.0,75.0,-1520.0,12535000.0,0.0,-12535000.0
<a href=/player/peavj001>peavj001</a>,Jake Peavy,Boston Red Sox,RSOX,2,4,4,8,2014,2020,6,Yes,0,1.72,2.68,0.96,145,269,124,96,1,-95,991.0,809.0,-182.0,5113000.0,0.0,-5113000.0
<a href=/player/peckh101>peckh101</a>,Hal Peck,Chicago Cubs,CUBS,1,2,1,3,1943,1949,6,No,0,0.0,5.51,5.51,0,511,511,0,2102,2102,0.0,0.0,0.0,0.0,0.0,0.0
<a href=/player/peckh101>peckh101</a>,Hal Peck,New York Yankees,YANKS,3,10,5,15,1946,1954,8,No,0,30.84,1.34,-29.5,1405,374,-1031,2470,260,-2210,6379.0,1746.0,-4633.0,11500.0,0.0,-11500.0
<a href=/player/peckh101>peckh101</a>,Hal Peck,Milwaukee,Milwaukee,1,1,5,6,1944,1944,0,No,0,1.19,0.0,-1.19,162,0,-162,669,0,-669,0.0,0.0,0.0,0.0,0.0,0.0
<a href=/player/peckr101>peckr101</a>,Roger Peckinpaugh,Cleveland Indians,INDINS,1,1,2,3,1913,1913,0,No,0,32.06,0.21,-31.85,1219,23,-1196,5262,23,-5239,0.0,0.0,0.0,0.0,0.0,0.0
<a href=/player/peckr101>peckr101</a>,Roger Peckinpaugh,New York Yankees,YANKS,4,11,7,18,1921,1946,25,No,0,28.58,81.31,52.73,995,2473,1478,1312,4729,3417,7730.0,15194.0,7464.0,42500.0,0.0,-42500.0
<a href=/player/peckr101>peckr101</a>,Roger Peckinpaugh,Boston Red Sox,RSOX,4,8,12,20,1922,1935,13,No,0,30.52,-2.46,-32.98,2375,905,-1470,9488,3403,-6085,0.0,159.0,159.0,16300.0,0.0,-16300.0
<a href=/player/peckr101>peckr101</a>,Roger Peckinpaugh,Washington Senators,TWINS,1,1,2,3,1927,1933,6,No,0,1.22,2.1,0.88,68,71,3,246,101,-145,0.0,616.0,616.0,0.0,0.0,0.0
<a href=/player/pecob001>pecob001</a>,Bill Pecota,Kansas City Royals,ROYALS,4,6,8,14,1991,1997,6,No,0,19.59,4.26,-15.33,606,997,391,1939,3941,2002,1576.0,52.0,-1524.0,3507500.0,0.0,-3507500.0
<a href=/player/pedej001>pedej001</a>,Joc Pederson,Chicago Cubs,CUBS,1,1,1,2,2021,2021,0,Yes,0,0.24,0.0,-0.24,64,0,-64,194,0,-194,0.0,0.0,0.0,4500000.0,0.0,-4500000.0
<a href=/player/pedra001>pedra001</a>,Al Pedrique,New York Mets,METS,2,3,3,6,1987,1990,3,No,0,0.91,0.12,-0.79,161,49,-112,446,62,-384,0.0,0.0,0.0,0.0,0.0,0.0
<a href=/player/peelh101>peelh101</a>,Homer Peel,St. Louis Cardinals,CARDS,2,4,5,9,1928,1936,8,No,0,28.36,11.55,-16.81,2032,988,-1044,7440,3573,-3867,0.0,0.0,0.0,0.0,0.0,0.0
<a href=/player/peelh101>peelh101</a>,Homer Peel,Philadelphia Phillies,PHILS,1,2,2,4,1929,1933,4,No,0,-1.21,0.77,1.98,26,281,255,77,572,495,0.0,0.0,0.0,6000.0,0.0,-6000.0
<a href=/player/peerj101>peerj101</a>,Jack Peerson,Philadelphia Athletics,ATLTCS,1,4,1,5,1937,1940,3,No,0,0.0,6.28,6.28,0,278,278,0,321,321,0.0,1514.0,1514.0,0.0,0.0,0.0
<a href=/player/pegue001>pegue001</a>,Elvis Peguero,New York Yankees,YANKS,1,2,2,4,2021,2021,0,No,0,-0.41,-0.59,-0.18,7,14,7,0,1,1,56.0,107.0,51.0,0.0,0.0,0.0
<a href=/player/peguj001>peguj001</a>,Julio Peguero,Pittsburgh Pirates,PIRATS,2,4,2,6,1990,1991,1,No,0,3.0,-0.21,-3.21,512,23,-489,1575,37,-1538,0.0,0.0,0.0,925000.0,0.0,-925000.0
<a href=/player/peguj001>peguj001</a>,Julio Peguero,Philadelphia Phillies,PHILS,1,2,1,3,1992,1992,0,No,0,0.0,1.64,1.64,0,74,74,0,313,313,0.0,0.0,0.0,175000.0,0.0,-175000.0
<a href=/player/peith101>peith101</a>,Heinie Peitz,St. Louis Cardinals,CARDS,5,8,13,21,1895,1899,4,No,0,45.5,0.55,-44.95,2073,759,-1314,7733,2872,-4861,1422.0,668.0,-754.0,0.0,0.0,0.0
<a href=/player/peith101>peith101</a>,Heinie Peitz,Cincinnati Reds,REDS,1,1,1,2,1905,1906,1,No,0,1.33,-0.05,-1.38,128,56,-72,454,217,-237,0.0,0.0,0.0,0.0,0.0,0.0
<a href=/player/pelle101>pelle101</a>,Eddie Pellagrini,Boston Red Sox,RSOX,2,8,5,13,1947,1955,8,No,0,6.5,21.93,15.43,835,962,127,1487,3127,1640,2844.0,2066.0,-778.0,10000.0,0.0,-10000.0
<a href=/player/pelle101>pelle101</a>,Eddie Pellagrini,Philadelphia Phillies,PHILS,3,8,7,15,1951,1957,6,No,0,12.59,16.8,4.21,922,1010,88,2813,3409,596,109.0,186.0,77.0,63000.0,0.0,-63000.0
<a href=/player/pembb101>pembb101</a>,Brock Pemberton,New York Mets,METS,1,2,1,3,1976,1976,0,No,0,0.0,0.0,0.0,0,0,0,0,0,0,0.0,0.0,0.0,0.0,0.0,0.0
<a href=/player/pembr001>pembr001</a>,Rudy Pemberton,Texas Rangers,RNGRS,1,1,1,2,1996,1996,0,No,0,0.72,0.0,-0.72,40,0,-40,115,0,-115,0.0,0.0,0.0,0.0,0.0,0.0
<a href=/player/penaa001>penaa001</a>,Alejandro Pena,Los Angeles Dodgers,DOGRS,1,2,1,3,1989,1992,3,No,0,2.0,2.55,0.55,245,343,98,183,1353,1170,417.0,0.0,-417.0,1975000.0,0.0,-1975000.0
<a href=/player/penaa001>penaa001</a>,Alejandro Pena,New York Mets,METS,8,13,15,28,1991,1999,8,No,1,9.37,7.83,-1.54,988,1076,88,691,303,-388,2432.0,3919.0,1487.0,7823000.0,0.0,-7823000.0
<a href=/player/penaa001>penaa001</a>,Alejandro Pena,Florida Marlins,MARLNS,1,1,1,2,1995,1997,2,No,0,0.1,0.0,-0.1,28,0,-28,0,0,0,39.0,0.0,-39.0,0.0,0.0,0.0
<a href=/player/penaa003>penaa003</a>,Ariel Pena,Anaheim Angels,ANGELS,1,3,1,4,2012,2012,0,No,0,4.26,1.47,-2.79,508,13,-495,1945,0,-1945,179.0,268.0,89.0,0.0,0.0,0.0
<a href=/player/penac001>penac001</a>,Carlos Pena,Texas Rangers,RNGRS,6,7,11,18,2002,2013,11,No,0,4.52,9.79,5.27,476,622,146,1358,1735,377,495.0,2132.0,1637.0,1600000.0,0.0,-1600000.0
<a href=/player/penac001>penac001</a>,Carlos Pena,Oakland Athletics,ATLTCS,6,8,9,17,2002,2009,7,No,0,16.13,13.6,-2.53,956,906,-50,1909,3247,1338,5469.0,605.0,-4864.0,947000.0,0.0,-947000.0
<a href=/player/penae001>penae001</a>,Elvis Pena,Colorado Rockies,ROCKS,3,5,5,10,2001,2002,1,No,0,3.56,0.31,-3.25,524,189,-335,63,5,-58,907.0,301.0,-606.0,0.0,0.0,0.0
<a href=/player/penaf002>penaf002</a>,Felix Pena,Chicago Cubs,CUBS,1,1,1,2,2017,2017,0,No,0,1.79,0.0,-1.79,74,0,-74,8,0,-8,652.0,0.0,-652.0,0.0,0.0,0.0
<a href=/player/penah001>penah001</a>,Hipolito Pena,Pittsburgh Pirates,PIRATS,1,1,1,2,1988,1989,1,No,0,-0.06,-0.23,-0.17,16,36,20,0,53,53,43.0,0.0,-43.0,0.0,0.0,0.0
<a href=/player/penaj001>penaj001</a>,Jim Pena,San Francisco Giants,GIANTS,1,1,1,2,1992,1992,0,No,0,0.0,0.0,0.0,0,0,0,0,0,0,0.0,0.0,0.0,0.0,0.0,0.0
<a href=/player/penaj003>penaj003</a>,Jesus Pena,Chicago White Sox,WSOX,1,1,1,2,2000,2001,1,No,0,0.08,0.0,-0.08,2,0,-2,0,0,0,9.0,0.0,-9.0,0.0,0.0,0.0
<a href=/player/penaj003>penaj003</a>,Jesus Pena,Milwaukee Brewers,BREWRS,12,23,23,46,2002,2020,18,Yes,1,50.21,31.43,-18.78,4158,2367,-1791,15837,5624,-10213,987.0,3864.0,2877.0,29855500.0,0.0,-29855500.0
<a href=/player/penao101>penao101</a>,Orlando Pena,Cincinnati Reds,REDS,1,2,1,3,1961,1961,0,No,0,0.0,1.5,1.5,0,30,30,0,26,26,0.0,249.0,249.0,0.0,0.0,0.0
<a href=/player/penao101>penao101</a>,Orlando Pena,Milwaukee Braves,BRAVES,1,1,2,3,1962,1962,0,No,0,6.11,0.0,-6.11,202,0,-202,205,0,-205,1684.0,0.0,-1684.0,0.0,0.0,0.0
<a href=/player/penao101>penao101</a>,Orlando Pena,St. Louis Cardinals,CARDS,1,1,1,2,1974,1974,0,No,0,1.0,0.0,-1.0,11,0,-11,0,0,0,62.0,0.0,-62.0,26000.0,0.0,-26000.0
<a href=/player/penar101>penar101</a>,Roberto Pena,Pittsburgh Pirates,PIRATS,1,2,1,3,1964,1964,0,No,0,-0.6,0.0,0.6,57,0,-57,209,0,-209,0.0,0.0,0.0,0.0,0.0,0.0
<a href=/player/penar101>penar101</a>,Roberto Pena,San Diego Padres,PADRS,1,1,1,2,1970,1970,0,No,0,-0.16,-0.13,0.03,19,95,76,62,128,66,0.0,0.0,0.0,0.0,0.0,0.0
<a href=/player/penar101>penar101</a>,Roberto Pena,Oakland Athletics,ATLTCS,2,2,2,4,1970,1971,1,No,0,-0.53,0.26,0.79,234,49,-185,746,99,-647,0.0,17.0,17.0,17000.0,0.0,-17000.0
<a href=/player/penat001>penat001</a>,Tony Pena,Pittsburgh Pirates,PIRATS,2,4,5,9,1987,1994,7,No,0,0.96,41.8,40.84,426,1853,1427,1435,6899,5464,300.0,1043.0,743.0,222500.0,0.0,-222500.0
<a href=/player/penat001>penat001</a>,Tony Pena,Chicago White Sox,WSOX,1,1,1,2,1997,1997,0,No,0,-0.12,0.0,0.12,9,0,-9,22,0,-22,0.0,0.0,0.0,425000.0,0.0,-425000.0
<a href=/player/penat002>penat002</a>,Tony Pena,Atlanta Braves,BRAVES,1,1,1,2,2007,2012,5,No,0,-1.12,0.0,1.12,288,0,-288,824,0,-824,3.0,0.0,-3.0,0.0,0.0,0.0
<a href=/player/penat003>penat003</a>,Tony Pena,Arizona Diamondbacks,DBACKS,3,4,4,8,2009,2016,7,Yes,0,1.96,6.64,4.68,231,745,514,165,216,51,736.0,1007.0,271.0,430000.0,0.0,-430000.0
<a href=/player/penaw001>penaw001</a>,Wily Mo Pena,New York Yankees,YANKS,1,1,2,3,2001,2001,0,No,0,-0.57,-0.57,0.0,302,12,-290,898,39,-859,0.0,0.0,0.0,0.0,0.0,0.0
<a href=/player/penaw001>penaw001</a>,Wily Mo Pena,Cincinnati Reds,REDS,1,1,2,3,2006,2013,7,No,0,-0.3,19.81,20.11,157,531,374,476,612,136,0.0,5071.0,5071.0,0.0,0.0,0.0
<a href=/player/penaw001>penaw001</a>,Wily Mo Pena,Boston Red Sox,RSOX,3,5,4,9,2007,2018,11,No,2,-0.56,0.23,0.79,201,62,-139,531,116,-415,0.0,41.0,41.0,2275000.0,0.0,-2275000.0
<a href=/player/pench001>pench001</a>,Hunter Pence,Houston Astros,ASTROS,5,14,14,28,2011,2019,8,Yes,0,28.03,24.13,-3.9,2041,1132,-909,3948,2705,-1243,3599.0,3065.0,-534.0,9612000.0,0.0,-9612000.0
<a href=/player/pench001>pench001</a>,Hunter Pence,Philadelphia Phillies,PHILS,1,1,3,4,2012,2018,6,No,0,9.8,-0.71,-10.51,789,286,-503,3151,953,-2198,0.0,0.0,0.0,10400000.0,0.0,-10400000.0
<a href=/player/pendj101>pendj101</a>,Jim Pendleton,Brooklyn Dodgers,DOGRS,3,6,5,11,1953,1961,8,No,0,18.08,1.43,-16.65,1862,372,-1490,3448,742,-2706,2426.0,1360.0,-1066.0,0.0,0.0,0.0
<a href=/player/pendj101>pendj101</a>,Jim Pendleton,Milwaukee Braves,BRAVES,1,1,1,2,1957,1957,0,No,0,0.09,-0.52,-0.61,49,15,-34,75,19,-56,0.0,0.0,0.0,0.0,0.0,0.0
<a href=/player/pendj101>pendj101</a>,Jim Pendleton,Pittsburgh Pirates,PIRATS,9,16,18,34,1959,1973,14,No,0,-0.94,37.67,38.61,564,1623,1059,1204,4862,3658,386.0,2327.0,1941.0,17500.0,0.0,-17500.0
<a href=/player/pendt001>pendt001</a>,Terry Pendleton,Florida Marlins,MARLNS,1,1,1,2,1996,1997,1,No,0,-1.29,0.0,1.29,42,0,-42,177,0,-177,0.0,0.0,0.0,1625000.0,0.0,-1625000.0
<a href=/player/pennb001>pennb001</a>,Brad Pennington,Baltimore Orioles,ORLS,2,3,3,6,1995,2003,8,No,0,-0.43,3.97,4.4,40,156,116,91,49,-42,29.0,2220.0,2191.0,0.0,0.0,0.0
<a href=/player/pennb002>pennb002</a>,Brad Penny,Arizona Diamondbacks,DBACKS,1,3,1,4,1999,2004,5,No,0,6.5,2.69,-3.81,696,350,-346,447,0,-447,3453.0,521.0,-2932.0,0.0,0.0,0.0
<a href=/player/pennb002>pennb002</a>,Brad Penny,Florida Marlins,MARLNS,10,19,25,44,2004,2019,15,Yes,0,75.87,54.29,-21.58,2478,2882,404,6294,8326,2032,10672.0,5424.0,-5248.0,38568667.0,0.0,-38568667.0
<a href=/player/pennc001>pennc001</a>,Cliff Pennington,Oakland Athletics,ATLTCS,1,2,2,4,2012,2013,1,No,0,3.02,-0.37,-3.39,236,107,-129,657,375,-282,0.0,0.0,0.0,490000.0,0.0,-490000.0
<a href=/player/pennc001>pennc001</a>,Cliff Pennington,Arizona Diamondbacks,DBACKS,2,5,2,7,2015,2017,2,No,0,-1.71,2.41,4.12,156,62,-94,515,257,-258,0.0,0.0,0.0,3275000.0,0.0,-3275000.0
<a href=/player/pennh001>pennh001</a>,Hayden Penn,Baltimore Orioles,ORLS,2,2,2,4,2009,2013,4,No,0,-1.46,3.07,4.53,61,360,299,87,1223,1136,66.0,0.0,-66.0,1300000.0,0.0,-1300000.0
<a href=/player/pennh101>pennh101</a>,Herb Pennock,Boston Red Sox,RSOX,3,4,6,10,1923,1933,10,No,0,33.57,1.13,-32.44,768,605,-163,1134,1820,686,6610.0,765.0,-5845.0,7200.0,0.0,-7200.0
<a href=/player/pennw001>pennw001</a>,Will Pennyfeather,Cincinnati Reds,REDS,1,1,1,2,1996,1998,2,No,0,0.0,0.57,0.57,0,208,208,0,569,569,0.0,0.0,0.0,0.0,0.0,0.0
<a href=/player/pentg101>pentg101</a>,Gene Pentz,Detroit Tigers,TIGRS,1,4,3,7,1975,1979,4,No,0,4.11,5.38,1.27,431,290,-141,467,862,395,1859.0,1144.0,-715.0,16500.0,0.0,-16500.0
<a href=/player/pepij101>pepij101</a>,Joe Pepitone,New York Yankees,YANKS,3,4,4,8,1969,1973,4,No,0,-0.75,-0.45,0.3,283,287,4,735,928,193,22.0,300.0,278.0,70500.0,0.0,-70500.0
<a href=/player/pepij101>pepij101</a>,Joe Pepitone,Chicago Cubs,CUBS,8,9,10,19,1973,1988,15,No,1,2.88,12.21,9.33,425,1563,1138,1195,5033,3838,160.0,685.0,525.0,0.0,0.0,0.0
<a href=/player/peraf001>peraf001</a>,Freddy Peralta,Seattle Mariners,MARNRS,1,3,1,4,2015,2016,1,No,0,3.41,-0.26,-3.67,178,126,-52,88,430,342,1011.0,0.0,-1011.0,0.0,0.0,0.0
<a href=/player/peraj001>peraj001</a>,Jhonny Peralta,Cleveland Indians,INDINS,1,2,1,3,2010,2016,6,No,0,8.67,0.15,-8.52,460,6,-454,1851,0,-1851,0.0,10.0,10.0,4850000.0,0.0,-4850000.0
<a href=/player/peraj002>peraj002</a>,Joel Peralta,Tampa Bay Devil Rays,RAYS,1,2,2,4,2014,2015,1,Yes,0,0.98,0.23,-0.75,298,5,-293,4,0,-4,353.0,17.0,-336.0,3000000.0,0.0,-3000000.0
<a href=/player/peraj003>peraj003</a>,Jose Peraza,Atlanta Braves,BRAVES,3,7,11,18,2015,2020,5,Yes,0,4.88,-1.29,-6.17,588,465,-123,687,1320,633,1642.0,246.0,-1396.0,24400000.0,0.0,-24400000.0
<a href=/player/peraj003>peraj003</a>,Jose Peraza,Los Angeles Dodgers,DOGRS,3,7,6,13,2015,2019,4,No,0,7.85,6.19,-1.66,1100,293,-807,3346,616,-2730,1782.0,1084.0,-698.0,0.0,0.0,0.0
<a href=/player/perao001>perao001</a>,Oswaldo Peraza,Toronto Blue Jays,BJAYS,1,2,1,3,1987,1990,3,No,0,-2.03,4.09,6.12,69,76,7,0,0,0,1066.0,1357.0,291.0,0.0,0.0,0.0
<a href=/player/peraw002>peraw002</a>,Wandy Peralta,San Francisco Giants,GIANTS,1,2,1,3,2021,2021,0,No,0,0.95,0.0,-0.95,52,65,13,0,175,175,128.0,3.0,-125.0,925000.0,0.0,-925000.0
<a href=/player/percj001>percj001</a>,Jack Perconte,Los Angeles Dodgers,DOGRS,4,5,6,11,1981,1986,5,No,0,8.2,1.95,-6.25,273,439,166,478,515,37,1699.0,432.0,-1267.0,1085000.0,0.0,-1085000.0
<a href=/player/percj001>percj001</a>,Jack Perconte,Cleveland Indians,INDINS,3,4,4,8,1983,1989,6,No,0,6.14,3.15,-2.99,575,539,-36,2408,2048,-360,0.0,224.0,224.0,630000.0,0.0,-630000.0
<a href=/player/perdh101>perdh101</a>,Hub Perdue,Boston Braves,BRAVES,2,4,3,7,1914,1917,3,No,0,5.43,7.31,1.88,759,506,-253,2372,1961,-411,801.0,0.0,-801.0,0.0,0.0,0.0
<a href=/player/perdl001>perdl001</a>,Luis Perdomo,Cleveland Indians,INDINS,1,1,1,2,2008,2011,3,No,0,0.0,0.94,0.94,0,15,15,0,1,1,0.0,218.0,218.0,0.0,0.0,0.0
<a href=/player/perea001>perea001</a>,Antonio Perez,Cincinnati Reds,REDS,2,6,3,9,2000,2013,13,No,0,18.66,15.9,-2.76,696,1440,744,2678,3953,1275,381.0,721.0,340.0,8282695.0,0.0,-8282695.0
<a href=/player/perea001>perea001</a>,Antonio Perez,Seattle Mariners,MARNRS,4,5,5,10,2002,2007,5,No,0,13.67,8.92,-4.75,1087,458,-629,4329,1918,-2411,0.0,0.0,0.0,3750000.0,0.0,-3750000.0
<a href=/player/perea001>perea001</a>,Antonio Perez,Tampa Bay Devil Rays,RAYS,1,1,1,2,2004,2004,0,No,0,1.24,-0.03,-1.27,111,4,-107,301,8,-293,0.0,0.0,0.0,0.0,0.0,0.0
<a href=/player/perea001>perea001</a>,Antonio Perez,Los Angeles Dodgers,DOGRS,1,2,1,3,2005,2017,12,No,0,0.96,21.5,20.54,172,1455,1283,589,5425,4836,0.0,0.0,0.0,2830000.0,0.0,-2830000.0
<a href=/player/pereb001>pereb001</a>,Beltran Perez,Arizona Diamondbacks,DBACKS,2,6,2,8,2005,2009,4,No,0,0.95,0.24,-0.71,303,273,-30,1104,1118,14,0.0,0.0,0.0,10213898.0,0.0,-10213898.0
<a href=/player/perec001>perec001</a>,Carlos Perez,Montreal Expos,NATEX,3,8,7,15,1998,2004,6,No,0,7.97,-4.29,-12.26,909,664,-245,2909,2173,-736,1579.0,285.0,-1294.0,2150000.0,0.0,-2150000.0
<a href=/player/perec002>perec002</a>,Chris Perez,St. Louis Cardinals,CARDS,2,3,2,5,2009,2009,0,No,1,4.0,0.42,-3.58,311,68,-243,0,262,262,883.0,0.0,-883.0,0.0,0.0,0.0
<a href=/player/perec003>perec003</a>,Carlos Perez,Toronto Blue Jays,BJAYS,4,12,6,18,2012,2016,4,No,0,10.83,2.99,-7.84,1068,309,-759,3494,605,-2889,904.0,1431.0,527.0,11237500.0,0.0,-11237500.0
<a href=/player/perec003>perec003</a>,Carlos Perez,Houston Astros,ASTROS,1,2,1,3,2014,2015,1,No,0,3.0,0.42,-2.58,223,73,-150,597,229,-368,587.0,0.0,-587.0,0.0,0.0,0.0
<a href=/player/perec003>perec003</a>,Carlos Perez,Anaheim Angels,ANGELS,1,1,1,2,2018,2018,0,No,0,-0.36,0.14,0.5,8,5,-3,22,7,-15,0.0,0.0,0.0,0.0,0.0,0.0
<a href=/player/perec004>perec004</a>,Cionel Perez,Houston Astros,ASTROS,1,1,1,2,2021,2021,0,Yes,0,-0.48,0.0,0.48,48,0,-48,2,0,-2,72.0,0.0,-72.0,0.0,0.0,0.0
<a href=/player/peree001>peree001</a>,Eduardo Perez,California Angels,ANGELS,1,1,1,2,1996,1996,0,No,0,0.57,0.0,-0.57,208,0,-208,569,0,-569,0.0,0.0,0.0,0.0,0.0,0.0
<a href=/player/peree001>peree001</a>,Eduardo Perez,Cleveland Indians,INDINS,2,3,2,5,2006,2016,10,No,0,0.62,20.22,19.6,182,956,774,661,3995,3334,0.0,0.0,0.0,11750000.0,0.0,-11750000.0
<a href=/player/peree002>peree002</a>,Eddie Perez,Atlanta Braves,BRAVES,1,1,1,2,2002,2002,0,No,0,-0.36,0.0,0.36,42,0,-42,125,0,-125,0.0,0.0,0.0,0.0,0.0,0.0
<a href=/player/peref001>peref001</a>,Fernando Perez,Tampa Bay Devil Rays,RAYS,3,5,10,15,2011,2018,7,Yes,0,7.14,19.57,12.43,511,809,298,692,1746,1054,1779.0,3357.0,1578.0,0.0,0.0,0.0
<a href=/player/pereh002>pereh002</a>,Hector Perez,Houston Astros,ASTROS,1,3,1,4,2018,2020,2,No,0,2.45,2.96,0.51,92,98,6,0,0,0,254.0,276.0,22.0,4600000.0,0.0,-4600000.0
<a href=/player/pereh002>pereh002</a>,Hector Perez,Toronto Blue Jays,BJAYS,1,1,1,2,2021,2021,0,Yes,0,0.0,0.0,0.0,0,0,0,0,0,0,0.0,0.0,0.0,0.0,0.0,0.0
<a href=/player/perem001>perem001</a>,Melido Perez,Kansas City Royals,ROYALS,2,5,3,8,1987,1989,2,No,0,6.71,1.86,-4.85,503,45,-458,494,0,-494,4503.0,794.0,-3709.0,62500.0,0.0,-62500.0
<a href=/player/perem001>perem001</a>,Melido Perez,Chicago White Sox,WSOX,1,3,1,4,1992,1994,2,No,0,12.77,-0.22,-12.99,326,200,-126,0,759,759,3273.0,0.0,-3273.0,0.0,0.0,0.0
<a href=/player/perem005>perem005</a>,Michael Perez,Arizona Diamondbacks,DBACKS,2,3,2,5,2018,2021,3,No,0,1.28,-0.96,-2.24,100,134,34,228,7,-221,96.0,270.0,174.0,0.0,0.0,0.0
<a href=/player/perem101>perem101</a>,Marty Perez,California Angels,ANGELS,1,1,1,2,1970,1970,0,No,0,-0.67,0.0,0.67,690,0,-690,2639,0,-2639,0.0,0.0,0.0,7200.0,0.0,-7200.0
<a href=/player/perem101>perem101</a>,Marty Perez,Atlanta Braves,BRAVES,5,7,13,20,1976,1983,7,No,0,20.68,4.17,-16.51,1646,914,-732,6239,1922,-4317,541.0,2701.0,2160.0,480000.0,0.0,-480000.0
<a href=/player/perem101>perem101</a>,Marty Perez,San Francisco Giants,GIANTS,1,1,1,2,1977,1981,4,No,0,0.02,5.55,5.53,1,514,513,4,1688,1684,0.0,0.0,0.0,0.0,0.0,0.0
<a href=/player/perem101>perem101</a>,Marty Perez,New York Yankees,YANKS,2,4,2,6,1977,1985,8,No,1,-3.76,2.42,6.18,344,31,-313,885,0,-885,78.0,651.0,573.0,0.0,0.0,0.0
<a href=/player/peren001>peren001</a>,Neifi Perez,Colorado Rockies,ROCKS,2,2,4,6,2001,2003,2,No,0,0.54,0.24,-0.3,588,89,-499,2468,292,-2176,0.0,28.0,28.0,3550000.0,0.0,-3550000.0
<a href=/player/peren001>peren001</a>,Neifi Perez,Chicago Cubs,CUBS,1,1,1,2,2006,2011,5,No,0,-0.51,0.0,0.51,54,0,-54,141,0,-141,0.0,0.0,0.0,2500000.0,0.0,-2500000.0
<a href=/player/pereo001>pereo001</a>,Odalis Perez,Atlanta Braves,BRAVES,1,3,1,4,2002,2003,1,No,0,12.57,11.23,-1.34,452,290,-162,1035,1257,222,2316.0,0.0,-2316.0,0.0,0.0,0.0
<a href=/player/pereo001>pereo001</a>,Odalis Perez,Los Angeles Dodgers,DOGRS,2,5,3,8,2006,2007,1,No,0,-0.56,-0.24,0.32,64,85,21,5,67,62,658.0,69.0,-589.0,8750000.0,0.0,-8750000.0
<a href=/player/pereo002>pereo002</a>,Oliver Perez,San Diego Padres,PADRS,1,3,1,4,2003,2009,6,No,0,19.18,17.35,-1.83,859,833,-26,3184,3689,505,1194.0,0.0,-1194.0,305000.0,0.0,-305000.0
<a href=/player/pereo002>pereo002</a>,Oliver Perez,Pittsburgh Pirates,PIRATS,3,5,7,12,2006,2016,10,No,0,1.97,9.91,7.94,388,1408,1020,455,3224,2769,1770.0,3210.0,1440.0,14150000.0,0.0,-14150000.0
<a href=/player/pereo002>pereo002</a>,Oliver Perez,Arizona Diamondbacks,DBACKS,1,1,1,2,2015,2015,0,Yes,0,-0.72,0.0,0.72,25,0,-25,0,0,0,36.0,0.0,-36.0,2500000.0,0.0,-2500000.0
<a href=/player/perep001>perep001</a>,Pascual Perez,Pittsburgh Pirates,PIRATS,1,2,1,3,1982,1987,5,No,0,6.94,8.17,1.23,204,340,136,222,296,74,1805.0,2507.0,702.0,0.0,0.0,0.0
<a href=/player/perer001>perer001</a>,Robert Perez,Seattle Mariners,MARNRS,1,1,1,2,1998,1999,1,No,0,-0.92,-0.03,0.89,52,1,-51,110,1,-109,0.0,0.0,0.0,215000.0,0.0,-215000.0
<a href=/player/peres001>peres001</a>,Santiago Perez,Detroit Tigers,TIGRS,3,5,3,8,1997,2009,12,No,0,-1.75,6.44,8.19,380,244,-136,75,32,-43,652.0,3275.0,2623.0,4485000.0,0.0,-4485000.0
<a href=/player/peres001>peres001</a>,Santiago Perez,Milwaukee Brewers,BREWRS,1,2,2,4,2000,2001,1,No,0,-0.17,-1.16,-0.99,43,82,39,97,8,-89,0.0,184.0,184.0,0.0,0.0,0.0
<a href=/player/peret001>peret001</a>,Tony Perez,Cincinnati Reds,REDS,3,5,4,9,1976,1981,5,No,0,8.77,1.11,-7.66,1082,372,-710,1854,353,-1501,1843.0,1635.0,-208.0,85000.0,0.0,-85000.0
<a href=/player/peret003>peret003</a>,Tomas Perez,Toronto Blue Jays,BJAYS,1,1,2,3,1999,1999,0,No,0,0.0,-0.47,-0.47,0,27,27,0,104,104,0.0,0.0,0.0,0.0,0.0,0.0
<a href=/player/peret003>peret003</a>,Tomas Perez,Los Angeles Dodgers,DOGRS,1,1,1,2,2007,2007,0,No,0,0.0,0.0,0.0,0,0,0,0,0,0,0.0,0.0,0.0,0.0,0.0,0.0
<a href=/player/peret004>peret004</a>,Timo Perez,New York Mets,METS,2,2,2,4,2004,2005,1,No,0,-1.71,0.76,2.47,193,28,-165,517,19,-498,105.0,208.0,103.0,0.0,0.0,0.0
<a href=/player/perey001>perey001</a>,Yorkis Perez,Minnesota Twins,TWINS,6,12,11,23,1987,2007,20,No,6,9.32,35.62,26.3,1101,1557,456,2383,5077,2694,2963.0,1837.0,-1126.0,103500.0,0.0,-103500.0
<a href=/player/perey001>perey001</a>,Yorkis Perez,Atlanta Braves,BRAVES,1,2,2,4,1991,1993,2,No,0,0.81,1.0,0.19,361,259,-102,26,720,694,723.0,247.0,-476.0,0.0,0.0,0.0
<a href=/player/perey001>perey001</a>,Yorkis Perez,Florida Marlins,MARLNS,1,1,1,2,1996,1996,0,No,0,0.0,0.0,0.0,0,0,0,0,0,0,0.0,0.0,0.0,187500.0,0.0,-187500.0
<a href=/player/perey001>perey001</a>,Yorkis Perez,Philadelphia Phillies,PHILS,1,1,1,2,2000,2000,0,No,0,-0.27,-0.49,-0.22,65,28,-37,1,0,-1,68.0,42.0,-26.0,0.0,0.0,0.0
<a href=/player/perim001>perim001</a>,Matt Perisho,Anaheim Angels,ANGELS,1,1,1,2,1997,1997,0,No,0,-1.83,0.0,1.83,42,0,-42,4,0,-4,361.0,0.0,-361.0,0.0,0.0,0.0
<a href=/player/perim001>perim001</a>,Matt Perisho,Texas Rangers,RNGRS,1,1,2,3,2000,2001,1,No,0,-0.7,-0.26,0.44,35,6,-29,0,0,0,149.0,17.0,-132.0,220000.0,0.0,-220000.0
<a href=/player/perkb001>perkb001</a>,Broderick Perkins,San Diego Padres,PADRS,4,7,5,12,1982,1994,12,No,1,4.07,-0.5,-4.57,850,470,-380,2345,1007,-1338,402.0,1199.0,797.0,130000.0,0.0,-130000.0
<a href=/player/perkh101>perkh101</a>,Harry Perkowski,Cincinnati Reds,REDS,2,7,3,10,1954,1960,6,No,0,0.48,13.19,12.71,599,458,-141,824,407,-417,733.0,2898.0,2165.0,18000.0,0.0,-18000.0
<a href=/player/perrb102>perrb102</a>,Boyd Perry,Detroit Tigers,TIGRS,1,2,1,3,1941,1946,5,No,0,-0.12,-1.38,-1.26,211,88,-123,687,313,-374,0.0,0.0,0.0,0.0,0.0,0.0
<a href=/player/perrb103>perrb103</a>,Bob Perry,California Angels,ANGELS,4,5,4,9,1965,1968,3,No,0,0.31,0.94,0.63,412,135,-277,701,312,-389,443.0,0.0,-443.0,0.0,0.0,0.0
<a href=/player/perrg001>perrg001</a>,Gerald Perry,Atlanta Braves,BRAVES,4,6,5,11,1989,1999,10,No,0,0.53,8.7,8.17,181,486,305,594,687,93,451.0,1914.0,1463.0,3957333.0,0.0,-3957333.0
<a href=/player/perrg101>perrg101</a>,Gaylord Perry,San Francisco Giants,GIANTS,1,2,1,3,1971,1973,2,No,0,40.19,-0.73,-40.92,981,92,-889,2877,77,-2800,3392.0,613.0,-2779.0,84000.0,0.0,-84000.0
<a href=/player/perrg101>perrg101</a>,Gaylord Perry,Cleveland Indians,INDINS,6,8,12,20,1975,1989,14,No,0,21.49,50.63,29.14,1345,2557,1212,3843,7581,3738,3489.0,7610.0,4121.0,1675000.0,0.0,-1675000.0
<a href=/player/perrg101>perrg101</a>,Gaylord Perry,Texas Rangers,RNGRS,1,1,2,3,1978,1978,0,No,0,6.57,0.0,-6.57,138,0,-138,186,0,-186,1480.0,0.0,-1480.0,0.0,0.0,0.0
<a href=/player/perrg101>perrg101</a>,Gaylord Perry,San Diego Padres,PADRS,4,8,6,14,1980,1984,4,No,0,16.75,2.24,-14.51,1038,424,-614,3623,1747,-1876,529.0,0.0,-529.0,0.0,0.0,0.0
<a href=/player/perrg101>perrg101</a>,Gaylord Perry,Texas Rangers,RNGRS,5,11,12,23,1980,1987,7,No,0,9.05,9.46,0.41,696,433,-263,1581,631,-950,2873.0,2813.0,-60.0,1017500.0,0.0,-1017500.0
<a href=/player/perrh001>perrh001</a>,Herbert Perry,Chicago White Sox,WSOX,1,1,1,2,2001,2002,1,No,0,1.52,0.0,-1.52,192,0,-192,673,0,-673,0.0,0.0,0.0,975000.0,0.0,-975000.0
<a href=/player/perrj001>perrj001</a>,Jason Perry,Toronto Blue Jays,BJAYS,1,1,1,2,2003,2007,4,No,0,0.0,0.24,0.24,0,13,13,0,27,27,0.0,0.0,0.0,0.0,0.0,0.0
<a href=/player/perrj001>perrj001</a>,Jason Perry,Oakland Athletics,ATLTCS,2,2,2,4,2007,2009,2,No,0,0.6,3.82,3.22,51,236,185,167,804,637,0.0,0.0,0.0,410000.0,0.0,-410000.0
<a href=/player/perrj102>perrj102</a>,Jim Perry,Cleveland Indians,INDINS,1,1,1,2,1963,1967,4,No,0,28.75,6.39,-22.36,756,234,-522,681,180,-501,5649.0,1633.0,-4016.0,0.0,0.0,0.0
<a href=/player/perrj102>perrj102</a>,Jim Perry,Minnesota Twins,TWINS,1,1,2,3,1973,1973,0,No,0,3.47,0.39,-3.08,35,10,-25,0,0,0,609.0,155.0,-454.0,0.0,0.0,0.0
<a href=/player/perrj102>perrj102</a>,Jim Perry,Detroit Tigers,TIGRS,1,2,1,3,1974,1975,1,No,0,3.2,-0.06,-3.26,44,74,30,0,215,215,869.0,0.0,-869.0,0.0,0.0,0.0
<a href=/player/perrj102>perrj102</a>,Jim Perry,Cleveland Indians,INDINS,3,5,4,9,1975,1976,1,No,0,-1.95,0.82,2.77,177,25,-152,203,0,-203,1075.0,430.0,-645.0,68000.0,0.0,-68000.0
<a href=/player/perrp001>perrp001</a>,Pat Perry,St. Louis Cardinals,CARDS,1,1,1,2,1987,1992,5,No,0,0.2,3.8,3.6,48,420,372,2,106,104,108.0,1331.0,1223.0,80000.0,0.0,-80000.0
<a href=/player/perrp001>perrp001</a>,Pat Perry,Cincinnati Reds,REDS,1,2,1,3,1988,1988,0,No,0,1.9,-0.23,-2.13,108,21,-87,7,56,49,221.0,0.0,-221.0,132500.0,0.0,-132500.0
<a href=/player/perrp101>perrp101</a>,Pol Perritt,St. Louis Cardinals,CARDS,2,6,3,9,1915,1917,2,No,0,6.22,3.34,-2.88,339,351,12,336,1359,1023,2915.0,256.0,-2659.0,9800.0,0.0,-9800.0
<a href=/player/perrr001>perrr001</a>,Ryan Perry,Detroit Tigers,TIGRS,1,1,1,2,2011,2012,1,No,0,-0.38,-0.24,0.14,14,11,-3,0,0,0,24.0,54.0,30.0,430000.0,0.0,-430000.0
<a href=/player/perrr101>perrr101</a>,Ron Perranoski,Chicago Cubs,CUBS,1,4,1,5,1960,1961,1,No,0,14.78,2.04,-12.74,914,260,-654,121,914,793,2300.0,0.0,-2300.0,0.0,0.0,0.0
<a href=/player/perrr101>perrr101</a>,Ron Perranoski,Los Angeles Dodgers,DOGRS,1,3,2,5,1967,1968,1,No,0,7.85,0.27,-7.58,924,202,-722,948,467,-481,1656.0,285.0,-1371.0,122000.0,0.0,-122000.0
<a href=/player/perrs101>perrs101</a>,Scott Perry,Atlanta,Atlanta,1,1,2,3,1918,1933,15,No,0,13.2,0.0,-13.2,246,0,-246,312,0,-312,2543.0,0.0,-2543.0,0.0,0.0,0.0
<a href=/player/persr001>persr001</a>,Robert Person,Cleveland Indians,INDINS,1,1,1,2,1991,1991,0,No,0,0.0,0.0,0.0,0,0,0,0,0,0,0.0,0.0,0.0,0.0,0.0,0.0
<a href=/player/persr001>persr001</a>,Robert Person,Florida Marlins,MARLNS,1,1,1,2,1994,1994,0,No,0,0.35,0.0,-0.35,62,0,-62,29,0,-29,305.0,0.0,-305.0,0.0,0.0,0.0
<a href=/player/persr001>persr001</a>,Robert Person,New York Mets,METS,5,11,12,23,1996,2008,12,No,2,10.73,16.79,6.06,1400,812,-588,2314,3030,716,2146.0,327.0,-1819.0,8109000.0,0.0,-8109000.0
<a href=/player/persr001>persr001</a>,Robert Person,Toronto Blue Jays,BJAYS,4,6,9,15,1999,2001,2,No,0,9.12,-0.22,-9.34,292,332,40,290,474,184,2704.0,617.0,-2087.0,8979000.0,0.0,-8979000.0
<a href=/player/pertb101>pertb101</a>,Bill Pertica,LosAngeles,LosAngeles,1,1,3,4,1921,1924,3,No,0,-0.82,0.0,0.82,147,0,-147,111,0,-111,984.0,0.0,-984.0,0.0,0.0,0.0
<a href=/player/perzs101>perzs101</a>,Stan Perzanowski,Chicago White Sox,WSOX,3,6,6,12,1975,1978,3,No,0,1.91,-0.17,-2.08,438,278,-160,1261,1093,-168,251.0,0.0,-251.0,70000.0,0.0,-70000.0
<a href=/player/perzs101>perzs101</a>,Stan Perzanowski,Texas Rangers,RNGRS,1,2,1,3,1976,1977,1,No,0,0.0,0.1,0.1,0,4,4,0,0,0,0.0,45.0,45.0,0.0,0.0,0.0
<a href=/player/perzs101>perzs101</a>,Stan Perzanowski,Cleveland Indians,INDINS,1,2,1,3,1977,1977,0,No,0,0.0,0.05,0.05,0,50,50,0,154,154,0.0,0.0,0.0,0.0,0.0,0.0
<a href=/player/peskj101>peskj101</a>,Johnny Pesky,Boston Red Sox,RSOX,2,6,6,12,1952,1956,4,No,0,8.2,10.1,1.9,1335,867,-468,4777,3045,-1732,507.0,401.0,-106.0,80000.0,0.0,-80000.0
<a href=/player/peskj101>peskj101</a>,Johnny Pesky,Detroit Tigers,TIGRS,1,1,1,2,1954,1954,0,No,0,-0.31,0.0,0.31,49,0,-49,171,0,-171,0.0,0.0,0.0,15000.0,0.0,-15000.0
<a href=/player/pestv001>pestv001</a>,Vinnie Pestano,Cleveland Indians,INDINS,2,4,7,11,2014,2020,6,Yes,0,0.74,12.54,11.8,37,143,106,4,89,85,121.0,1614.0,1493.0,4100000.0,0.0,-4100000.0
<a href=/player/petar001>petar001</a>,Roberto Petagine,Houston Astros,ASTROS,15,31,38,69,1994,2011,17,No,2,59.26,30.42,-28.84,4671,6149,1478,11202,16044,4842,6620.0,5977.0,-643.0,31714000.0,0.0,-31714000.0
<a href=/player/petar001>petar001</a>,Roberto Petagine,San Diego Padres,PADRS,1,2,2,4,1996,1996,0,No,0,-0.29,0.02,0.31,62,2,-60,131,0,-131,0.0,2.0,2.0,0.0,0.0,0.0
<a href=/player/petar001>petar001</a>,Roberto Petagine,New York Mets,METS,1,1,1,2,1998,1998,0,No,0,0.52,0.0,-0.52,34,0,-34,79,0,-79,0.0,0.0,0.0,0.0,0.0,0.0
<a href=/player/petea001>petea001</a>,Adam Peterson,Chicago White Sox,WSOX,2,3,4,7,1991,1997,6,No,0,-0.66,5.47,6.13,79,723,644,105,2072,1967,199.0,133.0,-66.0,200000.0,0.0,-200000.0
<a href=/player/petea002>petea002</a>,Adam Peterson,Toronto Blue Jays,BJAYS,2,3,2,5,2005,2010,5,No,0,0.24,4.38,4.14,281,377,96,251,964,713,321.0,419.0,98.0,6148500.0,0.0,-6148500.0
<a href=/player/petec002>petec002</a>,Chris Petersen,Pittsburgh Pirates,PIRATS,1,1,1,2,2001,2001,0,No,0,0.0,0.0,0.0,0,0,0,0,0,0,0.0,0.0,0.0,0.0,0.0,0.0
<a href=/player/petec101>petec101</a>,Cap Peterson,San Francisco Giants,GIANTS,3,4,3,7,1966,1972,6,No,0,-2.2,6.95,9.15,357,389,32,728,341,-387,457.0,2870.0,2413.0,17000.0,0.0,-17000.0
<a href=/player/petec101>petec101</a>,Cap Peterson,Washington Senators,RNGRS,1,1,1,2,1969,1969,0,No,0,-0.29,0.0,0.29,76,0,-76,137,0,-137,0.0,0.0,0.0,0.0,0.0,0.0
<a href=/player/peted001>peted001</a>,Dillon Peters,Miami Marlins,MARLNS,1,1,1,2,2018,2018,0,Yes,0,-0.28,0.0,0.28,18,0,-18,0,0,0,221.0,0.0,-221.0,1090000.0,0.0,-1090000.0
<a href=/player/peted002>peted002</a>,Dustin Peterson,San Diego Padres,PADRS,1,4,2,6,2014,2016,2,No,0,14.14,4.21,-9.93,618,150,-468,1586,620,-966,1341.0,0.0,-1341.0,0.0,0.0,0.0
<a href=/player/petef101>petef101</a>,Fritz Peterson,New York Yankees,YANKS,18,35,30,65,1974,2001,27,No,1,68.7,43.61,-25.09,4667,3496,-1171,10476,9633,-843,15153.0,7546.0,-7607.0,4780000.0,0.0,-4780000.0
<a href=/player/petef101>petef101</a>,Fritz Peterson,Cleveland Indians,INDINS,2,3,3,6,1976,1977,1,No,0,0.1,0.05,-0.05,4,50,46,0,154,154,45.0,0.0,-45.0,0.0,0.0,0.0
<a href=/player/peteg101>peteg101</a>,Gary Peters,Chicago White Sox,WSOX,9,18,15,33,1969,1985,16,No,1,26.9,26.12,-0.78,2363,1756,-607,5130,5926,796,6374.0,2182.0,-4192.0,150950.0,0.0,-150950.0
<a href=/player/petej002>petej002</a>,Jace Peterson,San Diego Padres,PADRS,1,4,2,6,2014,2016,2,No,0,14.14,4.21,-9.93,618,150,-468,1586,620,-966,1341.0,0.0,-1341.0,0.0,0.0,0.0
<a href=/player/petej101>petej101</a>,Jim Peterson,Philadelphia Athletics,ATLTCS,2,4,4,8,1933,1936,3,No,0,40.03,8.42,-31.61,1089,278,-811,4170,340,-3830,1354.0,2184.0,830.0,8500.0,0.0,-8500.0
<a href=/player/petej102>petej102</a>,John Peters,Philadelphia Phillies,PHILS,4,9,8,17,1922,1936,14,No,0,25.37,3.27,-22.1,1352,2052,700,5364,8721,3357,77.0,0.0,-77.0,43100.0,0.0,-43100.0
<a href=/player/petek101>petek101</a>,Kent Peterson,Cincinnati Reds,REDS,3,4,4,8,1952,1958,6,No,0,0.93,3.9,2.97,451,195,-256,1172,136,-1036,552.0,1210.0,658.0,0.0,0.0,0.0
<a href=/player/peter101>peter101</a>,Rusty Peters,Albany,Albany,1,1,2,3,1935,1935,0,No,0,-0.88,0.0,0.88,163,0,-163,516,0,-516,0.0,0.0,0.0,0.0,0.0,0.0
<a href=/player/peter103>peter103</a>,Ray Peters,Milwaukee Brewers,BREWRS,4,7,4,11,1971,1976,5,No,0,4.46,14.89,10.43,682,733,51,2218,2738,520,335.0,0.0,-335.0,159600.0,0.0,-159600.0
<a href=/player/petes001>petes001</a>,Steve Peters,St. Louis Cardinals,CARDS,1,2,1,3,1990,1995,5,No,0,0.0,4.64,4.64,0,288,288,0,209,209,0.0,1818.0,1818.0,0.0,0.0,0.0
<a href=/player/petes002>petes002</a>,Shane Peterson,St. Louis Cardinals,CARDS,1,3,1,4,2009,2016,7,No,0,-0.87,23.07,23.94,9,982,973,8,4121,4113,101.0,0.0,-101.0,0.0,0.0,0.0
<a href=/player/petig001>petig001</a>,Gregorio Petit,Oakland Athletics,ATLTCS,1,1,1,2,2010,2010,0,No,0,0.0,-0.13,-0.13,0,7,7,0,0,0,0.0,33.0,33.0,0.0,0.0,0.0
<a href=/player/petig001>petig001</a>,Gregorio Petit,Houston Astros,ASTROS,1,1,1,2,2015,2015,0,No,0,-0.62,0.0,0.62,20,0,-20,47,0,-47,0.0,0.0,0.0,0.0,0.0,0.0
<a href=/player/petiy001>petiy001</a>,Yusmeiro Petit,New York Mets,METS,1,3,2,5,2005,2009,4,No,0,-3.72,4.84,8.56,420,468,48,1504,2023,519,79.0,0.0,-79.0,0.0,0.0,0.0
<a href=/player/petiy001>petiy001</a>,Yusmeiro Petit,Florida Marlins,MARLNS,2,2,3,5,2007,2007,0,No,0,0.94,-1.05,-1.99,224,64,-160,62,40,-22,767.0,357.0,-410.0,3600000.0,0.0,-3600000.0
<a href=/player/petkm001>petkm001</a>,Mark Petkovsek,St. Louis Cardinals,CARDS,1,1,1,2,1998,1998,0,No,0,2.17,0.0,-2.17,139,0,-139,0,0,0,492.0,0.0,-492.0,475000.0,0.0,-475000.0
<a href=/player/petrb001>petrb001</a>,Ben Petrick,Colorado Rockies,ROCKS,1,1,1,2,2003,2004,1,No,0,0.19,0.08,-0.11,43,94,51,129,8,-121,0.0,195.0,195.0,0.0,0.0,0.0
<a href=/player/petrd001>petrd001</a>,Dan Petry,Detroit Tigers,TIGRS,1,1,1,2,1987,1989,2,No,0,0.47,4.72,4.25,41,248,207,0,1048,1048,572.0,0.0,-572.0,975000.0,0.0,-975000.0
<a href=/player/petrd001>petrd001</a>,Dan Petry,Detroit Tigers,TIGRS,1,1,1,2,1991,1991,0,No,0,-0.06,0.0,0.06,20,0,-20,5,0,-5,73.0,0.0,-73.0,650000.0,0.0,-650000.0
<a href=/player/petrd001>petrd001</a>,Dan Petry,Atlanta Braves,BRAVES,1,1,1,2,1991,1991,0,No,0,-0.64,0.0,0.64,13,0,-13,0,0,0,67.0,0.0,-67.0,0.0,0.0,0.0
<a href=/player/petrj001>petrj001</a>,Jake Petricka,Milwaukee Brewers,BREWRS,1,1,1,2,2019,2019,0,No,0,0.0,0.0,0.0,0,0,0,0,0,0,0.0,0.0,0.0,0.0,0.0,0.0
<a href=/player/pettc101>pettc101</a>,Charlie Petty,New York Giants,GIANTS,2,6,3,9,1894,1899,5,No,0,4.47,33.12,28.65,259,755,496,879,2015,1136,369.0,5250.0,4881.0,0.0,0.0,0.0
<a href=/player/pettg001>pettg001</a>,Gary Pettis,California Angels,ANGELS,1,1,1,2,1987,1989,2,No,0,6.22,0.47,-5.75,296,41,-255,1208,0,-1208,0.0,572.0,572.0,400000.0,0.0,-400000.0
<a href=/player/pettj101>pettj101</a>,Joe Pettini,Montreal Expos,NATEX,1,2,1,3,1980,1981,1,No,0,-1.01,-0.09,0.92,188,37,-151,392,58,-334,0.0,0.0,0.0,0.0,0.0,0.0
<a href=/player/pettj102>pettj102</a>,Jay Pettibone,Minnesota Twins,TWINS,1,2,1,3,1984,1984,0,No,0,0.0,-0.19,-0.19,0,12,12,0,37,37,0.0,0.0,0.0,0.0,0.0,0.0
<a href=/player/pettj103>pettj103</a>,Jesse Petty,Brooklyn Dodgers,DOGRS,1,2,1,3,1928,1934,6,No,0,0.53,8.54,8.01,100,434,334,99,1570,1471,677.0,0.0,-677.0,21000.0,0.0,-21000.0
<a href=/player/pevem001>pevem001</a>,Marty Pevey,St. Louis Cardinals,CARDS,1,1,1,2,1988,1988,0,No,0,-0.24,0.0,0.24,13,0,-13,42,0,-42,0.0,0.0,0.0,0.0,0.0,0.0
<a href=/player/pezzp101>pezzp101</a>,Pretzel Pezzullo,New York Giants,GIANTS,3,12,5,17,1934,1949,15,No,0,8.76,66.74,57.98,1268,2382,1114,4502,9585,5083,296.0,0.0,-296.0,0.0,0.0,0.0
<a href=/player/pfeff101>pfeff101</a>,Fred Pfeffer,Chicago Cubs,CUBS,1,1,2,3,1892,1892,0,No,0,5.85,-0.83,-6.68,367,118,-249,1608,487,-1121,36.0,0.0,-36.0,0.0,0.0,0.0
<a href=/player/pfeff102>pfeff102</a>,Big Jeff Pfeffer,Chicago Cubs,CUBS,1,2,1,3,1905,1910,5,No,0,1.88,3.49,1.61,264,262,-2,476,905,429,1653.0,0.0,-1653.0,0.0,0.0,0.0
<a href=/player/pfeff102>pfeff102</a>,Big Jeff Pfeffer,Chicago Cubs,CUBS,1,2,1,3,1911,1912,1,No,0,-1.23,-0.64,0.59,195,54,-141,626,160,-466,292.0,0.0,-292.0,0.0,0.0,0.0
<a href=/player/pfefj101>pfefj101</a>,Jeff Pfeffer,Brooklyn Dodgers,DOGRS,1,1,2,3,1921,1921,0,No,0,4.34,-0.35,-4.69,209,84,-125,222,117,-105,1768.0,183.0,-1585.0,7500.0,0.0,-7500.0
<a href=/player/pfeib101>pfeib101</a>,Bobby Pfeil,Chicago Cubs,CUBS,2,3,2,5,1965,1966,1,No,0,2.3,1.05,-1.25,454,82,-372,65,4,-61,1253.0,197.0,-1056.0,0.0,0.0,0.0
<a href=/player/pfeib101>pfeib101</a>,Bobby Pfeil,New York Mets,METS,2,2,2,4,1970,1971,1,No,0,0.07,0.0,-0.07,51,0,-51,91,0,-91,0.0,0.0,0.0,0.0,0.0,0.0
<a href=/player/pfeib101>pfeib101</a>,Bobby Pfeil,Philadelphia Phillies,PHILS,1,1,1,2,1972,1972,0,No,0,0.0,0.0,0.0,0,0,0,0,0,0,0.0,0.0,0.0,0.0,0.0,0.0
<a href=/player/pfiej101>pfiej101</a>,Jack Pfiester,Chicago Cubs,CUBS,1,1,1,2,1911,1911,0,No,0,0.0,-0.33,-0.33,0,44,44,0,10,10,0.0,161.0,161.0,0.0,0.0,0.0
<a href=/player/phamt001>phamt001</a>,Tommy Pham,St. Louis Cardinals,CARDS,1,2,3,5,2018,2021,3,Yes,0,6.49,-1.04,-7.53,184,57,-127,828,143,-685,0.0,3.0,3.0,570100.0,0.0,-570100.0
<a href=/player/phamt001>phamt001</a>,Tommy Pham,Tampa Bay Devil Rays,RAYS,1,2,3,5,2019,2020,1,Yes,0,7.81,-0.02,-7.83,393,42,-351,1521,139,-1382,2.0,0.0,-2.0,4100000.0,0.0,-4100000.0
<a href=/player/phegj001>phegj001</a>,Josh Phegley,Chicago White Sox,WSOX,1,4,2,6,2014,2018,4,No,0,32.02,0.52,-31.5,1179,80,-1099,4237,2,-4235,1580.0,819.0,-761.0,500000.0,0.0,-500000.0
<a href=/player/phela101>phela101</a>,Art Phelan,Cincinnati Reds,REDS,3,8,5,13,1912,1913,1,No,0,9.38,6.71,-2.67,842,270,-572,2287,704,-1583,1567.0,500.0,-1067.0,11280.0,0.0,-11280.0
<a href=/player/phelb101>phelb101</a>,Babe Phelps,Brooklyn Dodgers,DOGRS,1,4,1,5,1941,1948,7,No,0,4.25,10.42,6.17,798,406,-392,2943,1540,-1403,336.0,0.0,-336.0,0.0,0.0,0.0
<a href=/player/phelb101>phelb101</a>,Babe Phelps,Pittsburgh Pirates,PIRATS,1,2,1,3,1943,1946,3,No,0,0.0,1.71,1.71,0,302,302,0,1252,1252,0.0,0.0,0.0,0.0,0.0,0.0
<a href=/player/pheld001>pheld001</a>,David Phelps,New York Yankees,YANKS,1,3,3,6,2014,2016,2,Yes,0,8.73,2.98,-5.75,736,115,-621,1879,164,-1715,737.0,839.0,102.0,11541425.0,0.0,-11541425.0
<a href=/player/pheld001>pheld001</a>,David Phelps,Miami Marlins,MARLNS,1,1,4,5,2017,2017,0,Yes,0,0.23,0.0,-0.23,11,0,-11,0,0,0,26.0,0.0,-26.0,4600000.0,0.0,-4600000.0
<a href=/player/pheld001>pheld001</a>,David Phelps,Toronto Blue Jays,BJAYS,1,2,1,3,2019,2019,0,Yes,0,0.37,0.0,-0.37,48,0,-48,0,0,0,51.0,0.0,-51.0,2500000.0,0.0,-2500000.0
<a href=/player/pheld001>pheld001</a>,David Phelps,Milwaukee Brewers,BREWRS,1,1,3,4,2020,2020,0,Yes,0,-0.6,0.0,0.6,10,0,-10,0,0,0,23.0,0.0,-23.0,1250000.0,0.0,-1250000.0
<a href=/player/phele101>phele101</a>,Ed Phelps,Pittsburgh Pirates,PIRATS,1,1,1,2,1905,1905,0,No,0,-0.05,0.66,0.71,56,88,32,217,316,99,0.0,0.0,0.0,0.0,0.0,0.0
<a href=/player/phelj001>phelj001</a>,Josh Phelps,Toronto Blue Jays,BJAYS,1,1,1,2,2004,2005,1,No,0,0.37,0.08,-0.29,24,14,-10,80,39,-41,0.0,0.0,0.0,342000.0,0.0,-342000.0
<a href=/player/phelk001>phelk001</a>,Ken Phelps,Kansas City Royals,ROYALS,1,1,1,2,1982,1982,0,No,0,0.0,-0.75,-0.75,10,20,10,9,0,-9,0.0,115.0,115.0,0.0,0.0,0.0
<a href=/player/phelk001>phelk001</a>,Ken Phelps,Seattle Mariners,MARNRS,1,1,3,4,1988,2001,13,No,0,1.01,23.05,22.04,131,1440,1309,342,5828,5486,0.0,0.0,0.0,670000.0,0.0,-670000.0
<a href=/player/phelk001>phelk001</a>,Ken Phelps,New York Yankees,YANKS,1,1,1,2,1989,1989,0,No,0,-0.13,0.0,0.13,43,0,-43,85,0,-85,0.0,0.0,0.0,655000.0,0.0,-655000.0
<a href=/player/phelr101>phelr101</a>,Ray Phelps,Brooklyn Dodgers,DOGRS,1,4,1,5,1933,1933,0,No,0,0.0,0.0,0.0,0,0,0,0,0,0,0.0,0.0,0.0,0.0,0.0,0.0
<a href=/player/phila001>phila001</a>,Andy Phillips,Pittsburgh Pirates,PIRATS,1,1,1,2,2009,2009,0,No,0,0.0,0.0,0.0,0,0,0,0,0,0,0.0,0.0,0.0,0.0,0.0,0.0
<a href=/player/phila101>phila101</a>,Adolfo Phillips,Philadelphia Phillies,PHILS,1,3,2,5,1966,1968,2,No,0,66.82,10.77,-56.05,1243,294,-949,2604,327,-2277,8021.0,2661.0,-5360.0,0.0,0.0,0.0
<a href=/player/phila101>phila101</a>,Adolfo Phillips,Chicago Cubs,CUBS,2,3,3,6,1969,1976,7,No,0,1.26,-2.01,-3.27,234,496,262,608,1128,520,0.0,471.0,471.0,0.0,0.0,0.0
<a href=/player/philb001>philb001</a>,Brandon Phillips,Montreal Expos,NATEX,2,6,6,12,2002,2004,2,No,0,48.64,-2.57,-51.21,1323,330,-993,4723,156,-4567,4264.0,874.0,-3390.0,4000000.0,0.0,-4000000.0
<a href=/player/philb001>philb001</a>,Brandon Phillips,Cleveland Indians,INDINS,3,5,4,9,2006,2013,7,No,0,27.67,5.27,-22.4,1754,382,-1372,7163,314,-6849,120.0,883.0,763.0,5500000.0,0.0,-5500000.0
<a href=/player/philb001>philb001</a>,Brandon Phillips,Cincinnati Reds,REDS,1,2,2,4,2017,2017,0,Yes,0,1.0,0.0,-1.0,120,0,-120,499,0,-499,0.0,0.0,0.0,0.0,0.0,0.0
<a href=/player/philb001>philb001</a>,Brandon Phillips,Atlanta Braves,BRAVES,1,1,1,2,2017,2017,0,No,0,-0.1,0.0,0.1,24,1,-23,105,1,-104,0.0,0.0,0.0,0.0,0.0,0.0
<a href=/player/philb002>philb002</a>,Brett Phillips,Houston Astros,ASTROS,1,4,3,7,2015,2017,2,No,0,18.89,0.28,-18.61,984,198,-786,1471,487,-984,1823.0,1153.0,-670.0,0.0,0.0,0.0
<a href=/player/philb002>philb002</a>,Brett Phillips,Milwaukee Brewers,BREWRS,1,2,1,3,2018,2019,1,No,0,-0.83,3.09,3.92,134,197,63,238,802,564,475.0,0.0,-475.0,0.0,0.0,0.0
<a href=/player/philb002>philb002</a>,Brett Phillips,Kansas City Royals,ROYALS,1,1,1,2,2020,2020,0,Yes,0,2.69,0.0,-2.69,136,0,-136,317,0,-317,3.0,0.0,-3.0,0.0,0.0,0.0
<a href=/player/philb102>philb102</a>,Bubba Phillips,Detroit Tigers,TIGRS,5,11,10,21,1955,1961,6,No,0,18.52,2.11,-16.41,991,623,-368,1633,1663,30,3228.0,400.0,-2828.0,13200.0,0.0,-13200.0
<a href=/player/philb102>philb102</a>,Bubba Phillips,Chicago White Sox,WSOX,5,8,10,18,1959,1969,10,No,0,11.6,14.81,3.21,1350,938,-412,4415,3667,-748,492.0,12.0,-480.0,77250.0,0.0,-77250.0
<a href=/player/philb102>philb102</a>,Bubba Phillips,Cleveland Indians,INDINS,1,1,2,3,1962,1965,3,No,0,-1.2,-0.48,0.72,174,28,-146,601,1,-600,0.0,50.0,50.0,0.0,0.0,0.0
<a href=/player/phild101>phild101</a>,Deacon Phillippe,Louisville Colonels,LS3,1,12,5,17,1899,1900,1,No,0,267.1,0.0,-267.1,7388,0,-7388,29004,0,-29004,7568.0,0.0,-7568.0,4350.0,0.0,-4350.0
<a href=/player/phild102>phild102</a>,Dave Philley,Chicago White Sox,WSOX,37,70,65,135,1951,1971,20,No,0,135.72,175.24,39.52,11342,10596,-746,33371,28350,-5021,13927.0,15729.0,1802.0,374250.0,0.0,-374250.0
<a href=/player/phild102>phild102</a>,Dave Philley,Philadelphia Athletics,ATLTCS,33,66,65,131,1954,1976,22,No,0,95.8,55.95,-39.85,9769,6842,-2927,23736,19563,-4173,12004.0,6285.0,-5719.0,476100.0,0.0,-476100.0
<a href=/player/phild102>phild102</a>,Dave Philley,Baltimore Orioles,ORLS,26,48,50,98,1956,1994,38,No,3,80.74,145.05,64.31,5690,7775,2085,11208,18490,7282,20337.0,19836.0,-501.0,923333.0,0.0,-923333.0
<a href=/player/phild102>phild102</a>,Dave Philley,Chicago White Sox,WSOX,1,1,1,2,1957,1961,4,No,0,0.01,4.81,4.8,65,397,332,181,984,803,0.0,0.0,0.0,22000.0,0.0,-22000.0
<a href=/player/phild102>phild102</a>,Dave Philley,Houston Astros,ASTROS,1,1,1,2,1962,1962,0,No,0,-0.33,0.0,0.33,38,0,-38,48,0,-48,0.0,0.0,0.0,0.0,0.0,0.0
<a href=/player/phild103>phild103</a>,Dick Phillips,Milwaukee Braves,BRAVES,1,1,1,2,1960,1960,0,No,0,-0.1,0.0,0.1,5,0,-5,4,0,-4,0.0,0.0,0.0,0.0,0.0,0.0
<a href=/player/phild104>phild104</a>,Dee Phillips,Boston Braves,BRAVES,4,14,5,19,1949,1960,11,No,0,7.36,21.56,14.2,1117,1270,153,2487,5255,2768,2162.0,0.0,-2162.0,6600.0,0.0,-6600.0
<a href=/player/phile001>phile001</a>,Evan Phillips,Atlanta Braves,BRAVES,1,5,2,7,2018,2020,2,No,0,0.09,0.72,0.63,63,86,23,4,50,46,357.0,484.0,127.0,0.0,0.0,0.0
<a href=/player/phile102>phile102</a>,Eddie Phillips,Pittsburgh Pirates,PIRATS,2,4,2,6,1932,1940,8,No,0,-0.39,22.08,22.47,8,680,672,3,632,629,28.0,4937.0,4909.0,7000.0,0.0,-7000.0
<a href=/player/philj003>philj003</a>,Jason Phillips,New York Mets,METS,1,1,1,2,2005,2005,0,No,0,-1.38,-0.11,1.27,121,37,-84,434,30,-404,0.0,273.0,273.0,0.0,0.0,0.0
<a href=/player/philj101>philj101</a>,Jack Phillips,Pittsburgh Pirates,PIRATS,1,1,2,3,1954,1960,6,No,0,0.0,0.0,0.0,0,0,0,0,0,0,0.0,0.0,0.0,0.0,0.0,0.0
<a href=/player/philj101>philj101</a>,Jack Phillips,Chicago White Sox,WSOX,3,8,6,14,1954,1961,7,No,0,23.22,8.09,-15.13,1221,1065,-156,3572,3021,-551,2246.0,488.0,-1758.0,62000.0,0.0,-62000.0
<a href=/player/philj101>philj101</a>,Jack Phillips,Detroit Tigers,TIGRS,1,1,1,2,1957,1957,0,No,0,0.0,-0.28,-0.28,0,8,8,0,15,15,0.0,0.0,0.0,0.0,0.0,0.0
<a href=/player/philm101>philm101</a>,Mike Phillips,New York Mets,METS,2,2,2,4,1977,1986,9,No,0,-0.48,9.55,10.03,271,806,535,634,2119,1485,0.0,507.0,507.0,366667.0,0.0,-366667.0
<a href=/player/philm101>philm101</a>,Mike Phillips,St. Louis Cardinals,CARDS,12,29,23,52,1980,1998,18,No,5,83.63,121.95,38.32,6733,4994,-1739,20851,17148,-3703,6532.0,3025.0,-3507.0,1533333.0,0.0,-1533333.0
<a href=/player/philr101>philr101</a>,Red Phillips,Detroit Tigers,TIGRS,19,44,45,89,1936,1964,28,No,0,49.33,102.41,53.08,4601,5659,1058,11266,13498,2232,8483.0,17035.0,8552.0,157700.0,0.0,-157700.0
<a href=/player/philt001>philt001</a>,Tony Phillips,Montreal Expos,NATEX,2,3,2,5,1980,1982,2,No,0,-0.4,-0.54,-0.14,65,97,32,74,209,135,0.0,0.0,0.0,0.0,0.0,0.0
<a href=/player/philt001>philt001</a>,Tony Phillips,San Diego Padres,PADRS,2,4,3,7,1981,1984,3,No,0,15.21,2.85,-12.36,959,296,-663,3500,1221,-2279,64.0,0.0,-64.0,0.0,0.0,0.0
<a href=/player/philt001>philt001</a>,Tony Phillips,Detroit Tigers,TIGRS,5,6,8,14,1995,2005,10,No,2,7.72,5.63,-2.09,442,470,28,1798,1306,-492,0.0,1903.0,1903.0,2600000.0,0.0,-2600000.0
<a href=/player/philt001>philt001</a>,Tony Phillips,Chicago White Sox,WSOX,1,2,2,4,1997,1997,0,No,0,1.15,1.16,0.01,178,151,-27,735,342,-393,0.0,178.0,178.0,2847500.0,0.0,-2847500.0
<a href=/player/philt001>philt001</a>,Tony Phillips,Toronto Blue Jays,BJAYS,2,3,2,5,1998,2002,4,No,0,-0.32,0.93,1.25,52,38,-14,229,6,-223,0.0,557.0,557.0,0.0,0.0,0.0
<a href=/player/philt101>philt101</a>,Taylor Phillips,Milwaukee Braves,BRAVES,2,5,5,10,1957,1961,4,No,0,-0.24,3.65,3.89,692,187,-505,1842,252,-1590,561.0,791.0,230.0,0.0,0.0,0.0
<a href=/player/philt101>philt101</a>,Taylor Phillips,Chicago Cubs,CUBS,8,14,12,26,1959,1977,18,No,0,12.27,42.05,29.78,1026,3112,2086,728,8458,7730,3868.0,5672.0,1804.0,122500.0,0.0,-122500.0
<a href=/player/philt101>philt101</a>,Taylor Phillips,Philadelphia Phillies,PHILS,1,2,2,4,1961,1962,1,No,0,-0.26,0.0,0.26,97,0,-97,147,0,-147,42.0,0.0,-42.0,0.0,0.0,0.0
<a href=/player/philz001>philz001</a>,Zach Phillips,Texas Rangers,RNGRS,1,1,2,3,2011,2011,0,No,0,0.4,0.0,-0.4,16,0,-16,0,0,0,42.0,0.0,-42.0,0.0,0.0,0.0
<a href=/player/philz001>philz001</a>,Zach Phillips,Baltimore Orioles,ORLS,1,1,1,2,2016,2016,0,No,0,0.18,0.0,-0.18,16,0,-16,0,0,0,20.0,0.0,-20.0,0.0,0.0,0.0
<a href=/player/phoet101>phoet101</a>,Tom Phoebus,Baltimore Orioles,ORLS,16,38,31,69,1970,1994,24,No,3,54.62,146.79,92.17,4179,7236,3057,9813,16664,6851,14313.0,25489.0,11176.0,888833.0,0.0,-888833.0
<a href=/player/phoet101>phoet101</a>,Tom Phoebus,Chicago Cubs,CUBS,1,1,1,2,1972,1974,2,No,0,0.0,0.0,0.0,0,1,1,0,0,0,0.0,0.0,0.0,0.0,0.0,0.0
<a href=/player/phylb101>phylb101</a>,Bill Phyle,St.Paul,St.Paul,1,1,1,2,1898,1898,0,No,0,-0.47,0.0,0.47,27,0,-27,45,0,-45,320.0,0.0,-320.0,0.0,0.0,0.0
<a href=/player/phylb101>phylb101</a>,Bill Phyle,Chicago Cubs,CUBS,2,6,2,8,1900,1902,2,No,0,10.49,0.81,-9.68,648,153,-495,2353,607,-1746,0.0,0.0,0.0,0.0,0.0,0.0
<a href=/player/phylb101>phylb101</a>,Bill Phyle,KansasCity,KansasCity,1,1,2,3,1906,1908,2,No,0,-0.14,0.0,0.14,22,0,-22,79,0,-79,0.0,0.0,0.0,0.0,0.0,0.0
<a href=/player/piatd001>piatd001</a>,Doug Piatt,Cleveland Indians,INDINS,1,1,1,2,1989,1989,0,No,0,0.59,0.0,-0.59,42,0,-42,1,0,-1,104.0,0.0,-104.0,0.0,0.0,0.0
<a href=/player/piatd001>piatd001</a>,Doug Piatt,Montreal Expos,NATEX,2,3,3,6,1992,1996,4,No,0,-0.47,0.96,1.43,26,525,499,0,267,267,304.0,701.0,397.0,625000.0,0.0,-625000.0
<a href=/player/piazm001>piazm001</a>,Mike Piazza,Los Angeles Dodgers,DOGRS,9,17,19,36,1998,2017,19,No,0,17.97,55.2,37.23,1483,3217,1734,4788,11288,6500,1883.0,2450.0,567.0,29893334.0,0.0,-29893334.0
<a href=/player/piazm001>piazm001</a>,Mike Piazza,Florida Marlins,MARLNS,13,27,34,61,1998,2019,21,Yes,0,97.88,93.37,-4.51,3713,5399,1686,11493,15928,4435,10493.0,10160.0,-333.0,43044000.0,0.0,-43044000.0
<a href=/player/piccr001>piccr001</a>,Rob Picciolo,Oakland Athletics,ATLTCS,1,1,2,3,1982,1985,3,No,0,-0.28,-0.85,-0.57,36,52,16,52,0,-52,0.0,614.0,614.0,0.0,0.0,0.0
<a href=/player/pichr101>pichr101</a>,Ron Piche,Milwaukee Braves,BRAVES,6,12,9,21,1964,1968,4,No,0,-1.26,1.32,2.58,659,529,-130,866,569,-297,775.0,799.0,24.0,15000.0,0.0,-15000.0
<a href=/player/pichr101>pichr101</a>,Ron Piche,St. Louis Cardinals,CARDS,3,5,6,11,1968,1972,4,No,0,-0.84,1.08,1.92,394,109,-285,40,207,167,1007.0,64.0,-943.0,17500.0,0.0,-17500.0
<a href=/player/piciv101>piciv101</a>,Val Picinich,Philadelphia Athletics,ATLTCS,1,2,1,3,1918,1918,0,No,0,0.0,7.48,7.48,0,88,88,0,123,123,0.0,995.0,995.0,0.0,0.0,0.0
<a href=/player/piciv101>piciv101</a>,Val Picinich,Washington Senators,TWINS,1,3,2,5,1923,1930,7,No,0,1.13,22.03,20.9,449,1009,560,1547,3473,1926,0.0,543.0,543.0,0.0,0.0,0.0
<a href=/player/piciv101>piciv101</a>,Val Picinich,Cincinnati Reds,REDS,2,2,3,5,1929,1945,16,No,0,-0.43,1.02,1.45,187,222,35,496,631,135,0.0,148.0,148.0,0.0,0.0,0.0
<a href=/player/pickc101>pickc101</a>,Clarence Pickrel,Boston Braves,BRAVES,2,5,2,7,1934,1940,6,No,0,0.0,6.69,6.69,0,395,395,0,958,958,0.0,2031.0,2031.0,0.0,0.0,0.0
<a href=/player/pickc103>pickc103</a>,Charlie Pick,Philadelphia Athletics,ATLTCS,2,3,2,5,1917,1920,3,No,0,3.65,11.88,8.23,385,426,41,1524,1760,236,0.0,0.0,0.0,0.0,0.0,0.0
<a href=/player/pickc103>pickc103</a>,Charlie Pick,Chicago Cubs,CUBS,1,2,1,3,1919,1921,2,No,0,5.35,-0.19,-5.54,455,143,-312,1719,569,-1150,0.0,0.0,0.0,4800.0,0.0,-4800.0
<a href=/player/picke101>picke101</a>,Eddie Pick,Chicago Cubs,CUBS,1,2,1,3,1927,1927,0,No,0,0.0,0.0,0.0,0,0,0,0,0,0,0.0,0.0,0.0,3300.0,0.0,-3300.0
<a href=/player/picko101>picko101</a>,Ollie Pickering,St.Louis Browns,ORLS,1,1,1,2,1907,1907,0,No,0,0.17,0.0,-0.17,113,0,-113,408,0,-408,0.0,0.0,0.0,0.0,0.0,0.0
<a href=/player/pickr001>pickr001</a>,Ricky Pickett,Cincinnati Reds,REDS,5,11,7,18,1995,2010,15,No,0,11.19,26.95,15.76,438,1436,998,728,5040,4312,2595.0,2089.0,-506.0,13266667.0,0.0,-13266667.0
<a href=/player/pickr001>pickr001</a>,Ricky Pickett,San Francisco Giants,GIANTS,1,1,1,2,1998,1998,0,No,0,-0.22,-0.44,-0.22,4,43,39,0,100,100,2.0,0.0,-2.0,0.0,0.0,0.0
<a href=/player/pie-f001>pie-f001</a>,Felix Pie,Chicago Cubs,CUBS,3,4,5,9,2009,2012,3,No,0,-4.57,0.86,5.43,594,217,-377,976,3,-973,676.0,339.0,-337.0,1625000.0,0.0,-1625000.0
<a href=/player/pieca101>pieca101</a>,Al Piechota,New York Yankees,YANKS,1,1,1,2,1939,1940,1,No,0,-0.83,0.0,0.83,44,0,-44,24,0,-24,186.0,0.0,-186.0,0.0,0.0,0.0
<a href=/player/piedj001>piedj001</a>,Jorge Piedra,Los Angeles Dodgers,DOGRS,1,3,1,4,2000,2000,0,No,0,-0.56,-0.49,0.07,24,18,-6,10,13,3,98.0,120.0,22.0,0.0,0.0,0.0
<a href=/player/piera001>piera001</a>,A.J. Pierzynski,Minnesota Twins,TWINS,4,5,9,14,2003,2018,15,Yes,0,5.9,32.55,26.65,509,1446,937,2054,2455,401,176.0,5088.0,4912.0,10715000.0,0.0,-10715000.0
<a href=/player/pierb101>pierb101</a>,Billy Pierce,Detroit Tigers,TIGRS,1,2,1,3,1948,1951,3,No,0,48.75,3.7,-45.05,943,253,-690,1127,868,-259,8793.0,0.0,-8793.0,0.0,0.0,0.0
<a href=/player/pierb101>pierb101</a>,Billy Pierce,Chicago White Sox,WSOX,6,7,11,18,1961,1968,7,No,0,9.19,14.32,5.13,984,1200,216,811,1186,375,2300.0,2896.0,596.0,31250.0,0.0,-31250.0
<a href=/player/pierb103>pierb103</a>,Bill Piercy,New York Yankees,YANKS,4,11,7,18,1921,1946,25,No,0,28.58,81.31,52.73,995,2473,1478,1312,4729,3417,7730.0,15194.0,7464.0,42500.0,0.0,-42500.0
<a href=/player/pierj001>pierj001</a>,Jeff Pierce,Chicago White Sox,WSOX,1,2,1,3,1993,1993,0,No,0,1.84,0.47,-1.37,262,12,-250,17,0,-17,550.0,215.0,-335.0,0.0,0.0,0.0
<a href=/player/pierj002>pierj002</a>,Juan Pierre,Colorado Rockies,ROCKS,4,7,10,17,2002,2007,5,No,0,7.86,3.55,-4.31,711,790,79,2863,2114,-749,329.0,1166.0,837.0,25103543.0,0.0,-25103543.0
<a href=/player/pierj002>pierj002</a>,Juan Pierre,Florida Marlins,MARLNS,2,3,6,9,2005,2015,10,No,0,2.9,14.84,11.94,193,981,788,780,493,-287,261.0,4952.0,4691.0,3700000.0,0.0,-3700000.0
<a href=/player/pierj002>pierj002</a>,Juan Pierre,Los Angeles Dodgers,DOGRS,3,3,5,8,2009,2013,4,No,0,-0.64,-1.32,-0.68,318,88,-230,1445,89,-1356,0.0,372.0,372.0,10000000.0,0.0,-10000000.0
<a href=/player/pierj101>pierj101</a>,Jack Pierce,Atlanta Braves,BRAVES,1,1,1,2,1975,1975,0,No,0,-0.17,0.0,0.17,53,0,-53,194,0,-194,0.0,0.0,0.0,0.0,0.0,0.0
<a href=/player/pierj102>pierj102</a>,Jim Piersall,Boston Red Sox,RSOX,1,1,2,3,1958,1965,7,No,0,9.68,10.51,0.83,359,942,583,1413,3414,2001,0.0,0.0,0.0,0.0,0.0,0.0
<a href=/player/pierj102>pierj102</a>,Jim Piersall,Cleveland Indians,INDINS,2,2,4,6,1961,1965,4,No,0,-1.44,5.39,6.83,179,368,189,651,571,-80,0.0,1913.0,1913.0,0.0,0.0,0.0
<a href=/player/pierj102>pierj102</a>,Jim Piersall,Washington Senators,RNGRS,3,4,4,8,1963,1970,7,No,0,-1.02,1.46,2.48,40,173,133,140,535,395,0.0,6.0,6.0,0.0,0.0,0.0
<a href=/player/pierm101>pierm101</a>,Marino Pieretti,Washington Senators,TWINS,1,1,1,2,1948,1948,0,No,0,-1.13,0.33,1.46,140,46,-94,85,18,-67,708.0,182.0,-526.0,0.0,0.0,0.0
<a href=/player/piett101>piett101</a>,Tony Piet,Pittsburgh Pirates,PIRATS,1,2,2,4,1933,1939,6,No,0,-1.61,11.63,13.24,298,385,87,1097,447,-650,0.0,2051.0,2051.0,0.0,0.0,0.0
<a href=/player/piett101>piett101</a>,Tony Piet,Chicago White Sox,WSOX,2,4,5,9,1937,1950,13,No,0,5.83,16.69,10.86,429,2282,1853,1515,8577,7062,633.0,270.0,-363.0,37500.0,0.0,-37500.0
<a href=/player/piett101>piett101</a>,Tony Piet,Detroit Tigers,TIGRS,1,5,1,6,1938,1952,14,No,0,0.0,25.69,25.69,0,589,589,0,728,728,0.0,4363.0,4363.0,11000.0,0.0,-11000.0
<a href=/player/pignj101>pignj101</a>,Joe Pignatano,Kansas City Athletics,ATLTCS,11,24,16,40,1961,1976,15,No,0,27.21,18.41,-8.8,4303,2226,-2077,9008,5907,-3101,5181.0,1373.0,-3808.0,355600.0,0.0,-355600.0
<a href=/player/pilaa101>pilaa101</a>,Al Pilarcik,Kansas City Athletics,ATLTCS,52,112,116,228,1956,1976,20,No,0,250.68,149.14,-101.54,20796,15499,-5297,51279,47670,-3609,28842.0,13383.0,-15459.0,673600.0,0.0,-673600.0
<a href=/player/pilaa101>pilaa101</a>,Al Pilarcik,Baltimore Orioles,ORLS,4,11,7,18,1961,1973,12,No,0,20.55,30.35,9.8,1602,1797,195,5528,6131,603,845.0,306.0,-539.0,72000.0,0.0,-72000.0
<a href=/player/pilaa101>pilaa101</a>,Al Pilarcik,Kansas City Athletics,ATLTCS,19,40,34,74,1961,1976,15,No,0,67.84,34.29,-33.55,6835,3922,-2913,16048,11060,-4988,8728.0,3414.0,-5314.0,393100.0,0.0,-393100.0
<a href=/player/pilld101>pilld101</a>,Duane Pillette,New York Yankees,YANKS,2,8,4,12,1950,1954,4,No,0,21.38,0.72,-20.66,1235,437,-798,2252,180,-2072,6559.0,1785.0,-4774.0,29000.0,0.0,-29000.0
<a href=/player/pilld101>pilld101</a>,Duane Pillette,Buffalo,Buffalo,1,1,2,3,1956,1956,0,No,0,-0.48,0.0,0.48,40,0,-40,1,0,-1,70.0,0.0,-70.0,0.0,0.0,0.0
<a href=/player/pillh101>pillh101</a>,Herman Pillette,Portland,Portland,4,6,14,20,1921,1926,5,No,0,21.37,0.0,-21.37,1173,0,-1173,3235,0,-3235,2921.0,0.0,-2921.0,0.0,0.0,0.0
<a href=/player/pillk001>pillk001</a>,Kevin Pillar,Toronto Blue Jays,BJAYS,1,1,3,4,2019,2019,0,Yes,0,0.77,-0.38,-1.15,156,80,-76,628,48,-580,0.0,182.0,182.0,0.0,0.0,0.0
<a href=/player/pillk001>pillk001</a>,Kevin Pillar,Boston Red Sox,RSOX,1,1,1,2,2020,2020,0,Yes,0,0.19,0.0,-0.19,24,0,-24,97,0,-97,0.0,0.0,0.0,4250000.0,0.0,-4250000.0
<a href=/player/pimes001>pimes001</a>,Stolmy Pimentel,Boston Red Sox,RSOX,1,4,2,6,2012,2019,7,No,0,7.63,8.07,0.44,566,624,58,6,2223,2217,907.0,22.0,-885.0,521000.0,0.0,-521000.0
<a href=/player/pinah101>pinah101</a>,Horacio Pina,Cleveland Indians,INDINS,5,8,7,15,1969,1974,5,No,0,5.0,-0.41,-5.41,1218,311,-907,2882,450,-2432,1036.0,482.0,-554.0,104000.0,0.0,-104000.0
<a href=/player/pinah101>pinah101</a>,Horacio Pina,Texas Rangers,RNGRS,8,20,13,33,1972,1988,16,No,0,44.28,39.14,-5.14,2462,2571,109,8647,8729,82,3037.0,4668.0,1631.0,475000.0,0.0,-475000.0
<a href=/player/pinah101>pinah101</a>,Horacio Pina,Oakland Athletics,ATLTCS,2,4,2,6,1973,1976,3,No,0,2.13,1.92,-0.21,1225,275,-950,3070,1015,-2055,720.0,0.0,-720.0,93800.0,0.0,-93800.0
<a href=/player/pinah101>pinah101</a>,Horacio Pina,Chicago Cubs,CUBS,2,2,2,4,1974,1978,4,No,0,0.43,0.19,-0.24,11,25,14,0,56,56,35.0,0.0,-35.0,24000.0,0.0,-24000.0
<a href=/player/pinam001>pinam001</a>,Manny Pina,Texas Rangers,RNGRS,1,2,1,3,2009,2009,0,No,0,-0.11,0.0,0.11,5,0,-5,17,0,-17,0.0,0.0,0.0,0.0,0.0,0.0
<a href=/player/pinam001>pinam001</a>,Manny Pina,Seattle Mariners,MARNRS,1,1,1,2,2014,2014,0,No,0,0.0,0.0,0.0,0,0,0,0,0,0,0.0,0.0,0.0,0.0,0.0,0.0
<a href=/player/pinam001>pinam001</a>,Manny Pina,Detroit Tigers,TIGRS,1,2,1,3,2015,2017,2,No,0,6.56,0.31,-6.25,404,95,-309,1209,0,-1209,0.0,251.0,251.0,0.0,0.0,0.0
<a href=/player/pinej001>pinej001</a>,Joel Pineiro,Boston Red Sox,RSOX,1,2,1,3,2007,2007,0,No,0,2.56,0.0,-2.56,145,0,-145,160,0,-160,1279.0,0.0,-1279.0,4000000.0,0.0,-4000000.0
<a href=/player/pinel001>pinel001</a>,Luis Pineda,Detroit Tigers,TIGRS,1,2,1,3,2001,2006,5,No,0,1.7,6.8,5.1,135,487,352,357,1976,1619,97.0,0.0,-97.0,4400000.0,0.0,-4400000.0
<a href=/player/pinem001>pinem001</a>,Michael Pineda,Seattle Mariners,MARNRS,1,2,2,4,2012,2016,4,No,0,6.28,-2.3,-8.58,93,246,153,7,800,793,1527.0,405.0,-1122.0,0.0,0.0,0.0
<a href=/player/pinil001>pinil001</a>,Lou Piniella,Washington Senators,RNGRS,13,28,22,50,1964,1988,24,No,0,46.51,50.92,4.41,2995,4473,1478,9421,12658,3237,3885.0,7987.0,4102.0,527000.0,0.0,-527000.0
<a href=/player/pinil001>pinil001</a>,Lou Piniella,Baltimore Orioles,ORLS,1,1,1,2,1966,1966,0,No,0,-0.03,0.23,0.26,6,4,-2,6,12,6,0.0,0.0,0.0,0.0,0.0,0.0
<a href=/player/pinil001>pinil001</a>,Lou Piniella,Seattle Pilots,BREWRS,4,6,5,11,1969,1971,2,No,0,5.62,1.3,-4.32,913,364,-549,2823,214,-2609,485.0,1100.0,615.0,65500.0,0.0,-65500.0
<a href=/player/pinil001>pinil001</a>,Lou Piniella,Kansas City Royals,ROYALS,1,2,1,3,1973,1977,4,No,0,9.36,0.87,-8.49,1040,79,-961,3577,0,-3577,17.0,554.0,537.0,65000.0,0.0,-65000.0
<a href=/player/pinil001>pinil001</a>,Lou Piniella,Seattle Mariners,MARNRS,4,5,5,10,2002,2007,5,No,0,13.67,8.92,-4.75,1087,458,-629,4329,1918,-2411,0.0,0.0,0.0,3750000.0,0.0,-3750000.0
<a href=/player/pinoy001>pinoy001</a>,Yohan Pino,Minnesota Twins,TWINS,1,1,1,2,2009,2012,3,No,0,0.0,5.79,5.79,0,93,93,0,16,16,0.0,1739.0,1739.0,0.0,0.0,0.0
<a href=/player/pinsv101>pinsv101</a>,Vada Pinson,Cincinnati Reds,REDS,6,7,8,15,1968,1977,9,No,0,-0.92,17.59,18.51,1168,1565,397,1712,3004,1292,1648.0,2894.0,1246.0,40000.0,0.0,-40000.0
<a href=/player/pinsv101>pinsv101</a>,Vada Pinson,St. Louis Cardinals,CARDS,3,5,4,9,1969,1971,2,No,0,3.51,1.65,-1.86,422,269,-153,1591,1022,-569,18.0,0.0,-18.0,87500.0,0.0,-87500.0
<a href=/player/pinsv101>pinsv101</a>,Vada Pinson,Cleveland Indians,INDINS,8,13,14,27,1971,1984,13,No,0,47.87,7.93,-39.94,2666,2447,-219,9920,8254,-1666,38.0,317.0,279.0,169250.0,0.0,-169250.0
<a href=/player/pinsv101>pinsv101</a>,Vada Pinson,California Angels,ANGELS,1,1,2,3,1974,1974,0,No,0,0.06,-0.65,-0.71,218,13,-205,772,0,-772,0.0,50.0,50.0,0.0,0.0,0.0
<a href=/player/pintl101>pintl101</a>,Lerton Pinto,Philadelphia Phillies,PHILS,1,2,1,3,1924,1924,0,No,0,0.0,0.0,0.0,0,0,0,0,0,0,0.0,0.0,0.0,4800.0,0.0,-4800.0
<a href=/player/pintr001>pintr001</a>,Renyel Pinto,Chicago Cubs,CUBS,3,8,4,12,2005,2009,4,No,1,27.92,6.53,-21.39,1518,286,-1232,2540,824,-1716,5153.0,718.0,-4435.0,0.0,0.0,0.0
<a href=/player/pintr002>pintr002</a>,Ricardo Pinto,Philadelphia Phillies,PHILS,1,1,1,2,2018,2018,0,No,0,0.0,0.0,0.0,0,0,0,0,0,0,0.0,0.0,0.0,0.0,0.0,0.0
<a href=/player/pipgg101>pipgg101</a>,George Pipgras,Boston Red Sox,RSOX,1,2,2,4,1923,1927,4,No,0,9.14,-0.1,-9.24,571,74,-497,688,223,-465,4054.0,0.0,-4054.0,0.0,0.0,0.0
<a href=/player/pirej001>pirej001</a>,Jose Pirela,New York Yankees,YANKS,5,7,7,14,2015,2021,6,No,0,10.9,0.28,-10.62,484,104,-380,1389,361,-1028,1135.0,9.0,-1126.0,510000.0,0.0,-510000.0
<a href=/player/pirtg101>pirtg101</a>,Gerry Pirtle,New York Yankees,YANKS,1,1,1,2,1976,1976,0,No,0,0.0,0.0,0.0,0,0,0,0,0,0,0.0,0.0,0.0,0.0,0.0,0.0
<a href=/player/piscm001>piscm001</a>,Marc Pisciotta,Atlanta Braves,BRAVES,1,1,1,2,1999,1999,0,No,0,-0.15,0.0,0.15,8,0,-8,0,0,0,25.0,0.0,-25.0,0.0,0.0,0.0
<a href=/player/piscs001>piscs001</a>,Stephen Piscotty,St. Louis Cardinals,CARDS,1,1,2,3,2017,2020,3,No,0,3.05,-0.26,-3.31,361,208,-153,1357,527,-830,0.0,3.0,3.0,1333333.0,0.0,-1333333.0
<a href=/player/pisoj101>pisoj101</a>,Jim Pisoni,Baltimore Orioles,ORLS,6,15,10,25,1956,1973,17,No,0,20.81,32.2,11.39,1684,2354,670,5686,7591,1905,973.0,480.0,-493.0,72000.0,0.0,-72000.0
<a href=/player/pisoj101>pisoj101</a>,Jim Pisoni,Kansas City Athletics,ATLTCS,50,107,110,217,1957,1976,19,No,0,243.41,144.18,-99.23,19841,14910,-4931,49436,46172,-3264,28049.0,12074.0,-15975.0,661100.0,0.0,-661100.0
<a href=/player/pitlj101>pitlj101</a>,Jake Pitler,Chattanooga,Chattanooga,1,1,2,3,1917,1921,4,No,0,-1.02,0.0,1.02,111,0,-111,439,0,-439,0.0,0.0,0.0,0.0,0.0,0.0
<a href=/player/pitls101>pitls101</a>,Skip Pitlock,San Francisco Giants,GIANTS,1,1,2,3,1973,1975,2,No,0,0.06,0.0,-0.06,43,0,-43,0,0,0,317.0,0.0,-317.0,0.0,0.0,0.0
<a href=/player/pitls101>pitls101</a>,Skip Pitlock,Chicago White Sox,WSOX,5,9,6,15,1975,1989,14,No,1,34.89,33.07,-1.82,1503,1198,-305,4882,4106,-776,2621.0,1459.0,-1162.0,0.0,0.0,0.0
<a href=/player/pittc001>pittc001</a>,Chris Pittaro,Detroit Tigers,TIGRS,1,2,1,3,1986,1986,0,No,0,-0.73,-0.07,0.66,33,35,2,51,93,42,0.0,0.0,0.0,0.0,0.0,0.0
<a href=/player/pittg101>pittg101</a>,Gaylen Pitts,St. Louis Cardinals,CARDS,1,1,1,2,1971,1972,1,No,0,0.3,-0.18,-0.48,28,36,8,50,2,-48,0.0,89.0,89.0,0.0,0.0,0.0
<a href=/player/pittg101>pittg101</a>,Gaylen Pitts,Oakland Athletics,ATLTCS,1,1,1,2,1977,1977,0,No,0,0.0,0.27,0.27,0,96,96,0,328,328,0.0,0.0,0.0,0.0,0.0,0.0
<a href=/player/pittj001>pittj001</a>,Joe Pittman,Houston Astros,ASTROS,1,1,1,2,1982,1983,1,No,0,0.97,-0.08,-1.05,55,20,-35,129,1,-128,0.0,38.0,38.0,0.0,0.0,0.0
<a href=/player/pittj001>pittj001</a>,Joe Pittman,San Diego Padres,PADRS,1,2,1,3,1983,1984,1,No,0,-0.3,-0.1,0.2,17,47,30,23,59,36,0.0,0.0,0.0,0.0,0.0,0.0
<a href=/player/pittp101>pittp101</a>,Pinky Pittenger,Philadelphia Athletics,ATLTCS,2,7,2,9,1923,1927,4,No,0,0.0,2.68,2.68,0,472,472,0,1997,1997,0.0,0.0,0.0,12000.0,0.0,-12000.0
<a href=/player/pittp101>pittp101</a>,Pinky Pittenger,Chicago Cubs,CUBS,3,6,4,10,1925,1934,9,No,0,0.0,24.69,24.69,0,1007,1007,0,4044,4044,0.0,0.0,0.0,16467.0,0.0,-16467.0
<a href=/player/pittp101>pittp101</a>,Pinky Pittenger,SaltLakeCity,SaltLakeCity,1,1,1,2,1924,1924,0,No,0,0.75,0.0,-0.75,59,0,-59,195,0,-195,0.0,0.0,0.0,0.0,0.0,0.0
<a href=/player/pittt101>pittt101</a>,Togie Pittinger,Boston Braves,BRAVES,2,2,3,5,1904,1909,5,No,0,4.09,0.38,-3.71,226,435,209,311,954,643,2411.0,3355.0,944.0,0.0,0.0,0.0
<a href=/player/piven001>piven001</a>,Nick Pivetta,Washington Nationals,NATEX,1,1,2,3,2015,2016,1,No,0,0.6,-0.12,-0.72,177,115,-62,120,0,-120,1189.0,176.0,-1013.0,0.0,0.0,0.0
<a href=/player/piven001>piven001</a>,Nick Pivetta,Philadelphia Phillies,PHILS,1,2,2,4,2020,2020,0,No,0,3.19,-0.87,-4.06,36,25,-11,2,0,-2,504.0,67.0,-437.0,0.0,0.0,0.0
<a href=/player/pizaj101>pizaj101</a>,Juan Pizarro,Milwaukee Braves,BRAVES,2,3,3,6,1960,1969,9,No,0,11.93,7.0,-4.93,718,403,-315,1624,1494,-130,3308.0,0.0,-3308.0,0.0,0.0,0.0
<a href=/player/pizaj101>pizaj101</a>,Juan Pizarro,Cincinnati Reds,REDS,1,2,1,3,1960,1963,3,No,0,15.36,2.72,-12.64,449,236,-213,454,894,440,3599.0,0.0,-3599.0,0.0,0.0,0.0
<a href=/player/pizaj101>pizaj101</a>,Juan Pizarro,Chicago White Sox,WSOX,1,1,1,2,1966,1978,12,No,0,-1.1,50.06,51.16,139,965,826,36,349,313,426.0,7574.0,7148.0,26000.0,0.0,-26000.0
<a href=/player/pizaj101>pizaj101</a>,Juan Pizarro,Boston Red Sox,RSOX,3,6,6,12,1969,1973,4,No,0,5.38,12.96,7.58,1093,699,-394,2374,1115,-1259,1155.0,3166.0,2011.0,26500.0,0.0,-26500.0
<a href=/player/pizaj101>pizaj101</a>,Juan Pizarro,California Angels,ANGELS,2,2,2,4,1970,1973,3,No,0,0.98,-0.3,-1.28,102,72,-30,70,46,-24,597.0,82.0,-515.0,0.0,0.0,0.0
<a href=/player/plane101>plane101</a>,Eddie Plank,St.Louis Browns,ORLS,31,58,69,127,1918,1952,34,No,0,180.6,188.06,7.46,8263,12092,3829,24970,33212,8242,20858.0,35942.0,15084.0,281100.0,0.0,-281100.0
<a href=/player/planp001>planp001</a>,Phil Plantier,Boston Red Sox,RSOX,1,1,1,2,1992,1994,2,No,0,1.24,0.66,-0.58,298,19,-279,1096,0,-1096,0.0,97.0,97.0,200000.0,0.0,-200000.0
<a href=/player/planp001>planp001</a>,Phil Plantier,San Diego Padres,PADRS,16,32,32,64,1994,2010,16,No,6,18.63,52.35,33.72,3699,4432,733,12670,15324,2654,1244.0,1789.0,545.0,25389800.0,0.0,-25389800.0
<a href=/player/planp001>planp001</a>,Phil Plantier,Houston Astros,ASTROS,2,2,3,5,1995,1996,1,No,0,2.3,-0.95,-3.25,461,114,-347,186,15,-171,672.0,261.0,-411.0,2000000.0,0.0,-2000000.0
<a href=/player/planp001>planp001</a>,Phil Plantier,Detroit Tigers,TIGRS,1,1,2,3,1996,1996,0,No,0,-1.09,-0.36,0.73,73,14,-59,263,40,-223,0.0,0.0,0.0,0.0,0.0,0.0
<a href=/player/planp001>planp001</a>,Phil Plantier,San Diego Padres,PADRS,5,11,12,23,1997,2006,9,No,1,5.86,22.51,16.65,827,1744,917,2661,6285,3624,68.0,189.0,121.0,10901680.0,0.0,-10901680.0
<a href=/player/plawk001>plawk001</a>,Kevin Plawecki,New York Mets,METS,1,1,2,3,2019,2020,1,No,0,-0.04,-0.48,-0.44,61,31,-30,174,11,-163,6.0,92.0,86.0,0.0,0.0,0.0
<a href=/player/pleib101>pleib101</a>,Bill Pleis,Orlando,Orlando,1,1,1,2,1956,1956,0,No,0,-0.49,0.0,0.49,380,0,-380,58,0,-58,842.0,0.0,-842.0,0.0,0.0,0.0
<a href=/player/plesd001>plesd001</a>,Dan Plesac,Pittsburgh Pirates,PIRATS,3,5,8,13,1996,2007,11,No,0,2.44,5.98,3.54,539,1682,1143,911,3950,3039,615.0,1633.0,1018.0,9245000.0,0.0,-9245000.0
<a href=/player/plesd001>plesd001</a>,Dan Plesac,Toronto Blue Jays,BJAYS,1,1,2,3,1999,2001,2,No,0,0.84,6.98,6.14,187,434,247,1,1364,1363,185.0,379.0,194.0,1500000.0,0.0,-1500000.0
<a href=/player/plesd001>plesd001</a>,Dan Plesac,Toronto Blue Jays,BJAYS,1,1,1,2,2002,2003,1,No,0,0.47,1.18,0.71,193,117,-76,0,0,0,169.0,320.0,151.0,2200000.0,0.0,-2200000.0
<a href=/player/plewh101>plewh101</a>,Herb Plews,New York Yankees,YANKS,7,20,15,35,1956,1970,14,No,0,3.04,33.17,30.13,2442,2492,50,6615,5619,-996,2999.0,5239.0,2240.0,115500.0,0.0,-115500.0
<a href=/player/plewh101>plewh101</a>,Herb Plews,Washington Senators,TWINS,2,3,3,6,1959,1962,3,No,0,-0.17,-0.01,0.16,13,300,287,12,852,840,0.0,4.0,4.0,13000.0,0.0,-13000.0
<a href=/player/plout001>plout001</a>,Trevor Plouffe,Oakland Athletics,ATLTCS,1,2,1,3,2017,2017,0,No,0,-0.74,0.0,0.74,42,0,-42,114,0,-114,0.0,0.0,0.0,0.0,0.0,0.0
<a href=/player/plumb101>plumb101</a>,Bill Plummer,Chicago Cubs,CUBS,3,5,3,8,1969,1974,5,No,0,-2.15,0.81,2.96,445,387,-58,1077,715,-362,55.0,283.0,228.0,0.0,0.0,0.0
<a href=/player/plune001>plune001</a>,Eric Plunk,New York Yankees,YANKS,3,7,8,15,1984,1993,9,No,0,53.43,36.99,-16.44,2484,1135,-1349,8455,3089,-5366,3002.0,2795.0,-207.0,2415000.0,0.0,-2415000.0
<a href=/player/plune001>plune001</a>,Eric Plunk,Oakland Athletics,ATLTCS,3,5,4,9,1989,1998,9,No,0,13.62,32.12,18.5,801,794,-7,1223,2883,1660,2766.0,771.0,-1995.0,4272766.0,0.0,-4272766.0
<a href=/player/plune001>plune001</a>,Eric Plunk,Cleveland Indians,INDINS,1,1,1,2,1998,1998,0,No,0,0.36,0.68,0.32,184,23,-161,2,0,-2,321.0,94.0,-227.0,1800000.0,0.0,-1800000.0
<a href=/player/poatr101>poatr101</a>,Ray Poat,New York Giants,GIANTS,1,2,1,3,1949,1949,0,No,0,-0.71,0.46,1.17,25,74,49,18,18,0,108.0,241.0,133.0,0.0,0.0,0.0
<a href=/player/pochc001>pochc001</a>,Colin Poche,Arizona Diamondbacks,DBACKS,1,4,2,6,2018,2019,1,Yes,0,-0.39,-0.4,-0.01,65,72,7,0,272,272,232.0,0.0,-232.0,0.0,0.0,0.0
<a href=/player/podbb101>podbb101</a>,Bud Podbielan,Brooklyn Dodgers,DOGRS,2,2,3,5,1952,1953,1,No,0,2.7,0.0,-2.7,278,0,-278,152,0,-152,1491.0,0.0,-1491.0,0.0,0.0,0.0
<a href=/player/podgj101>podgj101</a>,Johnny Podgajny,Philadelphia Phillies,PHILS,1,1,1,2,1943,1943,0,No,0,-1.01,-1.01,0.0,36,42,6,7,7,0,103.0,108.0,5.0,0.0,0.0,0.0
<a href=/player/podgj101>podgj101</a>,Johnny Podgajny,Pittsburgh Pirates,PIRATS,2,6,4,10,1943,1950,7,No,0,26.56,10.14,-16.42,1156,549,-607,3340,925,-2415,3832.0,2198.0,-1634.0,0.0,0.0,0.0
<a href=/player/podss001>podss001</a>,Scott Podsednik,Texas Rangers,RNGRS,1,2,1,3,1995,1998,3,No,0,0.0,3.86,3.86,0,95,95,0,7,7,0.0,1618.0,1618.0,109000.0,0.0,-109000.0
<a href=/player/podss001>podss001</a>,Scott Podsednik,Milwaukee Brewers,BREWRS,11,22,22,44,2004,2020,16,Yes,1,50.21,29.77,-20.44,4158,1927,-2231,15837,5622,-10215,987.0,3218.0,2231.0,29855500.0,0.0,-29855500.0
<a href=/player/podss001>podss001</a>,Scott Podsednik,Kansas City Royals,ROYALS,2,2,3,5,2010,2011,1,No,0,-0.69,-0.45,0.24,39,12,-27,160,39,-121,0.0,0.0,0.0,1650000.0,0.0,-1650000.0
<a href=/player/podss001>podss001</a>,Scott Podsednik,Boston Red Sox,RSOX,1,2,1,3,2012,2015,3,No,0,0.39,1.0,0.61,46,199,153,0,0,0,63.0,597.0,534.0,1075000.0,0.0,-1075000.0
<a href=/player/pofaj101>pofaj101</a>,Jimmy Pofahl,Washington Senators,TWINS,1,3,1,4,1943,1943,0,No,0,7.97,3.2,-4.77,391,117,-274,1546,505,-1041,0.0,0.0,0.0,0.0,0.0,0.0
<a href=/player/pofaj101>pofaj101</a>,Jimmy Pofahl,Minneapolis,Minneapolis,1,1,4,5,1939,1946,7,No,0,-2.62,0.0,2.62,225,0,-225,849,0,-849,0.0,0.0,0.0,0.0,0.0,0.0
<a href=/player/poffj101>poffj101</a>,John Poff,Milwaukee Brewers,BREWRS,2,2,2,4,1981,1982,1,No,0,-0.91,-0.41,0.5,22,42,20,50,112,62,0.0,0.0,0.0,0.0,0.0,0.0
<a href=/player/pohot101>pohot101</a>,Tom Poholsky,St. Louis Cardinals,CARDS,15,35,30,65,1956,1972,16,No,0,38.58,60.99,22.41,4144,2647,-1497,9926,7589,-2337,4766.0,5429.0,663.0,32500.0,0.0,-32500.0
<a href=/player/pohot101>pohot101</a>,Tom Poholsky,Chicago Cubs,CUBS,2,2,2,4,1957,1958,1,No,0,0.0,-0.27,-0.27,0,14,14,0,1,1,0.0,22.0,22.0,0.0,0.0,0.0
<a href=/player/poina101>poina101</a>,Aaron Pointer,Houston Astros,ASTROS,1,1,1,2,1968,1969,1,No,0,0.0,0.08,0.08,0,10,10,0,17,17,0.0,0.0,0.0,0.0,0.0,0.0
<a href=/player/poinj101>poinj101</a>,Jennings Poindexter,Philadelphia Phillies,PHILS,1,2,1,3,1939,1940,1,No,0,0.0,0.32,0.32,0,69,69,0,222,222,0.0,0.0,0.0,3000.0,0.0,-3000.0
<a href=/player/polah101>polah101</a>,Hugh Poland,New York Giants,GIANTS,1,2,1,3,1943,1947,4,No,0,7.61,8.14,0.53,725,472,-253,2750,1521,-1229,0.0,0.0,0.0,0.0,0.0,0.0
<a href=/player/polah101>polah101</a>,Hugh Poland,Philadelphia Phillies,PHILS,1,2,1,3,1947,1949,2,No,0,23.82,-2.12,-25.94,519,88,-431,570,262,-308,4467.0,2.0,-4465.0,0.0,0.0,0.0
<a href=/player/polap001>polap001</a>,Placido Polanco,St. Louis Cardinals,CARDS,2,4,4,8,2002,2009,7,No,0,23.28,30.12,6.84,951,826,-125,3803,3406,-397,107.0,0.0,-107.0,7000000.0,0.0,-7000000.0
<a href=/player/polap001>polap001</a>,Placido Polanco,Philadelphia Phillies,PHILS,1,1,2,3,2005,2005,0,No,0,19.15,-0.18,-19.33,632,143,-489,2819,65,-2754,0.0,157.0,157.0,4600000.0,0.0,-4600000.0
<a href=/player/polic001>polic001</a>,Cliff Politte,St. Louis Cardinals,CARDS,1,3,2,5,1998,1999,1,No,0,3.97,-0.62,-4.59,475,133,-342,1012,3,-1009,549.0,220.0,-329.0,8470000.0,0.0,-8470000.0
<a href=/player/polic001>polic001</a>,Cliff Politte,Philadelphia Phillies,PHILS,1,1,1,2,2002,2002,0,No,0,1.18,-0.14,-1.32,117,78,-39,0,0,0,320.0,69.0,-251.0,245000.0,0.0,-245000.0
<a href=/player/polig001>polig001</a>,Gus Polidor,California Angels,ANGELS,1,1,1,2,1988,1990,2,No,0,-0.54,-0.07,0.47,97,59,-38,201,203,2,0.0,0.0,0.0,97000.0,0.0,-97000.0
<a href=/player/polig001>polig001</a>,Gus Polidor,Milwaukee Brewers,BREWRS,1,1,1,2,1991,1991,0,No,0,0.0,0.0,0.0,0,0,0,0,0,0,0.0,0.0,0.0,0.0,0.0,0.0
<a href=/player/pollh101>pollh101</a>,Howie Pollet,St. Louis Cardinals,CARDS,3,10,5,15,1951,1954,3,No,0,10.75,2.71,-8.04,1144,382,-762,2713,1234,-1479,1601.0,388.0,-1213.0,41500.0,0.0,-41500.0
<a href=/player/pollh101>pollh101</a>,Howie Pollet,Pittsburgh Pirates,PIRATS,7,12,15,27,1953,1962,9,No,0,9.43,3.47,-5.96,1075,1271,196,3095,3842,747,1449.0,56.0,-1393.0,86000.0,0.0,-86000.0
<a href=/player/poloj101>poloj101</a>,John Poloni,Texas Rangers,RNGRS,1,2,1,3,1977,1981,4,No,0,0.0,11.05,11.05,0,121,121,0,0,0,0.0,2436.0,2436.0,0.0,0.0,0.0
<a href=/player/polol001>polol001</a>,Luis Polonia,Oakland Athletics,ATLTCS,3,5,4,9,1989,1998,9,No,0,13.62,32.12,18.5,801,794,-7,1223,2883,1660,2766.0,771.0,-1995.0,4272766.0,0.0,-4272766.0
<a href=/player/polol001>polol001</a>,Luis Polonia,New York Yankees,YANKS,1,1,2,3,1990,1993,3,No,0,2.38,0.54,-1.84,560,153,-407,2347,83,-2264,0.0,698.0,698.0,200000.0,0.0,-200000.0
<a href=/player/polol001>polol001</a>,Luis Polonia,New York Yankees,YANKS,1,1,1,2,1995,1995,0,No,0,-0.18,0.0,0.18,50,0,-50,90,0,-90,0.0,0.0,0.0,1500000.0,0.0,-1500000.0
<a href=/player/pomed001>pomed001</a>,Drew Pomeranz,Cleveland Indians,INDINS,1,4,1,5,2011,2013,2,No,0,-0.32,1.97,2.29,204,79,-125,247,10,-237,813.0,1274.0,461.0,0.0,0.0,0.0
<a href=/player/pomed001>pomed001</a>,Drew Pomeranz,Colorado Rockies,ROCKS,1,2,2,4,2013,2014,1,No,0,1.75,1.05,-0.7,79,16,-63,0,15,15,465.0,130.0,-335.0,0.0,0.0,0.0
<a href=/player/pomed001>pomed001</a>,Drew Pomeranz,Oakland Athletics,ATLTCS,4,8,5,13,2015,2018,3,Yes,0,5.93,2.94,-2.99,610,354,-256,992,1020,28,691.0,108.0,-583.0,4517500.0,0.0,-4517500.0
<a href=/player/pomed001>pomed001</a>,Drew Pomeranz,San Diego Padres,PADRS,2,2,2,4,2016,2021,5,No,0,3.84,-0.19,-4.03,77,34,-43,3,54,51,949.0,0.0,-949.0,0.0,0.0,0.0
<a href=/player/pomed001>pomed001</a>,Drew Pomeranz,San Francisco Giants,GIANTS,1,2,1,3,2019,2019,0,Yes,0,0.99,0.61,-0.38,83,28,-55,2,109,107,130.0,0.0,-130.0,1500000.0,0.0,-1500000.0
<a href=/player/pomoj101>pomoj101</a>,John Pomorski,Montreal,Montreal,1,1,2,3,1933,1939,6,No,0,-0.02,0.0,0.02,6,0,-6,0,0,0,5.0,0.0,-5.0,0.0,0.0,0.0
<a href=/player/poncc002>poncc002</a>,Cody Ponce,Milwaukee Brewers,BREWRS,1,1,1,2,2019,2019,0,No,0,-0.72,1.85,2.57,35,21,-14,7,22,15,166.0,176.0,10.0,0.0,0.0,0.0
<a href=/player/ponde101>ponde101</a>,Elmer Ponder,Pittsburgh Pirates,PIRATS,1,1,1,2,1921,1922,1,No,0,-0.64,1.12,1.76,32,60,28,35,252,217,268.0,0.0,-268.0,4250.0,0.0,-4250.0
<a href=/player/ponde101>ponde101</a>,Elmer Ponder,Chicago Cubs,CUBS,2,8,5,13,1921,1926,5,No,0,29.39,11.6,-17.79,1120,351,-769,4097,694,-3403,1929.0,2961.0,1032.0,13500.0,0.0,-13500.0
<a href=/player/ponss001>ponss001</a>,Sidney Ponson,Baltimore Orioles,ORLS,1,1,3,4,2003,2005,2,No,0,0.88,-1.54,-2.42,20,20,0,25,0,-25,204.0,251.0,47.0,4250000.0,0.0,-4250000.0
<a href=/player/poolh101>poolh101</a>,Harlin Pool,Oakland,Oakland,1,1,2,3,1934,1934,0,No,0,0.38,0.0,-0.38,127,0,-127,457,0,-457,0.0,0.0,0.0,0.0,0.0,0.0
<a href=/player/poolj001>poolj001</a>,Jim Poole,Los Angeles Dodgers,DOGRS,1,2,2,4,1990,1990,0,No,0,-0.03,0.0,0.03,6,0,-6,0,0,0,18.0,0.0,-18.0,0.0,0.0,0.0
<a href=/player/poolj001>poolj001</a>,Jim Poole,Cleveland Indians,INDINS,1,2,1,3,1996,1996,0,No,0,-1.36,0.64,2.0,243,38,-205,9,156,147,316.0,0.0,-316.0,500000.0,0.0,-500000.0
<a href=/player/poolj101>poolj101</a>,Jim Poole,Portland,Portland,2,3,5,8,1925,1926,1,No,0,0.46,0.0,-0.46,300,0,-300,1041,0,-1041,63.0,0.0,-63.0,0.0,0.0,0.0
<a href=/player/pop-z001>pop-z001</a>,Zach Pop,Los Angeles Dodgers,DOGRS,1,5,1,6,2018,2018,0,No,0,-0.21,2.49,2.7,29,66,37,41,296,255,217.0,0.0,-217.0,0.0,0.0,0.0
<a href=/player/pop-z001>pop-z001</a>,Zach Pop,Arizona Diamondbacks,DBACKS,1,1,1,2,2020,2021,1,Yes,0,0.06,0.0,-0.06,95,0,-95,2,0,-2,164.0,0.0,-164.0,0.0,0.0,0.0
<a href=/player/poped101>poped101</a>,Dave Pope,Cleveland Indians,INDINS,9,17,16,33,1955,1968,13,No,0,100.62,38.17,-62.45,4524,2758,-1766,15556,10180,-5376,4502.0,562.0,-3940.0,0.0,0.0,0.0
<a href=/player/poped101>poped101</a>,Dave Pope,Baltimore Orioles,ORLS,1,1,1,2,1956,1956,0,No,0,-0.47,0.41,0.88,25,48,23,72,138,66,0.0,0.0,0.0,0.0,0.0,0.0
<a href=/player/poped101>poped101</a>,Dave Pope,Cleveland Indians,INDINS,1,2,1,3,1958,1960,2,No,0,0.0,0.48,0.48,0,12,12,0,2,2,0.0,27.0,27.0,0.0,0.0,0.0
<a href=/player/popop101>popop101</a>,Paul Popovich,Chicago Cubs,CUBS,3,4,3,7,1967,1973,6,No,0,1.48,-0.34,-1.82,258,333,75,792,861,69,0.0,8.0,8.0,37250.0,0.0,-37250.0
<a href=/player/popop101>popop101</a>,Paul Popovich,Los Angeles Dodgers,DOGRS,1,2,2,4,1969,1979,10,No,0,17.55,18.66,1.11,718,1264,546,2642,4042,1400,0.0,0.0,0.0,0.0,0.0,0.0
<a href=/player/popop101>popop101</a>,Paul Popovich,Montreal Expos,NATEX,1,1,2,3,1969,1971,2,No,0,-1.66,1.57,3.23,384,150,-234,1079,474,-605,0.0,0.0,0.0,0.0,0.0,0.0
<a href=/player/popop101>popop101</a>,Paul Popovich,Chicago Cubs,CUBS,1,1,2,3,1974,1976,2,No,0,-0.31,-0.35,-0.04,84,112,28,134,49,-85,0.0,471.0,471.0,0.0,0.0,0.0
<a href=/player/poqut101>poqut101</a>,Tom Poquette,Kansas City Royals,ROYALS,1,1,1,2,1979,1979,0,No,0,0.0,0.0,0.0,66,44,-22,172,162,-10,0.0,0.0,0.0,0.0,0.0,0.0
<a href=/player/porcr001>porcr001</a>,Rick Porcello,Detroit Tigers,TIGRS,6,9,11,20,2014,2019,5,Yes,0,30.16,14.63,-15.53,1425,689,-736,1837,924,-913,5391.0,1331.0,-4060.0,32215000.0,0.0,-32215000.0
<a href=/player/porea001>porea001</a>,Aaron Poreda,Chicago White Sox,WSOX,6,14,12,26,2009,2018,9,Yes,0,7.16,22.73,15.57,991,1029,38,935,3763,2828,4825.0,1688.0,-3137.0,13340000.0,0.0,-13340000.0
<a href=/player/porta101>porta101</a>,Arnie Portocarrero,Kansas City Athletics,ATLTCS,2,2,3,5,1958,1963,5,No,0,1.35,5.09,3.74,304,388,84,195,561,366,1819.0,1969.0,150.0,0.0,0.0,0.0
<a href=/player/portb102>portb102</a>,Bob Porterfield,New York Yankees,YANKS,1,3,1,4,1951,1954,3,No,0,18.48,1.84,-16.64,407,209,-198,444,108,-336,3513.0,1042.0,-2471.0,11500.0,0.0,-11500.0
<a href=/player/portb102>portb102</a>,Bob Porterfield,Washington Senators,TWINS,7,16,14,30,1955,1963,8,No,0,11.54,-1.9,-13.44,1150,1625,475,3478,3777,299,832.0,1792.0,960.0,17500.0,0.0,-17500.0
<a href=/player/portd001>portd001</a>,Darrell Porter,Milwaukee Brewers,BREWRS,3,4,6,10,1976,1986,10,No,0,23.16,4.69,-18.47,1350,684,-666,3618,973,-2645,1204.0,2526.0,1322.0,487500.0,0.0,-487500.0
<a href=/player/portd101>portd101</a>,Dick Porter,Baltimore,Baltimore,1,1,1,2,1928,1928,0,No,0,7.88,0.0,-7.88,596,0,-596,2556,0,-2556,0.0,0.0,0.0,0.0,0.0,0.0
<a href=/player/portd101>portd101</a>,Dick Porter,Cleveland Indians,INDINS,3,6,5,11,1934,1940,6,No,0,24.33,10.74,-13.59,727,766,39,1921,2878,957,2729.0,210.0,-2519.0,10500.0,0.0,-10500.0
<a href=/player/portj101>portj101</a>,JW Porter,Chicago White Sox,WSOX,8,14,15,29,1952,1969,17,No,0,11.54,36.17,24.63,1591,2618,1027,4750,8911,4161,1710.0,1860.0,150.0,87250.0,0.0,-87250.0
<a href=/player/portj101>portj101</a>,JW Porter,St.Louis Browns,ORLS,29,63,61,124,1952,1994,42,No,3,108.88,170.74,61.86,6500,10285,3785,14305,30002,15697,22658.0,18329.0,-4329.0,980833.0,0.0,-980833.0
<a href=/player/portj101>portj101</a>,JW Porter,Detroit Tigers,TIGRS,3,4,5,9,1958,1968,10,No,0,1.32,14.68,13.36,168,713,545,243,528,285,332.0,3536.0,3204.0,0.0,0.0,0.0
<a href=/player/portj101>portj101</a>,JW Porter,Cleveland Indians,INDINS,5,9,8,17,1958,1965,7,No,0,17.68,1.46,-16.22,1632,479,-1153,4130,1716,-2414,3556.0,132.0,-3424.0,7500.0,0.0,-7500.0
<a href=/player/portm001>portm001</a>,Mark Portugal,Minnesota Twins,TWINS,1,1,1,2,1988,1988,0,No,0,10.65,0.0,-10.65,271,0,-271,282,0,-282,2347.0,0.0,-2347.0,68800.0,0.0,-68800.0
<a href=/player/portm001>portm001</a>,Mark Portugal,San Francisco Giants,GIANTS,3,5,8,13,1995,1998,3,No,0,9.99,0.74,-9.25,311,256,-55,447,555,108,1958.0,96.0,-1862.0,5827778.0,0.0,-5827778.0
<a href=/player/porzm001>porzm001</a>,Mike Porzio,Atlanta Braves,BRAVES,1,2,1,3,1998,1998,0,No,0,1.03,0.19,-0.84,187,28,-159,2,49,47,290.0,0.0,-290.0,0.0,0.0,0.0
<a href=/player/posal101>posal101</a>,Leo Posada,Kansas City Athletics,ATLTCS,1,2,1,3,1962,1965,3,No,0,0.0,6.11,6.11,0,202,202,0,205,205,0.0,1684.0,1684.0,0.0,0.0,0.0
<a href=/player/poseb102>poseb102</a>,Bill Posedel,Brooklyn Dodgers,DOGRS,3,5,4,9,1939,1949,10,No,0,0.18,4.06,3.88,452,709,257,1041,2346,1305,1618.0,101.0,-1517.0,10000.0,0.0,-10000.0
<a href=/player/poseb102>poseb102</a>,Bill Posedel,Portland,Portland,1,1,1,2,1936,1936,0,No,0,0.0,0.0,0.0,0,0,0,0,0,0,0.0,0.0,0.0,0.0,0.0,0.0
<a href=/player/poses001>poses001</a>,Scott Pose,Cleveland Indians,INDINS,1,1,1,2,1996,1996,0,No,0,0.0,0.0,0.0,0,0,0,0,0,0,0.0,0.0,0.0,0.0,0.0,0.0
<a href=/player/postw101>postw101</a>,Wally Post,Cincinnati Reds,REDS,5,8,12,20,1957,1965,8,No,0,66.28,13.33,-52.95,3412,1144,-2268,10935,1792,-9143,2563.0,1487.0,-1076.0,0.0,0.0,0.0
<a href=/player/postw101>postw101</a>,Wally Post,Philadelphia Phillies,PHILS,1,3,2,5,1960,1968,8,No,0,5.52,24.2,18.68,336,1274,938,998,4678,3680,0.0,0.0,0.0,0.0,0.0,0.0
<a href=/player/potel001>potel001</a>,Lou Pote,San Francisco Giants,GIANTS,1,1,1,2,1995,1995,0,No,0,0.0,-0.63,-0.63,0,10,10,0,1,1,0.0,15.0,15.0,0.0,0.0,0.0
<a href=/player/pottm101>pottm101</a>,Mike Potter,St. Louis Cardinals,CARDS,1,1,1,2,1978,1979,1,No,0,0.0,0.0,0.0,0,0,0,0,0,0,0.0,0.0,0.0,0.0,0.0,0.0
<a href=/player/pottn101>pottn101</a>,Nellie Pott,Cleveland Indians,INDINS,1,5,1,6,1922,1935,13,No,0,0.0,5.93,5.93,0,850,850,0,2604,2604,0.0,0.0,0.0,0.0,0.0,0.0
<a href=/player/pounb001>pounb001</a>,Brooks Pounders,Pittsburgh Pirates,PIRATS,2,3,2,5,2011,2012,1,No,0,-0.43,-0.15,0.28,21,29,8,31,56,25,38.0,0.0,-38.0,483000.0,0.0,-483000.0
<a href=/player/pounb001>pounb001</a>,Brooks Pounders,Kansas City Royals,ROYALS,1,1,1,2,2016,2016,0,Yes,0,-0.4,0.0,0.4,11,0,-11,0,0,0,31.0,0.0,-31.0,0.0,0.0,0.0
<a href=/player/pounb101>pounb101</a>,Bill Pounds,Brooklyn Dodgers,DOGRS,1,4,1,5,1903,1908,5,No,0,0.0,0.0,0.0,0,0,0,0,0,0,0.0,0.0,0.0,0.0,0.0,0.0
<a href=/player/povsm001>povsm001</a>,Max Povse,Atlanta Braves,BRAVES,2,3,3,6,2016,2021,5,Yes,0,-0.2,0.58,0.78,48,74,26,123,266,143,45.0,0.0,-45.0,0.0,0.0,0.0
<a href=/player/powea001>powea001</a>,Alonzo Powell,San Francisco Giants,GIANTS,1,2,1,3,1985,1986,1,No,0,-0.44,0.85,1.29,34,78,44,46,40,-6,26.0,424.0,398.0,0.0,0.0,0.0
<a href=/player/powea001>powea001</a>,Alonzo Powell,Montreal Expos,NATEX,2,2,2,4,1989,1990,1,No,0,-0.44,0.0,0.44,37,13,-24,75,11,-64,0.0,0.0,0.0,0.0,0.0,0.0
<a href=/player/poweb001>poweb001</a>,Brian Powell,Detroit Tigers,TIGRS,4,11,7,18,1999,2002,3,No,1,3.62,7.62,4.0,1493,652,-841,3797,1742,-2055,861.0,1164.0,303.0,6750000.0,0.0,-6750000.0
<a href=/player/poweb002>poweb002</a>,Boog Powell,Oakland Athletics,ATLTCS,7,12,9,21,2015,2018,3,Yes,0,7.5,-0.52,-8.02,615,193,-422,2031,464,-1567,103.0,312.0,209.0,8300001.0,0.0,-8300001.0
<a href=/player/poweb002>poweb002</a>,Boog Powell,Tampa Bay Devil Rays,RAYS,2,5,4,9,2015,2018,3,Yes,0,-0.11,7.04,7.15,74,689,615,124,2370,2246,283.0,211.0,-72.0,508800.0,0.0,-508800.0
<a href=/player/poweb002>poweb002</a>,Boog Powell,Seattle Mariners,MARNRS,1,1,1,2,2017,2017,0,No,0,0.63,0.38,-0.25,36,42,6,117,150,33,0.0,0.0,0.0,0.0,0.0,0.0
<a href=/player/poweb101>poweb101</a>,Boog Powell,Baltimore Orioles,ORLS,2,3,3,6,1975,1980,5,No,0,6.5,4.24,-2.26,389,566,177,845,1795,950,1484.0,0.0,-1484.0,0.0,0.0,0.0
<a href=/player/powed001>powed001</a>,Dennis Powell,Los Angeles Dodgers,DOGRS,3,6,5,11,1986,1992,6,No,1,10.4,9.71,-0.69,399,1157,758,1,1800,1799,4543.0,1247.0,-3296.0,1249500.0,0.0,-1249500.0
<a href=/player/powed002>powed002</a>,Dante Powell,San Francisco Giants,GIANTS,2,3,2,5,1998,2001,3,No,0,-0.48,0.32,0.8,61,300,239,28,1,-27,102.0,416.0,314.0,2400000.0,0.0,-2400000.0
<a href=/player/powed002>powed002</a>,Dante Powell,Arizona Diamondbacks,DBACKS,1,1,1,2,1999,2000,1,No,0,0.0,0.0,0.0,0,0,0,0,0,0,0.0,0.0,0.0,200000.0,0.0,-200000.0
<a href=/player/poweg101>poweg101</a>,Grover Powell,Cincinnati Reds,REDS,1,1,1,2,1969,1969,0,No,0,0.0,0.0,0.0,0,1,1,0,1,1,0.0,0.0,0.0,0.0,0.0,0.0
<a href=/player/poweh101>poweh101</a>,Hosken Powell,Minnesota Twins,TWINS,1,1,1,2,1981,1983,2,No,0,-0.81,-0.5,0.31,152,15,-137,369,57,-312,0.0,0.0,0.0,0.0,0.0,0.0
<a href=/player/powej001>powej001</a>,Jay Powell,Baltimore Orioles,ORLS,1,1,1,2,1994,1995,1,No,0,0.41,1.09,0.68,359,90,-269,10,288,278,587.0,0.0,-587.0,0.0,0.0,0.0
<a href=/player/powej001>powej001</a>,Jay Powell,Florida Marlins,MARLNS,1,2,1,3,1998,2004,6,No,0,1.89,0.02,-1.87,314,207,-107,3,531,528,517.0,0.0,-517.0,320000.0,0.0,-320000.0
<a href=/player/powej001>powej001</a>,Jay Powell,Houston Astros,ASTROS,1,1,1,2,2001,2001,0,No,0,0.67,-0.38,-1.05,75,60,-15,0,15,15,116.0,204.0,88.0,1600000.0,0.0,-1600000.0
<a href=/player/powej103>powej103</a>,John Powers,Pittsburgh Pirates,PIRATS,9,16,18,34,1959,1973,14,No,0,-0.94,37.67,38.61,564,1623,1059,1204,4862,3658,386.0,2327.0,1941.0,17500.0,0.0,-17500.0
<a href=/player/powej103>powej103</a>,John Powers,Cleveland Indians,INDINS,2,2,3,5,1960,1960,0,No,0,0.09,0.16,0.07,26,66,40,61,203,142,0.0,0.0,0.0,0.0,0.0,0.0
<a href=/player/powej105>powej105</a>,Jack Powell,St.Louis Browns,ORLS,1,1,2,3,1904,1904,0,No,0,2.89,6.7,3.81,168,70,-98,224,122,-102,1776.0,899.0,-877.0,0.0,0.0,0.0
<a href=/player/powej106>powej106</a>,Jake Powell,Washington Senators,TWINS,4,5,6,11,1936,1942,6,No,0,11.3,17.7,6.4,990,1163,173,3744,4158,414,623.0,1269.0,646.0,39500.0,0.0,-39500.0
<a href=/player/powem103>powem103</a>,Mike Powers,Cleveland Indians,INDINS,1,1,1,2,1931,1934,3,No,0,0.0,-0.09,-0.09,0,30,30,0,3,3,0.0,69.0,69.0,0.0,0.0,0.0
<a href=/player/powep102>powep102</a>,Paul Powell,Minnesota Twins,TWINS,2,2,2,4,1971,1976,5,No,0,-0.13,7.05,7.18,90,577,487,294,2325,2031,0.0,0.0,0.0,0.0,0.0,0.0
<a href=/player/power001>power001</a>,Ross Powell,Cincinnati Reds,REDS,3,4,4,8,1994,2003,9,No,0,-0.82,7.3,8.12,166,906,740,133,2361,2228,172.0,625.0,453.0,1650000.0,0.0,-1650000.0
<a href=/player/power101>power101</a>,Ray Powell,Boston Braves,BRAVES,2,3,2,5,1923,1926,3,No,0,-0.57,0.9,1.47,238,272,34,860,1042,182,0.0,0.0,0.0,6000.0,0.0,-6000.0
<a href=/player/powet001>powet001</a>,Ted Power,Los Angeles Dodgers,DOGRS,1,1,2,3,1982,1982,0,No,0,7.16,0.0,-7.16,699,0,-699,134,0,-134,2159.0,0.0,-2159.0,0.0,0.0,0.0
<a href=/player/powet001>powet001</a>,Ted Power,Cincinnati Reds,REDS,1,2,2,4,1987,1990,3,No,0,6.27,5.43,-0.84,546,156,-390,2022,182,-1840,241.0,1481.0,1240.0,580000.0,0.0,-580000.0
<a href=/player/powet001>powet001</a>,Ted Power,Kansas City Royals,ROYALS,1,1,2,3,1988,1990,2,No,0,-0.3,-0.33,-0.03,4,105,101,0,125,125,56.0,15.0,-41.0,575000.0,0.0,-575000.0
<a href=/player/powev101>powev101</a>,Vic Power,New York Yankees,YANKS,16,45,38,83,1953,1970,17,No,0,48.62,78.17,29.55,7017,4726,-2291,22732,11340,-11392,3607.0,11554.0,7947.0,313000.0,0.0,-313000.0
<a href=/player/powev101>powev101</a>,Vic Power,Kansas City Athletics,ATLTCS,24,48,46,94,1958,1976,18,No,0,124.94,48.67,-76.27,9659,5527,-4132,26702,16658,-10044,8728.0,3973.0,-4755.0,440600.0,0.0,-440600.0
<a href=/player/powev101>powev101</a>,Vic Power,Cleveland Indians,INDINS,6,8,11,19,1962,1969,7,No,0,9.88,8.16,-1.72,1353,584,-769,1625,332,-1293,4119.0,3147.0,-972.0,97100.0,0.0,-97100.0
<a href=/player/powev101>powev101</a>,Vic Power,Minnesota Twins,TWINS,1,2,2,4,1964,1966,2,No,0,-1.17,-1.3,-0.13,231,246,15,550,644,94,0.0,0.0,0.0,15000.0,0.0,-15000.0
<a href=/player/powev101>powev101</a>,Vic Power,Los Angeles Angels,ANGELS,3,4,4,8,1964,1968,4,No,0,0.22,4.09,3.87,228,285,57,232,375,143,443.0,1270.0,827.0,24000.0,0.0,-24000.0
<a href=/player/pozoa001>pozoa001</a>,Arquimedez Pozo,Seattle Mariners,MARNRS,1,1,1,2,1996,1996,0,No,0,-0.49,-0.31,0.18,25,21,-4,79,63,-16,0.0,0.0,0.0,0.0,0.0,0.0
<a href=/player/pradm001>pradm001</a>,Martin Prado,Atlanta Braves,BRAVES,4,10,11,21,2013,2019,6,Yes,0,22.68,8.16,-14.52,2194,1203,-991,6430,4358,-2072,1394.0,147.0,-1247.0,14250000.0,0.0,-14250000.0
<a href=/player/pradm001>pradm001</a>,Martin Prado,Arizona Diamondbacks,DBACKS,2,2,3,5,2014,2017,3,Yes,0,2.1,-0.53,-2.63,37,36,-1,137,79,-58,0.0,0.0,0.0,0.0,0.0,0.0
<a href=/player/pradm001>pradm001</a>,Martin Prado,New York Yankees,YANKS,1,3,3,6,2014,2016,2,Yes,0,8.73,2.98,-5.75,736,115,-621,1879,164,-1715,737.0,839.0,102.0,11541425.0,0.0,-11541425.0
<a href=/player/pralw101>pralw101</a>,Willie Prall,San Francisco Giants,GIANTS,2,3,2,5,1974,1980,6,No,0,-1.53,2.73,4.26,105,488,383,148,1551,1403,126.0,0.0,-126.0,0.0,0.0,0.0
<a href=/player/pramj101>pramj101</a>,Johnny Pramesa,Cincinnati Reds,REDS,10,20,25,45,1951,1965,14,No,0,82.49,29.43,-53.06,4608,2904,-1704,14725,6918,-7807,2749.0,1517.0,-1232.0,76250.0,0.0,-76250.0
<a href=/player/prata001>prata001</a>,Andy Pratt,Texas Rangers,RNGRS,1,1,1,2,2002,2004,2,No,0,-0.03,0.02,0.05,2,2,0,0,0,0,4.0,30.0,26.0,0.0,0.0,0.0
<a href=/player/prata001>prata001</a>,Andy Pratt,Atlanta Braves,BRAVES,2,5,3,8,2004,2013,9,No,0,-3.3,26.82,30.12,86,573,487,55,584,529,235.0,4935.0,4700.0,370000.0,0.0,-370000.0
<a href=/player/prata001>prata001</a>,Andy Pratt,Chicago Cubs,CUBS,1,2,1,3,2004,2004,0,No,0,0.0,0.08,0.08,0,15,15,0,19,19,0.0,0.0,0.0,300000.0,0.0,-300000.0
<a href=/player/pratd101>pratd101</a>,Del Pratt,St.Louis Browns,ORLS,31,58,69,127,1918,1952,34,No,0,180.6,188.06,7.46,8263,12092,3829,24970,33212,8242,20858.0,35942.0,15084.0,281100.0,0.0,-281100.0
<a href=/player/pratd101>pratd101</a>,Del Pratt,New York Yankees,YANKS,4,8,10,18,1920,1931,11,No,0,18.87,48.71,29.84,1297,1673,376,4337,4022,-315,1020.0,6917.0,5897.0,44500.0,0.0,-44500.0
<a href=/player/pratd101>pratd101</a>,Del Pratt,Boston Red Sox,RSOX,5,10,13,23,1922,1937,15,No,0,16.16,24.39,8.23,675,750,75,1305,1574,269,3851.0,4650.0,799.0,45550.0,0.0,-45550.0
<a href=/player/pratt001>pratt001</a>,Todd Pratt,New York Mets,METS,2,2,2,4,2001,2001,0,No,0,1.8,0.0,-1.8,331,1,-330,1126,1,-1125,0.0,0.0,0.0,600000.0,0.0,-600000.0
<a href=/player/prenm101>prenm101</a>,Mike Prendergast,Chicago Cubs,CUBS,1,3,2,5,1917,1926,9,No,0,1.4,43.04,41.64,84,484,400,105,724,619,802.0,5642.0,4840.0,5000.0,0.0,-5000.0
<a href=/player/presa001>presa001</a>,Alex Presley,Pittsburgh Pirates,PIRATS,1,2,1,3,2013,2013,0,No,0,-0.24,-0.03,0.21,28,25,-3,122,92,-30,0.0,0.0,0.0,0.0,0.0,0.0
<a href=/player/presb101>presb101</a>,Bobby Prescott,San Francisco Giants,GIANTS,1,1,1,2,1961,1961,0,No,0,-0.31,0.0,0.31,10,0,-10,14,0,-14,0.0,0.0,0.0,0.0,0.0,0.0
<a href=/player/presb101>presb101</a>,Bobby Prescott,Kansas City Athletics,ATLTCS,2,4,3,7,1961,1962,1,No,0,-0.07,-0.09,-0.02,40,20,-20,51,37,-14,0.0,0.0,0.0,0.0,0.0,0.0
<a href=/player/presj001>presj001</a>,Jim Presley,Seattle Mariners,MARNRS,2,2,3,5,1990,1993,3,No,0,-1.77,0.78,2.55,140,160,20,577,0,-577,0.0,839.0,839.0,0.0,0.0,0.0
<a href=/player/presr001>presr001</a>,Ryan Pressly,Minnesota Twins,TWINS,1,1,2,3,2018,2018,0,Yes,0,5.2,0.0,-5.2,176,0,-176,0,0,0,488.0,0.0,-488.0,1600000.0,0.0,-1600000.0
<a href=/player/pricb001>pricb001</a>,Bryan Price,Boston Red Sox,RSOX,2,4,3,7,2009,2017,8,No,2,7.47,5.01,-2.46,325,200,-125,19,777,758,3215.0,255.0,-2960.0,415500.0,0.0,-415500.0
<a href=/player/pricd001>pricd001</a>,David Price,Tampa Bay Devil Rays,RAYS,5,7,13,20,2014,2021,7,Yes,0,9.45,17.77,8.32,408,1015,607,1367,3027,1660,730.0,1247.0,517.0,14000000.0,0.0,-14000000.0
<a href=/player/pricd001>pricd001</a>,David Price,Detroit Tigers,TIGRS,2,2,4,6,2015,2021,6,Yes,0,2.15,4.87,2.72,46,167,121,6,14,8,284.0,1552.0,1268.0,23225000.0,0.0,-23225000.0
<a href=/player/pricd001>pricd001</a>,David Price,Boston Red Sox,RSOX,1,3,3,6,2020,2020,0,Yes,0,8.46,2.13,-6.33,253,53,-200,814,221,-593,221.0,0.0,-221.0,0.0,0.0,0.0
<a href=/player/pridb101>pridb101</a>,Bob Priddy,Pittsburgh Pirates,PIRATS,1,2,1,3,1965,1965,0,No,0,0.03,0.41,0.38,287,60,-227,312,157,-155,304.0,0.0,-304.0,0.0,0.0,0.0
<a href=/player/pridb101>pridb101</a>,Bob Priddy,San Francisco Giants,GIANTS,3,4,3,7,1966,1972,6,No,0,-2.2,6.95,9.15,357,389,32,728,341,-387,457.0,2870.0,2413.0,17000.0,0.0,-17000.0
<a href=/player/pridb101>pridb101</a>,Bob Priddy,Washington Senators,RNGRS,12,27,21,48,1968,1988,20,No,0,46.51,51.95,5.44,2991,4295,1304,9420,12528,3108,3885.0,6824.0,2939.0,527000.0,0.0,-527000.0
<a href=/player/pridb101>pridb101</a>,Bob Priddy,Chicago White Sox,WSOX,2,3,3,6,1969,1971,2,No,0,9.0,0.38,-8.62,941,234,-707,3605,831,-2774,79.0,0.0,-79.0,15500.0,0.0,-15500.0
<a href=/player/pridb101>pridb101</a>,Bob Priddy,California Angels,ANGELS,3,7,6,13,1969,1990,21,No,0,44.93,60.7,15.77,1370,2449,1079,2746,9851,7105,8249.0,1336.0,-6913.0,212000.0,0.0,-212000.0
<a href=/player/pridj001>pridj001</a>,Jason Pridie,Tampa Bay Devil Rays,RAYS,6,10,18,28,2007,2018,11,Yes,0,7.31,39.77,32.46,1554,1744,190,4454,3404,-1050,1936.0,6404.0,4468.0,6476100.0,0.0,-6476100.0
<a href=/player/pridj101>pridj101</a>,Jerry Priddy,New York Yankees,YANKS,1,2,2,4,1943,1946,3,No,0,9.48,0.6,-8.88,716,132,-584,1943,129,-1814,1434.0,1073.0,-361.0,0.0,0.0,0.0
<a href=/player/pridj101>pridj101</a>,Jerry Priddy,Washington Senators,TWINS,1,1,1,2,1947,1952,5,No,0,5.67,0.0,-5.67,296,0,-296,1291,0,-1291,0.0,0.0,0.0,0.0,0.0,0.0
<a href=/player/pridj101>pridj101</a>,Jerry Priddy,St.Louis Browns,ORLS,1,1,2,3,1949,1950,1,No,0,6.81,-0.58,-7.39,451,19,-432,1933,3,-1930,0.0,43.0,43.0,0.0,0.0,0.0
<a href=/player/priee001>priee001</a>,Eddie Priest,Cincinnati Reds,REDS,1,2,1,3,1998,1998,0,No,0,0.0,-1.7,-1.7,0,31,31,0,4,4,0.0,79.0,79.0,0.0,0.0,0.0
<a href=/player/primr101>primr101</a>,Ray Prim,Washington Senators,TWINS,1,3,1,4,1935,1935,0,No,0,-0.51,0.0,0.51,66,0,-66,27,0,-27,256.0,0.0,-256.0,0.0,0.0,0.0
<a href=/player/primr101>primr101</a>,Ray Prim,Philadelphia Phillies,PHILS,1,1,1,2,1935,1938,3,No,0,0.0,-0.66,-0.66,0,270,270,0,1055,1055,0.0,0.0,0.0,0.0,0.0,0.0
<a href=/player/prinb001>prinb001</a>,Bret Prinz,Arizona Diamondbacks,DBACKS,1,3,2,5,2003,2003,0,No,0,-0.2,0.48,0.68,53,45,-8,58,183,125,91.0,0.0,-91.0,1200000.0,0.0,-1200000.0
<a href=/player/prinb001>prinb001</a>,Bret Prinz,New York Yankees,YANKS,1,1,1,2,2005,2007,2,No,0,0.04,-0.56,-0.6,3,35,32,0,76,76,9.0,0.0,-9.0,0.0,0.0,0.0
<a href=/player/procs001>procs001</a>,Scott Proctor,Los Angeles Dodgers,DOGRS,1,2,1,3,2003,2004,1,No,0,0.65,0.19,-0.46,406,152,-254,260,302,42,712.0,3.0,-709.0,0.0,0.0,0.0
<a href=/player/procs001>procs001</a>,Scott Proctor,New York Yankees,YANKS,3,5,4,9,2007,2013,6,Yes,1,-1.13,11.61,12.74,169,723,554,50,2791,2741,232.0,3.0,-229.0,1620923.0,0.0,-1620923.0
<a href=/player/profj001>profj001</a>,Jurickson Profar,Texas Rangers,RNGRS,1,2,5,7,2018,2020,2,Yes,0,-0.15,-0.13,0.02,139,13,-126,518,0,-518,0.0,38.0,38.0,1050000.0,0.0,-1050000.0
<a href=/player/profj001>profj001</a>,Jurickson Profar,Oakland Athletics,ATLTCS,1,1,2,3,2019,2019,0,Yes,0,1.34,0.0,-1.34,193,0,-193,614,0,-614,0.0,0.0,0.0,3600000.0,0.0,-3600000.0
<a href=/player/prokl001>prokl001</a>,Luke Prokopec,Los Angeles Dodgers,DOGRS,5,8,9,17,2001,2013,12,No,2,-1.46,13.97,15.43,433,1451,1018,1246,3538,2292,215.0,1865.0,1650.0,3810000.0,0.0,-3810000.0
<a href=/player/prolm101>prolm101</a>,Mike Proly,Chicago White Sox,WSOX,1,1,1,2,1981,1982,1,No,0,0.31,-0.79,-1.1,70,29,-41,7,49,42,189.0,0.0,-189.0,0.0,0.0,0.0
<a href=/player/protd101>protd101</a>,Doc Prothro,Washington Senators,TWINS,5,12,6,18,1924,1941,17,No,0,16.54,43.93,27.39,920,1700,780,2170,6848,4678,3390.0,1035.0,-2355.0,30400.0,0.0,-30400.0
<a href=/player/protd101>protd101</a>,Doc Prothro,Washington Senators,TWINS,1,1,1,2,1924,1924,0,No,0,2.0,0.0,-2.0,119,0,-119,474,0,-474,0.0,0.0,0.0,3200.0,0.0,-3200.0
<a href=/player/protd101>protd101</a>,Doc Prothro,Boston Red Sox,RSOX,1,2,1,3,1925,1925,0,No,0,0.0,0.0,0.0,0,0,0,0,0,0,0.0,0.0,0.0,4250.0,0.0,-4250.0
<a href=/player/protd101>protd101</a>,Doc Prothro,Portland,Portland,1,2,1,3,1926,1926,0,No,0,-0.58,0.0,0.58,17,0,-17,12,0,-12,63.0,0.0,-63.0,0.0,0.0,0.0
<a href=/player/protd101>protd101</a>,Doc Prothro,Memphis,Memphis,1,2,2,4,1924,1924,0,No,0,0.97,0.0,-0.97,178,0,-178,257,0,-257,684.0,0.0,-684.0,0.0,0.0,0.0
<a href=/player/pruda101>pruda101</a>,Augie Prudhomme,Toronto,Toronto,1,2,3,5,1928,1933,5,No,0,9.1,0.0,-9.1,535,0,-535,1990,0,-1990,281.0,0.0,-281.0,0.0,0.0,0.0
<a href=/player/pruej101>pruej101</a>,Jim Pruett,Milwaukee,Milwaukee,1,1,2,3,1944,1944,0,No,0,-0.08,0.0,0.08,9,0,-9,16,0,-16,0.0,0.0,0.0,0.0,0.0,0.0
<a href=/player/pruia001>pruia001</a>,Austin Pruitt,Tampa Bay Devil Rays,RAYS,2,2,4,6,2020,2021,1,Yes,0,-0.05,0.29,0.34,2,29,27,0,72,72,8.0,11.0,3.0,0.0,0.0,0.0
<a href=/player/pruia001>pruia001</a>,Austin Pruitt,Houston Astros,ASTROS,1,2,1,3,2021,2021,0,No,0,1.08,-0.33,-1.41,66,26,-40,219,0,-219,14.0,64.0,50.0,0.0,0.0,0.0
<a href=/player/pruir101>pruir101</a>,Ron Pruitt,Texas Rangers,RNGRS,1,2,1,3,1975,1982,7,No,0,2.82,-1.21,-4.03,325,301,-24,802,863,61,317.0,0.0,-317.0,0.0,0.0,0.0
<a href=/player/pruir101>pruir101</a>,Ron Pruitt,Cleveland Indians,INDINS,1,1,1,2,1980,1984,4,No,0,0.07,2.72,2.65,33,367,334,79,1367,1288,0.0,0.0,0.0,0.0,0.0,0.0
<a href=/player/pruit101>pruit101</a>,Tex Pruiett,Boston Red Sox,RSOX,1,1,1,2,1908,1908,0,No,0,0.0,-0.3,-0.3,0,2,2,0,0,0,0.0,2.0,2.0,0.0,0.0,0.0
<a href=/player/pruit101>pruit101</a>,Tex Pruiett,Cleveland Indians,INDINS,1,2,1,3,1908,1914,6,No,0,0.0,-1.58,-1.58,0,95,95,0,309,309,0.0,0.0,0.0,0.0,0.0,0.0
<a href=/player/pryog001>pryog001</a>,Greg Pryor,Texas Rangers,RNGRS,1,3,1,4,1977,1978,1,No,0,-0.74,-0.56,0.18,93,93,0,171,128,-43,0.0,0.0,0.0,0.0,0.0,0.0
<a href=/player/pryog001>pryog001</a>,Greg Pryor,Chicago White Sox,WSOX,1,1,1,2,1982,1982,0,No,0,-0.57,0.0,0.57,390,0,-390,821,0,-821,0.0,0.0,0.0,0.0,0.0,0.0
<a href=/player/pryos001>pryos001</a>,Stephen Pryor,Seattle Mariners,MARNRS,1,1,1,2,2014,2014,0,No,0,0.0,-0.22,-0.22,0,59,59,0,239,239,0.0,0.0,0.0,0.0,0.0,0.0
<a href=/player/puigy001>puigy001</a>,Yasiel Puig,Los Angeles Dodgers,DOGRS,3,12,8,20,2018,2021,3,Yes,0,5.8,8.33,2.53,663,133,-530,2223,501,-1722,299.0,229.0,-70.0,36964000.0,0.0,-36964000.0
<a href=/player/puigy001>puigy001</a>,Yasiel Puig,Cincinnati Reds,REDS,1,3,1,4,2019,2020,1,No,0,0.49,2.49,2.0,49,30,-19,207,16,-191,0.0,388.0,388.0,9700000.0,0.0,-9700000.0
<a href=/player/pujol001>pujol001</a>,Luis Pujols,Houston Astros,ASTROS,1,1,1,2,1984,1984,0,No,0,-0.04,0.0,0.04,4,0,-4,5,0,-5,0.0,0.0,0.0,0.0,0.0,0.0
<a href=/player/pulec001>pulec001</a>,Charlie Puleo,Toronto Blue Jays,BJAYS,1,2,1,3,1981,1981,0,No,0,0.67,1.04,0.37,80,21,-59,58,0,-58,553.0,271.0,-282.0,0.0,0.0,0.0
<a href=/player/pulec001>pulec001</a>,Charlie Puleo,New York Mets,METS,1,3,1,4,1982,1984,2,No,0,-1.57,2.55,4.12,181,68,-113,297,77,-220,497.0,693.0,196.0,0.0,0.0,0.0
<a href=/player/pulia001>pulia001</a>,Alfonso Pulido,Pittsburgh Pirates,PIRATS,1,3,3,6,1984,1986,2,No,0,0.69,0.08,-0.61,132,124,-8,338,327,-11,92.0,0.0,-92.0,0.0,0.0,0.0
<a href=/player/pullh001>pullh001</a>,Harvey Pulliam,Colorado Rockies,ROCKS,3,4,5,9,1997,2000,3,No,0,0.73,3.3,2.57,211,265,54,561,37,-524,40.0,364.0,324.0,4813333.0,0.0,-4813333.0
<a href=/player/pulsb001>pulsb001</a>,Bill Pulsipher,New York Mets,METS,2,5,2,7,1998,2000,2,No,0,28.2,0.13,-28.07,1389,89,-1300,5622,266,-5356,469.0,0.0,-469.0,210000.0,0.0,-210000.0
<a href=/player/pulsb001>pulsb001</a>,Bill Pulsipher,Milwaukee Brewers,BREWRS,1,1,1,2,2000,2002,2,No,0,-0.39,0.37,0.76,4,176,172,2,482,480,20.0,0.0,-20.0,0.0,0.0,0.0
<a href=/player/pulsb001>pulsb001</a>,Bill Pulsipher,New York Mets,METS,12,25,27,52,2000,2021,21,Yes,0,23.92,23.66,-0.26,974,1888,914,1624,4806,3182,6006.0,3554.0,-2452.0,30731467.0,0.0,-30731467.0
<a href=/player/puntn001>puntn001</a>,Nick Punto,Philadelphia Phillies,PHILS,1,3,1,4,2003,2004,1,No,0,19.34,1.44,-17.9,901,67,-834,2722,75,-2647,2374.0,603.0,-1771.0,610000.0,0.0,-610000.0
<a href=/player/puntn001>puntn001</a>,Nick Punto,Boston Red Sox,RSOX,7,22,14,36,2012,2019,7,Yes,0,37.54,19.18,-18.36,2738,1439,-1299,4768,4566,-202,4720.0,1908.0,-2812.0,4708000.0,0.0,-4708000.0
<a href=/player/purcd001>purcd001</a>,David Purcey,Toronto Blue Jays,BJAYS,1,1,1,2,2011,2012,1,No,0,0.31,-0.13,-0.44,9,3,-6,0,0,0,38.0,6.0,-32.0,436400.0,0.0,-436400.0
<a href=/player/purcd001>purcd001</a>,David Purcey,Oakland Athletics,ATLTCS,1,1,1,2,2011,2013,2,No,0,-0.41,1.13,1.54,21,95,74,0,361,361,56.0,0.0,-56.0,0.0,0.0,0.0
<a href=/player/purdj101>purdj101</a>,John Purdin,California Angels,ANGELS,1,1,1,2,1970,1970,0,No,0,0.0,0.0,0.0,0,0,0,0,0,0,0.0,0.0,0.0,0.0,0.0,0.0
<a href=/player/purkb101>purkb101</a>,Bob Purkey,Pittsburgh Pirates,PIRATS,1,1,1,2,1957,1957,0,No,0,22.16,0.0,-22.16,488,0,-488,594,0,-594,4764.0,0.0,-4764.0,0.0,0.0,0.0
<a href=/player/purkb101>purkb101</a>,Bob Purkey,Cincinnati Reds,REDS,1,1,2,3,1964,1966,2,No,0,-2.37,0.11,2.48,64,80,16,43,13,-30,373.0,193.0,-180.0,0.0,0.0,0.0
<a href=/player/purtb101>purtb101</a>,Billy Purtell,Chicago White Sox,WSOX,1,2,2,4,1910,1915,5,No,0,0.0,10.22,10.22,86,540,454,299,2308,2009,88.0,0.0,-88.0,0.0,0.0,0.0
<a href=/player/purtb101>purtb101</a>,Billy Purtell,Boston Red Sox,RSOX,9,25,23,48,1912,1935,23,No,0,51.77,27.05,-24.72,3792,3039,-753,15081,11185,-3896,0.0,1203.0,1203.0,45050.0,0.0,-45050.0
<a href=/player/putme101>putme101</a>,Ed Putman,Chicago Cubs,CUBS,1,1,1,2,1979,1981,2,No,0,0.0,0.12,0.12,21,242,221,43,584,541,0.0,0.0,0.0,0.0,0.0,0.0
<a href=/player/putme101>putme101</a>,Ed Putman,Detroit Tigers,TIGRS,1,2,3,5,1980,1980,0,No,0,0.0,0.0,0.0,0,0,0,0,0,0,0.0,0.0,0.0,0.0,0.0,0.0
<a href=/player/putnd001>putnd001</a>,Danny Putnam,Oakland Athletics,ATLTCS,1,1,1,2,2009,2009,0,No,0,0.0,-0.06,-0.06,0,1,1,0,0,0,0.0,15.0,15.0,0.0,0.0,0.0
<a href=/player/putnp001>putnp001</a>,Pat Putnam,Texas Rangers,RNGRS,1,1,1,2,1982,1984,2,No,0,-0.23,0.0,0.23,208,0,-208,686,0,-686,0.0,0.0,0.0,0.0,0.0,0.0
<a href=/player/putnp001>putnp001</a>,Pat Putnam,Seattle Mariners,MARNRS,1,1,1,2,1984,1984,0,No,0,-0.7,0.0,0.7,14,0,-14,43,0,-43,0.0,0.0,0.0,280000.0,0.0,-280000.0
<a href=/player/putnz001>putnz001</a>,Zach Putnam,Cleveland Indians,INDINS,1,1,2,3,2012,2012,0,No,0,0.09,0.0,-0.09,4,0,-4,0,0,0,6.0,0.0,-6.0,0.0,0.0,0.0
<a href=/player/putzj001>putzj001</a>,J.J. Putz,Seattle Mariners,MARNRS,8,16,16,32,2008,2015,7,No,0,0.83,32.43,31.6,1230,1763,533,2304,5784,3480,1045.0,2794.0,1749.0,18727500.0,0.0,-18727500.0
<a href=/player/pylee101>pylee101</a>,Ewald Pyle,St.Louis Browns,ORLS,1,1,2,3,1942,1942,0,No,0,-0.53,0.0,0.53,36,0,-36,22,0,-22,218.0,0.0,-218.0,0.0,0.0,0.0
<a href=/player/pylee101>pylee101</a>,Ewald Pyle,New York Giants,GIANTS,2,3,2,5,1945,1946,1,No,0,-0.4,0.68,1.08,74,93,19,237,277,40,41.0,0.0,-41.0,0.0,0.0,0.0
<a href=/player/pylee101>pylee101</a>,Ewald Pyle,Washington Senators,TWINS,1,1,1,2,1943,1943,0,No,0,0.0,-0.06,-0.06,0,13,13,0,15,15,0.0,97.0,97.0,0.0,0.0,0.0
<a href=/player/pylee101>pylee101</a>,Ewald Pyle,Boston Braves,BRAVES,1,2,1,3,1945,1945,0,No,0,0.0,-0.56,-0.56,0,74,74,0,19,19,0.0,220.0,220.0,0.0,0.0,0.0
<a href=/player/pytlf101>pytlf101</a>,Frankie Pytlak,Cleveland Indians,INDINS,2,4,5,9,1940,1945,5,No,0,20.77,6.72,-14.05,691,626,-65,1095,1460,365,4952.0,2948.0,-2004.0,22322.0,0.0,-22322.0
<a href=/player/pyznt001>pyznt001</a>,Tim Pyznarski,Oakland Athletics,ATLTCS,1,1,1,2,1985,1985,0,No,0,-0.05,0.0,0.05,15,0,-15,47,0,-47,0.0,0.0,0.0,0.0,0.0,0.0
<a href=/player/pyznt001>pyznt001</a>,Tim Pyznarski,San Diego Padres,PADRS,9,17,18,35,1986,1998,12,No,0,97.76,19.41,-78.35,6640,1856,-4784,25821,5410,-20411,1355.0,1888.0,533.0,9476667.0,0.0,-9476667.0
<a href=/player/pyznt001>pyznt001</a>,Tim Pyznarski,Milwaukee Brewers,BREWRS,1,1,2,3,1988,1988,0,No,0,0.0,0.0,0.0,0,0,0,0,0,0,0.0,0.0,0.0,0.0,0.0,0.0
<a href=/player/qualc001>qualc001</a>,Chad Qualls,Houston Astros,ASTROS,4,8,6,14,2007,2018,11,Yes,2,3.86,8.15,4.29,1017,824,-193,623,1881,1258,2956.0,649.0,-2307.0,856000.0,0.0,-856000.0
<a href=/player/qualc001>qualc001</a>,Chad Qualls,Arizona Diamondbacks,DBACKS,1,1,1,2,2010,2010,0,No,0,-0.67,0.0,0.67,27,0,-27,0,0,0,63.0,0.0,-63.0,4185000.0,0.0,-4185000.0
<a href=/player/qualc001>qualc001</a>,Chad Qualls,New York Yankees,YANKS,1,1,1,2,2012,2012,0,No,0,-0.3,-0.66,-0.36,34,22,-12,0,59,59,41.0,0.0,-41.0,0.0,0.0,0.0
<a href=/player/qualj101>qualj101</a>,Jim Qualls,Chicago Cubs,CUBS,2,2,2,4,1970,1971,1,No,0,-0.14,-0.04,0.1,176,74,-102,493,237,-256,0.0,0.0,0.0,0.0,0.0,0.0
<a href=/player/qualj101>qualj101</a>,Jim Qualls,Montreal Expos,NATEX,1,1,1,2,1971,1971,0,No,0,0.0,0.29,0.29,0,49,49,0,118,118,0.0,0.0,0.0,0.0,0.0,0.0
<a href=/player/qualj101>qualj101</a>,Jim Qualls,Cincinnati Reds,REDS,2,2,2,4,1971,1972,1,No,0,-0.21,0.0,0.21,11,0,-11,11,0,-11,0.0,0.0,0.0,0.0,0.0,0.0
<a href=/player/quanc001>quanc001</a>,Cal Quantrill,San Diego Padres,PADRS,2,7,4,11,2020,2021,1,Yes,0,3.34,0.62,-2.72,311,5,-306,892,4,-888,493.0,57.0,-436.0,3000000.0,0.0,-3000000.0
<a href=/player/quanp001>quanp001</a>,Paul Quantrill,Boston Red Sox,RSOX,2,3,3,6,1994,1995,1,No,0,-0.06,-1.0,-0.94,145,86,-59,216,248,32,628.0,0.0,-628.0,885000.0,0.0,-885000.0
<a href=/player/quanp001>quanp001</a>,Paul Quantrill,Philadelphia Phillies,PHILS,2,3,3,6,1995,2000,5,No,0,10.73,-2.09,-12.82,473,553,80,4,2028,2024,1674.0,75.0,-1599.0,526500.0,0.0,-526500.0
<a href=/player/quanp001>quanp001</a>,Paul Quantrill,Toronto Blue Jays,BJAYS,1,2,2,4,2001,2002,1,No,0,7.04,-0.73,-7.77,933,22,-911,2400,0,-2400,462.0,215.0,-247.0,1800000.0,0.0,-1800000.0
<a href=/player/quanp001>quanp001</a>,Paul Quantrill,New York Yankees,YANKS,1,1,3,4,2005,2005,0,No,0,0.3,-0.82,-1.12,44,3,-41,1,0,-1,95.0,24.0,-71.0,3000000.0,0.0,-3000000.0
<a href=/player/quelg101>quelg101</a>,George Quellich,New York Yankees,YANKS,2,5,3,8,1932,1940,8,No,0,1.79,6.34,4.55,337,462,125,641,986,345,1980.0,2260.0,280.0,0.0,0.0,0.0
<a href=/player/quenc001>quenc001</a>,Carlos Quentin,Arizona Diamondbacks,DBACKS,7,15,17,32,2007,2018,11,Yes,0,32.57,30.17,-2.4,1333,1190,-143,3297,2038,-1259,6760.0,6326.0,-434.0,15122000.0,0.0,-15122000.0
<a href=/player/quenc001>quenc001</a>,Carlos Quentin,Chicago White Sox,WSOX,2,3,3,6,2011,2013,2,No,0,8.07,0.05,-8.02,904,18,-886,3238,0,-3238,173.0,202.0,29.0,5530000.0,0.0,-5530000.0
<a href=/player/quenc001>quenc001</a>,Carlos Quentin,San Diego Padres,PADRS,6,17,12,29,2015,2021,6,Yes,0,17.57,11.2,-6.37,1317,971,-346,3711,2795,-916,1719.0,362.0,-1357.0,9570500.0,0.0,-9570500.0
<a href=/player/quevr001>quevr001</a>,Ruben Quevedo,Atlanta Braves,BRAVES,3,6,5,11,1999,2009,10,No,2,-4.19,8.84,13.03,73,1044,971,54,2148,2094,486.0,1194.0,708.0,0.0,0.0,0.0
<a href=/player/quevr001>quevr001</a>,Ruben Quevedo,Chicago Cubs,CUBS,2,3,4,7,2001,2001,0,No,2,-1.88,0.61,2.49,108,56,-52,117,0,-117,715.0,85.0,-630.0,0.0,0.0,0.0
<a href=/player/quice101>quice101</a>,Eddie Quick,New York Yankees,YANKS,1,2,1,3,1904,1910,6,No,0,0.0,5.04,5.04,0,522,522,0,1684,1684,0.0,0.0,0.0,0.0,0.0,0.0
<a href=/player/quinh001>quinh001</a>,Humberto Quintero,Chicago White Sox,WSOX,3,6,4,10,2002,2004,2,No,0,5.66,1.21,-4.45,316,141,-175,1204,435,-769,90.0,416.0,326.0,675000.0,0.0,-675000.0
<a href=/player/quinh001>quinh001</a>,Humberto Quintero,San Diego Padres,PADRS,2,4,3,7,2005,2005,0,No,0,0.13,-1.36,-1.49,347,62,-285,1035,10,-1025,24.0,184.0,160.0,3975000.0,0.0,-3975000.0
<a href=/player/quinh001>quinh001</a>,Humberto Quintero,Houston Astros,ASTROS,1,2,2,4,2012,2017,5,No,0,-0.3,0.42,0.72,73,60,-13,210,0,-210,0.0,165.0,165.0,0.0,0.0,0.0
<a href=/player/quinj001>quinj001</a>,Jose Quintana,Chicago White Sox,WSOX,1,1,4,5,2017,2017,0,Yes,0,3.51,0.0,-3.51,156,0,-156,150,0,-150,1319.0,0.0,-1319.0,0.0,0.0,0.0
<a href=/player/quinj102>quinj102</a>,Jack Quinn,New York Yankees,YANKS,1,2,1,3,1912,1912,0,No,0,0.0,-0.21,-0.21,0,41,41,0,175,175,0.0,0.0,0.0,0.0,0.0,0.0
<a href=/player/quinj102>quinj102</a>,Jack Quinn,New York Yankees,YANKS,4,11,7,18,1921,1946,25,No,0,28.58,81.31,52.73,995,2473,1478,1312,4729,3417,7730.0,15194.0,7464.0,42500.0,0.0,-42500.0
<a href=/player/quinj102>quinj102</a>,Jack Quinn,Vernon,Vernon,1,1,3,4,1918,1919,1,No,0,9.35,0.0,-9.35,224,0,-224,251,0,-251,1919.0,0.0,-1919.0,0.0,0.0,0.0
<a href=/player/quinj103>quinj103</a>,Joe Quinn,Boston Braves,BRAVES,1,1,1,2,1893,1894,1,No,0,-0.45,-0.24,0.21,549,120,-429,2339,531,-1808,0.0,0.0,0.0,0.0,0.0,0.0
<a href=/player/quinj103>quinj103</a>,Joe Quinn,Baltimore Orioles,BLN,1,2,2,4,1898,1903,5,No,0,2.47,4.06,1.59,268,251,-17,1122,1106,-16,0.0,0.0,0.0,0.0,0.0,0.0
<a href=/player/quinl001>quinl001</a>,Luis Quinones,Oakland Athletics,ATLTCS,1,1,1,2,1983,1985,2,No,0,0.0,1.58,1.58,0,63,63,0,162,162,0.0,0.0,0.0,0.0,0.0,0.0
<a href=/player/quinl001>quinl001</a>,Luis Quinones,Cleveland Indians,INDINS,3,4,4,8,1985,1991,6,No,0,-3.07,1.08,4.15,232,262,30,182,266,84,443.0,1475.0,1032.0,0.0,0.0,0.0
<a href=/player/quinl001>quinl001</a>,Luis Quinones,Oakland Athletics,ATLTCS,1,1,1,2,1987,1987,0,No,0,-0.28,-0.02,0.26,49,45,-4,111,128,17,0.0,0.0,0.0,0.0,0.0,0.0
<a href=/player/quinl001>quinl001</a>,Luis Quinones,Chicago Cubs,CUBS,1,1,1,2,1988,1988,0,No,0,1.81,-0.14,-1.95,300,14,-286,836,2,-834,0.0,37.0,37.0,0.0,0.0,0.0
<a href=/player/quino001>quino001</a>,Omar Quintanilla,Oakland Athletics,ATLTCS,1,2,2,4,2005,2007,2,No,0,0.29,2.31,2.02,231,152,-79,619,3,-616,0.0,786.0,786.0,2200000.0,0.0,-2200000.0
<a href=/player/quinr001>quinr001</a>,Rey Quinones,Seattle Mariners,MARNRS,1,2,3,5,1989,1989,0,No,0,-1.21,-0.79,0.42,71,15,-56,253,0,-253,0.0,256.0,256.0,215000.0,0.0,-215000.0
<a href=/player/quinr001>quinr001</a>,Rey Quinones,Boston Red Sox,RSOX,3,7,5,12,1986,1993,7,No,0,7.37,8.49,1.12,984,1130,146,3351,3154,-197,369.0,1455.0,1086.0,1275000.0,0.0,-1275000.0
<a href=/player/quint102>quint102</a>,Tad Quinn,Philadelphia Athletics,ATLTCS,1,2,1,3,1903,1903,0,No,0,0.0,0.0,0.0,0,0,0,0,0,0,0.0,0.0,0.0,0.0,0.0,0.0
<a href=/player/quira101>quira101</a>,Art Quirk,Baltimore Orioles,ORLS,1,3,2,5,1962,1967,5,No,0,0.29,3.01,2.72,74,349,275,211,975,764,63.0,22.0,-41.0,7000.0,0.0,-7000.0
<a href=/player/quirj001>quirj001</a>,Jamie Quirk,Kansas City Royals,ROYALS,4,7,5,12,1976,1997,21,No,1,3.48,61.02,57.54,709,1258,549,973,3160,2187,2893.0,7458.0,4565.0,1600000.0,0.0,-1600000.0
<a href=/player/quirj001>quirj001</a>,Jamie Quirk,Milwaukee Brewers,BREWRS,1,1,2,3,1978,1978,0,No,0,1.99,0.0,-1.99,504,0,-504,1348,0,-1348,0.0,0.0,0.0,0.0,0.0,0.0
<a href=/player/raabb001>raabb001</a>,Brian Raabe,Seattle Mariners,MARNRS,1,1,1,2,1997,1997,0,No,0,0.04,0.0,-0.04,2,0,-2,4,0,-4,0.0,0.0,0.0,160000.0,0.0,-160000.0
<a href=/player/rabbj001>rabbj001</a>,John Rabb,San Francisco Giants,GIANTS,3,3,3,6,1985,1990,5,No,1,1.65,5.38,3.73,164,579,415,391,2041,1650,0.0,0.0,0.0,462500.0,0.0,-462500.0
<a href=/player/rabbj101>rabbj101</a>,Joe Rabbitt,Chicago White Sox,WSOX,1,4,1,5,1924,1924,0,No,0,0.0,-0.04,-0.04,0,6,6,0,5,5,0.0,0.0,0.0,0.0,0.0,0.0
<a href=/player/rabec101>rabec101</a>,Charlie Rabe,Cincinnati Reds,REDS,1,4,1,5,1958,1960,2,No,0,0.85,9.64,8.79,265,190,-75,151,233,82,590.0,1314.0,724.0,14000.0,0.0,-14000.0
<a href=/player/rabem001>rabem001</a>,Mike Rabelo,Detroit Tigers,TIGRS,2,8,3,11,2007,2010,3,No,0,-0.1,-1.19,-1.09,705,27,-678,1077,3,-1074,1506.0,303.0,-1203.0,12380000.0,0.0,-12380000.0
<a href=/player/rabur001>rabur001</a>,Ryan Raburn,Chicago White Sox,WSOX,1,1,1,2,2017,2017,0,No,0,0.04,0.0,-0.04,25,0,-25,69,0,-69,0.0,0.0,0.0,0.0,0.0,0.0
<a href=/player/rackm101>rackm101</a>,Marv Rackley,Brooklyn Dodgers,DOGRS,1,1,2,3,1949,1952,3,No,0,0.16,-0.35,-0.51,11,8,-3,37,14,-23,0.0,0.0,0.0,0.0,0.0,0.0
<a href=/player/radad101>radad101</a>,Dick Radatz,Boston Red Sox,RSOX,2,3,3,6,1966,1970,4,No,0,3.1,6.39,3.29,238,631,393,23,758,735,592.0,2094.0,1502.0,0.0,0.0,0.0
<a href=/player/radad101>radad101</a>,Dick Radatz,Cleveland Indians,INDINS,2,4,3,7,1967,1968,1,No,0,0.01,0.99,0.98,356,130,-226,391,265,-126,1052.0,0.0,-1052.0,27000.0,0.0,-27000.0
<a href=/player/radcr101>radcr101</a>,Rip Radcliff,StPaul,StPaul,2,2,6,8,1933,1934,1,No,0,1.84,0.0,-1.84,131,0,-131,110,0,-110,910.0,0.0,-910.0,0.0,0.0,0.0
<a href=/player/radcr101>radcr101</a>,Rip Radcliff,Philadelphia Athletics,ATLTCS,1,2,1,3,1934,1934,0,No,0,0.0,0.0,0.0,0,0,0,0,0,0,0.0,0.0,0.0,0.0,0.0,0.0
<a href=/player/radcr101>radcr101</a>,Rip Radcliff,Chicago White Sox,WSOX,1,1,1,2,1939,1944,5,No,0,3.93,0.5,-3.43,169,234,65,717,833,116,0.0,0.0,0.0,10000.0,0.0,-10000.0
<a href=/player/radcr101>radcr101</a>,Rip Radcliff,Detroit Tigers,TIGRS,1,1,2,3,1943,1952,9,No,0,0.0,0.03,0.03,0,640,640,0,1953,1953,0.0,0.0,0.0,7000.0,0.0,-7000.0
<a href=/player/raded101>raded101</a>,Dave Rader,San Francisco Giants,GIANTS,3,6,6,12,1976,1979,3,No,1,0.11,-0.39,-0.5,172,638,466,406,1241,835,25.0,782.0,757.0,0.0,0.0,0.0
<a href=/player/raded101>raded101</a>,Dave Rader,St. Louis Cardinals,CARDS,18,38,36,74,1977,1998,21,No,7,91.47,158.37,66.9,7749,7153,-596,23063,25308,2245,8671.0,3716.0,-4955.0,3088333.0,0.0,-3088333.0
<a href=/player/raded101>raded101</a>,Dave Rader,Chicago Cubs,CUBS,9,17,19,36,1979,1990,11,No,0,20.77,12.9,-7.87,2689,1303,-1386,6948,2680,-4268,1072.0,3217.0,2145.0,890000.0,0.0,-890000.0
<a href=/player/raded101>raded101</a>,Dave Rader,Philadelphia Phillies,PHILS,1,1,2,3,1980,1980,0,No,0,1.12,0.0,-1.12,50,0,-50,152,0,-152,0.0,0.0,0.0,0.0,0.0,0.0
<a href=/player/raded103>raded103</a>,Doug Rader,Houston Astros,ASTROS,1,1,2,3,1975,1975,0,No,0,4.82,0.0,-4.82,191,0,-191,745,0,-745,0.0,0.0,0.0,0.0,0.0,0.0
<a href=/player/radfp101>radfp101</a>,Paul Radford,Cleveland Spiders,CL4,1,2,1,3,1891,1899,8,No,0,0.0,34.84,34.84,0,1004,1004,0,4749,4749,0.0,0.0,0.0,0.0,0.0,0.0
<a href=/player/radtj101>radtj101</a>,Jack Radtke,Brooklyn Dodgers,DOGRS,1,2,1,3,1937,1941,4,No,0,0.0,0.0,0.0,0,0,0,0,0,0,0.0,0.0,0.0,0.0,0.0,0.0
<a href=/player/raffk101>raffk101</a>,Ken Raffensberger,St. Louis Cardinals,CARDS,1,1,3,4,1939,1942,3,No,0,0.94,-0.63,-1.57,106,24,-82,37,76,39,395.0,0.0,-395.0,2400.0,0.0,-2400.0
<a href=/player/raffk101>raffk101</a>,Ken Raffensberger,Philadelphia Phillies,PHILS,1,2,1,3,1947,1949,2,No,0,23.82,-2.12,-25.94,519,88,-431,570,262,-308,4467.0,2.0,-4465.0,0.0,0.0,0.0
<a href=/player/raffk101>raffk101</a>,Ken Raffensberger,Chicago Cubs,CUBS,1,1,2,3,1943,1947,4,No,0,6.07,0.0,-6.07,185,0,-185,192,0,-192,1585.0,0.0,-1585.0,0.0,0.0,0.0
<a href=/player/raftt101>raftt101</a>,Tom Raftery,Pittsburgh Pirates,PIRATS,1,3,1,4,1910,1910,0,No,0,0.0,0.0,0.0,0,0,0,0,0,0,0.0,0.0,0.0,0.0,0.0,0.0
<a href=/player/ragap101>ragap101</a>,Pat Ragan,Boston Braves,BRAVES,1,1,1,2,1919,1919,0,No,0,0.42,0.58,0.16,14,60,46,8,168,160,68.0,0.0,-68.0,3000.0,0.0,-3000.0
<a href=/player/raglf101>raglf101</a>,Frank Ragland,Philadelphia Phillies,PHILS,1,3,1,4,1933,1934,1,No,0,0.0,-0.02,-0.02,0,6,6,0,21,21,0.0,0.0,0.0,0.0,0.0,0.0
<a href=/player/raglf101>raglf101</a>,Frank Ragland,Albany,Albany,1,1,2,3,1933,1934,1,No,0,-0.68,0.0,0.68,22,0,-22,11,0,-11,115.0,0.0,-115.0,0.0,0.0,0.0
<a href=/player/raglt101>raglt101</a>,Tom Ragland,Texas Rangers,RNGRS,2,3,2,5,1972,1974,2,No,0,-0.28,1.79,2.07,67,272,205,198,1149,951,0.0,0.0,0.0,9900.0,0.0,-9900.0
<a href=/player/rainc001>rainc001</a>,Chuck Rainey,Boston Red Sox,RSOX,1,1,1,2,1982,1983,1,No,0,0.09,-1.02,-1.11,102,22,-80,106,0,-106,838.0,203.0,-635.0,0.0,0.0,0.0
<a href=/player/rainc001>rainc001</a>,Chuck Rainey,Chicago Cubs,CUBS,2,3,2,5,1984,1988,4,No,0,-0.39,4.78,5.17,100,498,398,169,554,385,92.0,631.0,539.0,490000.0,0.0,-490000.0
<a href=/player/rainl101>rainl101</a>,Larry Raines,Cleveland Indians,INDINS,1,2,1,3,1958,1960,2,No,0,0.0,0.48,0.48,0,12,12,0,2,2,0.0,27.0,27.0,0.0,0.0,0.0
<a href=/player/raint001>raint001</a>,Tim Raines,Montreal Expos,NATEX,6,10,11,21,1990,2015,25,No,4,16.22,44.07,27.85,1031,2186,1155,3868,6692,2824,225.0,3662.0,3437.0,8925555.0,0.0,-8925555.0
<a href=/player/raint001>raint001</a>,Tim Raines,Chicago White Sox,WSOX,1,1,1,2,1995,1996,1,No,0,3.29,0.0,-3.29,242,0,-242,940,0,-940,0.0,0.0,0.0,3700000.0,0.0,-3700000.0
<a href=/player/raint003>raint003</a>,Tanner Rainey,Cincinnati Reds,REDS,4,7,5,12,2018,2021,3,Yes,0,1.73,2.06,0.33,296,86,-210,1,34,33,604.0,395.0,-209.0,10000000.0,0.0,-10000000.0
<a href=/player/rajsd101>rajsd101</a>,Dave Rajsich,New York Yankees,YANKS,25,56,45,101,1978,2001,23,No,2,104.42,67.09,-37.33,6884,4113,-2771,17114,10039,-7075,21429.0,9704.0,-11725.0,5628333.0,0.0,-5628333.0
<a href=/player/rajsd101>rajsd101</a>,Dave Rajsich,Texas Rangers,RNGRS,1,1,1,2,1981,1981,0,No,0,0.0,0.0,0.0,0,0,0,0,0,0,0.0,0.0,0.0,0.0,0.0,0.0
<a href=/player/rajsg001>rajsg001</a>,Gary Rajsich,Houston Astros,ASTROS,1,1,1,2,1981,1981,0,No,0,0.0,0.0,0.0,91,0,-91,222,0,-222,0.0,0.0,0.0,0.0,0.0,0.0
<a href=/player/rajsg001>rajsg001</a>,Gary Rajsich,St. Louis Cardinals,CARDS,3,6,5,11,1985,1998,13,No,4,10.04,29.74,19.7,1204,965,-239,3785,3877,92,620.0,0.0,-620.0,0.0,0.0,0.0
<a href=/player/rakoe101>rakoe101</a>,Ed Rakow,Los Angeles Dodgers,DOGRS,2,2,4,6,1961,1966,5,No,0,2.83,1.64,-1.19,280,130,-150,193,39,-154,1732.0,509.0,-1223.0,17000.0,0.0,-17000.0
<a href=/player/rakoe101>rakoe101</a>,Ed Rakow,Kansas City Athletics,ATLTCS,15,33,27,60,1963,1976,13,No,0,55.99,46.74,-9.25,6677,4175,-2502,14870,13661,-1209,10290.0,2197.0,-8093.0,387100.0,0.0,-387100.0
<a href=/player/rakoe101>rakoe101</a>,Ed Rakow,Boston Red Sox,RSOX,1,2,2,4,1966,1967,1,No,0,-0.2,0.0,0.2,68,0,-68,16,0,-16,197.0,0.0,-197.0,0.0,0.0,0.0
<a href=/player/raleb001>raleb001</a>,Brooks Raley,Cincinnati Reds,REDS,1,1,1,2,2020,2020,0,Yes,0,-0.16,0.0,0.16,79,0,-79,0,0,0,195.0,0.0,-195.0,0.0,0.0,0.0
<a href=/player/ralel001>ralel001</a>,Luke Raley,Los Angeles Dodgers,DOGRS,1,3,1,4,2018,2018,0,No,0,0.86,0.11,-0.75,69,47,-22,205,170,-35,209.0,0.0,-209.0,9000000.0,0.0,-9000000.0
<a href=/player/ralel001>ralel001</a>,Luke Raley,Minnesota Twins,TWINS,1,3,3,6,2020,2020,0,Yes,0,-0.29,1.55,1.84,124,11,-113,74,0,-74,170.0,200.0,30.0,0.0,0.0,0.0
<a href=/player/ramab101>ramab101</a>,Bob Ramazzotti,Brooklyn Dodgers,DOGRS,1,1,1,2,1949,1949,0,No,0,-1.16,0.0,1.16,275,0,-275,764,0,-764,0.0,0.0,0.0,0.0,0.0,0.0
<a href=/player/ramia001>ramia001</a>,Aramis Ramirez,Pittsburgh Pirates,PIRATS,2,4,4,8,2003,2005,2,No,0,25.85,-0.22,-26.07,1180,243,-937,4941,589,-4352,0.0,0.0,0.0,4351000.0,0.0,-4351000.0
<a href=/player/ramia001>ramia001</a>,Aramis Ramirez,Milwaukee Brewers,BREWRS,1,2,1,3,2015,2017,2,No,0,-0.29,0.3,0.59,56,10,-46,214,0,-214,0.0,20.0,20.0,0.0,0.0,0.0
<a href=/player/ramia002>ramia002</a>,Alex Ramirez,Cleveland Indians,INDINS,1,2,1,3,2000,2002,2,No,0,-2.57,-1.33,1.24,129,133,4,392,475,83,0.0,0.0,0.0,450000.0,0.0,-450000.0
<a href=/player/ramie001>ramie001</a>,Erasmo Ramirez,San Francisco Giants,GIANTS,1,3,1,4,2001,2001,0,No,0,1.58,0.17,-1.41,103,49,-54,31,174,143,323.0,0.0,-323.0,0.0,0.0,0.0
<a href=/player/ramie002>ramie002</a>,Elizardo Ramirez,Philadelphia Phillies,PHILS,2,5,5,10,2004,2009,5,No,0,6.82,2.03,-4.79,443,166,-277,1673,131,-1542,564.0,1155.0,591.0,16900000.0,0.0,-16900000.0
<a href=/player/ramie003>ramie003</a>,Edwar Ramirez,Texas Rangers,RNGRS,1,1,1,2,2010,2010,0,No,0,-0.13,0.0,0.13,7,0,-7,0,0,0,33.0,0.0,-33.0,0.0,0.0,0.0
<a href=/player/ramie004>ramie004</a>,Erasmo Ramirez,Seattle Mariners,MARNRS,3,4,4,8,2015,2020,5,No,0,5.78,2.81,-2.97,393,406,13,88,1271,1183,2344.0,455.0,-1889.0,0.0,0.0,0.0
<a href=/player/ramie004>ramie004</a>,Erasmo Ramirez,Tampa Bay Devil Rays,RAYS,1,1,2,3,2017,2017,0,No,0,0.29,1.07,0.78,24,28,4,6,0,-6,323.0,74.0,-249.0,3125000.0,0.0,-3125000.0
<a href=/player/ramih001>ramih001</a>,Hector Ramirez,New York Mets,METS,8,16,15,31,1997,2005,8,No,0,5.2,5.8,0.6,1347,2001,654,1609,3149,1540,2422.0,1675.0,-747.0,19588333.0,0.0,-19588333.0
<a href=/player/ramih002>ramih002</a>,Horacio Ramirez,Atlanta Braves,BRAVES,3,5,4,9,2006,2010,4,No,0,2.69,3.12,0.43,410,466,56,204,140,-64,1215.0,655.0,-560.0,8965000.0,0.0,-8965000.0
<a href=/player/ramih002>ramih002</a>,Horacio Ramirez,Kansas City Royals,ROYALS,1,1,1,2,2008,2018,10,No,0,-0.27,1.69,1.96,17,278,261,0,918,918,39.0,0.0,-39.0,0.0,0.0,0.0
<a href=/player/ramih003>ramih003</a>,Hanley Ramirez,Boston Red Sox,RSOX,14,38,25,63,2005,2019,14,Yes,0,93.01,61.11,-31.9,5581,3052,-2529,12204,8864,-3340,8381.0,6378.0,-2003.0,13099733.0,0.0,-13099733.0
<a href=/player/ramih003>ramih003</a>,Hanley Ramirez,Miami Marlins,MARLNS,3,6,9,15,2012,2019,7,Yes,0,16.03,11.46,-4.57,560,873,313,1297,2000,703,1929.0,1864.0,-65.0,9367000.0,0.0,-9367000.0
<a href=/player/ramih004>ramih004</a>,Harold Ramirez,Pittsburgh Pirates,PIRATS,1,3,1,4,2016,2017,1,No,0,1.56,-0.04,-1.6,169,12,-157,400,1,-399,396.0,34.0,-362.0,0.0,0.0,0.0
<a href=/player/ramij001>ramij001</a>,Julio Ramirez,Florida Marlins,MARLNS,1,1,1,2,2000,2001,1,No,0,-0.49,0.03,0.52,22,28,6,39,46,7,0.0,0.0,0.0,0.0,0.0,0.0
<a href=/player/ramij002>ramij002</a>,J.C. Ramirez,Seattle Mariners,MARNRS,6,11,9,20,2009,2014,5,No,0,2.34,8.64,6.3,470,811,341,626,2617,1991,956.0,1416.0,460.0,10564000.0,0.0,-10564000.0
<a href=/player/ramij004>ramij004</a>,Jose Ramirez,New York Yankees,YANKS,1,2,1,3,2015,2016,1,No,0,-0.41,-0.02,0.39,5,51,46,0,127,127,14.0,0.0,-14.0,0.0,0.0,0.0
<a href=/player/ramij004>ramij004</a>,Jose Ramirez,Seattle Mariners,MARNRS,1,1,1,2,2015,2017,2,No,0,0.33,0.0,-0.33,212,0,-212,0,0,0,303.0,0.0,-303.0,0.0,0.0,0.0
<a href=/player/ramim002>ramim002</a>,Manny Ramirez,Boston Red Sox,RSOX,4,7,6,13,2008,2020,12,Yes,2,4.59,12.23,7.64,255,548,293,894,858,-36,124.0,1387.0,1263.0,24042923.0,0.0,-24042923.0
<a href=/player/ramim003>ramim003</a>,Max Ramirez,Atlanta Braves,BRAVES,1,1,1,2,2006,2007,1,No,0,0.0,0.94,0.94,0,152,152,0,0,0,0.0,209.0,209.0,0.0,0.0,0.0
<a href=/player/ramim003>ramim003</a>,Max Ramirez,Cleveland Indians,INDINS,1,1,1,2,2007,2007,0,No,0,0.29,0.74,0.45,45,52,7,140,196,56,0.0,0.0,0.0,0.0,0.0,0.0
<a href=/player/ramim101>ramim101</a>,Milt Ramirez,St. Louis Cardinals,CARDS,3,4,4,8,1972,1975,3,No,0,-4.47,-0.62,3.85,305,37,-268,783,86,-697,0.0,0.0,0.0,0.0,0.0,0.0
<a href=/player/ramin001>ramin001</a>,Neil Ramirez,Texas Rangers,RNGRS,1,4,1,5,2013,2013,0,No,0,4.33,-0.09,-4.42,1129,13,-1116,283,0,-283,1426.0,253.0,-1173.0,0.0,0.0,0.0
<a href=/player/ramin002>ramin002</a>,Noe Ramirez,Anaheim Angels,ANGELS,1,2,1,3,2020,2021,1,No,0,0.0,2.81,2.81,0,81,81,0,0,0,0.0,210.0,210.0,900000.0,0.0,-900000.0
<a href=/player/ramir001>ramir001</a>,Rafael Ramirez,Atlanta Braves,BRAVES,1,2,2,4,1987,1987,0,No,0,-1.14,0.0,1.14,612,0,-612,2086,0,-2086,0.0,0.0,0.0,875000.0,0.0,-875000.0
<a href=/player/ramir003>ramir003</a>,Ramon Ramirez,New York Yankees,YANKS,2,3,2,5,2005,2006,1,No,0,2.28,1.29,-0.99,307,72,-235,33,112,79,681.0,426.0,-255.0,3600000.0,0.0,-3600000.0
<a href=/player/ramir003>ramir003</a>,Ramon Ramirez,Colorado Rockies,ROCKS,1,1,1,2,2008,2016,8,No,0,2.4,14.02,11.62,76,407,331,0,398,398,215.0,3424.0,3209.0,0.0,0.0,0.0
<a href=/player/ramir003>ramir003</a>,Ramon Ramirez,Kansas City Royals,ROYALS,1,1,1,2,2008,2009,1,No,0,2.03,1.4,-0.63,122,49,-73,1,215,214,336.0,0.0,-336.0,397000.0,0.0,-397000.0
<a href=/player/ramir003>ramir003</a>,Ramon Ramirez,Boston Red Sox,RSOX,2,2,2,4,2010,2011,1,No,0,1.23,0.0,-1.23,193,0,-193,1,0,-1,304.0,0.0,-304.0,1155000.0,0.0,-1155000.0
<a href=/player/ramir003>ramir003</a>,Ramon Ramirez,San Francisco Giants,GIANTS,1,2,1,3,2011,2016,5,No,0,1.51,6.46,4.95,247,583,336,434,2471,2037,191.0,0.0,-191.0,3850000.0,0.0,-3850000.0
<a href=/player/ramir005>ramir005</a>,Roel Ramirez,Tampa Bay Devil Rays,RAYS,2,5,5,10,2018,2020,2,Yes,0,6.49,6.47,-0.02,634,226,-408,1668,967,-701,343.0,0.0,-343.0,4100000.0,0.0,-4100000.0
<a href=/player/ramiy001>ramiy001</a>,Yefry Ramirez,Baltimore Orioles,ORLS,1,1,1,2,2019,2019,0,Yes,0,-0.36,0.0,0.36,18,0,-18,2,0,-2,42.0,0.0,-42.0,0.0,0.0,0.0
<a href=/player/ramoa001>ramoa001</a>,A.J. Ramos,Miami Marlins,MARLNS,1,1,2,3,2017,2019,2,Yes,0,-0.36,-0.15,0.21,96,15,-81,0,4,4,116.0,66.0,-50.0,6550000.0,0.0,-6550000.0
<a href=/player/ramoc001>ramoc001</a>,Cesar Ramos,San Diego Padres,PADRS,1,4,1,5,2010,2012,2,No,0,1.36,-1.01,-2.37,435,168,-267,53,716,663,1270.0,0.0,-1270.0,401300.0,0.0,-401300.0
<a href=/player/ramoc001>ramoc001</a>,Cesar Ramos,Tampa Bay Devil Rays,RAYS,1,1,1,2,2014,2014,0,Yes,0,0.96,0.0,-0.96,71,0,-71,0,0,0,157.0,0.0,-157.0,750000.0,0.0,-750000.0
<a href=/player/ramod001>ramod001</a>,Domingo Ramos,New York Yankees,YANKS,25,56,45,101,1978,2001,23,No,2,104.42,67.09,-37.33,6884,4113,-2771,17114,10039,-7075,21429.0,9704.0,-11725.0,5628333.0,0.0,-5628333.0
<a href=/player/ramok001>ramok001</a>,Ken Ramos,Cleveland Indians,INDINS,1,1,1,2,1994,1994,0,No,0,0.0,-0.27,-0.27,0,4,4,0,13,13,0.0,0.0,0.0,0.0,0.0,0.0
<a href=/player/ramom001>ramom001</a>,Mario Ramos,Oakland Athletics,ATLTCS,7,12,11,23,2002,2009,7,No,0,21.2,14.17,-7.03,1375,998,-377,3394,3388,-6,5508.0,716.0,-4792.0,947000.0,0.0,-947000.0
<a href=/player/ramop101>ramop101</a>,Pedro Ramos,Minnesota Twins,TWINS,3,5,6,11,1962,1968,6,No,0,1.21,5.47,4.26,545,948,403,745,2451,1706,1800.0,1931.0,131.0,15000.0,0.0,-15000.0
<a href=/player/ramop101>ramop101</a>,Pedro Ramos,Cleveland Indians,INDINS,5,6,10,16,1964,1969,5,No,0,2.58,4.48,1.9,776,338,-438,117,156,39,2188.0,1590.0,-598.0,97100.0,0.0,-97100.0
<a href=/player/ramop101>ramop101</a>,Pedro Ramos,New York Yankees,YANKS,1,1,2,3,1966,1966,0,No,0,-0.25,0.0,0.25,12,0,-12,1,0,-1,24.0,0.0,-24.0,25000.0,0.0,-25000.0
<a href=/player/ramor001>ramor001</a>,Bobby Ramos,Montreal Expos,NATEX,1,1,1,2,1982,1982,0,No,0,-0.07,-0.12,-0.05,4,5,1,11,7,-4,0.0,0.0,0.0,0.0,0.0,0.0
<a href=/player/ramow001>ramow001</a>,Wilson Ramos,Minnesota Twins,TWINS,1,2,1,3,2010,2012,2,No,0,10.47,1.92,-8.55,578,130,-448,2276,0,-2276,0.0,366.0,366.0,0.0,0.0,0.0
<a href=/player/ramow001>ramow001</a>,Wilson Ramos,Tampa Bay Devil Rays,RAYS,1,1,1,2,2018,2018,0,No,0,0.79,0.0,-0.79,33,0,-33,101,0,-101,0.0,0.0,0.0,8500000.0,0.0,-8500000.0
<a href=/player/ramsb101>ramsb101</a>,Bill Ramsey,Boston Braves,BRAVES,6,10,11,21,1946,1966,20,No,0,4.65,47.8,43.15,447,2538,2091,1596,8887,7291,15.0,0.0,-15.0,0.0,0.0,0.0
<a href=/player/ramsm001>ramsm001</a>,Mike Ramsey,St. Louis Cardinals,CARDS,2,2,4,6,1984,1984,0,No,0,-0.12,0.34,0.46,49,38,-11,107,129,22,0.0,0.0,0.0,0.0,0.0,0.0
<a href=/player/ramsm002>ramsm002</a>,Mike Ramsey,Cincinnati Reds,REDS,2,4,3,7,1982,1990,8,No,0,5.51,11.79,6.28,594,719,125,2160,312,-1848,241.0,3379.0,3138.0,580000.0,0.0,-580000.0
<a href=/player/ramsm003>ramsm003</a>,Matt Ramsey,Tampa Bay Devil Rays,RAYS,1,1,1,2,2014,2014,0,No,0,0.0,0.0,0.0,0,0,0,0,0,0,0.0,0.0,0.0,0.0,0.0,0.0
<a href=/player/ramsr001>ramsr001</a>,Robert Ramsay,Boston Red Sox,RSOX,1,1,1,2,1999,1999,0,No,0,0.77,-0.18,-0.95,44,45,1,0,131,131,206.0,0.0,-206.0,0.0,0.0,0.0
<a href=/player/ramst101>ramst101</a>,Toad Ramsey,Chattanooga,Chattanooga,1,1,2,3,1885,1885,0,No,0,0.0,0.0,0.0,0,0,0,0,0,0,0.0,0.0,0.0,0.0,0.0,0.0
<a href=/player/ramst101>ramst101</a>,Toad Ramsey,Louisville Colonels,LS2,1,1,1,2,1889,1889,0,No,0,4.44,0.0,-4.44,98,0,-98,171,0,-171,1169.0,0.0,-1169.0,0.0,0.0,0.0
<a href=/player/ramsw101>ramsw101</a>,Willie Ramsdell,Cincinnati Reds,REDS,3,5,3,8,1952,1961,9,No,0,2.75,13.56,10.81,226,1292,1066,624,5151,4527,302.0,373.0,71.0,11000.0,0.0,-11000.0
<a href=/player/ranaa001>ranaa001</a>,Anthony Ranaudo,Boston Red Sox,RSOX,1,1,1,2,2015,2017,2,No,0,-0.8,1.35,2.15,7,126,119,2,0,-2,57.0,375.0,318.0,0.0,0.0,0.0
<a href=/player/ranaa001>ranaa001</a>,Anthony Ranaudo,Texas Rangers,RNGRS,1,1,1,2,2016,2016,0,Yes,0,-0.57,0.0,0.57,9,0,-9,3,0,-3,83.0,0.0,-83.0,0.0,0.0,0.0
<a href=/player/randb101>randb101</a>,Bob Randall,Los Angeles Dodgers,DOGRS,2,2,3,5,1975,1978,3,No,0,3.43,0.0,-3.43,473,18,-455,1512,17,-1495,0.0,0.0,0.0,0.0,0.0,0.0
<a href=/player/randd101>randd101</a>,Dick Rand,St. Louis Cardinals,CARDS,1,2,1,3,1956,1956,0,No,0,-0.23,0.0,0.23,60,0,-60,122,0,-122,0.0,0.0,0.0,0.0,0.0,0.0
<a href=/player/randd101>randd101</a>,Dick Rand,Pittsburgh Pirates,PIRATS,3,3,4,7,1959,1962,3,No,0,-0.33,0.65,0.98,123,67,-56,369,216,-153,0.0,0.0,0.0,0.0,0.0,0.0
<a href=/player/randj002>randj002</a>,Joe Randa,Kansas City Royals,ROYALS,2,5,4,9,1996,2005,9,No,2,2.49,4.96,2.47,410,202,-208,728,666,-62,275.0,712.0,437.0,120000.0,0.0,-120000.0
<a href=/player/randj002>randj002</a>,Joe Randa,Arizona Diamondbacks,DBACKS,2,6,2,8,1997,2003,6,No,0,6.66,8.29,1.63,875,595,-280,3219,2462,-757,172.0,0.0,-172.0,0.0,0.0,0.0
<a href=/player/randj002>randj002</a>,Joe Randa,Detroit Tigers,TIGRS,1,1,1,2,1998,2000,2,No,0,0.0,0.18,0.18,0,94,94,0,4,4,0.0,872.0,872.0,375000.0,0.0,-375000.0
<a href=/player/randj002>randj002</a>,Joe Randa,New York Mets,METS,1,1,1,2,1998,1998,0,No,0,14.18,0.0,-14.18,875,0,-875,3712,0,-3712,0.0,0.0,0.0,0.0,0.0,0.0
<a href=/player/randj002>randj002</a>,Joe Randa,Cincinnati Reds,REDS,3,3,5,8,2005,2007,2,No,0,0.32,0.28,-0.04,61,118,57,241,3,-238,15.0,154.0,139.0,2150000.0,0.0,-2150000.0
<a href=/player/randl101>randl101</a>,Lenny Randle,Texas Rangers,RNGRS,1,1,2,3,1977,1977,0,No,0,5.03,0.0,-5.03,268,0,-268,1093,0,-1093,0.0,0.0,0.0,0.0,0.0,0.0
<a href=/player/randl101>randl101</a>,Lenny Randle,San Francisco Giants,GIANTS,13,25,28,53,1979,1998,19,No,2,47.4,67.93,20.53,2735,4727,1992,5444,6225,781,5201.0,15628.0,10427.0,10639278.0,0.0,-10639278.0
<a href=/player/randn101>randn101</a>,Newt Randall,Chicago Cubs,CUBS,1,2,1,3,1907,1907,0,No,0,11.38,-0.4,-11.78,977,51,-926,4014,159,-3855,0.0,0.0,0.0,0.0,0.0,0.0
<a href=/player/rands002>rands002</a>,Scott Randall,Colorado Rockies,ROCKS,1,1,1,2,1999,2000,1,No,0,0.0,0.0,0.0,0,0,0,0,0,0,0.0,0.0,0.0,0.0,0.0,0.0
<a href=/player/rands002>rands002</a>,Scott Randall,Montreal Expos,NATEX,1,1,1,2,2004,2005,1,No,0,0.0,0.32,0.32,0,11,11,0,17,17,0.0,0.0,0.0,0.0,0.0,0.0
<a href=/player/randw001>randw001</a>,Willie Randolph,Pittsburgh Pirates,PIRATS,6,13,12,25,1975,1988,13,No,0,109.3,32.91,-76.39,4660,1733,-2927,17124,6632,-10492,6130.0,687.0,-5443.0,807000.0,0.0,-807000.0
<a href=/player/randw001>randw001</a>,Willie Randolph,Los Angeles Dodgers,DOGRS,2,2,3,5,1990,1992,2,No,0,3.97,3.33,-0.64,167,281,114,646,584,-62,0.0,0.0,0.0,1590000.0,0.0,-1590000.0
<a href=/player/ranem101>ranem101</a>,Merritt Ranew,Houston Astros,ASTROS,3,7,4,11,1963,1965,2,No,0,1.38,1.37,-0.01,248,133,-115,214,502,288,382.0,0.0,-382.0,0.0,0.0,0.0
<a href=/player/ranem101>ranem101</a>,Merritt Ranew,Chicago Cubs,CUBS,4,6,7,13,1964,1968,4,No,0,-0.05,-1.91,-1.86,253,450,197,665,786,121,220.0,627.0,407.0,0.0,0.0,0.0
<a href=/player/ranem101>ranem101</a>,Merritt Ranew,Milwaukee Brewers,BREWRS,2,4,3,7,1969,1971,2,No,0,1.89,-2.52,-4.41,337,186,-151,1153,421,-732,0.0,0.0,0.0,12000.0,0.0,-12000.0
<a href=/player/rapac001>rapac001</a>,Clay Rapada,Chicago Cubs,CUBS,1,1,2,3,2007,2007,0,No,0,0.16,-0.36,-0.52,33,23,-10,0,55,55,81.0,0.0,-81.0,0.0,0.0,0.0
<a href=/player/rappe101>rappe101</a>,Earl Rapp,Detroit Tigers,TIGRS,2,2,2,4,1949,1953,4,No,0,-0.13,-0.55,-0.42,21,416,395,60,1501,1441,0.0,0.0,0.0,0.0,0.0,0.0
<a href=/player/rappe101>rappe101</a>,Earl Rapp,Chicago White Sox,WSOX,1,2,1,3,1949,1950,1,No,0,0.0,-0.16,-0.16,0,93,93,0,381,381,0.0,0.0,0.0,0.0,0.0,0.0
<a href=/player/rappe101>rappe101</a>,Earl Rapp,Oakland,Oakland,1,1,2,3,1951,1951,0,No,0,0.0,0.0,0.0,13,0,-13,13,0,-13,0.0,0.0,0.0,0.0,0.0,0.0
<a href=/player/rappe101>rappe101</a>,Earl Rapp,St.Louis Browns,ORLS,2,2,3,5,1952,1953,1,No,0,1.26,0.88,-0.38,175,96,-79,294,287,-7,0.0,0.0,0.0,0.0,0.0,0.0
<a href=/player/rappg101>rappg101</a>,Goldie Rapp,New York Giants,GIANTS,3,7,5,12,1921,1927,6,No,0,10.96,8.57,-2.39,1223,793,-430,4975,2790,-2185,0.0,87.0,87.0,29500.0,0.0,-29500.0
<a href=/player/rappg101>rappg101</a>,Goldie Rapp,StPaul,StPaul,1,1,1,2,1921,1921,0,No,0,-0.7,0.0,0.7,58,0,-58,203,0,-203,0.0,0.0,0.0,0.0,0.0,0.0
<a href=/player/rappp001>rappp001</a>,Pat Rapp,Florida Marlins,MARLNS,1,1,2,3,1997,1997,0,No,0,-0.56,0.0,0.56,16,0,-16,12,0,-12,99.0,0.0,-99.0,1125000.0,0.0,-1125000.0
<a href=/player/rarib101>rarib101</a>,Bill Rariden,New York Giants,GIANTS,1,2,1,3,1919,1919,0,No,0,0.24,1.26,1.02,178,110,-68,609,443,-166,0.0,0.0,0.0,0.0,0.0,0.0
<a href=/player/rasmc001>rasmc001</a>,Colby Rasmus,St. Louis Cardinals,CARDS,5,8,8,16,2011,2019,8,Yes,2,7.33,0.78,-6.55,586,381,-205,1627,154,-1473,283.0,547.0,264.0,3193000.0,0.0,-3193000.0
<a href=/player/rasmc002>rasmc002</a>,Cory Rasmus,Atlanta Braves,BRAVES,1,1,1,2,2013,2013,0,No,0,0.69,0.07,-0.62,89,50,-39,1,0,-1,349.0,42.0,-307.0,0.0,0.0,0.0
<a href=/player/rasmd001>rasmd001</a>,Dennis Rasmussen,California Angels,ANGELS,1,1,1,2,1982,1985,3,No,0,5.62,3.76,-1.86,103,85,-18,0,0,0,1792.0,1468.0,-324.0,0.0,0.0,0.0
<a href=/player/rasmd001>rasmd001</a>,Dennis Rasmussen,New York Yankees,YANKS,1,3,1,4,1983,1985,2,No,0,4.84,1.45,-3.39,236,20,-216,270,0,-270,2040.0,301.0,-1739.0,0.0,0.0,0.0
<a href=/player/rasmd001>rasmd001</a>,Dennis Rasmussen,San Diego Padres,PADRS,1,2,1,3,1984,1986,2,No,0,5.62,5.89,0.27,103,387,284,0,1380,1380,1792.0,0.0,-1792.0,0.0,0.0,0.0
<a href=/player/rasmd001>rasmd001</a>,Dennis Rasmussen,New York Yankees,YANKS,1,1,1,2,1987,1987,0,No,0,-0.19,0.18,0.37,36,8,-28,38,0,-38,305.0,144.0,-161.0,175000.0,0.0,-175000.0
<a href=/player/rasmd001>rasmd001</a>,Dennis Rasmussen,Cincinnati Reds,REDS,1,1,1,2,1988,1988,0,No,0,4.68,-0.02,-4.7,220,2,-218,252,1,-251,1999.0,12.0,-1987.0,457500.0,0.0,-457500.0
<a href=/player/rasmd002>rasmd002</a>,Drew Rasmussen,Milwaukee Brewers,BREWRS,2,4,3,7,2021,2021,0,Yes,0,2.75,4.04,1.29,94,185,91,3,588,585,385.0,59.0,-326.0,0.0,0.0,0.0
<a href=/player/rasme101>rasme101</a>,Eric Rasmussen,St. Louis Cardinals,CARDS,3,4,4,8,1978,1992,14,No,0,1.63,36.02,34.39,324,1646,1322,421,6032,5611,1443.0,2206.0,763.0,1100000.0,0.0,-1100000.0
<a href=/player/rasmr001>rasmr001</a>,Rob Rasmussen,Miami Marlins,MARLNS,1,2,1,3,2012,2012,0,No,0,1.76,-0.39,-2.15,340,81,-259,1309,338,-971,0.0,0.0,0.0,0.0,0.0,0.0
<a href=/player/rasmr001>rasmr001</a>,Rob Rasmussen,Houston Astros,ASTROS,1,1,1,2,2012,2013,1,No,0,0.0,0.0,0.0,0,0,0,0,0,0,0.0,0.0,0.0,0.0,0.0,0.0
<a href=/player/rasmr001>rasmr001</a>,Rob Rasmussen,Los Angeles Dodgers,DOGRS,1,1,2,3,2013,2013,0,No,0,0.0,-0.1,-0.1,0,21,21,0,53,53,0.0,0.0,0.0,0.0,0.0,0.0
<a href=/player/rasmr001>rasmr001</a>,Rob Rasmussen,Philadelphia Phillies,PHILS,1,2,1,3,2013,2014,1,No,0,0.38,-0.1,-0.48,46,4,-42,84,0,-84,37.0,7.0,-30.0,496000.0,0.0,-496000.0
<a href=/player/rasmr001>rasmr001</a>,Rob Rasmussen,Toronto Blue Jays,BJAYS,1,3,1,4,2015,2015,0,No,0,-1.1,0.06,1.16,24,25,1,0,0,0,43.0,57.0,14.0,0.0,0.0,0.0
<a href=/player/rathf101>rathf101</a>,Fred Rath,Chicago White Sox,WSOX,1,1,1,2,1970,1970,0,No,0,0.0,0.0,0.0,0,0,0,0,0,0,0.0,0.0,0.0,0.0,0.0,0.0
<a href=/player/rathm101>rathm101</a>,Morrie Rath,Philadelphia Athletics,ATLTCS,3,7,4,11,1910,1916,6,No,0,36.05,17.77,-18.28,769,1148,379,3166,4931,1765,0.0,0.0,0.0,0.0,0.0,0.0
<a href=/player/rathm101>rathm101</a>,Morrie Rath,Cincinnati Reds,REDS,1,3,1,4,1921,1926,5,No,0,0.0,8.24,8.24,0,602,602,0,2409,2409,0.0,0.0,0.0,0.0,0.0,0.0
<a href=/player/ratlg101>ratlg101</a>,Gene Ratliff,Houston Astros,ASTROS,1,3,3,6,1966,1968,2,No,0,0.0,-0.84,-0.84,0,120,120,0,7,7,0.0,229.0,229.0,0.0,0.0,0.0
<a href=/player/ratlj001>ratlj001</a>,Jon Ratliff,Chicago Cubs,CUBS,2,2,2,4,1998,2000,2,No,0,3.16,-0.18,-3.34,406,19,-387,2,1,-1,464.0,32.0,-432.0,0.0,0.0,0.0
<a href=/player/ratlp101>ratlp101</a>,Paul Ratliff,Minnesota Twins,TWINS,1,1,1,2,1971,1976,5,No,0,-0.46,2.17,2.63,45,264,219,92,684,592,0.0,0.0,0.0,14000.0,0.0,-14000.0
<a href=/player/ratlp101>ratlp101</a>,Paul Ratliff,Milwaukee Brewers,BREWRS,1,2,2,4,1972,1972,0,No,0,0.0,-0.49,-0.49,0,42,42,0,79,79,0.0,0.0,0.0,14000.0,0.0,-14000.0
<a href=/player/ratzs101>ratzs101</a>,Steve Ratzer,Montreal Expos,NATEX,1,2,1,3,1981,1982,1,No,0,0.0,-0.53,-0.53,0,48,48,0,98,98,0.0,0.0,0.0,0.0,0.0,0.0
<a href=/player/raubt101>raubt101</a>,Tommy Raub,Chicago Cubs,CUBS,2,9,2,11,1903,1913,10,No,0,5.14,24.13,18.99,814,1109,295,3290,4566,1276,0.0,1329.0,1329.0,0.0,0.0,0.0
<a href=/player/raucb101>raucb101</a>,Bob Rauch,New York Mets,METS,1,2,1,3,1972,1972,0,No,0,0.32,0.0,-0.32,27,0,-27,0,0,0,369.0,0.0,-369.0,6000.0,0.0,-6000.0
<a href=/player/raucj001>raucj001</a>,Jon Rauch,Chicago White Sox,WSOX,1,2,1,3,2004,2005,1,No,0,7.36,0.15,-7.21,749,178,-571,35,716,681,1328.0,0.0,-1328.0,0.0,0.0,0.0
<a href=/player/raucj001>raucj001</a>,Jon Rauch,Washington Nationals,NATEX,4,6,6,12,2008,2013,5,Yes,0,5.52,4.37,-1.15,727,597,-130,2188,1224,-964,245.0,770.0,525.0,6301000.0,0.0,-6301000.0
<a href=/player/raucj001>raucj001</a>,Jon Rauch,Arizona Diamondbacks,DBACKS,1,1,1,2,2009,2012,3,No,0,1.94,-0.41,-2.35,78,16,-62,1,7,6,220.0,78.0,-142.0,2525000.0,0.0,-2525000.0
<a href=/player/raudb101>raudb101</a>,Bob Raudman,Chicago Cubs,CUBS,1,2,1,3,1967,1968,1,No,0,0.0,-1.37,-1.37,0,40,40,0,4,4,0.0,70.0,70.0,0.0,0.0,0.0
<a href=/player/raudb101>raudb101</a>,Bob Raudman,Cleveland Indians,INDINS,1,3,1,4,1967,1968,1,No,0,1.38,0.99,-0.39,316,130,-186,387,265,-122,982.0,0.0,-982.0,27000.0,0.0,-27000.0
<a href=/player/rautl101>rautl101</a>,Lance Rautzhan,Milwaukee Brewers,BREWRS,1,1,1,2,1979,1979,0,No,0,0.0,0.0,0.0,0,0,0,0,0,0,0.0,0.0,0.0,0.0,0.0,0.0
<a href=/player/raver001>raver001</a>,Rangel Ravelo,Chicago White Sox,WSOX,1,4,2,6,2014,2018,4,No,0,32.02,0.52,-31.5,1179,80,-1099,4237,2,-4235,1580.0,819.0,-761.0,500000.0,0.0,-500000.0
<a href=/player/rawlj101>rawlj101</a>,Johnny Rawlings,Philadelphia Phillies,PHILS,2,4,4,8,1921,1923,2,No,0,7.05,-3.87,-10.92,351,317,-34,1240,1284,44,0.0,0.0,0.0,5000.0,0.0,-5000.0
<a href=/player/rawlj101>rawlj101</a>,Johnny Rawlings,Philadelphia Phillies,PHILS,2,3,5,8,1923,1925,2,No,0,15.64,3.41,-12.23,721,322,-399,1877,1147,-730,3746.0,484.0,-3262.0,5500.0,0.0,-5500.0
<a href=/player/rawlj101>rawlj101</a>,Johnny Rawlings,Cincinnati Reds,REDS,3,6,6,12,1914,1930,16,No,0,6.12,48.22,42.1,494,2027,1533,2101,8451,6350,0.0,27.0,27.0,0.0,0.0,0.0
<a href=/player/rawls001>rawls001</a>,Shane Rawley,Montreal Expos,NATEX,1,2,1,3,1977,1978,1,No,0,0.21,-0.44,-0.65,10,62,52,0,27,27,25.0,305.0,280.0,0.0,0.0,0.0
<a href=/player/rawls001>rawls001</a>,Shane Rawley,Cincinnati Reds,REDS,2,2,2,4,1977,1981,4,No,1,4.9,6.49,1.59,208,463,255,0,1574,1574,1133.0,0.0,-1133.0,0.0,0.0,0.0
<a href=/player/rawls001>rawls001</a>,Shane Rawley,Seattle Mariners,MARNRS,3,5,6,11,1982,1987,5,No,0,10.18,6.88,-3.3,334,673,339,2,1334,1332,2811.0,1641.0,-1170.0,0.0,0.0,0.0
<a href=/player/rawls001>rawls001</a>,Shane Rawley,New York Yankees,YANKS,2,3,3,6,1984,1987,3,No,0,9.85,0.11,-9.74,347,84,-263,467,188,-279,2713.0,241.0,-2472.0,62500.0,0.0,-62500.0
<a href=/player/rawls001>rawls001</a>,Shane Rawley,Philadelphia Phillies,PHILS,2,3,5,8,1988,1990,2,No,0,0.05,2.78,2.73,124,304,180,306,1185,879,435.0,0.0,-435.0,1725000.0,0.0,-1725000.0
<a href=/player/ray-c001>ray-c001</a>,Chris Ray,Baltimore Orioles,ORLS,1,2,2,4,2009,2010,1,No,0,0.65,0.2,-0.45,41,33,-8,0,5,5,95.0,572.0,477.0,850000.0,0.0,-850000.0
<a href=/player/ray-c001>ray-c001</a>,Chris Ray,Texas Rangers,RNGRS,1,2,1,3,2010,2010,0,No,0,0.12,-0.8,-0.92,56,57,1,0,195,195,72.0,0.0,-72.0,975000.0,0.0,-975000.0
<a href=/player/ray-j001>ray-j001</a>,Johnny Ray,Houston Astros,ASTROS,2,4,2,6,1981,1987,6,No,0,18.26,12.31,-5.95,1057,753,-304,4016,2821,-1195,147.0,0.0,-147.0,450000.0,0.0,-450000.0
<a href=/player/ray-j001>ray-j001</a>,Johnny Ray,Pittsburgh Pirates,PIRATS,2,2,3,5,1987,1988,1,No,0,4.86,0.02,-4.84,422,2,-420,1802,0,-1802,0.0,2.0,2.0,807000.0,0.0,-807000.0
<a href=/player/ray-j101>ray-j101</a>,Jim Ray,Houston Astros,ASTROS,1,2,2,4,1973,1975,2,No,0,0.24,-0.75,-0.99,348,138,-210,1336,4,-1332,157.0,233.0,76.0,66000.0,0.0,-66000.0
<a href=/player/ray-k001>ray-k001</a>,Ken Ray,Kansas City Royals,ROYALS,1,1,1,2,2000,2000,0,No,0,0.0,-0.22,-0.22,0,53,53,0,0,0,0.0,225.0,225.0,0.0,0.0,0.0
<a href=/player/ray-r002>ray-r002</a>,Robbie Ray,Washington Nationals,NATEX,1,3,1,4,2013,2015,2,No,0,-1.71,4.39,6.1,114,103,-11,3,101,98,324.0,801.0,477.0,501250.0,0.0,-501250.0
<a href=/player/ray-r002>ray-r002</a>,Robbie Ray,Detroit Tigers,TIGRS,2,3,3,6,2014,2021,7,Yes,0,9.39,0.09,-9.3,428,326,-102,315,226,-89,2587.0,942.0,-1645.0,4000000.0,0.0,-4000000.0
<a href=/player/ray-r002>ray-r002</a>,Robbie Ray,Arizona Diamondbacks,DBACKS,1,2,1,3,2020,2021,1,No,0,6.89,0.07,-6.82,39,7,-32,5,0,-5,642.0,20.0,-622.0,9430000.0,0.0,-9430000.0
<a href=/player/raydc101>raydc101</a>,Curt Raydon,Milwaukee Braves,BRAVES,2,10,2,12,1953,1960,7,No,0,8.19,12.74,4.55,794,729,-65,1824,3040,1216,2135.0,0.0,-2135.0,0.0,0.0,0.0
<a href=/player/rayff001>rayff001</a>,Floyd Rayford,California Angels,ANGELS,1,2,1,3,1979,1982,3,No,0,1.32,0.49,-0.83,334,214,-120,998,642,-356,0.0,0.0,0.0,0.0,0.0,0.0
<a href=/player/rayff001>rayff001</a>,Floyd Rayford,Baltimore Orioles,ORLS,2,2,2,4,1983,1984,1,No,0,0.74,0.26,-0.48,372,26,-346,772,44,-728,0.0,0.0,0.0,0.0,0.0,0.0
<a href=/player/raymb101>raymb101</a>,Bugs Raymond,St. Louis Cardinals,CARDS,1,3,1,4,1908,1912,4,No,0,13.84,10.02,-3.82,1179,290,-889,3934,993,-2941,1350.0,10.0,-1340.0,0.0,0.0,0.0
<a href=/player/raymc101>raymc101</a>,Claude Raymond,Houston Astros,ASTROS,1,2,2,4,1967,1972,5,No,0,0.31,-3.37,-3.68,194,234,40,17,135,118,428.0,1228.0,800.0,0.0,0.0,0.0
<a href=/player/razib101>razib101</a>,Barry Raziano,New York Mets,METS,2,2,2,4,1973,1976,3,No,0,-0.04,0.95,0.99,6,28,22,0,3,3,28.0,82.0,54.0,0.0,0.0,0.0
<a href=/player/razib101>razib101</a>,Barry Raziano,Kansas City Royals,ROYALS,1,2,1,3,1974,1975,1,No,0,-0.65,0.06,0.71,13,218,205,0,772,772,50.0,0.0,-50.0,0.0,0.0,0.0
<a href=/player/rea-c001>rea-c001</a>,Colin Rea,San Diego Padres,PADRS,4,12,9,21,2016,2021,5,Yes,0,1.39,-0.63,-2.02,553,209,-344,911,376,-535,973.0,576.0,-397.0,10660200.0,0.0,-10660200.0
<a href=/player/rea-c001>rea-c001</a>,Colin Rea,Miami Marlins,MARLNS,2,4,2,6,2016,2019,3,No,0,13.02,1.87,-11.15,374,112,-262,266,107,-159,2630.0,912.0,-1718.0,0.0,0.0,0.0
<a href=/player/readr001>readr001</a>,Randy Ready,Milwaukee Brewers,BREWRS,2,2,3,5,1986,1988,2,No,0,7.86,0.0,-7.86,267,0,-267,886,0,-886,0.0,0.0,0.0,0.0,0.0,0.0
<a href=/player/readr001>readr001</a>,Randy Ready,San Diego Padres,PADRS,8,16,17,33,1989,1998,9,No,0,97.76,11.55,-86.21,6640,1589,-5051,25821,4524,-21297,1355.0,1888.0,533.0,9476667.0,0.0,-9476667.0
<a href=/player/realj001>realj001</a>,J.T. Realmuto,Miami Marlins,MARLNS,1,1,4,5,2019,2019,0,Yes,0,9.39,1.01,-8.38,326,130,-196,1325,465,-860,0.0,0.0,0.0,0.0,0.0,0.0
<a href=/player/reamb001>reamb001</a>,Britt Reames,St. Louis Cardinals,CARDS,4,6,7,13,2000,2004,4,No,0,4.8,5.31,0.51,823,756,-67,2678,110,-2568,559.0,1705.0,1146.0,6083333.0,0.0,-6083333.0
<a href=/player/rearc001>rearc001</a>,Chris Rearick,Tampa Bay Devil Rays,RAYS,1,1,1,2,2012,2015,3,No,0,-0.16,-0.13,0.03,10,4,-6,0,14,14,9.0,0.0,-9.0,0.0,0.0,0.0
<a href=/player/rearj001>rearj001</a>,Jeff Reardon,New York Mets,METS,1,2,1,3,1981,1982,1,No,0,8.04,-0.11,-8.15,771,159,-612,125,526,401,1519.0,0.0,-1519.0,0.0,0.0,0.0
<a href=/player/rearj001>rearj001</a>,Jeff Reardon,Montreal Expos,NATEX,9,14,16,30,1987,1996,9,No,0,5.9,1.65,-4.25,1311,1101,-210,2173,1393,-780,2901.0,1691.0,-1210.0,955000.0,0.0,-955000.0
<a href=/player/rearj001>rearj001</a>,Jeff Reardon,Boston Red Sox,RSOX,2,3,3,6,1992,1996,4,No,0,0.67,2.21,1.54,28,143,115,0,511,511,47.0,168.0,121.0,2755334.0,0.0,-2755334.0
<a href=/player/rebea101>rebea101</a>,Art Rebel,Boston Red Sox,RSOX,1,1,1,2,1943,1945,2,No,0,0.0,-1.41,-1.41,0,97,97,0,115,115,0.0,540.0,540.0,0.0,0.0,0.0
<a href=/player/rebef101>rebef101</a>,Frank Reberger,San Diego Padres,PADRS,3,3,5,8,1969,1974,5,No,0,0.34,-0.06,-0.4,191,412,221,101,939,838,924.0,333.0,-591.0,0.0,0.0,0.0
<a href=/player/recka001>recka001</a>,Anthony Recker,Oakland Athletics,ATLTCS,1,1,1,2,2012,2012,0,No,0,0.12,0.0,-0.12,9,0,-9,21,0,-21,0.0,0.0,0.0,480000.0,0.0,-480000.0
<a href=/player/recka001>recka001</a>,Anthony Recker,Atlanta Braves,BRAVES,1,3,1,4,2017,2017,0,Yes,0,0.09,0.0,-0.09,1,0,-1,0,0,0,20.0,0.0,-20.0,12800000.0,0.0,-12800000.0
<a href=/player/reddj001>reddj001</a>,Josh Reddick,Boston Red Sox,RSOX,1,3,2,5,2011,2013,2,No,0,15.82,0.39,-15.43,609,113,-496,2364,219,-2145,139.0,132.0,-7.0,0.0,0.0,0.0
<a href=/player/reddj001>reddj001</a>,Josh Reddick,Oakland Athletics,ATLTCS,1,2,3,5,2016,2019,3,Yes,0,5.89,0.29,-5.6,179,30,-149,293,2,-291,1084.0,475.0,-609.0,0.0,0.0,0.0
<a href=/player/reddt001>reddt001</a>,Tim Redding,Houston Astros,ASTROS,2,4,3,7,2005,2017,12,No,0,-1.96,1.37,3.33,91,404,313,219,1035,816,89.0,165.0,76.0,0.0,0.0,0.0
<a href=/player/reddt001>reddt001</a>,Tim Redding,San Diego Padres,PADRS,1,3,1,4,2005,2005,0,No,0,-0.82,0.3,1.12,3,44,41,0,1,1,24.0,95.0,71.0,3975000.0,0.0,-3975000.0
<a href=/player/redfb101>redfb101</a>,Buck Redfern,Detroit Tigers,TIGRS,2,6,2,8,1925,1928,3,No,0,0.0,1.07,1.07,0,324,324,0,1271,1271,0.0,0.0,0.0,0.0,0.0,0.0
<a href=/player/redfj001>redfj001</a>,Joe Redfield,New York Mets,METS,1,1,1,2,1986,1986,0,No,0,0.0,0.0,0.0,0,0,0,0,0,0,0.0,0.0,0.0,0.0,0.0,0.0
<a href=/player/redfj001>redfj001</a>,Joe Redfield,Atlanta Braves,BRAVES,1,1,1,2,1987,1987,0,No,0,-0.02,0.0,0.02,1,0,-1,2,0,-2,0.0,0.0,0.0,0.0,0.0,0.0
<a href=/player/redmg101>redmg101</a>,Glenn Redmon,Chicago White Sox,WSOX,6,11,7,18,1973,1989,16,No,1,34.86,33.13,-1.73,1510,1241,-269,4901,4106,-795,2621.0,1776.0,-845.0,0.0,0.0,0.0
<a href=/player/redmm002>redmm002</a>,Mark Redman,Minnesota Twins,TWINS,1,1,1,2,2001,2001,0,No,0,2.76,0.29,-2.47,34,24,-10,5,0,-5,636.0,58.0,-578.0,235000.0,0.0,-235000.0
<a href=/player/redmm002>redmm002</a>,Mark Redman,Detroit Tigers,TIGRS,1,2,3,5,2003,2010,7,No,0,2.96,5.55,2.59,57,267,210,66,23,-43,572.0,3820.0,3248.0,0.0,0.0,0.0
<a href=/player/redmm002>redmm002</a>,Mark Redman,Florida Marlins,MARLNS,11,20,27,47,2003,2019,16,Yes,0,77.53,54.32,-23.21,2512,2883,371,6299,8326,2027,11245.0,5436.0,-5809.0,40718667.0,0.0,-40718667.0
<a href=/player/redmm002>redmm002</a>,Mark Redman,Oakland Athletics,ATLTCS,5,8,7,15,2004,2017,13,Yes,0,-1.43,13.16,14.59,290,983,693,344,2743,2399,707.0,801.0,94.0,17758194.0,0.0,-17758194.0
<a href=/player/redmm002>redmm002</a>,Mark Redman,Pittsburgh Pirates,PIRATS,1,1,2,3,2005,2008,3,No,0,0.11,-1.27,-1.38,30,95,65,3,0,-3,501.0,157.0,-344.0,4500000.0,0.0,-4500000.0
<a href=/player/redmt002>redmt002</a>,Todd Redmond,Pittsburgh Pirates,PIRATS,1,1,1,2,2008,2011,3,No,0,0.0,-0.49,-0.49,0,172,172,0,0,0,0.0,256.0,256.0,0.0,0.0,0.0
<a href=/player/redmt002>redmt002</a>,Todd Redmond,Atlanta Braves,BRAVES,1,1,1,2,2012,2013,1,No,0,-0.2,-0.57,-0.37,2,107,105,1,231,230,10.0,0.0,-10.0,0.0,0.0,0.0
<a href=/player/redug001>redug001</a>,Gary Redus,Cincinnati Reds,REDS,3,5,5,10,1985,1992,7,No,0,5.33,4.06,-1.27,304,351,47,423,887,464,1092.0,605.0,-487.0,1560833.0,0.0,-1560833.0
<a href=/player/redug001>redug001</a>,Gary Redus,Philadelphia Phillies,PHILS,1,1,2,3,1987,1987,0,No,0,3.47,-1.22,-4.69,207,10,-197,858,3,-855,0.0,35.0,35.0,0.0,0.0,0.0
<a href=/player/redug001>redug001</a>,Gary Redus,Chicago White Sox,WSOX,1,1,1,2,1988,1988,0,No,0,4.39,-0.59,-4.98,398,40,-358,1161,158,-1003,0.0,0.0,0.0,460000.0,0.0,-460000.0
<a href=/player/reeda001>reeda001</a>,Addison Reed,Chicago White Sox,WSOX,1,1,1,2,2013,2018,5,No,0,-0.62,-0.05,0.57,195,245,50,2,941,939,300.0,9.0,-291.0,520000.0,0.0,-520000.0
<a href=/player/reeda001>reeda001</a>,Addison Reed,Arizona Diamondbacks,DBACKS,1,1,2,3,2015,2019,4,Yes,0,5.08,0.63,-4.45,283,69,-214,0,35,35,426.0,376.0,-50.0,4875000.0,0.0,-4875000.0
<a href=/player/reeda001>reeda001</a>,Addison Reed,New York Mets,METS,2,6,6,12,2017,2018,1,Yes,0,0.07,-0.3,-0.37,222,27,-195,565,0,-565,457.0,33.0,-424.0,24250000.0,0.0,-24250000.0
<a href=/player/reedc001>reedc001</a>,Chris Reed,Los Angeles Dodgers,DOGRS,1,1,1,2,2015,2017,2,No,0,0.0,0.57,0.57,4,103,99,0,1,1,12.0,150.0,138.0,0.0,0.0,0.0
<a href=/player/reedc002>reedc002</a>,Cody Reed,Kansas City Royals,ROYALS,1,3,2,5,2015,2015,0,No,0,-1.23,0.27,1.5,231,13,-218,147,0,-147,1419.0,244.0,-1175.0,0.0,0.0,0.0
<a href=/player/reedc002>reedc002</a>,Cody Reed,Cincinnati Reds,REDS,1,1,1,2,2020,2020,0,Yes,0,0.1,0.0,-0.1,14,0,-14,0,0,0,37.0,0.0,-37.0,0.0,0.0,0.0
<a href=/player/reedd001>reedd001</a>,Darren Reed,New York Yankees,YANKS,1,3,2,5,1987,1989,2,No,0,0.13,-0.61,-0.74,44,148,104,95,521,426,0.0,0.0,0.0,0.0,0.0,0.0
<a href=/player/reedd001>reedd001</a>,Darren Reed,New York Mets,METS,1,2,2,4,1991,1991,0,No,0,-0.75,0.0,0.75,42,0,-42,88,0,-88,0.0,0.0,0.0,0.0,0.0,0.0
<a href=/player/reedd001>reedd001</a>,Darren Reed,Montreal Expos,NATEX,1,1,1,2,1992,1992,0,No,0,-0.28,-0.51,-0.23,14,18,4,37,4,-33,0.0,52.0,52.0,119000.0,0.0,-119000.0
<a href=/player/reedd001>reedd001</a>,Darren Reed,Minnesota Twins,TWINS,1,1,1,2,1992,1992,0,No,0,0.0,0.0,0.0,0,0,0,0,0,0,0.0,0.0,0.0,0.0,0.0,0.0
<a href=/player/reede002>reede002</a>,Evan Reed,Texas Rangers,RNGRS,1,2,1,3,2010,2010,0,No,0,0.0,-0.56,-0.56,0,30,30,0,105,105,0.0,0.0,0.0,0.0,0.0,0.0
<a href=/player/reedh102>reedh102</a>,Howie Reed,Kansas City Athletics,ATLTCS,16,35,28,63,1961,1976,15,No,0,57.63,48.82,-8.81,6807,4417,-2390,14909,13848,-1061,10799.0,3800.0,-6999.0,387100.0,0.0,-387100.0
<a href=/player/reedh102>reedh102</a>,Howie Reed,Los Angeles Dodgers,DOGRS,1,1,2,3,1966,1966,0,No,0,0.75,0.0,-0.75,38,0,-38,6,0,-6,129.0,0.0,-129.0,17000.0,0.0,-17000.0
<a href=/player/reedh102>reedh102</a>,Howie Reed,California Angels,ANGELS,1,1,1,2,1966,1966,0,No,0,0.09,0.0,-0.09,8,0,-8,4,0,-4,55.0,0.0,-55.0,0.0,0.0,0.0
<a href=/player/reedj001>reedj001</a>,Jeff Reed,Minnesota Twins,TWINS,6,12,11,23,1987,2007,20,No,6,9.32,35.62,26.3,1101,1557,456,2383,5077,2694,2963.0,1837.0,-1126.0,103500.0,0.0,-103500.0
<a href=/player/reedj001>reedj001</a>,Jeff Reed,Montreal Expos,NATEX,3,5,4,9,1988,1992,4,No,0,1.15,0.52,-0.63,739,280,-459,1881,660,-1221,41.0,0.0,-41.0,330000.0,0.0,-330000.0
<a href=/player/reedj002>reedj002</a>,Jerry Reed,Philadelphia Phillies,PHILS,3,6,5,11,1982,1987,5,No,0,5.02,15.9,10.88,358,462,104,942,672,-270,1316.0,2480.0,1164.0,1109333.0,0.0,-1109333.0
<a href=/player/reedj003>reedj003</a>,Jody Reed,Colorado Rockies,ROCKS,1,1,1,2,1992,1993,1,No,0,0.37,0.0,-0.37,132,0,-132,504,0,-504,0.0,0.0,0.0,0.0,0.0,0.0
<a href=/player/reedj003>reedj003</a>,Jody Reed,San Diego Padres,PADRS,1,1,2,3,1997,1999,2,No,0,-0.37,0.0,0.37,52,0,-52,129,0,-129,0.0,0.0,0.0,0.0,0.0,0.0
<a href=/player/reedj004>reedj004</a>,Jeremy Reed,Chicago White Sox,WSOX,4,9,8,17,2004,2013,9,No,0,26.28,24.52,-1.76,2038,506,-1532,7101,844,-6257,1892.0,4790.0,2898.0,12920000.0,0.0,-12920000.0
<a href=/player/reedj004>reedj004</a>,Jeremy Reed,Seattle Mariners,MARNRS,8,16,16,32,2008,2015,7,No,0,0.83,32.43,31.6,1230,1763,533,2304,5784,3480,1045.0,2794.0,1749.0,18727500.0,0.0,-18727500.0
<a href=/player/reedm001>reedm001</a>,Michael Reed,Minnesota Twins,TWINS,1,1,2,3,2019,2019,0,No,0,-0.32,0.0,0.32,4,0,-4,8,0,-8,0.0,0.0,0.0,0.0,0.0,0.0
<a href=/player/reedr001>reedr001</a>,Ron Reed,Atlanta Braves,BRAVES,3,6,6,12,1975,1977,2,No,0,7.21,1.02,-6.19,424,370,-54,701,70,-631,842.0,1041.0,199.0,0.0,0.0,0.0
<a href=/player/reedr001>reedr001</a>,Ron Reed,St. Louis Cardinals,CARDS,1,1,1,2,1975,1978,3,No,0,10.43,1.24,-9.19,916,180,-736,105,399,294,2427.0,0.0,-2427.0,0.0,0.0,0.0
<a href=/player/reedr001>reedr001</a>,Ron Reed,Philadelphia Phillies,PHILS,1,1,1,2,1983,1985,2,No,0,1.34,2.71,1.37,53,110,57,1,126,125,219.0,970.0,751.0,0.0,0.0,0.0
<a href=/player/reedr002>reedr002</a>,Rick Reed,New York Mets,METS,4,10,9,19,2001,2008,7,No,0,16.08,-0.18,-16.26,1408,384,-1024,2315,1225,-1090,2785.0,327.0,-2458.0,14750000.0,0.0,-14750000.0
<a href=/player/reeds001>reeds001</a>,Steve Reed,San Francisco Giants,GIANTS,5,7,9,16,1998,2008,10,No,2,4.17,4.04,-0.13,448,693,245,250,471,221,1207.0,1349.0,142.0,1508500.0,0.0,-1508500.0
<a href=/player/reeds001>reeds001</a>,Steve Reed,Cleveland Indians,INDINS,2,3,3,6,2001,2003,2,No,0,-0.19,-0.02,0.17,198,59,-139,2,0,-2,300.0,180.0,-120.0,4300000.0,0.0,-4300000.0
<a href=/player/reeds001>reeds001</a>,Steve Reed,San Diego Padres,PADRS,2,5,4,9,2002,2009,7,No,0,20.01,17.43,-2.58,923,844,-79,3191,3702,511,1341.0,29.0,-1312.0,805000.0,0.0,-805000.0
<a href=/player/reesj101>reesj101</a>,Jimmie Reese,Oakland,Oakland,1,2,1,3,1927,1927,0,No,0,12.23,0.0,-12.23,638,0,-638,2477,0,-2477,0.0,0.0,0.0,0.0,0.0,0.0
<a href=/player/reesj101>reesj101</a>,Jimmie Reese,New York Yankees,YANKS,1,5,2,7,1931,1947,16,No,0,0.0,15.3,15.3,0,992,992,0,1098,1098,0.0,2971.0,2971.0,19500.0,0.0,-19500.0
<a href=/player/reesk001>reesk001</a>,Kevin Reese,San Diego Padres,PADRS,1,1,1,2,2001,2004,3,No,0,0.18,0.0,-0.18,12,0,-12,16,0,-16,0.0,0.0,0.0,0.0,0.0,0.0
<a href=/player/reesp001>reesp001</a>,Pokey Reese,Cincinnati Reds,REDS,1,2,2,4,2001,2006,5,No,0,0.51,2.6,2.09,83,248,165,0,53,53,121.0,683.0,562.0,3825000.0,0.0,-3825000.0
<a href=/player/reesp001>reesp001</a>,Pokey Reese,Colorado Rockies,ROCKS,1,1,1,2,2001,2001,0,No,0,1.26,0.0,-1.26,96,0,-96,268,0,-268,0.0,0.0,0.0,0.0,0.0,0.0
<a href=/player/reesp101>reesp101</a>,Pee Wee Reese,Boston Red Sox,RSOX,2,3,6,9,1939,1947,8,No,0,68.5,1.66,-66.84,2166,64,-2102,9470,50,-9420,0.0,452.0,452.0,0.0,0.0,0.0
<a href=/player/reevb101>reevb101</a>,Bobby Reeves,Washington Senators,TWINS,1,5,1,6,1928,1941,13,No,0,14.54,41.49,26.95,801,1492,691,1696,6460,4764,3390.0,0.0,-3390.0,20500.0,0.0,-20500.0
<a href=/player/refsr001>refsr001</a>,Rob Refsnyder,New York Yankees,YANKS,1,1,1,2,2017,2019,2,No,0,-0.2,0.0,0.2,32,0,-32,58,0,-58,0.0,0.0,0.0,0.0,0.0,0.0
<a href=/player/regap101>regap101</a>,Phil Regan,Detroit Tigers,TIGRS,1,1,1,2,1965,1965,0,No,0,6.0,0.0,-6.0,250,0,-250,37,0,-37,662.0,0.0,-662.0,17500.0,0.0,-17500.0
<a href=/player/regap101>regap101</a>,Phil Regan,Los Angeles Dodgers,DOGRS,3,4,4,8,1968,1970,2,No,0,15.48,-0.58,-16.06,1246,61,-1185,2529,137,-2392,1193.0,0.0,-1193.0,36500.0,0.0,-36500.0
<a href=/player/rehgw101>rehgw101</a>,Wally Rehg,StPaul,StPaul,1,1,1,2,1913,1913,0,No,0,-0.91,0.0,0.91,123,0,-123,287,0,-287,0.0,0.0,0.0,0.0,0.0,0.0
<a href=/player/rehgw101>rehgw101</a>,Wally Rehg,Boston Braves,BRAVES,1,1,1,2,1919,1919,0,No,0,-0.11,0.14,0.25,5,31,26,14,92,78,0.0,0.0,0.0,0.0,0.0,0.0
<a href=/player/reicr101>reicr101</a>,Rick Reichardt,California Angels,ANGELS,10,16,20,36,1970,1977,7,No,0,30.4,30.36,-0.04,1555,1533,-22,4572,5092,520,3213.0,1843.0,-1370.0,333500.0,0.0,-333500.0
<a href=/player/reicr101>reicr101</a>,Rick Reichardt,Washington Senators,RNGRS,1,1,1,2,1971,1971,0,No,0,1.62,-0.56,-2.18,285,46,-239,1036,17,-1019,0.0,185.0,185.0,0.0,0.0,0.0
<a href=/player/reids001>reids001</a>,Sean Reid-Foley,Toronto Blue Jays,BJAYS,1,3,1,4,2021,2021,0,No,0,-0.51,2.02,2.53,63,30,-33,3,2,-1,137.0,452.0,315.0,0.0,0.0,0.0
<a href=/player/reilt101>reilt101</a>,Tom Reilly,DesMoines,DesMoines,1,1,2,3,1914,1914,0,No,0,0.0,0.0,0.0,1,0,-1,1,0,-1,0.0,0.0,0.0,0.0,0.0,0.0
<a href=/player/reimk001>reimk001</a>,Kevin Reimer,Colorado Rockies,ROCKS,2,3,3,6,1992,2000,8,No,0,0.09,6.28,6.19,250,1232,982,991,4864,3873,0.0,107.0,107.0,7250000.0,0.0,-7250000.0
<a href=/player/reinc001>reinc001</a>,Chad Reineke,Houston Astros,ASTROS,1,1,1,2,2008,2008,0,No,0,-0.01,1.18,1.19,8,24,16,6,26,20,54.0,212.0,158.0,0.0,0.0,0.0
<a href=/player/reinc001>reinc001</a>,Chad Reineke,San Diego Padres,PADRS,1,1,1,2,2009,2009,0,No,0,-0.06,0.0,0.06,1,0,-1,0,0,0,15.0,0.0,-15.0,0.0,0.0,0.0
<a href=/player/reinj001>reinj001</a>,Jack Reinheimer,Seattle Mariners,MARNRS,3,7,4,11,2015,2017,2,Yes,0,4.57,3.33,-1.24,655,244,-411,2424,508,-1916,92.0,403.0,311.0,9532900.0,0.0,-9532900.0
<a href=/player/reisa101>reisa101</a>,Al Reiss,Philadelphia Athletics,ATLTCS,1,2,1,3,1932,1936,4,No,0,0.0,1.11,1.11,0,224,224,0,182,182,0.0,1445.0,1445.0,2500.0,0.0,-2500.0
<a href=/player/reisb102>reisb102</a>,Bobby Reis,Brooklyn Dodgers,DOGRS,5,10,8,18,1935,1948,13,No,0,23.18,15.94,-7.24,1423,1121,-302,4586,3821,-765,1769.0,791.0,-978.0,0.0,0.0,0.0
<a href=/player/reisb102>reisb102</a>,Bobby Reis,Boston Braves,BRAVES,6,18,10,28,1938,1952,14,No,0,22.0,33.53,11.53,1506,1625,119,5516,5420,-96,0.0,2449.0,2449.0,12500.0,0.0,-12500.0
<a href=/player/reisp101>reisp101</a>,Pete Reiser,Brooklyn Dodgers,DOGRS,2,2,4,6,1948,1949,1,No,0,1.99,-0.55,-2.54,202,55,-147,574,158,-416,0.0,0.0,0.0,0.0,0.0,0.0
<a href=/player/reist101>reist101</a>,Tommy Reis,Boston Braves,BRAVES,6,18,10,28,1938,1952,14,No,0,22.0,33.53,11.53,1506,1625,119,5516,5420,-96,0.0,2449.0,2449.0,12500.0,0.0,-12500.0
<a href=/player/reitb001>reitb001</a>,Brian Reith,New York Yankees,YANKS,4,12,6,18,2000,2007,7,No,2,5.36,3.85,-1.51,689,111,-578,203,14,-189,3035.0,1602.0,-1433.0,4387150.0,0.0,-4387150.0
<a href=/player/reitc001>reitc001</a>,Chris Reitsma,Boston Red Sox,RSOX,1,2,1,3,2000,2001,1,No,0,1.86,0.82,-1.04,246,137,-109,104,537,433,1213.0,0.0,-1213.0,0.0,0.0,0.0
<a href=/player/reitc001>reitc001</a>,Chris Reitsma,Cincinnati Reds,REDS,1,1,2,3,2004,2006,2,No,0,-0.6,-0.35,0.25,368,5,-363,1,4,3,543.0,46.0,-497.0,0.0,0.0,0.0
<a href=/player/reith101>reith101</a>,Heinie Reitz,Baltimore Orioles,BLN,2,4,4,8,1897,1899,2,No,0,2.28,18.6,16.32,271,446,175,1095,1688,593,148.0,1122.0,974.0,0.0,0.0,0.0
<a href=/player/reith101>reith101</a>,Heinie Reitz,Washington Senators,WSN,1,1,3,4,1898,1900,2,No,0,0.36,1.28,0.92,35,408,373,149,1684,1535,0.0,0.0,0.0,0.0,0.0,0.0
<a href=/player/reith101>reith101</a>,Heinie Reitz,Pittsburgh Pirates,PIRATS,1,1,1,2,1900,1901,1,No,0,0.0,0.0,0.0,0,0,0,0,0,0,0.0,0.0,0.0,0.0,0.0,0.0
<a href=/player/reitk101>reitk101</a>,Ken Reitz,St. Louis Cardinals,CARDS,14,31,26,57,1975,1998,23,No,5,88.37,122.95,34.58,7178,5213,-1965,21650,17314,-4336,8355.0,4335.0,-4020.0,1533333.0,0.0,-1533333.0
<a href=/player/reitk101>reitk101</a>,Ken Reitz,San Francisco Giants,GIANTS,3,3,3,6,1976,1980,4,No,0,8.05,-2.42,-10.47,1045,207,-838,2865,275,-2590,1587.0,416.0,-1171.0,0.0,0.0,0.0
<a href=/player/reitk101>reitk101</a>,Ken Reitz,St. Louis Cardinals,CARDS,2,4,2,6,1980,1984,4,No,1,14.5,6.0,-8.5,1050,498,-552,4046,39,-4007,0.0,1190.0,1190.0,0.0,0.0,0.0
<a href=/player/rekab001>rekab001</a>,Bryan Rekar,Kansas City Royals,ROYALS,1,1,1,2,2002,2004,2,No,0,0.0,-0.19,-0.19,0,1,1,0,0,0,0.0,10.0,10.0,0.0,0.0,0.0
<a href=/player/relad001>relad001</a>,Desi Relaford,Seattle Mariners,MARNRS,1,1,1,2,1996,1996,0,No,0,-1.77,0.81,2.58,320,12,-308,1189,0,-1189,0.0,208.0,208.0,0.0,0.0,0.0
<a href=/player/relad001>relad001</a>,Desi Relaford,Philadelphia Phillies,PHILS,1,1,1,2,2000,2001,1,No,0,-0.07,0.11,0.18,45,17,-28,189,27,-162,0.0,0.0,0.0,345000.0,0.0,-345000.0
<a href=/player/relad001>relad001</a>,Desi Relaford,New York Mets,METS,2,4,5,9,2001,2003,2,No,0,1.23,0.97,-0.26,130,205,75,408,385,-23,84.0,416.0,332.0,7175000.0,0.0,-7175000.0
<a href=/player/relad001>relad001</a>,Desi Relaford,San Francisco Giants,GIANTS,1,2,1,3,2002,2002,0,No,0,1.16,3.15,1.99,112,154,42,376,628,252,0.0,0.0,0.0,0.0,0.0,0.0
<a href=/player/remlm001>remlm001</a>,Mike Remlinger,San Francisco Giants,GIANTS,4,7,11,18,1991,1998,7,No,0,10.32,12.82,2.5,410,1133,723,849,798,-51,1958.0,3071.0,1113.0,9577778.0,0.0,-9577778.0
<a href=/player/remlm001>remlm001</a>,Mike Remlinger,New York Mets,METS,1,1,1,2,1995,1995,0,No,0,1.81,0.0,-1.81,250,0,-250,90,0,-90,950.0,0.0,-950.0,118500.0,0.0,-118500.0
<a href=/player/remlm001>remlm001</a>,Mike Remlinger,Cincinnati Reds,REDS,1,2,1,3,1995,1995,0,No,0,-1.55,0.0,1.55,126,0,-126,291,0,-291,0.0,0.0,0.0,0.0,0.0,0.0
<a href=/player/remlm001>remlm001</a>,Mike Remlinger,Cincinnati Reds,REDS,8,13,16,29,1998,2013,15,No,0,32.31,35.48,3.17,2118,2354,236,5649,6223,574,1997.0,6510.0,4513.0,12325000.0,0.0,-12325000.0
<a href=/player/remlm001>remlm001</a>,Mike Remlinger,Chicago Cubs,CUBS,1,2,1,3,2005,2005,0,No,0,-0.55,0.0,0.55,8,0,-8,0,0,0,20.0,0.0,-20.0,4233333.0,0.0,-4233333.0
<a href=/player/remyj001>remyj001</a>,Jerry Remy,California Angels,ANGELS,2,2,3,5,1977,1984,7,No,1,6.5,10.47,3.97,710,192,-518,3118,0,-3118,0.0,2086.0,2086.0,80000.0,0.0,-80000.0
<a href=/player/rendt001>rendt001</a>,Tony Renda,Washington Nationals,NATEX,1,1,1,2,2015,2015,0,No,0,0.0,0.22,0.22,0,15,15,0,0,0,0.0,18.0,18.0,0.0,0.0,0.0
<a href=/player/rendt001>rendt001</a>,Tony Renda,New York Yankees,YANKS,4,8,7,15,2015,2020,5,Yes,0,-1.49,8.03,9.52,440,197,-243,1007,8,-999,290.0,1270.0,980.0,3936900.0,0.0,-3936900.0
<a href=/player/renfh001>renfh001</a>,Hunter Renfroe,San Diego Padres,PADRS,1,3,2,5,2019,2021,2,Yes,0,-0.02,1.32,1.34,42,186,144,139,686,547,0.0,0.0,0.0,582100.0,0.0,-582100.0
<a href=/player/rengl001>rengl001</a>,Luis Rengifo,Seattle Mariners,MARNRS,1,3,2,5,2017,2019,2,No,0,0.0,0.36,0.36,0,30,30,0,38,38,0.0,44.0,44.0,0.0,0.0,0.0
<a href=/player/rengl001>rengl001</a>,Luis Rengifo,Tampa Bay Devil Rays,RAYS,1,1,1,2,2018,2018,0,No,0,0.32,2.33,2.01,195,140,-55,702,560,-142,0.0,0.0,0.0,0.0,0.0,0.0
<a href=/player/renij101>renij101</a>,Jim Reninger,Baltimore,Baltimore,1,1,2,3,1938,1938,0,No,0,-0.27,0.0,0.27,16,0,-16,15,0,-15,119.0,0.0,-119.0,0.0,0.0,0.0
<a href=/player/renks101>renks101</a>,Steve Renko,New York Mets,METS,1,5,1,6,1969,1971,2,No,0,11.34,3.37,-7.97,538,281,-257,615,957,342,4078.0,0.0,-4078.0,0.0,0.0,0.0
<a href=/player/renks101>renks101</a>,Steve Renko,Montreal Expos,NATEX,2,3,2,5,1976,1978,2,No,0,19.9,-0.47,-20.37,1883,153,-1730,6872,280,-6592,648.0,557.0,-91.0,0.0,0.0,0.0
<a href=/player/renks101>renks101</a>,Steve Renko,Chicago Cubs,CUBS,2,2,3,5,1977,1978,1,No,0,1.3,0.52,-0.78,8,24,16,0,56,56,160.0,0.0,-160.0,0.0,0.0,0.0
<a href=/player/renks101>renks101</a>,Steve Renko,Chicago White Sox,WSOX,1,2,1,3,1978,1979,1,No,0,6.89,-0.37,-7.26,401,28,-373,1175,0,-1175,453.0,189.0,-264.0,0.0,0.0,0.0
<a href=/player/renks101>renks101</a>,Steve Renko,Boston Red Sox,RSOX,3,4,5,9,1981,1989,8,No,2,12.81,-0.08,-12.89,526,180,-346,1947,447,-1500,774.0,448.0,-326.0,0.0,0.0,0.0
<a href=/player/rennb101>rennb101</a>,Bill Renna,New York Yankees,YANKS,16,45,38,83,1953,1970,17,No,0,48.62,78.17,29.55,7017,4726,-2291,22732,11340,-11392,3607.0,11554.0,7947.0,313000.0,0.0,-313000.0
<a href=/player/rennb101>rennb101</a>,Bill Renna,Kansas City Athletics,ATLTCS,42,95,97,192,1956,1976,20,No,0,133.5,78.63,-54.87,13774,10527,-3247,30995,29007,-1988,20345.0,13097.0,-7248.0,522100.0,0.0,-522100.0
<a href=/player/rennb101>rennb101</a>,Bill Renna,New York Yankees,YANKS,2,3,3,6,1957,1960,3,No,0,0.23,-2.55,-2.78,87,104,17,126,53,-73,0.0,406.0,406.0,0.0,0.0,0.0
<a href=/player/renst101>renst101</a>,Tony Rensa,Chicago White Sox,WSOX,3,6,3,9,1939,1950,11,No,0,-0.26,2.54,2.8,394,795,401,1460,3225,1765,0.0,0.0,0.0,14200.0,0.0,-14200.0
<a href=/player/renst101>renst101</a>,Tony Rensa,Dallas,Dallas,1,1,3,4,1936,1936,0,No,0,0.61,0.0,-0.61,99,0,-99,283,0,-283,0.0,0.0,0.0,0.0,0.0,0.0
<a href=/player/rente001>rente001</a>,Edgar Renteria,Florida Marlins,MARLNS,5,10,14,24,1998,2015,17,No,0,28.19,25.74,-2.45,1796,2755,959,6742,2798,-3944,1797.0,6839.0,5042.0,13432000.0,0.0,-13432000.0
<a href=/player/rente001>rente001</a>,Edgar Renteria,Boston Red Sox,RSOX,7,14,9,23,2005,2011,6,No,0,23.71,8.9,-14.81,1892,794,-1098,4226,1778,-2448,1235.0,750.0,-485.0,16391733.0,0.0,-16391733.0
<a href=/player/rente001>rente001</a>,Edgar Renteria,Atlanta Braves,BRAVES,2,4,3,7,2007,2012,5,No,0,-0.89,9.81,10.7,691,493,-198,1061,1274,213,4336.0,2160.0,-2176.0,9000000.0,0.0,-9000000.0
<a href=/player/rentr001>rentr001</a>,Rich Renteria,Pittsburgh Pirates,PIRATS,1,1,1,2,1986,1986,0,No,0,-0.79,0.0,0.79,43,0,-43,102,0,-102,0.0,0.0,0.0,0.0,0.0,0.0
<a href=/player/repor101>repor101</a>,Roger Repoz,New York Yankees,YANKS,3,5,4,9,1966,1973,7,No,0,1.66,4.77,3.11,451,607,156,554,678,124,1018.0,1714.0,696.0,17000.0,0.0,-17000.0
<a href=/player/repor101>repor101</a>,Roger Repoz,Kansas City Athletics,ATLTCS,1,1,2,3,1967,1967,0,No,0,5.22,-0.69,-5.91,563,20,-543,1705,4,-1701,0.0,66.0,66.0,0.0,0.0,0.0
<a href=/player/repor101>repor101</a>,Roger Repoz,California Angels,ANGELS,3,3,4,7,1972,1974,2,No,0,-0.01,-0.28,-0.27,245,41,-204,776,52,-724,0.0,0.0,0.0,27000.0,0.0,-27000.0
<a href=/player/repur101>repur101</a>,Rip Repulski,St. Louis Cardinals,CARDS,3,7,6,13,1956,1963,7,No,0,8.24,1.4,-6.84,1198,700,-498,4161,1883,-2278,89.0,111.0,22.0,0.0,0.0,0.0
<a href=/player/repur101>repur101</a>,Rip Repulski,Philadelphia Phillies,PHILS,1,3,1,4,1958,1958,0,No,0,-0.86,0.0,0.86,137,0,-137,129,0,-129,226.0,0.0,-226.0,0.0,0.0,0.0
<a href=/player/repur101>repur101</a>,Rip Repulski,Los Angeles Dodgers,DOGRS,1,1,1,2,1960,1960,0,No,0,-0.17,0.0,0.17,88,0,-88,177,0,-177,0.0,0.0,0.0,17000.0,0.0,-17000.0
<a href=/player/resoc001>resoc001</a>,Chris Resop,Florida Marlins,MARLNS,2,2,2,4,2006,2013,7,No,0,0.65,2.68,2.03,266,333,67,0,5,5,405.0,545.0,140.0,2827000.0,0.0,-2827000.0
<a href=/player/resoc001>resoc001</a>,Chris Resop,Pittsburgh Pirates,PIRATS,2,3,2,5,2012,2014,2,No,0,-0.32,-0.07,0.25,19,131,112,0,397,397,54.0,0.0,-54.0,850000.0,0.0,-850000.0
<a href=/player/restd101>restd101</a>,Dino Restelli,SanFrancisco,SanFrancisco,1,1,2,3,1949,1949,0,No,0,1.3,0.0,-1.3,93,0,-93,314,0,-314,0.0,0.0,0.0,0.0,0.0,0.0
<a href=/player/restd101>restd101</a>,Dino Restelli,Cleveland Indians,INDINS,1,2,1,3,1952,1952,0,No,0,0.0,0.05,0.05,0,44,44,0,98,98,0.0,0.0,0.0,0.0,0.0,0.0
<a href=/player/rettm101>rettm101</a>,Merv Rettenmund,Baltimore Orioles,ORLS,2,4,3,7,1973,1977,4,No,1,4.01,5.74,1.73,498,137,-361,1375,0,-1375,0.0,2543.0,2543.0,40000.0,0.0,-40000.0
<a href=/player/rettm101>rettm101</a>,Merv Rettenmund,Cincinnati Reds,REDS,1,1,1,2,1976,1977,1,No,0,2.31,0.0,-2.31,193,0,-193,338,0,-338,0.0,0.0,0.0,0.0,0.0,0.0
<a href=/player/retzk101>retzk101</a>,Ken Retzer,Cleveland Indians,INDINS,1,1,1,2,1961,1961,0,No,0,1.36,0.0,-1.36,237,0,-237,754,0,-754,0.0,0.0,0.0,0.0,0.0,0.0
<a href=/player/retzk101>retzk101</a>,Ken Retzer,Washington Senators,RNGRS,1,1,1,2,1964,1964,0,No,0,0.0,0.0,0.0,0,0,0,0,0,0,0.0,0.0,0.0,13000.0,0.0,-13000.0
<a href=/player/retzk101>retzk101</a>,Ken Retzer,Minnesota Twins,TWINS,1,1,1,2,1966,1967,1,No,0,0.0,0.11,0.11,0,10,10,0,20,20,0.0,0.0,0.0,0.0,0.0,0.0
<a href=/player/retzk101>retzk101</a>,Ken Retzer,Houston Astros,ASTROS,4,5,6,11,1967,1978,11,No,0,2.92,1.17,-1.75,377,1322,945,888,4912,4024,159.0,122.0,-37.0,0.0,0.0,0.0
<a href=/player/reule101>reule101</a>,Ed Reulbach,Chicago Cubs,CUBS,1,1,2,3,1913,1915,2,No,0,5.81,-0.82,-6.63,118,36,-82,128,23,-105,1107.0,201.0,-906.0,3500.0,0.0,-3500.0
<a href=/player/reusj001>reusj001</a>,Jerry Reuss,St. Louis Cardinals,CARDS,4,5,5,10,1972,1974,2,No,0,2.19,2.3,0.11,180,169,-11,181,146,-35,1620.0,735.0,-885.0,0.0,0.0,0.0
<a href=/player/reusj001>reusj001</a>,Jerry Reuss,Houston Astros,ASTROS,7,12,10,22,1973,1989,16,No,0,20.84,15.66,-5.18,1770,1925,155,3774,5378,1604,6401.0,1859.0,-4542.0,22500.0,0.0,-22500.0
<a href=/player/reusj001>reusj001</a>,Jerry Reuss,Pittsburgh Pirates,PIRATS,4,6,7,13,1979,2001,22,No,2,25.63,45.27,19.64,738,1278,540,589,2151,1562,5981.0,9557.0,3576.0,1290000.0,0.0,-1290000.0
<a href=/player/reusj001>reusj001</a>,Jerry Reuss,Chicago White Sox,WSOX,1,1,1,2,1989,1993,4,No,0,-0.25,0.65,0.9,7,38,31,0,0,0,101.0,129.0,28.0,590000.0,0.0,-590000.0
<a href=/player/reusp101>reusp101</a>,Paul Reuschel,Chicago Cubs,CUBS,1,1,1,2,1978,1978,0,No,0,0.9,0.0,-0.9,36,0,-36,0,0,0,405.0,0.0,-405.0,0.0,0.0,0.0
<a href=/player/reusr001>reusr001</a>,Rick Reuschel,Chicago Cubs,CUBS,5,6,7,13,1981,1988,7,No,0,0.14,5.19,5.05,134,774,640,169,808,639,507.0,2424.0,1917.0,490000.0,0.0,-490000.0
<a href=/player/reusr001>reusr001</a>,Rick Reuschel,Pittsburgh Pirates,PIRATS,2,3,3,6,1987,1995,8,No,0,8.61,9.74,1.13,246,761,515,229,1691,1462,2069.0,878.0,-1191.0,1500000.0,0.0,-1500000.0
<a href=/player/reveb001>reveb001</a>,Ben Revere,Minnesota Twins,TWINS,1,1,2,3,2012,2020,8,No,0,4.92,1.09,-3.83,335,236,-99,1350,4,-1346,0.0,1094.0,1094.0,492500.0,0.0,-492500.0
<a href=/player/reveb001>reveb001</a>,Ben Revere,Philadelphia Phillies,PHILS,2,2,3,5,2015,2016,1,Yes,0,0.5,0.0,-0.5,100,0,-100,246,0,-246,57.0,0.0,-57.0,4100000.0,0.0,-4100000.0
<a href=/player/reveb001>reveb001</a>,Ben Revere,Toronto Blue Jays,BJAYS,2,4,3,7,2016,2016,0,No,0,-0.69,0.9,1.59,124,68,-56,375,0,-375,55.0,171.0,116.0,0.0,0.0,0.0
<a href=/player/reved101>reved101</a>,Dave Revering,Cincinnati Reds,REDS,2,3,3,6,1978,1981,3,No,0,9.19,3.21,-5.98,618,452,-166,1598,32,-1566,417.0,994.0,577.0,0.0,0.0,0.0
<a href=/player/reved101>reved101</a>,Dave Revering,Oakland Athletics,ATLTCS,1,3,2,5,1981,1983,2,No,0,-0.62,1.11,1.73,74,210,136,201,288,87,0.0,1046.0,1046.0,0.0,0.0,0.0
<a href=/player/reved101>reved101</a>,Dave Revering,New York Yankees,YANKS,1,3,1,4,1982,1983,1,No,0,-0.79,-0.41,0.38,55,69,14,159,249,90,0.0,0.0,0.0,250000.0,0.0,-250000.0
<a href=/player/reyea001>reyea001</a>,Alberto Reyes,Milwaukee Brewers,BREWRS,1,1,1,2,1999,2001,2,No,0,-0.07,0.31,0.38,43,74,31,0,8,8,128.0,178.0,50.0,0.0,0.0,0.0
<a href=/player/reyea001>reyea001</a>,Alberto Reyes,Baltimore Orioles,ORLS,1,1,2,3,2000,2001,1,No,0,0.51,-0.89,-1.4,48,42,-6,4,0,-4,97.0,113.0,16.0,620000.0,0.0,-620000.0
<a href=/player/reyea002>reyea002</a>,Anthony Reyes,St. Louis Cardinals,CARDS,1,1,1,2,2008,2008,0,No,0,0.94,0.0,-0.94,15,0,-15,1,0,-1,218.0,0.0,-218.0,392500.0,0.0,-392500.0
<a href=/player/reyec001>reyec001</a>,Carlos Reyes,San Diego Padres,PADRS,4,8,7,15,1998,2002,4,No,0,4.23,0.82,-3.41,472,389,-83,1448,834,-614,139.0,215.0,76.0,3650000.0,0.0,-3650000.0
<a href=/player/reyed001>reyed001</a>,Dennys Reyes,Los Angeles Dodgers,DOGRS,1,2,1,3,1998,2001,3,No,0,-0.12,3.63,3.75,362,466,104,111,0,-111,591.0,706.0,115.0,170000.0,0.0,-170000.0
<a href=/player/reyed001>reyed001</a>,Dennys Reyes,Cincinnati Reds,REDS,1,2,2,4,2001,2006,5,No,0,0.51,2.6,2.09,83,248,165,0,53,53,121.0,683.0,562.0,3825000.0,0.0,-3825000.0
<a href=/player/reyed001>reyed001</a>,Dennys Reyes,Colorado Rockies,ROCKS,2,3,4,7,2002,2003,1,No,0,-0.86,0.5,1.36,91,99,8,186,247,61,127.0,0.0,-127.0,3650000.0,0.0,-3650000.0
<a href=/player/reyef001>reyef001</a>,Franmil Reyes,San Diego Padres,PADRS,2,7,4,11,2019,2021,2,Yes,0,6.96,0.42,-6.54,597,36,-561,2267,75,-2192,192.0,42.0,-150.0,570500.0,0.0,-570500.0
<a href=/player/reyeg001>reyeg001</a>,Gil Reyes,Los Angeles Dodgers,DOGRS,1,1,1,2,1989,1989,0,No,0,0.98,-0.18,-1.16,87,4,-83,234,0,-234,0.0,10.0,10.0,0.0,0.0,0.0
<a href=/player/reyeg002>reyeg002</a>,Gerardo Reyes,Tampa Bay Devil Rays,RAYS,4,8,12,20,2014,2020,6,Yes,0,10.52,4.14,-6.38,1388,617,-771,4818,2218,-2600,195.0,136.0,-59.0,3254200.0,0.0,-3254200.0
<a href=/player/reyeg002>reyeg002</a>,Gerardo Reyes,San Diego Padres,PADRS,1,1,1,2,2020,2020,0,No,0,0.0,-0.16,-0.16,0,9,9,0,30,30,0.0,0.0,0.0,0.0,0.0,0.0
<a href=/player/reyej001>reyej001</a>,Jose Reyes,Miami Marlins,MARLNS,12,33,32,65,2012,2020,8,Yes,0,57.99,24.95,-33.04,3997,2605,-1392,9990,7444,-2546,7539.0,4278.0,-3261.0,66200000.0,0.0,-66200000.0
<a href=/player/reyej001>reyej001</a>,Jose Reyes,Toronto Blue Jays,BJAYS,1,4,2,6,2015,2018,3,No,0,-2.36,5.17,7.53,267,257,-10,284,987,703,875.0,49.0,-826.0,0.0,0.0,0.0
<a href=/player/reyej003>reyej003</a>,Jo-Jo Reyes,Atlanta Braves,BRAVES,2,5,5,10,2010,2015,5,No,0,10.05,1.22,-8.83,679,438,-241,1672,1292,-380,1064.0,60.0,-1004.0,1260000.0,0.0,-1260000.0
<a href=/player/reyev001>reyev001</a>,Victor Reyes,Atlanta Braves,BRAVES,1,1,1,2,2015,2015,0,No,0,0.0,0.0,0.0,0,0,0,0,0,0,0.0,0.0,0.0,0.0,0.0,0.0
<a href=/player/reyna001>reyna001</a>,Armando Reynoso,Colorado Rockies,ROCKS,1,1,1,2,1996,1999,3,No,0,1.87,5.31,3.44,53,402,349,63,17,-46,479.0,761.0,282.0,440000.0,0.0,-440000.0
<a href=/player/reyna101>reyna101</a>,Archie Reynolds,Chicago Cubs,CUBS,1,1,1,2,1970,1973,3,No,0,-0.31,1.84,2.15,30,92,62,2,66,64,82.0,541.0,459.0,10000.0,0.0,-10000.0
<a href=/player/reyna101>reyna101</a>,Archie Reynolds,California Angels,ANGELS,1,1,1,2,1972,1973,1,No,0,-0.86,0.01,0.87,10,42,32,4,44,40,56.0,0.0,-56.0,0.0,0.0,0.0
<a href=/player/reyna102>reyna102</a>,Allie Reynolds,Cleveland Indians,INDINS,1,1,1,2,1946,1950,4,No,0,20.32,19.02,-1.3,609,566,-43,677,2321,1644,5099.0,0.0,-5099.0,0.0,0.0,0.0
<a href=/player/reynb001>reynb001</a>,Bryan Reynolds,San Francisco Giants,GIANTS,3,8,5,13,2018,2020,2,No,0,12.26,2.28,-9.98,738,296,-442,1562,1215,-347,600.0,0.0,-600.0,14750000.0,0.0,-14750000.0
<a href=/player/reynb102>reynb102</a>,Bob Reynolds,Montreal Expos,NATEX,2,3,4,7,1971,1976,5,No,0,33.25,2.72,-30.53,1490,246,-1244,6073,305,-5768,833.0,2154.0,1321.0,98500.0,0.0,-98500.0
<a href=/player/reynb102>reynb102</a>,Bob Reynolds,St. Louis Cardinals,CARDS,2,4,3,7,1971,1971,0,No,0,0.65,0.42,-0.23,128,32,-96,382,84,-298,18.0,0.0,-18.0,27000.0,0.0,-27000.0
<a href=/player/reynb102>reynb102</a>,Bob Reynolds,Milwaukee Brewers,BREWRS,2,3,2,5,1972,1972,0,No,0,3.49,-0.76,-4.25,151,16,-135,46,11,-35,588.0,56.0,-532.0,20500.0,0.0,-20500.0
<a href=/player/reynb102>reynb102</a>,Bob Reynolds,Baltimore Orioles,ORLS,3,3,3,6,1975,1979,4,No,0,-0.18,0.82,1.0,71,28,-43,15,0,-15,299.0,162.0,-137.0,0.0,0.0,0.0
<a href=/player/reync001>reync001</a>,Craig Reynolds,Pittsburgh Pirates,PIRATS,1,2,1,3,1976,1981,5,No,0,3.27,4.64,1.37,297,554,257,1099,51,-1048,0.0,1061.0,1061.0,0.0,0.0,0.0
<a href=/player/reync001>reync001</a>,Craig Reynolds,Seattle Mariners,MARNRS,4,4,4,8,1978,1987,9,No,1,9.7,14.18,4.48,1200,160,-1040,3726,0,-3726,112.0,2589.0,2477.0,0.0,0.0,0.0
<a href=/player/reync102>reync102</a>,Carl Reynolds,Chicago White Sox,WSOX,3,5,5,10,1931,1940,9,No,0,20.15,15.13,-5.02,1226,1402,176,4055,5150,1095,2296.0,2157.0,-139.0,35600.0,0.0,-35600.0
<a href=/player/reync102>reync102</a>,Carl Reynolds,Washington Senators,TWINS,3,6,5,11,1932,1936,4,No,0,25.58,12.35,-13.23,1434,628,-806,5873,2235,-3638,390.0,1249.0,859.0,38000.0,0.0,-38000.0
<a href=/player/reync102>reync102</a>,Carl Reynolds,St.Louis Browns,ORLS,16,31,40,71,1933,1952,19,No,0,66.46,76.95,10.49,3547,7518,3971,11156,22870,11714,6968.0,15393.0,8425.0,147000.0,0.0,-147000.0
<a href=/player/reync102>reync102</a>,Carl Reynolds,Boston Red Sox,RSOX,1,2,1,3,1935,1936,1,No,0,0.2,-0.88,-1.08,89,82,-7,318,334,16,0.0,0.0,0.0,16500.0,0.0,-16500.0
<a href=/player/reync102>reync102</a>,Carl Reynolds,Washington Senators,TWINS,1,3,1,4,1937,1940,3,No,0,0.0,-1.14,-1.14,0,124,124,0,429,429,0.0,0.0,0.0,0.0,0.0,0.0
<a href=/player/reyng001>reyng001</a>,Greg Reynolds,Colorado Rockies,ROCKS,1,1,1,2,2012,2012,0,No,0,0.0,0.0,0.0,0,0,0,0,0,0,0.0,0.0,0.0,0.0,0.0,0.0
<a href=/player/reynh001>reynh001</a>,Harold Reynolds,San Diego Padres,PADRS,1,1,1,2,1994,1994,0,No,0,-0.84,0.0,0.84,74,0,-74,235,0,-235,0.0,0.0,0.0,0.0,0.0,0.0
<a href=/player/reynk101>reynk101</a>,Ken Reynolds,Philadelphia Phillies,PHILS,1,3,1,4,1972,1973,1,No,0,-1.38,0.91,2.29,154,97,-57,334,364,30,133.0,0.0,-133.0,14500.0,0.0,-14500.0
<a href=/player/reynk101>reynk101</a>,Ken Reynolds,Minnesota Twins,TWINS,1,1,1,2,1973,1973,0,No,0,-0.16,0.0,0.16,2,0,-2,0,0,0,22.0,0.0,-22.0,0.0,0.0,0.0
<a href=/player/reynk101>reynk101</a>,Ken Reynolds,St. Louis Cardinals,CARDS,9,13,13,26,1976,1992,16,No,0,18.06,16.92,-1.14,1525,1431,-94,2979,3196,217,3633.0,4989.0,1356.0,1943333.0,0.0,-1943333.0
<a href=/player/reynm001>reynm001</a>,Mark Reynolds,Arizona Diamondbacks,DBACKS,1,2,2,4,2010,2015,5,No,0,1.04,1.11,0.07,290,493,203,1158,2,-1156,0.0,721.0,721.0,833333.0,0.0,-833333.0
<a href=/player/reynm002>reynm002</a>,Matt Reynolds,Colorado Rockies,ROCKS,1,1,1,2,2012,2014,2,No,0,0.75,-1.06,-1.81,93,59,-34,0,106,106,123.0,0.0,-123.0,481000.0,0.0,-481000.0
<a href=/player/reynr001>reynr001</a>,R.J. Reynolds,Los Angeles Dodgers,DOGRS,1,3,1,4,1985,1987,2,No,0,13.58,2.02,-11.56,1414,166,-1248,4553,618,-3935,0.0,0.0,0.0,0.0,0.0,0.0
<a href=/player/reynr002>reynr002</a>,Ronn Reynolds,New York Mets,METS,2,4,3,7,1986,1986,0,No,0,-0.05,0.0,0.05,49,0,-49,136,0,-136,44.0,0.0,-44.0,0.0,0.0,0.0
<a href=/player/reynr002>reynr002</a>,Ronn Reynolds,Philadelphia Phillies,PHILS,1,1,1,2,1987,1988,1,No,0,-0.99,1.02,2.01,38,90,52,107,1,-106,0.0,135.0,135.0,0.0,0.0,0.0
<a href=/player/reynt101>reynt101</a>,Tommie Reynolds,California Angels,ANGELS,4,6,5,11,1972,1976,4,No,0,2.71,3.85,1.14,491,218,-273,1603,746,-857,0.0,0.0,0.0,65500.0,0.0,-65500.0
<a href=/player/rhamj001>rhamj001</a>,Jacob Rhame,Los Angeles Dodgers,DOGRS,1,1,2,3,2017,2017,0,No,0,-0.54,-0.24,0.3,86,36,-50,1,132,131,143.0,0.0,-143.0,0.0,0.0,0.0
<a href=/player/rhawr101>rhawr101</a>,Bobby Rhawn,New York Giants,GIANTS,1,2,1,3,1949,1949,0,No,0,-0.71,0.46,1.17,25,74,49,18,18,0,108.0,241.0,133.0,0.0,0.0,0.0
<a href=/player/rhawr101>rhawr101</a>,Bobby Rhawn,Chicago White Sox,WSOX,11,27,22,49,1949,1963,14,No,0,23.73,52.27,28.54,4184,3723,-461,12734,12126,-608,4692.0,2309.0,-2383.0,109500.0,0.0,-109500.0
<a href=/player/rheij001>rheij001</a>,John Rheinecker,Oakland Athletics,ATLTCS,1,2,1,3,2006,2006,0,No,0,-0.32,0.0,0.32,45,0,-45,1,0,-1,363.0,0.0,-363.0,0.0,0.0,0.0
<a href=/player/rhinb101>rhinb101</a>,Billy Rhines,Cincinnati Reds,REDS,1,5,3,8,1897,1900,3,No,0,8.1,12.35,4.25,718,395,-323,2747,1335,-1412,936.0,1747.0,811.0,0.0,0.0,0.0
<a href=/player/rhoab101>rhoab101</a>,Bob Rhoads,Chicago Cubs,CUBS,2,2,3,5,1903,1913,10,No,0,-0.22,27.97,28.19,75,540,465,106,821,715,831.0,5582.0,4751.0,0.0,0.0,0.0
<a href=/player/rhoda001>rhoda001</a>,Arthur Rhodes,Oakland Athletics,ATLTCS,5,8,7,15,2004,2017,13,Yes,0,-1.43,13.16,14.59,290,983,693,344,2743,2399,707.0,801.0,94.0,17758194.0,0.0,-17758194.0
<a href=/player/rhoda001>rhoda001</a>,Arthur Rhodes,Pittsburgh Pirates,PIRATS,2,2,3,5,2004,2007,3,No,0,0.53,0.68,0.15,68,105,37,83,463,380,130.0,0.0,-130.0,7750000.0,0.0,-7750000.0
<a href=/player/rhoda001>rhoda001</a>,Arthur Rhodes,Cleveland Indians,INDINS,1,1,1,2,2006,2008,2,No,0,0.06,1.3,1.24,107,249,142,0,910,910,137.0,0.0,-137.0,0.0,0.0,0.0
<a href=/player/rhoda001>rhoda001</a>,Arthur Rhodes,Seattle Mariners,MARNRS,1,1,1,2,2008,2008,0,No,0,0.89,0.0,-0.89,50,0,-50,0,0,0,40.0,0.0,-40.0,0.0,0.0,0.0
<a href=/player/rhodg101>rhodg101</a>,Gordon Rhodes,New York Yankees,YANKS,1,1,1,2,1932,1934,2,No,0,6.06,-0.97,-7.03,251,90,-161,247,25,-222,2030.0,261.0,-1769.0,6000.0,0.0,-6000.0
<a href=/player/rhodg101>rhodg101</a>,Gordon Rhodes,Boston Red Sox,RSOX,2,4,3,7,1935,1946,11,No,0,-0.22,39.77,39.99,98,1215,1117,100,4433,4333,792.0,1354.0,562.0,15500.0,0.0,-15500.0
<a href=/player/rhodk001>rhodk001</a>,Tuffy Rhodes,Kansas City Royals,ROYALS,1,1,1,2,1993,1993,0,No,0,0.73,0.12,-0.61,123,12,-111,388,0,-388,0.0,42.0,42.0,0.0,0.0,0.0
<a href=/player/rhodr001>rhodr001</a>,Rick Rhoden,Los Angeles Dodgers,DOGRS,1,1,1,2,1979,1987,8,No,0,24.56,20.0,-4.56,442,506,64,546,496,-50,4344.0,4223.0,-121.0,0.0,0.0,0.0
<a href=/player/rhodr001>rhodr001</a>,Rick Rhoden,Pittsburgh Pirates,PIRATS,3,5,6,11,1986,2001,15,No,2,5.63,20.71,15.08,232,836,604,93,1605,1512,1758.0,5213.0,3455.0,1290000.0,0.0,-1290000.0
<a href=/player/rhodr001>rhodr001</a>,Rick Rhoden,New York Yankees,YANKS,1,1,3,4,1989,1990,1,No,0,-0.25,0.0,0.25,40,0,-40,31,0,-31,290.0,0.0,-290.0,0.0,0.0,0.0
<a href=/player/rhynh101>rhynh101</a>,Hal Rhyne,Boston Red Sox,RSOX,5,12,11,23,1932,1940,8,No,0,26.52,36.5,9.98,1813,1321,-492,6379,4051,-2328,2979.0,4057.0,1078.0,56000.0,0.0,-56000.0
<a href=/player/rhynh101>rhynh101</a>,Hal Rhyne,Chicago White Sox,WSOX,1,3,1,4,1934,1936,2,No,0,0.0,-0.14,-0.14,0,10,10,0,2,2,0.0,39.0,39.0,0.0,0.0,0.0
<a href=/player/ribad101>ribad101</a>,Dennis Ribant,Milwaukee Braves,BRAVES,1,2,1,3,1964,1965,1,No,0,3.71,-0.1,-3.81,148,10,-138,93,3,-90,844.0,37.0,-807.0,0.0,0.0,0.0
<a href=/player/ribad101>ribad101</a>,Dennis Ribant,New York Mets,METS,1,2,2,4,1966,1970,4,No,0,1.41,1.94,0.53,188,298,110,235,385,150,516.0,1427.0,911.0,0.0,0.0,0.0
<a href=/player/ribad101>ribad101</a>,Dennis Ribant,Pittsburgh Pirates,PIRATS,1,1,1,2,1967,1968,1,No,0,0.35,-0.31,-0.66,30,22,-8,6,4,-2,73.0,62.0,-11.0,20000.0,0.0,-20000.0
<a href=/player/ribad101>ribad101</a>,Dennis Ribant,Detroit Tigers,TIGRS,2,2,2,4,1968,1972,4,No,0,4.04,-1.09,-5.13,454,298,-156,42,558,516,1009.0,218.0,-791.0,24500.0,0.0,-24500.0
<a href=/player/ribad101>ribad101</a>,Dennis Ribant,St. Louis Cardinals,CARDS,1,1,1,2,1969,1969,0,No,0,-0.04,0.0,0.04,14,0,-14,0,0,0,25.0,0.0,-25.0,0.0,0.0,0.0
<a href=/player/ribad101>ribad101</a>,Dennis Ribant,Cincinnati Reds,REDS,1,1,1,2,1970,1970,0,No,0,0.0,0.04,0.04,0,6,6,0,2,2,0.0,24.0,24.0,0.0,0.0,0.0
<a href=/player/riccf101>riccf101</a>,Frank Riccelli,San Francisco Giants,GIANTS,1,1,1,2,1977,1979,2,No,0,0.0,-0.04,-0.04,0,73,73,0,208,208,0.0,0.0,0.0,0.0,0.0,0.0
<a href=/player/riccf101>riccf101</a>,Frank Riccelli,St. Louis Cardinals,CARDS,2,2,2,4,1978,1979,1,No,0,0.27,-0.06,-0.33,26,5,-21,6,4,-2,75.0,0.0,-75.0,0.0,0.0,0.0
<a href=/player/riced101>riced101</a>,Del Rice,St. Louis Cardinals,CARDS,2,2,2,4,1955,1956,1,No,0,0.26,0.16,-0.1,311,133,-178,959,303,-656,0.0,0.0,0.0,0.0,0.0,0.0
<a href=/player/riceh101>riceh101</a>,Harry Rice,St.Louis Browns,ORLS,22,44,51,95,1927,1952,25,No,0,139.77,131.99,-7.78,6854,9855,3001,22708,32907,10199,12609.0,15510.0,2901.0,213500.0,0.0,-213500.0
<a href=/player/riceh101>riceh101</a>,Harry Rice,Detroit Tigers,TIGRS,1,3,2,5,1930,1932,2,No,0,0.55,-1.14,-1.69,146,271,125,467,761,294,97.0,731.0,634.0,18000.0,0.0,-18000.0
<a href=/player/riceh101>riceh101</a>,Harry Rice,Washington Senators,TWINS,1,5,1,6,1931,1939,8,No,0,0.0,8.51,8.51,0,385,385,0,407,407,0.0,3095.0,3095.0,6500.0,0.0,-6500.0
<a href=/player/riceh102>riceh102</a>,Hal Rice,St. Louis Cardinals,CARDS,1,2,1,3,1953,1953,0,No,0,1.16,-0.38,-1.54,106,67,-39,401,55,-346,0.0,0.0,0.0,0.0,0.0,0.0
<a href=/player/riceh102>riceh102</a>,Hal Rice,Pittsburgh Pirates,PIRATS,1,1,1,2,1954,1954,0,No,0,-1.31,0.02,1.33,51,14,-37,81,14,-67,0.0,0.0,0.0,0.0,0.0,0.0
<a href=/player/richc001>richc001</a>,Chris Richard,St. Louis Cardinals,CARDS,3,6,6,12,2000,2009,9,No,0,25.91,31.82,5.91,1193,1089,-104,4738,3413,-1325,107.0,490.0,383.0,7200000.0,0.0,-7200000.0
<a href=/player/richc001>richc001</a>,Chris Richard,Baltimore Orioles,ORLS,1,1,1,2,2003,2004,1,No,0,-0.18,0.41,0.59,19,28,9,30,85,55,0.0,0.0,0.0,0.0,0.0,0.0
<a href=/player/richc002>richc002</a>,Clayton Richard,Chicago White Sox,WSOX,6,14,12,26,2009,2018,9,Yes,0,7.16,22.73,15.57,991,1029,38,935,3763,2828,4825.0,1688.0,-3137.0,13340000.0,0.0,-13340000.0
<a href=/player/richc002>richc002</a>,Clayton Richard,San Diego Padres,PADRS,1,2,1,3,2018,2018,0,Yes,0,-0.17,0.0,0.17,10,0,-10,0,0,0,136.0,0.0,-136.0,3000000.0,0.0,-3000000.0
<a href=/player/richd001>richd001</a>,Danny Richar,Arizona Diamondbacks,DBACKS,7,15,17,32,2007,2018,11,Yes,0,24.64,30.17,5.53,911,1190,279,1525,2038,513,6760.0,6326.0,-434.0,14741000.0,0.0,-14741000.0
<a href=/player/richd001>richd001</a>,Danny Richar,Chicago White Sox,WSOX,1,2,2,4,2008,2008,0,No,0,3.05,0.44,-2.61,495,41,-454,49,150,101,721.0,0.0,-721.0,396000.0,0.0,-396000.0
<a href=/player/richd002>richd002</a>,Dustin Richardson,Boston Red Sox,RSOX,2,2,2,4,2010,2021,11,No,0,0.96,16.82,15.86,24,336,312,0,33,33,60.0,3105.0,3045.0,1900000.0,0.0,-1900000.0
<a href=/player/richd101>richd101</a>,Danny Richardson,Washington Senators,WSN,3,4,9,13,1893,1905,12,No,0,19.9,18.4,-1.5,1093,647,-446,4528,2564,-1964,0.0,695.0,695.0,0.0,0.0,0.0
<a href=/player/richd103>richd103</a>,Don Richmond,St.Louis Browns,ORLS,2,2,2,4,1949,1955,6,No,0,-0.09,-2.29,-2.2,31,649,618,84,2646,2562,0.0,0.0,0.0,0.0,0.0,0.0
<a href=/player/richg101>richg101</a>,Gordie Richardson,St. Louis Cardinals,CARDS,1,2,2,4,1964,1964,0,No,0,0.92,0.0,-0.92,326,0,-326,777,0,-777,213.0,0.0,-213.0,0.0,0.0,0.0
<a href=/player/richj001>richj001</a>,Jeff Richardson,Cincinnati Reds,REDS,2,3,2,5,1990,1992,2,No,0,-1.08,-0.05,1.03,271,352,81,1090,1144,54,18.0,139.0,121.0,1600000.0,0.0,-1600000.0
<a href=/player/richj001>richj001</a>,Jeff Richardson,Pittsburgh Pirates,PIRATS,1,1,1,2,1993,1993,0,No,0,0.44,0.0,-0.44,15,0,-15,27,0,-27,0.0,0.0,0.0,0.0,0.0,0.0
<a href=/player/richj002>richj002</a>,Jeff Richardson,New York Mets,METS,2,3,2,5,1987,1987,0,No,1,0.01,-0.06,-0.07,1,6,5,0,5,5,1.0,37.0,36.0,0.0,0.0,0.0
<a href=/player/richk101>richk101</a>,Ken Richardson,Pittsburgh Pirates,PIRATS,1,1,2,3,1945,1947,2,No,0,-0.34,0.0,0.34,6,0,-6,20,0,-20,0.0,0.0,0.0,0.0,0.0,0.0
<a href=/player/richl101>richl101</a>,Lee Richard,Chicago White Sox,WSOX,1,1,2,3,1975,1976,1,No,0,-0.55,0.63,1.18,66,80,14,97,258,161,0.0,0.0,0.0,0.0,0.0,0.0
<a href=/player/richl102>richl102</a>,Lew Richie,Philadelphia Phillies,PHILS,13,27,30,57,1909,1931,22,No,0,110.35,96.74,-13.61,5407,5417,10,17248,19665,2417,13600.0,6282.0,-7318.0,25000.0,0.0,-25000.0
<a href=/player/richl102>richl102</a>,Lew Richie,Boston Braves,BRAVES,2,2,2,4,1910,1913,3,No,0,7.44,6.1,-1.34,378,510,132,532,2125,1593,2058.0,0.0,-2058.0,3600.0,0.0,-3600.0
<a href=/player/richl102>richl102</a>,Lew Richie,Chicago Cubs,CUBS,1,1,1,2,1913,1913,0,No,0,0.0,1.6,1.6,0,14,14,0,21,21,0.0,168.0,168.0,2500.0,0.0,-2500.0
<a href=/player/richl103>richl103</a>,Lance Richbourg,New York Giants,GIANTS,3,7,5,12,1921,1927,6,No,0,10.96,8.57,-2.39,1223,793,-430,4975,2790,-2185,0.0,87.0,87.0,29500.0,0.0,-29500.0
<a href=/player/richl103>richl103</a>,Lance Richbourg,Washington Senators,TWINS,8,20,12,32,1924,1941,17,No,0,54.71,71.12,16.41,4079,3032,-1047,12814,11321,-1493,8820.0,3821.0,-4999.0,95600.0,0.0,-95600.0
<a href=/player/richl103>richl103</a>,Lance Richbourg,Chicago Cubs,CUBS,2,7,3,10,1932,1941,9,No,0,3.2,27.52,24.32,621,896,275,1233,2014,781,2473.0,4458.0,1985.0,0.0,0.0,0.0
<a href=/player/richl103>richl103</a>,Lance Richbourg,Milwaukee,Milwaukee,3,3,7,10,1926,1927,1,No,0,6.43,0.0,-6.43,783,0,-783,3175,0,-3175,0.0,0.0,0.0,0.0,0.0,0.0
<a href=/player/richl103>richl103</a>,Lance Richbourg,Philadelphia Phillies,PHILS,1,2,1,3,1922,1922,0,No,0,0.0,-0.19,-0.19,0,6,6,0,21,21,0.0,0.0,0.0,0.0,0.0,0.0
<a href=/player/richm001>richm001</a>,Mike Richardt,Texas Rangers,RNGRS,1,1,1,2,1984,1985,1,No,0,0.0,0.56,0.56,16,104,88,15,272,257,0.0,0.0,0.0,0.0,0.0,0.0
<a href=/player/richn101>richn101</a>,Nolen Richardson,Baltimore,Baltimore,1,1,1,2,1938,1938,0,No,0,0.61,0.0,-0.61,36,0,-36,109,0,-109,0.0,0.0,0.0,0.0,0.0,0.0
<a href=/player/richp101>richp101</a>,Paul Richards,Philadelphia Athletics,ATLTCS,1,2,1,3,1935,1938,3,No,0,0.0,-2.17,-2.17,0,92,92,0,56,56,0.0,506.0,506.0,0.0,0.0,0.0
<a href=/player/richp102>richp102</a>,Pete Richert,Los Angeles Dodgers,DOGRS,4,12,9,21,1964,1984,20,No,0,57.0,60.48,3.48,4290,2463,-1827,14544,7259,-7285,4034.0,7191.0,3157.0,163000.0,0.0,-163000.0
<a href=/player/richp102>richp102</a>,Pete Richert,Washington Senators,RNGRS,17,30,33,63,1967,1992,25,No,2,71.79,40.62,-31.17,4013,2822,-1191,6770,7552,782,12905.0,5517.0,-7388.0,245000.0,0.0,-245000.0
<a href=/player/richp102>richp102</a>,Pete Richert,Baltimore Orioles,ORLS,11,23,23,46,1971,1994,23,No,3,52.46,87.15,34.69,2515,4565,2050,4845,10705,5860,11065.0,15470.0,4405.0,880333.0,0.0,-880333.0
<a href=/player/richp102>richp102</a>,Pete Richert,Los Angeles Dodgers,DOGRS,1,1,1,2,1973,1974,1,No,0,-0.11,0.0,0.11,26,0,-26,0,0,0,34.0,0.0,-34.0,0.0,0.0,0.0
<a href=/player/richr101>richr101</a>,Reggie Richter,Louisville,Louisville,1,1,1,2,1911,1911,0,No,0,-0.33,0.0,0.33,44,0,-44,10,0,-10,161.0,0.0,-161.0,0.0,0.0,0.0
<a href=/player/richr102>richr102</a>,Ray Richmond,St.Louis Browns,ORLS,1,1,1,2,1921,1921,0,No,0,0.0,-0.35,-0.35,0,6,6,0,1,1,0.0,17.0,17.0,0.0,0.0,0.0
<a href=/player/richt001>richt001</a>,Trevor Richards,Miami Marlins,MARLNS,1,2,2,4,2019,2020,1,Yes,0,1.9,-0.48,-2.38,73,53,-20,0,0,0,333.0,94.0,-239.0,1125000.0,0.0,-1125000.0
<a href=/player/richt001>richt001</a>,Trevor Richards,Tampa Bay Devil Rays,RAYS,1,2,2,4,2021,2021,0,Yes,0,3.81,2.17,-1.64,129,60,-69,414,3,-411,59.0,287.0,228.0,0.0,0.0,0.0
<a href=/player/richt001>richt001</a>,Trevor Richards,Milwaukee Brewers,BREWRS,1,2,1,3,2021,2021,0,Yes,0,0.58,0.23,-0.35,34,56,22,0,174,174,98.0,0.0,-98.0,0.0,0.0,0.0
<a href=/player/rickb101>rickb101</a>,Branch Rickey,St.Louis Browns,ORLS,1,1,1,2,1907,1907,0,No,0,-1.04,2.43,3.47,52,123,71,153,474,321,0.0,0.0,0.0,0.0,0.0,0.0
<a href=/player/rickb101>rickb101</a>,Branch Rickey,Milwaukee,Milwaukee,1,2,1,3,1906,1906,0,No,0,1.69,0.0,-1.69,67,0,-67,223,0,-223,0.0,0.0,0.0,0.0,0.0,0.0
<a href=/player/rickd101>rickd101</a>,Dick Ricketts,St. Louis Cardinals,CARDS,2,7,3,10,1960,1963,3,No,0,1.56,-0.35,-1.91,364,164,-200,1157,310,-847,0.0,0.0,0.0,0.0,0.0,0.0
<a href=/player/rickd102>rickd102</a>,Dave Ricketts,St. Louis Cardinals,CARDS,2,4,5,9,1969,1972,3,No,0,8.31,1.34,-6.97,834,199,-635,108,492,384,1854.0,0.0,-1854.0,17500.0,0.0,-17500.0
<a href=/player/rickm101>rickm101</a>,Marv Rickert,Cincinnati Reds,REDS,1,1,1,2,1948,1950,2,No,0,1.4,4.55,3.15,103,262,159,314,860,546,0.0,0.0,0.0,0.0,0.0,0.0
<a href=/player/ricof101>ricof101</a>,Fred Rico,Kansas City Royals,ROYALS,1,1,1,2,1970,1977,7,No,0,0.0,7.18,7.18,0,880,880,0,3354,3354,0.0,0.0,0.0,0.0,0.0,0.0
<a href=/player/ricof101>ricof101</a>,Fred Rico,St. Louis Cardinals,CARDS,1,2,1,3,1971,1972,1,No,0,0.0,0.65,0.65,0,20,20,0,1,1,0.0,38.0,38.0,0.0,0.0,0.0
<a href=/player/ricoh101>ricoh101</a>,Harry Riconda,Philadelphia Athletics,ATLTCS,3,9,5,14,1924,1935,11,No,0,15.67,38.22,22.55,391,1328,937,1453,5363,3910,735.0,0.0,-735.0,39667.0,0.0,-39667.0
<a href=/player/ricoh101>ricoh101</a>,Harry Riconda,Brooklyn Dodgers,DOGRS,1,2,1,3,1928,1934,6,No,0,0.53,8.54,8.01,100,434,334,99,1570,1471,677.0,0.0,-677.0,21000.0,0.0,-21000.0
<a href=/player/ricoh101>ricoh101</a>,Harry Riconda,Milwaukee,Milwaukee,2,2,4,6,1927,1927,0,No,0,-0.17,0.0,0.17,154,0,-154,514,0,-514,0.0,0.0,0.0,0.0,0.0,0.0
<a href=/player/ricoh101>ricoh101</a>,Harry Riconda,Boston Braves,BRAVES,1,3,1,4,1926,1931,5,No,0,0.0,6.6,6.6,0,629,629,0,2661,2661,0.0,0.0,0.0,8700.0,0.0,-8700.0
<a href=/player/riddd102>riddd102</a>,Denny Riddleberger,Pittsburgh Pirates,PIRATS,5,8,9,17,1970,1978,8,No,0,5.84,10.38,4.54,523,878,355,1285,1838,553,910.0,1701.0,791.0,94500.0,0.0,-94500.0
<a href=/player/riddd102>riddd102</a>,Denny Riddleberger,Texas Rangers,RNGRS,15,34,23,57,1971,1988,17,No,0,48.57,49.18,0.61,3015,3170,155,9911,9907,-4,4375.0,6620.0,2245.0,528000.0,0.0,-528000.0
<a href=/player/riddj101>riddj101</a>,Johnny Riddle,Indianapolis,Indianapolis,1,1,1,2,1937,1937,0,No,0,-0.01,0.0,0.01,8,0,-8,28,0,-28,0.0,0.0,0.0,0.0,0.0,0.0
<a href=/player/riddj101>riddj101</a>,Johnny Riddle,Boston Braves,BRAVES,6,18,10,28,1938,1952,14,No,0,22.0,33.53,11.53,1506,1625,119,5516,5420,-96,0.0,2449.0,2449.0,12500.0,0.0,-12500.0
<a href=/player/ridgj001>ridgj001</a>,Jeff Ridgway,Tampa Bay Devil Rays,RAYS,1,1,2,3,2008,2010,2,No,0,0.21,1.25,1.04,18,300,282,0,1007,1007,29.0,0.0,-29.0,0.0,0.0,0.0
<a href=/player/ridis001>ridis001</a>,Stephen Ridings,Chicago Cubs,CUBS,1,1,1,2,2019,2019,0,Yes,0,0.0,0.0,0.0,0,0,0,0,0,0,0.0,0.0,0.0,0.0,0.0,0.0
<a href=/player/ridzs101>ridzs101</a>,Steve Ridzik,Philadelphia Phillies,PHILS,2,4,4,8,1955,1957,2,No,0,8.43,2.22,-6.21,540,413,-127,1547,1258,-289,90.0,0.0,-90.0,15500.0,0.0,-15500.0
<a href=/player/riefc001>riefc001</a>,C.J. Riefenhauser,Tampa Bay Devil Rays,RAYS,2,5,4,9,2015,2018,3,Yes,0,-0.11,7.04,7.15,74,689,615,124,2370,2246,283.0,211.0,-72.0,508800.0,0.0,-508800.0
<a href=/player/riefc001>riefc001</a>,C.J. Riefenhauser,Seattle Mariners,MARNRS,1,2,1,3,2015,2015,0,Yes,0,1.72,0.0,-1.72,407,0,-407,1659,0,-1659,0.0,0.0,0.0,6900000.0,0.0,-6900000.0
<a href=/player/riena001>riena001</a>,Andre Rienzo,Chicago White Sox,WSOX,2,2,2,4,2014,2017,3,Yes,0,-0.03,2.32,2.35,59,173,114,2,0,-2,114.0,484.0,370.0,1400000.0,0.0,-1400000.0
<a href=/player/riesn001>riesn001</a>,Nikco Riesgo,San Diego Padres,PADRS,1,1,1,2,1990,1990,0,No,0,0.0,0.0,0.0,0,0,0,0,0,0,0.0,0.0,0.0,0.0,0.0,0.0
<a href=/player/riesn001>riesn001</a>,Nikco Riesgo,New York Mets,METS,1,2,1,3,1990,1991,1,No,0,0.0,-0.36,-0.36,0,97,97,0,306,306,0.0,0.0,0.0,0.0,0.0,0.0
<a href=/player/riesn001>riesn001</a>,Nikco Riesgo,Milwaukee Brewers,BREWRS,1,1,1,2,1993,1995,2,No,0,0.0,0.07,0.07,0,34,34,0,0,0,0.0,110.0,110.0,0.0,0.0,0.0
<a href=/player/rigbb001>rigbb001</a>,Brad Rigby,Oakland Athletics,ATLTCS,9,14,13,27,1999,2009,10,No,2,17.9,16.23,-1.67,1131,951,-180,1914,3253,1339,7029.0,1397.0,-5632.0,1148500.0,0.0,-1148500.0
<a href=/player/rigbb001>rigbb001</a>,Brad Rigby,Kansas City Royals,ROYALS,1,1,1,2,2000,2000,0,No,0,-0.18,-0.99,-0.81,12,16,4,1,3,2,16.0,171.0,155.0,220000.0,0.0,-220000.0
<a href=/player/rigdp001>rigdp001</a>,Paul Rigdon,Cleveland Indians,INDINS,3,6,5,11,2000,2007,7,No,0,13.63,7.12,-6.51,820,378,-442,2478,197,-2281,718.0,1361.0,643.0,5247000.0,0.0,-5247000.0
<a href=/player/riggj001>riggj001</a>,Jerrod Riggan,New York Mets,METS,3,9,8,17,2001,2008,7,No,0,12.43,-0.5,-12.93,1334,336,-998,2309,1012,-1297,1613.0,327.0,-1286.0,8000000.0,0.0,-8000000.0
<a href=/player/riggl101>riggl101</a>,Lew Riggs,Cincinnati Reds,REDS,1,1,1,2,1940,1941,1,No,0,2.1,-0.08,-2.18,148,4,-144,423,13,-410,0.0,0.0,0.0,5000.0,0.0,-5000.0
<a href=/player/righd001>righd001</a>,Dave Righetti,Texas Rangers,RNGRS,9,19,16,35,1978,1992,14,No,2,37.88,13.17,-24.71,1966,942,-1024,3128,2227,-901,8593.0,2130.0,-6463.0,0.0,0.0,0.0
<a href=/player/righr001>righr001</a>,Ron Rightnowar,Detroit Tigers,TIGRS,1,1,1,2,1993,1993,0,No,0,0.07,0.0,-0.07,34,0,-34,0,0,0,110.0,0.0,-110.0,0.0,0.0,0.0
<a href=/player/rignb101>rignb101</a>,Bill Rigney,Oakland,Oakland,1,1,1,2,1943,1945,2,No,0,7.72,0.0,-7.72,654,0,-654,2217,0,-2217,0.0,0.0,0.0,0.0,0.0,0.0
<a href=/player/rignt101>rignt101</a>,Topper Rigney,Boston Red Sox,RSOX,7,13,14,27,1927,1945,18,No,0,68.75,60.85,-7.9,3437,1957,-1480,13044,5029,-8015,4146.0,8828.0,4682.0,66000.0,0.0,-66000.0
<a href=/player/rijoj001>rijoj001</a>,Jose Rijo,New York Yankees,YANKS,3,7,8,15,1984,1993,9,No,0,53.43,36.99,-16.44,2484,1135,-1349,8455,3089,-5366,3002.0,2795.0,-207.0,2415000.0,0.0,-2415000.0
<a href=/player/rijoj001>rijoj001</a>,Jose Rijo,Oakland Athletics,ATLTCS,2,3,3,6,1987,1996,9,No,2,38.12,0.22,-37.9,775,350,-425,532,1011,479,4990.0,1220.0,-3770.0,0.0,0.0,0.0
<a href=/player/rikac101>rikac101</a>,Culley Rikard,Pittsburgh Pirates,PIRATS,1,2,1,3,1949,1951,2,No,0,0.0,1.3,1.3,0,93,93,0,314,314,0.0,0.0,0.0,0.0,0.0,0.0
<a href=/player/rilee001>rilee001</a>,Ernie Riles,Milwaukee Brewers,BREWRS,2,2,2,4,1988,1988,0,No,1,4.5,-1.09,-5.59,293,94,-199,722,398,-324,0.0,0.0,0.0,250000.0,0.0,-250000.0
<a href=/player/rilee001>rilee001</a>,Ernie Riles,San Francisco Giants,GIANTS,4,6,10,16,1990,1998,8,No,0,10.4,5.31,-5.09,419,752,333,768,2609,1841,1958.0,96.0,-1862.0,6502778.0,0.0,-6502778.0
<a href=/player/rileg001>rileg001</a>,George Riley,Philadelphia Phillies,PHILS,2,3,3,6,1984,1985,1,No,0,3.94,-0.28,-4.22,400,66,-334,337,103,-234,2374.0,85.0,-2289.0,0.0,0.0,0.0
<a href=/player/rileg001>rileg001</a>,George Riley,San Francisco Giants,GIANTS,1,2,1,3,1985,1986,1,No,0,-0.44,0.85,1.29,34,78,44,46,40,-6,26.0,424.0,398.0,0.0,0.0,0.0
<a href=/player/rilem001>rilem001</a>,Matt Riley,Baltimore Orioles,ORLS,1,1,1,2,2005,2005,0,No,0,-0.55,0.16,0.71,7,7,0,0,15,15,38.0,0.0,-38.0,0.0,0.0,0.0
<a href=/player/rincr001>rincr001</a>,Ricardo Rincon,Pittsburgh Pirates,PIRATS,7,9,16,25,1998,2016,18,No,0,32.02,54.18,22.16,1891,3677,1786,4995,11200,6205,2597.0,4751.0,2154.0,29739833.0,0.0,-29739833.0
<a href=/player/rincr001>rincr001</a>,Ricardo Rincon,Cleveland Indians,INDINS,1,1,1,2,2002,2002,0,No,0,2.72,0.0,-2.72,233,0,-233,0,0,0,471.0,0.0,-471.0,1500000.0,0.0,-1500000.0
<a href=/player/ringj101>ringj101</a>,Jimmy Ring,Cincinnati Reds,REDS,1,2,1,3,1920,1920,0,No,0,12.54,0.0,-12.54,460,0,-460,635,0,-635,4385.0,0.0,-4385.0,11000.0,0.0,-11000.0
<a href=/player/ringj101>ringj101</a>,Jimmy Ring,Philadelphia Phillies,PHILS,1,1,2,3,1925,1927,2,No,0,-1.47,-0.68,0.79,78,183,105,60,367,307,550.0,696.0,146.0,7000.0,0.0,-7000.0
<a href=/player/ringj101>ringj101</a>,Jimmy Ring,New York Giants,GIANTS,4,6,5,11,1926,1932,6,No,0,44.88,18.94,-25.94,1758,1119,-639,7309,4215,-3094,99.0,0.0,-99.0,24000.0,0.0,-24000.0
<a href=/player/ringj101>ringj101</a>,Jimmy Ring,St. Louis Cardinals,CARDS,1,2,3,5,1927,1928,1,No,0,-1.19,0.0,1.19,135,0,-135,192,0,-192,529.0,0.0,-529.0,13300.0,0.0,-13300.0
<a href=/player/ringr001>ringr001</a>,Royce Ring,Chicago White Sox,WSOX,1,3,2,5,2003,2003,0,No,0,-0.24,0.07,0.31,72,67,-5,1,296,295,104.0,0.0,-104.0,0.0,0.0,0.0
<a href=/player/ringr001>ringr001</a>,Royce Ring,New York Mets,METS,1,2,2,4,2006,2008,2,No,0,8.55,-0.17,-8.72,723,11,-712,2,30,28,1167.0,3.0,-1164.0,0.0,0.0,0.0
<a href=/player/ringr001>ringr001</a>,Royce Ring,San Diego Padres,PADRS,1,1,2,3,2007,2008,1,No,0,-1.08,-0.32,0.76,103,68,-35,0,14,14,82.0,206.0,124.0,0.0,0.0,0.0
<a href=/player/riosa001>riosa001</a>,Armando Rios,San Francisco Giants,GIANTS,4,5,6,11,2001,2013,12,No,2,-2.21,26.82,29.03,411,647,236,569,1403,834,1088.0,3414.0,2326.0,310000.0,0.0,-310000.0
<a href=/player/riosa002>riosa002</a>,Alex Rios,Chicago White Sox,WSOX,1,1,1,2,2013,2021,8,No,0,1.24,5.21,3.97,178,581,403,718,2030,1312,0.0,6.0,6.0,0.0,0.0,0.0
<a href=/player/ripla101>ripla101</a>,Allen Ripley,San Francisco Giants,GIANTS,1,1,1,2,1981,1982,1,No,0,0.62,0.0,-0.62,56,0,-56,40,0,-40,368.0,0.0,-368.0,0.0,0.0,0.0
<a href=/player/rippj101>rippj101</a>,Jimmy Ripple,New York Giants,GIANTS,1,1,1,2,1939,1940,1,No,0,0.6,-0.08,-0.68,35,5,-30,135,14,-121,0.0,0.0,0.0,8000.0,0.0,-8000.0
<a href=/player/rippj101>rippj101</a>,Jimmy Ripple,St. Louis Cardinals,CARDS,2,2,3,5,1942,1944,2,No,0,-0.32,0.32,0.64,66,4,-62,303,2,-301,0.0,21.0,21.0,0.0,0.0,0.0
<a href=/player/rippj101>rippj101</a>,Jimmy Ripple,Toronto,Toronto,1,1,1,2,1943,1943,0,No,0,-0.63,0.0,0.63,32,0,-32,138,0,-138,0.0,0.0,0.0,0.0,0.0,0.0
<a href=/player/rippj101>rippj101</a>,Jimmy Ripple,Pittsburgh Pirates,PIRATS,1,1,1,2,1943,1943,0,No,0,-0.63,0.0,0.63,32,0,-32,138,0,-138,0.0,0.0,0.0,0.0,0.0,0.0
<a href=/player/riskd001>riskd001</a>,David Riske,Cleveland Indians,INDINS,2,4,6,10,2006,2011,5,No,0,6.08,6.32,0.24,533,659,126,1913,1893,-20,29.0,785.0,756.0,1950000.0,0.0,-1950000.0
<a href=/player/riskd001>riskd001</a>,David Riske,Boston Red Sox,RSOX,1,1,1,2,2006,2009,3,No,0,0.55,2.51,1.96,37,182,145,0,1,1,103.0,385.0,282.0,1800000.0,0.0,-1800000.0
<a href=/player/rislb001>rislb001</a>,Bill Risley,Cincinnati Reds,REDS,5,7,10,17,1991,2006,15,No,0,8.76,8.38,-0.38,1127,1227,100,1121,3011,1890,1371.0,1423.0,52.0,12068333.0,0.0,-12068333.0
<a href=/player/rislb001>rislb001</a>,Bill Risley,Seattle Mariners,MARNRS,2,3,3,6,1995,1997,2,No,0,0.75,-0.72,-1.47,99,11,-88,44,0,-44,434.0,126.0,-308.0,135000.0,0.0,-135000.0
<a href=/player/ritcc101>ritcc101</a>,Claude Ritchey,Cincinnati Reds,REDS,2,5,2,7,1898,1898,0,No,0,7.73,2.21,-5.52,627,66,-561,2681,105,-2576,267.0,786.0,519.0,0.0,0.0,0.0
<a href=/player/ritcc101>ritcc101</a>,Claude Ritchey,Louisville Colonels,LS3,1,12,5,17,1899,1900,1,No,0,267.1,0.0,-267.1,7388,0,-7388,29004,0,-29004,7568.0,0.0,-7568.0,4350.0,0.0,-4350.0
<a href=/player/ritcc101>ritcc101</a>,Claude Ritchey,Pittsburgh Pirates,PIRATS,1,3,1,4,1906,1910,4,No,0,14.38,6.11,-8.27,866,332,-534,3143,1286,-1857,1417.0,0.0,-1417.0,0.0,0.0,0.0
<a href=/player/ritcj101>ritcj101</a>,Jay Ritchie,Boston Red Sox,RSOX,1,3,2,5,1965,1968,3,No,0,0.78,1.64,0.86,187,156,-31,154,15,-139,353.0,393.0,40.0,0.0,0.0,0.0
<a href=/player/ritcj101>ritcj101</a>,Jay Ritchie,Atlanta Braves,BRAVES,1,3,1,4,1967,1968,1,No,0,0.5,-0.77,-1.27,233,127,-106,406,383,-23,170.0,0.0,-170.0,0.0,0.0,0.0
<a href=/player/ritct001>ritct001</a>,Todd Ritchie,Pittsburgh Pirates,PIRATS,3,4,5,9,2001,2010,9,No,0,-1.67,7.92,9.59,31,815,784,5,714,709,425.0,4763.0,4338.0,6485333.0,0.0,-6485333.0
<a href=/player/rittj101>rittj101</a>,Jim Rittwage,Kansas City Athletics,ATLTCS,10,22,14,36,1965,1976,11,No,0,26.85,38.2,11.35,3876,2816,-1060,8514,9189,675,4493.0,1098.0,-3395.0,362100.0,0.0,-362100.0
<a href=/player/rittj101>rittj101</a>,Jim Rittwage,Cleveland Indians,INDINS,1,1,1,2,1973,1973,0,No,0,0.0,0.0,0.0,0,0,0,0,0,0,0.0,0.0,0.0,0.0,0.0,0.0
<a href=/player/rivaa001>rivaa001</a>,Alfonso Rivas,Oakland Athletics,ATLTCS,1,1,1,2,2020,2020,0,Yes,0,0.09,-0.21,-0.3,18,49,31,49,114,65,0.0,0.0,0.0,0.0,0.0,0.0
<a href=/player/riveb001>riveb001</a>,Ben Rivera,Atlanta Braves,BRAVES,2,4,2,6,1992,1997,5,No,0,1.53,11.08,9.55,307,636,329,453,2705,2252,1014.0,0.0,-1014.0,109000.0,0.0,-109000.0
<a href=/player/rivef001>rivef001</a>,Felipe Vazquez,Tampa Bay Devil Rays,RAYS,3,8,5,13,2014,2018,4,Yes,0,0.49,9.21,8.72,459,720,261,782,2375,1593,577.0,688.0,111.0,508800.0,0.0,-508800.0
<a href=/player/rivef001>rivef001</a>,Felipe Vazquez,Washington Nationals,NATEX,1,2,1,3,2016,2016,0,No,0,7.25,1.19,-6.06,436,60,-376,3,0,-3,698.0,89.0,-609.0,0.0,0.0,0.0
<a href=/player/riveg001>riveg001</a>,German Rivera,Los Angeles Dodgers,DOGRS,1,2,1,3,1985,1986,1,No,0,-0.17,0.39,0.56,15,164,149,41,506,465,3.0,0.0,-3.0,0.0,0.0,0.0
<a href=/player/rivej001>rivej001</a>,Juan Rivera,New York Yankees,YANKS,8,19,13,32,2003,2014,11,Yes,2,26.42,21.86,-4.56,2170,1008,-1162,5379,2872,-2507,5079.0,2402.0,-2677.0,1920525.0,0.0,-1920525.0
<a href=/player/rivej001>rivej001</a>,Juan Rivera,Washington Nationals,NATEX,3,6,3,9,2004,2012,8,No,1,19.76,4.35,-15.41,1354,365,-989,5013,919,-4094,0.0,531.0,531.0,312000.0,0.0,-312000.0
<a href=/player/rivej001>rivej001</a>,Juan Rivera,Anaheim Angels,ANGELS,2,3,3,6,2011,2013,2,Yes,0,-0.32,-0.07,0.25,200,208,8,733,791,58,0.0,0.0,0.0,0.0,0.0,0.0
<a href=/player/rivej101>rivej101</a>,Jim Rivera,Chicago White Sox,WSOX,2,6,4,10,1951,1963,12,No,0,1.43,25.02,23.59,363,1422,1059,910,5079,4169,614.0,0.0,-614.0,0.0,0.0,0.0
<a href=/player/rivej101>rivej101</a>,Jim Rivera,St.Louis Browns,ORLS,32,76,74,150,1952,1994,42,No,3,130.65,189.94,59.29,8445,12895,4450,19022,39022,20000,28431.0,18680.0,-9751.0,996333.0,0.0,-996333.0
<a href=/player/rivel001>rivel001</a>,Luis Rivera,Montreal Expos,NATEX,2,3,4,7,1988,1992,4,No,2,6.16,6.42,0.26,597,552,-45,1669,1976,307,1455.0,0.0,-1455.0,132500.0,0.0,-132500.0
<a href=/player/rivel002>rivel002</a>,Luis Rivera,Atlanta Braves,BRAVES,1,3,2,5,2000,2002,2,No,0,-0.42,1.16,1.58,107,214,107,224,759,535,2.0,6.0,4.0,800000.0,0.0,-800000.0
<a href=/player/rivem001>rivem001</a>,Mickey Rivers,Atlanta Braves,BRAVES,1,2,2,4,1969,1970,1,No,0,9.24,2.87,-6.37,457,118,-339,1833,14,-1819,0.0,278.0,278.0,0.0,0.0,0.0
<a href=/player/rivem001>rivem001</a>,Mickey Rivers,California Angels,ANGELS,2,5,4,9,1975,1990,15,No,0,42.88,51.46,8.58,1084,1992,908,2703,8018,5315,7553.0,1336.0,-6217.0,175000.0,0.0,-175000.0
<a href=/player/rivem001>rivem001</a>,Mickey Rivers,New York Yankees,YANKS,20,48,38,86,1979,2001,22,No,2,75.03,66.03,-9.0,5348,4915,-433,15166,15462,296,12396.0,4403.0,-7993.0,3694706.0,0.0,-3694706.0
<a href=/player/rivem003>rivem003</a>,Mike Rivera,Detroit Tigers,TIGRS,1,1,1,2,2002,2003,1,No,0,-0.41,-0.58,-0.17,19,39,20,58,140,82,0.0,0.0,0.0,200000.0,0.0,-200000.0
<a href=/player/river002>river002</a>,Ruben Rivera,New York Yankees,YANKS,11,24,18,42,1997,2013,16,Yes,1,32.6,51.23,18.63,1993,1981,-12,3061,4822,1761,8275.0,6854.0,-1421.0,22173073.0,0.0,-22173073.0
<a href=/player/river003>river003</a>,Rene Rivera,San Diego Padres,PADRS,3,7,6,13,2014,2020,6,Yes,0,-1.53,-1.48,0.05,295,146,-149,1021,301,-720,0.0,78.0,78.0,506400.0,0.0,-506400.0
<a href=/player/rives001>rives001</a>,Saul Rivera,New York Mets,METS,1,4,3,7,2002,2005,3,No,0,2.12,1.12,-1.0,505,185,-320,25,27,2,939.0,263.0,-676.0,300000.0,0.0,-300000.0
<a href=/player/rives001>rives001</a>,Saul Rivera,Montreal Expos,NATEX,1,2,2,4,2004,2004,0,No,0,0.0,0.0,0.0,0,0,0,0,0,0,0.0,0.0,0.0,300000.0,0.0,-300000.0
<a href=/player/rixee101>rixee101</a>,Eppa Rixey,Philadelphia Phillies,PHILS,2,2,4,6,1920,1927,7,No,0,38.6,13.39,-25.21,958,573,-385,1160,941,-219,9219.0,4552.0,-4667.0,12000.0,0.0,-12000.0
<a href=/player/rizza001>rizza001</a>,Anthony Rizzo,San Diego Padres,PADRS,5,14,11,25,2012,2021,9,Yes,0,38.08,3.36,-34.72,1863,479,-1384,6550,569,-5981,976.0,2402.0,1426.0,10660200.0,0.0,-10660200.0
<a href=/player/rizza001>rizza001</a>,Anthony Rizzo,Boston Red Sox,RSOX,8,26,15,41,2010,2019,9,Yes,0,35.43,29.06,-6.37,2876,1721,-1155,5076,5808,732,4841.0,1908.0,-2933.0,4708000.0,0.0,-4708000.0
<a href=/player/rizza001>rizza001</a>,Anthony Rizzo,Chicago Cubs,CUBS,1,2,2,4,2021,2021,0,Yes,0,0.5,0.0,-0.5,49,0,-49,200,0,-200,0.0,0.0,0.0,16500000.0,0.0,-16500000.0
<a href=/player/rizzj101>rizzj101</a>,Johnny Rizzo,St. Louis Cardinals,CARDS,1,1,4,5,1937,1943,6,No,0,4.23,0.0,-4.23,246,0,-246,1035,0,-1035,0.0,0.0,0.0,0.0,0.0,0.0
<a href=/player/rizzj101>rizzj101</a>,Johnny Rizzo,Pittsburgh Pirates,PIRATS,3,3,3,6,1940,1946,6,No,0,3.24,14.06,10.82,164,805,641,641,2668,2027,0.0,666.0,666.0,0.0,0.0,0.0
<a href=/player/rizzj101>rizzj101</a>,Johnny Rizzo,Cincinnati Reds,REDS,1,1,1,2,1940,1940,0,No,0,2.66,0.41,-2.25,202,62,-140,672,226,-446,0.0,0.0,0.0,0.0,0.0,0.0
<a href=/player/roa-j001>roa-j001</a>,Joe Roa,Atlanta Braves,BRAVES,1,2,1,3,1991,1992,1,No,0,0.78,0.88,0.1,20,112,92,6,3,-3,71.0,184.0,113.0,165000.0,0.0,-165000.0
<a href=/player/roa-j001>roa-j001</a>,Joe Roa,New York Mets,METS,6,10,11,21,1994,1999,5,No,1,9.6,7.76,-1.84,747,954,207,324,289,-35,2209.0,3636.0,1427.0,6823000.0,0.0,-6823000.0
<a href=/player/roa-j001>roa-j001</a>,Joe Roa,Cleveland Indians,INDINS,3,6,6,12,1996,2001,5,No,0,40.02,3.44,-36.58,2173,212,-1961,7166,649,-6517,933.0,172.0,-761.0,7541666.0,0.0,-7541666.0
<a href=/player/roacd001>roacd001</a>,Donn Roach,Anaheim Angels,ANGELS,2,3,2,5,2012,2014,2,No,0,0.27,1.16,0.89,644,214,-430,1673,0,-1673,125.0,563.0,438.0,481000.0,0.0,-481000.0
<a href=/player/roacm101>roacm101</a>,Mel Roach,Milwaukee Braves,BRAVES,2,3,3,6,1961,1964,3,No,0,3.27,3.41,0.14,400,209,-191,1398,698,-700,0.0,0.0,0.0,0.0,0.0,0.0
<a href=/player/roacm101>roacm101</a>,Mel Roach,Chicago Cubs,CUBS,1,1,2,3,1961,1961,0,No,0,0.0,0.0,0.0,0,0,0,0,0,0,0.0,0.0,0.0,0.0,0.0,0.0
<a href=/player/roacm101>roacm101</a>,Mel Roach,Cleveland Indians,INDINS,2,2,3,5,1962,1966,4,No,0,-1.42,-0.53,0.89,65,52,-13,111,71,-40,0.0,0.0,0.0,0.0,0.0,0.0
<a href=/player/roacr101>roacr101</a>,Roxey Roach,JerseyCity,JerseyCity,2,2,3,5,1912,1916,4,No,0,0.41,0.0,-0.41,72,0,-72,284,0,-284,0.0,0.0,0.0,0.0,0.0,0.0
<a href=/player/roarm101>roarm101</a>,Mike Roarke,Milwaukee Braves,BRAVES,1,3,2,5,1959,1961,2,No,0,-0.44,0.34,0.78,224,49,-175,615,163,-452,0.0,0.0,0.0,0.0,0.0,0.0
<a href=/player/roart001>roart001</a>,Tanner Roark,Texas Rangers,RNGRS,1,2,1,3,2010,2010,0,No,0,17.02,-0.67,-17.69,353,15,-338,317,50,-267,2805.0,0.0,-2805.0,0.0,0.0,0.0
<a href=/player/roart001>roart001</a>,Tanner Roark,Washington Nationals,NATEX,1,1,1,2,2018,2018,0,Yes,0,1.75,0.0,-1.75,40,0,-40,34,0,-34,331.0,0.0,-331.0,6475000.0,0.0,-6475000.0
<a href=/player/roart001>roart001</a>,Tanner Roark,Cincinnati Reds,REDS,3,6,4,10,2019,2021,2,Yes,0,1.28,0.31,-0.97,105,46,-59,0,0,0,303.0,64.0,-239.0,10000000.0,0.0,-10000000.0
<a href=/player/robea001>robea001</a>,Andre Robertson,New York Yankees,YANKS,1,2,2,4,1986,1988,2,No,0,1.46,3.1,1.64,271,317,46,976,1061,85,0.0,0.0,0.0,1050000.0,0.0,-1050000.0
<a href=/player/robeb001>robeb001</a>,Bert Roberge,Chicago White Sox,WSOX,1,1,1,2,1984,1986,2,No,0,-0.28,1.15,1.43,126,93,-33,3,262,259,290.0,0.0,-290.0,0.0,0.0,0.0
<a href=/player/robeb002>robeb002</a>,Bip Roberts,San Diego Padres,PADRS,1,2,1,3,1991,1992,1,No,0,4.78,-0.97,-5.75,230,132,-98,937,8,-929,0.0,239.0,239.0,675000.0,0.0,-675000.0
<a href=/player/robeb002>robeb002</a>,Bip Roberts,San Diego Padres,PADRS,3,6,6,12,1995,2006,11,No,1,5.59,24.83,19.24,564,1458,894,2040,5766,3726,0.0,4.0,4.0,10951680.0,0.0,-10951680.0
<a href=/player/robeb002>robeb002</a>,Bip Roberts,Kansas City Royals,ROYALS,1,1,1,2,1997,1997,0,No,0,0.19,0.01,-0.18,23,1,-22,96,0,-96,0.0,6.0,6.0,1950000.0,0.0,-1950000.0
<a href=/player/robeb002>robeb002</a>,Bip Roberts,Detroit Tigers,TIGRS,1,1,1,2,1998,1999,1,No,0,1.23,-0.21,-1.44,61,37,-24,201,73,-128,0.0,0.0,0.0,2300000.0,0.0,-2300000.0
<a href=/player/robec002>robec002</a>,Connor Robertson,Oakland Athletics,ATLTCS,15,28,26,54,2007,2018,11,Yes,0,108.14,27.37,-80.77,6020,2116,-3904,18233,6199,-12034,5643.0,3558.0,-2085.0,32617500.0,0.0,-32617500.0
<a href=/player/robec002>robec002</a>,Connor Robertson,Arizona Diamondbacks,DBACKS,1,1,1,2,2008,2009,1,No,0,0.0,-0.7,-0.7,0,87,87,0,0,0,0.0,72.0,72.0,0.0,0.0,0.0
<a href=/player/robec102>robec102</a>,Curt Roberts,Pittsburgh Pirates,PIRATS,1,2,1,3,1956,1956,0,No,0,-0.27,-0.37,-0.1,46,11,-35,14,41,27,185.0,0.0,-185.0,0.0,0.0,0.0
<a href=/player/robec102>robec102</a>,Curt Roberts,Kansas City Athletics,ATLTCS,38,80,81,161,1957,1976,19,No,0,137.3,59.64,-77.66,12943,8836,-4107,29783,24655,-5128,18720.0,9434.0,-9286.0,506100.0,0.0,-506100.0
<a href=/player/robed001>robed001</a>,Dave Roberts,Detroit Tigers,TIGRS,1,2,1,3,1998,1998,0,No,0,0.14,-0.51,-0.65,78,52,-26,182,145,-37,16.0,0.0,-16.0,1000000.0,0.0,-1000000.0
<a href=/player/robed001>robed001</a>,Dave Roberts,Cleveland Indians,INDINS,1,1,2,3,2001,2001,0,No,0,4.7,0.0,-4.7,302,0,-302,1189,0,-1189,0.0,0.0,0.0,212000.0,0.0,-212000.0
<a href=/player/robed001>robed001</a>,Dave Roberts,Los Angeles Dodgers,DOGRS,1,1,1,2,2004,2004,0,No,0,0.31,0.0,-0.31,45,0,-45,101,0,-101,0.0,0.0,0.0,975000.0,0.0,-975000.0
<a href=/player/robed001>robed001</a>,Dave Roberts,Boston Red Sox,RSOX,4,5,7,12,2004,2010,6,No,0,7.49,1.65,-5.84,501,423,-78,2029,1001,-1028,0.0,155.0,155.0,4200000.0,0.0,-4200000.0
<a href=/player/robed002>robed002</a>,David Robertson,Chicago White Sox,WSOX,2,4,5,9,2017,2017,0,Yes,0,4.16,0.5,-3.66,327,12,-315,241,0,-241,693.0,30.0,-663.0,12535000.0,0.0,-12535000.0
<a href=/player/robed003>robed003</a>,Daniel Robertson,Texas Rangers,RNGRS,1,1,1,2,2014,2014,0,No,0,0.62,0.0,-0.62,37,0,-37,80,0,-80,0.0,0.0,0.0,0.0,0.0,0.0
<a href=/player/robed004>robed004</a>,Daniel Robertson,Oakland Athletics,ATLTCS,7,12,9,21,2015,2018,3,Yes,0,7.5,-0.52,-8.02,615,193,-422,2031,464,-1567,103.0,312.0,209.0,8300001.0,0.0,-8300001.0
<a href=/player/robed101>robed101</a>,Dave Roberts,San Diego Padres,PADRS,5,6,9,15,1971,1982,11,No,0,11.48,-0.86,-12.34,888,1750,862,1831,3554,1723,3035.0,3400.0,365.0,0.0,0.0,0.0
<a href=/player/robed101>robed101</a>,Dave Roberts,Houston Astros,ASTROS,6,11,9,20,1975,1989,14,No,0,10.73,12.05,1.32,1452,1687,235,3403,4505,1102,3386.0,1859.0,-1527.0,22500.0,0.0,-22500.0
<a href=/player/robed101>robed101</a>,Dave Roberts,San Francisco Giants,GIANTS,13,25,28,53,1979,1998,19,No,2,47.4,67.93,20.53,2735,4727,1992,5444,6225,781,5201.0,15628.0,10427.0,10639278.0,0.0,-10639278.0
<a href=/player/robed102>robed102</a>,Dave Roberts,Toronto Blue Jays,BJAYS,1,1,1,2,1977,1978,1,No,0,0.33,-0.06,-0.39,136,43,-93,314,0,-314,0.0,258.0,258.0,0.0,0.0,0.0
<a href=/player/robed102>robed102</a>,Dave Roberts,San Diego Padres,PADRS,5,12,10,22,1978,1989,11,No,0,40.51,8.43,-32.08,3264,1226,-2038,10982,3533,-7449,2009.0,1127.0,-882.0,475000.0,0.0,-475000.0
<a href=/player/robed102>robed102</a>,Dave Roberts,Houston Astros,ASTROS,1,1,1,2,1982,1982,0,No,0,-0.44,0.0,0.44,28,0,-28,36,0,-36,0.0,0.0,0.0,0.0,0.0,0.0
<a href=/player/robed103>robed103</a>,Dave Robertson,New York Giants,GIANTS,1,1,1,2,1919,1919,0,No,0,1.13,-0.26,-1.39,183,16,-167,691,16,-675,0.0,154.0,154.0,4968.0,0.0,-4968.0
<a href=/player/robed103>robed103</a>,Dave Robertson,Chicago Cubs,CUBS,3,9,6,15,1921,1926,5,No,0,30.51,10.96,-19.55,1180,383,-797,4349,729,-3620,1929.0,3229.0,1300.0,18586.0,0.0,-18586.0
<a href=/player/robed105>robed105</a>,Daryl Robertson,Milwaukee Braves,BRAVES,1,2,2,4,1961,1961,0,No,0,3.31,-0.59,-3.9,499,56,-443,1886,5,-1881,0.0,122.0,122.0,0.0,0.0,0.0
<a href=/player/robed105>robed105</a>,Daryl Robertson,Chicago Cubs,CUBS,5,10,7,17,1962,1977,15,No,0,11.99,38.79,26.8,728,2444,1716,383,6330,5947,3515.0,5246.0,1731.0,122500.0,0.0,-122500.0
<a href=/player/robed107>robed107</a>,Dale Roberts,New York Yankees,YANKS,1,2,1,3,1967,1970,3,No,0,0.07,0.93,0.86,226,220,-6,711,719,8,0.0,0.0,0.0,6000.0,0.0,-6000.0
<a href=/player/robeg101>robeg101</a>,Gene Robertson,StPaul,StPaul,1,1,1,2,1927,1927,0,No,0,1.2,0.0,-1.2,173,0,-173,624,0,-624,0.0,0.0,0.0,0.0,0.0,0.0
<a href=/player/robeg101>robeg101</a>,Gene Robertson,Boston Braves,BRAVES,1,2,1,3,1930,1932,2,No,0,0.0,-0.08,-0.08,0,129,129,0,512,512,0.0,0.0,0.0,5000.0,0.0,-5000.0
<a href=/player/robeg101>robeg101</a>,Gene Robertson,St.Louis Browns,ORLS,21,42,49,91,1926,1952,26,No,0,96.01,107.81,11.8,5218,9406,4188,17109,30707,13598,8613.0,15510.0,6897.0,200300.0,0.0,-200300.0
<a href=/player/robej001>robej001</a>,Jeriome Robertson,Houston Astros,ASTROS,2,6,2,8,2004,2009,5,No,0,10.31,7.34,-2.97,870,547,-323,1797,2103,306,1372.0,0.0,-1372.0,382000.0,0.0,-382000.0
<a href=/player/robej001>robej001</a>,Jeriome Robertson,Cleveland Indians,INDINS,1,1,1,2,2004,2004,0,No,0,0.0,0.0,0.0,0,0,0,0,0,0,0.0,0.0,0.0,0.0,0.0,0.0
<a href=/player/robej101>robej101</a>,Jim Roberts,LittleRock,LittleRock,1,1,2,3,1924,1925,1,No,0,-1.03,0.0,1.03,24,0,-24,8,0,-8,79.0,0.0,-79.0,0.0,0.0,0.0
<a href=/player/robej102>robej102</a>,Jerry Robertson,Montreal Expos,NATEX,1,1,1,2,1969,1969,0,No,0,0.06,0.0,-0.06,22,0,-22,0,0,0,44.0,0.0,-44.0,0.0,0.0,0.0
<a href=/player/robej102>robej102</a>,Jerry Robertson,Detroit Tigers,TIGRS,5,5,6,11,1971,1973,2,No,0,0.39,2.41,2.02,72,196,124,148,31,-117,36.0,772.0,736.0,0.0,0.0,0.0
<a href=/player/robej103>robej103</a>,Jim Robertson,New York Yankees,YANKS,16,45,38,83,1953,1970,17,No,0,48.62,78.17,29.55,7017,4726,-2291,22732,11340,-11392,3607.0,11554.0,7947.0,313000.0,0.0,-313000.0
<a href=/player/robej103>robej103</a>,Jim Robertson,Detroit Tigers,TIGRS,1,2,2,4,1956,1956,0,No,0,0.0,0.0,0.0,0,0,0,0,0,0,0.0,0.0,0.0,0.0,0.0,0.0
<a href=/player/robel001>robel001</a>,Leon Roberts,Detroit Tigers,TIGRS,1,4,3,7,1975,1979,4,No,0,4.11,5.38,1.27,431,290,-141,467,862,395,1859.0,1144.0,-715.0,16500.0,0.0,-16500.0
<a href=/player/robel001>robel001</a>,Leon Roberts,Houston Astros,ASTROS,3,3,3,6,1977,1983,6,No,0,10.17,0.2,-9.97,601,140,-461,1630,205,-1425,728.0,0.0,-728.0,0.0,0.0,0.0
<a href=/player/robel001>robel001</a>,Leon Roberts,Seattle Mariners,MARNRS,2,7,7,14,1980,1985,5,No,0,8.79,3.61,-5.18,489,434,-55,632,1358,726,2623.0,1017.0,-1606.0,175000.0,0.0,-175000.0
<a href=/player/robel001>robel001</a>,Leon Roberts,Toronto Blue Jays,BJAYS,1,1,1,2,1983,1988,5,No,0,0.46,0.26,-0.2,113,220,107,284,558,274,3.0,0.0,-3.0,0.0,0.0,0.0
<a href=/player/robem001>robem001</a>,Mike Robertson,Chicago White Sox,WSOX,1,1,1,2,1997,1997,0,No,0,-0.33,0.0,0.33,22,0,-22,41,0,-41,0.0,0.0,0.0,0.0,0.0,0.0
<a href=/player/roben001>roben001</a>,Nate Robertson,Florida Marlins,MARLNS,12,23,29,52,2003,2019,16,Yes,0,83.08,57.28,-25.8,2779,2940,161,6322,8392,2070,15065.0,6008.0,-9057.0,40718667.0,0.0,-40718667.0
<a href=/player/rober002>rober002</a>,Ryan Roberts,Arizona Diamondbacks,DBACKS,1,1,1,2,2012,2012,0,No,0,0.9,0.0,-0.9,120,0,-120,382,0,-382,0.0,0.0,0.0,2012500.0,0.0,-2012500.0
<a href=/player/robia101>robia101</a>,Aaron Robinson,New York Yankees,YANKS,2,4,2,6,1948,1956,8,No,0,8.14,18.41,10.27,334,437,103,647,602,-45,2224.0,4492.0,2268.0,0.0,0.0,0.0
<a href=/player/robia101>robia101</a>,Aaron Robinson,Chicago White Sox,WSOX,7,8,13,21,1948,1968,20,No,0,12.89,63.07,50.18,1237,2143,906,1679,2313,634,2300.0,11689.0,9389.0,31250.0,0.0,-31250.0
<a href=/player/robib101>robib101</a>,Bill Robinson,Atlanta Braves,BRAVES,1,2,1,3,1966,1971,5,No,0,-2.04,8.56,10.6,310,533,223,998,2105,1107,0.0,0.0,0.0,5500.0,0.0,-5500.0
<a href=/player/robib101>robib101</a>,Bill Robinson,New York Yankees,YANKS,1,1,1,2,1970,1970,0,No,0,0.0,0.0,0.0,0,0,0,0,0,0,0.0,0.0,0.0,0.0,0.0,0.0
<a href=/player/robib101>robib101</a>,Bill Robinson,Chicago White Sox,WSOX,1,1,1,2,1971,1971,0,No,0,2.12,0.0,-2.12,351,0,-351,1072,0,-1072,0.0,0.0,0.0,0.0,0.0,0.0
<a href=/player/robib101>robib101</a>,Bill Robinson,Philadelphia Phillies,PHILS,1,1,1,2,1975,1976,1,No,0,7.46,0.56,-6.9,805,14,-791,2649,10,-2639,0.0,92.0,92.0,0.0,0.0,0.0
<a href=/player/robib101>robib101</a>,Bill Robinson,Pittsburgh Pirates,PIRATS,2,2,2,4,1982,1983,1,No,0,-1.41,-0.58,0.83,117,40,-77,283,90,-193,0.0,0.0,0.0,0.0,0.0,0.0
<a href=/player/robic001>robic001</a>,Clint Robinson,Kansas City Royals,ROYALS,1,2,2,4,2012,2015,3,No,0,1.15,0.0,-1.15,120,0,-120,7,0,-7,252.0,0.0,-252.0,0.0,0.0,0.0
<a href=/player/robic002>robic002</a>,Chris Robinson,Detroit Tigers,TIGRS,1,1,1,2,2006,2007,1,No,0,0.0,-0.51,-0.51,0,54,54,0,141,141,0.0,0.0,0.0,0.0,0.0,0.0
<a href=/player/robic101>robic101</a>,Craig Robinson,Philadelphia Phillies,PHILS,1,2,1,3,1973,1977,4,No,0,-0.85,1.42,2.27,197,250,53,576,78,-498,0.0,1037.0,1037.0,0.0,0.0,0.0
<a href=/player/robic101>robic101</a>,Craig Robinson,Atlanta Braves,BRAVES,3,5,6,11,1975,1984,9,No,0,22.71,-0.2,-22.91,1673,1539,-134,5437,5141,-296,292.0,128.0,-164.0,0.0,0.0,0.0
<a href=/player/robic101>robic101</a>,Craig Robinson,San Francisco Giants,GIANTS,5,10,8,18,1976,1995,19,No,1,14.15,26.8,12.65,1367,2042,675,3556,6654,3098,4215.0,726.0,-3489.0,1545000.0,0.0,-1545000.0
<a href=/player/robid001>robid001</a>,Don Robinson,Pittsburgh Pirates,PIRATS,3,4,5,9,1987,1988,1,No,0,18.64,0.05,-18.59,1284,52,-1232,3306,126,-3180,2086.0,0.0,-2086.0,857500.0,0.0,-857500.0
<a href=/player/robid003>robid003</a>,Drew Robinson,Texas Rangers,RNGRS,1,1,1,2,2018,2019,1,No,0,-0.09,-0.25,-0.16,5,9,4,7,28,21,0.0,0.0,0.0,0.0,0.0,0.0
<a href=/player/robid101>robid101</a>,Dewey Robinson,Chicago White Sox,WSOX,1,2,1,3,1981,2007,26,No,0,0.0,0.0,0.0,0,0,0,0,0,0,0.0,0.0,0.0,0.0,0.0,0.0
<a href=/player/robie101>robie101</a>,Eddie Robinson,Cleveland Indians,INDINS,14,26,24,50,1948,1968,20,No,0,162.56,72.5,-90.06,7462,3103,-4359,23911,8852,-15059,13186.0,8500.0,-4686.0,30900.0,0.0,-30900.0
<a href=/player/robie101>robie101</a>,Eddie Robinson,Washington Senators,TWINS,12,23,24,47,1950,1963,13,No,0,21.31,19.51,-1.8,2117,2519,402,6320,5694,-626,2404.0,6282.0,3878.0,32000.0,0.0,-32000.0
<a href=/player/robie101>robie101</a>,Eddie Robinson,Chicago White Sox,WSOX,4,11,8,19,1953,1961,8,No,0,18.88,11.66,-7.22,2482,1258,-1224,8241,3866,-4375,2246.0,488.0,-1758.0,62000.0,0.0,-62000.0
<a href=/player/robie101>robie101</a>,Eddie Robinson,Philadelphia Athletics,ATLTCS,46,109,116,225,1953,1976,23,No,0,189.08,109.39,-79.69,16486,13560,-2926,40867,38903,-1964,20759.0,16429.0,-4330.0,546100.0,0.0,-546100.0
<a href=/player/robie101>robie101</a>,Eddie Robinson,New York Yankees,YANKS,3,5,6,11,1956,1960,4,No,0,1.84,-2.55,-4.39,364,104,-260,1055,53,-1002,0.0,406.0,406.0,4500.0,0.0,-4500.0
<a href=/player/robie101>robie101</a>,Eddie Robinson,Kansas City Athletics,ATLTCS,40,86,88,174,1956,1976,20,No,0,134.11,73.29,-60.82,13270,9412,-3858,30102,25264,-4838,19786.0,12575.0,-7211.0,506100.0,0.0,-506100.0
<a href=/player/robif102>robif102</a>,Floyd Robinson,Chicago White Sox,WSOX,1,1,1,2,1966,1966,0,No,0,-0.72,0.0,0.72,55,0,-55,145,0,-145,0.0,0.0,0.0,26000.0,0.0,-26000.0
<a href=/player/robif102>robif102</a>,Floyd Robinson,Cincinnati Reds,REDS,1,2,1,3,1967,1968,1,No,0,0.17,0.0,-0.17,59,0,-59,90,0,-90,17.0,0.0,-17.0,0.0,0.0,0.0
<a href=/player/robif103>robif103</a>,Frank Robinson,Cincinnati Reds,REDS,14,18,24,42,1965,1988,23,No,0,43.19,71.71,28.52,2283,5415,3132,7779,8902,1123,1546.0,11662.0,10116.0,75500.0,0.0,-75500.0
<a href=/player/robif103>robif103</a>,Frank Robinson,Baltimore Orioles,ORLS,11,23,23,46,1971,1994,23,No,3,52.46,87.15,34.69,2515,4565,2050,4845,10705,5860,11065.0,15470.0,4405.0,880333.0,0.0,-880333.0
<a href=/player/robif103>robif103</a>,Frank Robinson,Los Angeles Dodgers,DOGRS,1,5,2,7,1972,1976,4,No,0,16.6,19.03,2.43,596,356,-240,1923,542,-1381,1810.0,2591.0,781.0,251500.0,0.0,-251500.0
<a href=/player/robif103>robif103</a>,Frank Robinson,California Angels,ANGELS,1,1,3,4,1974,1977,3,No,0,0.94,0.32,-0.62,100,178,78,289,399,110,0.0,0.0,0.0,160000.0,0.0,-160000.0
<a href=/player/robih101>robih101</a>,Humberto Robinson,Milwaukee Braves,BRAVES,1,1,1,2,1959,1959,0,No,0,0.01,0.07,0.06,10,74,64,0,99,99,26.0,0.0,-26.0,0.0,0.0,0.0
<a href=/player/robih101>robih101</a>,Humberto Robinson,Cleveland Indians,INDINS,1,1,1,2,1959,1959,0,No,0,1.68,-0.35,-2.03,128,27,-101,23,69,46,368.0,0.0,-368.0,0.0,0.0,0.0
<a href=/player/robih102>robih102</a>,Hank Robinson,Pittsburgh Pirates,PIRATS,1,5,3,8,1913,1915,2,No,0,18.03,3.31,-14.72,1733,233,-1500,6155,938,-5217,795.0,0.0,-795.0,11400.0,0.0,-11400.0
<a href=/player/robij001>robij001</a>,Jeff Robinson,San Francisco Giants,GIANTS,1,2,1,3,1987,1991,4,No,0,-1.33,7.08,8.41,332,192,-140,71,229,158,980.0,1803.0,823.0,0.0,0.0,0.0
<a href=/player/robij001>robij001</a>,Jeff Robinson,Pittsburgh Pirates,PIRATS,1,2,1,3,1989,1995,6,No,0,1.53,10.25,8.72,54,475,421,0,1624,1624,266.0,0.0,-266.0,750000.0,0.0,-750000.0
<a href=/player/robij002>robij002</a>,Jeff Robinson,Detroit Tigers,TIGRS,1,1,1,2,1991,1994,3,No,0,-0.4,14.83,15.23,21,570,549,0,2343,2343,313.0,0.0,-313.0,0.0,0.0,0.0
<a href=/player/robij101>robij101</a>,Jack Robinson,New York Yankees,YANKS,1,2,2,4,1948,1948,0,No,0,0.1,0.0,-0.1,6,0,-6,0,0,0,12.0,0.0,-12.0,0.0,0.0,0.0
<a href=/player/robij103>robij103</a>,Jackie Robinson,Brooklyn Dodgers,DOGRS,1,1,2,3,1956,1958,2,No,0,0.0,0.0,0.0,0,0,0,0,0,0,0.0,0.0,0.0,31500.0,0.0,-31500.0
<a href=/player/robik002>robik002</a>,Kerry Robinson,Seattle Mariners,MARNRS,1,1,1,2,1999,2000,1,No,0,-0.06,0.16,0.22,9,13,4,1,0,-1,0.0,29.0,29.0,0.0,0.0,0.0
<a href=/player/robik002>robik002</a>,Kerry Robinson,St. Louis Cardinals,CARDS,1,1,1,2,2004,2004,0,No,0,-0.31,0.0,0.31,80,0,-80,101,0,-101,0.0,0.0,0.0,0.0,0.0,0.0
<a href=/player/robir001>robir001</a>,Ron Robinson,Cincinnati Reds,REDS,1,2,2,4,1990,1992,2,No,0,2.39,3.07,0.68,42,257,215,0,822,822,597.0,0.0,-597.0,500000.0,0.0,-500000.0
<a href=/player/robir101>robir101</a>,Rabbit Robinson,Cincinnati Reds,REDS,1,2,1,3,1910,1910,0,No,0,0.0,-0.59,-0.59,0,21,21,0,69,69,0.0,0.0,0.0,0.0,0.0,0.0
<a href=/player/robit001>robit001</a>,Trayvon Robinson,Los Angeles Dodgers,DOGRS,5,11,11,22,2011,2021,10,Yes,0,5.98,11.71,5.73,566,1023,457,1625,2754,1129,1807.0,632.0,-1175.0,21000000.0,0.0,-21000000.0
<a href=/player/robit001>robit001</a>,Trayvon Robinson,Seattle Mariners,MARNRS,2,2,2,4,2012,2013,1,No,0,0.0,-0.4,-0.4,0,29,29,0,85,85,0.0,0.0,0.0,0.0,0.0,0.0
<a href=/player/roblh001>roblh001</a>,Hansel Robles,Minnesota Twins,TWINS,1,1,1,2,2021,2021,0,Yes,0,0.49,0.0,-0.49,29,0,-29,0,0,0,75.0,0.0,-75.0,2000000.0,0.0,-2000000.0
<a href=/player/roblm001>roblm001</a>,Mauricio Robles,Detroit Tigers,TIGRS,1,2,1,3,2009,2009,0,No,0,-0.44,-0.68,-0.24,25,8,-17,1,0,-1,377.0,129.0,-248.0,0.0,0.0,0.0
<a href=/player/roblr101>roblr101</a>,Rafael Robles,San Diego Padres,PADRS,1,1,2,3,1972,1972,0,No,0,0.0,0.0,0.0,0,7,7,0,7,7,0.0,0.0,0.0,0.0,0.0,0.0
<a href=/player/robls101>robls101</a>,Sergio Robles,Los Angeles Dodgers,DOGRS,3,10,5,15,1971,1976,5,No,0,18.58,22.72,4.14,838,611,-227,2013,960,-1053,3623.0,2900.0,-723.0,259900.0,0.0,-259900.0
<a href=/player/roccm101>roccm101</a>,Mickey Rocco,Nashville,Nashville,1,3,1,4,1940,1954,14,No,0,0.0,0.0,0.0,0,0,0,0,0,0,0.0,0.0,0.0,0.0,0.0,0.0
<a href=/player/roccm101>roccm101</a>,Mickey Rocco,Cleveland Indians,INDINS,1,2,1,3,1946,1947,1,No,0,0.0,0.89,0.89,0,52,52,0,174,174,0.0,0.0,0.0,0.0,0.0,0.0
<a href=/player/rockj001>rockj001</a>,John Rocker,Atlanta Braves,BRAVES,4,7,6,13,2001,2014,13,No,2,-3.15,26.02,29.17,118,642,524,55,580,525,334.0,4952.0,4618.0,2270000.0,0.0,-2270000.0
<a href=/player/rockj001>rockj001</a>,John Rocker,Cleveland Indians,INDINS,1,1,1,2,2001,2003,2,No,0,-0.54,0.13,0.67,36,19,-17,0,0,0,73.0,76.0,3.0,0.0,0.0,0.0
<a href=/player/rockp101>rockp101</a>,Pat Rockett,Atlanta Braves,BRAVES,1,3,2,5,1979,1986,7,No,0,6.25,5.96,-0.29,653,1043,390,1647,3360,1713,1023.0,3.0,-1020.0,0.0,0.0,0.0
<a href=/player/rodga101>rodga101</a>,Andre Rodgers,San Francisco Giants,GIANTS,1,1,1,2,1960,1960,0,No,0,0.0,0.0,0.0,0,0,0,0,0,0,0.0,0.0,0.0,0.0,0.0,0.0
<a href=/player/rodga101>rodga101</a>,Andre Rodgers,Milwaukee Braves,BRAVES,1,2,2,4,1961,1961,0,No,0,3.31,-0.59,-3.9,499,56,-443,1886,5,-1881,0.0,122.0,122.0,0.0,0.0,0.0
<a href=/player/rodga101>rodga101</a>,Andre Rodgers,Chicago Cubs,CUBS,1,1,2,3,1964,1966,2,No,0,0.82,-0.6,-1.42,158,57,-101,328,209,-119,0.0,0.0,0.0,0.0,0.0,0.0
<a href=/player/rodnf001>rodnf001</a>,Fernando Rodney,Seattle Mariners,MARNRS,1,1,1,2,2015,2015,0,No,0,0.2,0.0,-0.2,28,0,-28,0,0,0,36.0,0.0,-36.0,7000000.0,0.0,-7000000.0
<a href=/player/rodnf001>rodnf001</a>,Fernando Rodney,San Diego Padres,PADRS,1,1,1,2,2016,2016,0,Yes,0,-0.78,0.0,0.78,77,0,-77,0,0,0,110.0,0.0,-110.0,0.0,0.0,0.0
<a href=/player/rodnf001>rodnf001</a>,Fernando Rodney,Minnesota Twins,TWINS,1,1,1,2,2018,2018,0,Yes,0,-0.42,0.0,0.42,41,0,-41,0,0,0,105.0,0.0,-105.0,0.0,0.0,0.0
<a href=/player/rodra001>rodra001</a>,Alex Rodriguez,Texas Rangers,RNGRS,5,8,11,19,2004,2010,6,No,0,93.01,8.2,-84.81,2905,738,-2167,11217,2392,-8825,3052.0,497.0,-2555.0,7902000.0,0.0,-7902000.0
<a href=/player/rodra002>rodra002</a>,Aneury Rodriguez,Colorado Rockies,ROCKS,3,4,3,7,2009,2012,3,No,0,6.7,2.79,-3.91,199,236,37,28,217,189,2842.0,1880.0,-962.0,8200000.0,0.0,-8200000.0
<a href=/player/rodra101>rodra101</a>,Aurelio Rodriguez,California Angels,ANGELS,10,16,20,36,1970,1977,7,No,0,30.4,30.36,-0.04,1555,1533,-22,4572,5092,520,3213.0,1843.0,-1370.0,333500.0,0.0,-333500.0
<a href=/player/rodra101>rodra101</a>,Aurelio Rodriguez,Washington Senators,RNGRS,6,10,11,21,1970,1976,6,No,0,30.0,-0.41,-30.41,2790,834,-1956,8622,1724,-6898,5481.0,1612.0,-3869.0,75900.0,0.0,-75900.0
<a href=/player/rodra101>rodra101</a>,Aurelio Rodriguez,New York Yankees,YANKS,1,1,1,2,1981,1981,0,No,0,0.0,0.0,0.0,0,0,0,0,0,0,0.0,0.0,0.0,0.0,0.0,0.0
<a href=/player/rodra101>rodra101</a>,Aurelio Rodriguez,Toronto Blue Jays,BJAYS,3,3,3,6,1982,1982,0,No,0,-0.11,-2.44,-2.33,179,147,-32,384,402,18,0.0,0.0,0.0,0.0,0.0,0.0
<a href=/player/rodre001>rodre001</a>,Edwin Rodriguez,New York Yankees,YANKS,1,3,1,4,1983,1985,2,No,0,4.84,1.45,-3.39,236,20,-216,270,0,-270,2040.0,301.0,-1739.0,0.0,0.0,0.0
<a href=/player/rodre004>rodre004</a>,Eduardo Rodriguez,Baltimore Orioles,ORLS,1,1,1,2,2014,2014,0,No,0,15.37,0.96,-14.41,172,24,-148,29,0,-29,2570.0,60.0,-2510.0,0.0,0.0,0.0
<a href=/player/rodre101>rodre101</a>,Ellie Rodriguez,Kansas City Royals,ROYALS,1,1,1,2,1971,1971,0,No,0,7.99,-0.11,-8.1,325,20,-305,1152,46,-1106,0.0,0.0,0.0,0.0,0.0,0.0
<a href=/player/rodre101>rodre101</a>,Ellie Rodriguez,Milwaukee Brewers,BREWRS,3,7,7,14,1973,1978,5,No,0,7.23,1.8,-5.43,546,209,-337,1533,327,-1206,524.0,1634.0,1110.0,168301.0,0.0,-168301.0
<a href=/player/rodre101>rodre101</a>,Ellie Rodriguez,California Angels,ANGELS,1,1,2,3,1976,1976,0,No,0,0.1,-0.34,-0.44,36,15,-21,90,42,-48,0.0,0.0,0.0,0.0,0.0,0.0
<a href=/player/rodrf001>rodrf001</a>,Frankie Rodriguez,Boston Red Sox,RSOX,1,2,1,3,1995,1995,0,No,0,2.15,1.05,-1.1,120,30,-90,1,0,-1,1528.0,91.0,-1437.0,109000.0,0.0,-109000.0
<a href=/player/rodrf002>rodrf002</a>,Felix Rodriguez,Cincinnati Reds,REDS,1,1,1,2,1997,1997,0,No,0,-0.7,-0.07,0.63,85,10,-75,0,0,0,132.0,18.0,-114.0,175000.0,0.0,-175000.0
<a href=/player/rodrf002>rodrf002</a>,Felix Rodriguez,Arizona Diamondbacks,DBACKS,1,1,2,3,1998,2002,4,No,0,8.33,0.24,-8.09,765,116,-649,15,1,-14,1209.0,148.0,-1061.0,210000.0,0.0,-210000.0
<a href=/player/rodrf002>rodrf002</a>,Felix Rodriguez,San Francisco Giants,GIANTS,1,1,2,3,2004,2006,2,No,0,0.54,-0.41,-0.95,46,31,-15,0,60,60,63.0,0.0,-63.0,3050000.0,0.0,-3050000.0
<a href=/player/rodrf002>rodrf002</a>,Felix Rodriguez,Philadelphia Phillies,PHILS,1,1,1,2,2004,2005,1,No,0,0.31,3.55,3.24,35,110,75,0,406,406,97.0,0.0,-97.0,0.0,0.0,0.0
<a href=/player/rodrf003>rodrf003</a>,Francisco Rodriguez,New York Mets,METS,1,2,2,4,2011,2013,2,No,0,5.0,0.38,-4.62,513,32,-481,1,0,-1,752.0,24.0,-728.0,12166666.0,0.0,-12166666.0
<a href=/player/rodrf003>rodrf003</a>,Francisco Rodriguez,Milwaukee Brewers,BREWRS,1,1,1,2,2013,2015,2,No,0,0.01,0.0,-0.01,29,0,-29,0,0,0,66.0,0.0,-66.0,0.0,0.0,0.0
<a href=/player/rodrf003>rodrf003</a>,Francisco Rodriguez,Milwaukee Brewers,BREWRS,1,1,2,3,2015,2021,6,Yes,0,0.31,6.56,6.25,95,404,309,0,1209,1209,251.0,0.0,-251.0,3500000.0,0.0,-3500000.0
<a href=/player/rodrf004>rodrf004</a>,Fernando Rodriguez,Houston Astros,ASTROS,2,3,5,8,2013,2020,7,Yes,0,13.46,8.06,-5.4,1071,776,-295,3907,2069,-1838,325.0,1629.0,1304.0,590100.0,0.0,-590100.0
<a href=/player/rodrf101>rodrf101</a>,Freddy Rodriguez,San Francisco Giants,GIANTS,1,1,1,2,1957,1957,0,No,0,-0.27,0.0,0.27,14,0,-14,1,0,-1,22.0,0.0,-22.0,0.0,0.0,0.0
<a href=/player/rodrf101>rodrf101</a>,Freddy Rodriguez,Chicago Cubs,CUBS,1,1,1,2,1958,1958,0,No,0,0.0,0.0,0.0,0,0,0,0,0,0,0.0,0.0,0.0,0.0,0.0,0.0
<a href=/player/rodrh001>rodrh001</a>,Henry Rodriguez,Los Angeles Dodgers,DOGRS,2,4,3,7,1995,1996,1,No,0,1.62,-0.16,-1.78,426,245,-181,1244,564,-680,244.0,191.0,-53.0,305000.0,0.0,-305000.0
<a href=/player/rodrh001>rodrh001</a>,Henry Rodriguez,Montreal Expos,NATEX,2,2,2,4,1997,2000,3,No,0,2.84,0.22,-2.62,350,203,-147,1267,78,-1189,171.0,850.0,679.0,2625000.0,0.0,-2625000.0
<a href=/player/rodrh001>rodrh001</a>,Henry Rodriguez,Chicago Cubs,CUBS,6,10,9,19,2000,2011,11,No,1,3.59,5.03,1.44,575,630,55,961,2305,1344,801.0,0.0,-801.0,11833333.0,0.0,-11833333.0
<a href=/player/rodrh002>rodrh002</a>,Henry Rodriguez,Oakland Athletics,ATLTCS,9,15,12,27,2010,2018,8,Yes,2,7.39,2.24,-5.15,868,456,-412,2078,1439,-639,442.0,312.0,-130.0,8300001.0,0.0,-8300001.0
<a href=/player/rodrh002>rodrh002</a>,Henry Rodriguez,Washington Nationals,NATEX,1,1,1,2,2013,2013,0,Yes,0,-0.1,0.0,0.1,10,0,-10,0,0,0,12.0,0.0,-12.0,501000.0,0.0,-501000.0
<a href=/player/rodrh101>rodrh101</a>,Hector Rodriguez,Brooklyn Dodgers,DOGRS,2,2,3,5,1951,1953,2,No,0,0.83,0.03,-0.8,128,37,-91,466,46,-420,0.0,0.0,0.0,0.0,0.0,0.0
<a href=/player/rodrh101>rodrh101</a>,Hector Rodriguez,Chicago White Sox,WSOX,30,57,56,113,1953,1971,18,No,0,64.71,123.89,59.18,7633,8346,713,20626,20050,-576,7158.0,13944.0,6786.0,248750.0,0.0,-248750.0
<a href=/player/rodri001>rodri001</a>,Ivan Rodriguez,Detroit Tigers,TIGRS,1,1,1,2,2008,2008,0,No,0,-0.8,-0.51,0.29,33,16,-17,101,0,-101,0.0,48.0,48.0,12379883.0,0.0,-12379883.0
<a href=/player/rodri001>rodri001</a>,Ivan Rodriguez,Houston Astros,ASTROS,1,1,2,3,2009,2009,0,No,0,-0.43,0.0,0.43,28,0,-28,104,0,-104,0.0,0.0,0.0,1500000.0,0.0,-1500000.0
<a href=/player/rodrj002>rodrj002</a>,John Rodriguez,Cleveland Indians,INDINS,1,1,1,2,2005,2005,0,No,0,0.63,0.0,-0.63,158,0,-158,388,0,-388,0.0,0.0,0.0,0.0,0.0,0.0
<a href=/player/rodrj004>rodrj004</a>,Joely Rodriguez,Pittsburgh Pirates,PIRATS,1,1,1,2,2014,2015,1,No,0,-0.74,0.91,1.65,76,127,51,0,2,2,110.0,172.0,62.0,0.0,0.0,0.0
<a href=/player/rodrj004>rodrj004</a>,Joely Rodriguez,Philadelphia Phillies,PHILS,1,1,1,2,2017,2017,0,No,0,-0.19,0.0,0.19,46,0,-46,0,0,0,120.0,0.0,-120.0,535000.0,0.0,-535000.0
<a href=/player/rodrj004>rodrj004</a>,Joely Rodriguez,Texas Rangers,RNGRS,1,3,4,7,2021,2021,0,Yes,0,0.78,-0.87,-1.65,82,6,-76,228,0,-228,57.0,70.0,13.0,8700000.0,0.0,-8700000.0
<a href=/player/rodrj005>rodrj005</a>,Jefry Rodriguez,Washington Nationals,NATEX,2,6,4,10,2018,2021,3,Yes,0,-0.4,4.3,4.7,134,190,56,433,712,279,140.0,0.0,-140.0,7000000.0,0.0,-7000000.0
<a href=/player/rodrj101>rodrj101</a>,Jose Rodriguez,New York Giants,GIANTS,2,8,3,11,1919,1923,4,No,0,10.49,7.89,-2.6,305,402,97,539,1094,555,2035.0,323.0,-1712.0,12500.0,0.0,-12500.0
<a href=/player/rodrn001>rodrn001</a>,Nerio Rodriguez,Baltimore Orioles,ORLS,3,5,5,10,1998,2012,14,No,2,0.36,10.17,9.81,33,490,457,30,104,74,263.0,1704.0,1441.0,5250000.0,0.0,-5250000.0
<a href=/player/rodrn001>rodrn001</a>,Nerio Rodriguez,Cleveland Indians,INDINS,1,1,1,2,2002,2002,0,No,0,-0.05,0.0,0.05,4,0,-4,1,0,-1,13.0,0.0,-13.0,0.0,0.0,0.0
<a href=/player/rodrp001>rodrp001</a>,Paco Rodriguez,Los Angeles Dodgers,DOGRS,9,31,24,55,2015,2021,6,Yes,0,13.41,18.97,5.56,1905,1113,-792,5768,1311,-4457,2200.0,3323.0,1123.0,37486500.0,0.0,-37486500.0
<a href=/player/rodrr002>rodrr002</a>,Ruben Rodriguez,Pittsburgh Pirates,PIRATS,1,1,1,2,1989,1989,0,No,0,0.0,0.0,0.0,0,0,0,0,0,0,0.0,0.0,0.0,0.0,0.0,0.0
<a href=/player/rodrr004>rodrr004</a>,Rich Rodriguez,New York Mets,METS,1,1,2,3,1989,1989,0,No,0,3.38,0.0,-3.38,383,0,-383,18,0,-18,746.0,0.0,-746.0,0.0,0.0,0.0
<a href=/player/rodrr004>rodrr004</a>,Rich Rodriguez,San Diego Padres,PADRS,2,3,4,7,1993,2008,15,No,0,13.46,26.09,12.63,630,1877,1247,2360,48,-2312,138.0,3132.0,2994.0,3375000.0,0.0,-3375000.0
<a href=/player/rodrr005>rodrr005</a>,Ricardo Rodriguez,Los Angeles Dodgers,DOGRS,1,3,1,4,2002,2004,2,No,0,-0.33,0.6,0.93,92,177,85,4,5,1,830.0,299.0,-531.0,3250000.0,0.0,-3250000.0
<a href=/player/rodrr005>rodrr005</a>,Ricardo Rodriguez,Cleveland Indians,INDINS,1,2,1,3,2003,2005,2,No,0,0.87,1.1,0.23,75,73,-2,221,247,26,251.0,0.0,-251.0,902400.0,0.0,-902400.0
<a href=/player/rodrr005>rodrr005</a>,Ricardo Rodriguez,Texas Rangers,RNGRS,1,1,1,2,2005,2009,4,No,0,0.0,4.08,4.08,0,107,107,0,10,10,0.0,1798.0,1798.0,0.0,0.0,0.0
<a href=/player/rodrr006>rodrr006</a>,Rafael Rodriguez,Anaheim Angels,ANGELS,1,4,1,5,2010,2012,2,No,0,13.1,6.5,-6.6,498,84,-414,497,11,-486,4323.0,1527.0,-2796.0,3700000.0,0.0,-3700000.0
<a href=/player/rodrr008>rodrr008</a>,Richard Rodriguez,Pittsburgh Pirates,PIRATS,1,1,2,3,2021,2021,0,Yes,0,0.61,0.25,-0.36,53,15,-38,0,12,12,78.0,121.0,43.0,1700000.0,0.0,-1700000.0
<a href=/player/rodrr101>rodrr101</a>,Roberto Rodriguez,Oakland Athletics,ATLTCS,1,1,1,2,1970,1970,0,No,0,-0.82,0.0,0.82,52,0,-52,9,0,-9,130.0,0.0,-130.0,0.0,0.0,0.0
<a href=/player/rodrs002>rodrs002</a>,Sean Rodriguez,Anaheim Angels,ANGELS,1,3,1,4,2009,2011,2,No,0,9.82,-0.01,-9.83,598,38,-560,1637,7,-1630,198.0,564.0,366.0,405000.0,0.0,-405000.0
<a href=/player/rodrs002>rodrs002</a>,Sean Rodriguez,Tampa Bay Devil Rays,RAYS,1,1,1,2,2014,2014,0,Yes,0,1.1,0.0,-1.1,384,0,-384,861,0,-861,0.0,0.0,0.0,1475000.0,0.0,-1475000.0
<a href=/player/rodrs002>rodrs002</a>,Sean Rodriguez,Atlanta Braves,BRAVES,2,2,2,4,2017,2017,0,No,0,-0.61,0.0,0.61,105,0,-105,279,0,-279,0.0,0.0,0.0,0.0,0.0,0.0
<a href=/player/rodrv001>rodrv001</a>,Vic Rodriguez,Baltimore Orioles,ORLS,1,1,1,2,1985,1985,0,No,0,0.0,0.35,0.35,0,50,50,0,135,135,0.0,0.0,0.0,0.0,0.0,0.0
<a href=/player/rodrw002>rodrw002</a>,Wandy Rodriguez,Houston Astros,ASTROS,1,1,3,4,2012,2015,3,No,0,0.18,1.62,1.44,63,191,128,59,764,705,493.0,17.0,-476.0,0.0,0.0,0.0
<a href=/player/roe-c001>roe-c001</a>,Chaz Roe,Colorado Rockies,ROCKS,1,1,1,2,2010,2011,1,No,0,0.0,-0.43,-0.43,0,38,38,0,129,129,0.0,0.0,0.0,0.0,0.0,0.0
<a href=/player/roe-p101>roe-p101</a>,Preacher Roe,St. Louis Cardinals,CARDS,1,1,3,4,1943,1946,3,No,0,8.3,0.0,-8.3,262,0,-262,215,0,-215,1903.0,0.0,-1903.0,0.0,0.0,0.0
<a href=/player/roe-p101>roe-p101</a>,Preacher Roe,Pittsburgh Pirates,PIRATS,1,3,3,6,1947,1950,3,No,0,26.56,1.84,-24.72,1156,287,-869,3340,710,-2630,3832.0,295.0,-3537.0,0.0,0.0,0.0
<a href=/player/roe-p101>roe-p101</a>,Preacher Roe,Brooklyn Dodgers,DOGRS,1,2,3,5,1954,1954,0,No,0,0.54,0.0,-0.54,53,0,-53,213,0,-213,0.0,0.0,0.0,19000.0,0.0,-19000.0
<a href=/player/roebe101>roebe101</a>,Ed Roebuck,Los Angeles Dodgers,DOGRS,1,1,1,2,1963,1964,1,No,0,0.54,-0.38,-0.92,56,20,-36,13,40,27,175.0,0.0,-175.0,0.0,0.0,0.0
<a href=/player/roeng001>roeng001</a>,Gary Roenicke,Montreal Expos,NATEX,2,4,4,8,1977,1986,9,No,1,17.04,9.82,-7.22,1002,871,-131,2634,1351,-1283,744.0,3222.0,2478.0,0.0,0.0,0.0
<a href=/player/roeng001>roeng001</a>,Gary Roenicke,Baltimore Orioles,ORLS,1,2,2,4,1985,1987,2,No,0,-0.33,0.34,0.67,76,66,-10,188,1,-187,0.0,321.0,321.0,558333.0,0.0,-558333.0
<a href=/player/roenj001>roenj001</a>,Josh Roenicke,Cincinnati Reds,REDS,1,3,1,4,2009,2012,3,No,0,24.68,7.61,-17.07,1033,330,-703,4205,1298,-2907,160.0,0.0,-160.0,2425000.0,0.0,-2425000.0
<a href=/player/roesm001>roesm001</a>,Mike Roesler,Cincinnati Reds,REDS,2,3,2,5,1990,1992,2,No,0,-1.08,-0.05,1.03,271,352,81,1090,1144,54,18.0,139.0,121.0,1600000.0,0.0,-1600000.0
<a href=/player/roeto101>roeto101</a>,Oscar Roettger,New York Yankees,YANKS,2,6,4,10,1925,1931,6,No,0,-1.14,6.67,7.81,271,713,442,761,2895,2134,731.0,97.0,-634.0,31500.0,0.0,-31500.0
<a href=/player/roeto101>roeto101</a>,Oscar Roettger,StPaul,StPaul,1,1,2,3,1931,1931,0,No,0,-0.33,0.0,0.33,26,0,-26,66,0,-66,0.0,0.0,0.0,0.0,0.0,0.0
<a href=/player/roeto101>roeto101</a>,Oscar Roettger,Philadelphia Athletics,ATLTCS,3,6,3,9,1932,1934,2,No,0,0.0,-0.52,-0.52,0,16,16,0,5,5,0.0,34.0,34.0,7600.0,0.0,-7600.0
<a href=/player/roetw101>roetw101</a>,Wally Roettger,St. Louis Cardinals,CARDS,2,2,3,5,1930,1932,2,No,0,-0.8,1.35,2.15,139,115,-24,481,352,-129,0.0,0.0,0.0,0.0,0.0,0.0
<a href=/player/roetw101>roetw101</a>,Wally Roettger,Cincinnati Reds,REDS,1,1,1,2,1931,1933,2,No,0,-0.24,-0.27,-0.03,45,192,147,169,798,629,0.0,0.0,0.0,0.0,0.0,0.0
<a href=/player/roetw101>roetw101</a>,Wally Roettger,Cincinnati Reds,REDS,1,2,2,4,1933,1935,2,No,0,11.2,-0.59,-11.79,432,112,-320,556,459,-97,2051.0,0.0,-2051.0,0.0,0.0,0.0
<a href=/player/rogeb001>rogeb001</a>,Brian Rogers,Detroit Tigers,TIGRS,1,1,1,2,2006,2007,1,No,0,-0.33,-0.09,0.24,26,196,170,0,692,692,32.0,0.0,-32.0,0.0,0.0,0.0
<a href=/player/rogeb102>rogeb102</a>,Billy Rogell,Boston Red Sox,RSOX,1,2,2,4,1928,1928,0,No,0,0.0,0.0,0.0,0,0,0,0,0,0,0.0,0.0,0.0,3000.0,0.0,-3000.0
<a href=/player/rogeb102>rogeb102</a>,Billy Rogell,Detroit Tigers,TIGRS,1,1,1,2,1939,1941,2,No,0,-0.57,-0.5,0.07,33,144,111,63,635,572,0.0,0.0,0.0,11000.0,0.0,-11000.0
<a href=/player/rogee002>rogee002</a>,Esmil Rogers,Cleveland Indians,INDINS,2,2,5,7,2012,2020,8,Yes,0,4.29,11.72,7.43,256,955,699,719,3396,2677,475.0,140.0,-335.0,6514333.0,0.0,-6514333.0
<a href=/player/rogej002>rogej002</a>,Jason Rogers,Milwaukee Brewers,BREWRS,3,4,6,10,2015,2021,6,Yes,0,-0.63,4.1,4.73,57,272,215,86,796,710,0.0,7.0,7.0,507500.0,0.0,-507500.0
<a href=/player/rogej003>rogej003</a>,Josh Rogers,New York Yankees,YANKS,1,3,1,4,2018,2019,1,Yes,0,-0.19,2.71,2.9,121,97,-24,0,0,0,451.0,259.0,-192.0,0.0,0.0,0.0
<a href=/player/rogej004>rogej004</a>,Jake Rogers,Houston Astros,ASTROS,1,3,3,6,2017,2021,4,Yes,0,-0.1,16.16,16.26,126,77,-49,429,7,-422,3.0,1431.0,1428.0,0.0,0.0,0.0
<a href=/player/rogej102>rogej102</a>,Jim Rogers,Washington Senators,WSN,1,3,1,4,1896,1897,1,No,0,-1.24,0.18,1.42,153,159,6,636,662,26,0.0,0.0,0.0,0.0,0.0,0.0
<a href=/player/rogek001>rogek001</a>,Kenny Rogers,New York Yankees,YANKS,1,2,1,3,1997,2001,4,No,0,9.23,8.3,-0.93,56,540,484,7,2129,2122,1074.0,0.0,-1074.0,5000000.0,0.0,-5000000.0
<a href=/player/rogek001>rogek001</a>,Kenny Rogers,Oakland Athletics,ATLTCS,3,4,5,9,1999,2012,13,No,0,8.62,14.48,5.86,458,1147,689,1512,4567,3055,228.0,206.0,-22.0,9062500.0,0.0,-9062500.0
<a href=/player/rogel101>rogel101</a>,Lee Rogers,Boston Red Sox,RSOX,1,1,1,2,1938,1939,1,No,0,-0.08,0.0,0.08,26,0,-26,4,0,-4,71.0,0.0,-71.0,0.0,0.0,0.0
<a href=/player/rogos101>rogos101</a>,Saul Rogovin,Detroit Tigers,TIGRS,12,27,25,52,1951,1961,10,No,0,27.97,16.36,-11.61,2275,2285,10,4156,6502,2346,7305.0,2805.0,-4500.0,45200.0,0.0,-45200.0
<a href=/player/rogos101>rogos101</a>,Saul Rogovin,Chicago White Sox,WSOX,1,3,1,4,1953,1955,2,No,0,0.0,-0.06,-0.06,1,69,68,1,138,137,0.0,0.0,0.0,0.0,0.0,0.0
<a href=/player/rohdd001>rohdd001</a>,Dave Rohde,Houston Astros,ASTROS,2,3,4,7,1991,1995,4,No,0,53.38,-0.45,-53.83,1975,315,-1660,8100,672,-7428,0.0,285.0,285.0,375000.0,0.0,-375000.0
<a href=/player/rohnd001>rohnd001</a>,Dan Rohn,Chicago Cubs,CUBS,1,1,1,2,1985,1987,2,No,0,-0.05,-0.27,-0.22,6,158,152,11,16,5,0.0,405.0,405.0,0.0,0.0,0.0
<a href=/player/rohnd001>rohnd001</a>,Dan Rohn,Chicago Cubs,CUBS,1,2,3,5,1987,1987,0,No,0,15.94,0.0,-15.94,542,0,-542,0,0,0,1911.0,0.0,-1911.0,0.0,0.0,0.0
<a href=/player/rohrb101>rohrb101</a>,Billy Rohr,Cleveland Indians,INDINS,1,2,1,3,1970,1970,0,No,0,-0.16,-0.64,-0.48,28,86,58,38,9,-29,0.0,173.0,173.0,8070.0,0.0,-8070.0
<a href=/player/rohwr101>rohwr101</a>,Ray Rohwer,Pittsburgh Pirates,PIRATS,1,3,1,4,1922,1927,5,No,0,0.0,-0.21,-0.21,0,25,25,0,62,62,0.0,0.0,0.0,3600.0,0.0,-3600.0
<a href=/player/rojac101>rojac101</a>,Cookie Rojas,Cincinnati Reds,REDS,1,1,1,2,1962,1963,1,No,0,3.63,-0.74,-4.37,881,38,-843,3369,8,-3361,3.0,127.0,124.0,0.0,0.0,0.0
<a href=/player/rojac101>rojac101</a>,Cookie Rojas,Philadelphia Phillies,PHILS,5,9,11,20,1969,1977,8,No,0,2.27,5.62,3.35,374,740,366,889,1587,698,321.0,625.0,304.0,70000.0,0.0,-70000.0
<a href=/player/rojac101>rojac101</a>,Cookie Rojas,St. Louis Cardinals,CARDS,2,3,2,5,1970,1972,2,No,0,7.18,0.65,-6.53,880,20,-860,3354,1,-3353,0.0,38.0,38.0,0.0,0.0,0.0
<a href=/player/rojaj001>rojaj001</a>,Josh Rojas,Houston Astros,ASTROS,1,4,2,6,2019,2021,2,No,0,-0.93,3.35,4.28,254,54,-200,791,4,-787,100.0,902.0,802.0,0.0,0.0,0.0
<a href=/player/rojam001>rojam001</a>,Mel Rojas,Chicago Cubs,CUBS,2,4,4,8,1997,2001,4,No,0,3.27,3.1,-0.17,1097,717,-380,1379,2198,819,1191.0,830.0,-361.0,9308333.0,0.0,-9308333.0
<a href=/player/rojam001>rojam001</a>,Mel Rojas,New York Mets,METS,1,1,1,2,1998,2000,2,No,0,-0.23,-1.41,-1.18,10,60,50,0,141,141,15.0,0.0,-15.0,4583333.0,0.0,-4583333.0
<a href=/player/rojam001>rojam001</a>,Mel Rojas,Los Angeles Dodgers,DOGRS,1,2,3,5,1999,1999,0,No,0,0.03,-0.71,-0.74,81,18,-63,9,4,-5,1195.0,47.0,-1148.0,6833334.0,0.0,-6833334.0
<a href=/player/rojam002>rojam002</a>,Miguel Rojas,Los Angeles Dodgers,DOGRS,4,7,8,15,2014,2020,6,Yes,0,27.35,10.53,-16.82,1361,1127,-234,4322,2916,-1406,2273.0,350.0,-1923.0,21765000.0,0.0,-21765000.0
<a href=/player/rojes101>rojes101</a>,Stan Rojek,Pittsburgh Pirates,PIRATS,1,1,2,3,1951,1951,0,No,0,0.47,-0.43,-0.9,51,95,44,202,249,47,0.0,20.0,20.0,0.0,0.0,0.0
<a href=/player/rojes101>rojes101</a>,Stan Rojek,St.Louis Browns,ORLS,22,50,44,94,1952,1994,42,No,3,83.66,149.23,65.57,4979,8789,3810,10385,25784,15399,18519.0,15968.0,-2551.0,970833.0,0.0,-970833.0
<a href=/player/rolaj101>rolaj101</a>,Jim Roland,New York Yankees,YANKS,1,1,1,2,1972,1973,1,No,0,-0.11,-0.07,0.04,10,11,1,0,1,1,10.0,44.0,34.0,0.0,0.0,0.0
<a href=/player/roles001>roles001</a>,Scott Rolen,Philadelphia Phillies,PHILS,2,4,5,9,2002,2005,3,No,0,45.06,10.26,-34.8,1293,547,-746,5556,1575,-3981,0.0,264.0,264.0,13200000.0,0.0,-13200000.0
<a href=/player/roles001>roles001</a>,Scott Rolen,St. Louis Cardinals,CARDS,1,1,1,2,2008,2009,1,No,0,7.36,4.21,-3.15,203,165,-38,840,669,-171,0.0,0.0,0.0,0.0,0.0,0.0
<a href=/player/roles001>roles001</a>,Scott Rolen,Toronto Blue Jays,BJAYS,3,7,9,16,2009,2014,5,No,0,6.88,8.45,1.57,726,615,-111,1387,2188,801,842.0,175.0,-667.0,19454600.0,0.0,-19454600.0
<a href=/player/rolld002>rolld002</a>,David Rollins,Toronto Blue Jays,BJAYS,4,12,6,18,2012,2016,4,No,0,10.83,2.99,-7.84,1068,309,-759,3494,605,-2889,904.0,1431.0,527.0,11237500.0,0.0,-11237500.0
<a href=/player/rollj001>rollj001</a>,Jimmy Rollins,Philadelphia Phillies,PHILS,1,2,2,4,2014,2014,0,Yes,0,0.44,0.0,-0.44,144,0,-144,563,0,-563,0.0,0.0,0.0,11000000.0,0.0,-11000000.0
<a href=/player/romaj001>romaj001</a>,Jose Roman,Cleveland Indians,INDINS,1,1,1,2,1987,1987,0,No,0,0.0,0.0,0.0,0,0,0,0,0,0,0.0,0.0,0.0,0.0,0.0,0.0
<a href=/player/romaj002>romaj002</a>,Jason Romano,Texas Rangers,RNGRS,1,3,2,5,2002,2002,0,No,0,0.5,-0.12,-0.62,97,54,-43,245,149,-96,0.0,127.0,127.0,1850000.0,0.0,-1850000.0
<a href=/player/romaj002>romaj002</a>,Jason Romano,Colorado Rockies,ROCKS,1,1,1,2,2003,2003,0,No,0,-0.74,0.0,0.74,37,2,-35,37,2,-35,0.0,0.0,0.0,0.0,0.0,0.0
<a href=/player/romaj002>romaj002</a>,Jason Romano,Los Angeles Dodgers,DOGRS,2,3,2,5,2004,2017,13,No,0,0.93,22.74,21.81,176,1566,1390,597,5726,5129,0.0,0.0,0.0,2830000.0,0.0,-2830000.0
<a href=/player/romaj003>romaj003</a>,Jamie Romak,Atlanta Braves,BRAVES,7,15,18,33,2007,2015,8,No,2,20.02,10.32,-9.7,2739,1597,-1142,4450,3607,-843,3035.0,1968.0,-1067.0,26080000.0,0.0,-26080000.0
<a href=/player/romaj101>romaj101</a>,John Romano,Chicago White Sox,WSOX,5,8,10,18,1959,1969,10,No,0,11.6,14.81,3.21,1350,938,-412,4415,3667,-748,492.0,12.0,-480.0,77250.0,0.0,-77250.0
<a href=/player/romaj101>romaj101</a>,John Romano,Cleveland Indians,INDINS,3,5,5,10,1965,1968,3,No,0,40.72,5.22,-35.5,1111,420,-691,2880,1615,-1265,4479.0,0.0,-4479.0,0.0,0.0,0.0
<a href=/player/romaj101>romaj101</a>,John Romano,Chicago White Sox,WSOX,3,4,4,8,1966,1976,10,No,0,0.79,1.71,0.92,129,790,661,442,2422,1980,0.0,142.0,142.0,83000.0,0.0,-83000.0
<a href=/player/romam001>romam001</a>,Mike Romano,Toronto Blue Jays,BJAYS,1,1,1,2,2000,2000,0,No,0,0.0,0.0,0.0,0,0,0,0,0,0,0.0,0.0,0.0,0.0,0.0,0.0
<a href=/player/romar001>romar001</a>,Ron Romanick,California Angels,ANGELS,1,2,1,3,1986,1988,2,No,0,0.09,0.46,0.37,42,58,16,0,167,167,174.0,0.0,-174.0,425000.0,0.0,-425000.0
<a href=/player/romat001>romat001</a>,Tom Romano,Oakland Athletics,ATLTCS,1,1,1,2,1986,1986,0,No,0,-0.06,0.0,0.06,7,0,-7,3,0,-3,0.0,0.0,0.0,0.0,0.0,0.0
<a href=/player/romee001>romee001</a>,Ed Romero,Milwaukee Brewers,BREWRS,1,1,1,2,1985,1988,3,No,0,-3.59,3.24,6.83,265,142,-123,727,0,-727,0.0,543.0,543.0,290000.0,0.0,-290000.0
<a href=/player/romee001>romee001</a>,Ed Romero,Atlanta Braves,BRAVES,1,1,1,2,1989,1989,0,No,0,-0.38,0.03,0.41,15,16,1,50,1,-49,0.0,37.0,37.0,0.0,0.0,0.0
<a href=/player/romee002>romee002</a>,Enny Romero,Tampa Bay Devil Rays,RAYS,1,1,1,2,2017,2017,0,Yes,0,0.48,0.0,-0.48,107,0,-107,1,0,-1,173.0,0.0,-173.0,0.0,0.0,0.0
<a href=/player/romej001>romej001</a>,J.C. Romero,Minnesota Twins,TWINS,1,1,1,2,2005,2012,7,No,0,-0.95,3.58,4.53,71,515,444,0,1764,1764,145.0,0.0,-145.0,1250000.0,0.0,-1250000.0
<a href=/player/romej001>romej001</a>,J.C. Romero,Cleveland Indians,INDINS,1,1,1,2,2012,2012,0,No,0,-0.12,0.0,0.12,5,0,-5,0,0,0,12.0,0.0,-12.0,0.0,0.0,0.0
<a href=/player/romej003>romej003</a>,Jhon Romero,Chicago Cubs,CUBS,1,1,1,2,2018,2019,1,No,0,0.02,1.17,1.15,10,168,158,0,1,1,12.0,225.0,213.0,0.0,0.0,0.0
<a href=/player/romem001>romem001</a>,Mandy Romero,San Diego Padres,PADRS,4,8,7,15,1998,2002,4,No,0,4.23,0.82,-3.41,472,389,-83,1448,834,-614,139.0,215.0,76.0,3650000.0,0.0,-3650000.0
<a href=/player/romem001>romem001</a>,Mandy Romero,Boston Red Sox,RSOX,1,1,1,2,1999,1999,0,No,0,0.0,0.0,0.0,0,0,0,0,0,0,0.0,0.0,0.0,0.0,0.0,0.0
<a href=/player/romer001>romer001</a>,Ramon Romero,Cleveland Indians,INDINS,1,2,2,4,1986,1988,2,No,0,3.92,1.63,-2.29,86,69,-17,0,0,0,1168.0,825.0,-343.0,0.0,0.0,0.0
<a href=/player/romia001>romia001</a>,Andrew Romine,Anaheim Angels,ANGELS,2,2,2,4,2014,2019,5,No,0,1.94,2.53,0.59,576,355,-221,1018,1,-1017,204.0,896.0,692.0,1050000.0,0.0,-1050000.0
<a href=/player/romoe101>romoe101</a>,Enrique Romo,Seattle Mariners,MARNRS,5,14,13,27,1978,1985,7,No,0,13.7,0.35,-13.35,1053,894,-159,693,2333,1640,4377.0,1863.0,-2514.0,175000.0,0.0,-175000.0
<a href=/player/romos001>romos001</a>,Sergio Romo,Los Angeles Dodgers,DOGRS,1,1,1,2,2017,2017,0,No,0,1.17,0.0,-1.17,105,0,-105,1,0,-1,294.0,0.0,-294.0,3000000.0,0.0,-3000000.0
<a href=/player/romos001>romos001</a>,Sergio Romo,Miami Marlins,MARLNS,1,3,1,4,2019,2019,0,Yes,0,0.34,0.0,-0.34,55,0,-55,0,0,0,128.0,0.0,-128.0,2500000.0,0.0,-2500000.0
<a href=/player/romov101>romov101</a>,Vicente Romo,Cleveland Indians,INDINS,1,3,3,6,1969,1970,1,No,0,13.72,3.96,-9.76,502,371,-131,436,691,255,3166.0,784.0,-2382.0,34500.0,0.0,-34500.0
<a href=/player/romov101>romov101</a>,Vicente Romo,Boston Red Sox,RSOX,1,2,2,4,1971,1971,0,No,0,2.81,0.28,-2.53,456,91,-365,786,331,-455,371.0,0.0,-371.0,0.0,0.0,0.0
<a href=/player/romov101>romov101</a>,Vicente Romo,Chicago White Sox,WSOX,3,4,3,7,1972,1976,4,No,0,-1.53,-0.31,1.22,214,295,81,44,1033,989,489.0,0.0,-489.0,27000.0,0.0,-27000.0
<a href=/player/ronam001>ronam001</a>,Marc Ronan,St. Louis Cardinals,CARDS,1,1,1,2,1995,1995,0,No,0,0.0,0.0,0.0,0,0,0,0,0,0,0.0,0.0,0.0,0.0,0.0,0.0
<a href=/player/rondh101>rondh101</a>,Henri Rondeau,Minneapolis,Minneapolis,1,1,1,2,1915,1927,12,No,0,0.51,0.0,-0.51,64,0,-64,241,0,-241,0.0,0.0,0.0,0.0,0.0,0.0
<a href=/player/rondj002>rondj002</a>,Jose Rondon,Anaheim Angels,ANGELS,2,6,4,10,2014,2017,3,No,0,-0.93,3.94,4.87,94,402,308,26,948,922,108.0,488.0,380.0,0.0,0.0,0.0
<a href=/player/roofp101>roofp101</a>,Phil Roof,Milwaukee Braves,BRAVES,6,12,9,21,1964,1968,4,No,0,-1.26,1.32,2.58,659,529,-130,866,569,-297,775.0,799.0,24.0,15000.0,0.0,-15000.0
<a href=/player/roofp101>roofp101</a>,Phil Roof,California Angels,ANGELS,1,1,2,3,1965,1965,0,No,0,-0.09,0.0,0.09,43,0,-43,61,0,-61,0.0,0.0,0.0,0.0,0.0,0.0
<a href=/player/roofp101>roofp101</a>,Phil Roof,Cleveland Indians,INDINS,4,7,7,14,1965,1973,8,No,0,23.16,3.29,-19.87,1705,368,-1337,6211,949,-5262,0.0,78.0,78.0,7000.0,0.0,-7000.0
<a href=/player/roofp101>roofp101</a>,Phil Roof,Oakland Athletics,ATLTCS,9,20,12,32,1970,1976,6,No,0,26.16,16.01,-10.15,3775,1399,-2376,8326,3903,-4423,4415.0,1098.0,-3317.0,340600.0,0.0,-340600.0
<a href=/player/roofp101>roofp101</a>,Phil Roof,Milwaukee Brewers,BREWRS,2,3,3,6,1971,1972,1,No,0,2.17,-0.95,-3.12,264,87,-177,684,171,-513,0.0,0.0,0.0,14000.0,0.0,-14000.0
<a href=/player/roofp101>roofp101</a>,Phil Roof,Chicago White Sox,WSOX,3,5,3,8,1976,1979,3,No,0,6.78,0.35,-6.43,404,42,-362,1180,0,-1180,453.0,375.0,-78.0,0.0,0.0,0.0
<a href=/player/rookj101>rookj101</a>,Jim Rooker,Detroit Tigers,TIGRS,1,1,1,2,1968,1969,1,No,0,0.0,0.35,0.35,0,44,44,0,2,2,0.0,91.0,91.0,8000.0,0.0,-8000.0
<a href=/player/rookj101>rookj101</a>,Jim Rooker,Kansas City Royals,ROYALS,1,1,1,2,1972,1974,2,No,0,17.06,0.82,-16.24,434,70,-364,496,0,-496,3953.0,542.0,-3411.0,0.0,0.0,0.0
<a href=/player/roomr001>roomr001</a>,Rolando Roomes,Chicago Cubs,CUBS,2,2,2,4,1988,1990,2,No,0,1.03,-0.43,-1.46,449,141,-308,1109,427,-682,0.0,0.0,0.0,272500.0,0.0,-272500.0
<a href=/player/roonp101>roonp101</a>,Pat Rooney,Montreal Expos,NATEX,3,3,5,8,1983,1991,8,No,0,3.57,11.27,7.7,227,856,629,6,53,47,2384.0,1852.0,-532.0,0.0,0.0,0.0
<a href=/player/ropej001>ropej001</a>,John Roper,Cincinnati Reds,REDS,5,11,7,18,1995,2010,15,No,0,11.19,26.95,15.76,438,1436,998,728,5040,4312,2595.0,2089.0,-506.0,13266667.0,0.0,-13266667.0
<a href=/player/roquj101>roquj101</a>,Jorge Roque,St. Louis Cardinals,CARDS,1,1,1,2,1972,1974,2,No,0,-0.69,0.03,0.72,25,204,179,66,518,452,0.0,0.0,0.0,0.0,0.0,0.0
<a href=/player/rosaa001>rosaa001</a>,Adam Rosales,Cincinnati Reds,REDS,1,2,2,4,2010,2010,0,No,0,1.98,0.0,-1.98,268,0,-268,835,0,-835,0.0,0.0,0.0,0.0,0.0,0.0
<a href=/player/rosaa001>rosaa001</a>,Adam Rosales,Oakland Athletics,ATLTCS,1,1,1,2,2017,2017,0,Yes,0,-0.56,0.0,0.56,34,0,-34,89,0,-89,0.0,0.0,0.0,1250000.0,0.0,-1250000.0
<a href=/player/rosaa003>rosaa003</a>,Amed Rosario,New York Mets,METS,1,4,2,6,2021,2021,0,Yes,0,2.78,2.19,-0.59,209,149,-60,798,543,-255,0.0,161.0,161.0,0.0,0.0,0.0
<a href=/player/rosab101>rosab101</a>,Buddy Rosar,New York Yankees,YANKS,1,2,2,4,1942,1946,4,No,0,14.72,6.82,-7.9,514,360,-154,2082,1425,-657,0.0,0.0,0.0,17500.0,0.0,-17500.0
<a href=/player/rosab101>rosab101</a>,Buddy Rosar,Cleveland Indians,INDINS,2,2,2,4,1945,1946,1,No,0,5.07,1.73,-3.34,490,184,-306,1872,669,-1203,0.0,0.0,0.0,13000.0,0.0,-13000.0
<a href=/player/rosab101>rosab101</a>,Buddy Rosar,Philadelphia Athletics,ATLTCS,2,2,2,4,1949,1953,4,No,0,-0.27,0.54,0.81,107,313,206,323,1157,834,0.0,0.0,0.0,12000.0,0.0,-12000.0
<a href=/player/rosac001>rosac001</a>,Carlos Rosa,Kansas City Royals,ROYALS,1,1,1,2,2010,2013,3,No,0,0.06,0.0,-0.06,44,0,-44,0,0,0,60.0,0.0,-60.0,0.0,0.0,0.0
<a href=/player/rosae001>rosae001</a>,Eddie Rosario,Cleveland Indians,INDINS,1,2,1,3,2021,2021,0,No,0,0.51,0.0,-0.51,33,0,-33,106,0,-106,0.0,0.0,0.0,8000000.0,0.0,-8000000.0
<a href=/player/rosal001>rosal001</a>,Leo Rosales,San Diego Padres,PADRS,9,21,17,38,2007,2021,14,Yes,0,21.52,23.86,2.34,2094,1770,-324,3969,4930,961,2913.0,702.0,-2211.0,11240300.0,0.0,-11240300.0
<a href=/player/rosal101>rosal101</a>,Luis Rosado,Baltimore Orioles,ORLS,1,1,1,2,1985,1986,1,No,0,0.0,0.0,0.0,0,0,0,0,0,0,0.0,0.0,0.0,0.0,0.0,0.0
<a href=/player/rosam001>rosam001</a>,Melvin Rosario,San Diego Padres,PADRS,1,1,1,2,1996,1996,0,No,0,-0.14,0.0,0.14,4,0,-4,3,0,-3,0.0,0.0,0.0,0.0,0.0,0.0
<a href=/player/rosas001>rosas001</a>,Sandy Rosario,Boston Red Sox,RSOX,1,1,1,2,2012,2013,1,No,0,0.0,0.0,0.0,0,0,0,0,0,0,0.0,0.0,0.0,0.0,0.0,0.0
<a href=/player/rosav001>rosav001</a>,Victor Rosario,Boston Red Sox,RSOX,1,1,1,2,1988,1988,0,No,0,0.0,-0.61,-0.61,0,9,9,0,0,0,0.0,48.0,48.0,0.0,0.0,0.0
<a href=/player/rosav001>rosav001</a>,Victor Rosario,Montreal Expos,NATEX,1,1,1,2,1989,1989,0,No,0,0.0,0.0,0.0,0,0,0,0,0,0,0.0,0.0,0.0,0.0,0.0,0.0
<a href=/player/rosav001>rosav001</a>,Victor Rosario,Philadelphia Phillies,PHILS,1,3,2,5,1990,1996,6,No,0,0.28,7.71,7.43,106,447,341,38,1122,1084,145.0,1741.0,1596.0,750000.0,0.0,-750000.0
<a href=/player/rosav001>rosav001</a>,Victor Rosario,Atlanta Braves,BRAVES,2,2,2,4,1991,1991,0,No,0,-0.64,-0.06,0.58,13,20,7,0,5,5,67.0,73.0,6.0,0.0,0.0,0.0
<a href=/player/roseb002>roseb002</a>,Brian Rose,Boston Red Sox,RSOX,2,5,5,10,2000,2002,2,No,0,0.87,1.83,0.96,125,248,123,134,537,403,371.0,782.0,411.0,3375000.0,0.0,-3375000.0
<a href=/player/roseb002>roseb002</a>,Brian Rose,Colorado Rockies,ROCKS,4,6,6,12,2001,2002,1,No,0,3.66,0.31,-3.35,530,189,-341,64,5,-59,933.0,301.0,-632.0,0.0,0.0,0.0
<a href=/player/rosed101>rosed101</a>,Dave Rosello,Chicago Cubs,CUBS,1,1,2,3,1977,1977,0,No,0,-0.15,0.0,0.15,173,0,-173,361,0,-361,0.0,0.0,0.0,0.0,0.0,0.0
<a href=/player/rosed102>rosed102</a>,Don Rose,New York Mets,METS,1,4,1,5,1971,1973,2,No,0,45.16,0.14,-45.02,957,146,-811,2120,526,-1594,6672.0,0.0,-6672.0,45950.0,0.0,-45950.0
<a href=/player/rosed102>rosed102</a>,Don Rose,California Angels,ANGELS,3,7,5,12,1973,1990,17,No,0,42.82,58.13,15.31,1088,2050,962,2703,8018,5315,7556.0,2386.0,-5170.0,175000.0,0.0,-175000.0
<a href=/player/roseg101>roseg101</a>,Goody Rosen,Cincinnati Reds,REDS,1,1,3,4,1944,1944,0,No,0,6.14,-0.35,-6.49,237,4,-233,969,0,-969,0.0,5.0,5.0,0.0,0.0,0.0
<a href=/player/roseh101>roseh101</a>,Harry Rosenberg,New York Giants,GIANTS,1,4,1,5,1931,1931,0,No,0,0.0,0.0,0.0,0,0,0,0,0,0,0.0,0.0,0.0,0.0,0.0,0.0
<a href=/player/rosej101>rosej101</a>,John Roseboro,Los Angeles Dodgers,DOGRS,1,3,2,5,1967,1968,1,No,0,7.85,0.27,-7.58,924,202,-722,948,467,-481,1656.0,285.0,-1371.0,122000.0,0.0,-122000.0
<a href=/player/rosel101>rosel101</a>,Larry Rosenthal,Cleveland Indians,INDINS,1,1,1,2,1942,1946,4,No,0,-0.23,0.66,0.89,36,89,53,120,246,126,0.0,0.0,0.0,0.0,0.0,0.0
<a href=/player/rosep001>rosep001</a>,Pete Rose,Montreal Expos,NATEX,2,2,2,4,1984,1985,1,No,0,0.38,0.14,-0.24,383,29,-354,1097,34,-1063,0.0,145.0,145.0,700000.0,0.0,-700000.0
<a href=/player/rosep002>rosep002</a>,Pete Rose,Baltimore Orioles,ORLS,3,4,3,7,1991,1996,5,No,0,0.29,-0.56,-0.85,94,84,-10,3,263,260,185.0,196.0,11.0,2934000.0,0.0,-2934000.0
<a href=/player/roses001>roses001</a>,Steve Rosenberg,New York Yankees,YANKS,2,4,3,7,1987,1989,2,No,0,7.16,-1.48,-8.64,782,63,-719,2351,14,-2337,594.0,729.0,135.0,247000.0,0.0,-247000.0
<a href=/player/roses001>roses001</a>,Steve Rosenberg,Chicago White Sox,WSOX,2,3,4,7,1991,1997,6,No,0,-0.66,5.47,6.13,79,723,644,105,2072,1967,199.0,133.0,-66.0,200000.0,0.0,-200000.0
<a href=/player/roses001>roses001</a>,Steve Rosenberg,San Diego Padres,PADRS,1,1,1,2,1991,1994,3,No,0,0.0,-0.75,-0.75,0,155,155,0,472,472,0.0,0.0,0.0,130000.0,0.0,-130000.0
<a href=/player/roset001>roset001</a>,Trevor Rosenthal,Kansas City Royals,ROYALS,1,1,2,3,2020,2020,0,Yes,0,0.64,-0.26,-0.9,10,18,8,0,65,65,30.0,0.0,-30.0,100000.0,0.0,-100000.0
<a href=/player/rosis001>rosis001</a>,Seth Rosin,San Francisco Giants,GIANTS,1,3,1,4,2012,2018,6,No,0,-0.86,10.45,11.31,288,772,484,953,3095,2142,6.0,0.0,-6.0,1300000.0,0.0,-1300000.0
<a href=/player/rossb102>rossb102</a>,Buck Ross,Williamsport,Williamsport,1,1,1,2,1936,1936,0,No,0,1.07,0.0,-1.07,282,0,-282,328,0,-328,2600.0,0.0,-2600.0,0.0,0.0,0.0
<a href=/player/rossb103>rossb103</a>,Buster Ross,Boston Red Sox,RSOX,1,3,1,4,1926,1926,0,No,0,0.0,-0.79,-0.79,0,31,31,0,103,103,0.0,0.0,0.0,7100.0,0.0,-7100.0
<a href=/player/rossc001>rossc001</a>,Cody Ross,Detroit Tigers,TIGRS,2,2,2,4,2004,2005,1,No,0,0.28,-0.78,-1.06,22,59,37,40,0,-40,0.0,201.0,201.0,0.0,0.0,0.0
<a href=/player/rossc001>rossc001</a>,Cody Ross,Los Angeles Dodgers,DOGRS,1,1,1,2,2006,2006,0,No,0,-0.15,0.0,0.15,2,0,-2,5,0,-5,0.0,0.0,0.0,327500.0,0.0,-327500.0
<a href=/player/rossc101>rossc101</a>,Claude Rossman,Detroit Tigers,TIGRS,1,1,1,2,1909,1909,0,No,0,-0.1,0.92,1.02,2,44,42,8,165,157,0.0,0.0,0.0,0.0,0.0,0.0
<a href=/player/rossd001>rossd001</a>,David Ross,Pittsburgh Pirates,PIRATS,1,1,1,2,2005,2006,1,No,0,0.15,0.16,0.01,11,13,2,19,30,11,0.0,0.0,0.0,338500.0,0.0,-338500.0
<a href=/player/rossd001>rossd001</a>,David Ross,San Diego Padres,PADRS,1,1,1,2,2006,2006,0,No,0,2.33,0.0,-2.33,254,0,-254,817,0,-817,0.0,0.0,0.0,0.0,0.0,0.0
<a href=/player/rossd101>rossd101</a>,Don Ross,Detroit Tigers,TIGRS,1,2,1,3,1945,1947,2,No,0,5.36,14.82,9.46,363,401,38,1392,1659,267,0.0,0.0,0.0,0.0,0.0,0.0
<a href=/player/rossg102>rossg102</a>,Gary Ross,Chicago Cubs,CUBS,3,6,4,10,1969,1974,5,No,0,4.19,2.65,-1.54,1200,512,-688,1393,950,-443,2550.0,898.0,-1652.0,19000.0,0.0,-19000.0
<a href=/player/rossg102>rossg102</a>,Gary Ross,San Diego Padres,PADRS,4,5,5,10,1975,1984,9,No,1,2.16,2.27,0.11,264,384,120,280,800,520,1033.0,0.0,-1033.0,0.0,0.0,0.0
<a href=/player/rossj002>rossj002</a>,Joe Ross,San Diego Padres,PADRS,3,7,6,13,2014,2020,6,Yes,0,27.39,-1.48,-28.87,938,146,-792,3307,301,-3006,1330.0,78.0,-1252.0,506400.0,0.0,-506400.0
<a href=/player/rossj101>rossj101</a>,Joe Rossi,Cincinnati Reds,REDS,1,3,1,4,1952,1961,9,No,0,1.64,13.15,11.51,150,1235,1085,601,5109,4508,0.0,0.0,0.0,0.0,0.0,0.0
<a href=/player/rossr001>rossr001</a>,Rico Rossy,Baltimore Orioles,ORLS,1,2,1,3,1987,1992,5,No,0,0.0,8.01,8.01,0,632,632,0,2276,2276,0.0,0.0,0.0,0.0,0.0,0.0
<a href=/player/rossr001>rossr001</a>,Rico Rossy,Pittsburgh Pirates,PIRATS,1,1,1,2,1990,1992,2,No,0,-0.04,0.0,0.04,5,0,-5,1,0,-1,0.0,0.0,0.0,0.0,0.0,0.0
<a href=/player/rossr001>rossr001</a>,Rico Rossy,Atlanta Braves,BRAVES,1,1,1,2,1991,1991,0,No,0,1.07,0.0,-1.07,105,0,-105,275,0,-275,0.0,0.0,0.0,0.0,0.0,0.0
<a href=/player/rossr002>rossr002</a>,Robbie Ross,Texas Rangers,RNGRS,2,2,2,4,2015,2016,1,Yes,0,0.78,-0.8,-1.58,135,7,-128,3,2,-1,458.0,57.0,-401.0,0.0,0.0,0.0
<a href=/player/rosst001>rosst001</a>,Tyson Ross,Oakland Athletics,ATLTCS,1,2,2,4,2012,2014,2,No,0,8.33,-0.72,-9.05,240,35,-205,210,87,-123,1936.0,0.0,-1936.0,0.0,0.0,0.0
<a href=/player/rossz001>rossz001</a>,Zac Rosscup,Tampa Bay Devil Rays,RAYS,3,5,10,15,2011,2018,7,Yes,0,7.14,19.57,12.43,511,809,298,692,1746,1054,1779.0,3357.0,1578.0,0.0,0.0,0.0
<a href=/player/rossz001>rossz001</a>,Zac Rosscup,Chicago Cubs,CUBS,1,1,1,2,2017,2017,0,No,0,0.07,0.0,-0.07,24,0,-24,0,0,0,30.0,0.0,-30.0,0.0,0.0,0.0
<a href=/player/rotbm101>rotbm101</a>,Marv Rotblatt,Chicago White Sox,WSOX,3,10,4,14,1951,1953,2,No,0,2.36,0.32,-2.04,404,226,-178,236,372,136,2232.0,741.0,-1491.0,0.0,0.0,0.0
<a href=/player/rothb102>rothb102</a>,Braggo Roth,Chicago White Sox,WSOX,1,4,1,5,1915,1915,0,No,0,12.78,0.79,-11.99,588,45,-543,1793,193,-1600,1219.0,0.0,-1219.0,0.0,0.0,0.0
<a href=/player/rothb102>rothb102</a>,Braggo Roth,Cleveland Indians,INDINS,1,2,3,5,1919,1932,13,No,0,1.85,28.0,26.15,48,1706,1658,214,7031,6817,0.0,678.0,678.0,0.0,0.0,0.0
<a href=/player/rothb102>rothb102</a>,Braggo Roth,Philadelphia Athletics,ATLTCS,1,2,2,4,1919,1920,1,No,0,0.98,0.04,-0.94,143,118,-25,582,462,-120,0.0,0.0,0.0,2400.0,0.0,-2400.0
<a href=/player/rothb102>rothb102</a>,Braggo Roth,Boston Red Sox,RSOX,12,23,27,50,1919,1937,18,No,0,88.36,56.94,-31.42,3577,3010,-567,9223,10199,976,11819.0,5427.0,-6392.0,73300.0,0.0,-73300.0
<a href=/player/rothb102>rothb102</a>,Braggo Roth,Washington Senators,TWINS,2,3,3,6,1920,1926,6,No,0,2.6,17.64,15.04,206,362,156,681,558,-123,46.0,3052.0,3006.0,8600.0,0.0,-8600.0
<a href=/player/rothf101>rothf101</a>,Frank Roth,Milwaukee,Milwaukee,1,1,2,3,1909,1909,0,No,0,-0.12,0.0,0.12,82,0,-82,193,0,-193,0.0,0.0,0.0,0.0,0.0,0.0
<a href=/player/rothf101>rothf101</a>,Frank Roth,St.Louis Browns,ORLS,2,2,3,5,1906,1907,1,No,0,-1.04,4.12,5.16,52,188,136,153,695,542,0.0,0.0,0.0,0.0,0.0,0.0
<a href=/player/rothf101>rothf101</a>,Frank Roth,Indianapolis,Indianapolis,1,1,2,3,1905,1913,8,No,0,0.06,0.0,-0.06,35,0,-35,115,0,-115,0.0,0.0,0.0,0.0,0.0,0.0
<a href=/player/rothf101>rothf101</a>,Frank Roth,Philadelphia Phillies,PHILS,1,2,1,3,1905,1905,0,No,0,0.0,0.2,0.2,0,16,16,0,52,52,0.0,0.0,0.0,0.0,0.0,0.0
<a href=/player/rothj101>rothj101</a>,Jack Rothrock,Boston Red Sox,RSOX,4,10,7,17,1932,1937,5,No,0,13.6,8.5,-5.1,544,1121,577,1112,4164,3052,1631.0,0.0,-1631.0,49250.0,0.0,-49250.0
<a href=/player/rothj101>rothj101</a>,Jack Rothrock,Chicago White Sox,WSOX,1,2,1,3,1932,1932,0,No,0,1.87,0.41,-1.46,283,14,-269,1288,61,-1227,0.0,0.0,0.0,5000.0,0.0,-5000.0
<a href=/player/rottv001>rottv001</a>,Vinny Rottino,Milwaukee Brewers,BREWRS,1,1,1,2,2009,2010,1,No,0,0.0,0.64,0.64,0,89,89,0,3,3,0.0,150.0,150.0,0.0,0.0,0.0
<a href=/player/rouse101>rouse101</a>,Edd Roush,New York Giants,GIANTS,3,6,6,12,1916,1923,7,No,0,51.71,19.99,-31.72,1982,727,-1255,7625,1751,-5874,2062.0,3773.0,1711.0,15800.0,0.0,-15800.0
<a href=/player/rouse101>rouse101</a>,Edd Roush,Cincinnati Reds,REDS,1,1,2,3,1927,1930,3,No,0,2.72,3.25,0.53,301,375,74,1302,1523,221,0.0,0.0,0.0,0.0,0.0,0.0
<a href=/player/rousm001>rousm001</a>,Mike Rouse,Toronto Blue Jays,BJAYS,1,2,1,3,2002,2003,1,No,0,0.04,0.58,0.54,8,33,25,26,6,-20,0.0,578.0,578.0,0.0,0.0,0.0
<a href=/player/rousm001>rousm001</a>,Mike Rouse,Chicago White Sox,WSOX,1,1,1,2,2008,2008,0,No,0,0.0,0.0,0.0,0,0,0,0,0,0,0.0,0.0,0.0,0.0,0.0,0.0
<a href=/player/rowaa001>rowaa001</a>,Aaron Rowand,Chicago White Sox,WSOX,2,5,3,8,2005,2009,4,No,0,5.6,12.08,6.48,287,529,242,1146,2165,1019,0.0,0.0,0.0,15000000.0,0.0,-15000000.0
<a href=/player/rowaj101>rowaj101</a>,Jack Rowan,Cincinnati Reds,REDS,2,6,5,11,1910,1914,4,No,0,23.79,7.43,-16.36,1495,715,-780,6220,2571,-3649,283.0,231.0,-52.0,0.0,0.0,0.0
<a href=/player/rowaj101>rowaj101</a>,Jack Rowan,Philadelphia Phillies,PHILS,1,1,1,2,1911,1912,1,No,0,-0.25,0.3,0.55,2,36,34,1,32,31,6.0,285.0,279.0,0.0,0.0,0.0
<a href=/player/rowdw001>rowdw001</a>,Wade Rowdon,Chicago White Sox,WSOX,1,2,1,3,1982,1984,2,No,0,-0.41,-0.13,0.28,101,14,-87,177,0,-177,0.0,86.0,86.0,0.0,0.0,0.0
<a href=/player/rowdw001>rowdw001</a>,Wade Rowdon,Cincinnati Reds,REDS,1,1,1,2,1987,1988,1,No,0,-0.21,1.39,1.6,11,72,61,34,48,14,0.0,476.0,476.0,0.0,0.0,0.0
<a href=/player/rowdw001>rowdw001</a>,Wade Rowdon,Chicago Cubs,CUBS,1,1,2,3,1988,1988,0,No,0,-0.57,0.0,0.57,20,0,-20,30,0,-30,0.0,0.0,0.0,0.0,0.0,0.0
<a href=/player/roweb001>roweb001</a>,Ben Rowen,Los Angeles Dodgers,DOGRS,1,2,3,5,2015,2015,0,Yes,0,0.0,0.0,0.0,0,0,0,0,0,0,0.0,0.0,0.0,0.0,0.0,0.0
<a href=/player/roweb101>roweb101</a>,Bama Rowell,Boston Braves,BRAVES,4,15,8,23,1948,1960,12,No,0,49.35,41.77,-7.58,2025,1769,-256,7279,7265,-14,2138.0,0.0,-2138.0,0.0,0.0,0.0
<a href=/player/rowlr001>rowlr001</a>,Rich Rowland,Detroit Tigers,TIGRS,8,16,19,35,1994,2010,16,No,1,12.99,23.4,10.41,4921,1754,-3167,12902,3237,-9665,4562.0,6757.0,2195.0,12079000.0,0.0,-12079000.0
<a href=/player/roy-l101>roy-l101</a>,Luther Roy,Philadelphia Phillies,PHILS,1,1,1,2,1929,1937,8,No,0,0.03,0.08,0.05,4,56,52,1,46,45,11.0,373.0,362.0,4500.0,0.0,-4500.0
<a href=/player/royes001>royes001</a>,Stan Royer,Oakland Athletics,ATLTCS,2,4,3,7,1990,1991,1,No,2,4.87,0.81,-4.06,395,29,-366,1429,123,-1306,0.0,0.0,0.0,102500.0,0.0,-102500.0
<a href=/player/roysj001>roysj001</a>,Jerry Royster,Los Angeles Dodgers,DOGRS,1,4,2,6,1975,1984,9,No,0,-0.88,19.14,20.02,1504,1261,-243,5163,4749,-414,0.0,0.0,0.0,0.0,0.0,0.0
<a href=/player/roysj001>roysj001</a>,Jerry Royster,Chicago White Sox,WSOX,2,4,3,7,1987,1993,6,No,0,58.18,-1.05,-59.23,1893,402,-1491,7947,1106,-6841,125.0,649.0,524.0,260000.0,0.0,-260000.0
<a href=/player/rozed101>rozed101</a>,Dick Rozek,Cleveland Indians,INDINS,1,2,1,3,1952,1955,3,No,0,0.19,-0.65,-0.84,8,120,112,3,17,14,36.0,312.0,276.0,0.0,0.0,0.0
<a href=/player/roznv101>roznv101</a>,Vic Roznovsky,Chicago Cubs,CUBS,1,1,1,2,1966,1966,0,No,0,-0.4,-0.09,0.31,86,16,-70,210,22,-188,0.0,0.0,0.0,0.0,0.0,0.0
<a href=/player/roznv101>roznv101</a>,Vic Roznovsky,Baltimore Orioles,ORLS,1,1,2,3,1969,1970,1,No,0,-0.07,0.0,0.07,13,0,-13,14,0,-14,0.0,0.0,0.0,0.0,0.0,0.0
<a href=/player/ruanw001>ruanw001</a>,Wilkin Ruan,Montreal Expos,NATEX,4,7,10,17,2002,2004,2,No,0,14.79,-4.81,-19.6,572,445,-127,87,268,181,2398.0,643.0,-1755.0,370000.0,0.0,-370000.0
<a href=/player/rubes101>rubes101</a>,Sonny Ruberto,St. Louis Cardinals,CARDS,3,5,4,9,1969,1972,3,No,0,0.79,1.88,1.09,125,189,64,357,73,-284,0.0,264.0,264.0,10000.0,0.0,-10000.0
<a href=/player/rubij101>rubij101</a>,Jorge Rubio,California Angels,ANGELS,3,4,4,8,1967,1971,4,No,0,-0.47,-0.05,0.42,214,297,83,361,652,291,251.0,492.0,241.0,20000.0,0.0,-20000.0
<a href=/player/rubla101>rubla101</a>,Art Ruble,Philadelphia Phillies,PHILS,1,3,2,5,1934,1941,7,No,0,-1.11,22.67,23.78,139,911,772,269,2270,2001,324.0,2379.0,2055.0,0.0,0.0,0.0
<a href=/player/rubla101>rubla101</a>,Art Ruble,Cincinnati Reds,REDS,1,2,1,3,1934,1934,0,No,0,0.0,1.09,1.09,0,99,99,0,387,387,0.0,0.0,0.0,0.0,0.0,0.0
<a href=/player/ruckd001>ruckd001</a>,Dave Rucker,Detroit Tigers,TIGRS,1,1,1,2,1983,1985,2,No,0,1.7,-0.91,-2.61,168,97,-71,11,0,-11,330.0,595.0,265.0,0.0,0.0,0.0
<a href=/player/ruckd001>ruckd001</a>,Dave Rucker,St. Louis Cardinals,CARDS,3,4,6,10,1985,1996,11,No,1,-1.47,9.07,10.54,197,986,789,340,3253,2913,313.0,822.0,509.0,3700000.0,0.0,-3700000.0
<a href=/player/rudij101>rudij101</a>,Joe Rudi,Cleveland Indians,INDINS,4,7,7,14,1965,1973,8,No,0,23.16,3.29,-19.87,1705,368,-1337,6211,949,-5262,0.0,78.0,78.0,7000.0,0.0,-7000.0
<a href=/player/rudij101>rudij101</a>,Joe Rudi,California Angels,ANGELS,3,7,5,12,1981,1992,11,No,1,-0.2,18.35,18.55,173,631,458,348,1947,1599,512.0,2439.0,1927.0,0.0,0.0,0.0
<a href=/player/rudod101>rudod101</a>,Dick Rudolph,Toronto,Toronto,1,1,2,3,1913,1913,0,No,0,23.58,0.0,-23.58,555,0,-555,778,0,-778,6096.0,0.0,-6096.0,0.0,0.0,0.0
<a href=/player/rudod103>rudod103</a>,Don Rudolph,Chicago White Sox,WSOX,1,2,1,3,1959,1959,0,No,0,0.02,-0.82,-0.84,10,26,16,1,100,99,22.0,0.0,-22.0,10500.0,0.0,-10500.0
<a href=/player/rudod103>rudod103</a>,Don Rudolph,Cleveland Indians,INDINS,1,2,1,3,1962,1962,0,No,0,3.15,-0.76,-3.91,294,75,-219,163,225,62,1590.0,0.0,-1590.0,0.0,0.0,0.0
<a href=/player/rudok101>rudok101</a>,Ken Rudolph,Chicago Cubs,CUBS,1,1,1,2,1974,1974,0,No,0,0.14,0.0,-0.14,68,0,-68,197,0,-197,0.0,0.0,0.0,0.0,0.0,0.0
<a href=/player/rudok101>rudok101</a>,Ken Rudolph,San Francisco Giants,GIANTS,1,2,1,3,1974,1980,6,No,0,-1.06,2.57,3.63,99,431,332,142,1370,1228,82.0,0.0,-82.0,0.0,0.0,0.0
<a href=/player/ruelm101>ruelm101</a>,Muddy Ruel,New York Yankees,YANKS,4,8,10,18,1920,1931,11,No,0,18.87,48.71,29.84,1297,1673,376,4337,4022,-315,1020.0,6917.0,5897.0,44500.0,0.0,-44500.0
<a href=/player/ruelm101>ruelm101</a>,Muddy Ruel,Boston Red Sox,RSOX,5,7,7,14,1923,1929,6,No,0,20.64,17.92,-2.72,1225,1357,132,3718,5420,1702,990.0,0.0,-990.0,10750.0,0.0,-10750.0
<a href=/player/ruelm101>ruelm101</a>,Muddy Ruel,Boston Red Sox,RSOX,1,1,1,2,1931,1933,2,No,0,-0.44,3.49,3.93,65,216,151,211,840,629,0.0,0.0,0.0,10000.0,0.0,-10000.0
<a href=/player/ruetd101>ruetd101</a>,Dutch Ruether,Cincinnati Reds,REDS,2,3,2,5,1920,1922,2,No,0,11.63,2.48,-9.15,717,80,-637,1324,100,-1224,4403.0,797.0,-3606.0,7500.0,0.0,-7500.0
<a href=/player/ruetd101>ruetd101</a>,Dutch Ruether,Washington Senators,TWINS,2,3,3,6,1926,1931,5,No,0,3.59,10.98,7.39,317,349,32,724,316,-408,1075.0,1748.0,673.0,23500.0,0.0,-23500.0
<a href=/player/ruetk001>ruetk001</a>,Kirk Rueter,Montreal Expos,NATEX,1,2,1,3,1996,1996,0,No,0,12.18,0.67,-11.51,598,24,-574,619,29,-590,4901.0,209.0,-4692.0,860000.0,0.0,-860000.0
<a href=/player/ruf-d001>ruf-d001</a>,Darin Ruf,Philadelphia Phillies,PHILS,3,5,5,10,2016,2018,2,No,0,3.05,1.06,-1.99,238,68,-170,808,210,-598,0.0,0.0,0.0,10527000.0,0.0,-10527000.0
<a href=/player/rufer101>rufer101</a>,Rudy Rufer,Cincinnati Reds,REDS,2,5,2,7,1952,1961,9,No,0,1.64,13.96,12.32,150,1306,1156,601,5286,4685,0.0,0.0,0.0,0.0,0.0,0.0
<a href=/player/ruffb001>ruffb001</a>,Bruce Ruffin,Philadelphia Phillies,PHILS,2,2,2,4,1991,1992,1,No,0,-1.01,-1.02,-0.01,65,78,13,131,153,22,174.0,66.0,-108.0,375000.0,0.0,-375000.0
<a href=/player/ruffc001>ruffc001</a>,Chance Ruffin,Detroit Tigers,TIGRS,7,12,11,23,2011,2021,10,Yes,0,17.56,10.21,-7.35,1262,701,-561,1311,661,-650,4444.0,2831.0,-1613.0,16933000.0,0.0,-16933000.0
<a href=/player/ruffj001>ruffj001</a>,Johnny Ruffin,Chicago White Sox,WSOX,1,2,1,3,1993,1993,0,No,0,1.84,0.47,-1.37,262,12,-250,17,0,-17,550.0,215.0,-335.0,0.0,0.0,0.0
<a href=/player/ruffr101>ruffr101</a>,Red Ruffing,Danville,Danville,1,1,1,2,1923,1923,0,No,0,12.63,0.0,-12.63,426,0,-426,469,0,-469,3359.0,0.0,-3359.0,0.0,0.0,0.0
<a href=/player/ruffr101>ruffr101</a>,Red Ruffing,Boston Red Sox,RSOX,1,1,2,3,1930,1930,0,No,0,56.84,-0.48,-57.32,1057,102,-955,1589,330,-1259,9506.0,0.0,-9506.0,6750.0,0.0,-6750.0
<a href=/player/ruggj001>ruggj001</a>,Justin Ruggiano,Los Angeles Dodgers,DOGRS,1,3,3,6,2006,2007,1,No,0,1.99,-0.07,-2.06,586,130,-456,1881,113,-1768,426.0,593.0,167.0,682000.0,0.0,-682000.0
<a href=/player/ruggj001>ruggj001</a>,Justin Ruggiano,Houston Astros,ASTROS,1,1,1,2,2012,2012,0,No,0,2.67,0.0,-2.67,219,0,-219,792,0,-792,0.0,0.0,0.0,0.0,0.0,0.0
<a href=/player/ruggj001>ruggj001</a>,Justin Ruggiano,Miami Marlins,MARLNS,1,1,1,2,2013,2014,1,No,0,-0.37,0.0,0.37,81,0,-81,250,0,-250,0.0,0.0,0.0,494500.0,0.0,-494500.0
<a href=/player/ruggj001>ruggj001</a>,Justin Ruggiano,Chicago Cubs,CUBS,1,1,1,2,2014,2014,0,Yes,0,-0.53,0.0,0.53,36,0,-36,81,0,-81,0.0,0.0,0.0,2000000.0,0.0,-2000000.0
<a href=/player/ruggj001>ruggj001</a>,Justin Ruggiano,Seattle Mariners,MARNRS,1,2,1,3,2015,2015,0,No,0,0.64,0.0,-0.64,21,0,-21,60,0,-60,0.0,0.0,0.0,2505000.0,0.0,-2505000.0
<a href=/player/ruizc001>ruizc001</a>,Carlos Ruiz,Philadelphia Phillies,PHILS,2,3,4,7,2016,2017,1,Yes,0,0.23,0.19,-0.04,14,11,-3,40,35,-5,0.0,0.0,0.0,0.0,0.0,0.0
<a href=/player/ruizc001>ruizc001</a>,Carlos Ruiz,Los Angeles Dodgers,DOGRS,2,2,2,4,2016,2017,1,Yes,0,-0.05,0.0,0.05,67,0,-67,146,0,-146,47.0,0.0,-47.0,8500000.0,0.0,-8500000.0
<a href=/player/ruizc102>ruizc102</a>,Chico Ruiz,Cincinnati Reds,REDS,9,11,14,25,1969,1988,19,No,0,6.47,49.11,42.64,1174,3400,2226,3915,6767,2852,279.0,5781.0,5502.0,18500.0,0.0,-18500.0
<a href=/player/ruizk001>ruizk001</a>,Keibert Ruiz,Los Angeles Dodgers,DOGRS,1,4,2,6,2021,2021,0,Yes,0,0.24,4.89,4.65,47,74,27,110,252,142,188.0,205.0,17.0,0.0,0.0,0.0
<a href=/player/ruizr002>ruizr002</a>,Rio Ruiz,Houston Astros,ASTROS,2,4,3,7,2015,2018,3,Yes,0,4.87,5.33,0.46,316,563,247,420,1880,1460,2027.0,215.0,-1812.0,0.0,0.0,0.0
<a href=/player/rullj101>rullj101</a>,Joe Rullo,Philadelphia Athletics,ATLTCS,1,5,1,6,1944,1946,2,No,0,0.0,1.19,1.19,0,162,162,0,669,669,0.0,0.0,0.0,3000.0,0.0,-3000.0
<a href=/player/rumbn001>rumbn001</a>,Nick Rumbelow,New York Yankees,YANKS,2,2,4,6,2017,2019,2,Yes,0,-0.4,0.67,1.07,16,44,28,0,197,197,57.0,0.0,-57.0,0.0,0.0,0.0
<a href=/player/rumlw101>rumlw101</a>,William Rumler,LittleRock,LittleRock,1,1,3,4,1916,1916,0,No,0,0.66,0.0,-0.66,105,0,-105,140,0,-140,0.0,0.0,0.0,0.0,0.0,0.0
<a href=/player/rumlw101>rumlw101</a>,William Rumler,St.Louis Browns,ORLS,1,4,2,6,1915,1924,9,No,0,0.0,-0.32,-0.32,0,2,2,0,1,1,0.0,10.0,10.0,0.0,0.0,0.0
<a href=/player/rundr001>rundr001</a>,Rich Rundles,Boston Red Sox,RSOX,1,2,1,3,2001,2002,1,No,0,9.01,2.21,-6.8,198,82,-116,193,0,-193,1755.0,240.0,-1515.0,225000.0,0.0,-225000.0
<a href=/player/runnp101>runnp101</a>,Pete Runnels,Washington Senators,TWINS,3,4,5,9,1958,1966,8,No,0,19.19,5.56,-13.63,1091,1232,141,3807,4135,328,0.0,0.0,0.0,15000.0,0.0,-15000.0
<a href=/player/runnp101>runnp101</a>,Pete Runnels,Boston Red Sox,RSOX,1,1,1,2,1962,1962,0,No,0,0.46,0.0,-0.46,146,0,-146,508,0,-508,0.0,0.0,0.0,0.0,0.0,0.0
<a href=/player/runys001>runys001</a>,Sean Runyan,Houston Astros,ASTROS,2,2,2,4,1997,2000,3,No,0,-0.04,0.72,0.76,263,394,131,612,1149,537,0.0,6.0,6.0,0.0,0.0,0.0
<a href=/player/rupej001>rupej001</a>,Josh Rupe,Chicago White Sox,WSOX,1,3,1,4,2003,2003,0,No,0,5.54,2.04,-3.5,375,73,-302,0,289,289,1248.0,0.0,-1248.0,0.0,0.0,0.0
<a href=/player/ruscg001>ruscg001</a>,Glendon Rusch,Kansas City Royals,ROYALS,1,1,1,2,1999,1999,0,No,0,2.31,-0.28,-2.59,126,4,-122,118,0,-118,1112.0,25.0,-1087.0,0.0,0.0,0.0
<a href=/player/ruscg001>ruscg001</a>,Glendon Rusch,New York Mets,METS,11,24,26,50,2002,2021,19,Yes,0,23.92,23.68,-0.24,974,1702,728,1624,4506,2882,6006.0,3554.0,-2452.0,30731467.0,0.0,-30731467.0
<a href=/player/rushb101>rushb101</a>,Bob Rush,Chicago Cubs,CUBS,11,20,17,37,1957,1977,20,No,0,15.71,44.12,28.41,1386,3941,2555,1236,10815,9579,4659.0,6233.0,1574.0,122500.0,0.0,-122500.0
<a href=/player/rusia101>rusia101</a>,Amos Rusie,New York Giants,GIANTS,4,7,7,14,1900,1923,23,No,0,51.02,126.6,75.58,1988,2008,20,7634,3637,-3997,2128.0,18112.0,15984.0,15800.0,0.0,-15800.0
<a href=/player/rusks001>rusks001</a>,Scott Ruskin,Pittsburgh Pirates,PIRATS,1,3,1,4,1990,1994,4,No,0,13.0,10.16,-2.84,782,221,-561,2388,261,-2127,274.0,2055.0,1781.0,200000.0,0.0,-200000.0
<a href=/player/rusks001>rusks001</a>,Scott Ruskin,Montreal Expos,NATEX,2,4,4,8,1991,2001,10,No,0,7.84,6.46,-1.38,825,557,-268,1993,412,-1581,539.0,721.0,182.0,287500.0,0.0,-287500.0
<a href=/player/russa001>russa001</a>,Adam Russell,Chicago White Sox,WSOX,6,14,12,26,2009,2018,9,Yes,0,7.16,22.73,15.57,991,1029,38,935,3763,2828,4825.0,1688.0,-3137.0,13340000.0,0.0,-13340000.0
<a href=/player/russa001>russa001</a>,Adam Russell,San Diego Padres,PADRS,1,4,1,5,2010,2012,2,No,0,1.36,-1.01,-2.37,435,168,-267,53,716,663,1270.0,0.0,-1270.0,401300.0,0.0,-401300.0
<a href=/player/russa002>russa002</a>,Addison Russell,Oakland Athletics,ATLTCS,2,6,6,12,2014,2020,6,Yes,0,10.93,24.37,13.44,708,1106,398,2216,4232,2016,860.0,540.0,-320.0,5345000.0,0.0,-5345000.0
<a href=/player/russa101>russa101</a>,Allen Russell,New York Yankees,YANKS,1,3,1,4,1919,1923,4,No,0,4.53,19.1,14.57,242,331,89,205,452,247,1664.0,3271.0,1607.0,4800.0,0.0,-4800.0
<a href=/player/russa101>russa101</a>,Allen Russell,Boston Red Sox,RSOX,5,7,7,14,1923,1929,6,No,0,20.64,17.92,-2.72,1225,1357,132,3718,5420,1702,990.0,0.0,-990.0,10750.0,0.0,-10750.0
<a href=/player/russj001>russj001</a>,Jeff Russell,Cincinnati Reds,REDS,2,3,2,5,1985,1988,3,No,0,10.64,5.16,-5.48,575,386,-189,438,1599,1161,2258.0,0.0,-2258.0,790909.0,0.0,-790909.0
<a href=/player/russj001>russj001</a>,Jeff Russell,Texas Rangers,RNGRS,2,5,3,8,1992,1996,4,No,0,8.49,4.09,-4.4,638,377,-261,2442,1627,-815,1191.0,3.0,-1188.0,15083333.0,0.0,-15083333.0
<a href=/player/russj001>russj001</a>,Jeff Russell,Boston Red Sox,RSOX,1,1,2,3,1994,1994,0,No,0,-0.01,-0.23,-0.22,13,19,6,0,0,0,38.0,165.0,127.0,2975000.0,0.0,-2975000.0
<a href=/player/russj003>russj003</a>,James Russell,Chicago Cubs,CUBS,2,5,6,11,2014,2021,7,Yes,0,0.58,0.03,-0.55,319,313,-6,628,721,93,572.0,456.0,-116.0,26275000.0,0.0,-26275000.0
<a href=/player/russj102>russj102</a>,Jim Russell,Pittsburgh Pirates,PIRATS,2,5,3,8,1947,1949,2,No,0,5.52,3.82,-1.7,394,236,-158,1349,883,-466,38.0,0.0,-38.0,0.0,0.0,0.0
<a href=/player/russj102>russj102</a>,Jim Russell,Boston Braves,BRAVES,1,3,1,4,1949,1949,0,No,0,0.73,0.0,-0.73,93,0,-93,264,0,-264,0.0,0.0,0.0,0.0,0.0,0.0
<a href=/player/russj103>russj103</a>,Jack Russell,Boston Red Sox,RSOX,1,1,1,2,1932,1946,14,No,0,1.94,-0.21,-2.15,36,22,-14,43,17,-26,339.0,138.0,-201.0,5500.0,0.0,-5500.0
<a href=/player/russj103>russj103</a>,Jack Russell,Cleveland Indians,INDINS,1,2,1,3,1932,1932,0,No,0,3.72,0.0,-3.72,330,0,-330,151,0,-151,1373.0,0.0,-1373.0,0.0,0.0,0.0
<a href=/player/russj103>russj103</a>,Jack Russell,Washington Senators,TWINS,1,1,1,2,1936,1937,1,No,0,0.35,0.62,0.27,46,64,18,7,64,57,120.0,515.0,395.0,7000.0,0.0,-7000.0
<a href=/player/russr101>russr101</a>,Rip Russell,Chicago Cubs,CUBS,1,1,2,3,1945,1949,4,No,0,-1.34,0.0,1.34,106,0,-106,357,0,-357,0.0,0.0,0.0,0.0,0.0,0.0
<a href=/player/russr102>russr102</a>,Reb Russell,Minneapolis,Minneapolis,1,1,2,3,1922,1928,6,No,0,4.2,0.0,-4.2,154,0,-154,568,0,-568,0.0,0.0,0.0,0.0,0.0,0.0
<a href=/player/ruthd001>ruthd001</a>,Dick Ruthven,Philadelphia Phillies,PHILS,1,3,2,5,1975,1979,4,No,0,0.71,0.93,0.22,442,215,-227,1620,199,-1421,0.0,1610.0,1610.0,0.0,0.0,0.0
<a href=/player/ruthd001>ruthd001</a>,Dick Ruthven,Chicago White Sox,WSOX,5,8,7,15,1975,1985,10,No,1,12.65,5.98,-6.67,638,673,35,1614,2532,918,1538.0,16.0,-1522.0,0.0,0.0,0.0
<a href=/player/ruthd001>ruthd001</a>,Dick Ruthven,Atlanta Braves,BRAVES,2,2,2,4,1978,1987,9,No,0,7.23,9.52,2.29,313,1116,803,332,94,-238,2784.0,2568.0,-216.0,851667.0,0.0,-851667.0
<a href=/player/ruthd001>ruthd001</a>,Dick Ruthven,Philadelphia Phillies,PHILS,4,8,7,15,1983,1989,6,No,0,22.89,10.28,-12.61,2046,1011,-1035,3682,3184,-498,3936.0,302.0,-3634.0,1629900.0,0.0,-1629900.0
<a href=/player/rutlj001>rutlj001</a>,Josh Rutledge,Colorado Rockies,ROCKS,1,1,1,2,2014,2018,4,No,0,0.0,0.51,0.51,0,48,48,0,0,0,0.0,72.0,72.0,501000.0,0.0,-501000.0
<a href=/player/rutlj001>rutlj001</a>,Josh Rutledge,Anaheim Angels,ANGELS,1,1,2,3,2015,2015,0,No,0,-0.13,-0.33,-0.2,104,38,-66,259,98,-161,0.0,0.0,0.0,0.0,0.0,0.0
<a href=/player/ryanb001>ryanb001</a>,B.J. Ryan,Cincinnati Reds,REDS,3,4,5,9,1999,2006,7,No,2,8.35,0.25,-8.1,496,86,-410,2,96,94,1642.0,746.0,-896.0,0.0,0.0,0.0
<a href=/player/ryanb002>ryanb002</a>,Brendan Ryan,St. Louis Cardinals,CARDS,1,1,1,2,2010,2013,3,No,0,7.49,-0.77,-8.26,351,26,-325,1251,3,-1248,0.0,47.0,47.0,425000.0,0.0,-425000.0
<a href=/player/ryanb002>ryanb002</a>,Brendan Ryan,Seattle Mariners,MARNRS,1,1,1,2,2013,2013,0,No,0,-0.3,0.0,0.3,114,0,-114,289,0,-289,6.0,0.0,-6.0,3250000.0,0.0,-3250000.0
<a href=/player/ryanb002>ryanb002</a>,Brendan Ryan,New York Yankees,YANKS,2,5,2,7,2015,2017,2,Yes,0,1.29,3.2,1.91,400,263,-137,1373,1083,-290,113.0,0.0,-113.0,12429743.0,0.0,-12429743.0
<a href=/player/ryanb002>ryanb002</a>,Brendan Ryan,Washington Nationals,NATEX,1,1,1,2,2016,2016,0,No,0,-0.23,0.0,0.23,17,0,-17,14,0,-14,0.0,0.0,0.0,0.0,0.0,0.0
<a href=/player/ryanb101>ryanb101</a>,Blondy Ryan,Buffalo,Buffalo,1,1,2,3,1932,1937,5,No,0,2.15,0.0,-2.15,289,0,-289,1068,0,-1068,0.0,0.0,0.0,0.0,0.0,0.0
<a href=/player/ryanb101>ryanb101</a>,Blondy Ryan,New York Giants,GIANTS,3,12,5,17,1934,1949,15,No,0,8.76,66.74,57.98,1268,2382,1114,4502,9585,5083,296.0,0.0,-296.0,0.0,0.0,0.0
<a href=/player/ryanb101>ryanb101</a>,Blondy Ryan,Cleveland Indians,INDINS,1,1,1,2,1937,1937,0,No,0,0.11,0.0,-0.11,33,0,-33,108,0,-108,0.0,0.0,0.0,0.0,0.0,0.0
<a href=/player/ryanb101>ryanb101</a>,Blondy Ryan,New York Giants,GIANTS,1,2,1,3,1938,1938,0,No,0,0.0,0.62,0.62,0,38,38,0,155,155,0.0,0.0,0.0,0.0,0.0,0.0
<a href=/player/ryanc102>ryanc102</a>,Connie Ryan,New York Giants,GIANTS,1,2,1,3,1943,1947,4,No,0,7.61,8.14,0.53,725,472,-253,2750,1521,-1229,0.0,0.0,0.0,0.0,0.0,0.0
<a href=/player/ryanc102>ryanc102</a>,Connie Ryan,Boston Braves,BRAVES,1,1,1,2,1950,1954,4,No,0,2.86,8.65,5.79,243,366,123,987,1272,285,0.0,0.0,0.0,0.0,0.0,0.0
<a href=/player/ryanc102>ryanc102</a>,Connie Ryan,Cincinnati Reds,REDS,8,16,22,38,1951,1965,14,No,0,82.9,22.04,-60.86,4576,2061,-2515,14654,4760,-9894,2749.0,1025.0,-1724.0,63000.0,0.0,-63000.0
<a href=/player/ryanc102>ryanc102</a>,Connie Ryan,Chicago White Sox,WSOX,1,3,1,4,1953,1955,2,No,0,0.0,-0.06,-0.06,1,69,68,1,138,137,0.0,0.0,0.0,0.0,0.0,0.0
<a href=/player/ryanj001>ryanj001</a>,Jason Ryan,Pittsburgh Pirates,PIRATS,1,1,1,2,2001,2006,5,No,0,0.0,0.0,0.0,0,0,0,0,0,0,0.0,0.0,0.0,0.0,0.0,0.0
<a href=/player/ryanj001>ryanj001</a>,Jason Ryan,Chicago Cubs,CUBS,3,4,5,9,1999,2001,2,No,2,5.9,3.0,-2.9,235,338,103,49,464,415,3132.0,564.0,-2568.0,0.0,0.0,0.0
<a href=/player/ryanj002>ryanj002</a>,Joe Ryan,Tampa Bay Devil Rays,RAYS,1,2,2,4,2021,2021,0,Yes,0,0.33,0.48,0.15,6,55,49,2,238,236,80.0,0.0,-80.0,0.0,0.0,0.0
<a href=/player/ryanj102>ryanj102</a>,Jack Ryan,Cleveland Indians,INDINS,1,3,1,4,1909,1911,2,No,0,-0.98,5.53,6.51,61,126,65,61,191,130,504.0,1513.0,1009.0,0.0,0.0,0.0
<a href=/player/ryanj102>ryanj102</a>,Jack Ryan,Boston Red Sox,RSOX,1,3,2,5,1909,1913,4,No,0,0.0,7.22,7.22,0,337,337,0,348,348,0.0,2273.0,2273.0,0.0,0.0,0.0
<a href=/player/ryank001>ryank001</a>,Ken Ryan,Boston Red Sox,RSOX,8,14,15,29,1996,2020,24,Yes,4,-2.56,56.84,59.4,788,2785,1997,802,6826,6024,1145.0,5281.0,4136.0,26826923.0,0.0,-26826923.0
<a href=/player/ryanm101>ryanm101</a>,Mike Ryan,Boston Red Sox,RSOX,4,8,8,16,1967,1973,6,No,0,6.28,14.11,7.83,1485,781,-704,3661,1238,-2423,1155.0,3790.0,2635.0,41500.0,0.0,-41500.0
<a href=/player/ryanm101>ryanm101</a>,Mike Ryan,Philadelphia Phillies,PHILS,1,1,1,2,1974,1974,0,No,0,-0.29,0.0,0.29,15,0,-15,34,0,-34,0.0,0.0,0.0,0.0,0.0,0.0
<a href=/player/ryann001>ryann001</a>,Nolan Ryan,New York Mets,METS,1,4,1,5,1971,1973,2,No,0,45.16,0.14,-45.02,957,146,-811,2120,526,-1594,6672.0,0.0,-6672.0,45950.0,0.0,-45950.0
<a href=/player/ryanr001>ryanr001</a>,Rob Ryan,Arizona Diamondbacks,DBACKS,1,1,1,2,2001,2001,0,No,0,-0.17,0.05,0.22,7,19,12,7,5,-2,0.0,0.0,0.0,0.0,0.0,0.0
<a href=/player/ryanr101>ryanr101</a>,Rosy Ryan,New York Giants,GIANTS,1,1,1,2,1925,1925,0,No,0,-2.55,0.0,2.55,89,0,-89,45,0,-45,425.0,0.0,-425.0,0.0,0.0,0.0
<a href=/player/rybam101>rybam101</a>,Mike Ryba,St. Louis Cardinals,CARDS,1,1,1,2,1940,1954,14,No,0,5.58,20.12,14.54,369,888,519,211,466,255,1746.0,4131.0,2385.0,0.0,0.0,0.0
<a href=/player/ryerg101>ryerg101</a>,Gary Ryerson,San Francisco Giants,GIANTS,1,2,1,3,1971,1975,4,No,0,-1.59,-0.22,1.37,49,62,13,28,2,-26,375.0,100.0,-275.0,0.0,0.0,0.0
<a href=/player/ryerg101>ryerg101</a>,Gary Ryerson,Milwaukee Brewers,BREWRS,3,7,7,14,1973,1978,5,No,0,7.23,1.8,-5.43,546,209,-337,1533,327,-1206,524.0,1634.0,1110.0,168301.0,0.0,-168301.0
<a href=/player/ryu-j001>ryu-j001</a>,Jae Kuk Ryu,Chicago Cubs,CUBS,1,1,2,3,2007,2007,0,No,0,-0.22,0.0,0.22,18,0,-18,0,0,0,74.0,0.0,-74.0,0.0,0.0,0.0
<a href=/player/rzepm001>rzepm001</a>,Marc Rzepczynski,Toronto Blue Jays,BJAYS,1,4,4,8,2011,2014,3,No,0,0.4,6.43,6.03,344,416,72,89,1599,1510,547.0,15.0,-532.0,4329600.0,0.0,-4329600.0
<a href=/player/rzepm001>rzepm001</a>,Marc Rzepczynski,St. Louis Cardinals,CARDS,1,1,1,2,2013,2013,0,Yes,0,1.15,0.0,-1.15,161,0,-161,0,0,0,268.0,0.0,-268.0,0.0,0.0,0.0
<a href=/player/rzepm001>rzepm001</a>,Marc Rzepczynski,Cleveland Indians,INDINS,1,1,1,2,2015,2018,3,No,0,-0.8,1.78,2.58,54,187,133,0,585,585,44.0,0.0,-44.0,2400000.0,0.0,-2400000.0
<a href=/player/rzepm001>rzepm001</a>,Marc Rzepczynski,San Diego Padres,PADRS,4,5,8,13,2015,2021,6,No,0,6.15,2.58,-3.57,395,351,-44,906,448,-458,1057.0,739.0,-318.0,1650000.0,0.0,-1650000.0
<a href=/player/rzepm001>rzepm001</a>,Marc Rzepczynski,Oakland Athletics,ATLTCS,2,4,2,6,2016,2017,1,Yes,0,0.09,0.0,-0.09,236,0,-236,527,0,-527,38.0,0.0,-38.0,0.0,0.0,0.0
<a href=/player/saark001>saark001</a>,Kirk Saarloos,Houston Astros,ASTROS,1,1,1,2,2004,2005,1,No,0,3.13,-0.76,-3.89,80,181,101,1,2,1,995.0,274.0,-721.0,0.0,0.0,0.0
<a href=/player/saark001>saark001</a>,Kirk Saarloos,Oakland Athletics,ATLTCS,1,2,2,4,2007,2007,0,No,0,-0.82,0.0,0.82,68,0,-68,6,0,-6,128.0,0.0,-128.0,0.0,0.0,0.0
<a href=/player/sabac001>sabac001</a>,CC Sabathia,Cleveland Indians,INDINS,1,1,4,5,2008,2018,10,No,0,5.2,22.37,17.17,34,1354,1320,50,5551,5501,392.0,190.0,-202.0,11000000.0,0.0,-11000000.0
<a href=/player/sabeb001>sabeb001</a>,Bret Saberhagen,Kansas City Royals,ROYALS,4,6,8,14,1991,1997,6,No,0,19.59,4.26,-15.33,606,997,391,1939,3941,2002,1576.0,52.0,-1524.0,3507500.0,0.0,-3507500.0
<a href=/player/sabeb001>sabeb001</a>,Bret Saberhagen,New York Mets,METS,11,23,20,43,1995,2019,24,No,2,30.73,69.74,39.01,1995,4353,2358,3430,9978,6548,4638.0,3705.0,-933.0,25260990.0,0.0,-25260990.0
<a href=/player/sader101>sader101</a>,Ray Sadecki,St. Louis Cardinals,CARDS,8,10,10,20,1966,1978,12,No,0,24.42,39.07,14.65,2169,1711,-458,3342,6557,3215,5037.0,616.0,-4421.0,202000.0,0.0,-202000.0
<a href=/player/sader101>sader101</a>,Ray Sadecki,San Francisco Giants,GIANTS,2,3,3,6,1969,1971,2,No,0,8.87,-0.91,-9.78,806,89,-717,1416,200,-1216,1801.0,0.0,-1801.0,0.0,0.0,0.0
<a href=/player/sader101>sader101</a>,Ray Sadecki,New York Mets,METS,1,2,1,3,1974,1977,3,No,0,0.04,1.83,1.79,36,254,218,2,794,792,89.0,0.0,-89.0,0.0,0.0,0.0
<a href=/player/sader101>sader101</a>,Ray Sadecki,St. Louis Cardinals,CARDS,2,3,3,6,1975,1978,3,No,0,9.69,4.02,-5.67,1094,228,-866,136,461,325,2919.0,527.0,-2392.0,52000.0,0.0,-52000.0
<a href=/player/sader101>sader101</a>,Ray Sadecki,Atlanta Braves,BRAVES,1,2,3,5,1975,1977,2,No,0,0.35,1.15,0.8,8,136,128,0,30,30,23.0,421.0,398.0,0.0,0.0,0.0
<a href=/player/sadlc002>sadlc002</a>,Casey Sadler,Tampa Bay Devil Rays,RAYS,1,1,1,2,2019,2019,0,Yes,0,0.27,0.0,-0.27,47,0,-47,3,0,-3,81.0,0.0,-81.0,0.0,0.0,0.0
<a href=/player/sadlc002>sadlc002</a>,Casey Sadler,Los Angeles Dodgers,DOGRS,1,1,1,2,2020,2020,0,Yes,0,-0.14,0.0,0.14,10,0,-10,0,0,0,28.0,0.0,-28.0,0.0,0.0,0.0
<a href=/player/sadld001>sadld001</a>,Donnie Sadler,Boston Red Sox,RSOX,1,2,1,3,2000,2001,1,No,0,-0.55,1.15,1.7,39,96,57,95,386,291,0.0,0.0,0.0,0.0,0.0,0.0
<a href=/player/sadld001>sadld001</a>,Donnie Sadler,Cincinnati Reds,REDS,1,1,1,2,2001,2001,0,No,0,-0.37,0.0,0.37,89,0,-89,189,0,-189,0.0,0.0,0.0,225000.0,0.0,-225000.0
<a href=/player/sadlr001>sadlr001</a>,Ray Sadler,Chicago Cubs,CUBS,1,1,1,2,2003,2003,0,No,0,-0.06,0.44,0.5,3,33,30,8,110,102,0.0,0.0,0.0,0.0,0.0,0.0
<a href=/player/sadob101>sadob101</a>,Bob Sadowski,Philadelphia Phillies,PHILS,1,2,2,4,1961,1962,1,No,0,-0.26,0.0,0.26,97,0,-97,147,0,-147,42.0,0.0,-42.0,0.0,0.0,0.0
<a href=/player/sadob101>sadob101</a>,Bob Sadowski,St. Louis Cardinals,CARDS,2,7,3,10,1960,1963,3,No,0,1.56,-0.35,-1.91,364,164,-200,1157,310,-847,0.0,0.0,0.0,0.0,0.0,0.0
<a href=/player/sadob102>sadob102</a>,Bob Sadowski,St. Louis Cardinals,CARDS,3,6,4,10,1963,1965,2,No,0,5.52,0.29,-5.23,682,84,-598,1519,49,-1470,1673.0,458.0,-1215.0,0.0,0.0,0.0
<a href=/player/sadob102>sadob102</a>,Bob Sadowski,Atlanta Braves,BRAVES,5,10,8,18,1965,1968,3,No,0,-0.38,-0.18,0.2,622,407,-215,842,564,-278,716.0,549.0,-167.0,15000.0,0.0,-15000.0
<a href=/player/sadoj101>sadoj101</a>,Jim Sadowski,Pittsburgh Pirates,PIRATS,1,1,1,2,1976,1976,0,No,0,0.0,0.0,0.0,0,0,0,0,0,0,0.0,0.0,0.0,0.0,0.0,0.0
<a href=/player/sadzc001>sadzc001</a>,Connor Sadzeck,Texas Rangers,RNGRS,1,1,1,2,2019,2019,0,Yes,0,0.43,0.0,-0.43,20,0,-20,0,0,0,71.0,0.0,-71.0,0.0,0.0,0.0
<a href=/player/safft101>safft101</a>,Tom Saffell,Kansas City Athletics,ATLTCS,32,65,62,127,1956,1976,20,No,0,95.85,56.13,-39.72,9593,6816,-2777,23097,19555,-3542,12004.0,6179.0,-5825.0,476100.0,0.0,-476100.0
<a href=/player/sainj101>sainj101</a>,Johnny Sain,Boston Braves,BRAVES,8,13,13,26,1951,1968,17,No,0,6.08,31.32,25.24,1038,2055,1017,1363,3210,1847,2411.0,9683.0,7272.0,15000.0,0.0,-15000.0
<a href=/player/sainj101>sainj101</a>,Johnny Sain,New York Yankees,YANKS,1,2,2,4,1955,1955,0,No,0,3.23,0.0,-3.23,249,0,-249,578,0,-578,134.0,0.0,-134.0,20000.0,0.0,-20000.0
<a href=/player/sakal001>sakal001</a>,Lenn Sakata,Milwaukee Brewers,BREWRS,1,1,1,2,1979,1982,3,No,0,4.14,-0.16,-4.3,441,20,-421,1068,0,-1068,0.0,111.0,111.0,0.0,0.0,0.0
<a href=/player/salaa001>salaa001</a>,Angel Salazar,St. Louis Cardinals,CARDS,1,2,2,4,1985,1995,10,No,0,0.0,14.6,14.6,0,992,992,0,3173,3173,0.0,18.0,18.0,0.0,0.0,0.0
<a href=/player/salaa001>salaa001</a>,Angel Salazar,New York Mets,METS,1,1,1,2,1986,1986,0,No,0,0.81,0.0,-0.81,233,0,-233,645,0,-645,0.0,0.0,0.0,0.0,0.0,0.0
<a href=/player/salaa001>salaa001</a>,Angel Salazar,Kansas City Royals,ROYALS,5,7,11,18,1987,2008,21,No,2,34.09,25.38,-8.71,1455,2390,935,5453,8409,2956,1537.0,1236.0,-301.0,900000.0,0.0,-900000.0
<a href=/player/salaf001>salaf001</a>,Fernando Salas,St. Louis Cardinals,CARDS,2,3,4,7,2013,2019,6,No,0,9.31,6.71,-2.6,948,777,-171,2847,1905,-942,577.0,194.0,-383.0,3662000.0,0.0,-3662000.0
<a href=/player/salaf001>salaf001</a>,Fernando Salas,Anaheim Angels,ANGELS,1,1,1,2,2016,2016,0,Yes,0,-0.39,0.0,0.39,128,0,-128,2,0,-2,187.0,0.0,-187.0,0.0,0.0,0.0
<a href=/player/salaj001>salaj001</a>,Juan Salas,Tampa Bay Devil Rays,RAYS,1,1,1,2,2009,2009,0,No,0,0.0,0.0,0.0,0,0,0,0,0,0,0.0,0.0,0.0,0.0,0.0,0.0
<a href=/player/salal001>salal001</a>,Luis Salazar,Pittsburgh Pirates,PIRATS,1,2,2,4,1980,1982,2,No,0,6.29,0.5,-5.79,723,83,-640,2424,87,-2337,6.0,76.0,70.0,0.0,0.0,0.0
<a href=/player/salal001>salal001</a>,Luis Salazar,San Diego Padres,PADRS,2,6,4,10,1984,1989,5,No,0,23.33,0.76,-22.57,2084,146,-1938,6812,127,-6685,1933.0,1127.0,-806.0,0.0,0.0,0.0
<a href=/player/salal001>salal001</a>,Luis Salazar,Detroit Tigers,TIGRS,2,2,2,4,1989,1990,1,No,0,1.16,-2.52,-3.68,95,223,128,265,620,355,0.0,0.0,0.0,0.0,0.0,0.0
<a href=/player/salal001>salal001</a>,Luis Salazar,San Diego Padres,PADRS,18,35,37,72,1989,2010,21,No,6,17.39,61.98,44.59,4199,5322,1123,14254,17973,3719,1244.0,2171.0,927.0,26139800.0,0.0,-26139800.0
<a href=/player/salam001>salam001</a>,Mark Salas,Minnesota Twins,TWINS,1,1,1,2,1987,1988,1,No,0,-0.1,-1.37,-1.27,50,24,-26,130,0,-130,0.0,324.0,324.0,0.0,0.0,0.0
<a href=/player/salam001>salam001</a>,Mark Salas,New York Yankees,YANKS,2,4,3,7,1987,1989,2,No,0,7.16,-1.48,-8.64,782,63,-719,2351,14,-2337,594.0,729.0,135.0,247000.0,0.0,-247000.0
<a href=/player/salam002>salam002</a>,Marino Salas,Milwaukee Brewers,BREWRS,1,2,1,3,2007,2007,0,No,0,-0.41,0.0,0.41,24,0,-24,0,0,0,51.0,0.0,-51.0,0.0,0.0,0.0
<a href=/player/salao001>salao001</a>,Oscar Salazar,Baltimore Orioles,ORLS,1,1,1,2,2009,2010,1,No,0,-0.35,0.5,0.85,140,52,-88,269,0,-269,0.0,131.0,131.0,0.0,0.0,0.0
<a href=/player/salec001>salec001</a>,Chris Sale,Chicago White Sox,WSOX,1,1,4,5,2016,2020,4,Yes,0,16.47,0.0,-16.47,96,0,-96,6,0,-6,1687.0,0.0,-1687.0,9150000.0,0.0,-9150000.0
<a href=/player/salkb101>salkb101</a>,Bill Salkeld,Pittsburgh Pirates,PIRATS,2,5,3,8,1947,1949,2,No,0,5.52,3.82,-1.7,394,236,-158,1349,883,-466,38.0,0.0,-38.0,0.0,0.0,0.0
<a href=/player/salkr001>salkr001</a>,Roger Salkeld,Seattle Mariners,MARNRS,1,1,1,2,1995,1995,0,No,0,0.08,2.23,2.15,58,28,-30,37,0,-37,348.0,538.0,190.0,0.0,0.0,0.0
<a href=/player/salmb001>salmb001</a>,Brad Salmon,Cincinnati Reds,REDS,1,1,1,2,2008,2008,0,No,0,0.0,0.0,0.0,0,0,0,0,0,0,0.0,0.0,0.0,0.0,0.0,0.0
<a href=/player/salmc101>salmc101</a>,Chico Salmon,Milwaukee Braves,BRAVES,2,2,2,4,1963,1969,6,No,0,1.17,0.66,-0.51,485,304,-181,1409,660,-749,0.0,0.0,0.0,0.0,0.0,0.0
<a href=/player/salmc101>salmc101</a>,Chico Salmon,Seattle Pilots,BREWRS,4,5,6,11,1969,1972,3,No,0,-0.13,-1.34,-1.21,214,347,133,504,646,142,0.0,993.0,993.0,37000.0,0.0,-37000.0
<a href=/player/saltj001>saltj001</a>,Jarrod Saltalamacchia,Atlanta Braves,BRAVES,4,8,6,14,2007,2009,2,No,1,51.72,9.48,-42.24,2314,404,-1910,8153,1445,-6708,2789.0,84.0,-2705.0,15385000.0,0.0,-15385000.0
<a href=/player/saltj001>saltj001</a>,Jarrod Saltalamacchia,Texas Rangers,RNGRS,1,1,4,5,2010,2015,5,No,0,5.19,1.08,-4.11,355,45,-310,1329,0,-1329,0.0,134.0,134.0,418580.0,0.0,-418580.0
<a href=/player/saltj101>saltj101</a>,Jack Saltzgaver,StPaul,StPaul,1,2,5,7,1931,1932,1,No,0,15.3,0.0,-15.3,992,0,-992,1098,0,-1098,2971.0,0.0,-2971.0,0.0,0.0,0.0
<a href=/player/salvj101>salvj101</a>,Jack Salveson,New York Giants,GIANTS,1,1,1,2,1934,1934,0,No,0,-0.5,0.0,0.5,10,0,-10,2,0,-2,21.0,0.0,-21.0,0.0,0.0,0.0
<a href=/player/salvj101>salvj101</a>,Jack Salveson,Pittsburgh Pirates,PIRATS,5,8,5,13,1935,1946,11,No,0,3.99,17.92,13.93,204,1148,944,662,4032,3370,200.0,666.0,466.0,3000.0,0.0,-3000.0
<a href=/player/salvj101>salvj101</a>,Jack Salveson,Chicago White Sox,WSOX,1,1,1,2,1936,1947,11,No,0,0.0,30.28,30.28,0,523,523,0,732,732,0.0,5664.0,5664.0,0.0,0.0,0.0
<a href=/player/salvm101>salvm101</a>,Manny Salvo,SanDiego,SanDiego,1,1,2,3,1938,1938,0,No,0,-0.67,0.0,0.67,64,0,-64,42,0,-42,409.0,0.0,-409.0,0.0,0.0,0.0
<a href=/player/salvm101>salvm101</a>,Manny Salvo,New York Giants,GIANTS,1,2,1,3,1940,1945,5,No,0,4.14,-0.49,-4.63,264,88,-176,377,324,-53,1753.0,0.0,-1753.0,0.0,0.0,0.0
<a href=/player/samaj001>samaj001</a>,Jeff Samardzija,Chicago Cubs,CUBS,3,8,6,14,2014,2019,5,No,0,16.29,18.03,1.74,803,963,160,2607,3455,848,941.0,121.0,-820.0,0.0,0.0,0.0
<a href=/player/samaj001>samaj001</a>,Jeff Samardzija,Oakland Athletics,ATLTCS,1,2,4,6,2014,2020,6,Yes,0,0.52,22.61,22.09,80,1074,994,2,4228,4226,819.0,2.0,-817.0,5345000.0,0.0,-5345000.0
<a href=/player/samfr101>samfr101</a>,Ron Samford,Detroit Tigers,TIGRS,2,5,4,9,1958,1960,2,No,0,-1.58,7.47,9.05,379,604,225,1361,2163,802,0.0,0.0,0.0,7000.0,0.0,-7000.0
<a href=/player/samfr101>samfr101</a>,Ron Samford,Washington Senators,TWINS,2,3,2,5,1960,1962,2,No,0,0.48,0.05,-0.43,150,222,72,361,823,462,0.0,80.0,80.0,0.0,0.0,0.0
<a href=/player/sampa001>sampa001</a>,Adrian Sampson,Pittsburgh Pirates,PIRATS,1,1,1,2,2015,2015,0,No,0,-0.02,2.39,2.41,1,22,21,0,25,25,14.0,190.0,176.0,0.0,0.0,0.0
<a href=/player/sampb001>sampb001</a>,Billy Sample,Texas Rangers,RNGRS,1,2,1,3,1985,1986,1,No,0,0.32,4.12,3.8,59,221,162,154,862,708,0.0,0.0,0.0,0.0,0.0,0.0
<a href=/player/sampb001>sampb001</a>,Billy Sample,New York Yankees,YANKS,1,1,1,2,1985,1985,0,No,0,0.62,0.0,-0.62,92,0,-92,221,0,-221,0.0,0.0,0.0,435000.0,0.0,-435000.0
<a href=/player/sampb002>sampb002</a>,Bill Sampen,Montreal Expos,NATEX,4,6,7,13,1992,1999,7,No,0,12.1,6.46,-5.64,755,737,-18,1155,1582,427,2451.0,419.0,-2032.0,1303000.0,0.0,-1303000.0
<a href=/player/samuj001>samuj001</a>,Juan Samuel,Philadelphia Phillies,PHILS,3,3,6,9,1989,1996,7,No,0,4.02,4.94,0.92,508,827,319,380,597,217,949.0,1605.0,656.0,3675000.0,0.0,-3675000.0
<a href=/player/samuj001>samuj001</a>,Juan Samuel,New York Mets,METS,13,19,23,42,1989,1999,10,No,1,15.01,10.9,-4.11,1714,1663,-51,2841,1374,-1467,3557.0,4730.0,1173.0,13039666.0,0.0,-13039666.0
<a href=/player/samuj001>samuj001</a>,Juan Samuel,Detroit Tigers,TIGRS,1,1,1,2,1995,1996,1,No,0,-0.11,0.02,0.13,15,7,-8,39,23,-16,0.0,0.0,0.0,375000.0,0.0,-375000.0
<a href=/player/samur001>samur001</a>,Roger Samuels,San Francisco Giants,GIANTS,2,2,2,4,1989,1993,4,No,1,-0.32,0.91,1.23,10,83,73,0,129,129,11.0,0.0,-11.0,0.0,0.0,0.0
<a href=/player/sanca001>sanca001</a>,Alejandro Sanchez,Philadelphia Phillies,PHILS,4,7,7,14,1984,1989,5,No,0,20.55,8.65,-11.9,1881,885,-996,3583,3171,-412,2761.0,15.0,-2746.0,1629900.0,0.0,-1629900.0
<a href=/player/sanca001>sanca001</a>,Alejandro Sanchez,San Francisco Giants,GIANTS,1,1,1,2,1985,1988,3,No,0,-0.31,-0.49,-0.18,71,42,-29,133,43,-90,0.0,347.0,347.0,0.0,0.0,0.0
<a href=/player/sanca001>sanca001</a>,Alejandro Sanchez,Detroit Tigers,TIGRS,1,2,1,3,1986,1986,0,No,0,-0.73,-0.07,0.66,33,35,2,51,93,42,0.0,0.0,0.0,0.0,0.0,0.0
<a href=/player/sanca002>sanca002</a>,Alex Sanchez,Toronto Blue Jays,BJAYS,1,3,1,4,1990,1990,0,No,0,-0.34,0.18,0.52,4,3,-1,0,0,0,23.0,47.0,24.0,102500.0,0.0,-102500.0
<a href=/player/sanca002>sanca002</a>,Alex Sanchez,Cleveland Indians,INDINS,17,23,28,51,1990,2020,30,Yes,2,33.95,111.05,77.1,3251,3351,100,9795,9199,-596,3983.0,9499.0,5516.0,44654400.0,0.0,-44654400.0
<a href=/player/sanca003>sanca003</a>,Alex Sanchez,Milwaukee Brewers,BREWRS,8,14,17,31,2003,2012,9,No,2,37.6,23.81,-13.79,2643,1970,-673,10054,4716,-5338,883.0,6330.0,5447.0,9087000.0,0.0,-9087000.0
<a href=/player/sanca004>sanca004</a>,Anibal Sanchez,Boston Red Sox,RSOX,14,38,25,63,2005,2019,14,Yes,0,93.01,61.11,-31.9,5581,3052,-2529,12204,8864,-3340,8381.0,6378.0,-2003.0,13099733.0,0.0,-13099733.0
<a href=/player/sanca004>sanca004</a>,Anibal Sanchez,Miami Marlins,MARLNS,3,5,6,11,2012,2015,3,Yes,0,12.57,-1.22,-13.79,462,200,-262,752,437,-315,2987.0,792.0,-2195.0,8000000.0,0.0,-8000000.0
<a href=/player/sanca005>sanca005</a>,Angel Sanchez,Boston Red Sox,RSOX,1,1,1,2,2010,2010,0,No,0,-1.16,-0.74,0.42,175,29,-146,597,68,-529,0.0,0.0,0.0,0.0,0.0,0.0
<a href=/player/sanca006>sanca006</a>,Aaron Sanchez,Toronto Blue Jays,BJAYS,2,4,3,7,2019,2021,2,Yes,0,-0.75,-0.48,0.27,26,56,30,8,146,138,113.0,0.0,-113.0,4800000.0,0.0,-4800000.0
<a href=/player/sanca008>sanca008</a>,Angel Sanchez,Los Angeles Dodgers,DOGRS,1,3,2,5,2013,2013,0,No,0,0.0,0.91,0.91,8,31,23,0,30,30,12.0,261.0,249.0,0.0,0.0,0.0
<a href=/player/sancb001>sancb001</a>,Brian Sanches,Kansas City Royals,ROYALS,1,2,1,3,2003,2003,0,No,0,0.0,0.89,0.89,0,22,22,0,85,85,0.0,0.0,0.0,0.0,0.0,0.0
<a href=/player/sancb001>sancb001</a>,Brian Sanches,San Diego Padres,PADRS,1,1,1,2,2004,2004,0,No,0,-0.58,0.0,0.58,71,0,-71,1,0,-1,127.0,0.0,-127.0,0.0,0.0,0.0
<a href=/player/sancc002>sancc002</a>,Cristopher Sanchez,Tampa Bay Devil Rays,RAYS,1,1,1,2,2019,2019,0,Yes,0,-0.02,0.0,0.02,12,0,-12,0,0,0,38.0,0.0,-38.0,0.0,0.0,0.0
<a href=/player/sancc101>sancc101</a>,Celerino Sanchez,MexicoCityTigers,MexicoCityTigers,1,1,1,2,1971,1971,0,No,0,-0.02,0.0,0.02,105,0,-105,336,0,-336,0.0,0.0,0.0,0.0,0.0,0.0
<a href=/player/sancd001>sancd001</a>,Duaner Sanchez,Arizona Diamondbacks,DBACKS,1,1,1,2,2002,2002,0,No,0,-0.54,-0.43,0.11,18,66,48,0,0,0,25.0,74.0,49.0,0.0,0.0,0.0
<a href=/player/sancd001>sancd001</a>,Duaner Sanchez,Los Angeles Dodgers,DOGRS,2,5,5,10,2006,2007,1,No,0,3.53,-1.15,-4.68,810,232,-578,1884,134,-1750,767.0,896.0,129.0,682000.0,0.0,-682000.0
<a href=/player/sancf001>sancf001</a>,Freddy Sanchez,Boston Red Sox,RSOX,2,7,4,11,2003,2008,5,No,0,19.22,18.0,-1.22,1732,200,-1532,2840,14,-2826,1848.0,2423.0,575.0,634000.0,0.0,-634000.0
<a href=/player/sancf001>sancf001</a>,Freddy Sanchez,Pittsburgh Pirates,PIRATS,2,2,2,4,2009,2013,4,No,0,2.86,0.0,-2.86,196,0,-196,847,0,-847,0.0,0.0,0.0,6250000.0,0.0,-6250000.0
<a href=/player/sancf002>sancf002</a>,Felix Sanchez,Chicago Cubs,CUBS,1,1,2,3,2004,2005,1,No,0,0.0,0.0,0.0,0,0,0,0,0,0,0.0,0.0,0.0,0.0,0.0,0.0
<a href=/player/sancg001>sancg001</a>,Gaby Sanchez,Miami Marlins,MARLNS,2,3,2,5,2012,2013,1,Yes,0,0.79,-0.75,-1.54,309,45,-264,740,147,-593,0.0,0.0,0.0,483000.0,0.0,-483000.0
<a href=/player/sanch001>sanch001</a>,Humberto Sanchez,Detroit Tigers,TIGRS,1,3,1,4,2006,2009,3,No,0,-0.32,2.79,3.11,6,247,241,0,1075,1075,19.0,0.0,-19.0,0.0,0.0,0.0
<a href=/player/sancj001>sancj001</a>,Jesus Sanchez,New York Mets,METS,4,8,6,14,1998,2004,6,No,0,16.46,25.48,9.02,820,471,-349,1355,484,-871,4079.0,4278.0,199.0,362500.0,0.0,-362500.0
<a href=/player/sancj001>sancj001</a>,Jesus Sanchez,Florida Marlins,MARLNS,1,1,1,2,2001,2003,2,No,0,-0.46,-0.36,0.1,16,4,-12,1,2,1,25.0,22.0,-3.0,0.0,0.0,0.0
<a href=/player/sancj002>sancj002</a>,Jonathan Sanchez,San Francisco Giants,GIANTS,1,2,1,3,2011,2012,1,No,0,-1.57,4.82,6.39,14,113,99,2,501,499,165.0,0.0,-165.0,4800000.0,0.0,-4800000.0
<a href=/player/sancj002>sancj002</a>,Jonathan Sanchez,Kansas City Royals,ROYALS,1,1,1,2,2012,2015,3,No,0,-0.39,3.59,3.98,6,116,110,3,17,14,34.0,1961.0,1927.0,5600000.0,0.0,-5600000.0
<a href=/player/sancj003>sancj003</a>,Jesus Sanchez,Tampa Bay Devil Rays,RAYS,2,4,4,8,2019,2021,2,Yes,0,4.08,3.02,-1.06,256,108,-148,694,3,-691,153.0,553.0,400.0,564200.0,0.0,-564200.0
<a href=/player/sancl001>sancl001</a>,Luis Sanchez,Houston Astros,ASTROS,2,3,2,5,1975,1984,9,No,0,11.67,4.55,-7.12,325,651,326,410,1211,801,3231.0,2344.0,-887.0,0.0,0.0,0.0
<a href=/player/sancl001>sancl001</a>,Luis Sanchez,California Angels,ANGELS,1,2,1,3,1985,1987,2,No,0,0.0,0.47,0.47,0,75,75,0,0,0,0.0,360.0,360.0,340000.0,0.0,-340000.0
<a href=/player/sancr001>sancr001</a>,Rey Sanchez,Texas Rangers,RNGRS,1,1,1,2,1990,1990,0,No,0,6.03,0.0,-6.03,594,0,-594,1995,0,-1995,0.0,0.0,0.0,0.0,0.0,0.0
<a href=/player/sancr001>sancr001</a>,Rey Sanchez,Chicago Cubs,CUBS,1,1,1,2,1997,1997,0,No,0,0.3,0.0,-0.3,61,0,-61,198,0,-198,0.0,0.0,0.0,1287500.0,0.0,-1287500.0
<a href=/player/sancr001>sancr001</a>,Rey Sanchez,Kansas City Royals,ROYALS,2,3,3,6,2001,2004,3,No,0,0.45,-0.12,-0.57,167,90,-77,246,1,-245,746.0,330.0,-416.0,2300000.0,0.0,-2300000.0
<a href=/player/sancr001>sancr001</a>,Rey Sanchez,New York Mets,METS,1,2,1,3,2003,2004,1,No,0,1.06,0.0,-1.06,46,0,-46,186,0,-186,0.0,0.0,0.0,1300000.0,0.0,-1300000.0
<a href=/player/sancr002>sancr002</a>,Romulo Sanchez,Pittsburgh Pirates,PIRATS,1,1,1,2,2009,2009,0,No,0,0.17,-0.02,-0.19,2,6,4,0,0,0,13.0,9.0,-4.0,0.0,0.0,0.0
<a href=/player/sancr003>sancr003</a>,Ricardo Sanchez,Anaheim Angels,ANGELS,1,2,1,3,2015,2016,1,No,0,0.0,-0.31,-0.31,0,19,19,0,39,39,0.0,0.0,0.0,0.0,0.0,0.0
<a href=/player/sancs001>sancs001</a>,Sixto Sanchez,Philadelphia Phillies,PHILS,1,4,1,5,2019,2021,2,Yes,0,1.81,9.39,7.58,260,326,66,876,1325,449,117.0,0.0,-117.0,0.0,0.0,0.0
<a href=/player/sanct001>sanct001</a>,Tony Sanchez,Anaheim Angels,ANGELS,1,1,1,2,2017,2017,0,No,0,0.0,-0.1,-0.1,1,24,23,1,105,104,0.0,0.0,0.0,0.0,0.0,0.0
<a href=/player/sanct001>sanct001</a>,Tony Sanchez,Cincinnati Reds,REDS,1,1,1,2,2018,2018,0,No,0,0.0,0.0,0.0,0,0,0,0,0,0,0.0,0.0,0.0,0.0,0.0,0.0
<a href=/player/sandc101>sandc101</a>,Charlie Sands,New York Yankees,YANKS,1,3,3,6,1970,1970,0,No,0,0.24,0.0,-0.24,29,0,-29,33,0,-33,0.0,0.0,0.0,0.0,0.0,0.0
<a href=/player/sandc101>sandc101</a>,Charlie Sands,Pittsburgh Pirates,PIRATS,2,2,2,4,1973,1973,0,No,0,0.0,0.17,0.17,0,12,12,0,2,2,0.0,36.0,36.0,17500.0,0.0,-17500.0
<a href=/player/sandc101>sandc101</a>,Charlie Sands,Detroit Tigers,TIGRS,2,2,2,4,1973,1973,0,No,0,0.22,0.46,0.24,60,22,-38,146,0,-146,0.0,241.0,241.0,0.0,0.0,0.0
<a href=/player/sandd001>sandd001</a>,Deion Sanders,Atlanta Braves,BRAVES,7,13,11,24,1994,2005,11,No,2,61.15,23.08,-38.07,2498,1037,-1461,5386,3101,-2285,9346.0,423.0,-8923.0,8175513.0,0.0,-8175513.0
<a href=/player/sandd001>sandd001</a>,Deion Sanders,Cincinnati Reds,REDS,5,11,7,18,1995,2010,15,No,0,11.19,26.95,15.76,438,1436,998,728,5040,4312,2595.0,2089.0,-506.0,13266667.0,0.0,-13266667.0
<a href=/player/sandh101>sandh101</a>,Heinie Sand,Philadelphia Phillies,PHILS,3,5,7,12,1928,1936,8,No,0,25.37,2.86,-22.51,1352,1204,-148,5364,5193,-171,77.0,0.0,-77.0,31000.0,0.0,-31000.0
<a href=/player/sandh101>sandh101</a>,Heinie Sand,SaltLakeCity,SaltLakeCity,1,1,4,5,1922,1922,0,No,0,0.41,0.0,-0.41,848,0,-848,3528,0,-3528,0.0,0.0,0.0,0.0,0.0,0.0
<a href=/player/sandj002>sandj002</a>,Jerry Sands,Boston Red Sox,RSOX,1,4,2,6,2012,2019,7,No,0,7.63,8.07,0.44,566,624,58,6,2223,2217,907.0,22.0,-885.0,521000.0,0.0,-521000.0
<a href=/player/sandj002>sandj002</a>,Jerry Sands,Los Angeles Dodgers,DOGRS,5,22,14,36,2012,2021,9,Yes,0,4.41,31.13,26.72,1016,1541,525,2843,5562,2719,1152.0,835.0,-317.0,78709000.0,0.0,-78709000.0
<a href=/player/sandk101>sandk101</a>,Ken Sanders,Boston Red Sox,RSOX,2,6,4,10,1966,1969,3,No,0,1.66,1.54,-0.12,432,533,101,910,683,-227,275.0,859.0,584.0,24500.0,0.0,-24500.0
<a href=/player/sandk101>sandk101</a>,Ken Sanders,Oakland Athletics,ATLTCS,9,20,12,32,1970,1976,6,No,0,26.16,16.01,-10.15,3775,1399,-2376,8326,3903,-4423,4415.0,1098.0,-3317.0,340600.0,0.0,-340600.0
<a href=/player/sandk101>sandk101</a>,Ken Sanders,Milwaukee Brewers,BREWRS,3,6,5,11,1972,1984,12,No,0,7.41,27.71,20.3,475,1402,927,547,5127,4580,4062.0,1332.0,-2730.0,59800.0,0.0,-59800.0
<a href=/player/sandk101>sandk101</a>,Ken Sanders,Philadelphia Phillies,PHILS,1,3,1,4,1972,1973,1,No,0,-1.38,0.91,2.29,154,97,-57,334,364,30,133.0,0.0,-133.0,14500.0,0.0,-14500.0
<a href=/player/sandk101>sandk101</a>,Ken Sanders,California Angels,ANGELS,1,1,1,2,1975,1980,5,No,0,1.5,0.39,-1.11,122,109,-13,4,147,143,270.0,0.0,-270.0,0.0,0.0,0.0
<a href=/player/sandm101>sandm101</a>,Mike Sandlock,Boston Braves,BRAVES,1,2,1,3,1944,1944,0,No,0,0.92,0.2,-0.72,99,46,-53,257,168,-89,0.0,0.0,0.0,0.0,0.0,0.0
<a href=/player/sandp001>sandp001</a>,Pablo Sandoval,Atlanta Braves,BRAVES,1,1,2,3,2021,2021,0,No,0,0.0,0.51,0.51,0,33,33,0,106,106,0.0,0.0,0.0,1000000.0,0.0,-1000000.0
<a href=/player/sandp002>sandp002</a>,Patrick Sandoval,Houston Astros,ASTROS,1,2,1,3,2018,2018,0,No,0,2.51,0.11,-2.4,39,41,2,6,114,108,489.0,0.0,-489.0,0.0,0.0,0.0
<a href=/player/sandr001>sandr001</a>,Ryne Sandberg,Philadelphia Phillies,PHILS,2,4,2,6,1982,1986,4,No,0,69.17,2.77,-66.4,2804,581,-2223,11092,1670,-9422,193.0,313.0,120.0,0.0,0.0,0.0
<a href=/player/sandr002>sandr002</a>,Reggie Sanders,Cincinnati Reds,REDS,4,7,7,14,1999,2004,5,No,0,10.74,9.45,-1.29,965,646,-319,3397,2378,-1019,0.0,0.0,0.0,3650000.0,0.0,-3650000.0
<a href=/player/sandr002>sandr002</a>,Reggie Sanders,San Diego Padres,PADRS,2,4,4,8,1999,2006,7,No,1,3.54,15.79,12.25,377,961,584,1296,3858,2562,0.0,4.0,4.0,8651680.0,0.0,-8651680.0
<a href=/player/sandr101>sandr101</a>,Roy Sanders,St.Louis Browns,ORLS,1,6,1,7,1921,1921,0,No,0,0.0,0.0,0.0,0,0,0,0,0,0,0.0,0.0,0.0,6600.0,0.0,-6600.0
<a href=/player/sandr102>sandr102</a>,Ray Sanders,Boston Braves,BRAVES,4,15,8,23,1948,1960,12,No,0,49.35,41.77,-7.58,2025,1769,-256,7279,7265,-14,2138.0,0.0,-2138.0,0.0,0.0,0.0
<a href=/player/sandr102>sandr102</a>,Ray Sanders,Brooklyn Dodgers,DOGRS,1,2,3,5,1948,1948,0,No,0,8.05,0.0,-8.05,219,0,-219,971,0,-971,0.0,0.0,0.0,0.0,0.0,0.0
<a href=/player/sandr103>sandr103</a>,Reggie Sanders,Oakland Athletics,ATLTCS,2,4,2,6,1972,1972,0,No,0,0.23,-0.12,-0.35,110,22,-88,227,60,-167,13.0,3.0,-10.0,20500.0,0.0,-20500.0
<a href=/player/sandr103>sandr103</a>,Reggie Sanders,Detroit Tigers,TIGRS,1,1,1,2,1975,1975,0,No,0,0.0,-0.17,-0.17,0,53,53,0,194,194,0.0,0.0,0.0,0.0,0.0,0.0
<a href=/player/sandr104>sandr104</a>,Roy Sanders,KansasCity,KansasCity,1,2,3,5,1917,1918,1,No,0,0.77,0.0,-0.77,267,0,-267,890,0,-890,475.0,0.0,-475.0,0.0,0.0,0.0
<a href=/player/sands001>sands001</a>,Scott Sanderson,Montreal Expos,NATEX,2,3,3,6,1983,1986,3,No,0,11.29,0.58,-10.71,396,208,-188,249,9,-240,2573.0,362.0,-2211.0,513500.0,0.0,-513500.0
<a href=/player/sands002>sands002</a>,Scott Sanders,San Diego Padres,PADRS,2,2,3,5,1996,2002,6,No,0,-1.22,5.66,6.88,96,246,150,0,223,223,617.0,1953.0,1336.0,6300000.0,0.0,-6300000.0
<a href=/player/sands002>sands002</a>,Scott Sanders,Seattle Mariners,MARNRS,1,3,2,5,1997,1998,1,No,0,0.42,-0.64,-1.06,53,29,-24,0,2,2,389.0,290.0,-99.0,1300000.0,0.0,-1300000.0
<a href=/player/sands002>sands002</a>,Scott Sanders,Detroit Tigers,TIGRS,1,1,1,2,1998,1998,0,No,0,-0.22,0.0,0.22,46,0,-46,1,0,-1,92.0,0.0,-92.0,1700000.0,0.0,-1700000.0
<a href=/player/sandt101>sandt101</a>,Tommy Sandt,St. Louis Cardinals,CARDS,3,4,5,9,1979,1984,5,No,0,-0.19,1.88,2.07,234,169,-65,556,151,-405,297.0,1188.0,891.0,0.0,0.0,0.0
<a href=/player/sanff101>sanff101</a>,Fred Sanford,St.Louis Browns,ORLS,44,106,109,215,1948,1994,46,No,3,173.64,220.75,47.11,11733,18932,7199,27283,56805,29522,35289.0,22275.0,-13014.0,1054583.0,0.0,-1054583.0
<a href=/player/sanff101>sanff101</a>,Fred Sanford,New York Yankees,YANKS,1,3,1,4,1951,1954,3,No,0,18.48,1.84,-16.64,407,209,-198,444,108,-336,3513.0,1042.0,-2471.0,11500.0,0.0,-11500.0
<a href=/player/sanff101>sanff101</a>,Fred Sanford,Washington Senators,TWINS,1,1,1,2,1951,1951,0,No,0,-1.17,-0.07,1.1,18,22,4,9,21,12,82.0,184.0,102.0,0.0,0.0,0.0
<a href=/player/sanff101>sanff101</a>,Fred Sanford,St.Louis Browns,ORLS,2,5,3,8,1951,1952,1,No,0,0.64,0.33,-0.31,156,96,-60,332,319,-13,0.0,0.0,0.0,0.0,0.0,0.0
<a href=/player/sanfj101>sanfj101</a>,Jack Sanford,Philadelphia Phillies,PHILS,1,1,2,3,1958,1962,4,No,0,13.08,-2.23,-15.31,471,154,-317,541,186,-355,4217.0,374.0,-3843.0,0.0,0.0,0.0
<a href=/player/sanfj101>sanfj101</a>,Jack Sanford,California Angels,ANGELS,4,5,5,10,1967,1974,7,No,0,-0.7,4.94,5.64,265,604,339,780,1757,977,66.0,0.0,-66.0,57000.0,0.0,-57000.0
<a href=/player/sangm101>sangm101</a>,Manny Sanguillen,Pittsburgh Pirates,PIRATS,1,2,1,3,1976,1976,0,No,0,0.65,0.0,-0.65,152,0,-152,601,0,-601,0.0,0.0,0.0,0.0,0.0,0.0
<a href=/player/sangm101>sangm101</a>,Manny Sanguillen,Oakland Athletics,ATLTCS,2,2,4,6,1978,1980,2,No,1,-1.43,0.36,1.79,188,545,357,368,1322,954,0.0,327.0,327.0,0.0,0.0,0.0
<a href=/player/sangm101>sangm101</a>,Manny Sanguillen,Pittsburgh Pirates,PIRATS,4,6,9,15,1980,1984,4,No,0,24.19,-0.04,-24.23,615,106,-509,1402,76,-1326,2781.0,299.0,-2482.0,300000.0,0.0,-300000.0
<a href=/player/sanmr001>sanmr001</a>,Reiver Sanmartin,Texas Rangers,RNGRS,1,1,1,2,2017,2019,2,No,0,0.0,0.0,0.0,0,0,0,0,0,0,0.0,0.0,0.0,0.0,0.0,0.0
<a href=/player/sanmr001>sanmr001</a>,Reiver Sanmartin,New York Yankees,YANKS,3,5,5,10,2019,2021,2,No,0,10.03,0.33,-9.7,238,102,-136,526,361,-165,1135.0,0.0,-1135.0,0.0,0.0,0.0
<a href=/player/santa001>santa001</a>,Andres Santana,San Francisco Giants,GIANTS,1,1,1,2,1993,1993,0,No,0,0.0,0.0,0.0,0,0,0,0,0,0,0.0,0.0,0.0,0.0,0.0,0.0
<a href=/player/santa002>santa002</a>,Angel Santos,Boston Red Sox,RSOX,1,1,1,2,2003,2005,2,No,0,0.2,-0.08,-0.28,32,4,-28,80,0,-80,0.0,23.0,23.0,0.0,0.0,0.0
<a href=/player/santa101>santa101</a>,Al Santorini,San Diego Padres,PADRS,3,3,6,9,1971,1977,6,No,0,12.6,11.49,-1.11,586,839,253,580,1845,1265,4520.0,1817.0,-2703.0,0.0,0.0,0.0
<a href=/player/santa101>santa101</a>,Al Santorini,St. Louis Cardinals,CARDS,4,4,4,8,1973,1976,3,No,0,2.97,0.71,-2.26,208,74,-134,184,108,-76,641.0,266.0,-375.0,34000.0,0.0,-34000.0
<a href=/player/santb001>santb001</a>,Benito Santiago,Kansas City Royals,ROYALS,2,3,2,5,2004,2009,5,No,0,2.19,0.82,-1.37,418,240,-178,24,478,454,594.0,477.0,-117.0,2555000.0,0.0,-2555000.0
<a href=/player/santc002>santc002</a>,Carlos Santana,Los Angeles Dodgers,DOGRS,1,2,2,4,2008,2011,3,No,0,29.84,9.15,-20.69,1336,406,-930,5723,1608,-4115,6.0,0.0,-6.0,0.0,0.0,0.0
<a href=/player/santc002>santc002</a>,Carlos Santana,Philadelphia Phillies,PHILS,2,3,4,7,2018,2019,1,Yes,0,7.13,-0.08,-7.21,336,92,-244,1315,2,-1313,47.0,142.0,95.0,18878833.0,0.0,-18878833.0
<a href=/player/santc002>santc002</a>,Carlos Santana,Seattle Mariners,MARNRS,2,4,3,7,2018,2019,1,Yes,0,6.24,2.05,-4.19,262,65,-197,1138,289,-849,0.0,0.0,0.0,0.0,0.0,0.0
<a href=/player/santd001>santd001</a>,Danny Santana,Minnesota Twins,TWINS,1,1,2,3,2017,2017,0,No,0,-0.09,0.0,0.09,84,0,-84,184,0,-184,0.0,0.0,0.0,0.0,0.0,0.0
<a href=/player/santd002>santd002</a>,Domingo Santana,Philadelphia Phillies,PHILS,2,5,5,10,2011,2018,7,No,0,10.84,2.57,-8.27,1005,441,-564,3635,1629,-2006,674.0,0.0,-674.0,10400000.0,0.0,-10400000.0
<a href=/player/santd002>santd002</a>,Domingo Santana,Houston Astros,ASTROS,1,4,3,7,2015,2017,2,No,0,18.89,0.28,-18.61,984,198,-786,1471,487,-984,1823.0,1153.0,-670.0,0.0,0.0,0.0
<a href=/player/santd002>santd002</a>,Domingo Santana,Milwaukee Brewers,BREWRS,1,1,2,3,2018,2020,2,Yes,0,0.49,0.26,-0.23,121,174,53,507,483,-24,0.0,0.0,0.0,572400.0,0.0,-572400.0
<a href=/player/santd003>santd003</a>,Dennis Santana,Los Angeles Dodgers,DOGRS,1,1,1,2,2021,2021,0,Yes,0,0.15,0.0,-0.15,40,0,-40,0,0,0,119.0,0.0,-119.0,0.0,0.0,0.0
<a href=/player/sante001>sante001</a>,Ervin Santana,Anaheim Angels,ANGELS,1,2,1,3,2012,2012,0,No,0,3.73,0.0,-3.73,74,0,-74,4,0,-4,829.0,0.0,-829.0,11200000.0,0.0,-11200000.0
<a href=/player/santg001>santg001</a>,Gregory Santos,Boston Red Sox,RSOX,1,2,1,3,2017,2019,2,No,0,-0.97,-1.55,-0.58,77,226,149,28,849,821,340.0,3.0,-337.0,0.0,0.0,0.0
<a href=/player/santh001>santh001</a>,Hector Santiago,Chicago White Sox,WSOX,3,5,5,10,2013,2020,7,Yes,0,6.93,16.12,9.19,431,440,9,1326,1933,607,1639.0,102.0,-1537.0,3255000.0,0.0,-3255000.0
<a href=/player/santh001>santh001</a>,Hector Santiago,Anaheim Angels,ANGELS,1,2,3,5,2016,2018,2,No,0,-0.15,3.27,3.42,80,67,-13,0,11,11,566.0,1029.0,463.0,0.0,0.0,0.0
<a href=/player/santj001>santj001</a>,Julio Santana,Tampa Bay Devil Rays,RAYS,1,1,2,3,1999,1999,0,No,0,0.0,0.0,0.0,0,0,0,0,0,0,0.0,0.0,0.0,272500.0,0.0,-272500.0
<a href=/player/santj002>santj002</a>,Jose Santiago,Kansas City Royals,ROYALS,2,2,2,4,2001,2012,11,No,1,-0.82,8.77,9.59,183,413,230,7,1124,1117,328.0,971.0,643.0,260000.0,0.0,-260000.0
<a href=/player/santj003>santj003</a>,Johan Santana,Florida Marlins,MARLNS,1,2,1,3,1999,1999,0,No,0,36.05,0.0,-36.05,267,0,-267,32,0,-32,3926.0,0.0,-3926.0,0.0,0.0,0.0
<a href=/player/santj003>santj003</a>,Johan Santana,Minnesota Twins,TWINS,4,5,8,13,2008,2014,6,No,0,49.88,4.96,-44.92,1812,511,-1301,6466,1339,-5127,2229.0,360.0,-1869.0,6987500.0,0.0,-6987500.0
<a href=/player/santl001>santl001</a>,Luis Santos,Pittsburgh Pirates,PIRATS,1,2,2,4,2012,2014,2,No,0,0.0,1.15,1.15,0,120,120,0,7,7,0.0,252.0,252.0,0.0,0.0,0.0
<a href=/player/santp001>santp001</a>,Pedro Santana,Houston Astros,ASTROS,1,2,1,3,1996,1996,0,No,0,0.0,-0.01,-0.01,1,18,17,0,0,0,0.0,28.0,28.0,0.0,0.0,0.0
<a href=/player/santr001>santr001</a>,Rafael Santana,New York Yankees,YANKS,4,6,6,12,1981,1985,4,No,0,4.34,5.22,0.88,642,287,-355,1507,453,-1054,133.0,764.0,631.0,435000.0,0.0,-435000.0
<a href=/player/santr001>santr001</a>,Rafael Santana,New York Mets,METS,3,5,7,12,1987,1991,4,No,0,-1.46,0.62,2.08,394,117,-277,613,186,-427,350.0,0.0,-350.0,250000.0,0.0,-250000.0
<a href=/player/santr002>santr002</a>,Ramon Santiago,Detroit Tigers,TIGRS,1,2,1,3,2004,2011,7,No,0,-0.28,18.63,18.91,27,817,790,58,3384,3326,0.0,0.0,0.0,0.0,0.0,0.0
<a href=/player/santr102>santr102</a>,Ron Santo,Chicago Cubs,CUBS,13,23,27,50,1973,1990,17,No,0,17.95,23.31,5.36,3143,2363,-780,8342,4769,-3573,1137.0,6181.0,5044.0,1130000.0,0.0,-1130000.0
<a href=/player/sants001>sants001</a>,Sergio Santos,Arizona Diamondbacks,DBACKS,5,6,8,14,2005,2019,14,Yes,3,11.95,12.76,0.81,863,764,-99,2032,1902,-130,590.0,1295.0,705.0,13875000.0,0.0,-13875000.0
<a href=/player/sants001>sants001</a>,Sergio Santos,Chicago White Sox,WSOX,1,1,1,2,2011,2011,0,No,0,-0.71,0.0,0.71,67,0,-67,1,0,-1,155.0,0.0,-155.0,435000.0,0.0,-435000.0
<a href=/player/santv001>santv001</a>,Victor Santos,Detroit Tigers,TIGRS,1,2,1,3,2002,2002,0,No,0,-1.27,-0.52,0.75,48,45,-3,2,0,-2,78.0,125.0,47.0,0.0,0.0,0.0
<a href=/player/sappd001>sappd001</a>,Dave Sappelt,Cincinnati Reds,REDS,1,3,1,4,2011,2015,4,No,0,7.63,1.09,-6.54,509,203,-306,388,0,-388,2074.0,256.0,-1818.0,422500.0,0.0,-422500.0
<a href=/player/sardl001>sardl001</a>,Luis Sardinas,Texas Rangers,RNGRS,1,3,2,5,2015,2015,0,No,0,4.24,4.26,0.02,471,35,-436,105,4,-101,683.0,553.0,-130.0,0.0,0.0,0.0
<a href=/player/sardl001>sardl001</a>,Luis Sardinas,Milwaukee Brewers,BREWRS,1,1,1,2,2015,2016,1,No,0,-0.48,-1.41,-0.93,33,104,71,77,289,212,3.0,0.0,-3.0,0.0,0.0,0.0
<a href=/player/sardl001>sardl001</a>,Luis Sardinas,Seattle Mariners,MARNRS,1,1,1,2,2016,2016,0,No,0,-0.16,0.0,0.16,64,0,-64,173,0,-173,3.0,0.0,-3.0,512000.0,0.0,-512000.0
<a href=/player/sarfd001>sarfd001</a>,Dennis Sarfate,Houston Astros,ASTROS,1,5,1,6,2007,2009,2,No,0,11.62,3.81,-7.81,860,316,-544,1797,1340,-457,1330.0,0.0,-1330.0,382000.0,0.0,-382000.0
<a href=/player/sargj101>sargj101</a>,Joe Sargent,Detroit Tigers,TIGRS,1,9,2,11,1921,1941,20,No,0,0.0,3.03,3.03,0,202,202,0,144,144,0.0,1168.0,1168.0,3000.0,0.0,-3000.0
<a href=/player/sarmm101>sarmm101</a>,Manny Sarmiento,Seattle Mariners,MARNRS,1,1,1,2,1981,1982,1,No,0,0.0,-0.69,-0.69,0,39,39,0,0,0,0.0,161.0,161.0,0.0,0.0,0.0
<a href=/player/sarnb101>sarnb101</a>,Bill Sarni,St. Louis Cardinals,CARDS,19,44,38,82,1956,1972,16,No,0,56.42,67.4,10.98,5645,3260,-2385,13530,9157,-4373,6309.0,6165.0,-144.0,120500.0,0.0,-120500.0
<a href=/player/sassm001>sassm001</a>,Mackey Sasser,San Francisco Giants,GIANTS,1,2,1,3,1987,1991,4,No,0,-0.47,5.23,5.7,26,353,327,49,256,207,0.0,2086.0,2086.0,0.0,0.0,0.0
<a href=/player/sassm001>sassm001</a>,Mackey Sasser,Pittsburgh Pirates,PIRATS,2,3,3,6,1988,1988,0,No,0,13.41,0.21,-13.2,931,40,-891,3050,103,-2947,0.0,0.0,0.0,62500.0,0.0,-62500.0
<a href=/player/sassr001>sassr001</a>,Rob Sasser,Anaheim Angels,ANGELS,1,2,1,3,1997,2000,3,No,0,0.66,4.28,3.62,38,78,40,115,11,-104,0.0,1167.0,1167.0,1916972.0,0.0,-1916972.0
<a href=/player/satrt101>satrt101</a>,Tom Satriano,California Angels,ANGELS,5,8,7,15,1969,1976,7,No,0,0.73,2.0,1.27,550,367,-183,1839,1229,-610,0.0,90.0,90.0,63500.0,0.0,-63500.0
<a href=/player/sauck101>sauck101</a>,Kevin Saucier,Philadelphia Phillies,PHILS,1,1,1,2,1980,1982,2,No,0,0.0,-0.57,-0.57,0,184,184,0,10,10,0.0,377.0,377.0,0.0,0.0,0.0
<a href=/player/sauck101>sauck101</a>,Kevin Saucier,Texas Rangers,RNGRS,1,1,1,2,1980,1983,3,No,0,2.21,1.16,-1.05,70,112,42,0,293,293,268.0,0.0,-268.0,0.0,0.0,0.0
<a href=/player/sauee101>sauee101</a>,Ed Sauer,Pittsburgh Pirates,PIRATS,1,1,1,2,1949,1950,1,No,0,-0.18,0.76,0.94,79,48,-31,234,155,-79,0.0,0.0,0.0,0.0,0.0,0.0
<a href=/player/sauee101>sauee101</a>,Ed Sauer,Boston Braves,BRAVES,1,3,1,4,1949,1949,0,No,0,0.73,0.0,-0.73,93,0,-93,264,0,-264,0.0,0.0,0.0,0.0,0.0,0.0
<a href=/player/saueh101>saueh101</a>,Hank Sauer,Cincinnati Reds,REDS,3,4,5,9,1949,1951,2,No,0,25.39,2.56,-22.83,1630,361,-1269,6349,1295,-5054,0.0,0.0,0.0,10000.0,0.0,-10000.0
<a href=/player/saueh101>saueh101</a>,Hank Sauer,Chicago Cubs,CUBS,3,6,5,11,1956,1958,2,No,0,8.44,-0.08,-8.52,848,208,-640,2477,380,-2097,130.0,197.0,67.0,0.0,0.0,0.0
<a href=/player/saues001>saues001</a>,Scott Sauerbeck,Pittsburgh Pirates,PIRATS,7,13,14,27,2003,2013,10,No,0,4.43,39.52,35.09,675,2405,1730,958,7168,6210,1221.0,934.0,-287.0,15866667.0,0.0,-15866667.0
<a href=/player/saunj001>saunj001</a>,Joe Saunders,Anaheim Angels,ANGELS,1,4,1,5,2010,2012,2,No,0,13.1,6.5,-6.6,498,84,-414,497,11,-486,4323.0,1527.0,-2796.0,3700000.0,0.0,-3700000.0
<a href=/player/saunj001>saunj001</a>,Joe Saunders,Arizona Diamondbacks,DBACKS,1,2,2,4,2012,2012,0,No,0,0.57,0.25,-0.32,13,24,11,0,0,0,144.0,32.0,-112.0,6000000.0,0.0,-6000000.0
<a href=/player/saunm001>saunm001</a>,Michael Saunders,Seattle Mariners,MARNRS,2,2,2,4,2014,2016,2,No,0,3.66,0.68,-2.98,183,23,-160,639,2,-637,190.0,340.0,150.0,9000000.0,0.0,-9000000.0
<a href=/player/savaj001>savaj001</a>,Jack Savage,Los Angeles Dodgers,DOGRS,2,4,4,8,1987,1992,5,No,1,0.0,9.73,9.73,0,1063,1063,0,1797,1797,0.0,1084.0,1084.0,1187500.0,0.0,-1187500.0
<a href=/player/savaj001>savaj001</a>,Jack Savage,New York Mets,METS,2,6,3,9,1989,1991,2,No,2,34.39,9.58,-24.81,807,164,-643,0,204,204,6852.0,1699.0,-5153.0,378000.0,0.0,-378000.0
<a href=/player/savat101>savat101</a>,Ted Savage,Philadelphia Phillies,PHILS,1,2,1,3,1962,1964,2,No,0,-0.67,1.44,2.11,85,121,36,167,417,250,0.0,0.0,0.0,0.0,0.0,0.0
<a href=/player/savat101>savat101</a>,Ted Savage,Pittsburgh Pirates,PIRATS,6,10,11,21,1964,1973,9,No,0,-1.2,0.41,1.61,81,41,-40,182,35,-147,16.0,36.0,20.0,17500.0,0.0,-17500.0
<a href=/player/savat101>savat101</a>,Ted Savage,Chicago Cubs,CUBS,2,3,3,6,1968,1974,6,No,0,-0.08,14.65,14.73,111,1174,1063,205,2396,2191,0.0,1177.0,1177.0,0.0,0.0,0.0
<a href=/player/savat101>savat101</a>,Ted Savage,Los Angeles Dodgers,DOGRS,1,1,1,2,1969,1970,1,No,0,0.61,0.0,-0.61,68,0,-68,132,0,-132,0.0,0.0,0.0,0.0,0.0,0.0
<a href=/player/savat101>savat101</a>,Ted Savage,Milwaukee Brewers,BREWRS,3,4,4,8,1971,1973,2,No,0,-0.51,-0.65,-0.14,22,168,146,41,528,487,0.0,22.0,22.0,40000.0,0.0,-40000.0
<a href=/player/saveb101>saveb101</a>,Bob Saverine,Baltimore Orioles,ORLS,1,2,1,3,1965,1966,1,No,0,0.0,0.29,0.29,0,54,54,0,11,11,0.0,162.0,162.0,0.0,0.0,0.0
<a href=/player/savrm101>savrm101</a>,Moe Savransky,Buffalo,Buffalo,1,2,1,3,1951,1952,1,No,0,4.75,0.0,-4.75,338,0,-338,99,0,-99,1213.0,0.0,-1213.0,0.0,0.0,0.0
<a href=/player/sawac101>sawac101</a>,Carl Sawatski,Toronto,Toronto,1,1,2,3,1956,1956,0,No,0,0.68,0.0,-0.68,68,0,-68,131,0,-131,0.0,0.0,0.0,0.0,0.0,0.0
<a href=/player/sawac101>sawac101</a>,Carl Sawatski,Milwaukee Braves,BRAVES,2,3,3,6,1958,1961,3,No,0,0.97,0.34,-0.63,134,49,-85,436,163,-273,0.0,0.0,0.0,0.0,0.0,0.0
<a href=/player/sawac101>sawac101</a>,Carl Sawatski,Philadelphia Phillies,PHILS,1,1,2,3,1959,1961,2,No,0,3.25,1.12,-2.13,305,177,-128,785,422,-363,0.0,0.0,0.0,0.0,0.0,0.0
<a href=/player/sawyr101>sawyr101</a>,Rick Sawyer,Cleveland Indians,INDINS,4,7,5,12,1974,1976,2,No,0,-3.21,4.02,7.23,307,69,-238,459,0,-459,1098.0,1299.0,201.0,68000.0,0.0,-68000.0
<a href=/player/sawyr101>sawyr101</a>,Rick Sawyer,New York Yankees,YANKS,1,1,1,2,1976,1976,0,No,0,0.41,-0.29,-0.7,138,13,-125,58,34,-24,578.0,0.0,-578.0,0.0,0.0,0.0
<a href=/player/sax-d001>sax-d001</a>,Dave Sax,Texas Rangers,RNGRS,1,1,1,2,1988,1988,0,No,0,0.0,0.0,0.0,0,0,0,0,0,0,0.0,0.0,0.0,0.0,0.0,0.0
<a href=/player/sax-s001>sax-s001</a>,Steve Sax,New York Yankees,YANKS,4,8,8,16,1992,2003,11,No,0,18.62,30.57,11.95,1366,580,-786,2830,16,-2814,2545.0,5552.0,3007.0,1188000.0,0.0,-1188000.0
<a href=/player/saylb101>saylb101</a>,Bill Sayles,New York Giants,GIANTS,2,4,3,7,1943,1945,2,No,0,-0.25,-0.04,0.21,36,72,36,28,39,11,123.0,375.0,252.0,0.0,0.0,0.0
<a href=/player/sborj002>sborj002</a>,Josh Sborz,Los Angeles Dodgers,DOGRS,1,1,1,2,2021,2021,0,Yes,0,0.3,0.0,-0.3,68,0,-68,1,0,-1,177.0,0.0,-177.0,0.0,0.0,0.0
<a href=/player/scahr001>scahr001</a>,Rob Scahill,Colorado Rockies,ROCKS,1,1,1,2,2014,2018,4,No,0,-0.09,-0.02,0.07,84,6,-78,2,0,-2,141.0,12.0,-129.0,0.0,0.0,0.0
<a href=/player/scalj102>scalj102</a>,Jerry Scala,Sacramento,Sacramento,2,2,3,5,1951,1952,1,No,0,0.42,0.0,-0.42,302,0,-302,758,0,-758,0.0,0.0,0.0,0.0,0.0,0.0
<a href=/player/scanb001>scanb001</a>,Bob Scanlan,Philadelphia Phillies,PHILS,3,5,4,9,1991,1996,5,No,0,0.9,5.94,5.04,864,567,-297,60,158,98,1703.0,1127.0,-576.0,3609000.0,0.0,-3609000.0
<a href=/player/scanb001>scanb001</a>,Bob Scanlan,Chicago Cubs,CUBS,1,1,2,3,1993,1993,0,No,0,0.89,0.0,-0.89,51,0,-51,0,0,0,564.0,0.0,-564.0,245000.0,0.0,-245000.0
<a href=/player/scand101>scand101</a>,Doc Scanlan,Brooklyn Dodgers,DOGRS,2,3,2,5,1911,1915,4,No,0,-0.82,7.63,8.45,36,220,184,23,209,186,201.0,1792.0,1591.0,2600.0,0.0,-2600.0
<a href=/player/scanp102>scanp102</a>,Pat Scanlon,Montreal Expos,NATEX,3,6,6,12,1976,1983,7,No,0,4.1,3.12,-0.98,573,1002,429,1861,2648,787,25.0,308.0,283.0,0.0,0.0,0.0
<a href=/player/scanp102>scanp102</a>,Pat Scanlon,St. Louis Cardinals,CARDS,1,2,1,3,1977,1978,1,No,0,-0.62,0.98,1.6,351,116,-235,172,6,-166,1013.0,278.0,-735.0,0.0,0.0,0.0
<a href=/player/scarl101>scarl101</a>,Les Scarsella,Cincinnati Reds,REDS,2,5,2,7,1939,1942,3,No,0,-0.55,3.89,4.44,194,139,-55,101,249,148,438.0,909.0,471.0,4500.0,0.0,-4500.0
<a href=/player/scarm101>scarm101</a>,Mac Scarce,Philadelphia Phillies,PHILS,2,4,4,8,1974,1984,10,No,0,23.16,7.68,-15.48,1035,1011,-24,3964,168,-3796,0.0,2166.0,2166.0,0.0,0.0,0.0
<a href=/player/scarm101>scarm101</a>,Mac Scarce,New York Mets,METS,2,2,3,5,1975,1976,1,No,0,-0.55,-0.88,-0.33,39,79,40,0,6,6,114.0,196.0,82.0,0.0,0.0,0.0
<a href=/player/scarm101>scarm101</a>,Mac Scarce,Minnesota Twins,TWINS,2,2,2,4,1978,1981,3,No,0,0.0,0.0,0.0,0,41,41,0,0,0,0.0,266.0,266.0,0.0,0.0,0.0
<a href=/player/scarr101>scarr101</a>,Randy Scarbery,Oakland Athletics,ATLTCS,1,1,1,2,1977,1977,0,No,0,0.0,0.18,0.18,0,6,6,0,0,0,0.0,55.0,55.0,0.0,0.0,0.0
<a href=/player/scarr101>scarr101</a>,Randy Scarbery,Chicago White Sox,WSOX,7,12,10,22,1980,1994,14,No,0,14.41,9.12,-5.29,691,989,298,1049,2546,1497,4103.0,4503.0,400.0,1513333.0,0.0,-1513333.0
<a href=/player/scarr102>scarr102</a>,Ray Scarborough,Washington Senators,TWINS,12,23,24,47,1950,1963,13,No,0,21.31,19.51,-1.8,2117,2519,402,6320,5694,-626,2404.0,6282.0,3878.0,32000.0,0.0,-32000.0
<a href=/player/scarr102>scarr102</a>,Ray Scarborough,Chicago White Sox,WSOX,5,11,10,21,1950,1963,13,No,0,1.07,31.48,30.41,1321,1905,584,3161,6140,2979,1824.0,1373.0,-451.0,20000.0,0.0,-20000.0
<a href=/player/scarr103>scarr103</a>,Russ Scarritt,StPaul,StPaul,1,2,2,4,1928,1929,1,No,0,0.83,0.0,-0.83,329,0,-329,1236,0,-1236,0.0,0.0,0.0,0.0,0.0,0.0
<a href=/player/scars001>scars001</a>,Steve Scarsone,Philadelphia Phillies,PHILS,1,1,1,2,1992,1993,1,No,0,-0.11,0.28,0.39,11,70,59,19,241,222,0.0,0.0,0.0,0.0,0.0,0.0
<a href=/player/scars001>scars001</a>,Steve Scarsone,Baltimore Orioles,ORLS,1,1,1,2,1993,1993,0,No,0,1.3,-0.25,-1.55,281,10,-271,810,21,-789,0.0,0.0,0.0,0.0,0.0,0.0
<a href=/player/schaa102>schaa102</a>,Art Schallock,Brooklyn Dodgers,DOGRS,1,1,3,4,1951,1951,0,No,0,0.28,0.0,-0.28,56,0,-56,29,0,-29,270.0,0.0,-270.0,0.0,0.0,0.0
<a href=/player/schab102>schab102</a>,Bill Schardt,Brooklyn Dodgers,DOGRS,1,2,2,4,1912,1916,4,No,0,0.0,-0.4,-0.4,0,214,214,0,788,788,0.0,0.0,0.0,4200.0,0.0,-4200.0
<a href=/player/schab103>schab103</a>,Biff Schaller,Chicago White Sox,WSOX,1,1,1,2,1913,1913,0,No,0,0.0,0.0,0.0,0,0,0,0,0,0,0.0,0.0,0.0,0.0,0.0,0.0
<a href=/player/schac101>schac101</a>,Charley Schanz,Seattle,Seattle,1,2,2,4,1949,1950,1,No,0,-0.68,0.0,0.68,28,0,-28,12,0,-12,68.0,0.0,-68.0,0.0,0.0,0.0
<a href=/player/schad001>schad001</a>,Dan Schatzeder,Montreal Expos,NATEX,1,1,1,2,1979,1980,1,No,0,1.95,2.49,0.54,49,139,90,0,587,587,792.0,0.0,-792.0,0.0,0.0,0.0
<a href=/player/schad001>schad001</a>,Dan Schatzeder,Detroit Tigers,TIGRS,1,2,1,3,1981,1986,5,No,0,-1.99,10.36,12.35,58,678,620,18,2558,2540,218.0,0.0,-218.0,0.0,0.0,0.0
<a href=/player/schad001>schad001</a>,Dan Schatzeder,Montreal Expos,NATEX,1,2,2,4,1986,1992,6,No,0,0.09,3.06,2.97,102,697,595,18,1867,1849,201.0,144.0,-57.0,415000.0,0.0,-415000.0
<a href=/player/schad001>schad001</a>,Dan Schatzeder,Philadelphia Phillies,PHILS,1,2,2,4,1987,1987,0,No,0,-0.54,0.0,0.54,41,0,-41,0,0,0,162.0,0.0,-162.0,425000.0,0.0,-425000.0
<a href=/player/schad001>schad001</a>,Dan Schatzeder,Houston Astros,ASTROS,1,1,2,3,1990,1990,0,No,0,0.27,0.0,-0.27,12,0,-12,0,0,0,17.0,0.0,-17.0,450000.0,0.0,-450000.0
<a href=/player/schag001>schag001</a>,Gene Schall,Philadelphia Phillies,PHILS,1,1,1,2,1997,1997,0,No,0,0.0,-0.33,-0.33,0,22,22,0,41,41,0.0,0.0,0.0,0.0,0.0,0.0
<a href=/player/schag101>schag101</a>,Germany Schaefer,Detroit Tigers,TIGRS,1,2,1,3,1909,1909,0,No,0,6.2,1.23,-4.97,528,46,-482,1839,188,-1651,2.0,0.0,-2.0,0.0,0.0,0.0
<a href=/player/schag102>schag102</a>,George Scharein,New York Giants,GIANTS,1,2,1,3,1936,1936,0,No,0,-4.47,0.0,4.47,388,0,-388,1419,0,-1419,0.0,0.0,0.0,0.0,0.0,0.0
<a href=/player/schag102>schag102</a>,George Scharein,Philadelphia Phillies,PHILS,1,2,1,3,1940,1941,1,No,0,0.0,-0.18,-0.18,0,120,120,0,488,488,0.0,0.0,0.0,0.0,0.0,0.0
<a href=/player/schaj002>schaj002</a>,Jordan Schafer,Atlanta Braves,BRAVES,2,5,3,8,2011,2019,8,No,1,1.07,6.63,5.56,249,230,-19,481,952,471,1075.0,36.0,-1039.0,0.0,0.0,0.0
<a href=/player/schaj101>schaj101</a>,Jeff Schattinger,Kansas City Royals,ROYALS,1,1,1,2,1982,1987,5,No,0,0.0,-0.57,-0.57,0,390,390,0,821,821,0.0,0.0,0.0,0.0,0.0,0.0
<a href=/player/schaj104>schaj104</a>,Jimmie Schaffer,St. Louis Cardinals,CARDS,15,32,26,58,1962,1972,10,No,0,54.99,16.45,-38.54,4551,1419,-3132,9818,4107,-5711,7592.0,1574.0,-6018.0,32500.0,0.0,-32500.0
<a href=/player/schaj104>schaj104</a>,Jimmie Schaffer,Chicago Cubs,CUBS,1,1,1,2,1964,1964,0,No,0,0.27,0.0,-0.27,17,0,-17,34,0,-34,0.0,0.0,0.0,0.0,0.0,0.0
<a href=/player/schaj104>schaj104</a>,Jimmie Schaffer,Chicago White Sox,WSOX,1,1,1,2,1965,1965,0,No,0,-0.55,-0.06,0.49,24,28,4,38,3,-35,0.0,80.0,80.0,13500.0,0.0,-13500.0
<a href=/player/schaj104>schaj104</a>,Jimmie Schaffer,New York Mets,METS,1,3,1,4,1966,1966,0,No,0,-0.11,-0.09,0.02,10,31,21,19,96,77,0.0,0.0,0.0,0.0,0.0,0.0
<a href=/player/schaj104>schaj104</a>,Jimmie Schaffer,Cincinnati Reds,REDS,1,1,1,2,1969,1970,1,No,0,0.0,0.61,0.61,0,68,68,0,132,132,0.0,0.0,0.0,0.0,0.0,0.0
<a href=/player/scham101>scham101</a>,Mark Schaeffer,Boston Red Sox,RSOX,1,1,1,2,1969,1969,0,No,0,0.0,0.0,0.0,0,0,0,0,0,0,0.0,0.0,0.0,0.0,0.0,0.0
<a href=/player/scham101>scham101</a>,Mark Schaeffer,Houston Astros,ASTROS,7,14,10,24,1971,1989,18,No,0,9.86,19.8,9.94,2403,1970,-433,5583,4832,-751,5444.0,4390.0,-1054.0,22500.0,0.0,-22500.0
<a href=/player/schap101>schap101</a>,Paul Schaal,Kansas City Royals,ROYALS,1,1,1,2,1974,1974,0,No,0,-0.63,-0.74,-0.11,53,36,-17,183,91,-92,0.0,0.0,0.0,0.0,0.0,0.0
<a href=/player/schar103>schar103</a>,Ray Schalk,Milwaukee,Milwaukee,1,1,5,6,1912,1919,7,No,0,33.22,0.0,-33.22,1757,0,-1757,6239,0,-6239,0.0,0.0,0.0,0.0,0.0,0.0
<a href=/player/schaw101>schaw101</a>,Wally Schang,Philadelphia Athletics,ATLTCS,2,6,5,11,1917,1924,7,No,0,21.83,0.26,-21.57,730,281,-449,2197,867,-1330,2329.0,731.0,-1598.0,12000.0,0.0,-12000.0
<a href=/player/schaw101>schaw101</a>,Wally Schang,Boston Red Sox,RSOX,11,21,24,45,1920,1937,17,No,0,85.68,51.32,-34.36,3377,2671,-706,8411,9094,683,11819.0,4939.0,-6880.0,73300.0,0.0,-73300.0
<a href=/player/schaw101>schaw101</a>,Wally Schang,New York Yankees,YANKS,1,1,2,3,1926,1926,0,No,0,11.12,0.0,-11.12,385,0,-385,1302,0,-1302,0.0,0.0,0.0,0.0,0.0,0.0
<a href=/player/schaw101>schaw101</a>,Wally Schang,St.Louis Browns,ORLS,1,1,2,3,1929,1929,0,No,0,-0.56,0.0,0.56,45,0,-45,116,0,-116,0.0,0.0,0.0,10000.0,0.0,-10000.0
<a href=/player/scheb001>scheb001</a>,Bill Scherrer,Cincinnati Reds,REDS,1,1,2,3,1984,1985,1,No,0,-0.02,-0.88,-0.86,80,36,-44,0,3,3,318.0,70.0,-248.0,0.0,0.0,0.0
<a href=/player/scheb101>scheb101</a>,Bob Scheffing,Chicago Cubs,CUBS,1,1,1,2,1950,1954,4,No,0,0.02,0.35,0.33,68,54,-14,190,126,-64,0.0,0.0,0.0,0.0,0.0,0.0
<a href=/player/schef102>schef102</a>,Fred Scherman,Detroit Tigers,TIGRS,2,3,3,6,1973,1976,3,No,0,-1.64,-0.8,0.84,197,425,228,134,1581,1447,233.0,157.0,-76.0,32000.0,0.0,-32000.0
<a href=/player/scheh101>scheh101</a>,Heinie Scheer,Philadelphia Athletics,ATLTCS,1,4,1,5,1923,1932,9,No,0,0.0,51.22,51.22,0,1240,1240,0,5473,5473,0.0,0.0,0.0,9900.0,0.0,-9900.0
<a href=/player/scheh103>scheh103</a>,Hank Schenz,Chicago Cubs,CUBS,1,1,1,2,1949,1949,0,No,0,0.0,-1.35,-1.35,0,65,65,0,201,201,0.0,0.0,0.0,0.0,0.0,0.0
<a href=/player/schem001>schem001</a>,Max Scherzer,Arizona Diamondbacks,DBACKS,5,9,10,19,2009,2019,10,Yes,0,25.87,12.08,-13.79,479,854,375,186,430,244,5327.0,4326.0,-1001.0,18334500.0,0.0,-18334500.0
<a href=/player/schem001>schem001</a>,Max Scherzer,Washington Nationals,NATEX,1,2,4,6,2021,2021,0,Yes,0,4.89,0.24,-4.65,74,47,-27,252,110,-142,205.0,188.0,-17.0,47503480.0,0.0,-47503480.0
<a href=/player/scher001>scher001</a>,Rich Scheid,New York Yankees,YANKS,6,14,8,22,1987,2001,14,No,1,22.68,17.2,-5.48,1957,1291,-666,5757,3988,-1769,3742.0,1690.0,-2052.0,2485000.0,0.0,-2485000.0
<a href=/player/scher001>scher001</a>,Rich Scheid,Chicago Cubs,CUBS,1,1,1,2,1989,1989,0,No,0,0.0,0.0,0.0,0,0,0,0,0,0,0.0,0.0,0.0,0.0,0.0,0.0
<a href=/player/scher001>scher001</a>,Rich Scheid,Chicago White Sox,WSOX,1,1,1,2,1992,1992,0,No,0,-0.18,0.0,0.18,14,0,-14,1,0,-1,36.0,0.0,-36.0,0.0,0.0,0.0
<a href=/player/scher101>scher101</a>,Richie Scheinblum,Kansas City Royals,ROYALS,2,3,3,6,1972,1986,14,No,0,0.89,27.33,26.44,85,1835,1750,116,7325,7209,420.0,179.0,-241.0,31000.0,0.0,-31000.0
<a href=/player/scher101>scher101</a>,Richie Scheinblum,Cincinnati Reds,REDS,1,1,2,3,1973,1973,0,No,0,1.47,0.0,-1.47,87,0,-87,295,0,-295,0.0,0.0,0.0,27500.0,0.0,-27500.0
<a href=/player/scher101>scher101</a>,Richie Scheinblum,California Angels,ANGELS,1,1,1,2,1974,1974,0,No,0,-0.74,-0.63,0.11,36,53,17,91,183,92,0.0,0.0,0.0,0.0,0.0,0.0
<a href=/player/sches001>sches001</a>,Scott Schebler,Los Angeles Dodgers,DOGRS,3,7,6,13,2015,2019,4,No,0,7.85,6.19,-1.66,1100,293,-807,3346,616,-2730,1782.0,1084.0,-698.0,0.0,0.0,0.0
<a href=/player/schic001>schic001</a>,Calvin Schiraldi,New York Mets,METS,6,12,11,23,1985,1994,9,No,0,8.23,9.35,1.12,636,686,50,644,1209,565,3320.0,3063.0,-257.0,4116666.0,0.0,-4116666.0
<a href=/player/schic001>schic001</a>,Calvin Schiraldi,Boston Red Sox,RSOX,2,3,2,5,1987,1992,5,No,0,5.91,6.0,0.09,700,548,-152,106,1578,1472,1775.0,506.0,-1269.0,1675000.0,0.0,-1675000.0
<a href=/player/schic001>schic001</a>,Calvin Schiraldi,Chicago Cubs,CUBS,1,3,2,5,1989,1992,3,No,0,9.01,-0.33,-9.34,632,454,-178,1598,1395,-203,382.0,0.0,-382.0,400000.0,0.0,-400000.0
<a href=/player/schic002>schic002</a>,Curt Schilling,Boston Red Sox,RSOX,3,4,4,8,1988,2001,13,No,2,35.17,13.87,-21.3,1803,537,-1266,7464,1508,-5956,208.0,1586.0,1378.0,1112500.0,0.0,-1112500.0
<a href=/player/schic002>schic002</a>,Curt Schilling,Baltimore Orioles,ORLS,1,3,1,4,1991,1993,2,No,0,24.17,0.73,-23.44,904,185,-719,2612,764,-1848,2435.0,0.0,-2435.0,0.0,0.0,0.0
<a href=/player/schic002>schic002</a>,Curt Schilling,Houston Astros,ASTROS,1,1,1,2,1992,1993,1,No,0,36.28,0.0,-36.28,479,0,-479,594,0,-594,4978.0,0.0,-4978.0,0.0,0.0,0.0
<a href=/player/schic002>schic002</a>,Curt Schilling,Philadelphia Phillies,PHILS,3,3,7,10,2000,2006,6,No,0,30.94,10.08,-20.86,397,825,428,351,1810,1459,4627.0,3322.0,-1305.0,11600000.0,0.0,-11600000.0
<a href=/player/schic002>schic002</a>,Curt Schilling,Arizona Diamondbacks,DBACKS,8,16,17,33,2003,2012,9,No,3,32.31,1.14,-31.17,2256,826,-1430,5190,761,-4429,6187.0,1931.0,-4256.0,17950667.0,0.0,-17950667.0
<a href=/player/schic101>schic101</a>,Chuck Schilling,Boston Red Sox,RSOX,2,5,3,8,1966,1966,0,No,0,-0.53,-0.7,-0.17,125,80,-45,299,29,-270,0.0,336.0,336.0,18500.0,0.0,-18500.0
<a href=/player/schin001>schin001</a>,Nate Schierholtz,San Francisco Giants,GIANTS,1,3,1,4,2012,2018,6,No,0,-0.86,10.45,11.31,288,772,484,953,3095,2142,6.0,0.0,-6.0,1300000.0,0.0,-1300000.0
<a href=/player/schir001>schir001</a>,Ryan Schimpf,San Diego Padres,PADRS,1,1,1,2,2017,2017,0,Yes,0,0.0,0.0,0.0,0,0,0,0,0,0,0.0,0.0,0.0,546200.0,0.0,-546200.0
<a href=/player/schir001>schir001</a>,Ryan Schimpf,Tampa Bay Devil Rays,RAYS,1,1,1,2,2018,2018,0,No,0,0.0,0.0,0.0,0,0,0,0,0,0,0.0,0.0,0.0,0.0,0.0,0.0
<a href=/player/schir001>schir001</a>,Ryan Schimpf,Atlanta Braves,BRAVES,1,1,1,2,2018,2018,0,No,0,0.14,-0.36,-0.5,5,8,3,7,22,15,0.0,0.0,0.0,0.0,0.0,0.0
<a href=/player/schla101>schla101</a>,Admiral Schlei,Cincinnati Reds,REDS,3,3,9,12,1908,1925,17,No,0,7.71,59.0,51.29,556,2164,1608,1859,7745,5886,786.0,4428.0,3642.0,14391.0,0.0,-14391.0
<a href=/player/schla101>schla101</a>,Admiral Schlei,St. Louis Cardinals,CARDS,1,3,1,4,1908,1912,4,No,0,13.84,10.02,-3.82,1179,290,-889,3934,993,-2941,1350.0,10.0,-1340.0,0.0,0.0,0.0
<a href=/player/schlb001>schlb001</a>,Brian Schlitter,Philadelphia Phillies,PHILS,1,1,1,2,2008,2009,1,No,0,-0.86,1.69,2.55,152,121,-31,1,0,-1,215.0,133.0,-82.0,0.0,0.0,0.0
<a href=/player/schld001>schld001</a>,Daniel Schlereth,Arizona Diamondbacks,DBACKS,5,9,10,19,2009,2019,10,Yes,0,25.87,12.08,-13.79,479,854,375,186,430,244,5327.0,4326.0,-1001.0,18334500.0,0.0,-18334500.0
<a href=/player/schld101>schld101</a>,Dutch Schliebner,Brooklyn Dodgers,DOGRS,1,1,2,3,1923,1933,10,No,0,0.14,0.11,-0.03,127,66,-61,503,57,-446,0.0,421.0,421.0,3000.0,0.0,-3000.0
<a href=/player/schld101>schld101</a>,Dutch Schliebner,St.Louis Browns,ORLS,29,55,62,117,1924,1952,28,No,0,152.63,143.12,-9.51,7484,11236,3752,22593,31279,8686,18747.0,30694.0,11947.0,281100.0,0.0,-281100.0
<a href=/player/schlg001>schlg001</a>,Gus Schlosser,Atlanta Braves,BRAVES,5,11,10,21,2015,2017,2,Yes,0,22.57,1.32,-21.25,930,130,-800,2591,403,-2188,1128.0,339.0,-789.0,16307500.0,0.0,-16307500.0
<a href=/player/schlj101>schlj101</a>,JayD Schlueter,Houston Astros,ASTROS,1,1,1,2,1973,1973,0,No,0,0.0,0.0,0.0,0,0,0,0,0,0,0.0,0.0,0.0,0.0,0.0,0.0
<a href=/player/schlj101>schlj101</a>,JayD Schlueter,Houston Astros,ASTROS,6,9,10,19,1974,1989,15,No,0,0.9,31.67,30.77,1396,3000,1604,4891,8483,3592,0.0,5622.0,5622.0,705000.0,0.0,-705000.0
<a href=/player/schll101>schll101</a>,Larry Schlafly,Boston Red Sox,RSOX,10,27,24,51,1907,1935,28,No,0,51.77,27.79,-23.98,3792,3187,-605,15081,11693,-3388,0.0,1203.0,1203.0,48850.0,0.0,-48850.0
<a href=/player/schlr101>schlr101</a>,Bill Schlesinger,Boston Red Sox,RSOX,1,1,1,2,1969,1969,0,No,0,0.0,-0.08,-0.08,0,53,53,0,70,70,0.0,0.0,0.0,0.0,0.0,0.0
<a href=/player/schlr101>schlr101</a>,Bill Schlesinger,Boston Red Sox,RSOX,1,3,1,4,1967,1972,5,No,0,-0.13,11.23,11.36,5,302,297,13,404,391,0.0,3126.0,3126.0,0.0,0.0,0.0
<a href=/player/schlt001>schlt001</a>,Travis Schlichting,Tampa Bay Devil Rays,RAYS,1,1,1,2,2005,2008,3,No,0,0.0,0.21,0.21,0,93,93,0,280,280,0.0,0.0,0.0,0.0,0.0,0.0
<a href=/player/schmb001>schmb001</a>,Brian Schmack,Chicago White Sox,WSOX,1,2,1,3,2000,2002,2,No,0,-2.48,2.74,5.22,35,247,212,0,861,861,387.0,0.0,-387.0,200000.0,0.0,-200000.0
<a href=/player/schmb101>schmb101</a>,Bob Schmidt,San Francisco Giants,GIANTS,9,17,13,30,1961,1972,11,No,0,22.69,19.49,-3.2,2066,1611,-455,6411,2790,-3621,1334.0,4789.0,3455.0,50000.0,0.0,-50000.0
<a href=/player/schmb101>schmb101</a>,Bob Schmidt,Cincinnati Reds,REDS,1,2,2,4,1961,1966,5,No,0,3.64,1.4,-2.24,249,457,208,410,839,429,1116.0,326.0,-790.0,0.0,0.0,0.0
<a href=/player/schmd001>schmd001</a>,Dave J. Schmidt,Texas Rangers,RNGRS,5,8,10,18,1985,1992,7,No,0,27.49,15.69,-11.8,1300,776,-524,3930,3021,-909,3469.0,327.0,-3142.0,2890539.0,0.0,-2890539.0
<a href=/player/schmf101>schmf101</a>,Freddy Schmidt,St. Louis Cardinals,CARDS,2,4,2,6,1947,1952,5,No,0,7.58,4.01,-3.57,327,364,37,1048,1141,93,230.0,0.0,-230.0,9000.0,0.0,-9000.0
<a href=/player/schmj001>schmj001</a>,Jason Schmidt,Atlanta Braves,BRAVES,10,23,19,42,1996,2015,19,No,3,94.1,26.32,-67.78,4716,2211,-2505,15043,5115,-9928,7498.0,3071.0,-4427.0,29276500.0,0.0,-29276500.0
<a href=/player/schmj001>schmj001</a>,Jason Schmidt,Pittsburgh Pirates,PIRATS,1,2,2,4,2001,2006,5,No,0,22.58,-2.33,-24.91,365,279,-86,551,301,-250,3209.0,841.0,-2368.0,5050000.0,0.0,-5050000.0
<a href=/player/schmj101>schmj101</a>,Johnny Schmitz,Chicago Cubs,CUBS,9,26,24,50,1951,1965,14,No,0,14.31,21.74,7.43,2452,2862,410,6527,5620,-907,3090.0,5461.0,2371.0,143500.0,0.0,-143500.0
<a href=/player/schmj101>schmj101</a>,Johnny Schmitz,Brooklyn Dodgers,DOGRS,1,1,1,2,1952,1952,0,No,0,0.21,0.0,-0.21,16,0,-16,6,0,-6,58.0,0.0,-58.0,0.0,0.0,0.0
<a href=/player/schmj101>schmj101</a>,Johnny Schmitz,New York Yankees,YANKS,1,5,1,6,1952,1955,3,No,0,5.35,0.52,-4.83,390,26,-364,1419,10,-1409,46.0,107.0,61.0,0.0,0.0,0.0
<a href=/player/schmj101>schmj101</a>,Johnny Schmitz,Washington Senators,TWINS,7,16,14,30,1955,1963,8,No,0,11.54,-1.9,-13.44,1150,1625,475,3478,3777,299,832.0,1792.0,960.0,17500.0,0.0,-17500.0
<a href=/player/schmr101>schmr101</a>,Ray Schmandt,Brooklyn Dodgers,DOGRS,1,2,1,3,1923,1926,3,No,0,0.02,18.82,18.8,141,519,378,488,2176,1688,0.0,0.0,0.0,0.0,0.0,0.0
<a href=/player/schms001>schms001</a>,Steve Schmoll,Los Angeles Dodgers,DOGRS,2,5,5,10,2006,2007,1,No,0,3.53,-1.15,-4.68,810,232,-578,1884,134,-1750,767.0,896.0,129.0,682000.0,0.0,-682000.0
<a href=/player/schmw101>schmw101</a>,Willard Schmidt,St. Louis Cardinals,CARDS,31,60,55,115,1957,1998,41,No,7,117.05,218.79,101.74,11329,10308,-1021,30194,36340,6146,12663.0,4453.0,-8210.0,3323333.0,0.0,-3323333.0
<a href=/player/schnb001>schnb001</a>,Brian Schneider,Washington Nationals,NATEX,3,5,5,10,2007,2012,5,No,0,12.18,4.97,-7.21,1207,808,-399,2595,1406,-1189,688.0,605.0,-83.0,4767000.0,0.0,-4767000.0
<a href=/player/schnd101>schnd101</a>,Dan Schneider,Atlanta Braves,BRAVES,1,3,3,6,1966,1970,4,No,0,-2.48,0.0,2.48,260,0,-260,50,0,-50,409.0,0.0,-409.0,0.0,0.0,0.0
<a href=/player/schnd102>schnd102</a>,Dave Schneck,New York Mets,METS,6,9,10,19,1974,1984,10,No,0,10.05,22.43,12.38,1462,1185,-277,1334,4141,2807,2280.0,196.0,-2084.0,90000.0,0.0,-90000.0
<a href=/player/schnd102>schnd102</a>,Dave Schneck,Philadelphia Phillies,PHILS,1,1,1,2,1975,1981,6,No,0,0.0,-0.47,-0.47,0,76,76,0,93,93,0.0,0.0,0.0,0.0,0.0,0.0
<a href=/player/schnd102>schnd102</a>,Dave Schneck,Cincinnati Reds,REDS,2,2,2,4,1977,1979,2,No,0,4.41,-0.12,-4.53,274,99,-175,887,200,-687,0.0,0.0,0.0,0.0,0.0,0.0
<a href=/player/schnf101>schnf101</a>,Frank Schneiberg,Brooklyn Dodgers,DOGRS,1,2,1,3,1910,1915,5,No,0,0.0,2.48,2.48,0,205,205,0,830,830,0.0,0.0,0.0,0.0,0.0,0.0
<a href=/player/schnj101>schnj101</a>,Jeff Schneider,Baltimore Orioles,ORLS,1,2,1,3,1982,1983,1,No,0,18.92,1.8,-17.12,787,226,-561,3268,901,-2367,0.0,0.0,0.0,0.0,0.0,0.0
<a href=/player/schod001>schod001</a>,Dick Schofield,California Angels,ANGELS,1,2,1,3,1992,1996,4,No,0,2.15,2.22,0.07,142,49,-93,498,0,-498,0.0,723.0,723.0,1600000.0,0.0,-1600000.0
<a href=/player/schod101>schod101</a>,Dick Schofield,St. Louis Cardinals,CARDS,2,3,3,6,1958,1958,0,No,0,10.23,-0.59,-10.82,708,75,-633,2195,205,-1990,0.0,6.0,6.0,0.0,0.0,0.0
<a href=/player/schod101>schod101</a>,Dick Schofield,Pittsburgh Pirates,PIRATS,1,1,1,2,1965,1972,7,No,0,-0.4,3.44,3.84,112,625,513,439,1710,1271,0.0,0.0,0.0,0.0,0.0,0.0
<a href=/player/schod101>schod101</a>,Dick Schofield,New York Yankees,YANKS,1,1,2,3,1966,1966,0,No,0,1.03,0.0,-1.03,104,0,-104,351,0,-351,0.0,0.0,0.0,0.0,0.0,0.0
<a href=/player/schod101>schod101</a>,Dick Schofield,St. Louis Cardinals,CARDS,2,2,2,4,1968,1969,1,No,0,1.21,0.5,-0.71,242,85,-157,463,22,-441,402.0,252.0,-150.0,25000.0,0.0,-25000.0
<a href=/player/schod101>schod101</a>,Dick Schofield,Boston Red Sox,RSOX,1,1,1,2,1970,1970,0,No,0,0.63,0.0,-0.63,34,0,-34,72,0,-72,0.0,0.0,0.0,32000.0,0.0,-32000.0
<a href=/player/schod101>schod101</a>,Dick Schofield,St. Louis Cardinals,CARDS,2,4,3,7,1971,1971,0,No,0,0.65,0.42,-0.23,128,32,-96,382,84,-298,18.0,0.0,-18.0,27000.0,0.0,-27000.0
<a href=/player/schog102>schog102</a>,Gerry Schoen,Seattle Pilots,BREWRS,3,5,5,10,1969,1971,2,No,0,-0.36,0.51,0.87,44,202,158,5,21,16,119.0,376.0,257.0,17500.0,0.0,-17500.0
<a href=/player/schoj001>schoj001</a>,Jonathan Schoop,Baltimore Orioles,ORLS,2,2,4,6,2018,2020,2,Yes,0,-0.08,5.49,5.57,76,219,143,262,950,688,0.0,17.0,17.0,13325000.0,0.0,-13325000.0
<a href=/player/schoo101>schoo101</a>,Otto Schomberg,Pittsburgh Pirates,PIRATS,1,2,1,3,1886,1886,0,No,0,0.0,0.0,0.0,0,0,0,0,0,0,0.0,0.0,0.0,0.0,0.0,0.0
<a href=/player/schor101>schor101</a>,Red Schoendienst,New York Giants,GIANTS,3,3,6,9,1957,1960,3,No,0,10.09,2.95,-7.14,546,495,-51,2172,1209,-963,0.0,503.0,503.0,42000.0,0.0,-42000.0
<a href=/player/schor101>schor101</a>,Red Schoendienst,St. Louis Cardinals,CARDS,19,44,38,82,1956,1972,16,No,0,56.42,67.4,10.98,5645,3260,-2385,13530,9157,-4373,6309.0,6165.0,-144.0,120500.0,0.0,-120500.0
<a href=/player/schos001>schos001</a>,Scott Schoeneweis,Anaheim Angels,ANGELS,1,2,3,5,2003,2006,3,No,0,0.32,0.04,-0.28,41,21,-20,2,0,-2,416.0,90.0,-326.0,1425000.0,0.0,-1425000.0
<a href=/player/schos001>schos001</a>,Scott Schoeneweis,Toronto Blue Jays,BJAYS,1,1,1,2,2006,2006,0,No,0,0.94,0.0,-0.94,32,0,-32,0,0,0,43.0,0.0,-43.0,2750000.0,0.0,-2750000.0
<a href=/player/schos001>schos001</a>,Scott Schoeneweis,New York Mets,METS,1,1,1,2,2008,2009,1,No,0,-0.7,0.0,0.7,87,0,-87,0,0,0,72.0,0.0,-72.0,3600000.0,0.0,-3600000.0
<a href=/player/schra101>schra101</a>,Al Schroll,Boston Red Sox,RSOX,1,1,1,2,1959,1960,1,No,0,-0.19,0.73,0.92,4,40,36,1,127,126,8.0,0.0,-8.0,0.0,0.0,0.0
<a href=/player/schrb001>schrb001</a>,Bill Schroeder,Milwaukee Brewers,BREWRS,1,1,1,2,1988,1990,2,No,0,-0.07,-0.54,-0.47,59,97,38,203,201,-2,0.0,0.0,0.0,372500.0,0.0,-372500.0
<a href=/player/schrh101>schrh101</a>,Hank Schreiber,Indianapolis,Indianapolis,1,2,3,5,1926,1926,0,No,0,24.0,0.0,-24.0,988,0,-988,3984,0,-3984,0.0,0.0,0.0,0.0,0.0,0.0
<a href=/player/schrh101>schrh101</a>,Hank Schreiber,Chicago Cubs,CUBS,1,1,1,2,1926,1926,0,No,0,0.0,0.0,0.0,0,0,0,0,0,0,0.0,0.0,0.0,3467.0,0.0,-3467.0
<a href=/player/schrk001>schrk001</a>,Ken Schrom,California Angels,ANGELS,1,1,1,2,1980,1980,0,No,0,-0.15,0.01,0.16,26,21,-5,0,0,0,139.0,200.0,61.0,0.0,0.0,0.0
<a href=/player/schrk001>schrk001</a>,Ken Schrom,Minnesota Twins,TWINS,1,2,2,4,1986,1986,0,No,0,-0.02,-0.18,-0.16,101,5,-96,0,0,0,1286.0,31.0,-1255.0,0.0,0.0,0.0
<a href=/player/schrm001>schrm001</a>,Max Schrock,Washington Nationals,NATEX,1,1,2,3,2016,2016,0,No,0,0.0,0.35,0.35,0,28,28,0,0,0,0.0,35.0,35.0,0.0,0.0,0.0
<a href=/player/schrm001>schrm001</a>,Max Schrock,Oakland Athletics,ATLTCS,1,2,1,3,2017,2017,0,Yes,0,-0.26,0.0,0.26,208,0,-208,527,0,-527,3.0,0.0,-3.0,0.0,0.0,0.0
<a href=/player/schro101>schro101</a>,Osee Schrecongost,Boston Red Sox,RSOX,1,1,1,2,1901,1905,4,No,0,0.11,0.74,0.63,18,448,430,74,1834,1760,0.0,0.0,0.0,0.0,0.0,0.0
<a href=/player/schrp101>schrp101</a>,Pop Schriver,Philadelphia Phillies,PHILS,1,2,1,3,1891,1891,0,No,0,0.0,2.31,2.31,0,76,76,0,125,125,0.0,807.0,807.0,0.0,0.0,0.0
<a href=/player/schrp101>schrp101</a>,Pop Schriver,Cincinnati Reds,REDS,1,5,3,8,1897,1900,3,No,0,8.1,12.35,4.25,718,395,-323,2747,1335,-1412,936.0,1747.0,811.0,0.0,0.0,0.0
<a href=/player/schua001>schua001</a>,A.J. Schugel,Anaheim Angels,ANGELS,2,4,5,9,2013,2018,5,Yes,0,-0.66,6.84,7.5,224,159,-65,546,24,-522,593.0,2315.0,1722.0,540000.0,0.0,-540000.0
<a href=/player/schub101>schub101</a>,Barney Schultz,St. Louis Cardinals,CARDS,2,2,2,4,1958,1962,4,No,0,-0.06,0.0,0.06,26,0,-26,2,0,-2,55.0,0.0,-55.0,0.0,0.0,0.0
<a href=/player/schub101>schub101</a>,Barney Schultz,Chicago Cubs,CUBS,1,1,1,2,1963,1963,0,No,0,2.11,-0.34,-2.45,176,27,-149,10,55,45,381.0,0.0,-381.0,0.0,0.0,0.0
<a href=/player/schub102>schub102</a>,Bill Schuster,Pittsburgh Pirates,PIRATS,2,3,2,5,1939,1954,15,No,0,-0.07,26.25,26.32,2,940,938,3,3857,3854,0.0,0.0,0.0,0.0,0.0,0.0
<a href=/player/schub103>schub103</a>,Bob Schultz,Chicago Cubs,CUBS,7,18,16,34,1953,1965,12,No,0,5.64,21.93,16.29,1405,1825,420,3839,2173,-1666,1451.0,4951.0,3500.0,82000.0,0.0,-82000.0
<a href=/player/schub104>schub104</a>,Buddy Schultz,Chicago Cubs,CUBS,1,1,1,2,1977,1977,0,No,0,2.23,0.0,-2.23,267,0,-267,28,0,-28,632.0,0.0,-632.0,0.0,0.0,0.0
<a href=/player/schud001>schud001</a>,Don Schulze,Chicago Cubs,CUBS,4,14,9,23,1984,1991,7,No,0,18.76,21.66,2.9,1968,1112,-856,6227,902,-5325,1933.0,5322.0,3389.0,1746666.0,0.0,-1746666.0
<a href=/player/schud001>schud001</a>,Don Schulze,Cleveland Indians,INDINS,1,1,1,2,1987,1987,0,No,0,-0.25,0.0,0.25,10,0,-10,5,0,-5,65.0,0.0,-65.0,0.0,0.0,0.0
<a href=/player/schud001>schud001</a>,Don Schulze,Minnesota Twins,TWINS,3,3,3,6,1988,1990,2,No,0,0.0,-0.18,-0.18,0,11,11,0,0,0,0.0,36.0,36.0,0.0,0.0,0.0
<a href=/player/schud001>schud001</a>,Don Schulze,New York Yankees,YANKS,2,3,3,6,1989,1996,7,No,1,-0.39,-0.58,-0.19,192,33,-159,619,38,-581,73.0,249.0,176.0,575000.0,0.0,-575000.0
<a href=/player/schud002>schud002</a>,Dave Schuler,Cleveland Indians,INDINS,2,3,4,7,1977,1983,6,No,0,4.0,9.46,5.46,343,468,125,13,775,762,1466.0,1221.0,-245.0,85000.0,0.0,-85000.0
<a href=/player/schue001>schue001</a>,Erik Schullstrom,Baltimore Orioles,ORLS,1,2,1,3,1992,1992,0,No,0,-1.14,-0.08,1.06,223,5,-218,809,0,-809,0.0,99.0,99.0,0.0,0.0,0.0
<a href=/player/schue001>schue001</a>,Erik Schullstrom,Baltimore Orioles,ORLS,1,1,1,2,1993,1993,0,No,0,-0.25,1.35,1.6,46,33,-13,0,126,126,180.0,0.0,-180.0,0.0,0.0,0.0
<a href=/player/schuf101>schuf101</a>,Fred Schulte,St.Louis Browns,ORLS,20,38,48,86,1932,1952,20,No,0,96.01,96.11,0.1,5218,8686,3468,17109,27646,10537,8613.0,15510.0,6897.0,185500.0,0.0,-185500.0
<a href=/player/schuf101>schuf101</a>,Fred Schulte,Milwaukee,Milwaukee,1,1,4,5,1926,1930,4,No,0,11.7,0.0,-11.7,720,0,-720,3061,0,-3061,0.0,0.0,0.0,0.0,0.0,0.0
<a href=/player/schuf102>schuf102</a>,Ferdie Schupp,New York Giants,GIANTS,1,1,1,2,1919,1926,7,No,0,1.26,10.0,8.74,115,731,616,135,2428,2293,1076.0,0.0,-1076.0,4472.0,0.0,-4472.0
<a href=/player/schuf102>schuf102</a>,Ferdie Schupp,St. Louis Cardinals,CARDS,1,2,1,3,1921,1924,3,No,0,-0.25,4.34,4.59,114,209,95,179,222,43,183.0,1768.0,1585.0,5000.0,0.0,-5000.0
<a href=/player/schuf103>schuf103</a>,Frank Schulte,Chicago Cubs,CUBS,2,5,2,7,1916,1918,2,No,0,4.43,7.54,3.11,398,188,-210,1271,487,-784,0.0,807.0,807.0,4000.0,0.0,-4000.0
<a href=/player/schuh101>schuh101</a>,Howie Schultz,StPaul,StPaul,1,1,2,3,1943,1943,0,No,0,0.43,0.0,-0.43,314,0,-314,1177,0,-1177,0.0,0.0,0.0,0.0,0.0,0.0
<a href=/player/schuh104>schuh104</a>,Ham Schulte,New York Yankees,YANKS,1,1,2,3,1940,1940,0,No,0,-0.18,0.0,0.18,120,0,-120,488,0,-488,0.0,0.0,0.0,0.0,0.0,0.0
<a href=/player/schuj002>schuj002</a>,Jaime Schultz,Tampa Bay Devil Rays,RAYS,1,1,1,2,2019,2019,0,Yes,0,-0.06,0.0,0.06,8,0,-8,0,0,0,15.0,0.0,-15.0,0.0,0.0,0.0
<a href=/player/schuj101>schuj101</a>,Joe Schultz,Brooklyn Dodgers,DOGRS,1,2,1,3,1915,1919,4,No,0,-0.02,6.73,6.75,7,245,238,8,251,243,0.0,2183.0,2183.0,3500.0,0.0,-3500.0
<a href=/player/schuj103>schuj103</a>,Joe Schultz,Pittsburgh Pirates,PIRATS,1,2,1,3,1941,1948,7,No,0,0.0,-0.37,-0.37,0,16,16,0,56,56,0.0,0.0,0.0,0.0,0.0,0.0
<a href=/player/schuj106>schuj106</a>,Johnny Schulte,St. Louis Cardinals,CARDS,1,2,3,5,1927,1928,1,No,0,-1.19,0.0,1.19,135,0,-135,192,0,-192,529.0,0.0,-529.0,13300.0,0.0,-13300.0
<a href=/player/schum101>schum101</a>,Mike Schultz,Cincinnati Reds,REDS,1,1,1,2,1949,1954,5,No,0,0.0,0.01,0.01,0,12,12,0,0,0,0.0,21.0,21.0,0.0,0.0,0.0
<a href=/player/schup001>schup001</a>,Patrick Schuster,Houston Astros,ASTROS,1,1,2,3,2013,2014,1,No,0,0.0,-0.87,-0.87,0,21,21,0,0,0,0.0,81.0,81.0,0.0,0.0,0.0
<a href=/player/schur001>schur001</a>,Rick Schu,Philadelphia Phillies,PHILS,2,4,3,7,1988,1988,0,No,0,-2.46,0.71,3.17,165,85,-80,504,178,-326,0.0,49.0,49.0,395000.0,0.0,-395000.0
<a href=/player/schur101>schur101</a>,Ron Schueler,Atlanta Braves,BRAVES,4,6,8,14,1973,1984,11,No,0,24.13,-0.92,-25.05,1923,1694,-229,5515,5664,149,1329.0,128.0,-1201.0,0.0,0.0,0.0
<a href=/player/schus001>schus001</a>,Skip Schumaker,St. Louis Cardinals,CARDS,1,1,1,2,2012,2012,0,No,0,-1.21,0.0,1.21,127,0,-127,356,0,-356,6.0,0.0,-6.0,1500000.0,0.0,-1500000.0
<a href=/player/schuw101>schuw101</a>,Wes Schulmerich,Chicago Cubs,CUBS,3,9,5,14,1930,1941,11,No,0,5.24,32.0,26.76,900,1038,138,2126,2153,27,2562.0,5533.0,2971.0,3600.0,0.0,-3600.0
<a href=/player/schuw101>schuw101</a>,Wes Schulmerich,Philadelphia Phillies,PHILS,1,3,2,5,1934,1941,7,No,0,-1.11,22.67,23.78,139,911,772,269,2270,2001,324.0,2379.0,2055.0,0.0,0.0,0.0
<a href=/player/schuw101>schuw101</a>,Wes Schulmerich,Boston Braves,BRAVES,3,4,4,8,1933,1938,5,No,0,5.87,7.69,1.82,599,982,383,2168,3856,1688,0.0,0.0,0.0,0.0,0.0,0.0
<a href=/player/schuw102>schuw102</a>,Wayne Schurr,Chicago Cubs,CUBS,1,2,2,4,1966,1966,0,No,0,0.0,0.0,0.0,0,0,0,0,0,0,0.0,0.0,0.0,0.0,0.0,0.0
<a href=/player/schuw103>schuw103</a>,Walt Schulz,St. Louis Cardinals,CARDS,1,3,1,4,1921,1921,0,No,0,0.0,-0.04,-0.04,0,22,22,0,57,57,0.0,0.0,0.0,0.0,0.0,0.0
<a href=/player/schwd101>schwd101</a>,Don Schwall,Boston Red Sox,RSOX,5,6,7,13,1962,1974,12,No,0,12.31,8.2,-4.11,890,1047,157,2393,1626,-767,1125.0,3389.0,2264.0,80500.0,0.0,-80500.0
<a href=/player/schwd101>schwd101</a>,Don Schwall,Pittsburgh Pirates,PIRATS,1,1,1,2,1966,1967,1,No,0,0.04,-0.39,-0.43,24,129,105,13,46,33,138.0,474.0,336.0,0.0,0.0,0.0
<a href=/player/schwj001>schwj001</a>,Jeff Schwarz,Chicago White Sox,WSOX,1,1,1,2,1994,1994,0,No,0,0.1,-0.26,-0.36,4,11,7,0,21,21,20.0,0.0,-20.0,150000.0,0.0,-150000.0
<a href=/player/schwk001>schwk001</a>,Kyle Schwarber,Washington Nationals,NATEX,1,1,1,2,2021,2021,0,Yes,0,1.33,0.0,-1.33,41,0,-41,168,0,-168,0.0,0.0,0.0,7000000.0,0.0,-7000000.0
<a href=/player/schwm002>schwm002</a>,Michael Schwimer,Philadelphia Phillies,PHILS,1,1,1,2,2013,2013,0,Yes,0,0.0,0.0,0.0,0,0,0,0,0,0,0.0,0.0,0.0,0.0,0.0,0.0
<a href=/player/scorh101>scorh101</a>,Herb Score,Cleveland Indians,INDINS,10,17,16,33,1960,1978,18,No,0,27.0,14.62,-12.38,2306,1988,-318,5446,5961,515,3368.0,3141.0,-227.0,115500.0,0.0,-115500.0
<a href=/player/scotd001>scotd001</a>,Donnie Scott,Texas Rangers,RNGRS,2,2,2,4,1985,1987,2,No,0,-0.53,-0.41,0.12,90,46,-44,229,112,-117,0.0,0.0,0.0,0.0,0.0,0.0
<a href=/player/scotd102>scotd102</a>,Dick Scott,Los Angeles Dodgers,DOGRS,2,2,3,5,1963,1975,12,No,0,1.11,15.76,14.65,40,959,919,0,118,118,177.0,2487.0,2310.0,0.0,0.0,0.0
<a href=/player/scote101>scote101</a>,Everett Scott,Boston Red Sox,RSOX,10,21,30,51,1921,1937,16,No,0,73.06,40.4,-32.66,4195,2010,-2185,13395,5364,-8031,9458.0,7949.0,-1509.0,78550.0,0.0,-78550.0
<a href=/player/scotg001>scotg001</a>,Gary Scott,Chicago Cubs,CUBS,1,2,1,3,1992,1993,1,No,0,1.43,0.32,-1.11,423,63,-360,1012,70,-942,0.0,573.0,573.0,116000.0,0.0,-116000.0
<a href=/player/scotg001>scotg001</a>,Gary Scott,Florida Marlins,MARLNS,1,2,1,3,1993,1996,3,No,0,2.43,5.1,2.67,405,217,-188,18,182,164,808.0,1519.0,711.0,0.0,0.0,0.0
<a href=/player/scotg001>scotg001</a>,Gary Scott,Cincinnati Reds,REDS,1,1,2,3,1993,1993,0,No,0,0.0,0.0,0.0,0,0,0,0,0,0,0.0,0.0,0.0,0.0,0.0,0.0
<a href=/player/scotg102>scotg102</a>,George Scott,Boston Red Sox,RSOX,5,10,10,20,1971,1977,6,No,0,35.42,11.92,-23.5,1569,736,-833,4628,2092,-2536,3846.0,2344.0,-1502.0,155000.0,0.0,-155000.0
<a href=/player/scotg102>scotg102</a>,George Scott,Milwaukee Brewers,BREWRS,1,2,1,3,1976,1976,0,No,0,4.95,0.0,-4.95,442,0,-442,1687,0,-1687,0.0,0.0,0.0,150000.0,0.0,-150000.0
<a href=/player/scotg102>scotg102</a>,George Scott,Boston Red Sox,RSOX,1,1,1,2,1979,1981,2,No,0,0.0,0.0,0.0,44,66,22,162,172,10,0.0,0.0,0.0,200000.0,0.0,-200000.0
<a href=/player/scotj101>scotj101</a>,Jack Scott,Boston Braves,BRAVES,1,1,2,3,1922,1925,3,No,0,-0.04,0.46,0.5,2,344,342,1,722,721,3.0,1636.0,1633.0,0.0,0.0,0.0
<a href=/player/scotj101>scotj101</a>,Jack Scott,New York Giants,GIANTS,6,15,10,25,1927,1949,22,No,0,30.29,66.01,35.72,2286,3209,923,6995,11614,4619,4737.0,1177.0,-3560.0,10500.0,0.0,-10500.0
<a href=/player/scotj102>scotj102</a>,John Scott,Toronto Blue Jays,BJAYS,8,15,14,29,1977,1987,10,No,0,28.86,22.15,-6.71,2801,2757,-44,8515,8792,277,3123.0,3581.0,458.0,669000.0,0.0,-669000.0
<a href=/player/scotj102>scotj102</a>,John Scott,St. Louis Cardinals,CARDS,1,1,1,2,1978,1979,1,No,0,0.0,0.0,0.0,0,0,0,0,0,0,0.0,0.0,0.0,0.0,0.0,0.0
<a href=/player/scotl001>scotl001</a>,Luke Scott,Cleveland Indians,INDINS,2,2,2,4,2004,2004,0,No,0,3.53,-1.31,-4.84,231,10,-221,763,0,-763,0.0,42.0,42.0,0.0,0.0,0.0
<a href=/player/scotl001>scotl001</a>,Luke Scott,Houston Astros,ASTROS,1,5,1,6,2007,2009,2,No,0,11.62,3.81,-7.81,860,316,-544,1797,1340,-457,1330.0,0.0,-1330.0,382000.0,0.0,-382000.0
<a href=/player/scotm001>scotm001</a>,Mike Scott,New York Mets,METS,1,1,1,2,1982,1986,4,No,0,23.81,0.98,-22.83,527,395,-132,622,1054,432,5112.0,0.0,-5112.0,0.0,0.0,0.0
<a href=/player/scotm101>scotm101</a>,Mickey Scott,New York Yankees,YANKS,1,2,1,3,1969,1971,2,No,0,0.0,0.42,0.42,0,66,66,0,87,87,0.0,0.0,0.0,0.0,0.0,0.0
<a href=/player/scotm101>scotm101</a>,Mickey Scott,Chicago White Sox,WSOX,1,1,1,2,1970,1970,0,No,0,0.33,0.0,-0.33,31,0,-31,3,0,-3,74.0,0.0,-74.0,0.0,0.0,0.0
<a href=/player/scotm101>scotm101</a>,Mickey Scott,Montreal Expos,NATEX,1,1,1,2,1974,1975,1,No,0,0.0,0.5,0.5,0,117,117,0,13,13,0.0,301.0,301.0,0.0,0.0,0.0
<a href=/player/scotm101>scotm101</a>,Mickey Scott,Baltimore Orioles,ORLS,1,2,1,3,1974,1974,0,No,0,-0.27,-0.11,0.16,98,9,-89,0,20,20,370.0,0.0,-370.0,0.0,0.0,0.0
<a href=/player/scotm101>scotm101</a>,Mickey Scott,California Angels,ANGELS,1,1,1,2,1978,1978,0,No,0,0.0,0.0,0.0,0,0,0,0,0,0,0.0,0.0,0.0,0.0,0.0,0.0
<a href=/player/scotp101>scotp101</a>,Pete Scott,KansasCity,KansasCity,1,1,3,4,1924,1931,7,No,0,0.0,0.0,0.0,0,0,0,0,0,0,0.0,0.0,0.0,0.0,0.0,0.0
<a href=/player/scotp101>scotp101</a>,Pete Scott,Chicago Cubs,CUBS,1,2,1,3,1927,1935,8,No,0,1.8,26.3,24.5,269,949,680,1048,4196,3148,0.0,0.0,0.0,15500.0,0.0,-15500.0
<a href=/player/scotr101>scotr101</a>,Rodney Scott,Kansas City Royals,ROYALS,1,1,1,2,1975,1976,1,No,0,2.75,2.74,-0.01,421,142,-279,1741,417,-1324,0.0,0.0,0.0,0.0,0.0,0.0
<a href=/player/scotr101>scotr101</a>,Rodney Scott,Montreal Expos,NATEX,1,1,1,2,1977,1977,0,No,0,0.0,-0.31,-0.31,0,26,26,0,1,1,0.0,62.0,62.0,0.0,0.0,0.0
<a href=/player/scotr101>scotr101</a>,Rodney Scott,Texas Rangers,RNGRS,6,12,10,22,1977,1982,5,No,0,21.67,6.59,-15.08,1054,693,-361,2707,1819,-888,4329.0,810.0,-3519.0,313000.0,0.0,-313000.0
<a href=/player/scotr101>scotr101</a>,Rodney Scott,Oakland Athletics,ATLTCS,1,2,1,3,1978,1978,0,No,0,0.99,-0.55,-1.54,78,35,-43,280,0,-280,0.0,497.0,497.0,0.0,0.0,0.0
<a href=/player/scotr101>scotr101</a>,Rodney Scott,Chicago Cubs,CUBS,1,2,1,3,1978,1979,1,No,0,3.97,-0.08,-4.05,798,31,-767,2458,14,-2444,0.0,0.0,0.0,0.0,0.0,0.0
<a href=/player/scott001>scott001</a>,Tony Scott,Montreal Expos,NATEX,3,6,6,12,1976,1983,7,No,0,4.1,3.12,-0.98,573,1002,429,1861,2648,787,25.0,308.0,283.0,0.0,0.0,0.0
<a href=/player/scott001>scott001</a>,Tony Scott,St. Louis Cardinals,CARDS,4,4,6,10,1981,1992,11,No,0,19.1,11.83,-7.27,956,729,-227,2639,1319,-1320,2317.0,4643.0,2326.0,1943333.0,0.0,-1943333.0
<a href=/player/scott002>scott002</a>,Tim Scott,San Diego Padres,PADRS,1,1,1,2,1993,1994,1,No,0,3.1,-1.48,-4.58,358,143,-215,12,464,452,591.0,0.0,-591.0,125000.0,0.0,-125000.0
<a href=/player/scott002>scott002</a>,Tim Scott,Montreal Expos,NATEX,1,2,1,3,1996,1996,0,No,0,12.18,0.67,-11.51,598,24,-574,619,29,-590,4901.0,209.0,-4692.0,860000.0,0.0,-860000.0
<a href=/player/scott004>scott004</a>,Tayler Scott,Milwaukee Brewers,BREWRS,1,1,1,2,2017,2019,2,No,0,0.0,3.37,3.37,0,276,276,0,3,3,0.0,460.0,460.0,0.0,0.0,0.0
<a href=/player/scrie001>scrie001</a>,Evan Scribner,Arizona Diamondbacks,DBACKS,1,1,1,2,2008,2009,1,No,0,-0.23,-0.63,-0.4,19,74,55,0,155,155,42.0,0.0,-42.0,0.0,0.0,0.0
<a href=/player/scrie001>scrie001</a>,Evan Scribner,Oakland Athletics,ATLTCS,1,1,1,2,2015,2015,0,Yes,0,0.4,0.0,-0.4,20,0,-20,0,0,0,64.0,0.0,-64.0,512500.0,0.0,-512500.0
<a href=/player/scrua001>scrua001</a>,Andre Scrubb,Los Angeles Dodgers,DOGRS,1,1,1,2,2019,2020,1,No,0,0.89,-0.46,-1.35,38,12,-26,0,26,26,130.0,0.0,-130.0,0.0,0.0,0.0
<a href=/player/scuds001>scuds001</a>,Scott Scudder,Cincinnati Reds,REDS,3,5,4,9,1991,1999,8,No,2,-2.2,4.83,7.03,60,162,102,0,279,279,839.0,641.0,-198.0,215000.0,0.0,-215000.0
<a href=/player/scurr001>scurr001</a>,Rod Scurry,San Francisco Giants,GIANTS,1,1,1,2,1988,1990,2,No,0,0.23,1.05,0.82,39,154,115,0,266,266,94.0,0.0,-94.0,0.0,0.0,0.0
<a href=/player/scutm001>scutm001</a>,Marco Scutaro,Cleveland Indians,INDINS,3,6,5,11,2000,2007,7,No,0,13.63,7.12,-6.51,820,378,-442,2478,197,-2281,718.0,1361.0,643.0,5247000.0,0.0,-5247000.0
<a href=/player/scutm001>scutm001</a>,Marco Scutaro,Oakland Athletics,ATLTCS,2,2,3,5,2007,2012,5,No,0,9.81,-0.44,-10.25,289,11,-278,1272,2,-1270,0.0,138.0,138.0,2030000.0,0.0,-2030000.0
<a href=/player/scutm001>scutm001</a>,Marco Scutaro,Boston Red Sox,RSOX,2,2,2,4,2012,2013,1,No,0,0.05,0.75,0.7,95,66,-29,415,11,-404,0.0,217.0,217.0,504500.0,0.0,-504500.0
<a href=/player/scutm001>scutm001</a>,Marco Scutaro,Colorado Rockies,ROCKS,1,2,1,3,2012,2015,3,No,0,4.02,-1.89,-5.91,193,142,-51,828,337,-491,0.0,0.0,0.0,6000000.0,0.0,-6000000.0
<a href=/player/seabc001>seabc001</a>,Conner Seabold,Philadelphia Phillies,PHILS,1,2,2,4,2020,2020,0,No,0,3.19,-0.87,-4.06,36,25,-11,2,0,-2,504.0,67.0,-437.0,0.0,0.0,0.0
<a href=/player/seamk101>seamk101</a>,Kim Seaman,New York Mets,METS,22,47,40,87,1978,2019,41,No,4,42.77,110.13,67.36,3719,6479,2760,7583,14933,7350,8114.0,10449.0,2335.0,32500923.0,0.0,-32500923.0
<a href=/player/seamk101>seamk101</a>,Kim Seaman,St. Louis Cardinals,CARDS,12,29,23,52,1980,1998,18,No,5,83.63,121.95,38.32,6733,4994,-1739,20851,17148,-3703,6532.0,3025.0,-3507.0,1533333.0,0.0,-1533333.0
<a href=/player/seamk101>seamk101</a>,Kim Seaman,San Diego Padres,PADRS,2,2,2,4,1982,1983,1,No,0,0.0,0.01,0.01,0,16,16,0,7,7,0.0,31.0,31.0,0.0,0.0,0.0
<a href=/player/seanr001>seanr001</a>,Rudy Seanez,Cleveland Indians,INDINS,1,1,2,3,1991,1993,2,No,0,0.4,1.32,0.92,249,76,-173,3,0,-3,403.0,725.0,322.0,0.0,0.0,0.0
<a href=/player/seanr001>seanr001</a>,Rudy Seanez,Los Angeles Dodgers,DOGRS,1,1,1,2,1992,1993,1,No,0,0.0,0.37,0.37,0,132,132,0,504,504,0.0,0.0,0.0,0.0,0.0,0.0
<a href=/player/seanr001>seanr001</a>,Rudy Seanez,San Diego Padres,PADRS,2,2,2,4,2001,2002,1,No,0,0.2,0.0,-0.2,24,0,-24,0,0,0,36.0,0.0,-36.0,0.0,0.0,0.0
<a href=/player/seanr001>seanr001</a>,Rudy Seanez,Kansas City Royals,ROYALS,1,1,1,2,2004,2005,1,No,0,0.52,-0.52,-1.04,46,59,13,0,247,247,69.0,0.0,-69.0,0.0,0.0,0.0
<a href=/player/seark101>seark101</a>,Ken Sears,New York Yankees,YANKS,2,3,4,7,1946,1948,2,No,0,0.12,0.0,-0.12,13,0,-13,18,0,-18,12.0,0.0,-12.0,0.0,0.0,0.0
<a href=/player/searr001>searr001</a>,Ray Searage,St. Louis Cardinals,CARDS,1,1,1,2,1979,1980,1,No,0,0.34,0.0,-0.34,52,0,-52,1,0,-1,110.0,0.0,-110.0,0.0,0.0,0.0
<a href=/player/searr001>searr001</a>,Ray Searage,New York Mets,METS,2,2,3,5,1982,1983,1,No,0,-1.38,-0.21,1.17,103,40,-63,175,58,-117,0.0,0.0,0.0,0.0,0.0,0.0
<a href=/player/searr001>searr001</a>,Ray Searage,Milwaukee Brewers,BREWRS,1,1,2,3,1986,1986,0,No,0,1.98,0.0,-1.98,87,0,-87,0,0,0,254.0,0.0,-254.0,121500.0,0.0,-121500.0
<a href=/player/sears001>sears001</a>,Steve Searcy,Philadelphia Phillies,PHILS,1,2,1,3,1992,1992,0,No,0,0.0,1.64,1.64,0,74,74,0,313,313,0.0,0.0,0.0,175000.0,0.0,-175000.0
<a href=/player/seart001>seart001</a>,Todd Sears,Colorado Rockies,ROCKS,3,7,6,13,2000,2002,2,No,0,3.49,2.57,-0.92,364,438,74,1382,1550,168,0.0,3.0,3.0,1050000.0,0.0,-1050000.0
<a href=/player/seart001>seart001</a>,Todd Sears,Minnesota Twins,TWINS,1,1,1,2,2003,2003,0,No,0,0.04,0.0,-0.04,9,0,-9,8,0,-8,0.0,0.0,0.0,0.0,0.0,0.0
<a href=/player/seavt001>seavt001</a>,Tom Seaver,New York Mets,METS,8,14,12,26,1977,1986,9,No,0,27.43,13.87,-13.56,2407,2813,406,3829,9573,5744,5804.0,2225.0,-3579.0,395000.0,0.0,-395000.0
<a href=/player/seavt001>seavt001</a>,Tom Seaver,Cincinnati Reds,REDS,2,2,4,6,1982,1990,8,No,0,2.12,-0.96,-3.08,209,318,109,504,692,188,693.0,497.0,-196.0,450000.0,0.0,-450000.0
<a href=/player/seavt001>seavt001</a>,Tom Seaver,Chicago White Sox,WSOX,1,1,1,2,1986,1991,5,No,0,1.94,1.71,-0.23,16,498,482,0,1529,1529,313.0,6.0,-307.0,1132652.0,0.0,-1132652.0
<a href=/player/seayb001>seayb001</a>,Bobby Seay,Tampa Bay Devil Rays,RAYS,1,1,1,2,2005,2005,0,No,0,-0.31,-0.04,0.27,31,11,-20,0,24,24,35.0,0.0,-35.0,0.0,0.0,0.0
<a href=/player/sebrb001>sebrb001</a>,Bob Sebra,Texas Rangers,RNGRS,1,2,1,3,1985,1991,6,No,0,2.79,7.32,4.53,107,694,587,87,2718,2631,806.0,0.0,-806.0,0.0,0.0,0.0
<a href=/player/sebrb001>sebrb001</a>,Bob Sebra,Montreal Expos,NATEX,1,1,1,2,1988,1988,0,No,0,-0.53,0.0,0.53,18,0,-18,18,0,-18,137.0,0.0,-137.0,0.0,0.0,0.0
<a href=/player/sebrb001>sebrb001</a>,Bob Sebra,Philadelphia Phillies,PHILS,1,1,1,2,1989,1990,1,No,0,-0.48,0.0,0.48,30,0,-30,1,0,-1,63.0,0.0,-63.0,0.0,0.0,0.0
<a href=/player/sebrb001>sebrb001</a>,Bob Sebra,Cincinnati Reds,REDS,1,2,2,4,1990,1992,2,No,0,2.39,3.07,0.68,42,257,215,0,822,822,597.0,0.0,-597.0,500000.0,0.0,-500000.0
<a href=/player/sebrj101>sebrj101</a>,Jimmy Sebring,Pittsburgh Pirates,PIRATS,3,7,4,11,1904,1910,6,No,0,14.19,23.57,9.38,1717,639,-1078,6091,1726,-4365,2702.0,3643.0,941.0,0.0,0.0,0.0
<a href=/player/sebrj101>sebrj101</a>,Jimmy Sebring,Cincinnati Reds,REDS,2,4,3,7,1905,1910,5,No,0,18.64,12.54,-6.1,746,275,-471,3017,389,-2628,9.0,2982.0,2973.0,0.0,0.0,0.0
<a href=/player/secrd101>secrd101</a>,Don Secrist,Cincinnati Reds,REDS,2,3,3,6,1968,1970,2,No,0,-0.45,-1.78,-1.33,134,68,-66,227,36,-191,164.0,339.0,175.0,21500.0,0.0,-21500.0
<a href=/player/sedls001>sedls001</a>,Shawn Sedlacek,Kansas City Royals,ROYALS,1,1,1,2,2004,2005,1,No,0,0.0,0.63,0.63,0,76,76,0,0,0,0.0,194.0,194.0,0.0,0.0,0.0
<a href=/player/see-c101>see-c101</a>,Charlie See,Rochester,Rochester,1,1,1,2,1919,1919,0,No,0,-0.29,0.0,0.29,93,0,-93,221,0,-221,18.0,0.0,-18.0,0.0,0.0,0.0
<a href=/player/see-l001>see-l001</a>,Larry See,Los Angeles Dodgers,DOGRS,1,1,1,2,1987,1988,1,No,0,-0.44,0.0,0.44,13,0,-13,25,0,-25,0.0,0.0,0.0,0.0,0.0,0.0
<a href=/player/seedb101>seedb101</a>,Bob Seeds,Cleveland Indians,INDINS,2,3,3,6,1932,1938,6,No,0,-0.54,9.51,10.05,286,513,227,1117,1176,59,0.0,1369.0,1369.0,22500.0,0.0,-22500.0
<a href=/player/seedb101>seedb101</a>,Bob Seeds,Chicago White Sox,WSOX,2,7,3,10,1932,1936,4,No,0,0.81,-0.11,-0.92,234,49,-185,748,93,-655,0.0,39.0,39.0,8600.0,0.0,-8600.0
<a href=/player/seedb101>seedb101</a>,Bob Seeds,Boston Red Sox,RSOX,4,10,7,17,1934,1940,6,No,0,25.17,35.69,10.52,1726,1087,-639,6233,3303,-2930,2563.0,4057.0,1494.0,43500.0,0.0,-43500.0
<a href=/player/seedb101>seedb101</a>,Bob Seeds,Montreal,Montreal,1,1,2,3,1936,1936,0,No,0,0.31,0.0,-0.31,13,0,-13,47,0,-47,0.0,0.0,0.0,0.0,0.0,0.0
<a href=/player/seelc001>seelc001</a>,Chris Seelbach,Atlanta Braves,BRAVES,1,1,1,2,1995,1995,0,No,0,0.0,0.1,0.1,0,28,28,0,0,0,0.0,39.0,39.0,0.0,0.0,0.0
<a href=/player/seerp101>seerp101</a>,Pat Seerey,Cleveland Indians,INDINS,2,3,2,5,1948,1955,7,No,0,0.72,3.02,2.3,315,566,251,926,1749,823,633.0,0.0,-633.0,0.0,0.0,0.0
<a href=/player/segeh101>segeh101</a>,Herman Segelke,Chicago Cubs,CUBS,2,2,3,5,1982,1985,3,No,0,-0.09,-0.14,-0.05,5,32,27,0,15,15,39.0,144.0,105.0,0.0,0.0,0.0
<a href=/player/seger001>seger001</a>,Rob Segedin,New York Yankees,YANKS,1,2,2,4,2016,2016,0,No,0,-0.23,0.27,0.5,53,73,20,103,169,66,0.0,8.0,8.0,0.0,0.0,0.0
<a href=/player/segrk101>segrk101</a>,Kal Segrist,New York Yankees,YANKS,12,33,27,60,1954,1970,16,No,0,40.55,76.98,36.43,5201,4368,-833,16466,10777,-5689,3212.0,10751.0,7539.0,302500.0,0.0,-302500.0
<a href=/player/segud001>segud001</a>,David Segui,Baltimore Orioles,ORLS,1,1,2,3,1994,1994,0,No,0,-0.63,0.0,0.63,125,0,-125,467,0,-467,0.0,0.0,0.0,0.0,0.0,0.0
<a href=/player/segud001>segud001</a>,David Segui,New York Mets,METS,9,18,15,33,1995,2005,10,No,0,9.72,6.12,-3.6,1692,2076,384,3051,3138,87,2422.0,2911.0,489.0,20343890.0,0.0,-20343890.0
<a href=/player/segud001>segud001</a>,David Segui,Seattle Mariners,MARNRS,2,3,3,6,1999,2001,2,No,0,0.61,1.56,0.95,215,177,-38,234,469,235,215.0,104.0,-111.0,4350000.0,0.0,-4350000.0
<a href=/player/segud001>segud001</a>,David Segui,Toronto Blue Jays,BJAYS,2,3,2,5,2000,2002,2,No,0,5.81,2.22,-3.59,286,281,-5,1103,1097,-6,0.0,25.0,25.0,0.0,0.0,0.0
<a href=/player/segud001>segud001</a>,David Segui,Texas Rangers,RNGRS,1,1,1,2,2000,2001,1,No,0,0.96,-1.73,-2.69,57,136,79,245,512,267,0.0,0.0,0.0,4325000.0,0.0,-4325000.0
<a href=/player/segud101>segud101</a>,Diego Segui,Washington Senators,RNGRS,1,1,1,2,1966,1966,0,No,0,5.15,-0.42,-5.57,336,10,-326,126,3,-123,1453.0,43.0,-1410.0,12000.0,0.0,-12000.0
<a href=/player/segud101>segud101</a>,Diego Segui,Milwaukee Brewers,BREWRS,16,29,31,60,1969,1986,17,No,0,56.11,55.7,-0.41,3782,3364,-418,9776,9018,-758,7371.0,9266.0,1895.0,829901.0,0.0,-829901.0
<a href=/player/segud101>segud101</a>,Diego Segui,St. Louis Cardinals,CARDS,27,55,49,104,1973,1998,25,No,8,106.47,182.0,75.53,10190,9338,-852,28502,29048,546,13842.0,9162.0,-4680.0,3130333.0,0.0,-3130333.0
<a href=/player/seguf001>seguf001</a>,Fernando Seguignol,New York Yankees,YANKS,2,3,3,6,1995,2011,16,No,2,-0.58,4.06,4.64,173,123,-50,394,0,-394,0.0,375.0,375.0,0.0,0.0,0.0
<a href=/player/seguj002>seguj002</a>,Jean Segura,Anaheim Angels,ANGELS,1,3,1,4,2012,2012,0,No,0,4.26,1.47,-2.79,508,13,-495,1945,0,-1945,179.0,268.0,89.0,0.0,0.0,0.0
<a href=/player/seguj002>seguj002</a>,Jean Segura,Milwaukee Brewers,BREWRS,6,11,10,21,2016,2020,4,Yes,0,-0.37,15.97,16.34,772,552,-220,2514,1371,-1143,401.0,1885.0,1484.0,6500000.0,0.0,-6500000.0
<a href=/player/seguj002>seguj002</a>,Jean Segura,Arizona Diamondbacks,DBACKS,1,3,2,5,2016,2019,3,Yes,0,21.55,3.22,-18.33,745,61,-684,3265,58,-3207,14.0,514.0,500.0,2600000.0,0.0,-2600000.0
<a href=/player/seguj002>seguj002</a>,Jean Segura,Seattle Mariners,MARNRS,3,7,5,12,2018,2019,1,Yes,0,12.9,2.05,-10.85,683,65,-618,2542,289,-2253,142.0,0.0,-142.0,17350000.0,0.0,-17350000.0
<a href=/player/seibp001>seibp001</a>,Phil Seibel,Montreal Expos,NATEX,5,10,12,22,2002,2011,9,No,0,5.61,14.61,9.0,687,585,-102,161,612,451,1873.0,3946.0,2073.0,8655000.0,0.0,-8655000.0
<a href=/player/seibp001>seibp001</a>,Phil Seibel,Boston Red Sox,RSOX,1,1,1,2,2006,2007,1,No,0,0.0,0.55,0.55,0,29,29,0,0,0,0.0,62.0,62.0,0.0,0.0,0.0
<a href=/player/seibs101>seibs101</a>,Socks Seibold,Chicago Cubs,CUBS,1,6,1,7,1928,1932,4,No,0,4.13,16.12,11.99,1036,317,-719,2232,1321,-911,4216.0,0.0,-4216.0,13000.0,0.0,-13000.0
<a href=/player/seitk001>seitk001</a>,Kevin Seitzer,Milwaukee Brewers,BREWRS,3,8,7,15,1996,2004,8,No,0,1.87,17.53,15.66,400,1175,775,1247,3930,2683,437.0,1049.0,612.0,3900000.0,0.0,-3900000.0
<a href=/player/selbk101>selbk101</a>,Kip Selbach,Washington Senators,TWINS,1,1,1,2,1904,1904,0,No,0,4.98,-1.37,-6.35,279,95,-184,1192,397,-795,0.0,0.0,0.0,0.0,0.0,0.0
<a href=/player/selea001>selea001</a>,Aaron Sele,Boston Red Sox,RSOX,4,7,7,14,1997,2000,3,No,0,8.97,2.55,-6.42,585,374,-211,1634,946,-688,1253.0,139.0,-1114.0,5063500.0,0.0,-5063500.0
<a href=/player/selld101>selld101</a>,Dave Sells,California Angels,ANGELS,1,1,1,2,1975,1975,0,No,0,0.0,1.05,1.05,10,21,11,1,0,-1,21.0,104.0,83.0,0.0,0.0,0.0
<a href=/player/sellj001>sellj001</a>,Jeff Sellers,Boston Red Sox,RSOX,5,9,6,15,1988,1995,7,No,1,-0.55,4.69,5.24,556,458,-98,1236,872,-364,1786.0,1405.0,-381.0,506000.0,0.0,-506000.0
<a href=/player/sellj002>sellj002</a>,Justin Sellers,Oakland Athletics,ATLTCS,1,2,1,3,2009,2011,2,No,0,0.0,1.6,1.6,0,173,173,0,0,0,0.0,456.0,456.0,0.0,0.0,0.0
<a href=/player/selmd101>selmd101</a>,Dick Selma,San Diego Padres,PADRS,10,12,17,29,1969,1984,15,No,1,13.9,8.61,-5.29,735,2329,1594,715,5138,4423,4453.0,3197.0,-1256.0,59500.0,0.0,-59500.0
<a href=/player/selmd101>selmd101</a>,Dick Selma,Chicago Cubs,CUBS,2,3,3,6,1969,1974,5,No,0,1.23,0.0,-1.23,677,440,-237,1258,890,-368,797.0,392.0,-405.0,0.0,0.0,0.0
<a href=/player/selms001>selms001</a>,Sam Selman,San Francisco Giants,GIANTS,1,3,1,4,2021,2021,0,No,0,-0.36,0.65,1.01,27,52,25,0,0,0,63.0,73.0,10.0,0.0,0.0,0.0
<a href=/player/selpc101>selpc101</a>,Carey Selph,Chicago White Sox,WSOX,1,2,1,3,1932,1932,0,No,0,1.87,0.41,-1.46,283,14,-269,1288,61,-1227,0.0,0.0,0.0,5000.0,0.0,-5000.0
<a href=/player/sembc101>sembc101</a>,Carroll Sembera,Montreal Expos,NATEX,1,1,1,2,1970,1970,0,No,0,0.0,-0.22,-0.22,0,36,36,0,2,2,0.0,92.0,92.0,0.0,0.0,0.0
<a href=/player/sembc101>sembc101</a>,Carroll Sembera,St. Louis Cardinals,CARDS,2,2,2,4,1971,1975,4,No,0,0.0,-0.44,-0.44,0,35,35,0,53,53,0.0,0.0,0.0,0.0,0.0,0.0
<a href=/player/semia101>semia101</a>,Andy Seminick,Philadelphia Phillies,PHILS,3,8,7,15,1951,1957,6,No,0,12.59,16.8,4.21,922,1010,88,2813,3409,596,109.0,186.0,77.0,63000.0,0.0,-63000.0
<a href=/player/semia101>semia101</a>,Andy Seminick,Cincinnati Reds,REDS,5,10,14,24,1955,1965,10,No,0,64.57,18.03,-46.54,3586,1613,-1973,11340,3264,-8076,2563.0,1025.0,-1538.0,13500.0,0.0,-13500.0
<a href=/player/semif001>semif001</a>,Frank Seminara,San Diego Padres,PADRS,2,4,3,7,1993,2000,7,No,0,-0.42,-0.7,-0.28,28,54,26,3,11,8,67.0,168.0,101.0,326000.0,0.0,-326000.0
<a href=/player/semim001>semim001</a>,Marcus Semien,Chicago White Sox,WSOX,1,4,2,6,2014,2018,4,No,0,32.02,0.52,-31.5,1179,80,-1099,4237,2,-4235,1580.0,819.0,-761.0,500000.0,0.0,-500000.0
<a href=/player/sempr101>sempr101</a>,Ray Semproch,Philadelphia Phillies,PHILS,1,2,3,5,1959,1962,3,No,0,0.43,-1.4,-1.83,456,279,-177,1595,804,-791,81.0,0.0,-81.0,9000.0,0.0,-9000.0
<a href=/player/sempr101>sempr101</a>,Ray Semproch,Detroit Tigers,TIGRS,1,2,1,3,1960,1960,0,No,0,0.0,-0.36,-0.36,0,28,28,0,2,2,0.0,58.0,58.0,9000.0,0.0,-9000.0
<a href=/player/senes101>senes101</a>,Sonny Senerchia,St. Louis Cardinals,CARDS,16,37,31,68,1956,1972,16,No,0,46.04,61.47,15.43,4532,2723,-1809,10204,7606,-2598,7123.0,5609.0,-1514.0,32500.0,0.0,-32500.0
<a href=/player/sents101>sents101</a>,Steve Senteney,Toronto Blue Jays,BJAYS,2,2,2,4,1983,1985,2,No,0,1.28,-1.43,-2.71,359,208,-151,1182,557,-625,0.0,0.0,0.0,250000.0,0.0,-250000.0
<a href=/player/sents101>sents101</a>,Steve Senteney,New York Mets,METS,1,2,2,4,1983,1984,1,No,0,-1.75,-1.63,0.12,360,108,-252,1480,288,-1192,0.0,0.0,0.0,0.0,0.0,0.0
<a href=/player/seo-j001>seo-j001</a>,Jae Weong Seo,New York Mets,METS,1,2,2,4,2006,2009,3,No,0,-1.08,1.54,2.62,102,224,122,21,3,-18,303.0,341.0,38.0,0.0,0.0,0.0
<a href=/player/seo-j001>seo-j001</a>,Jae Weong Seo,Los Angeles Dodgers,DOGRS,1,3,3,6,2006,2007,1,No,0,1.99,-0.07,-2.06,586,130,-456,1881,113,-1768,426.0,593.0,167.0,682000.0,0.0,-682000.0
<a href=/player/seoam101>seoam101</a>,Manny Seoane,Philadelphia Phillies,PHILS,1,1,1,2,1977,1979,2,No,0,-0.09,-0.61,-0.52,14,116,102,0,282,282,25.0,0.0,-25.0,0.0,0.0,0.0
<a href=/player/serad001>serad001</a>,Dan Serafini,Chicago Cubs,CUBS,1,1,1,2,1999,1999,0,No,0,-0.23,0.0,0.23,6,0,-6,0,0,0,9.0,0.0,-9.0,200000.0,0.0,-200000.0
<a href=/player/serad001>serad001</a>,Dan Serafini,San Diego Padres,PADRS,1,1,1,2,2000,2000,0,No,0,0.75,0.0,-0.75,22,0,-22,27,0,-27,187.0,0.0,-187.0,230000.0,0.0,-230000.0
<a href=/player/serrj001>serrj001</a>,Jimmy Serrano,Montreal Expos,NATEX,1,2,1,3,2002,2002,0,No,0,1.77,-0.23,-2.0,288,13,-275,1125,14,-1111,0.0,0.0,0.0,0.0,0.0,0.0
<a href=/player/serrw001>serrw001</a>,Wascar Serrano,San Diego Padres,PADRS,5,11,10,21,2001,2011,10,No,2,32.57,7.85,-24.72,553,890,337,877,2877,2000,4718.0,843.0,-3875.0,3727500.0,0.0,-3727500.0
<a href=/player/servs001>servs001</a>,Scott Service,Cincinnati Reds,REDS,5,11,7,18,1995,2010,15,No,0,11.19,26.95,15.76,438,1436,998,728,5040,4312,2595.0,2089.0,-506.0,13266667.0,0.0,-13266667.0
<a href=/player/servs001>servs001</a>,Scott Service,Cincinnati Reds,REDS,6,8,9,17,1997,2013,16,No,0,0.95,26.14,25.19,565,1375,810,1114,3203,2089,629.0,5071.0,4442.0,600000.0,0.0,-600000.0
<a href=/player/servs002>servs002</a>,Scott Servais,Houston Astros,ASTROS,2,4,2,6,1995,1996,1,No,0,9.88,0.54,-9.34,757,136,-621,2742,446,-2296,0.0,0.0,0.0,3390000.0,0.0,-3390000.0
<a href=/player/sevea101>sevea101</a>,Al Severinsen,Baltimore Orioles,ORLS,16,38,31,69,1970,1994,24,No,3,54.62,146.79,92.17,4179,7236,3057,9813,16664,6851,14313.0,25489.0,11176.0,888833.0,0.0,-888833.0
<a href=/player/sevea101>sevea101</a>,Al Severinsen,San Diego Padres,PADRS,1,1,1,2,1972,1973,1,No,0,0.0,0.19,0.19,0,39,39,0,59,59,0.0,0.0,0.0,0.0,0.0,0.0
<a href=/player/seveh101>seveh101</a>,Hank Severeid,St.Louis Browns,ORLS,28,56,65,121,1925,1952,27,No,0,169.27,185.55,16.28,8509,11840,3331,28645,39537,10892,13765.0,19385.0,5620.0,253500.0,0.0,-253500.0
<a href=/player/sewel101>sewel101</a>,Luke Sewell,Cleveland Indians,INDINS,1,1,1,2,1933,1934,1,No,0,1.78,-0.44,-2.22,213,80,-133,769,265,-504,0.0,0.0,0.0,0.0,0.0,0.0
<a href=/player/sewel101>sewel101</a>,Luke Sewell,Washington Senators,TWINS,2,4,3,7,1935,1939,4,No,0,4.36,3.29,-1.07,361,407,46,554,735,181,2260.0,2671.0,411.0,0.0,0.0,0.0
<a href=/player/sexsr001>sexsr001</a>,Richie Sexson,Cleveland Indians,INDINS,3,6,5,11,2000,2007,7,No,0,13.63,7.12,-6.51,820,378,-442,2478,197,-2281,718.0,1361.0,643.0,5247000.0,0.0,-5247000.0
<a href=/player/sexsr001>sexsr001</a>,Richie Sexson,Milwaukee Brewers,BREWRS,7,13,15,28,2003,2012,9,No,2,37.27,23.81,-13.46,2463,1970,-493,9279,4716,-4563,883.0,6330.0,5447.0,8747000.0,0.0,-8747000.0
<a href=/player/sextc001>sextc001</a>,Chris Sexton,Cincinnati Reds,REDS,1,1,1,2,1995,1995,0,No,0,-0.24,0.0,0.24,35,0,-35,70,0,-70,0.0,0.0,0.0,0.0,0.0,0.0
<a href=/player/sextj101>sextj101</a>,Jimmy Sexton,Pittsburgh Pirates,PIRATS,1,2,1,3,1976,1981,5,No,0,3.27,4.64,1.37,297,554,257,1099,51,-1048,0.0,1061.0,1061.0,0.0,0.0,0.0
<a href=/player/sextj101>sextj101</a>,Jimmy Sexton,Seattle Mariners,MARNRS,3,8,8,16,1977,1985,8,No,0,8.99,13.22,4.23,629,827,198,837,2831,1994,2623.0,1017.0,-1606.0,175000.0,0.0,-175000.0
<a href=/player/sextj101>sextj101</a>,Jimmy Sexton,Houston Astros,ASTROS,2,2,2,4,1981,1983,2,No,0,0.56,0.0,-0.56,208,0,-208,157,0,-157,728.0,0.0,-728.0,0.0,0.0,0.0
<a href=/player/seyfg101>seyfg101</a>,Gordon Seyfried,Detroit Tigers,TIGRS,1,2,1,3,1962,1965,3,No,0,-0.2,-1.2,-1.0,38,174,136,3,601,598,79.0,0.0,-79.0,0.0,0.0,0.0
<a href=/player/shacb001>shacb001</a>,Brian Shackelford,Kansas City Royals,ROYALS,1,2,2,4,2003,2003,0,No,0,-0.36,0.0,0.36,139,0,-139,11,0,-11,223.0,0.0,-223.0,0.0,0.0,0.0
<a href=/player/shacb001>shacb001</a>,Brian Shackelford,Cincinnati Reds,REDS,1,2,3,5,2007,2007,0,No,0,0.0,0.07,0.07,0,27,27,0,68,68,0.0,0.0,0.0,0.0,0.0,0.0
<a href=/player/shack001>shack001</a>,Kevin Shackelford,Milwaukee Brewers,BREWRS,2,4,2,6,2014,2015,1,Yes,0,-0.1,-0.55,-0.45,292,98,-194,5,0,-5,440.0,141.0,-299.0,0.0,0.0,0.0
<a href=/player/shafr001>shafr001</a>,Richie Shaffer,Tampa Bay Devil Rays,RAYS,1,2,3,5,2016,2021,5,Yes,0,-0.63,1.91,2.54,100,161,61,297,1,-296,3.0,549.0,546.0,0.0,0.0,0.0
<a href=/player/shama101>shama101</a>,Art Shamsky,Cincinnati Reds,REDS,4,6,7,13,1967,1977,10,No,0,10.39,11.79,1.4,662,1337,675,1652,602,-1050,1267.0,4200.0,2933.0,0.0,0.0,0.0
<a href=/player/shama101>shama101</a>,Art Shamsky,New York Mets,METS,1,4,4,8,1971,1975,4,No,0,1.94,1.36,-0.58,244,340,96,49,280,231,763.0,880.0,117.0,0.0,0.0,0.0
<a href=/player/shanb102>shanb102</a>,Bobby Shantz,Kansas City Athletics,ATLTCS,38,80,81,161,1957,1976,19,No,0,137.3,59.64,-77.66,12943,8836,-4107,29783,24655,-5128,18720.0,9434.0,-9286.0,506100.0,0.0,-506100.0
<a href=/player/shanb102>shanb102</a>,Bobby Shantz,Washington Senators,RNGRS,2,2,4,6,1960,1963,3,No,0,2.02,0.52,-1.5,88,185,97,21,629,608,268.0,0.0,-268.0,0.0,0.0,0.0
<a href=/player/shanb102>shanb102</a>,Bobby Shantz,Houston Astros,ASTROS,10,15,16,31,1962,1978,16,No,0,37.76,14.84,-22.92,2088,2514,426,2358,8171,5813,10498.0,2643.0,-7855.0,0.0,0.0,0.0
<a href=/player/shanb102>shanb102</a>,Bobby Shantz,St. Louis Cardinals,CARDS,1,3,3,6,1964,1965,1,No,0,-0.83,5.23,6.06,340,107,-233,612,464,-148,674.0,9.0,-665.0,0.0,0.0,0.0
<a href=/player/shanh101>shanh101</a>,Howie Shanks,Washington Senators,TWINS,1,3,2,5,1923,1930,7,No,0,1.13,22.03,20.9,449,1009,560,1547,3473,1926,0.0,543.0,543.0,0.0,0.0,0.0
<a href=/player/shanh101>shanh101</a>,Howie Shanks,Boston Red Sox,RSOX,3,4,3,7,1924,1925,1,No,0,-0.22,2.0,2.22,78,119,41,206,474,268,0.0,0.0,0.0,10750.0,0.0,-10750.0
<a href=/player/shanr101>shanr101</a>,Red Shannon,Philadelphia Athletics,ATLTCS,1,2,2,4,1919,1920,1,No,0,0.98,0.04,-0.94,143,118,-25,582,462,-120,0.0,0.0,0.0,2400.0,0.0,-2400.0
<a href=/player/shanr101>shanr101</a>,Red Shannon,Boston Red Sox,RSOX,12,23,27,50,1919,1937,18,No,0,88.36,56.94,-31.42,3577,3010,-567,9223,10199,976,11819.0,5427.0,-6392.0,73300.0,0.0,-73300.0
<a href=/player/shanr101>shanr101</a>,Red Shannon,Louisville,Louisville,1,1,2,3,1925,1925,0,No,0,0.69,0.0,-0.69,19,0,-19,60,0,-60,0.0,0.0,0.0,0.0,0.0,0.0
<a href=/player/shanr101>shanr101</a>,Red Shannon,Chicago Cubs,CUBS,2,4,3,7,1926,1934,8,No,0,0.0,24.0,24.0,0,988,988,0,3984,3984,0.0,0.0,0.0,12967.0,0.0,-12967.0
<a href=/player/shanr101>shanr101</a>,Red Shannon,Baltimore,Baltimore,1,2,5,7,1917,1920,3,No,0,0.91,0.0,-0.91,304,0,-304,1098,0,-1098,1.0,0.0,-1.0,0.0,0.0,0.0
<a href=/player/shans101>shans101</a>,Spike Shannon,St. Louis Cardinals,CARDS,1,1,2,3,1906,1908,2,No,0,1.14,0.72,-0.42,308,182,-126,1333,648,-685,0.0,0.0,0.0,0.0,0.0,0.0
<a href=/player/shanw101>shanw101</a>,Wally Shannon,St. Louis Cardinals,CARDS,2,7,3,10,1960,1963,3,No,0,1.56,-0.35,-1.91,364,164,-200,1157,310,-847,0.0,0.0,0.0,0.0,0.0,0.0
<a href=/player/sharb101>sharb101</a>,Bud Sharpe,Pittsburgh Pirates,PIRATS,1,2,1,3,1910,1910,0,No,0,-1.88,1.0,2.88,213,60,-153,568,54,-514,814.0,458.0,-356.0,0.0,0.0,0.0
<a href=/player/sharb102>sharb102</a>,Bill Sharp,Chicago White Sox,WSOX,1,1,1,2,1975,1978,3,No,0,0.72,-0.16,-0.88,203,81,-122,602,220,-382,0.0,0.0,0.0,0.0,0.0,0.0
<a href=/player/shard101>shard101</a>,Dick Sharon,Pittsburgh Pirates,PIRATS,5,5,6,11,1972,1983,11,No,0,-0.03,6.98,7.01,282,851,569,628,2739,2111,92.0,4.0,-88.0,0.0,0.0,0.0
<a href=/player/shard101>shard101</a>,Dick Sharon,Detroit Tigers,TIGRS,1,3,1,4,1974,1975,1,No,0,-0.19,-1.37,-1.18,91,45,-46,191,173,-18,0.0,0.0,0.0,79000.0,0.0,-79000.0
<a href=/player/shard101>shard101</a>,Dick Sharon,San Diego Padres,PADRS,1,1,1,2,1975,1977,2,No,0,0.0,1.7,1.7,0,141,141,0,522,522,0.0,0.0,0.0,0.0,0.0,0.0
<a href=/player/shard101>shard101</a>,Dick Sharon,St. Louis Cardinals,CARDS,1,1,1,2,1976,1976,0,No,0,0.0,0.0,0.0,0,0,0,0,0,0,0.0,0.0,0.0,0.0,0.0,0.0
<a href=/player/shard101>shard101</a>,Dick Sharon,California Angels,ANGELS,2,4,2,6,1976,1979,3,No,0,0.01,3.49,3.48,36,153,117,0,0,0,119.0,938.0,819.0,0.0,0.0,0.0
<a href=/player/sharj101>sharj101</a>,Jack Sharrott,New York Giants,GIANTS,1,3,1,4,1893,1894,1,No,0,-1.18,4.81,5.99,549,157,-392,2414,700,-1714,168.0,0.0,-168.0,0.0,0.0,0.0
<a href=/player/sharm001>sharm001</a>,Mike Sharperson,Toronto Blue Jays,BJAYS,2,2,3,5,1987,2000,13,No,0,8.72,20.44,11.72,552,205,-347,1277,2,-1275,566.0,3678.0,3112.0,5000000.0,0.0,-5000000.0
<a href=/player/shaus101>shaus101</a>,Shag Shaughnessy,Philadelphia Athletics,ATLTCS,1,1,1,2,1908,1916,8,No,0,0.0,42.2,42.2,0,899,899,0,3853,3853,0.0,0.0,0.0,0.0,0.0,0.0
<a href=/player/shawa101>shawa101</a>,Al Shaw,Boston Red Sox,RSOX,1,1,1,2,1908,1908,0,No,0,-0.98,0.34,1.32,32,19,-13,53,50,-3,0.0,0.0,0.0,0.0,0.0,0.0
<a href=/player/shawb001>shawb001</a>,Bryan Shaw,Arizona Diamondbacks,DBACKS,3,6,6,12,2012,2021,9,No,0,44.83,10.87,-33.96,1441,607,-834,2691,1018,-1673,5272.0,2512.0,-2760.0,11602833.0,0.0,-11602833.0
<a href=/player/shawb103>shawb103</a>,Bob Shaw,Detroit Tigers,TIGRS,2,3,3,6,1958,1959,1,No,0,16.44,-3.06,-19.5,1173,107,-1066,3797,151,-3646,1676.0,92.0,-1584.0,32000.0,0.0,-32000.0
<a href=/player/shawb103>shawb103</a>,Bob Shaw,Chicago White Sox,WSOX,11,17,21,38,1961,1969,8,No,0,15.81,27.33,11.52,1761,2250,489,3197,3489,292,3384.0,5251.0,1867.0,77750.0,0.0,-77750.0
<a href=/player/shawb103>shawb103</a>,Bob Shaw,Kansas City Athletics,ATLTCS,14,29,24,53,1961,1976,15,No,0,53.0,28.85,-24.15,5847,3256,-2591,13868,9788,-4080,6333.0,2140.0,-4193.0,393100.0,0.0,-393100.0
<a href=/player/shawb103>shawb103</a>,Bob Shaw,Milwaukee Braves,BRAVES,10,14,18,32,1963,1973,10,No,0,11.77,26.43,14.66,1218,1711,493,2811,4870,2059,2257.0,2054.0,-203.0,95000.0,0.0,-95000.0
<a href=/player/shawd102>shawd102</a>,Don Shaw,St. Louis Cardinals,CARDS,4,5,4,9,1972,1974,2,No,0,-2.02,-0.41,1.61,103,140,37,163,256,93,16.0,34.0,18.0,22000.0,0.0,-22000.0
<a href=/player/shawd102>shawd102</a>,Don Shaw,Oakland Athletics,ATLTCS,1,1,1,2,1973,1974,1,No,0,0.0,0.11,0.11,0,24,24,0,26,26,0.0,0.0,0.0,0.0,0.0,0.0
<a href=/player/shawj001>shawj001</a>,Jeff Shaw,Kansas City Royals,ROYALS,1,2,2,4,1992,1993,1,No,0,1.07,-0.36,-1.43,511,17,-494,265,0,-265,676.0,275.0,-401.0,0.0,0.0,0.0
<a href=/player/shawj001>shawj001</a>,Jeff Shaw,Montreal Expos,NATEX,1,1,1,2,1995,1995,0,No,0,-0.11,-0.11,0.0,9,14,5,0,2,2,29.0,25.0,-4.0,325000.0,0.0,-325000.0
<a href=/player/shawj001>shawj001</a>,Jeff Shaw,Cincinnati Reds,REDS,5,10,8,18,1998,2013,15,No,0,52.05,23.9,-28.15,3513,2196,-1317,11936,4753,-7183,1208.0,1995.0,787.0,12757695.0,0.0,-12757695.0
<a href=/player/shawt001>shawt001</a>,Travis Shaw,Boston Red Sox,RSOX,1,4,1,5,2016,2019,3,No,0,5.97,-0.24,-6.21,440,43,-397,1667,0,-1667,0.0,128.0,128.0,515000.0,0.0,-515000.0
<a href=/player/shead101>shead101</a>,Dave Shean,Philadelphia Phillies,PHILS,13,27,30,57,1909,1931,22,No,0,110.35,96.74,-13.61,5407,5417,10,17248,19665,2417,13600.0,6282.0,-7318.0,25000.0,0.0,-25000.0
<a href=/player/shead101>shead101</a>,Dave Shean,Boston Braves,BRAVES,1,1,2,3,1911,1912,1,No,0,-0.64,-1.23,-0.59,54,195,141,160,626,466,0.0,292.0,292.0,0.0,0.0,0.0
<a href=/player/shead101>shead101</a>,Dave Shean,Cincinnati Reds,REDS,1,1,1,2,1918,1918,0,No,0,1.46,0.0,-1.46,144,0,-144,614,0,-614,0.0,0.0,0.0,0.0,0.0,0.0
<a href=/player/sheam102>sheam102</a>,Merv Shea,Louisville,Louisville,1,1,2,3,1933,1933,0,No,0,-0.26,0.0,0.26,16,0,-16,60,0,-60,0.0,0.0,0.0,0.0,0.0,0.0
<a href=/player/sheam102>sheam102</a>,Merv Shea,Boston Red Sox,RSOX,8,14,12,26,1933,1943,10,No,0,54.55,37.24,-17.31,2815,1980,-835,9804,5762,-4042,4236.0,5439.0,1203.0,60350.0,0.0,-60350.0
<a href=/player/sheam102>sheam102</a>,Merv Shea,St.Louis Browns,ORLS,1,1,1,2,1933,1935,2,No,0,-1.6,0.15,1.75,147,68,-79,473,201,-272,0.0,0.0,0.0,0.0,0.0,0.0
<a href=/player/shear001>shear001</a>,Ryan Shealy,Colorado Rockies,ROCKS,2,3,3,6,2006,2007,1,No,0,0.87,-0.8,-1.67,160,227,67,478,3,-475,128.0,305.0,177.0,662000.0,0.0,-662000.0
<a href=/player/shear101>shear101</a>,Ray Shearer,Brooklyn Dodgers,DOGRS,1,1,1,2,1956,1956,0,No,0,0.03,0.0,-0.03,2,0,-2,3,0,-3,0.0,0.0,0.0,0.0,0.0,0.0
<a href=/player/sheas101>sheas101</a>,Spec Shea,New York Yankees,YANKS,7,19,15,34,1952,1970,18,No,0,13.22,40.85,27.63,2406,2911,505,6464,7208,744,3937.0,4978.0,1041.0,115500.0,0.0,-115500.0
<a href=/player/shecj101>shecj101</a>,Jimmy Sheckard,Brooklyn Dodgers,DOGRS,1,1,5,6,1905,1907,2,No,0,19.07,1.04,-18.03,1001,116,-885,4393,448,-3945,0.0,0.0,0.0,0.0,0.0,0.0
<a href=/player/sheea001>sheea001</a>,Andy Sheets,Tampa Bay Devil Rays,RAYS,1,2,1,3,1997,2002,5,No,0,1.57,0.35,-1.22,275,471,196,252,1802,1550,559.0,0.0,-559.0,0.0,0.0,0.0
<a href=/player/sheea001>sheea001</a>,Andy Sheets,San Diego Padres,PADRS,3,4,5,9,1999,2006,7,No,1,-1.99,17.0,18.99,162,874,712,576,3363,2787,0.0,547.0,547.0,9625000.0,0.0,-9625000.0
<a href=/player/sheeb101>sheeb101</a>,Bud Sheely,Seattle,Seattle,1,1,1,2,1951,1951,0,No,0,-1.14,0.0,1.14,101,0,-101,244,0,-244,0.0,0.0,0.0,0.0,0.0,0.0
<a href=/player/sheel001>sheel001</a>,Larry Sheets,Baltimore Orioles,ORLS,1,1,1,2,1990,1990,0,No,0,-1.02,0.0,1.02,131,0,-131,390,0,-390,0.0,0.0,0.0,0.0,0.0,0.0
<a href=/player/sheet102>sheet102</a>,Tom Sheehan,Cincinnati Reds,REDS,2,3,2,5,1925,1925,0,No,0,0.78,0.21,-0.57,65,51,-14,32,164,132,283.0,0.0,-283.0,0.0,0.0,0.0
<a href=/player/shefg001>shefg001</a>,Gary Sheffield,Milwaukee Brewers,BREWRS,14,28,32,60,1992,2012,20,No,2,73.34,65.99,-7.35,4315,5311,996,13697,11972,-1725,3271.0,12033.0,8762.0,18537000.0,0.0,-18537000.0
<a href=/player/shefg001>shefg001</a>,Gary Sheffield,San Diego Padres,PADRS,2,3,4,7,1993,2008,15,No,0,13.46,26.09,12.63,630,1877,1247,2360,48,-2312,138.0,3132.0,2994.0,3375000.0,0.0,-3375000.0
<a href=/player/shefg001>shefg001</a>,Gary Sheffield,Florida Marlins,MARLNS,15,33,38,71,1998,2019,21,Yes,0,116.45,94.42,-22.03,4698,5470,772,15425,16217,792,10496.0,10160.0,-336.0,68580667.0,0.0,-68580667.0
<a href=/player/shefg001>shefg001</a>,Gary Sheffield,Los Angeles Dodgers,DOGRS,5,10,8,18,2002,2017,15,No,0,17.25,38.29,21.04,819,2208,1389,2735,7440,4705,688.0,2385.0,1697.0,11580000.0,0.0,-11580000.0
<a href=/player/shefg001>shefg001</a>,Gary Sheffield,New York Yankees,YANKS,1,1,3,4,2006,2012,6,No,0,2.79,-0.32,-3.11,247,6,-241,1075,0,-1075,0.0,19.0,19.0,10756171.0,0.0,-10756171.0
<a href=/player/shefj001>shefj001</a>,Justus Sheffield,Cleveland Indians,INDINS,1,4,1,5,2016,2018,2,No,0,0.85,4.57,3.72,262,129,-133,807,2,-805,102.0,377.0,275.0,0.0,0.0,0.0
<a href=/player/shefj001>shefj001</a>,Justus Sheffield,New York Yankees,YANKS,1,3,1,4,2018,2020,2,No,0,-1.57,1.84,3.41,118,37,-81,6,8,2,818.0,513.0,-305.0,0.0,0.0,0.0
<a href=/player/shelc001>shelc001</a>,Chris Shelton,Detroit Tigers,TIGRS,1,1,1,2,2007,2008,1,No,0,0.38,0.0,-0.38,41,0,-41,117,0,-117,0.0,0.0,0.0,0.0,0.0,0.0
<a href=/player/shelj001>shelj001</a>,John Shelby,Baltimore Orioles,ORLS,2,3,2,5,1987,1988,1,No,1,3.02,0.79,-2.23,473,97,-376,1461,0,-1461,135.0,334.0,199.0,300000.0,0.0,-300000.0
<a href=/player/shelj101>shelj101</a>,Jim Shellenback,Pittsburgh Pirates,PIRATS,1,1,1,2,1969,1969,0,No,0,0.92,0.0,-0.92,276,0,-276,106,0,-106,1216.0,0.0,-1216.0,8500.0,0.0,-8500.0
<a href=/player/shelr101>shelr101</a>,Rollie Sheldon,New York Yankees,YANKS,2,3,2,5,1965,1967,2,No,0,0.45,-0.46,-0.91,144,131,-13,217,298,81,767.0,0.0,-767.0,35500.0,0.0,-35500.0
<a href=/player/shelr101>shelr101</a>,Rollie Sheldon,Kansas City Athletics,ATLTCS,10,23,15,38,1966,1976,10,No,0,27.1,17.67,-9.43,4296,1831,-2465,8999,4813,-4186,5181.0,1373.0,-3808.0,355600.0,0.0,-355600.0
<a href=/player/shelr101>shelr101</a>,Rollie Sheldon,Boston Red Sox,RSOX,1,3,1,4,1966,1966,0,No,0,0.0,0.6,0.6,0,12,12,0,10,10,0.0,93.0,93.0,18500.0,0.0,-18500.0
<a href=/player/shems101>shems101</a>,Steve Shemo,Boston Braves,BRAVES,1,2,1,3,1945,1949,4,No,0,0.0,3.35,3.35,0,154,154,0,133,133,0.0,1068.0,1068.0,0.0,0.0,0.0
<a href=/player/shepk001>shepk001</a>,Keith Shepherd,Chicago White Sox,WSOX,1,1,1,2,1992,1992,0,No,0,0.02,0.16,0.14,24,40,16,0,131,131,66.0,0.0,-66.0,0.0,0.0,0.0
<a href=/player/shepk001>shepk001</a>,Keith Shepherd,Colorado Rockies,ROCKS,1,1,1,2,1994,1994,0,No,0,-0.3,0.0,0.3,2,0,-2,0,0,0,3.0,0.0,-3.0,0.0,0.0,0.0
<a href=/player/sherb101>sherb101</a>,Bill Sherdel,St. Louis Cardinals,CARDS,3,4,5,9,1930,1932,2,No,0,17.17,7.22,-9.95,980,103,-877,1735,151,-1584,4684.0,1094.0,-3590.0,38000.0,0.0,-38000.0
<a href=/player/shere101>shere101</a>,Ed Sherling,Philadelphia Athletics,ATLTCS,3,9,5,14,1924,1935,11,No,0,15.67,38.22,22.55,391,1328,937,1453,5363,3910,735.0,0.0,-735.0,39667.0,0.0,-39667.0
<a href=/player/sherg001>sherg001</a>,George Sherrill,Seattle Mariners,MARNRS,4,9,5,14,2008,2013,5,No,0,43.53,3.71,-39.82,1975,169,-1806,6859,413,-6446,3908.0,766.0,-3142.0,1000000.0,0.0,-1000000.0
<a href=/player/sherg001>sherg001</a>,George Sherrill,Baltimore Orioles,ORLS,2,2,3,5,2009,2014,5,No,0,0.22,-0.73,-0.95,208,80,-128,57,226,169,192.0,4.0,-188.0,2750000.0,0.0,-2750000.0
<a href=/player/sherl101>sherl101</a>,Larry Sherry,Los Angeles Dodgers,DOGRS,3,4,6,10,1964,1979,15,No,0,17.69,25.85,8.16,1084,1813,729,2900,6019,3119,751.0,0.0,-751.0,0.0,0.0,0.0
<a href=/player/sherl101>sherl101</a>,Larry Sherry,Detroit Tigers,TIGRS,1,1,1,2,1967,1967,0,No,0,-0.89,-0.12,0.77,58,25,-33,5,56,51,122.0,0.0,-122.0,29000.0,0.0,-29000.0
<a href=/player/shern101>shern101</a>,Neill Sheridan,SanFrancisco,SanFrancisco,1,1,3,4,1947,1949,2,No,0,0.0,0.0,0.0,2,0,-2,1,0,-1,0.0,0.0,0.0,0.0,0.0,0.0
<a href=/player/sherp001>sherp001</a>,Pat Sheridan,Detroit Tigers,TIGRS,2,2,2,4,1989,1990,1,No,0,1.14,-1.31,-2.45,174,148,-26,464,429,-35,0.0,0.0,0.0,805000.0,0.0,-805000.0
<a href=/player/sherr102>sherr102</a>,Roy Sherid,New York Yankees,YANKS,1,5,2,7,1931,1947,16,No,0,0.0,15.3,15.3,0,992,992,0,1098,1098,0.0,2971.0,2971.0,19500.0,0.0,-19500.0
<a href=/player/sherv101>sherv101</a>,Vince Sherlock,Indianapolis,Indianapolis,1,2,3,5,1935,1936,1,No,0,2.11,0.0,-2.11,313,0,-313,1102,0,-1102,0.0,0.0,0.0,0.0,0.0,0.0
<a href=/player/shetb101>shetb101</a>,Barry Shetrone,Baltimore Orioles,ORLS,1,3,2,5,1962,1967,5,No,0,0.29,3.01,2.72,74,349,275,211,975,764,63.0,22.0,-41.0,7000.0,0.0,-7000.0
<a href=/player/shiec101>shiec101</a>,Charlie Shields,Altoona,Altoona,1,1,1,2,1907,1907,0,No,0,-0.73,0.0,0.73,6,0,-6,2,0,-2,20.0,0.0,-20.0,0.0,0.0,0.0
<a href=/player/shiej001>shiej001</a>,Jason Shiell,Atlanta Braves,BRAVES,1,3,3,6,1999,2001,2,No,0,15.79,3.54,-12.25,961,377,-584,3858,1296,-2562,4.0,0.0,-4.0,7650000.0,0.0,-7650000.0
<a href=/player/shiej002>shiej002</a>,James Shields,Tampa Bay Devil Rays,RAYS,8,14,20,34,2012,2020,8,Yes,0,32.69,16.85,-15.84,1967,1086,-881,5025,2972,-2053,4433.0,3274.0,-1159.0,15365300.0,0.0,-15365300.0
<a href=/player/shiej002>shiej002</a>,James Shields,San Diego Padres,PADRS,1,2,2,4,2016,2018,2,Yes,0,0.14,-0.69,-0.83,82,7,-75,11,5,-6,1308.0,59.0,-1249.0,0.0,0.0,0.0
<a href=/player/shies001>shies001</a>,Steve Shields,Atlanta Braves,BRAVES,1,1,1,2,1986,1987,1,No,0,0.23,-0.34,-0.57,3,11,8,0,19,19,26.0,0.0,-26.0,0.0,0.0,0.0
<a href=/player/shies001>shies001</a>,Steve Shields,Kansas City Royals,ROYALS,4,8,7,15,1986,1994,8,No,2,22.08,13.31,-8.77,1163,870,-293,1083,3196,2113,6286.0,300.0,-5986.0,1438000.0,0.0,-1438000.0
<a href=/player/shies001>shies001</a>,Steve Shields,New York Yankees,YANKS,1,1,1,2,1989,1989,0,No,0,-0.69,0.0,0.69,11,0,-11,0,0,0,52.0,0.0,-52.0,0.0,0.0,0.0
<a href=/player/shiet001>shiet001</a>,Tommy Shields,Pittsburgh Pirates,PIRATS,1,1,1,2,1991,1991,0,No,0,0.0,0.0,0.0,2,0,-2,0,0,0,0.0,0.0,0.0,0.0,0.0,0.0
<a href=/player/shilj101>shilj101</a>,Jim Shilling,Philadelphia Phillies,PHILS,1,2,1,3,1940,1943,3,No,0,0.0,0.0,0.0,0,1,1,0,1,1,0.0,0.0,0.0,0.0,0.0,0.0
<a href=/player/shinb101>shinb101</a>,Billy Shindle,Baltimore Orioles,BLN,1,2,2,4,1894,1899,5,No,0,9.18,29.72,20.54,830,772,-58,3686,3764,78,0.0,0.0,0.0,0.0,0.0,0.0
<a href=/player/shing101>shing101</a>,Ginger Shinault,Cleveland Indians,INDINS,1,5,1,6,1922,1935,13,No,0,0.0,5.93,5.93,0,850,850,0,2604,2604,0.0,0.0,0.0,0.0,0.0,0.0
<a href=/player/shinr101>shinr101</a>,Ralph Shinners,Indianapolis,Indianapolis,2,2,7,9,1921,1924,3,No,0,2.5,0.0,-2.5,356,0,-356,1321,0,-1321,0.0,0.0,0.0,0.0,0.0,0.0
<a href=/player/shint001>shint001</a>,Tsuyoshi Shinjo,New York Mets,METS,2,4,5,9,2001,2003,2,No,0,1.23,0.97,-0.26,130,205,75,408,385,-23,84.0,416.0,332.0,7175000.0,0.0,-7175000.0
<a href=/player/shinz001>shinz001</a>,Zak Shinall,Los Angeles Dodgers,DOGRS,1,1,1,2,1992,1992,0,No,0,0.0,0.0,0.0,0,0,0,0,0,0,0.0,0.0,0.0,0.0,0.0,0.0
<a href=/player/shipc001>shipc001</a>,Craig Shipley,Los Angeles Dodgers,DOGRS,1,1,1,2,1988,1988,0,No,0,0.03,0.0,-0.03,4,0,-4,7,0,-7,0.0,0.0,0.0,0.0,0.0,0.0
<a href=/player/shipc001>shipc001</a>,Craig Shipley,San Diego Padres,PADRS,16,32,32,64,1994,2010,16,No,6,18.63,52.35,33.72,3699,4432,733,12670,15324,2654,1244.0,1789.0,545.0,25389800.0,0.0,-25389800.0
<a href=/player/shipc001>shipc001</a>,Craig Shipley,St. Louis Cardinals,CARDS,1,1,1,2,1998,1998,0,No,0,0.19,0.0,-0.19,77,0,-77,162,0,-162,0.0,0.0,0.0,0.0,0.0,0.0
<a href=/player/shipd001>shipd001</a>,Dave Shipanoff,Toronto Blue Jays,BJAYS,2,4,2,6,1985,1985,0,No,0,1.41,-1.31,-2.72,202,123,-79,317,361,44,109.0,0.0,-109.0,185000.0,0.0,-185000.0
<a href=/player/shipj101>shipj101</a>,Joe Shipley,St. Louis Cardinals,CARDS,1,1,1,2,1962,1962,0,No,0,-0.46,0.0,0.46,6,0,-6,2,0,-2,14.0,0.0,-14.0,0.0,0.0,0.0
<a href=/player/shira101>shira101</a>,Art Shires,Chicago White Sox,WSOX,4,9,7,16,1930,1935,5,No,0,3.83,5.44,1.61,940,520,-420,3521,1378,-2143,0.0,1149.0,1149.0,41500.0,0.0,-41500.0
<a href=/player/shira101>shira101</a>,Art Shires,Milwaukee,Milwaukee,1,1,2,3,1931,1931,0,No,0,-0.39,0.0,0.39,82,0,-82,328,0,-328,0.0,0.0,0.0,0.0,0.0,0.0
<a href=/player/shirb001>shirb001</a>,Bob Shirley,San Diego Padres,PADRS,12,21,25,46,1980,1993,13,No,1,78.65,50.21,-28.44,3246,4423,1177,10088,11380,1292,4862.0,3507.0,-1355.0,3006667.0,0.0,-3006667.0
<a href=/player/shirb001>shirb001</a>,Bob Shirley,St. Louis Cardinals,CARDS,2,2,3,5,1982,1987,5,No,0,1.5,0.49,-1.01,82,382,300,48,668,620,458.0,170.0,-288.0,0.0,0.0,0.0
<a href=/player/shirm101>shirm101</a>,Mule Shirley,Washington Senators,TWINS,1,1,1,2,1926,1926,0,No,0,0.0,0.0,0.0,0,0,0,0,0,0,0.0,0.0,0.0,0.0,0.0,0.0
<a href=/player/shivi101>shivi101</a>,Ivey Shiver,Cincinnati Reds,REDS,1,3,1,4,1934,1936,2,No,0,0.0,1.84,1.84,0,131,131,0,110,110,0.0,910.0,910.0,3000.0,0.0,-3000.0
<a href=/player/shocc101>shocc101</a>,Costen Shockley,Philadelphia Phillies,PHILS,1,2,1,3,1964,1966,2,No,0,4.55,-0.7,-5.25,450,79,-371,427,37,-390,3416.0,375.0,-3041.0,5400.0,0.0,-5400.0
<a href=/player/shocg101>shocg101</a>,George Shoch,Brooklyn Dodgers,DOGRS,1,2,1,3,1897,1901,4,No,0,0.0,0.58,0.58,0,134,134,0,554,554,0.0,0.0,0.0,0.0,0.0,0.0
<a href=/player/shocu101>shocu101</a>,Urban Shocker,New York Yankees,YANKS,5,14,12,26,1918,1931,13,No,0,64.97,61.9,-3.07,2396,2093,-303,7435,5797,-1638,6303.0,6917.0,614.0,44500.0,0.0,-44500.0
<a href=/player/shocu101>shocu101</a>,Urban Shocker,St.Louis Browns,ORLS,29,55,62,117,1924,1952,28,No,0,167.19,143.12,-24.07,7712,11236,3524,22879,31279,8400,20858.0,30694.0,9836.0,281100.0,0.0,-281100.0
<a href=/player/shofm101>shofm101</a>,Milt Shoffner,Cincinnati Reds,REDS,1,1,1,2,1940,1940,0,No,0,0.0,0.0,0.0,0,0,0,0,0,0,0.0,0.0,0.0,5000.0,0.0,-5000.0
<a href=/player/shofs101>shofs101</a>,Strick Shofner,Boston Red Sox,RSOX,1,3,1,4,1947,1947,0,No,0,0.0,0.0,0.0,0,0,0,0,0,0,0.0,0.0,0.0,6000.0,0.0,-6000.0
<a href=/player/shopk001>shopk001</a>,Kelly Shoppach,Boston Red Sox,RSOX,6,12,8,20,2006,2011,5,No,0,15.42,8.9,-6.52,1619,794,-825,3010,1778,-1232,1235.0,750.0,-485.0,8391733.0,0.0,-8391733.0
<a href=/player/shopk001>shopk001</a>,Kelly Shoppach,Cleveland Indians,INDINS,1,1,1,2,2009,2011,2,No,0,0.87,-0.03,-0.9,150,44,-106,440,8,-432,0.0,669.0,669.0,1950000.0,0.0,-1950000.0
<a href=/player/shopk001>shopk001</a>,Kelly Shoppach,Boston Red Sox,RSOX,1,1,1,2,2012,2013,1,No,0,0.1,0.03,-0.07,28,14,-14,87,0,-87,0.0,53.0,53.0,1135000.0,0.0,-1135000.0
<a href=/player/shorb102>shorb102</a>,Bill Shores,Portland,Portland,1,1,2,3,1932,1933,1,No,0,-0.01,0.0,0.01,16,0,-16,12,0,-12,110.0,0.0,-110.0,0.0,0.0,0.0
<a href=/player/shorb102>shorb102</a>,Bill Shores,Chicago White Sox,WSOX,4,9,4,13,1936,1950,14,No,0,-0.26,3.15,3.41,394,894,500,1460,3508,2048,0.0,0.0,0.0,20900.0,0.0,-20900.0
<a href=/player/shorc101>shorc101</a>,Chick Shorten,Boston Red Sox,RSOX,1,3,1,4,1919,1919,0,No,0,4.45,1.63,-2.82,567,133,-434,1739,583,-1156,282.0,0.0,-282.0,0.0,0.0,0.0
<a href=/player/shore101>shore101</a>,Ernie Shore,New York Yankees,YANKS,1,2,1,3,1912,1912,0,No,0,0.0,0.0,0.0,0,0,0,0,0,0,0.0,0.0,0.0,0.0,0.0,0.0
<a href=/player/shore101>shore101</a>,Ernie Shore,Boston Red Sox,RSOX,4,11,11,22,1918,1925,7,No,0,12.28,-1.18,-13.46,1743,839,-904,6150,3067,-3083,700.0,265.0,-435.0,3300.0,0.0,-3300.0
<a href=/player/shore101>shore101</a>,Ernie Shore,New York Yankees,YANKS,3,12,4,16,1921,1928,7,No,0,-3.56,9.03,12.59,367,917,550,1242,3654,2412,159.0,0.0,-159.0,15750.0,0.0,-15750.0
<a href=/player/shorr001>shorr001</a>,Rick Short,Kansas City Royals,ROYALS,1,1,1,2,2004,2004,0,No,0,0.32,0.0,-0.32,11,0,-11,17,0,-17,0.0,0.0,0.0,0.0,0.0,0.0
<a href=/player/shorz001>shorz001</a>,Zack Short,Chicago Cubs,CUBS,1,1,1,2,2020,2021,1,No,0,-0.48,-0.02,0.46,61,18,-43,184,56,-128,0.0,0.0,0.0,0.0,0.0,0.0
<a href=/player/shotb101>shotb101</a>,Burt Shotton,St.Louis Browns,ORLS,1,2,2,4,1917,1920,3,No,0,3.97,0.15,-3.82,243,110,-133,1072,129,-943,0.0,1048.0,1048.0,9000.0,0.0,-9000.0
<a href=/player/shoub001>shoub001</a>,Brian Shouse,Texas Rangers,RNGRS,1,1,2,3,2006,2006,0,No,0,2.38,0.0,-2.38,391,0,-391,0,0,0,399.0,0.0,-399.0,725000.0,0.0,-725000.0
<a href=/player/shouc101>shouc101</a>,Clyde Shoun,Chicago Cubs,CUBS,1,4,1,5,1938,1938,0,No,0,10.27,2.49,-7.78,576,26,-550,361,27,-334,2894.0,224.0,-2670.0,0.0,0.0,0.0
<a href=/player/shouc101>shouc101</a>,Clyde Shoun,St. Louis Cardinals,CARDS,1,2,1,3,1942,1942,0,No,0,5.25,-0.02,-5.27,308,18,-290,155,2,-153,1547.0,37.0,-1510.0,0.0,0.0,0.0
<a href=/player/shrec001>shrec001</a>,Chasen Shreve,Atlanta Braves,BRAVES,1,2,1,3,2015,2016,1,No,0,1.56,-0.24,-1.8,214,14,-200,2,7,5,580.0,79.0,-501.0,0.0,0.0,0.0
<a href=/player/shrec001>shrec001</a>,Chasen Shreve,New York Yankees,YANKS,1,2,2,4,2018,2018,0,Yes,0,3.47,1.31,-2.16,336,39,-297,5,148,143,562.0,0.0,-562.0,825000.0,0.0,-825000.0
<a href=/player/shuep001>shuep001</a>,Paul Shuey,Cleveland Indians,INDINS,2,3,4,7,2002,2005,3,No,0,1.47,0.77,-0.7,252,165,-87,226,251,25,550.0,830.0,280.0,4152400.0,0.0,-4152400.0
<a href=/player/shugf101>shugf101</a>,Frank Shugart,Pittsburgh Pirates,PIRATS,1,2,1,3,1893,1894,1,No,0,0.22,3.25,3.03,192,153,-39,860,698,-162,0.0,0.0,0.0,0.0,0.0,0.0
<a href=/player/shugf101>shugf101</a>,Frank Shugart,St. Louis Cardinals,CARDS,1,1,1,2,1895,1895,0,No,0,-0.52,-0.94,-0.42,113,84,-29,511,407,-104,0.0,0.0,0.0,0.0,0.0,0.0
<a href=/player/shuma001>shuma001</a>,Anthony Shumaker,New York Mets,METS,1,1,1,2,2000,2000,0,No,0,0.0,0.0,0.0,0,0,0,0,0,0,0.0,0.0,0.0,0.0,0.0,0.0
<a href=/player/sicke101>sicke101</a>,Ed Sicking,New York Giants,GIANTS,2,7,2,9,1919,1926,7,No,0,9.28,14.26,4.98,1335,470,-865,2807,556,-2251,5840.0,4330.0,-1510.0,10442.0,0.0,-10442.0
<a href=/player/siebd102>siebd102</a>,Dick Siebert,St. Louis Cardinals,CARDS,1,1,3,4,1938,1938,0,No,0,7.67,0.0,-7.67,1004,0,-1004,4195,0,-4195,0.0,0.0,0.0,3500.0,0.0,-3500.0
<a href=/player/siebd102>siebd102</a>,Dick Siebert,Philadelphia Athletics,ATLTCS,1,1,1,2,1945,1947,2,No,0,0.0,-0.74,-0.74,0,136,136,0,556,556,0.0,0.0,0.0,12000.0,0.0,-12000.0
<a href=/player/siebd102>siebd102</a>,Dick Siebert,Brooklyn Dodgers,DOGRS,2,7,3,10,1936,1944,8,No,0,1.9,2.87,0.97,125,593,468,330,2189,1859,390.0,0.0,-390.0,10000.0,0.0,-10000.0
<a href=/player/siebn101>siebn101</a>,Norm Siebern,New York Yankees,YANKS,4,7,6,13,1959,1969,10,No,0,14.99,27.57,12.58,1233,1032,-201,4340,4017,-323,296.0,0.0,-296.0,175000.0,0.0,-175000.0
<a href=/player/siebn101>siebn101</a>,Norm Siebern,Kansas City Athletics,ATLTCS,2,2,4,6,1963,1965,2,No,0,5.51,1.89,-3.62,386,200,-186,1388,661,-727,0.0,46.0,46.0,32500.0,0.0,-32500.0
<a href=/player/siebn101>siebn101</a>,Norm Siebern,Baltimore Orioles,ORLS,13,27,25,52,1965,1994,29,No,3,57.31,119.52,62.21,3046,5392,2346,5593,14197,8604,12746.0,15470.0,2724.0,942833.0,0.0,-942833.0
<a href=/player/siebn101>siebn101</a>,Norm Siebern,California Angels,ANGELS,2,2,2,4,1966,1967,1,No,0,2.08,-0.05,-2.13,370,60,-310,910,103,-807,0.0,0.0,0.0,46000.0,0.0,-46000.0
<a href=/player/siebp101>siebp101</a>,Paul Siebert,Houston Astros,ASTROS,1,1,1,2,1977,1977,0,No,0,-0.22,0.0,0.22,8,0,-8,0,0,0,11.0,0.0,-11.0,0.0,0.0,0.0
<a href=/player/siebp101>siebp101</a>,Paul Siebert,San Diego Padres,PADRS,1,2,1,3,1977,1977,0,No,0,-0.17,0.36,0.53,215,56,-159,280,187,-93,168.0,0.0,-168.0,0.0,0.0,0.0
<a href=/player/siebp101>siebp101</a>,Paul Siebert,New York Mets,METS,1,1,1,2,1978,1978,0,No,0,0.0,0.0,0.0,0,0,0,0,0,0,0.0,0.0,0.0,0.0,0.0,0.0
<a href=/player/siebs101>siebs101</a>,Sonny Siebert,Cleveland Indians,INDINS,1,3,3,6,1969,1970,1,No,0,13.72,3.96,-9.76,502,371,-131,436,691,255,3166.0,784.0,-2382.0,34500.0,0.0,-34500.0
<a href=/player/siebs101>siebs101</a>,Sonny Siebert,Texas Rangers,RNGRS,1,1,2,3,1973,1977,4,No,0,0.13,0.0,-0.13,56,0,-56,49,0,-49,401.0,0.0,-401.0,0.0,0.0,0.0
<a href=/player/siebs101>siebs101</a>,Sonny Siebert,St. Louis Cardinals,CARDS,4,7,5,12,1974,1976,2,No,0,2.63,1.37,-1.26,416,126,-290,619,461,-158,1142.0,0.0,-1142.0,0.0,0.0,0.0
<a href=/player/siebs101>siebs101</a>,Sonny Siebert,San Diego Padres,PADRS,1,1,1,2,1975,1975,0,No,0,0.46,-0.64,-1.1,18,87,69,1,223,222,183.0,0.0,-183.0,0.0,0.0,0.0
<a href=/player/sierc001>sierc001</a>,Candy Sierra,San Diego Padres,PADRS,1,1,1,2,1988,1991,3,No,0,-0.02,4.68,4.7,2,220,218,1,252,251,12.0,1999.0,1987.0,62500.0,0.0,-62500.0
<a href=/player/sierm002>sierm002</a>,Magneuris Sierra,St. Louis Cardinals,CARDS,1,4,1,5,2017,2019,2,No,0,8.96,4.59,-4.37,386,278,-108,632,1177,545,1696.0,0.0,-1696.0,0.0,0.0,0.0
<a href=/player/sierr001>sierr001</a>,Ruben Sierra,Texas Rangers,RNGRS,2,5,3,8,1992,1996,4,No,0,8.49,4.09,-4.4,638,377,-261,2442,1627,-815,1191.0,3.0,-1188.0,15083333.0,0.0,-15083333.0
<a href=/player/sierr001>sierr001</a>,Ruben Sierra,Oakland Athletics,ATLTCS,2,3,3,6,1995,1997,2,No,0,-0.97,-0.14,0.83,515,36,-479,1898,98,-1800,0.0,89.0,89.0,6200000.0,0.0,-6200000.0
<a href=/player/sierr001>sierr001</a>,Ruben Sierra,New York Yankees,YANKS,1,2,1,3,1996,1997,1,No,0,-0.38,0.96,1.34,46,151,105,180,653,473,0.0,0.0,0.0,6200000.0,0.0,-6200000.0
<a href=/player/sierr001>sierr001</a>,Ruben Sierra,Detroit Tigers,TIGRS,1,1,2,3,1996,1996,0,No,0,0.04,0.0,-0.04,25,0,-25,96,0,-96,0.0,0.0,0.0,0.0,0.0,0.0
<a href=/player/sierr001>sierr001</a>,Ruben Sierra,Texas Rangers,RNGRS,1,1,1,2,2003,2003,0,No,0,-0.52,-0.44,0.08,231,30,-201,708,84,-624,0.0,0.0,0.0,600000.0,0.0,-600000.0
<a href=/player/sievr101>sievr101</a>,Roy Sievers,Baltimore Orioles,ORLS,1,1,1,2,1954,1955,1,No,0,14.6,-0.96,-15.56,856,155,-701,3573,432,-3141,0.0,0.0,0.0,0.0,0.0,0.0
<a href=/player/sievr101>sievr101</a>,Roy Sievers,Washington Senators,TWINS,4,9,9,18,1960,1971,11,No,0,32.57,40.51,7.94,1697,2191,494,5778,6105,327,873.0,2844.0,1971.0,153000.0,0.0,-153000.0
<a href=/player/sievr101>sievr101</a>,Roy Sievers,Chicago White Sox,WSOX,2,2,5,7,1961,1967,6,No,0,6.16,5.78,-0.38,593,417,-176,2190,480,-1710,0.0,2599.0,2599.0,44000.0,0.0,-44000.0
<a href=/player/sigaf101>sigaf101</a>,Frank Sigafoos,Chicago White Sox,WSOX,4,10,6,16,1929,1935,6,No,0,3.4,7.08,3.68,902,501,-401,3430,1582,-1848,0.0,735.0,735.0,34500.0,0.0,-34500.0
<a href=/player/sikob001>sikob001</a>,Brian Sikorski,San Diego Padres,PADRS,4,7,7,14,2006,2019,13,No,0,11.0,6.24,-4.76,793,884,91,2593,1173,-1420,319.0,1707.0,1388.0,3828600.0,0.0,-3828600.0
<a href=/player/silvc001>silvc001</a>,Carlos Silva,Philadelphia Phillies,PHILS,1,3,1,4,2003,2004,1,No,0,19.34,1.44,-17.9,901,67,-834,2722,75,-2647,2374.0,603.0,-1771.0,610000.0,0.0,-610000.0
<a href=/player/silvc001>silvc001</a>,Carlos Silva,Seattle Mariners,MARNRS,1,2,1,3,2009,2011,2,No,0,1.59,0.02,-1.57,40,101,61,40,393,353,339.0,0.0,-339.0,12250000.0,0.0,-12250000.0
<a href=/player/silvc101>silvc101</a>,Charlie Silvera,New York Yankees,YANKS,1,2,1,3,1956,1957,1,No,0,-0.26,0.0,0.26,26,0,-26,57,0,-57,0.0,0.0,0.0,16750.0,0.0,-16750.0
<a href=/player/silvd001>silvd001</a>,Dave Silvestri,Houston Astros,ASTROS,7,14,19,33,1990,2004,14,No,0,26.09,8.2,-17.89,2264,1789,-475,4026,3854,-172,4263.0,3434.0,-829.0,7155000.0,0.0,-7155000.0
<a href=/player/silvd001>silvd001</a>,Dave Silvestri,New York Yankees,YANKS,1,1,1,2,1995,1995,0,No,0,-0.71,0.0,0.71,125,0,-125,283,0,-283,0.0,0.0,0.0,116000.0,0.0,-116000.0
<a href=/player/silvj001>silvj001</a>,Jose Silva,Toronto Blue Jays,BJAYS,2,7,5,12,1996,2001,5,No,0,5.42,8.51,3.09,1726,826,-900,3923,2165,-1758,1392.0,748.0,-644.0,1500000.0,0.0,-1500000.0
<a href=/player/silvj001>silvj001</a>,Jose Silva,Pittsburgh Pirates,PIRATS,1,1,1,2,2001,2001,0,No,0,0.22,0.0,-0.22,22,0,-22,1,0,-1,70.0,0.0,-70.0,795000.0,0.0,-795000.0
<a href=/player/silvk101>silvk101</a>,Ken Silvestri,Chicago White Sox,WSOX,1,1,1,2,1940,1942,2,No,0,0.16,0.74,0.58,33,89,56,83,397,314,0.0,0.0,0.0,3000.0,0.0,-3000.0
<a href=/player/simaa101>simaa101</a>,Al Sima,Chicago White Sox,WSOX,1,4,2,6,1954,1956,2,No,0,0.81,2.11,1.3,331,206,-125,724,121,-603,571.0,421.0,-150.0,8500.0,0.0,-8500.0
<a href=/player/simaa101>simaa101</a>,Al Sima,Kansas City Athletics,ATLTCS,1,1,1,2,1955,1955,0,No,0,0.0,-0.73,-0.73,0,10,10,0,3,3,0.0,35.0,35.0,0.0,0.0,0.0
<a href=/player/simab001>simab001</a>,Bill Simas,California Angels,ANGELS,1,4,2,6,1995,1997,2,No,0,5.3,-0.85,-6.15,439,40,-399,87,0,-87,1686.0,680.0,-1006.0,0.0,0.0,0.0
<a href=/player/simma001>simma001</a>,Andrelton Simmons,Atlanta Braves,BRAVES,4,9,8,17,2015,2017,2,Yes,0,22.94,1.32,-21.62,894,130,-764,2564,403,-2161,887.0,339.0,-548.0,16307500.0,0.0,-16307500.0
<a href=/player/simma101>simma101</a>,Al Simmons,Milwaukee,Milwaukee,5,5,13,18,1923,1937,14,No,0,58.42,0.0,-58.42,2136,0,-2136,8966,0,-8966,0.0,0.0,0.0,0.0,0.0,0.0
<a href=/player/simmb001>simmb001</a>,Brian Simmons,Chicago White Sox,WSOX,2,5,3,8,2001,2001,0,No,0,-0.46,1.34,1.8,81,17,-64,117,2,-115,78.0,302.0,224.0,0.0,0.0,0.0
<a href=/player/simmn001>simmn001</a>,Nelson Simmons,Baltimore Orioles,ORLS,1,1,1,2,1987,1987,0,No,0,0.0,0.0,0.0,0,0,0,0,0,0,0.0,0.0,0.0,0.0,0.0,0.0
<a href=/player/simms001>simms001</a>,Shae Simmons,Atlanta Braves,BRAVES,1,2,2,4,2017,2019,2,Yes,0,-0.62,-0.29,0.33,157,27,-130,613,12,-601,23.0,147.0,124.0,0.0,0.0,0.0
<a href=/player/simmt001>simmt001</a>,Ted Simmons,St. Louis Cardinals,CARDS,8,19,15,34,1980,1998,18,No,4,64.49,118.5,54.01,5600,4432,-1168,17434,16118,-1316,5735.0,2617.0,-3118.0,1533333.0,0.0,-1533333.0
<a href=/player/simmt001>simmt001</a>,Ted Simmons,Milwaukee Brewers,BREWRS,2,2,4,6,1986,1986,0,No,1,-0.7,1.33,2.03,227,68,-159,467,242,-225,0.0,0.0,0.0,0.0,0.0,0.0
<a href=/player/simoa001>simoa001</a>,Alfredo Simon,Philadelphia Phillies,PHILS,2,3,2,5,2004,2005,1,No,0,-0.1,4.09,4.19,66,156,90,60,406,346,97.0,63.0,-34.0,1225000.0,0.0,-1225000.0
<a href=/player/simoa001>simoa001</a>,Alfredo Simon,Baltimore Orioles,ORLS,1,1,2,3,2006,2006,0,No,0,0.0,0.0,0.0,0,0,0,0,0,0,0.0,0.0,0.0,0.0,0.0,0.0
<a href=/player/simoa001>simoa001</a>,Alfredo Simon,Cincinnati Reds,REDS,1,1,2,3,2014,2014,0,Yes,0,-0.51,0.0,0.51,33,0,-33,5,0,-5,561.0,0.0,-561.0,1500000.0,0.0,-1500000.0
<a href=/player/simod001>simod001</a>,Doug Simons,New York Mets,METS,2,2,2,4,1992,1992,0,No,0,-0.78,0.11,0.89,14,46,32,0,145,145,16.0,0.0,-16.0,0.0,0.0,0.0
<a href=/player/simom101>simom101</a>,Mel Simons,Louisville,Louisville,1,1,1,2,1931,1931,0,No,0,-0.56,0.0,0.56,75,0,-75,213,0,-213,0.0,0.0,0.0,0.0,0.0,0.0
<a href=/player/simom101>simom101</a>,Mel Simons,Chicago White Sox,WSOX,2,4,2,6,1932,1936,4,No,0,0.0,0.77,0.77,0,142,142,0,507,507,0.0,39.0,39.0,5500.0,0.0,-5500.0
<a href=/player/simom102>simom102</a>,Mike Simon,Boston Braves,BRAVES,6,8,9,17,1909,1927,18,No,0,12.78,37.81,25.03,886,1876,990,2292,5043,2751,2058.0,9235.0,7177.0,6000.0,0.0,-6000.0
<a href=/player/simor001>simor001</a>,Randall Simon,Detroit Tigers,TIGRS,4,6,6,12,2002,2010,8,No,0,-0.79,4.22,5.01,551,270,-281,568,7,-561,685.0,1453.0,768.0,2265000.0,0.0,-2265000.0
<a href=/player/simor001>simor001</a>,Randall Simon,Pittsburgh Pirates,PIRATS,1,1,1,2,2003,2006,3,No,0,0.44,-0.06,-0.5,33,3,-30,110,8,-102,0.0,0.0,0.0,1475000.0,0.0,-1475000.0
<a href=/player/simpa001>simpa001</a>,Allan Simpson,Seattle Mariners,MARNRS,1,1,1,2,2003,2003,0,No,0,-0.39,0.0,0.39,67,0,-67,1,0,-1,119.0,0.0,-119.0,0.0,0.0,0.0
<a href=/player/simpa001>simpa001</a>,Allan Simpson,Colorado Rockies,ROCKS,1,1,1,2,2005,2006,1,No,0,-0.07,-0.77,-0.7,18,72,54,0,11,11,20.0,192.0,172.0,318000.0,0.0,-318000.0
<a href=/player/simpd102>simpd102</a>,Dick Simpson,California Angels,ANGELS,3,3,3,6,1965,1967,2,No,0,2.08,0.48,-1.6,370,185,-185,910,507,-403,0.0,0.0,0.0,53000.0,0.0,-53000.0
<a href=/player/simpd102>simpd102</a>,Dick Simpson,Baltimore Orioles,ORLS,12,26,24,50,1965,1994,29,No,3,56.78,119.52,62.74,2921,5392,2471,5189,14197,9008,12746.0,15470.0,2724.0,912833.0,0.0,-912833.0
<a href=/player/simpd102>simpd102</a>,Dick Simpson,Cincinnati Reds,REDS,10,12,15,27,1968,1988,20,No,0,6.26,55.61,49.35,1200,3688,2488,3980,7973,3993,279.0,5781.0,5502.0,18500.0,0.0,-18500.0
<a href=/player/simpd102>simpd102</a>,Dick Simpson,St. Louis Cardinals,CARDS,4,10,7,17,1968,1972,4,No,0,10.58,2.29,-8.29,1246,276,-970,1450,608,-842,1865.0,299.0,-1566.0,32500.0,0.0,-32500.0
<a href=/player/simpd102>simpd102</a>,Dick Simpson,Houston Astros,ASTROS,2,3,2,5,1968,1970,2,No,0,0.47,0.36,-0.11,24,150,126,15,31,16,43.0,466.0,423.0,23500.0,0.0,-23500.0
<a href=/player/simpd102>simpd102</a>,Dick Simpson,New York Yankees,YANKS,1,1,1,2,1969,1969,0,No,0,-0.44,0.0,0.44,26,0,-26,56,0,-56,0.0,0.0,0.0,16000.0,0.0,-16000.0
<a href=/player/simpd102>simpd102</a>,Dick Simpson,Milwaukee Brewers,BREWRS,2,3,2,5,1969,1970,1,No,0,2.45,-0.08,-2.53,213,64,-149,45,45,0,485.0,396.0,-89.0,48000.0,0.0,-48000.0
<a href=/player/simph101>simph101</a>,Harry Simpson,Kansas City Athletics,ATLTCS,50,107,110,217,1957,1976,19,No,0,243.41,144.18,-99.23,19841,14910,-4931,49436,46172,-3264,28049.0,12074.0,-15975.0,661100.0,0.0,-661100.0
<a href=/player/simph101>simph101</a>,Harry Simpson,New York Yankees,YANKS,1,2,2,4,1958,1960,2,No,0,2.31,-2.84,-5.15,242,240,-2,336,102,-234,756.0,1048.0,292.0,12500.0,0.0,-12500.0
<a href=/player/simph101>simph101</a>,Harry Simpson,Kansas City Athletics,ATLTCS,1,1,1,2,1959,1959,0,No,0,-0.11,0.7,0.81,38,61,23,79,161,82,0.0,0.0,0.0,12500.0,0.0,-12500.0
<a href=/player/simph101>simph101</a>,Harry Simpson,Chicago White Sox,WSOX,1,2,1,3,1959,1960,1,No,0,0.08,0.59,0.51,9,112,103,15,318,303,0.0,0.0,0.0,12500.0,0.0,-12500.0
<a href=/player/simps101>simps101</a>,Steve Simpson,San Diego Padres,PADRS,1,1,1,2,1973,1974,1,No,0,0.0,-0.44,-0.44,0,30,30,0,10,10,0.0,125.0,125.0,0.0,0.0,0.0
<a href=/player/simpw101>simpw101</a>,Wayne Simpson,Cincinnati Reds,REDS,2,3,4,7,1972,1974,2,No,0,29.0,0.89,-28.11,1940,85,-1855,7657,116,-7541,179.0,420.0,241.0,68500.0,0.0,-68500.0
<a href=/player/simpw101>simpw101</a>,Wayne Simpson,Kansas City Royals,ROYALS,1,1,1,2,1974,1974,0,No,0,0.0,0.0,0.0,0,0,0,0,0,0,0.0,0.0,0.0,0.0,0.0,0.0
<a href=/player/simpw101>simpw101</a>,Wayne Simpson,Pittsburgh Pirates,PIRATS,3,3,3,6,1975,1983,8,No,0,-0.85,6.88,7.73,131,845,714,293,2739,2446,92.0,0.0,-92.0,0.0,0.0,0.0
<a href=/player/simsd101>simsd101</a>,Duke Sims,Cleveland Indians,INDINS,9,14,16,30,1970,1984,14,No,0,49.67,12.19,-37.48,2807,2706,-101,10352,8390,-1962,38.0,1919.0,1881.0,195250.0,0.0,-195250.0
<a href=/player/simsd101>simsd101</a>,Duke Sims,New York Yankees,YANKS,2,2,3,5,1974,1978,4,No,0,18.37,3.77,-14.6,351,108,-243,118,205,87,5104.0,622.0,-4482.0,50000.0,0.0,-50000.0
<a href=/player/simsl001>simsl001</a>,Lucas Sims,Atlanta Braves,BRAVES,1,3,1,4,2018,2020,2,No,0,1.47,1.06,-0.41,203,131,-72,53,396,343,403.0,0.0,-403.0,565000.0,0.0,-565000.0
<a href=/player/sinam001>sinam001</a>,Matt Sinatro,Oakland Athletics,ATLTCS,1,1,1,2,1989,1991,2,No,0,0.0,-0.28,-0.28,0,19,19,0,26,26,0.0,0.0,0.0,0.0,0.0,0.0
<a href=/player/sincs001>sincs001</a>,Steve Sinclair,Toronto Blue Jays,BJAYS,3,5,3,8,1999,2002,3,No,0,6.14,2.49,-3.65,321,312,-9,1103,1201,98,104.0,25.0,-79.0,0.0,0.0,0.0
<a href=/player/singb101>singb101</a>,Bill Singer,Los Angeles Dodgers,DOGRS,1,5,2,7,1972,1976,4,No,0,16.6,19.03,2.43,596,356,-240,1923,542,-1381,1810.0,2591.0,781.0,251500.0,0.0,-251500.0
<a href=/player/singb101>singb101</a>,Bill Singer,California Angels,ANGELS,3,4,6,10,1975,1977,2,No,0,0.33,-0.47,-0.8,338,122,-216,1247,392,-855,194.0,18.0,-176.0,0.0,0.0,0.0
<a href=/player/singb101>singb101</a>,Bill Singer,Texas Rangers,RNGRS,5,14,9,23,1976,1988,12,No,0,43.04,39.52,-3.52,2266,2145,-121,8188,7408,-780,2609.0,4285.0,1676.0,330000.0,0.0,-330000.0
<a href=/player/singc001>singc001</a>,Chris Singleton,San Francisco Giants,GIANTS,1,2,2,4,1997,1999,2,No,0,0.0,0.66,0.66,0,206,206,0,667,667,0.0,0.0,0.0,0.0,0.0,0.0
<a href=/player/singc001>singc001</a>,Chris Singleton,New York Yankees,YANKS,1,1,1,2,1998,1999,1,No,0,8.16,0.0,-8.16,420,0,-420,1528,0,-1528,0.0,0.0,0.0,0.0,0.0,0.0
<a href=/player/singc001>singc001</a>,Chris Singleton,Chicago White Sox,WSOX,1,1,1,2,2002,2005,3,No,0,1.84,1.61,-0.23,136,313,177,502,938,436,0.0,0.0,0.0,0.0,0.0,0.0
<a href=/player/singd001>singd001</a>,Duane Singleton,Milwaukee Brewers,BREWRS,1,1,1,2,1996,1996,0,No,0,-0.5,0.0,0.5,18,0,-18,61,0,-61,0.0,0.0,0.0,0.0,0.0,0.0
<a href=/player/singe101>singe101</a>,Elmer Singleton,New York Yankees,YANKS,1,1,2,3,1945,1945,0,No,0,-0.51,0.0,0.51,45,0,-45,16,0,-16,213.0,0.0,-213.0,0.0,0.0,0.0
<a href=/player/singe101>singe101</a>,Elmer Singleton,Boston Braves,BRAVES,4,7,6,13,1946,1952,6,No,0,-0.23,24.56,24.79,358,848,490,547,3228,2681,596.0,210.0,-386.0,0.0,0.0,0.0
<a href=/player/singe101>singe101</a>,Elmer Singleton,SanFrancisco,SanFrancisco,1,1,1,2,1950,1950,0,No,0,0.3,0.0,-0.3,42,0,-42,8,0,-8,109.0,0.0,-109.0,0.0,0.0,0.0
<a href=/player/singe101>singe101</a>,Elmer Singleton,Cincinnati Reds,REDS,5,9,14,23,1956,1965,9,No,0,64.39,16.2,-48.19,3193,1555,-1638,9922,3215,-6707,2746.0,1065.0,-1681.0,0.0,0.0,0.0
<a href=/player/singf101>singf101</a>,Fred Sington,Washington Senators,TWINS,1,1,2,3,1938,1939,1,No,0,1.0,0.0,-1.0,49,0,-49,167,0,-167,0.0,0.0,0.0,0.0,0.0,0.0
<a href=/player/singf101>singf101</a>,Fred Sington,Albany,Albany,1,1,3,4,1934,1934,0,No,0,0.43,0.0,-0.43,132,0,-132,445,0,-445,0.0,0.0,0.0,0.0,0.0,0.0
<a href=/player/singj001>singj001</a>,Jon Singleton,Philadelphia Phillies,PHILS,2,5,5,10,2011,2018,7,No,0,10.84,2.57,-8.27,1005,441,-564,3635,1629,-2006,674.0,0.0,-674.0,10400000.0,0.0,-10400000.0
<a href=/player/singj101>singj101</a>,John Singleton,Philadelphia Phillies,PHILS,4,9,8,17,1922,1936,14,No,0,25.37,3.27,-22.1,1352,2052,700,5364,8721,3357,77.0,0.0,-77.0,43100.0,0.0,-43100.0
<a href=/player/singk001>singk001</a>,Ken Singleton,New York Mets,METS,2,5,3,8,1972,1979,7,No,0,27.3,7.07,-20.23,2407,595,-1812,9387,2358,-7029,284.0,578.0,294.0,110000.0,0.0,-110000.0
<a href=/player/singk001>singk001</a>,Ken Singleton,Montreal Expos,NATEX,1,2,3,5,1974,1976,2,No,0,33.5,-0.16,-33.66,1482,37,-1445,6072,69,-6003,812.0,232.0,-580.0,98500.0,0.0,-98500.0
<a href=/player/sipij101>sipij101</a>,John Sipin,St. Louis Cardinals,CARDS,3,5,4,9,1969,1972,3,No,0,0.79,1.88,1.09,125,189,64,357,73,-284,0.0,264.0,264.0,10000.0,0.0,-10000.0
<a href=/player/sippt001>sippt001</a>,Tony Sipp,Cleveland Indians,INDINS,4,8,11,19,2012,2019,7,Yes,0,4.46,23.51,19.05,328,937,609,554,910,356,512.0,4479.0,3967.0,22963900.0,0.0,-22963900.0
<a href=/player/sirom001>sirom001</a>,Mike Sirotka,Chicago White Sox,WSOX,2,5,3,8,2001,2001,0,No,0,-0.46,1.34,1.8,81,17,-64,117,2,-115,78.0,302.0,224.0,0.0,0.0,0.0
<a href=/player/sisca001>sisca001</a>,Andy Sisco,Kansas City Royals,ROYALS,2,3,2,5,2006,2009,3,No,0,0.12,0.28,0.16,146,224,78,259,764,505,45.0,0.0,-45.0,346500.0,0.0,-346500.0
<a href=/player/siscs001>siscs001</a>,Steve Sisco,Atlanta Braves,BRAVES,1,1,1,2,2000,2004,4,No,0,0.0,-0.88,-0.88,0,124,124,0,195,195,0.0,0.0,0.0,0.0,0.0,0.0
<a href=/player/siskd001>siskd001</a>,Doug Sisk,New York Mets,METS,3,3,4,7,1987,1996,9,No,0,1.0,0.17,-0.83,52,39,-13,0,18,18,283.0,68.0,-215.0,439000.0,0.0,-439000.0
<a href=/player/siskd001>siskd001</a>,Doug Sisk,New York Mets,METS,1,1,1,2,1990,1990,0,No,0,-0.79,0.0,0.79,34,0,-34,0,0,0,50.0,0.0,-50.0,0.0,0.0,0.0
<a href=/player/siskt101>siskt101</a>,Tommie Sisk,Pittsburgh Pirates,PIRATS,1,2,2,4,1969,1969,0,No,0,2.16,-0.66,-2.82,398,62,-336,1040,73,-967,429.0,0.0,-429.0,0.0,0.0,0.0
<a href=/player/siskt101>siskt101</a>,Tommie Sisk,San Diego Padres,PADRS,1,1,1,2,1970,1970,0,No,0,-0.68,-0.37,0.31,34,5,-29,4,1,-3,100.0,16.0,-84.0,0.0,0.0,0.0
<a href=/player/siskt101>siskt101</a>,Tommie Sisk,Chicago White Sox,WSOX,3,4,4,8,1970,1971,1,No,0,2.16,-0.62,-2.78,446,79,-367,1302,48,-1254,0.0,422.0,422.0,40000.0,0.0,-40000.0
<a href=/player/sisld101>sisld101</a>,Dick Sisler,St. Louis Cardinals,CARDS,1,1,2,3,1948,1948,0,No,0,7.16,-0.77,-7.93,508,87,-421,2019,245,-1774,0.0,0.0,0.0,0.0,0.0,0.0
<a href=/player/sisld101>sisld101</a>,Dick Sisler,Philadelphia Phillies,PHILS,3,8,7,15,1951,1957,6,No,0,12.59,16.8,4.21,922,1010,88,2813,3409,596,109.0,186.0,77.0,63000.0,0.0,-63000.0
<a href=/player/sisld101>sisld101</a>,Dick Sisler,Cincinnati Reds,REDS,2,3,4,7,1952,1953,1,No,0,3.75,-0.48,-4.23,393,72,-321,1163,232,-931,0.0,0.0,0.0,25500.0,0.0,-25500.0
<a href=/player/sisld101>sisld101</a>,Dick Sisler,St. Louis Cardinals,CARDS,1,3,1,4,1954,1954,0,No,0,0.0,-0.06,-0.06,0,66,66,0,271,271,0.0,0.0,0.0,0.0,0.0,0.0
<a href=/player/sisld102>sisld102</a>,Dave Sisler,Boston Red Sox,RSOX,2,3,2,5,1959,1959,0,No,0,7.37,-0.54,-7.91,476,29,-447,344,14,-330,1329.0,127.0,-1202.0,11000.0,0.0,-11000.0
<a href=/player/sisld102>sisld102</a>,Dave Sisler,Washington Senators,RNGRS,27,47,53,100,1961,1992,31,No,2,143.34,113.56,-29.78,8501,6844,-1657,19421,19559,138,25708.0,12847.0,-12861.0,358650.0,0.0,-358650.0
<a href=/player/sivep101>sivep101</a>,Pete Sivess,Philadelphia Phillies,PHILS,1,2,1,3,1939,1939,0,No,0,0.0,0.06,0.06,0,5,5,0,20,20,0.0,0.0,0.0,0.0,0.0,0.0
<a href=/player/siwyj001>siwyj001</a>,Jim Siwy,Chicago White Sox,WSOX,1,1,1,2,1984,1985,1,No,0,0.0,1.84,1.84,0,76,76,0,1,1,0.0,420.0,420.0,0.0,0.0,0.0
<a href=/player/sizeg001>sizeg001</a>,Grady Sizemore,Montreal Expos,NATEX,2,6,6,12,2002,2004,2,No,0,48.64,-2.57,-51.21,1323,330,-993,4723,156,-4567,4264.0,874.0,-3390.0,4000000.0,0.0,-4000000.0
<a href=/player/sizes001>sizes001</a>,Scott Sizemore,Detroit Tigers,TIGRS,1,1,1,2,2011,2011,0,No,0,1.13,-0.41,-1.54,95,21,-74,361,0,-361,0.0,56.0,56.0,0.0,0.0,0.0
<a href=/player/sizet101>sizet101</a>,Ted Sizemore,Los Angeles Dodgers,DOGRS,3,4,4,8,1970,1978,8,No,1,24.33,19.6,-4.73,1044,519,-525,4315,1112,-3203,0.0,3594.0,3594.0,125000.0,0.0,-125000.0
<a href=/player/sizet101>sizet101</a>,Ted Sizemore,St. Louis Cardinals,CARDS,22,45,42,87,1976,1998,22,No,7,91.55,161.79,70.24,8569,7461,-1108,23900,25883,1983,10540.0,4019.0,-6521.0,3088333.0,0.0,-3088333.0
<a href=/player/sizet101>sizet101</a>,Ted Sizemore,Los Angeles Dodgers,DOGRS,1,1,2,3,1976,1980,4,No,0,0.97,0.11,-0.86,260,126,-134,967,302,-665,0.0,0.0,0.0,0.0,0.0,0.0
<a href=/player/sizet101>sizet101</a>,Ted Sizemore,Philadelphia Phillies,PHILS,7,17,13,30,1979,1999,20,No,0,25.6,38.01,12.41,2807,3562,755,9986,9588,-398,522.0,1259.0,737.0,2950000.0,0.0,-2950000.0
<a href=/player/sizet101>sizet101</a>,Ted Sizemore,Chicago Cubs,CUBS,6,10,10,20,1979,1990,11,No,0,12.53,11.46,-1.07,946,694,-252,2591,463,-2128,1070.0,3095.0,2025.0,890000.0,0.0,-890000.0
<a href=/player/skaff101>skaff101</a>,Frank Skaff,Brooklyn Dodgers,DOGRS,1,2,1,3,1937,1937,0,No,0,0.0,-0.16,-0.16,0,12,12,0,30,30,0.0,0.0,0.0,0.0,0.0,0.0
<a href=/player/skagt001>skagt001</a>,Tyler Skaggs,Anaheim Angels,ANGELS,1,4,1,5,2010,2012,2,No,0,13.1,6.5,-6.6,498,84,-414,497,11,-486,4323.0,1527.0,-2796.0,3700000.0,0.0,-3700000.0
<a href=/player/skagt001>skagt001</a>,Tyler Skaggs,Arizona Diamondbacks,DBACKS,2,4,7,11,2013,2018,5,Yes,0,5.96,2.34,-3.62,303,392,89,439,1311,872,1761.0,119.0,-1642.0,491000.0,0.0,-491000.0
<a href=/player/skidr101>skidr101</a>,Roe Skidmore,Chicago Cubs,CUBS,1,3,2,5,1970,1973,3,No,0,1.15,0.0,-1.15,69,0,-69,29,0,-29,290.0,0.0,-290.0,0.0,0.0,0.0
<a href=/player/skidr101>skidr101</a>,Roe Skidmore,Cincinnati Reds,REDS,1,2,2,4,1973,1973,0,No,0,0.24,0.19,-0.05,16,36,20,0,60,60,24.0,0.0,-24.0,16000.0,0.0,-16000.0
<a href=/player/skidr101>skidr101</a>,Roe Skidmore,Houston Astros,ASTROS,1,1,1,2,1974,1974,0,No,0,0.0,0.0,0.0,0,0,0,0,0,0,0.0,0.0,0.0,0.0,0.0,0.0
<a href=/player/skidr101>skidr101</a>,Roe Skidmore,Chicago White Sox,WSOX,2,2,3,5,1972,1975,3,No,0,0.3,1.16,0.86,50,152,102,93,427,334,0.0,0.0,0.0,0.0,0.0,0.0
<a href=/player/skinb101>skinb101</a>,Bob Skinner,Pittsburgh Pirates,PIRATS,1,1,1,2,1963,1966,3,No,0,0.45,-0.21,-0.66,97,339,242,280,782,502,0.0,0.0,0.0,31000.0,0.0,-31000.0
<a href=/player/skinb101>skinb101</a>,Bob Skinner,Cincinnati Reds,REDS,1,1,2,3,1964,1964,0,No,0,0.73,0.0,-0.73,184,0,-184,341,0,-341,0.0,0.0,0.0,26500.0,0.0,-26500.0
<a href=/player/skinc102>skinc102</a>,Camp Skinner,New York Yankees,YANKS,1,4,1,5,1923,1934,11,No,0,-1.25,33.68,34.93,272,692,420,598,908,310,765.0,6610.0,5845.0,0.0,0.0,0.0
<a href=/player/skinj001>skinj001</a>,Joel Skinner,Chicago White Sox,WSOX,1,3,3,6,1986,1991,5,No,0,0.75,-0.11,-0.86,650,316,-334,1809,1056,-753,0.0,0.0,0.0,475000.0,0.0,-475000.0
<a href=/player/skinj001>skinj001</a>,Joel Skinner,New York Yankees,YANKS,1,2,1,3,1989,1992,3,No,0,1.27,3.12,1.85,281,519,238,803,1911,1108,0.0,0.0,0.0,0.0,0.0,0.0
<a href=/player/skizl101>skizl101</a>,Lou Skizas,New York Yankees,YANKS,3,5,6,11,1956,1960,4,No,0,1.84,-2.55,-4.39,364,104,-260,1055,53,-1002,0.0,406.0,406.0,4500.0,0.0,-4500.0
<a href=/player/skizl101>skizl101</a>,Lou Skizas,Kansas City Athletics,ATLTCS,31,62,61,123,1957,1976,19,No,0,95.85,56.38,-39.47,9593,6643,-2950,23097,19018,-4079,12004.0,6179.0,-5825.0,476100.0,0.0,-476100.0
<a href=/player/skizl101>skizl101</a>,Lou Skizas,Chicago White Sox,WSOX,1,2,1,3,1959,1959,0,No,0,0.02,-0.82,-0.84,10,26,16,1,100,99,22.0,0.0,-22.0,10500.0,0.0,-10500.0
<a href=/player/skokc101>skokc101</a>,Craig Skok,Boston Red Sox,RSOX,2,4,3,7,1975,1977,2,No,0,14.8,6.95,-7.85,545,58,-487,1514,0,-1514,2654.0,1206.0,-1448.0,200000.0,0.0,-200000.0
<a href=/player/skowb101>skowb101</a>,Bill Skowron,New York Yankees,YANKS,1,1,1,2,1962,1965,3,No,0,-1.13,1.38,2.51,89,101,12,256,75,-181,0.0,685.0,685.0,37500.0,0.0,-37500.0
<a href=/player/skowb101>skowb101</a>,Bill Skowron,Washington Senators,RNGRS,2,3,3,6,1964,1975,11,No,0,4.84,-0.04,-4.88,347,541,194,1279,559,-720,0.0,1708.0,1708.0,55000.0,0.0,-55000.0
<a href=/player/skowb101>skowb101</a>,Bill Skowron,Chicago White Sox,WSOX,2,2,3,5,1967,1969,2,No,0,-0.88,-0.11,0.77,62,3,-59,131,4,-127,0.0,0.0,0.0,36000.0,0.0,-36000.0
<a href=/player/skrmm001>skrmm001</a>,Matt Skrmetta,Detroit Tigers,TIGRS,1,2,1,3,1997,1997,0,No,0,2.51,-0.37,-2.88,188,52,-136,612,129,-483,0.0,0.0,0.0,0.0,0.0,0.0
<a href=/player/skrmm001>skrmm001</a>,Matt Skrmetta,Montreal Expos,NATEX,1,1,1,2,2000,2000,0,No,0,-0.6,0.0,0.6,16,0,-16,2,0,-2,28.0,0.0,-28.0,0.0,0.0,0.0
<a href=/player/sladg101>sladg101</a>,Gordon Slade,Brooklyn Dodgers,DOGRS,1,2,2,4,1933,1934,1,No,0,1.18,1.07,-0.11,133,145,12,117,327,210,474.0,679.0,205.0,0.0,0.0,0.0
<a href=/player/slagj102>slagj102</a>,Jimmy Slagle,Pittsburgh Pirates,PIRATS,2,4,2,6,1898,1901,3,No,0,1.28,0.36,-0.92,408,35,-373,1684,149,-1535,0.0,0.0,0.0,0.0,0.0,0.0
<a href=/player/slatj001>slatj001</a>,Jim Slaton,Milwaukee Brewers,BREWRS,1,2,1,3,1977,1986,9,No,0,2.06,21.52,19.46,58,1149,1091,0,4658,4658,821.0,0.0,-821.0,45000.0,0.0,-45000.0
<a href=/player/slatj001>slatj001</a>,Jim Slaton,Milwaukee Brewers,BREWRS,1,1,1,2,1983,1983,0,No,0,-0.09,0.0,0.09,75,0,-75,0,0,0,1154.0,0.0,-1154.0,247000.0,0.0,-247000.0
<a href=/player/slaud001>slaud001</a>,Don Slaught,Kansas City Royals,ROYALS,2,3,3,6,1985,1988,3,No,0,2.6,1.39,-1.21,377,358,-19,1204,1074,-130,0.0,58.0,58.0,0.0,0.0,0.0
<a href=/player/slaud001>slaud001</a>,Don Slaught,Texas Rangers,RNGRS,1,1,1,2,1987,1991,4,No,0,3.59,1.41,-2.18,214,80,-134,750,0,-750,0.0,361.0,361.0,431500.0,0.0,-431500.0
<a href=/player/slaud001>slaud001</a>,Don Slaught,New York Yankees,YANKS,1,1,2,3,1989,1992,3,No,0,10.25,1.53,-8.72,475,54,-421,1624,0,-1624,0.0,266.0,266.0,650000.0,0.0,-650000.0
<a href=/player/slaud001>slaud001</a>,Don Slaught,California Angels,ANGELS,1,1,1,2,1996,1996,0,No,0,-0.34,0.0,0.34,14,0,-14,39,0,-39,0.0,0.0,0.0,350000.0,0.0,-350000.0
<a href=/player/slaue101>slaue101</a>,Enos Slaughter,St. Louis Cardinals,CARDS,23,49,45,94,1954,1972,18,No,0,76.87,67.34,-9.53,7508,3672,-3836,20292,10279,-10013,6403.0,6334.0,-69.0,130500.0,0.0,-130500.0
<a href=/player/slaue101>slaue101</a>,Enos Slaughter,New York Yankees,YANKS,1,2,2,4,1955,1955,0,No,0,3.23,0.0,-3.23,249,0,-249,578,0,-578,134.0,0.0,-134.0,20000.0,0.0,-20000.0
<a href=/player/sleal101>sleal101</a>,Lou Sleater,St.Louis Browns,ORLS,1,2,1,3,1952,1952,0,No,0,-0.84,0.79,1.63,38,55,17,46,190,144,171.0,0.0,-171.0,6000.0,0.0,-6000.0
<a href=/player/sleal101>sleal101</a>,Lou Sleater,Milwaukee Braves,BRAVES,1,1,1,2,1957,1957,0,No,0,0.98,0.0,-0.98,90,0,-90,24,0,-24,224.0,0.0,-224.0,0.0,0.0,0.0
<a href=/player/sledt001>sledt001</a>,Terrmel Sledge,Seattle Mariners,MARNRS,1,2,1,3,2000,2001,1,No,0,1.04,-0.19,-1.23,169,10,-159,492,12,-480,20.0,0.0,-20.0,0.0,0.0,0.0
<a href=/player/sledt001>sledt001</a>,Terrmel Sledge,Washington Nationals,NATEX,2,4,3,7,2005,2015,10,No,2,0.68,26.37,25.69,217,505,288,754,1103,349,26.0,3282.0,3256.0,3395000.0,0.0,-3395000.0
<a href=/player/sledt001>sledt001</a>,Terrmel Sledge,Texas Rangers,RNGRS,1,3,3,6,2006,2007,1,No,0,28.55,3.75,-24.8,1126,114,-1012,3924,0,-3924,1652.0,471.0,-1181.0,0.0,0.0,0.0
<a href=/player/sloch001>sloch001</a>,Heathcliff Slocumb,Chicago Cubs,CUBS,4,6,8,14,1993,2001,8,No,2,0.23,2.96,2.73,314,769,455,362,1943,1581,1448.0,490.0,-958.0,5325000.0,0.0,-5325000.0
<a href=/player/sloch001>sloch001</a>,Heathcliff Slocumb,Cleveland Indians,INDINS,1,1,1,2,1993,1995,2,No,0,2.12,-0.31,-2.43,226,54,-172,6,93,87,413.0,0.0,-413.0,165000.0,0.0,-165000.0
<a href=/player/sloch001>sloch001</a>,Heathcliff Slocumb,Philadelphia Phillies,PHILS,2,4,4,8,1996,1999,3,No,0,1.93,-0.39,-2.32,220,301,81,209,170,-39,390.0,444.0,54.0,225000.0,0.0,-225000.0
<a href=/player/sloch001>sloch001</a>,Heathcliff Slocumb,Boston Red Sox,RSOX,7,11,12,23,1997,2020,23,Yes,4,-2.17,54.29,56.46,487,2657,2170,632,6826,6194,701.0,4891.0,4190.0,26826923.0,0.0,-26826923.0
<a href=/player/sloch001>sloch001</a>,Heathcliff Slocumb,St. Louis Cardinals,CARDS,1,2,2,4,2000,2000,0,No,0,0.41,0.16,-0.25,133,17,-116,223,58,-165,57.0,0.0,-57.0,1600000.0,0.0,-1600000.0
<a href=/player/slowk001>slowk001</a>,Kevin Slowey,Colorado Rockies,ROCKS,1,2,1,3,2012,2012,0,No,0,0.0,0.09,0.09,0,4,4,0,0,0,0.0,6.0,6.0,0.0,0.0,0.0
<a href=/player/slowk001>slowk001</a>,Kevin Slowey,Minnesota Twins,TWINS,1,1,1,2,2011,2011,0,No,0,0.0,0.0,0.0,0,0,0,0,0,0,0.0,0.0,0.0,2700000.0,0.0,-2700000.0
<a href=/player/smajc001>smajc001</a>,Craig Smajstrla,Chicago White Sox,WSOX,1,1,1,2,1985,1985,0,No,0,0.0,0.0,0.0,0,0,0,0,0,0,0.0,0.0,0.0,0.0,0.0,0.0
<a href=/player/smala001>smala001</a>,Aaron Small,Toronto Blue Jays,BJAYS,1,1,1,2,1995,1995,0,No,0,-0.5,0.0,0.5,28,0,-28,2,0,-2,68.0,0.0,-68.0,0.0,0.0,0.0
<a href=/player/smalj101>smalj101</a>,Jim Small,Detroit Tigers,TIGRS,4,12,12,24,1957,1964,7,No,0,6.47,14.38,7.91,1197,947,-250,3186,1303,-1883,1459.0,3692.0,2233.0,20000.0,0.0,-20000.0
<a href=/player/smalr001>smalr001</a>,Roy Smalley,Texas Rangers,RNGRS,5,14,9,23,1976,1988,12,No,0,43.04,39.52,-3.52,2266,2145,-121,8188,7408,-780,2609.0,4285.0,1676.0,330000.0,0.0,-330000.0
<a href=/player/smalr001>smalr001</a>,Roy Smalley,Minnesota Twins,TWINS,4,5,9,14,1982,1992,10,No,2,5.08,17.96,12.88,415,1594,1179,1314,3798,2484,157.0,1666.0,1509.0,1325000.0,0.0,-1325000.0
<a href=/player/smalr001>smalr001</a>,Roy Smalley,New York Yankees,YANKS,11,19,18,37,1984,2001,17,No,1,53.67,22.23,-31.44,2460,1621,-839,6052,4002,-2050,9392.0,4016.0,-5376.0,4250000.0,0.0,-4250000.0
<a href=/player/smalr001>smalr001</a>,Roy Smalley,Chicago White Sox,WSOX,1,1,2,3,1985,1985,0,No,0,2.04,0.0,-2.04,382,0,-382,1330,0,-1330,0.0,0.0,0.0,0.0,0.0,0.0
<a href=/player/smalr101>smalr101</a>,Roy Smalley,Chicago Cubs,CUBS,1,1,2,3,1954,1955,1,No,0,-0.06,-0.23,-0.17,25,37,12,42,31,-11,0.0,252.0,252.0,0.0,0.0,0.0
<a href=/player/smeld001>smeld001</a>,Devin Smeltzer,Los Angeles Dodgers,DOGRS,1,3,1,4,2018,2018,0,No,0,0.86,0.11,-0.75,69,47,-22,205,170,-35,209.0,0.0,-209.0,9000000.0,0.0,-9000000.0
<a href=/player/smilj001>smilj001</a>,John Smiley,Pittsburgh Pirates,PIRATS,3,4,7,11,1992,2006,14,No,0,34.72,14.13,-20.59,539,1081,542,727,1318,591,5379.0,5331.0,-48.0,7350000.0,0.0,-7350000.0
<a href=/player/smilj001>smilj001</a>,John Smiley,Cincinnati Reds,REDS,5,9,11,20,1997,2005,8,No,0,10.23,15.87,5.64,1063,1597,534,3584,2539,-1045,112.0,2236.0,2124.0,7950000.0,0.0,-7950000.0
<a href=/player/smita101>smita101</a>,Art Smith,Toronto,Toronto,1,1,1,2,1932,1932,0,No,0,-0.57,0.0,0.57,6,0,-6,1,0,-1,21.0,0.0,-21.0,0.0,0.0,0.0
<a href=/player/smita102>smita102</a>,Al Smith,Cleveland Indians,INDINS,8,14,14,28,1957,1968,11,No,0,114.78,28.23,-86.55,4690,1762,-2928,15896,6646,-9250,7534.0,133.0,-7401.0,15000.0,0.0,-15000.0
<a href=/player/smita102>smita102</a>,Al Smith,Chicago White Sox,WSOX,8,13,17,30,1963,1971,8,No,0,31.42,56.47,25.05,2785,3257,472,9290,8734,-556,740.0,2775.0,2035.0,72500.0,0.0,-72500.0
<a href=/player/smita102>smita102</a>,Al Smith,Baltimore Orioles,ORLS,1,2,1,3,1963,1964,1,No,0,-0.9,0.52,1.42,61,66,5,147,172,25,0.0,0.0,0.0,36500.0,0.0,-36500.0
<a href=/player/smita105>smita105</a>,Aleck Smith,Baltimore Orioles,BLN,3,4,4,8,1899,1906,7,No,0,-0.64,1.86,2.5,170,177,7,604,686,82,204.0,0.0,-204.0,0.0,0.0,0.0
<a href=/player/smita105>smita105</a>,Aleck Smith,Brooklyn Dodgers,DOGRS,1,2,1,3,1899,1902,3,No,0,2.44,3.21,0.77,77,202,125,321,766,445,0.0,0.0,0.0,0.0,0.0,0.0
<a href=/player/smitb001>smitb001</a>,Bryn Smith,Baltimore Orioles,ORLS,6,10,10,20,1977,1994,17,No,1,25.87,32.91,7.04,988,1932,944,938,5757,4819,6735.0,2646.0,-4089.0,713333.0,0.0,-713333.0
<a href=/player/smitb004>smitb004</a>,Bud Smith,St. Louis Cardinals,CARDS,2,4,4,8,2002,2009,7,No,0,23.28,30.12,6.84,951,826,-125,3803,3406,-397,107.0,0.0,-107.0,7000000.0,0.0,-7000000.0
<a href=/player/smitb005>smitb005</a>,Burch Smith,San Diego Padres,PADRS,3,7,6,13,2014,2020,6,Yes,0,-1.53,-1.48,0.05,295,146,-149,1021,301,-720,0.0,78.0,78.0,506400.0,0.0,-506400.0
<a href=/player/smitb005>smitb005</a>,Burch Smith,New York Mets,METS,1,1,1,2,2017,2017,0,No,0,-1.09,0.0,1.09,40,0,-40,0,0,0,234.0,0.0,-234.0,0.0,0.0,0.0
<a href=/player/smitb006>smitb006</a>,Blake Smith,Los Angeles Dodgers,DOGRS,1,1,1,2,2015,2015,0,No,0,-0.04,-0.2,-0.16,6,2,-4,0,1,1,13.0,10.0,-3.0,0.0,0.0,0.0
<a href=/player/smitb104>smitb104</a>,Bobby Smith,St. Louis Cardinals,CARDS,1,2,1,3,1959,1963,4,No,0,1.18,3.25,2.07,225,305,80,435,785,350,151.0,0.0,-151.0,9000.0,0.0,-9000.0
<a href=/player/smitb104>smitb104</a>,Bobby Smith,New York Mets,METS,4,6,5,11,1962,1970,8,No,0,-0.09,3.45,3.54,269,654,385,400,1331,931,516.0,1427.0,911.0,10500.0,0.0,-10500.0
<a href=/player/smitb104>smitb104</a>,Bobby Smith,Chicago Cubs,CUBS,5,10,7,17,1962,1977,15,No,0,11.99,38.79,26.8,728,2444,1716,383,6330,5947,3515.0,5246.0,1731.0,122500.0,0.0,-122500.0
<a href=/player/smitb105>smitb105</a>,Bernie Smith,New York Mets,METS,1,1,1,2,1969,1969,0,No,0,0.02,0.0,-0.02,59,0,-59,127,0,-127,0.0,0.0,0.0,0.0,0.0,0.0
<a href=/player/smitb108>smitb108</a>,Bob Smith,Boston Red Sox,RSOX,1,1,1,2,1959,1959,0,No,0,-0.33,0.0,0.33,2,0,-2,0,0,0,2.0,0.0,-2.0,0.0,0.0,0.0
<a href=/player/smitb108>smitb108</a>,Bob Smith,Chicago Cubs,CUBS,1,1,1,2,1959,1959,0,No,0,-0.45,0.16,0.61,24,41,17,6,91,85,88.0,0.0,-88.0,0.0,0.0,0.0
<a href=/player/smitb110>smitb110</a>,Bob Smith,Boston Braves,BRAVES,5,9,7,16,1930,1938,8,No,0,10.35,19.77,9.42,741,1862,1121,2307,7255,4948,1075.0,89.0,-986.0,16000.0,0.0,-16000.0
<a href=/player/smitb110>smitb110</a>,Bob Smith,Chicago Cubs,CUBS,2,7,3,10,1932,1941,9,No,0,3.2,27.52,24.32,621,896,275,1233,2014,781,2473.0,4458.0,1985.0,0.0,0.0,0.0
<a href=/player/smitb111>smitb111</a>,Bull Smith,Wheeling,Wheeling,1,1,2,3,1906,1906,0,No,0,0.0,0.0,0.0,1,0,-1,1,0,-1,0.0,0.0,0.0,0.0,0.0,0.0
<a href=/player/smitb112>smitb112</a>,Bill Smith,St. Louis Cardinals,CARDS,1,2,1,3,1959,1963,4,No,0,1.18,3.25,2.07,225,305,80,435,785,350,151.0,0.0,-151.0,9000.0,0.0,-9000.0
<a href=/player/smitc001>smitc001</a>,Chuck Smith,Texas Rangers,RNGRS,3,3,3,6,2000,2001,1,No,0,3.28,0.5,-2.78,168,38,-130,378,134,-244,632.0,0.0,-632.0,0.0,0.0,0.0
<a href=/player/smitc004>smitc004</a>,Carson Smith,Seattle Mariners,MARNRS,2,3,3,6,2015,2018,3,No,0,-0.47,2.16,2.63,84,70,-14,9,13,4,729.0,1001.0,272.0,0.0,0.0,0.0
<a href=/player/smitc006>smitc006</a>,Caleb Smith,New York Yankees,YANKS,1,2,2,4,2017,2017,0,Yes,0,5.67,0.0,-5.67,313,0,-313,917,0,-917,701.0,0.0,-701.0,0.0,0.0,0.0
<a href=/player/smitc006>smitc006</a>,Caleb Smith,Miami Marlins,MARLNS,2,4,2,6,2020,2021,1,Yes,0,2.61,2.79,0.18,160,115,-45,284,406,122,441.0,172.0,-269.0,0.0,0.0,0.0
<a href=/player/smitc101>smitc101</a>,Chris Smith,Texas Rangers,RNGRS,2,3,2,5,1980,1980,0,No,1,-0.15,1.32,1.47,9,109,100,9,388,379,0.0,0.0,0.0,0.0,0.0,0.0
<a href=/player/smitc101>smitc101</a>,Chris Smith,Montreal Expos,NATEX,1,1,1,2,1983,1986,3,No,0,0.33,1.35,1.02,22,318,296,77,626,549,0.0,0.0,0.0,0.0,0.0,0.0
<a href=/player/smitc103>smitc103</a>,Carr Smith,Washington Senators,TWINS,1,2,1,3,1924,1927,3,No,0,1.24,9.07,7.83,60,146,86,31,190,159,281.0,1502.0,1221.0,2100.0,0.0,-2100.0
<a href=/player/smitc105>smitc105</a>,Charley Smith,Los Angeles Dodgers,DOGRS,2,3,3,6,1961,1962,1,No,0,7.87,-0.43,-8.3,525,100,-425,2040,21,-2019,0.0,267.0,267.0,6000.0,0.0,-6000.0
<a href=/player/smitc105>smitc105</a>,Charley Smith,Philadelphia Phillies,PHILS,1,2,1,3,1961,1964,3,No,0,5.78,3.33,-2.45,417,331,-86,480,1188,708,2599.0,0.0,-2599.0,0.0,0.0,0.0
<a href=/player/smitc105>smitc105</a>,Charley Smith,Chicago White Sox,WSOX,1,1,3,4,1964,1964,0,No,0,2.83,0.0,-2.83,262,0,-262,1002,0,-1002,0.0,0.0,0.0,10000.0,0.0,-10000.0
<a href=/player/smitc105>smitc105</a>,Charley Smith,New York Mets,METS,3,5,4,9,1965,1970,5,No,0,3.02,4.23,1.21,629,336,-293,1532,1195,-337,1019.0,0.0,-1019.0,88000.0,0.0,-88000.0
<a href=/player/smitc105>smitc105</a>,Charley Smith,St. Louis Cardinals,CARDS,1,1,1,2,1966,1966,0,No,0,1.2,0.0,-1.2,181,0,-181,541,0,-541,0.0,0.0,0.0,20000.0,0.0,-20000.0
<a href=/player/smitc105>smitc105</a>,Charley Smith,New York Yankees,YANKS,2,2,2,4,1968,1969,1,No,0,-0.33,0.0,0.33,44,1,-43,49,1,-48,0.0,0.0,0.0,41000.0,0.0,-41000.0
<a href=/player/smitc107>smitc107</a>,Charlie Smith,Washington Senators,TWINS,1,1,1,2,1909,1912,3,No,0,2.19,5.78,3.59,56,290,234,66,1206,1140,550.0,0.0,-550.0,0.0,0.0,0.0
<a href=/player/smitd003>smitd003</a>,Dwight Smith,California Angels,ANGELS,1,1,1,2,1994,1994,0,No,0,0.18,0.0,-0.18,28,0,-28,80,0,-80,0.0,0.0,0.0,755718.0,0.0,-755718.0
<a href=/player/smitd007>smitd007</a>,Dwight Smith Jr.,Toronto Blue Jays,BJAYS,1,1,1,2,2019,2019,0,No,0,-1.05,0.0,1.05,122,0,-122,464,0,-464,0.0,0.0,0.0,0.0,0.0,0.0
<a href=/player/smitd009>smitd009</a>,Drew Smith,Detroit Tigers,TIGRS,1,1,1,2,2017,2019,2,No,0,0.0,0.11,0.11,0,185,185,0,654,654,0.0,0.0,0.0,0.0,0.0,0.0
<a href=/player/smitd009>smitd009</a>,Drew Smith,Tampa Bay Devil Rays,RAYS,1,1,1,2,2017,2017,0,No,0,1.12,0.13,-0.99,119,52,-67,1,200,199,229.0,0.0,-229.0,0.0,0.0,0.0
<a href=/player/smitd104>smitd104</a>,Dick Smith,New York Mets,METS,1,1,1,2,1964,1964,0,No,0,-0.22,0.0,0.22,10,0,-10,7,0,-7,0.0,0.0,0.0,0.0,0.0,0.0
<a href=/player/smitd104>smitd104</a>,Dick Smith,Los Angeles Dodgers,DOGRS,1,1,1,2,1967,1967,0,No,0,0.0,0.0,0.0,0,0,0,0,0,0,0.0,0.0,0.0,0.0,0.0,0.0
<a href=/player/smite104>smite104</a>,Elmer Smith,Cleveland Indians,INDINS,1,2,2,4,1916,1916,0,No,0,1.57,0.61,-0.96,293,50,-243,1105,56,-1049,0.0,182.0,182.0,0.0,0.0,0.0
<a href=/player/smite104>smite104</a>,Elmer Smith,Cleveland Indians,INDINS,1,3,1,4,1921,1923,2,No,0,18.85,0.33,-18.52,768,142,-626,3109,582,-2527,0.0,0.0,0.0,10000.0,0.0,-10000.0
<a href=/player/smite104>smite104</a>,Elmer Smith,Boston Red Sox,RSOX,3,7,10,17,1922,1935,13,No,0,18.05,-3.44,-21.49,1736,754,-982,6924,2797,-4127,0.0,159.0,159.0,16300.0,0.0,-16300.0
<a href=/player/smite104>smite104</a>,Elmer Smith,New York Yankees,YANKS,1,2,1,3,1924,1924,0,No,0,0.0,0.38,0.38,0,24,24,0,39,39,0.0,0.0,0.0,0.0,0.0,0.0
<a href=/player/smite106>smite106</a>,Earl Smith,Rochester,Rochester,1,1,6,7,1919,1938,19,No,0,4.82,0.0,-4.82,315,0,-315,900,0,-900,0.0,0.0,0.0,0.0,0.0,0.0
<a href=/player/smite106>smite106</a>,Earl Smith,New York Giants,GIANTS,1,2,2,4,1923,1923,0,No,0,10.49,3.07,-7.42,305,87,-218,539,194,-345,2035.0,323.0,-1712.0,12500.0,0.0,-12500.0
<a href=/player/smite107>smite107</a>,Earl Smith,St.Louis Browns,ORLS,1,1,1,2,1921,1924,3,No,0,-1.27,-0.22,1.05,124,235,111,416,999,583,0.0,0.0,0.0,4200.0,0.0,-4200.0
<a href=/player/smitf104>smitf104</a>,Frank Smith,Cincinnati Reds,REDS,6,10,16,26,1954,1965,11,No,0,65.0,15.82,-49.18,3249,1819,-1430,9927,3953,-5974,2863.0,1424.0,-1439.0,10000.0,0.0,-10000.0
<a href=/player/smitf106>smitf106</a>,Frank Smith,Chicago White Sox,WSOX,1,2,2,4,1910,1915,5,No,0,0.0,10.22,10.22,86,540,454,299,2308,2009,88.0,0.0,-88.0,0.0,0.0,0.0
<a href=/player/smitg001>smitg001</a>,Greg Smith,Chicago Cubs,CUBS,2,2,3,5,1990,1995,5,No,0,2.23,3.37,1.14,339,434,95,1423,1118,-305,0.0,468.0,468.0,0.0,0.0,0.0
<a href=/player/smitg002>smitg002</a>,Greg Smith,Arizona Diamondbacks,DBACKS,6,14,16,30,2007,2018,11,Yes,0,24.99,30.17,5.18,855,1190,335,1319,2038,719,6760.0,6326.0,-434.0,14741000.0,0.0,-14741000.0
<a href=/player/smitg002>smitg002</a>,Greg Smith,Oakland Athletics,ATLTCS,6,8,8,16,2008,2014,6,Yes,0,50.06,1.09,-48.97,2622,167,-2455,9256,628,-8628,794.0,101.0,-693.0,16800000.0,0.0,-16800000.0
<a href=/player/smitg101>smitg101</a>,George Smith,Detroit Tigers,TIGRS,1,3,1,4,1965,1967,2,No,0,0.26,-0.68,-0.94,350,64,-286,935,31,-904,0.0,314.0,314.0,32800.0,0.0,-32800.0
<a href=/player/smitg103>smitg103</a>,Germany Smith,Cincinnati Reds,REDS,1,3,1,4,1896,1906,10,No,0,0.1,7.82,7.72,152,1229,1077,519,5155,4636,447.0,0.0,-447.0,0.0,0.0,0.0
<a href=/player/smitg104>smitg104</a>,George Smith,New York Giants,GIANTS,2,7,2,9,1919,1926,7,No,0,9.28,14.26,4.98,1335,470,-865,2807,556,-2251,5840.0,4330.0,-1510.0,10442.0,0.0,-10442.0
<a href=/player/smitg104>smitg104</a>,George Smith,Philadelphia Phillies,PHILS,1,1,1,2,1923,1928,5,No,0,0.11,9.33,9.22,50,371,321,27,424,397,273.0,2366.0,2093.0,0.0,0.0,0.0
<a href=/player/smith101>smith101</a>,Happy Smith,Chicago Cubs,CUBS,1,3,1,4,1910,1912,2,No,0,-2.31,2.43,4.74,377,121,-256,1406,145,-1261,0.0,1039.0,1039.0,0.0,0.0,0.0
<a href=/player/smith104>smith104</a>,Harry Smith,Milwaukee,Milwaukee,1,1,1,2,1900,1900,0,No,0,-0.17,0.0,0.17,178,0,-178,644,0,-644,0.0,0.0,0.0,0.0,0.0,0.0
<a href=/player/smith106>smith106</a>,Hal Smith,New York Yankees,YANKS,12,33,27,60,1954,1970,16,No,0,40.55,76.98,36.43,5201,4368,-833,16466,10777,-5689,3212.0,10751.0,7539.0,302500.0,0.0,-302500.0
<a href=/player/smith106>smith106</a>,Hal Smith,Baltimore Orioles,ORLS,1,1,1,2,1956,1960,4,No,0,2.11,-0.69,-2.8,351,240,-111,1215,585,-630,0.0,0.0,0.0,12500.0,0.0,-12500.0
<a href=/player/smith106>smith106</a>,Hal Smith,Kansas City Athletics,ATLTCS,5,7,8,15,1959,1963,4,No,0,12.25,-4.01,-16.26,1107,620,-487,1242,1389,147,2603.0,1481.0,-1122.0,16500.0,0.0,-16500.0
<a href=/player/smith110>smith110</a>,Heinie Smith,New York Giants,GIANTS,1,1,1,2,1903,1903,0,No,0,-0.14,0.0,0.14,93,0,-93,376,0,-376,0.0,0.0,0.0,0.0,0.0,0.0
<a href=/player/smitj001>smitj001</a>,Jason Smith,Chicago Cubs,CUBS,1,2,1,3,2001,2002,1,No,0,-0.39,3.26,3.65,27,195,168,73,796,723,0.0,0.0,0.0,665000.0,0.0,-665000.0
<a href=/player/smitj002>smitj002</a>,Joe Smith,New York Mets,METS,1,7,3,10,2008,2010,2,No,0,7.03,-1.25,-8.28,462,358,-104,389,179,-210,868.0,325.0,-543.0,3398000.0,0.0,-3398000.0
<a href=/player/smitj002>smitj002</a>,Joe Smith,Anaheim Angels,ANGELS,1,1,1,2,2016,2016,0,Yes,0,0.27,0.0,-0.27,31,0,-31,0,0,0,43.0,0.0,-43.0,0.0,0.0,0.0
<a href=/player/smitj002>smitj002</a>,Joe Smith,Toronto Blue Jays,BJAYS,1,1,2,3,2017,2020,3,Yes,0,0.32,0.5,0.18,21,52,31,0,0,0,55.0,348.0,293.0,3000000.0,0.0,-3000000.0
<a href=/player/smitj002>smitj002</a>,Joe Smith,Houston Astros,ASTROS,1,2,2,4,2021,2021,0,Yes,0,1.64,0.78,-0.86,83,33,-50,253,0,-253,54.0,87.0,33.0,4000000.0,0.0,-4000000.0
<a href=/player/smitj107>smitj107</a>,Jimmy Smith,Chicago Whales,CHF,1,2,1,3,1915,1916,1,No,0,0.0,0.08,0.08,0,24,24,0,92,92,0.0,0.0,0.0,0.0,0.0,0.0
<a href=/player/smitj107>smitj107</a>,Jimmy Smith,Boston Braves,BRAVES,1,2,1,3,1919,1922,3,No,0,0.38,-0.18,-0.56,28,536,508,48,2218,2170,0.0,0.0,0.0,0.0,0.0,0.0
<a href=/player/smitj107>smitj107</a>,Jimmy Smith,Philadelphia Phillies,PHILS,4,9,8,17,1922,1936,14,No,0,25.37,3.27,-22.1,1352,2052,700,5364,8721,3357,77.0,0.0,-77.0,43100.0,0.0,-43100.0
<a href=/player/smitj110>smitj110</a>,John Smith,Boston Red Sox,RSOX,1,2,1,3,1931,1931,0,No,0,0.0,0.0,0.0,0,0,0,0,0,0,0.0,0.0,0.0,2400.0,0.0,-2400.0
<a href=/player/smitk101>smitk101</a>,Keith Smith,Texas Rangers,RNGRS,1,1,1,2,1979,1979,0,No,0,-0.27,0.0,0.27,30,0,-30,46,0,-46,0.0,0.0,0.0,0.0,0.0,0.0
<a href=/player/smitl001>smitl001</a>,Lee Smith,Chicago Cubs,CUBS,2,4,4,8,1987,1992,5,No,0,11.91,1.25,-10.66,771,664,-107,1598,1497,-101,888.0,975.0,87.0,1240000.0,0.0,-1240000.0
<a href=/player/smitl001>smitl001</a>,Lee Smith,Boston Red Sox,RSOX,1,1,1,2,1990,1992,2,No,0,4.33,3.1,-1.23,490,409,-81,4,1578,1574,800.0,0.0,-800.0,1200000.0,0.0,-1200000.0
<a href=/player/smitl001>smitl001</a>,Lee Smith,St. Louis Cardinals,CARDS,2,4,4,8,1993,1997,4,No,0,0.24,-1.47,-1.71,433,153,-280,688,182,-506,209.0,191.0,-18.0,7634167.0,0.0,-7634167.0
<a href=/player/smitl001>smitl001</a>,Lee Smith,California Angels,ANGELS,2,3,3,6,1996,1998,2,No,0,1.77,2.75,0.98,237,228,-9,342,727,385,311.0,157.0,-154.0,3192000.0,0.0,-3192000.0
<a href=/player/smitl002>smitl002</a>,Lonnie Smith,Philadelphia Phillies,PHILS,5,9,9,18,1981,1988,7,No,0,19.34,6.22,-13.12,1697,579,-1118,5512,1540,-3972,737.0,444.0,-293.0,1380000.0,0.0,-1380000.0
<a href=/player/smitl002>smitl002</a>,Lonnie Smith,St. Louis Cardinals,CARDS,1,1,1,2,1985,1990,5,No,0,3.36,0.07,-3.29,302,274,-28,1263,462,-801,0.0,0.0,0.0,740000.0,0.0,-740000.0
<a href=/player/smitl002>smitl002</a>,Lonnie Smith,Pittsburgh Pirates,PIRATS,1,1,2,3,1993,1993,0,No,0,-0.1,0.0,0.1,44,0,-44,104,0,-104,0.0,0.0,0.0,1000000.0,0.0,-1000000.0
<a href=/player/smitm001>smitm001</a>,Mike Smith,Cincinnati Reds,REDS,1,1,1,2,1986,1986,0,No,0,0.06,0.0,-0.06,10,0,-10,2,0,-2,26.0,0.0,-26.0,0.0,0.0,0.0
<a href=/player/smitm001>smitm001</a>,Mike Smith,Montreal Expos,NATEX,1,1,1,2,1988,1988,0,No,0,0.0,0.0,0.0,0,0,0,0,0,0,0.0,0.0,0.0,0.0,0.0,0.0
<a href=/player/smitm001>smitm001</a>,Mike Smith,Baltimore Orioles,ORLS,1,1,1,2,1989,1989,0,No,0,-0.2,0.0,0.2,32,0,-32,3,0,-3,72.0,0.0,-72.0,0.0,0.0,0.0
<a href=/player/smitm002>smitm002</a>,Mike Smithson,Boston Red Sox,RSOX,1,1,1,2,1982,1985,3,No,0,2.77,1.72,-1.05,41,64,23,0,0,0,810.0,351.0,-459.0,0.0,0.0,0.0
<a href=/player/smitm002>smitm002</a>,Mike Smithson,Texas Rangers,RNGRS,2,4,3,7,1983,1992,9,No,2,7.12,7.75,0.63,212,425,213,0,1729,1729,3956.0,28.0,-3928.0,0.0,0.0,0.0
<a href=/player/smitm004>smitm004</a>,Mark Smith,Baltimore Orioles,ORLS,1,1,1,2,1997,1997,0,No,0,0.0,0.0,0.0,0,0,0,0,0,0,0.0,0.0,0.0,0.0,0.0,0.0
<a href=/player/smitm004>smitm004</a>,Mark Smith,San Diego Padres,PADRS,13,19,19,38,1997,2005,8,No,0,0.7,9.11,8.41,1015,1374,359,2046,2428,382,1171.0,1867.0,696.0,13510000.0,0.0,-13510000.0
<a href=/player/smitm006>smitm006</a>,Matt Smith,New York Yankees,YANKS,1,4,2,6,2006,2008,2,No,0,0.06,7.5,7.44,46,382,336,0,1631,1631,38.0,136.0,98.0,0.0,0.0,0.0
<a href=/player/smitm007>smitm007</a>,Mallex Smith,San Diego Padres,PADRS,1,4,2,6,2014,2016,2,No,0,14.14,4.21,-9.93,618,150,-468,1586,620,-966,1341.0,0.0,-1341.0,0.0,0.0,0.0
<a href=/player/smitm007>smitm007</a>,Mallex Smith,Atlanta Braves,BRAVES,1,2,2,4,2017,2019,2,Yes,0,-0.62,-0.29,0.33,157,27,-130,613,12,-601,23.0,147.0,124.0,0.0,0.0,0.0
<a href=/player/smitm007>smitm007</a>,Mallex Smith,Seattle Mariners,MARNRS,1,3,1,4,2017,2017,0,No,0,6.86,0.0,-6.86,335,0,-335,833,0,-833,1499.0,0.0,-1499.0,0.0,0.0,0.0
<a href=/player/smitm007>smitm007</a>,Mallex Smith,Tampa Bay Devil Rays,RAYS,2,3,5,8,2018,2021,3,Yes,0,0.34,0.28,-0.06,245,235,-10,948,604,-344,0.0,88.0,88.0,0.0,0.0,0.0
<a href=/player/smitm101>smitm101</a>,Mark Smith,Baltimore Orioles,ORLS,1,1,1,2,1983,1983,0,No,0,-0.27,0.0,0.27,8,0,-8,0,0,0,44.0,0.0,-44.0,0.0,0.0,0.0
<a href=/player/smitm102>smitm102</a>,Milt Smith,Cincinnati Reds,REDS,1,1,1,2,1956,1956,0,No,0,0.0,0.39,0.39,0,22,22,0,6,6,0.0,81.0,81.0,0.0,0.0,0.0
<a href=/player/smitm104>smitm104</a>,Mike Smith,Pittsburgh Pirates,PIRATS,3,8,7,15,1897,1910,13,No,0,26.73,36.51,9.78,1261,2039,778,4478,8482,4004,3164.0,936.0,-2228.0,0.0,0.0,0.0
<a href=/player/smitm105>smitm105</a>,Mayo Smith,Philadelphia Athletics,ATLTCS,1,2,1,3,1945,1945,0,No,0,0.0,0.0,0.0,0,0,0,0,0,0,0.0,0.0,0.0,17200.0,0.0,-17200.0
<a href=/player/smito001>smito001</a>,Ozzie Smith,San Diego Padres,PADRS,7,12,13,25,1981,1993,12,No,1,64.79,33.72,-31.07,2384,3112,728,8892,7842,-1050,1163.0,2653.0,1490.0,905000.0,0.0,-905000.0
<a href=/player/smitp001>smitp001</a>,Pete Smith,Philadelphia Phillies,PHILS,7,11,13,24,1985,2002,17,No,0,26.27,18.31,-7.96,2374,2693,319,6477,5504,-973,2850.0,5172.0,2322.0,2160000.0,0.0,-2160000.0
<a href=/player/smitp001>smitp001</a>,Pete Smith,Atlanta Braves,BRAVES,1,1,1,2,1993,1994,1,No,0,0.01,-0.1,-0.11,42,89,47,47,177,130,394.0,0.0,-394.0,1025000.0,0.0,-1025000.0
<a href=/player/smitp001>smitp001</a>,Pete Smith,San Diego Padres,PADRS,1,1,1,2,1998,1998,0,No,0,-0.26,0.0,0.26,28,0,-28,2,0,-2,135.0,0.0,-135.0,975000.0,0.0,-975000.0
<a href=/player/smitr001>smitr001</a>,Roy Smith,Philadelphia Phillies,PHILS,3,6,5,11,1982,1987,5,No,0,5.02,15.9,10.88,358,462,104,942,672,-270,1316.0,2480.0,1164.0,1109333.0,0.0,-1109333.0
<a href=/player/smitr001>smitr001</a>,Roy Smith,Cleveland Indians,INDINS,1,2,2,4,1986,1988,2,No,0,3.92,1.63,-2.29,86,69,-17,0,0,0,1168.0,825.0,-343.0,0.0,0.0,0.0
<a href=/player/smitr101>smitr101</a>,Reggie Smith,Boston Red Sox,RSOX,5,10,8,18,1973,1987,14,No,0,23.48,30.66,7.18,1104,1173,69,2926,3213,287,3997.0,6340.0,2343.0,120000.0,0.0,-120000.0
<a href=/player/smitr101>smitr101</a>,Reggie Smith,St. Louis Cardinals,CARDS,3,5,7,12,1976,1978,2,No,0,31.74,-0.14,-31.88,908,133,-775,3459,264,-3195,0.0,236.0,236.0,0.0,0.0,0.0
<a href=/player/smitr102>smitr102</a>,Ray Smith,Minnesota Twins,TWINS,1,1,1,2,1984,1984,0,No,0,0.0,0.0,0.0,0,0,0,0,0,0,0.0,0.0,0.0,0.0,0.0,0.0
<a href=/player/smitr107>smitr107</a>,Red Smith,Philadelphia Athletics,ATLTCS,1,4,1,5,1925,1925,0,No,0,0.0,0.15,0.15,0,133,133,0,522,522,0.0,0.0,0.0,4850.0,0.0,-4850.0
<a href=/player/smits002>smits002</a>,Seth Smith,Colorado Rockies,ROCKS,2,2,3,5,2012,2015,3,No,0,2.63,2.18,-0.45,275,399,124,851,568,-283,74.0,434.0,360.0,675000.0,0.0,-675000.0
<a href=/player/smits002>smits002</a>,Seth Smith,Oakland Athletics,ATLTCS,1,1,1,2,2013,2014,1,No,0,3.42,1.75,-1.67,136,75,-61,521,0,-521,0.0,217.0,217.0,3675000.0,0.0,-3675000.0
<a href=/player/smits002>smits002</a>,Seth Smith,San Diego Padres,PADRS,2,4,5,9,2014,2017,3,Yes,0,0.75,-0.96,-1.71,380,340,-40,891,17,-874,304.0,637.0,333.0,8694700.0,0.0,-8694700.0
<a href=/player/smits002>smits002</a>,Seth Smith,Seattle Mariners,MARNRS,1,1,2,3,2017,2017,0,No,0,0.55,-0.25,-0.8,111,29,-82,373,2,-371,0.0,392.0,392.0,0.0,0.0,0.0
<a href=/player/smits101>smits101</a>,Syd Smith,Philadelphia Athletics,ATLTCS,1,1,1,2,1908,1908,0,No,0,-0.11,-0.23,-0.12,27,6,-21,83,19,-64,0.0,0.0,0.0,0.0,0.0,0.0
<a href=/player/smitt101>smitt101</a>,Tony Smith,Chicago Cubs,CUBS,1,3,1,4,1910,1912,2,No,0,-2.31,2.43,4.74,377,121,-256,1406,145,-1261,0.0,1039.0,1039.0,0.0,0.0,0.0
<a href=/player/smitt104>smitt104</a>,Tom Smith,Philadelphia Phillies,PHILS,1,1,1,2,1896,1896,0,No,0,-0.71,-0.35,0.36,26,6,-20,43,5,-38,165.0,31.0,-134.0,0.0,0.0,0.0
<a href=/player/smitv101>smitv101</a>,Vinnie Smith,Memphis,Memphis,1,1,2,3,1941,1942,1,No,0,-0.37,0.0,0.37,16,0,-16,56,0,-56,0.0,0.0,0.0,0.0,0.0,0.0
<a href=/player/smitw001>smitw001</a>,Willie Smith,Pittsburgh Pirates,PIRATS,1,2,1,3,1989,1995,6,No,0,1.53,10.25,8.72,54,475,421,0,1624,1624,266.0,0.0,-266.0,750000.0,0.0,-750000.0
<a href=/player/smitw002>smitw002</a>,Will Smith,Anaheim Angels,ANGELS,2,3,2,5,2010,2015,5,No,0,-1.93,6.97,8.9,238,527,289,631,1904,1273,756.0,0.0,-756.0,0.0,0.0,0.0
<a href=/player/smitw002>smitw002</a>,Will Smith,Kansas City Royals,ROYALS,1,1,1,2,2013,2014,1,No,0,0.94,1.13,0.19,350,132,-218,0,549,549,453.0,0.0,-453.0,0.0,0.0,0.0
<a href=/player/smitw002>smitw002</a>,Will Smith,Milwaukee Brewers,BREWRS,2,2,3,5,2016,2021,5,No,0,3.2,-0.35,-3.55,287,20,-267,28,31,3,410.0,6.0,-404.0,0.0,0.0,0.0
<a href=/player/smitw102>smitw102</a>,Willie Smith,Detroit Tigers,TIGRS,2,3,3,6,1964,1970,6,No,0,3.45,15.01,11.56,452,407,-45,1371,422,-949,95.0,3100.0,3005.0,0.0,0.0,0.0
<a href=/player/smitw102>smitw102</a>,Willie Smith,Cleveland Indians,INDINS,2,2,2,4,1968,1972,4,No,0,-0.38,2.04,2.42,313,354,41,710,741,31,8.0,0.0,-8.0,0.0,0.0,0.0
<a href=/player/smitw102>smitw102</a>,Willie Smith,Chicago Cubs,CUBS,1,1,1,2,1970,1973,3,No,0,-0.33,-0.52,-0.19,31,25,-6,58,79,21,0.0,0.0,0.0,11250.0,0.0,-11250.0
<a href=/player/smitw102>smitw102</a>,Willie Smith,California Angels,ANGELS,1,1,1,2,1966,1966,0,No,0,-0.91,0.0,0.91,56,0,-56,80,0,-80,15.0,0.0,-15.0,16000.0,0.0,-16000.0
<a href=/player/smitz001>smitz001</a>,Zane Smith,Atlanta Braves,BRAVES,3,5,5,10,1989,1992,3,No,0,3.39,-0.63,-4.02,121,128,7,51,1,-50,748.0,253.0,-495.0,650000.0,0.0,-650000.0
<a href=/player/smitz001>smitz001</a>,Zane Smith,Montreal Expos,NATEX,5,9,12,21,1990,2001,11,No,3,22.14,26.5,4.36,1780,1723,-57,4275,2818,-1457,3008.0,1716.0,-1292.0,1435000.0,0.0,-1435000.0
<a href=/player/smoaj001>smoaj001</a>,Justin Smoak,Texas Rangers,RNGRS,2,5,4,9,2010,2012,2,No,2,2.66,1.99,-0.67,576,111,-465,1946,0,-1946,977.0,588.0,-389.0,0.0,0.0,0.0
<a href=/player/smokj001>smokj001</a>,Josh Smoker,New York Mets,METS,1,1,2,3,2018,2021,3,No,0,-0.37,0.3,0.67,13,65,52,0,0,0,17.0,53.0,36.0,0.0,0.0,0.0
<a href=/player/smolj001>smolj001</a>,John Smoltz,Detroit Tigers,TIGRS,1,1,1,2,1987,1989,2,No,0,69.53,6.3,-63.23,1409,78,-1331,1151,0,-1151,10185.0,1621.0,-8564.0,0.0,0.0,0.0
<a href=/player/smolj002>smolj002</a>,Jake Smolinski,Washington Nationals,NATEX,3,5,5,10,2008,2013,5,Yes,0,5.63,4.16,-1.47,562,556,-6,2188,1050,-1138,12.0,770.0,758.0,5101000.0,0.0,-5101000.0
<a href=/player/smooh101>smooh101</a>,Homer Smoot,St. Louis Cardinals,CARDS,1,1,1,2,1906,1908,2,No,0,0.15,-0.34,-0.49,60,217,157,238,895,657,0.0,0.0,0.0,0.0,0.0,0.0
<a href=/player/smyld001>smyld001</a>,Drew Smyly,Detroit Tigers,TIGRS,3,5,5,10,2014,2021,7,Yes,0,13.54,10.17,-3.37,428,201,-227,1262,19,-1243,1153.0,2223.0,1070.0,29745000.0,0.0,-29745000.0
<a href=/player/smyld001>smyld001</a>,Drew Smyly,Tampa Bay Devil Rays,RAYS,3,4,8,12,2017,2021,4,Yes,0,0.34,5.04,4.7,245,457,212,948,1430,482,0.0,88.0,88.0,0.0,0.0,0.0
<a href=/player/smyld001>smyld001</a>,Drew Smyly,Chicago Cubs,CUBS,1,2,1,3,2018,2018,0,No,0,-0.69,0.0,0.69,14,0,-14,1,0,-1,154.0,0.0,-154.0,0.0,0.0,0.0
<a href=/player/smytr101>smytr101</a>,Red Smyth,St. Louis Cardinals,CARDS,1,2,2,4,1918,1918,0,No,0,0.0,-0.15,-0.15,0,31,31,0,60,60,0.0,69.0,69.0,0.0,0.0,0.0
<a href=/player/smyts001>smyts001</a>,Steve Smyth,Chicago Cubs,CUBS,2,4,3,7,2004,2004,0,No,0,1.21,-0.22,-1.43,97,23,-74,6,19,13,216.0,5.0,-211.0,300000.0,0.0,-300000.0
<a href=/player/snarr001>snarr001</a>,Ryan Snare,Cincinnati Reds,REDS,1,3,1,4,2002,2003,1,No,0,1.48,-2.8,-4.28,415,76,-339,1688,70,-1618,0.0,613.0,613.0,2400000.0,0.0,-2400000.0
<a href=/player/snarr001>snarr001</a>,Ryan Snare,Florida Marlins,MARLNS,1,3,1,4,2003,2003,0,No,0,-0.88,2.14,3.02,60,66,6,206,2,-204,10.0,115.0,105.0,0.0,0.0,0.0
<a href=/player/sneec001>sneec001</a>,Cy Sneed,Milwaukee Brewers,BREWRS,2,4,2,6,2015,2018,3,No,0,5.08,4.56,-0.52,245,411,166,950,1528,578,133.0,0.0,-133.0,2550000.0,0.0,-2550000.0
<a href=/player/snelb001>snelb001</a>,Blake Snell,Tampa Bay Devil Rays,RAYS,1,1,4,5,2020,2020,0,Yes,0,1.28,0.0,-1.28,52,0,-52,37,0,-37,386.0,0.0,-386.0,7600000.0,0.0,-7600000.0
<a href=/player/snelc001>snelc001</a>,Chris Snelling,Seattle Mariners,MARNRS,1,2,2,4,2006,2008,2,No,0,-0.42,0.87,1.29,24,232,208,61,955,894,0.0,0.0,0.0,328500.0,0.0,-328500.0
<a href=/player/snelc001>snelc001</a>,Chris Snelling,Washington Nationals,NATEX,6,10,9,19,2007,2020,13,Yes,0,4.33,17.52,13.19,559,1541,982,715,1832,1117,1207.0,2502.0,1295.0,9181616.0,0.0,-9181616.0
<a href=/player/sneli001>sneli001</a>,Ian Snell,Pittsburgh Pirates,PIRATS,1,2,5,7,2009,2012,3,No,0,2.82,0.94,-1.88,179,390,211,514,1304,790,332.0,0.0,-332.0,10600000.0,0.0,-10600000.0
<a href=/player/snidt001>snidt001</a>,Travis Snider,Toronto Blue Jays,BJAYS,4,7,5,12,2012,2015,3,No,0,-0.1,0.42,0.52,371,228,-143,854,423,-431,111.0,275.0,164.0,510200.0,0.0,-510200.0
<a href=/player/snidt001>snidt001</a>,Travis Snider,Pittsburgh Pirates,PIRATS,3,4,5,9,2015,2018,3,Yes,0,3.04,3.15,0.11,137,138,1,241,140,-101,662.0,1238.0,576.0,9167000.0,0.0,-9167000.0
<a href=/player/snidv001>snidv001</a>,Van Snider,Kansas City Royals,ROYALS,1,1,1,2,1988,1999,11,No,0,-0.11,20.89,21.0,19,697,678,36,0,-36,0.0,2548.0,2548.0,0.0,0.0,0.0
<a href=/player/snidv001>snidv001</a>,Van Snider,Cincinnati Reds,REDS,1,2,2,4,1989,1997,8,No,0,0.48,12.7,12.22,78,910,832,0,3572,3572,1277.0,0.0,-1277.0,0.0,0.0,0.0
<a href=/player/snopc001>snopc001</a>,Chris Snopek,Chicago White Sox,WSOX,1,1,1,2,1998,1998,0,No,0,-0.08,0.0,0.08,8,0,-8,14,0,-14,0.0,0.0,0.0,190000.0,0.0,-190000.0
<a href=/player/snowj001>snowj001</a>,J.T. Snow,New York Yankees,YANKS,1,3,1,4,1992,1994,2,No,0,-1.97,3.42,5.39,549,56,-493,1984,0,-1984,509.0,1123.0,614.0,0.0,0.0,0.0
<a href=/player/snowj001>snowj001</a>,J.T. Snow,Anaheim Angels,ANGELS,1,1,2,3,1996,1998,2,No,0,12.44,0.96,-11.48,1183,63,-1120,4497,0,-4497,0.0,874.0,874.0,725000.0,0.0,-725000.0
<a href=/player/snydb101>snydb101</a>,Bernie Snyder,Philadelphia Athletics,ATLTCS,1,2,1,3,1935,1938,3,No,0,0.0,-0.88,-0.88,0,163,163,0,516,516,0.0,0.0,0.0,0.0,0.0,0.0
<a href=/player/snydb102>snydb102</a>,Bill Snyder,Washington Senators,TWINS,3,6,4,10,1920,1933,13,No,0,2.2,13.36,11.16,219,847,628,852,3211,2359,0.0,616.0,616.0,2000.0,0.0,-2000.0
<a href=/player/snydc001>snydc001</a>,Cory Snyder,Cleveland Indians,INDINS,1,2,2,4,1990,1992,2,No,0,-0.52,2.03,2.55,50,76,26,126,0,-126,0.0,701.0,701.0,700000.0,0.0,-700000.0
<a href=/player/snydc001>snydc001</a>,Cory Snyder,Chicago White Sox,WSOX,1,1,2,3,1991,1991,0,No,0,-0.65,0.12,0.77,21,6,-15,54,0,-54,0.0,15.0,15.0,800000.0,0.0,-800000.0
<a href=/player/snydc002>snydc002</a>,Chris Snyder,Arizona Diamondbacks,DBACKS,1,3,3,6,2010,2010,0,No,0,0.71,-0.12,-0.83,105,82,-23,301,69,-232,0.0,68.0,68.0,5250000.0,0.0,-5250000.0
<a href=/player/snydc002>snydc002</a>,Chris Snyder,Anaheim Angels,ANGELS,1,1,1,2,2013,2013,0,No,0,0.02,0.0,-0.02,9,0,-9,24,0,-24,0.0,0.0,0.0,0.0,0.0,0.0
<a href=/player/snyde001>snyde001</a>,Earl Snyder,New York Mets,METS,3,9,8,17,2001,2008,7,No,0,12.43,-0.5,-12.93,1334,336,-998,2309,1012,-1297,1613.0,327.0,-1286.0,8000000.0,0.0,-8000000.0
<a href=/player/snydf101>snydf101</a>,Frank Snyder,St. Louis Cardinals,CARDS,2,3,2,5,1919,1924,5,No,0,9.75,5.6,-4.15,845,324,-521,2607,357,-2250,183.0,2844.0,2661.0,5000.0,0.0,-5000.0
<a href=/player/snydg102>snydg102</a>,Gene Snyder,Philadelphia Phillies,PHILS,1,3,1,4,1958,1958,0,No,0,-0.86,0.0,0.86,137,0,-137,129,0,-129,226.0,0.0,-226.0,0.0,0.0,0.0
<a href=/player/snydj001>snydj001</a>,John Snyder,California Angels,ANGELS,1,4,2,6,1995,1997,2,No,0,5.3,-0.85,-6.15,439,40,-399,87,0,-87,1686.0,680.0,-1006.0,0.0,0.0,0.0
<a href=/player/snydj001>snydj001</a>,John Snyder,Chicago White Sox,WSOX,1,2,2,4,2000,2004,4,No,0,-2.6,18.62,21.22,55,696,641,47,2756,2709,437.0,354.0,-83.0,0.0,0.0,0.0
<a href=/player/snydj103>snydj103</a>,Jim Snyder,Philadelphia Phillies,PHILS,1,1,1,2,1958,1958,0,No,0,0.0,0.0,0.0,0,0,0,0,0,0,0.0,0.0,0.0,0.0,0.0,0.0
<a href=/player/snydj105>snydj105</a>,Jerry Snyder,New York Yankees,YANKS,7,19,15,34,1952,1970,18,No,0,13.22,40.85,27.63,2406,2911,505,6464,7208,744,3937.0,4978.0,1041.0,115500.0,0.0,-115500.0
<a href=/player/snydr102>snydr102</a>,Russ Snyder,New York Yankees,YANKS,1,2,2,4,1959,1959,0,No,0,0.31,0.0,-0.31,212,0,-212,603,0,-603,0.0,0.0,0.0,0.0,0.0,0.0
<a href=/player/snydr102>snydr102</a>,Russ Snyder,Kansas City Athletics,ATLTCS,24,51,45,96,1961,1976,15,No,0,93.37,59.87,-33.5,8944,6063,-2881,21756,17588,-4168,9976.0,4965.0,-5011.0,504100.0,0.0,-504100.0
<a href=/player/snydr102>snydr102</a>,Russ Snyder,Baltimore Orioles,ORLS,2,4,4,8,1967,1973,6,No,0,9.46,19.82,10.36,579,770,191,2185,2951,766,146.0,306.0,160.0,72000.0,0.0,-72000.0
<a href=/player/snydr102>snydr102</a>,Russ Snyder,Chicago White Sox,WSOX,1,1,1,2,1968,1968,0,No,0,0.16,-0.34,-0.5,190,69,-121,539,183,-356,0.0,0.0,0.0,21500.0,0.0,-21500.0
<a href=/player/snydr102>snydr102</a>,Russ Snyder,Cleveland Indians,INDINS,7,13,13,26,1970,1978,8,No,0,23.54,10.24,-13.3,1728,850,-878,4111,2770,-1341,2427.0,1183.0,-1244.0,83000.0,0.0,-83000.0
<a href=/player/soboc001>soboc001</a>,Chad Sobotka,Atlanta Braves,BRAVES,1,2,1,3,2021,2021,0,Yes,0,0.01,-0.18,-0.19,6,32,26,0,78,78,12.0,0.0,-12.0,0.0,0.0,0.0
<a href=/player/socom001>socom001</a>,Miguel Socolovich,Boston Red Sox,RSOX,11,30,18,48,2008,2019,11,Yes,0,37.8,29.22,-8.58,3009,1818,-1191,5076,5902,826,5204.0,2054.0,-3150.0,4708000.0,0.0,-4708000.0
<a href=/player/sodee101>sodee101</a>,Eric Soderholm,Chicago White Sox,WSOX,2,3,3,6,1979,2007,28,No,0,0.48,2.65,2.17,63,150,87,166,0,-166,0.0,701.0,701.0,0.0,0.0,0.0
<a href=/player/sodee101>sodee101</a>,Eric Soderholm,Texas Rangers,RNGRS,1,1,3,4,1979,1979,0,No,0,1.82,0.0,-1.82,95,0,-95,304,0,-304,0.0,0.0,0.0,0.0,0.0,0.0
<a href=/player/sodoc001>sodoc001</a>,Clint Sodowsky,Detroit Tigers,TIGRS,3,6,4,10,1996,1998,2,No,0,6.42,-0.59,-7.01,711,169,-542,196,193,-3,1179.0,433.0,-746.0,1584000.0,0.0,-1584000.0
<a href=/player/sodoc001>sodoc001</a>,Clint Sodowsky,Arizona Diamondbacks,DBACKS,2,3,2,5,1999,2000,1,No,0,6.42,1.09,-5.33,440,238,-202,1365,1,-1364,398.0,284.0,-114.0,720000.0,0.0,-720000.0
<a href=/player/sogae001>sogae001</a>,Eric Sogard,San Diego Padres,PADRS,3,4,4,8,2010,2013,3,No,0,5.05,1.13,-3.92,706,243,-463,2175,585,-1590,34.0,54.0,20.0,0.0,0.0,0.0
<a href=/player/sogae001>sogae001</a>,Eric Sogard,Toronto Blue Jays,BJAYS,1,1,2,3,2019,2019,0,Yes,0,0.71,0.0,-0.71,37,0,-37,119,0,-119,0.0,0.0,0.0,100000.0,0.0,-100000.0
<a href=/player/sojol001>sojol001</a>,Luis Sojo,Toronto Blue Jays,BJAYS,4,7,8,15,1990,2002,12,No,2,4.59,23.06,18.47,622,749,127,2444,2988,544,0.0,935.0,935.0,255000.0,0.0,-255000.0
<a href=/player/sojol001>sojol001</a>,Luis Sojo,California Angels,ANGELS,1,1,2,3,1992,1993,1,No,0,-0.45,0.32,0.77,19,18,-1,54,70,16,0.0,0.0,0.0,190000.0,0.0,-190000.0
<a href=/player/sojol001>sojol001</a>,Luis Sojo,Pittsburgh Pirates,PIRATS,1,1,1,2,2000,2002,2,No,0,-0.26,0.0,0.26,76,0,-76,222,0,-222,0.0,0.0,0.0,450000.0,0.0,-450000.0
<a href=/player/solaj001>solaj001</a>,Julio Solano,Houston Astros,ASTROS,1,1,1,2,1987,1987,0,No,0,-0.22,0.0,0.22,24,0,-24,0,0,0,95.0,0.0,-95.0,0.0,0.0,0.0
<a href=/player/solan001>solan001</a>,Nick Solak,New York Yankees,YANKS,2,4,2,6,2018,2020,2,No,0,-1.13,4.02,5.15,271,71,-200,932,61,-871,0.0,823.0,823.0,621900.0,0.0,-621900.0
<a href=/player/solan001>solan001</a>,Nick Solak,Tampa Bay Devil Rays,RAYS,1,1,1,2,2019,2019,0,Yes,0,0.78,-0.41,-1.19,218,15,-203,879,0,-879,0.0,37.0,37.0,0.0,0.0,0.0
<a href=/player/solat101>solat101</a>,Tony Solaita,New York Yankees,YANKS,1,1,1,2,1973,1973,0,No,0,0.0,0.0,0.0,0,0,0,0,0,0,0.0,0.0,0.0,0.0,0.0,0.0
<a href=/player/solat101>solat101</a>,Tony Solaita,Montreal Expos,NATEX,1,1,1,2,1979,1980,1,No,0,0.55,0.0,-0.55,36,0,-36,121,0,-121,0.0,0.0,0.0,0.0,0.0,0.0
<a href=/player/solay001>solay001</a>,Yangervis Solarte,New York Yankees,YANKS,3,6,4,10,2014,2018,4,No,0,4.88,7.78,2.9,526,501,-25,1896,1981,85,219.0,0.0,-219.0,13550625.0,0.0,-13550625.0
<a href=/player/solay001>solay001</a>,Yangervis Solarte,San Diego Padres,PADRS,2,3,3,6,2018,2020,2,Yes,0,-0.24,0.14,0.38,184,23,-161,682,36,-646,19.0,30.0,11.0,0.0,0.0,0.0
<a href=/player/solej001>solej001</a>,Jorge Soler,Chicago Cubs,CUBS,1,1,1,2,2016,2017,1,No,0,1.39,1.83,0.44,395,115,-280,1580,0,-1580,0.0,176.0,176.0,3666667.0,0.0,-3666667.0
<a href=/player/solej001>solej001</a>,Jorge Soler,Kansas City Royals,ROYALS,1,1,1,2,2021,2021,0,Yes,0,1.05,0.0,-1.05,55,0,-55,242,0,-242,0.0,0.0,0.0,8050000.0,0.0,-8050000.0
<a href=/player/soloe101>soloe101</a>,Eddie Solomon,Los Angeles Dodgers,DOGRS,5,9,7,16,1975,1992,17,No,2,9.7,35.66,25.96,449,1802,1353,26,2476,2450,4776.0,6831.0,2055.0,1249500.0,0.0,-1249500.0
<a href=/player/soloe101>soloe101</a>,Eddie Solomon,Chicago Cubs,CUBS,1,1,1,2,1975,1975,0,No,0,-0.38,0.27,0.65,52,18,-34,5,1,-4,111.0,25.0,-86.0,0.0,0.0,0.0
<a href=/player/soloe101>soloe101</a>,Eddie Solomon,St. Louis Cardinals,CARDS,1,1,1,2,1977,1977,0,No,0,4.13,0.0,-4.13,174,0,-174,133,0,-133,1142.0,0.0,-1142.0,0.0,0.0,0.0
<a href=/player/soloe101>soloe101</a>,Eddie Solomon,Atlanta Braves,BRAVES,1,1,1,2,1980,1980,0,No,0,2.36,0.0,-2.36,123,0,-123,99,0,-99,822.0,0.0,-822.0,0.0,0.0,0.0
<a href=/player/soloe101>soloe101</a>,Eddie Solomon,Pittsburgh Pirates,PIRATS,6,6,8,14,1982,1993,11,No,0,0.98,11.66,10.68,783,870,87,2768,2816,48,22.0,77.0,55.0,1442500.0,0.0,-1442500.0
<a href=/player/soltm101>soltm101</a>,Moose Solters,Boston Red Sox,RSOX,1,2,1,3,1935,1938,3,No,0,4.12,-2.77,-6.89,319,230,-89,1405,874,-531,0.0,0.0,0.0,0.0,0.0,0.0
<a href=/player/soltm101>soltm101</a>,Moose Solters,St.Louis Browns,ORLS,12,23,32,55,1937,1952,15,No,0,55.87,54.37,-1.5,2736,6464,3728,7991,19515,11524,6789.0,12669.0,5880.0,129000.0,0.0,-129000.0
<a href=/player/soltm101>soltm101</a>,Moose Solters,St.Louis Browns,ORLS,1,1,1,2,1939,1941,2,No,0,0.5,3.93,3.43,234,169,-65,833,717,-116,0.0,0.0,0.0,0.0,0.0,0.0
<a href=/player/sommb101>sommb101</a>,Bill Sommers,Boston Red Sox,RSOX,2,5,3,8,1947,1955,8,No,0,0.52,24.8,24.28,500,919,419,1627,990,-637,67.0,3427.0,3360.0,0.0,0.0,0.0
<a href=/player/songd101>songd101</a>,Don Songer,OklahomaCity,OklahomaCity,1,2,1,3,1924,1924,0,No,0,0.53,0.0,-0.53,98,0,-98,46,0,-46,457.0,0.0,-457.0,0.0,0.0,0.0
<a href=/player/sorel001>sorel001</a>,Lary Sorensen,Milwaukee Brewers,BREWRS,3,6,7,13,1980,1986,6,No,1,6.59,20.26,13.67,970,997,27,2159,3010,851,2112.0,2376.0,264.0,0.0,0.0,0.0
<a href=/player/sorel001>sorel001</a>,Lary Sorensen,St. Louis Cardinals,CARDS,2,3,2,5,1981,1990,9,No,0,6.11,11.74,5.63,370,733,363,1263,2386,1123,1236.0,0.0,-1236.0,740000.0,0.0,-740000.0
<a href=/player/sorel001>sorel001</a>,Lary Sorensen,Philadelphia Phillies,PHILS,2,4,4,8,1986,1987,1,No,0,2.35,0.09,-2.26,749,102,-647,1893,18,-1875,306.0,201.0,-105.0,635000.0,0.0,-635000.0
<a href=/player/soria001>soria001</a>,Alfonso Soriano,New York Yankees,YANKS,1,2,2,4,2004,2016,12,No,0,3.52,53.95,50.43,392,1509,1117,1582,6520,4938,0.0,0.0,0.0,0.0,0.0,0.0
<a href=/player/soria001>soria001</a>,Alfonso Soriano,Texas Rangers,RNGRS,3,5,7,12,2005,2008,3,No,0,39.21,4.43,-34.78,1374,331,-1043,4664,754,-3910,3052.0,497.0,-2555.0,7500000.0,0.0,-7500000.0
<a href=/player/soria001>soria001</a>,Alfonso Soriano,Chicago Cubs,CUBS,1,2,1,3,2013,2013,0,Yes,0,0.9,0.0,-0.9,125,0,-125,481,0,-481,0.0,0.0,0.0,0.0,0.0,0.0
<a href=/player/sorij001>sorij001</a>,Joakim Soria,Texas Rangers,RNGRS,7,18,20,38,2014,2021,7,Yes,0,16.16,17.54,1.38,1321,328,-993,1769,20,-1749,3375.0,2717.0,-658.0,3762500.0,0.0,-3762500.0
<a href=/player/sorij001>sorij001</a>,Joakim Soria,Detroit Tigers,TIGRS,1,1,1,2,2015,2021,6,No,0,0.73,1.1,0.37,58,352,294,0,1195,1195,80.0,0.0,-80.0,7000000.0,0.0,-7000000.0
<a href=/player/sorij001>sorij001</a>,Joakim Soria,Kansas City Royals,ROYALS,1,3,2,5,2018,2021,3,No,0,1.11,-0.68,-1.79,43,21,-22,0,43,43,116.0,41.0,-75.0,0.0,0.0,0.0
<a href=/player/sorij001>sorij001</a>,Joakim Soria,Chicago White Sox,WSOX,1,2,2,4,2018,2018,0,Yes,0,-0.17,0.0,0.17,52,0,-52,0,0,0,66.0,0.0,-66.0,0.0,0.0,0.0
<a href=/player/sorij001>sorij001</a>,Joakim Soria,Arizona Diamondbacks,DBACKS,1,1,2,3,2021,2021,0,Yes,0,-0.26,0.0,0.26,10,0,-10,0,0,0,24.0,0.0,-24.0,3500000.0,0.0,-3500000.0
<a href=/player/sorir001>sorir001</a>,Rafael Soriano,Seattle Mariners,MARNRS,1,1,1,2,2006,2008,2,No,0,3.51,-1.43,-4.94,318,20,-298,0,0,0,485.0,294.0,-191.0,450000.0,0.0,-450000.0
<a href=/player/sorir001>sorir001</a>,Rafael Soriano,Atlanta Braves,BRAVES,2,4,3,7,2009,2010,1,No,0,4.12,-0.39,-4.51,390,148,-242,204,140,-64,921.0,170.0,-751.0,6765000.0,0.0,-6765000.0
<a href=/player/sorrb101>sorrb101</a>,Billy Sorrell,Philadelphia Phillies,PHILS,2,3,3,6,1968,1969,1,No,0,0.0,0.05,0.05,0,25,25,0,34,34,0.0,0.0,0.0,0.0,0.0,0.0
<a href=/player/sorrp001>sorrp001</a>,Paul Sorrento,California Angels,ANGELS,1,3,2,5,1988,1992,4,No,0,-0.32,6.07,6.39,96,81,-15,213,0,-213,64.0,1524.0,1460.0,0.0,0.0,0.0
<a href=/player/sorrp001>sorrp001</a>,Paul Sorrento,Minnesota Twins,TWINS,1,1,2,3,1992,1995,3,No,0,3.9,-0.31,-4.21,487,10,-477,1779,0,-1779,0.0,106.0,106.0,0.0,0.0,0.0
<a href=/player/sorrv101>sorrv101</a>,Vic Sorrell,Toronto,Toronto,1,1,1,2,1928,1928,0,No,0,17.07,0.0,-17.07,561,0,-561,624,0,-624,5010.0,0.0,-5010.0,0.0,0.0,0.0
<a href=/player/sosae101>sosae101</a>,Elias Sosa,San Francisco Giants,GIANTS,1,2,1,3,1974,1980,6,No,0,-1.06,2.57,3.63,99,431,332,142,1370,1228,82.0,0.0,-82.0,0.0,0.0,0.0
<a href=/player/sosae101>sosae101</a>,Elias Sosa,St. Louis Cardinals,CARDS,2,3,3,6,1975,1978,3,No,0,9.69,4.02,-5.67,1094,228,-866,136,461,325,2919.0,527.0,-2392.0,52000.0,0.0,-52000.0
<a href=/player/sosae101>sosae101</a>,Elias Sosa,Atlanta Braves,BRAVES,1,2,1,3,1976,1977,1,No,0,4.08,0.61,-3.47,368,56,-312,639,9,-630,292.0,128.0,-164.0,0.0,0.0,0.0
<a href=/player/sosae101>sosae101</a>,Elias Sosa,Pittsburgh Pirates,PIRATS,5,9,10,19,1978,1984,6,No,0,24.55,-1.47,-26.02,1160,294,-866,2724,444,-2280,3108.0,299.0,-2809.0,300000.0,0.0,-300000.0
<a href=/player/sosah001>sosah001</a>,Henry Sosa,San Francisco Giants,GIANTS,1,2,1,3,2011,2011,0,No,0,-0.35,-0.74,-0.39,20,56,36,18,230,212,160.0,0.0,-160.0,0.0,0.0,0.0
<a href=/player/sosaj001>sosaj001</a>,Juan Sosa,Colorado Rockies,ROCKS,1,1,1,2,2001,2001,0,No,0,-0.01,0.0,0.01,2,0,-2,1,0,-1,0.0,0.0,0.0,0.0,0.0,0.0
<a href=/player/sosaj002>sosaj002</a>,Jorge Sosa,Tampa Bay Devil Rays,RAYS,1,1,1,2,2005,2006,1,No,0,3.13,0.19,-2.94,137,128,-9,63,420,357,664.0,0.0,-664.0,0.0,0.0,0.0
<a href=/player/sosaj002>sosaj002</a>,Jorge Sosa,Atlanta Braves,BRAVES,1,1,1,2,2006,2006,0,No,0,-0.17,0.0,0.17,38,0,-38,4,0,-4,92.0,0.0,-92.0,2200000.0,0.0,-2200000.0
<a href=/player/sosas001>sosas001</a>,Sammy Sosa,Texas Rangers,RNGRS,3,5,6,11,1989,1992,3,No,0,24.82,3.73,-21.09,1170,237,-933,3620,767,-2853,3192.0,327.0,-2865.0,2411539.0,0.0,-2411539.0
<a href=/player/sosas001>sosas001</a>,Sammy Sosa,Chicago White Sox,WSOX,1,2,1,3,1992,1993,1,No,0,58.16,-2.67,-60.83,1875,257,-1618,7900,1106,-6794,125.0,0.0,-125.0,0.0,0.0,0.0
<a href=/player/sosas001>sosas001</a>,Sammy Sosa,Chicago Cubs,CUBS,4,6,7,13,2005,2010,5,No,0,-0.96,4.29,5.25,367,641,274,1090,1872,782,0.0,0.0,0.0,3300000.0,0.0,-3300000.0
<a href=/player/sothd101>sothd101</a>,Denny Sothern,Philadelphia Phillies,PHILS,1,1,1,2,1930,1933,3,No,0,-0.43,-2.43,-2.0,17,236,219,54,905,851,0.0,0.0,0.0,5000.0,0.0,-5000.0
<a href=/player/sothd101>sothd101</a>,Denny Sothern,Baltimore,Baltimore,1,1,1,2,1931,1931,0,No,0,-0.32,0.0,0.32,19,0,-19,37,0,-37,0.0,0.0,0.0,0.0,0.0,0.0
<a href=/player/sotoe001>sotoe001</a>,Elliot Soto,Chicago Cubs,CUBS,1,2,2,4,2015,2015,0,No,0,0.0,0.17,0.17,0,21,21,0,23,23,0.0,175.0,175.0,0.0,0.0,0.0
<a href=/player/sotog001>sotog001</a>,Geovany Soto,Chicago Cubs,CUBS,2,2,3,5,2012,2012,0,No,0,0.74,0.0,-0.74,111,0,-111,386,0,-386,0.0,0.0,0.0,4300000.0,0.0,-4300000.0
<a href=/player/sotog002>sotog002</a>,Giovanni Soto,Detroit Tigers,TIGRS,1,1,2,3,2010,2013,3,No,0,0.15,8.67,8.52,6,460,454,0,1851,1851,10.0,0.0,-10.0,0.0,0.0,0.0
<a href=/player/soucb101>soucb101</a>,Bud Souchock,New York Yankees,YANKS,3,9,5,14,1948,1954,6,No,0,21.49,0.79,-20.7,1319,458,-861,2529,213,-2316,6559.0,1785.0,-4774.0,29000.0,0.0,-29000.0
<a href=/player/soutb101>soutb101</a>,Billy Southworth,Pittsburgh Pirates,PIRATS,5,10,8,18,1921,1932,11,No,0,20.59,54.57,33.98,2344,1948,-396,9152,7061,-2091,1307.0,3847.0,2540.0,22300.0,0.0,-22300.0
<a href=/player/soutb101>soutb101</a>,Billy Southworth,Boston Braves,BRAVES,1,2,3,5,1923,1927,4,No,0,1.22,11.01,9.79,273,702,429,996,2898,1902,87.0,0.0,-87.0,5000.0,0.0,-5000.0
<a href=/player/soutb101>soutb101</a>,Billy Southworth,New York Giants,GIANTS,1,1,1,2,1926,1927,1,No,0,3.63,0.3,-3.33,210,169,-41,814,554,-260,0.0,0.0,0.0,8000.0,0.0,-8000.0
<a href=/player/soutb102>soutb102</a>,Bill Southworth,Chicago White Sox,WSOX,3,5,5,10,1967,1971,4,No,0,9.67,-0.45,-10.12,1085,468,-617,4072,1523,-2549,79.0,0.0,-79.0,35500.0,0.0,-35500.0
<a href=/player/souzs001>souzs001</a>,Steven Souza,Washington Nationals,NATEX,2,4,6,10,2014,2021,7,Yes,0,10.96,22.51,11.55,452,684,232,1763,2913,1150,205.0,188.0,-17.0,47503480.0,0.0,-47503480.0
<a href=/player/souzs001>souzs001</a>,Steven Souza,Tampa Bay Devil Rays,RAYS,2,2,5,7,2018,2020,2,Yes,0,0.38,-0.77,-1.15,290,25,-265,1151,0,-1151,0.0,114.0,114.0,0.0,0.0,0.0
<a href=/player/spadb101>spadb101</a>,Bob Spade,New York Giants,GIANTS,1,2,2,4,1908,1908,0,No,0,0.79,-0.32,-1.11,104,11,-93,143,17,-126,1093.0,0.0,-1093.0,0.0,0.0,0.0
<a href=/player/spana101>spana101</a>,Al Spangler,Houston Astros,ASTROS,1,1,1,2,1965,1966,1,No,0,0.69,0.69,0.0,57,32,-25,115,2,-113,0.0,78.0,78.0,0.0,0.0,0.0
<a href=/player/spand001>spand001</a>,Denard Span,Minnesota Twins,TWINS,2,4,3,7,2012,2018,6,No,0,11.69,-0.56,-12.25,428,86,-342,1616,0,-1616,1029.0,585.0,-444.0,3000000.0,0.0,-3000000.0
<a href=/player/spand001>spand001</a>,Denard Span,San Francisco Giants,GIANTS,1,4,2,6,2017,2017,0,Yes,0,1.25,0.0,-1.25,79,0,-79,289,0,-289,0.0,0.0,0.0,11000000.0,0.0,-11000000.0
<a href=/player/spand001>spand001</a>,Denard Span,Tampa Bay Devil Rays,RAYS,1,3,2,5,2018,2019,1,Yes,0,2.35,0.0,-2.35,144,0,-144,328,0,-328,139.0,0.0,-139.0,5300000.0,0.0,-5300000.0
<a href=/player/sparj001>sparj001</a>,Jeff Sparks,Pittsburgh Pirates,PIRATS,1,2,2,4,1999,2007,8,No,0,1.13,-1.06,-2.19,216,241,25,680,708,28,91.0,0.0,-91.0,375000.0,0.0,-375000.0
<a href=/player/sparj101>sparj101</a>,Joe Sparma,Detroit Tigers,TIGRS,6,6,7,13,1969,1973,4,No,0,-0.27,2.47,2.74,90,218,128,156,31,-125,124.0,816.0,692.0,23500.0,0.0,-23500.0
<a href=/player/speab101>speab101</a>,Bob Speake,Chicago Cubs,CUBS,2,3,2,5,1958,1961,3,No,0,0.92,4.24,3.32,121,278,157,224,1033,809,0.0,8.0,8.0,0.0,0.0,0.0
<a href=/player/speat101>speat101</a>,Tris Speaker,Boston Red Sox,RSOX,11,22,33,55,1916,1937,21,No,0,147.85,52.38,-95.47,5714,2379,-3335,20029,5927,-14102,9458.0,11085.0,1627.0,78550.0,0.0,-78550.0
<a href=/player/speeb101>speeb101</a>,By Speece,Omaha,Omaha,1,1,2,3,1924,1924,0,No,0,0.24,0.0,-0.24,42,0,-42,16,0,-16,169.0,0.0,-169.0,0.0,0.0,0.0
<a href=/player/speeb101>speeb101</a>,By Speece,Washington Senators,TWINS,1,2,1,3,1924,1927,3,No,0,1.24,9.07,7.83,60,146,86,31,190,159,281.0,1502.0,1221.0,2100.0,0.0,-2100.0
<a href=/player/speht001>speht001</a>,Tim Spehr,Kansas City Royals,ROYALS,1,2,2,4,1992,1993,1,No,0,1.07,-0.36,-1.43,511,17,-494,265,0,-265,676.0,275.0,-401.0,0.0,0.0,0.0
<a href=/player/speic001>speic001</a>,Chris Speier,San Francisco Giants,GIANTS,1,1,1,2,1977,1977,0,No,0,9.43,-0.92,-10.35,895,104,-791,3289,387,-2902,0.0,0.0,0.0,90000.0,0.0,-90000.0
<a href=/player/speic001>speic001</a>,Chris Speier,Montreal Expos,NATEX,1,2,1,3,1984,1985,1,No,0,0.34,0.07,-0.27,38,37,-1,129,70,-59,0.0,0.0,0.0,0.0,0.0,0.0
<a href=/player/speic001>speic001</a>,Chris Speier,St. Louis Cardinals,CARDS,1,1,2,3,1984,1984,0,No,0,-0.19,0.0,0.19,12,0,-12,37,0,-37,0.0,0.0,0.0,0.0,0.0,0.0
<a href=/player/speig001>speig001</a>,Gabe Speier,Boston Red Sox,RSOX,1,3,1,4,2014,2019,5,No,0,9.45,9.39,-0.06,366,170,-196,427,24,-403,794.0,2892.0,2098.0,10500000.0,0.0,-10500000.0
<a href=/player/speig001>speig001</a>,Gabe Speier,Detroit Tigers,TIGRS,2,3,2,5,2015,2019,4,No,0,1.92,2.82,0.9,314,181,-133,389,391,2,300.0,240.0,-60.0,8515000.0,0.0,-8515000.0
<a href=/player/speig001>speig001</a>,Gabe Speier,Atlanta Braves,BRAVES,1,2,3,5,2015,2021,6,Yes,0,-1.25,7.57,8.82,58,639,581,48,2431,2383,417.0,219.0,-198.0,535000.0,0.0,-535000.0
<a href=/player/speig001>speig001</a>,Gabe Speier,Arizona Diamondbacks,DBACKS,1,2,1,3,2018,2018,0,No,0,-0.12,-0.27,-0.15,25,84,59,0,320,320,62.0,0.0,-62.0,0.0,0.0,0.0
<a href=/player/speij001>speij001</a>,Justin Speier,Chicago Cubs,CUBS,4,13,7,20,1998,2009,11,No,0,13.03,10.6,-2.43,859,1301,442,2754,2788,34,471.0,1208.0,737.0,7140000.0,0.0,-7140000.0
<a href=/player/speij001>speij001</a>,Justin Speier,Florida Marlins,MARLNS,1,1,1,2,1999,1999,0,No,0,-0.06,0.0,0.06,37,0,-37,3,0,-3,86.0,0.0,-86.0,0.0,0.0,0.0
<a href=/player/speij001>speij001</a>,Justin Speier,Cleveland Indians,INDINS,1,1,1,2,2001,2001,0,No,0,0.0,0.0,0.0,0,0,0,0,0,0,0.0,0.0,0.0,243000.0,0.0,-243000.0
<a href=/player/speij001>speij001</a>,Justin Speier,Colorado Rockies,ROCKS,4,6,6,12,2003,2010,7,No,0,7.79,3.67,-4.12,906,468,-438,1692,779,-913,1362.0,897.0,-465.0,3376000.0,0.0,-3376000.0
<a href=/player/speil001>speil001</a>,Levale Speigner,Minnesota Twins,TWINS,1,1,1,2,2007,2008,1,No,0,-1.69,-0.22,1.47,50,4,-46,8,11,3,144.0,0.0,-144.0,0.0,0.0,0.0
<a href=/player/spenb102>spenb102</a>,Bob Spence,Chicago White Sox,WSOX,2,3,2,5,1971,1972,1,No,0,0.08,0.0,-0.08,33,0,-33,5,0,-5,104.0,0.0,-104.0,0.0,0.0,0.0
<a href=/player/spenc101>spenc101</a>,Chet Spencer,Rochester,Rochester,2,4,5,9,1911,1913,2,No,0,29.68,0.0,-29.68,1807,0,-1807,7810,0,-7810,0.0,0.0,0.0,0.0,0.0,0.0
<a href=/player/spend101>spend101</a>,Daryl Spencer,San Francisco Giants,GIANTS,10,19,14,33,1959,1972,13,No,0,26.08,20.98,-5.1,2290,1750,-540,7278,3376,-3902,1334.0,4789.0,3455.0,50000.0,0.0,-50000.0
<a href=/player/spend101>spend101</a>,Daryl Spencer,St. Louis Cardinals,CARDS,3,6,6,12,1961,1965,4,No,0,2.48,8.05,5.57,784,459,-325,2143,937,-1206,727.0,472.0,-255.0,0.0,0.0,0.0
<a href=/player/speng101>speng101</a>,Glenn Spencer,Pittsburgh Pirates,PIRATS,2,4,4,8,1932,1938,6,No,0,21.06,8.93,-12.13,668,581,-87,953,1370,417,4600.0,2252.0,-2348.0,0.0,0.0,0.0
<a href=/player/speng101>speng101</a>,Glenn Spencer,New York Giants,GIANTS,1,1,1,2,1933,1934,1,No,0,0.0,0.2,0.2,0,32,32,0,37,37,0.0,0.0,0.0,0.0,0.0,0.0
<a href=/player/speng101>speng101</a>,Glenn Spencer,Cincinnati Reds,REDS,3,5,6,11,1934,1937,3,No,0,22.67,0.4,-22.27,911,284,-627,2270,797,-1473,2379.0,341.0,-2038.0,0.0,0.0,0.0
<a href=/player/spenj101>spenj101</a>,Jim Spencer,California Angels,ANGELS,3,4,5,9,1973,1975,2,No,0,-0.57,1.96,2.53,414,169,-245,1273,459,-814,189.0,261.0,72.0,0.0,0.0,0.0
<a href=/player/spenj101>spenj101</a>,Jim Spencer,Texas Rangers,RNGRS,6,16,10,26,1975,1988,13,No,0,43.04,39.97,-3.07,2266,2155,-111,8188,7408,-780,2609.0,4479.0,1870.0,377000.0,0.0,-377000.0
<a href=/player/spenj101>spenj101</a>,Jim Spencer,California Angels,ANGELS,2,3,4,7,1975,1977,2,No,0,-0.12,-0.47,-0.35,328,122,-206,1247,392,-855,0.0,18.0,18.0,0.0,0.0,0.0
<a href=/player/spenj101>spenj101</a>,Jim Spencer,Chicago White Sox,WSOX,1,3,3,6,1977,1978,1,No,0,1.55,0.0,-1.55,299,0,-299,869,0,-869,0.0,0.0,0.0,70000.0,0.0,-70000.0
<a href=/player/spenj101>spenj101</a>,Jim Spencer,New York Yankees,YANKS,2,5,4,9,1981,1983,2,No,0,0.32,-0.84,-1.16,265,132,-133,447,432,-15,1046.0,0.0,-1046.0,250000.0,0.0,-250000.0
<a href=/player/spenr101>spenr101</a>,Roy Spencer,Pittsburgh Pirates,PIRATS,1,2,1,3,1927,1927,0,No,0,0.0,0.0,0.0,0,0,0,0,0,0,0.0,0.0,0.0,11200.0,0.0,-11200.0
<a href=/player/spenr101>spenr101</a>,Roy Spencer,Washington Senators,TWINS,3,5,4,9,1933,1939,6,No,0,3.92,5.07,1.15,441,620,179,819,1504,685,2260.0,2671.0,411.0,0.0,0.0,0.0
<a href=/player/spens001>spens001</a>,Shane Spencer,Cleveland Indians,INDINS,1,2,1,3,2003,2005,2,No,0,0.87,1.1,0.23,75,73,-2,221,247,26,251.0,0.0,-251.0,902400.0,0.0,-902400.0
<a href=/player/spens003>spens003</a>,Sean Spencer,Seattle Mariners,MARNRS,1,2,1,3,2000,2001,1,No,0,1.04,-0.19,-1.23,169,10,-159,492,12,-480,20.0,0.0,-20.0,0.0,0.0,0.0
<a href=/player/spens101>spens101</a>,Stan Spence,Boston Red Sox,RSOX,2,3,3,6,1941,1943,2,No,0,21.33,-1.33,-22.66,818,70,-748,3332,174,-3158,514.0,323.0,-191.0,22500.0,0.0,-22500.0
<a href=/player/spens101>spens101</a>,Stan Spence,Washington Senators,TWINS,15,27,28,55,1947,1963,16,No,0,24.78,22.78,-2.0,2496,3241,745,7422,8427,1005,2404.0,6282.0,3878.0,43000.0,0.0,-43000.0
<a href=/player/spens101>spens101</a>,Stan Spence,Boston Red Sox,RSOX,4,11,9,20,1949,1956,7,No,0,14.35,13.52,-0.83,1766,1339,-427,5882,4275,-1607,1880.0,1611.0,-269.0,126000.0,0.0,-126000.0
<a href=/player/spent101>spent101</a>,Tubby Spencer,St.Louis Browns,ORLS,2,3,3,6,1908,1914,6,No,0,-0.55,4.9,5.45,55,238,183,164,479,315,0.0,1597.0,1597.0,0.0,0.0,0.0
<a href=/player/spent102>spent102</a>,Tom Spencer,Cincinnati Reds,REDS,1,1,1,2,1976,1976,0,No,0,-0.61,0.0,0.61,29,0,-29,67,0,-67,0.0,0.0,0.0,0.0,0.0,0.0
<a href=/player/spenv101>spenv101</a>,Vern Spencer,Toronto,Toronto,1,1,2,3,1920,1920,0,No,0,-0.55,0.0,0.55,45,0,-45,152,0,-152,0.0,0.0,0.0,0.0,0.0,0.0
<a href=/player/spenv101>spenv101</a>,Vern Spencer,New York Giants,GIANTS,1,5,1,6,1921,1924,3,No,0,0.0,-0.65,-0.65,0,89,89,0,166,166,0.0,0.0,0.0,1500.0,0.0,-1500.0
<a href=/player/sperr101>sperr101</a>,Rob Sperring,Chicago Cubs,CUBS,3,6,5,11,1977,1982,5,No,0,6.0,5.18,-0.82,669,907,238,2312,3575,1263,152.0,0.0,-152.0,320000.0,0.0,-320000.0
<a href=/player/sperr101>sperr101</a>,Rob Sperring,San Francisco Giants,GIANTS,1,2,2,4,1977,1979,2,No,0,-0.16,-0.23,-0.07,100,281,181,275,873,598,0.0,0.0,0.0,0.0,0.0,0.0
<a href=/player/spiee101>spiee101</a>,Ed Spiezio,St. Louis Cardinals,CARDS,3,8,6,14,1968,1972,4,No,0,11.85,2.24,-9.61,1182,243,-939,1248,521,-727,1854.0,299.0,-1555.0,17500.0,0.0,-17500.0
<a href=/player/spiee101>spiee101</a>,Ed Spiezio,San Diego Padres,PADRS,1,1,2,3,1972,1972,0,No,0,-0.08,0.0,0.08,74,0,-74,295,0,-295,0.0,0.0,0.0,0.0,0.0,0.0
<a href=/player/spikc101>spikc101</a>,Charlie Spikes,New York Yankees,YANKS,5,8,9,17,1972,1987,15,No,0,9.09,48.73,39.64,1757,1810,53,5603,6602,999,883.0,1959.0,1076.0,246600.0,0.0,-246600.0
<a href=/player/spikc101>spikc101</a>,Charlie Spikes,Cleveland Indians,INDINS,2,2,2,4,1977,1982,5,No,0,-0.2,-0.46,-0.26,50,463,413,90,1581,1491,0.0,0.0,0.0,0.0,0.0,0.0
<a href=/player/spild001>spild001</a>,Dan Spillner,San Diego Padres,PADRS,3,3,3,6,1978,1981,3,No,0,8.67,-0.8,-9.47,302,140,-162,0,16,16,2359.0,323.0,-2036.0,0.0,0.0,0.0
<a href=/player/spild001>spild001</a>,Dan Spillner,Cleveland Indians,INDINS,1,1,1,2,1984,1984,0,No,0,1.84,0.0,-1.84,76,0,-76,1,0,-1,420.0,0.0,-420.0,400000.0,0.0,-400000.0
<a href=/player/spilh001>spilh001</a>,Harry Spilman,Cincinnati Reds,REDS,11,15,21,36,1981,2006,25,No,0,17.83,35.54,17.71,3261,3027,-234,2392,4330,1938,4092.0,5583.0,1491.0,22668833.0,0.0,-22668833.0
<a href=/player/spins101>spins101</a>,Scipio Spinks,Houston Astros,ASTROS,8,14,11,25,1972,1989,17,No,0,22.94,18.16,-4.78,1829,2074,245,3832,5559,1727,6887.0,3273.0,-3614.0,22500.0,0.0,-22500.0
<a href=/player/spins101>spins101</a>,Scipio Spinks,St. Louis Cardinals,CARDS,1,1,1,2,1974,1974,0,No,0,0.0,0.5,0.5,0,50,50,0,68,68,0.0,0.0,0.0,0.0,0.0,0.0
<a href=/player/spivj001>spivj001</a>,Junior Spivey,Arizona Diamondbacks,DBACKS,3,10,7,17,2003,2008,5,No,2,15.65,2.42,-13.23,2019,225,-1794,5161,413,-4748,3052.0,809.0,-2243.0,3950667.0,0.0,-3950667.0
<a href=/player/spivj001>spivj001</a>,Junior Spivey,Milwaukee Brewers,BREWRS,1,1,1,2,2005,2006,1,No,0,0.61,1.34,0.73,28,79,51,91,78,-13,0.0,670.0,670.0,2125000.0,0.0,-2125000.0
<a href=/player/spoha101>spoha101</a>,Al Spohrer,New York Giants,GIANTS,1,4,1,5,1928,1928,0,No,0,11.88,2.32,-9.56,1432,52,-1380,2925,68,-2857,4700.0,475.0,-4225.0,21900.0,0.0,-21900.0
<a href=/player/spolp001>spolp001</a>,Paul Spoljaric,Toronto Blue Jays,BJAYS,1,2,1,3,1997,2002,5,No,0,1.41,11.51,10.1,180,698,518,0,2901,2901,633.0,0.0,-633.0,1485000.0,0.0,-1485000.0
<a href=/player/spolp001>spolp001</a>,Paul Spoljaric,Seattle Mariners,MARNRS,1,1,1,2,1998,1999,1,No,0,-0.94,-0.01,0.93,10,2,-8,4,0,-4,34.0,4.0,-30.0,255000.0,0.0,-255000.0
<a href=/player/spolp001>spolp001</a>,Paul Spoljaric,Philadelphia Phillies,PHILS,1,1,1,2,1999,2002,3,No,0,0.12,6.16,6.04,39,211,172,0,216,216,186.0,1819.0,1633.0,450000.0,0.0,-450000.0
<a href=/player/spolp001>spolp001</a>,Paul Spoljaric,Toronto Blue Jays,BJAYS,3,5,8,13,1999,2001,2,No,0,2.96,-0.34,-3.3,81,293,212,74,474,400,885.0,431.0,-454.0,8600000.0,0.0,-8600000.0
<a href=/player/spoot001>spoot001</a>,Tim Spooneybarger,Atlanta Braves,BRAVES,1,2,2,4,2002,2008,6,No,0,0.15,5.9,5.75,66,176,110,3,203,200,126.0,1529.0,1403.0,200000.0,0.0,-200000.0
<a href=/player/sprae001>sprae001</a>,Ed Sprague,Toronto Blue Jays,BJAYS,1,1,1,2,1998,1998,0,No,0,-0.8,0.0,0.8,27,0,-27,91,0,-91,0.0,0.0,0.0,2350000.0,0.0,-2350000.0
<a href=/player/sprae001>sprae001</a>,Ed Sprague,San Diego Padres,PADRS,3,7,5,12,2000,2005,5,No,0,-0.83,-1.53,-0.7,173,136,-37,612,34,-578,24.0,532.0,508.0,8350000.0,0.0,-8350000.0
<a href=/player/sprae101>sprae101</a>,Ed Sprague,Cincinnati Reds,REDS,1,2,2,4,1973,1973,0,No,0,0.24,0.19,-0.05,16,36,20,0,60,60,24.0,0.0,-24.0,16000.0,0.0,-16000.0
<a href=/player/spraj001>spraj001</a>,Jerry Spradlin,Philadelphia Phillies,PHILS,1,1,1,2,1998,1999,1,No,0,-0.21,-0.39,-0.18,4,70,66,0,55,55,9.0,504.0,495.0,235000.0,0.0,-235000.0
<a href=/player/spraj001>spraj001</a>,Jerry Spradlin,Cleveland Indians,INDINS,1,1,2,3,1999,1999,0,No,0,0.45,0.0,-0.45,114,0,-114,1,0,-1,174.0,0.0,-174.0,687500.0,0.0,-687500.0
<a href=/player/spraj001>spraj001</a>,Jerry Spradlin,San Francisco Giants,GIANTS,1,1,1,2,1999,2000,1,No,0,-0.22,0.0,0.22,53,0,-53,0,0,0,225.0,0.0,-225.0,0.0,0.0,0.0
<a href=/player/sprij001>sprij001</a>,Jeffrey Springs,Texas Rangers,RNGRS,1,1,1,2,2020,2020,0,No,0,-0.27,0.0,0.27,16,0,-16,0,0,0,61.0,0.0,-61.0,0.0,0.0,0.0
<a href=/player/sprij001>sprij001</a>,Jeffrey Springs,Boston Red Sox,RSOX,1,3,2,5,2021,2021,0,Yes,0,0.11,0.0,-0.11,61,0,-61,0,0,0,216.0,0.0,-216.0,0.0,0.0,0.0
<a href=/player/sprij102>sprij102</a>,Jack Spring,Boston Red Sox,RSOX,2,2,3,5,1958,1959,1,No,0,-0.15,0.43,0.58,66,36,-30,4,4,0,126.0,91.0,-35.0,0.0,0.0,0.0
<a href=/player/sprij102>sprij102</a>,Jack Spring,Boston Red Sox,RSOX,1,1,1,2,1958,1958,0,No,0,0.19,0.0,-0.19,28,0,-28,4,0,-4,65.0,0.0,-65.0,0.0,0.0,0.0
<a href=/player/sprij102>sprij102</a>,Jack Spring,Chicago Cubs,CUBS,2,4,4,8,1964,1966,2,No,0,41.31,1.04,-40.27,2470,267,-2203,10220,596,-9624,9.0,335.0,326.0,12000.0,0.0,-12000.0
<a href=/player/sprir001>sprir001</a>,Russ Springer,New York Yankees,YANKS,1,3,1,4,1992,1994,2,No,0,-1.97,3.42,5.39,549,56,-493,1984,0,-1984,509.0,1123.0,614.0,0.0,0.0,0.0
<a href=/player/sprir001>sprir001</a>,Russ Springer,California Angels,ANGELS,1,2,1,3,1995,1995,0,No,0,-0.59,-0.19,0.4,154,11,-143,102,18,-84,370.0,0.0,-370.0,250000.0,0.0,-250000.0
<a href=/player/sprir001>sprir001</a>,Russ Springer,Arizona Diamondbacks,DBACKS,3,3,3,6,1998,2000,2,No,0,0.88,-0.27,-1.15,437,92,-345,1,29,28,618.0,105.0,-513.0,900000.0,0.0,-900000.0
<a href=/player/spris001>spris001</a>,Steve Springer,New York Mets,METS,1,2,2,4,1988,1989,1,No,0,0.86,0.0,-0.86,37,0,-37,0,0,0,239.0,0.0,-239.0,0.0,0.0,0.0
<a href=/player/sprob101>sprob101</a>,Bobby Sprowl,Boston Red Sox,RSOX,5,11,7,18,1979,1993,14,No,1,6.69,9.69,3.0,1042,1268,226,3358,3501,143,507.0,2168.0,1661.0,1275000.0,0.0,-1275000.0
<a href=/player/sprob101>sprob101</a>,Bobby Sprowl,Houston Astros,ASTROS,1,1,1,2,1983,1983,0,No,0,0.0,0.0,0.0,0,0,0,0,0,0,0.0,0.0,0.0,0.0,0.0,0.0
<a href=/player/spruz001>spruz001</a>,Zeke Spruill,Atlanta Braves,BRAVES,4,10,11,21,2013,2019,6,Yes,0,22.68,8.16,-14.52,2194,1203,-991,6430,4358,-2072,1394.0,147.0,-1247.0,14250000.0,0.0,-14250000.0
<a href=/player/spruz001>spruz001</a>,Zeke Spruill,Arizona Diamondbacks,DBACKS,1,1,1,2,2014,2014,0,Yes,0,0.0,0.0,0.0,0,0,0,0,0,0,0.0,0.0,0.0,0.0,0.0,0.0
<a href=/player/spurc001>spurc001</a>,Chris Spurling,New York Yankees,YANKS,1,1,1,2,2000,2003,3,No,0,0.0,-0.26,-0.26,0,76,76,0,222,222,0.0,0.0,0.0,0.0,0.0,0.0
<a href=/player/spurc001>spurc001</a>,Chris Spurling,Atlanta Braves,BRAVES,1,1,1,2,2003,2003,0,No,0,1.26,0.0,-1.26,141,0,-141,0,0,0,477.0,0.0,-477.0,0.0,0.0,0.0
<a href=/player/stace101>stace101</a>,Eddie Stack,Philadelphia Phillies,PHILS,1,1,1,2,1911,1911,0,No,0,1.82,0.0,-1.82,102,0,-102,81,0,-81,685.0,0.0,-685.0,0.0,0.0,0.0
<a href=/player/stace101>stace101</a>,Eddie Stack,Brooklyn Dodgers,DOGRS,1,2,1,3,1913,1915,2,No,0,-0.82,5.81,6.63,36,118,82,23,128,105,201.0,1107.0,906.0,2600.0,0.0,-2600.0
<a href=/player/staem101>staem101</a>,Marv Staehle,Chicago White Sox,WSOX,1,2,1,3,1967,1968,1,No,0,-0.19,0.06,0.25,19,60,41,22,220,198,0.0,0.0,0.0,25000.0,0.0,-25000.0
<a href=/player/staem101>staem101</a>,Marv Staehle,Seattle Pilots,BREWRS,5,7,5,12,1969,1976,7,No,0,3.03,4.56,1.53,664,447,-217,2230,871,-1359,335.0,641.0,306.0,163000.0,0.0,-163000.0
<a href=/player/stafb101>stafb101</a>,Bill Stafford,New York Yankees,YANKS,3,5,4,9,1966,1973,7,No,0,1.66,4.77,3.11,451,607,156,554,678,124,1018.0,1714.0,696.0,17000.0,0.0,-17000.0
<a href=/player/stafg101>stafg101</a>,General Stafford,New York Giants,GIANTS,2,4,3,7,1897,1903,6,No,0,1.21,7.1,5.89,186,517,331,798,2035,1237,0.0,0.0,0.0,0.0,0.0,0.0
<a href=/player/stags101>stags101</a>,Steve Staggs,Toronto Blue Jays,BJAYS,2,2,2,4,1978,1979,1,No,0,0.7,-0.32,-1.02,47,42,-5,97,0,-97,0.0,273.0,273.0,0.0,0.0,0.0
<a href=/player/stahj101>stahj101</a>,Jake Stahl,Chicago White Sox,WSOX,1,1,1,2,1907,1907,0,No,0,1.29,0.0,-1.29,75,0,-75,301,0,-301,0.0,0.0,0.0,0.0,0.0,0.0
<a href=/player/staim001>staim001</a>,Matt Stairs,Oakland Athletics,ATLTCS,1,1,1,2,2000,2000,0,No,0,1.47,0.0,-1.47,128,0,-128,403,0,-403,0.0,0.0,0.0,3050000.0,0.0,-3050000.0
<a href=/player/staim001>staim001</a>,Matt Stairs,Kansas City Royals,ROYALS,1,1,1,2,2006,2006,0,No,0,-0.19,-0.17,0.02,26,4,-22,88,0,-88,0.0,20.0,20.0,1350000.0,0.0,-1350000.0
<a href=/player/staim001>staim001</a>,Matt Stairs,Toronto Blue Jays,BJAYS,1,1,1,2,2008,2009,1,No,0,0.6,0.0,-0.6,115,0,-115,148,0,-148,0.0,0.0,0.0,1625000.0,0.0,-1625000.0
<a href=/player/stair101>stair101</a>,Roy Staiger,New York Mets,METS,1,1,1,2,1977,1977,0,No,0,0.04,0.0,-0.04,4,0,-4,13,0,-13,0.0,0.0,0.0,40000.0,0.0,-40000.0
<a href=/player/stait101>stait101</a>,Tuck Stainback,Chicago Cubs,CUBS,1,4,1,5,1938,1938,0,No,0,10.27,2.49,-7.78,576,26,-550,361,27,-334,2894.0,224.0,-2670.0,0.0,0.0,0.0
<a href=/player/stait101>stait101</a>,Tuck Stainback,Philadelphia Phillies,PHILS,1,1,1,2,1938,1939,1,No,0,-0.5,1.49,1.99,103,163,60,318,603,285,0.0,0.0,0.0,0.0,0.0,0.0
<a href=/player/stait101>stait101</a>,Tuck Stainback,Detroit Tigers,TIGRS,1,2,1,3,1941,1946,5,No,0,-0.12,-1.38,-1.26,211,88,-123,687,313,-374,0.0,0.0,0.0,0.0,0.0,0.0
<a href=/player/stait101>stait101</a>,Tuck Stainback,LosAngeles,LosAngeles,1,1,3,4,1933,1937,4,No,0,-1.72,0.0,1.72,267,0,-267,727,0,-727,0.0,0.0,0.0,0.0,0.0,0.0
<a href=/player/stalg102>stalg102</a>,George Staller,Brooklyn Dodgers,DOGRS,2,9,3,12,1941,1947,6,No,0,3.3,-0.19,-3.49,337,37,-300,419,81,-338,1285.0,0.0,-1285.0,17500.0,0.0,-17500.0
<a href=/player/stalg103>stalg103</a>,Gerry Staley,St. Louis Cardinals,CARDS,1,2,1,3,1954,1956,2,No,0,-0.38,0.61,0.99,264,56,-208,738,5,-733,359.0,117.0,-242.0,0.0,0.0,0.0
<a href=/player/stalg103>stalg103</a>,Gerry Staley,Chicago White Sox,WSOX,11,17,21,38,1961,1969,8,No,0,15.81,27.33,11.52,1761,2250,489,3197,3489,292,3384.0,5251.0,1867.0,77750.0,0.0,-77750.0
<a href=/player/stalg103>stalg103</a>,Gerry Staley,Kansas City Athletics,ATLTCS,1,2,2,4,1961,1963,2,No,0,0.04,2.6,2.56,55,199,144,51,85,34,40.0,733.0,693.0,0.0,0.0,0.0
<a href=/player/stalt101>stalt101</a>,Tracy Stallard,Boston Red Sox,RSOX,2,4,2,6,1962,1966,4,No,0,1.63,7.14,5.51,379,407,28,759,1449,690,1141.0,0.0,-1141.0,0.0,0.0,0.0
<a href=/player/stalt101>stalt101</a>,Tracy Stallard,New York Mets,METS,1,2,2,4,1964,1964,0,No,0,0.41,0.0,-0.41,120,0,-120,87,0,-87,740.0,0.0,-740.0,0.0,0.0,0.0
<a href=/player/stalv101>stalv101</a>,Virgil Stallcup,Cincinnati Reds,REDS,2,3,4,7,1952,1953,1,No,0,3.75,-0.48,-4.23,393,72,-321,1163,232,-931,0.0,0.0,0.0,25500.0,0.0,-25500.0
<a href=/player/stame001>stame001</a>,Eric Stamets,Anaheim Angels,ANGELS,1,1,1,2,2015,2015,0,No,0,-0.71,-0.3,0.41,15,48,33,48,162,114,0.0,0.0,0.0,0.0,0.0,0.0
<a href=/player/stana001>stana001</a>,Andy Stankiewicz,New York Yankees,YANKS,1,2,1,3,1993,1994,1,No,0,0.14,-0.35,-0.49,80,32,-48,134,0,-134,0.0,120.0,120.0,138000.0,0.0,-138000.0
<a href=/player/stand101>stand101</a>,Don Stanhouse,Oakland Athletics,ATLTCS,2,3,2,5,1972,1972,0,No,0,-1.73,-0.85,0.88,237,13,-224,63,9,-54,1061.0,67.0,-994.0,75000.0,0.0,-75000.0
<a href=/player/stand101>stand101</a>,Don Stanhouse,Texas Rangers,RNGRS,2,3,3,6,1974,1976,2,No,0,4.6,-0.5,-5.1,567,57,-510,1479,176,-1303,1066.0,63.0,-1003.0,14000.0,0.0,-14000.0
<a href=/player/stand101>stand101</a>,Don Stanhouse,Montreal Expos,NATEX,2,4,4,8,1977,1986,9,No,1,17.04,9.82,-7.22,1002,871,-131,2634,1351,-1283,744.0,3222.0,2478.0,0.0,0.0,0.0
<a href=/player/stane101>stane101</a>,Eddie Stanky,Chicago Cubs,CUBS,1,1,1,2,1944,1950,6,No,0,16.22,5.86,-10.36,532,379,-153,2362,203,-2159,0.0,1878.0,1878.0,0.0,0.0,0.0
<a href=/player/stane101>stane101</a>,Eddie Stanky,Brooklyn Dodgers,DOGRS,1,2,3,5,1948,1948,0,No,0,8.05,0.0,-8.05,219,0,-219,971,0,-971,0.0,0.0,0.0,0.0,0.0,0.0
<a href=/player/stane101>stane101</a>,Eddie Stanky,Boston Braves,BRAVES,3,12,6,18,1949,1960,11,No,0,49.35,33.68,-15.67,2025,1559,-466,7279,6319,-960,2138.0,0.0,-2138.0,0.0,0.0,0.0
<a href=/player/stane101>stane101</a>,Eddie Stanky,New York Giants,GIANTS,2,5,3,8,1951,1957,6,No,0,0.88,3.03,2.15,70,374,304,145,124,-21,0.0,1136.0,1136.0,32500.0,0.0,-32500.0
<a href=/player/stanf101>stanf101</a>,Fred Stanley,Cleveland Indians,INDINS,1,1,1,2,1972,1972,0,No,0,-0.3,0.29,0.59,39,44,5,99,16,-83,0.0,174.0,174.0,10500.0,0.0,-10500.0
<a href=/player/stanf101>stanf101</a>,Fred Stanley,San Diego Padres,PADRS,1,1,1,2,1972,1972,0,No,0,2.85,0.0,-2.85,521,0,-521,1157,0,-1157,0.0,0.0,0.0,0.0,0.0,0.0
<a href=/player/stanf101>stanf101</a>,Fred Stanley,New York Yankees,YANKS,2,5,3,8,1980,1985,5,No,0,23.27,1.25,-22.02,1007,92,-915,3692,0,-3692,136.0,811.0,675.0,650000.0,0.0,-650000.0
<a href=/player/stanj105>stanj105</a>,Joe Stanka,Chicago Cubs,CUBS,3,7,5,12,1955,1961,6,No,0,-0.03,2.29,2.32,58,334,276,20,837,817,147.0,324.0,177.0,0.0,0.0,0.0
<a href=/player/stanl101>stanl101</a>,Lee Stange,Minnesota Twins,TWINS,4,9,8,17,1964,1971,7,No,0,23.37,18.05,-5.32,1251,1468,217,3644,1313,-2331,1591.0,4850.0,3259.0,202500.0,0.0,-202500.0
<a href=/player/stanl101>stanl101</a>,Lee Stange,Cleveland Indians,INDINS,3,6,4,10,1966,1968,2,No,0,5.05,0.29,-4.76,824,214,-610,588,274,-314,3146.0,179.0,-2967.0,27000.0,0.0,-27000.0
<a href=/player/stanl102>stanl102</a>,Leroy Stanton,New York Mets,METS,1,4,1,5,1971,1973,2,No,0,45.16,0.14,-45.02,957,146,-811,2120,526,-1594,6672.0,0.0,-6672.0,45950.0,0.0,-45950.0
<a href=/player/stanm002>stanm002</a>,Mike Stanley,Boston Red Sox,RSOX,4,6,6,12,1997,2016,19,Yes,2,9.67,68.59,58.92,482,428,-54,535,36,-499,3841.0,7654.0,3813.0,15100000.0,0.0,-15100000.0
<a href=/player/stanm002>stanm002</a>,Mike Stanley,Toronto Blue Jays,BJAYS,2,2,3,5,1998,2000,2,No,0,2.97,0.45,-2.52,241,88,-153,918,207,-711,0.0,243.0,243.0,2020000.0,0.0,-2020000.0
<a href=/player/stanm003>stanm003</a>,Mike Stanton,Atlanta Braves,BRAVES,2,3,3,6,1995,1997,2,No,0,1.44,0.0,-1.44,84,28,-56,0,58,58,245.0,0.0,-245.0,1500000.0,0.0,-1500000.0
<a href=/player/stanm003>stanm003</a>,Mike Stanton,Boston Red Sox,RSOX,5,9,9,18,1996,2000,4,No,0,9.7,3.32,-6.38,608,447,-161,1634,946,-688,1320.0,379.0,-941.0,7038500.0,0.0,-7038500.0
<a href=/player/stanm003>stanm003</a>,Mike Stanton,New York Mets,METS,1,1,1,2,2004,2005,1,No,0,-0.09,0.11,0.2,33,6,-27,0,0,0,42.0,8.0,-34.0,3000000.0,0.0,-3000000.0
<a href=/player/stanm003>stanm003</a>,Mike Stanton,Washington Nationals,NATEX,1,1,2,3,2005,2005,0,No,0,0.05,0.0,-0.05,1,0,-1,0,0,0,3.0,0.0,-3.0,0.0,0.0,0.0
<a href=/player/stanm003>stanm003</a>,Mike Stanton,Washington Nationals,NATEX,1,1,1,2,2006,2011,5,No,0,0.66,0.59,-0.07,52,38,-14,1,35,34,70.0,319.0,249.0,1000000.0,0.0,-1000000.0
<a href=/player/stanm004>stanm004</a>,Giancarlo Stanton,Miami Marlins,MARLNS,1,1,3,4,2017,2021,4,Yes,0,8.41,2.42,-5.99,338,321,-17,1450,1323,-127,0.0,8.0,8.0,14500000.0,0.0,-14500000.0
<a href=/player/stano101>stano101</a>,Oscar Stanage,St. Louis Cardinals,CARDS,2,2,2,4,1906,1907,1,No,0,-0.02,0.29,0.31,1,38,37,1,59,58,0.0,418.0,418.0,0.0,0.0,0.0
<a href=/player/stanr001>stanr001</a>,Rob Stanifer,Florida Marlins,MARLNS,1,1,1,2,1999,1999,0,No,0,-0.55,0.0,0.55,11,0,-11,0,0,0,39.0,0.0,-39.0,0.0,0.0,0.0
<a href=/player/stanr002>stanr002</a>,Ryne Stanek,Tampa Bay Devil Rays,RAYS,2,4,4,8,2019,2021,2,Yes,0,4.08,3.02,-1.06,256,108,-148,694,3,-691,153.0,553.0,400.0,564200.0,0.0,-564200.0
<a href=/player/stans001>stans001</a>,Steve Stanicek,San Francisco Giants,GIANTS,1,1,1,2,1986,1986,0,No,0,0.06,0.0,-0.06,4,0,-4,7,0,-7,0.0,0.0,0.0,0.0,0.0,0.0
<a href=/player/starc101>starc101</a>,Charlie Starr,Pittsburgh Pirates,PIRATS,1,1,1,2,1909,1914,5,No,0,0.03,0.51,0.48,61,239,178,259,700,441,0.0,0.0,0.0,0.0,0.0,0.0
<a href=/player/starc101>starc101</a>,Charlie Starr,Boston Braves,BRAVES,5,7,8,15,1909,1927,18,No,0,12.27,37.78,25.51,647,1815,1168,1592,4784,3192,2058.0,9235.0,7177.0,6000.0,0.0,-6000.0
<a href=/player/stard001>stard001</a>,Denny Stark,Seattle Mariners,MARNRS,3,7,6,13,2001,2008,7,No,0,8.61,1.58,-7.03,1096,337,-759,200,984,784,2142.0,123.0,-2019.0,1587500.0,0.0,-1587500.0
<a href=/player/stard101>stard101</a>,Dolly Stark,Brooklyn Dodgers,DOGRS,1,2,2,4,1912,1916,4,No,0,0.0,-0.4,-0.4,0,214,214,0,788,788,0.0,0.0,0.0,4200.0,0.0,-4200.0
<a href=/player/stard102>stard102</a>,Dick Starr,New York Yankees,YANKS,2,7,3,10,1948,1954,6,No,0,24.48,2.06,-22.42,970,341,-629,1730,188,-1542,4702.0,1746.0,-2956.0,11500.0,0.0,-11500.0
<a href=/player/stard102>stard102</a>,Dick Starr,St.Louis Browns,ORLS,3,6,4,10,1951,1952,1,No,0,0.57,-0.84,-1.41,178,114,-64,353,328,-25,184.0,82.0,-102.0,0.0,0.0,0.0
<a href=/player/starr101>starr101</a>,Ray Starr,St. Louis Cardinals,CARDS,3,6,6,12,1932,1939,7,No,0,8.47,6.35,-2.12,942,482,-460,3293,766,-2527,60.0,2559.0,2499.0,0.0,0.0,0.0
<a href=/player/stasm001>stasm001</a>,Max Stassi,Oakland Athletics,ATLTCS,1,3,2,5,2013,2016,3,No,0,8.06,4.16,-3.9,776,397,-379,2069,1228,-841,1629.0,325.0,-1304.0,0.0,0.0,0.0
<a href=/player/stasm001>stasm001</a>,Max Stassi,Houston Astros,ASTROS,1,1,2,3,2019,2019,0,Yes,0,2.05,0.0,-2.05,138,0,-138,473,0,-473,0.0,0.0,0.0,590100.0,0.0,-590100.0
<a href=/player/statj101>statj101</a>,Jigger Statz,LosAngeles,LosAngeles,1,2,5,7,1921,1922,1,No,0,14.87,0.0,-14.87,633,0,-633,2280,0,-2280,2159.0,0.0,-2159.0,0.0,0.0,0.0
<a href=/player/staur001>staur001</a>,Rusty Staub,Houston Astros,ASTROS,1,1,2,3,1969,1973,4,No,0,18.54,0.22,-18.32,518,434,-84,2163,1578,-585,0.0,0.0,0.0,0.0,0.0,0.0
<a href=/player/staur001>staur001</a>,Rusty Staub,Montreal Expos,NATEX,5,7,9,16,1972,1985,13,No,0,40.49,30.74,-9.75,2632,3209,577,9789,10505,716,812.0,1543.0,731.0,193500.0,0.0,-193500.0
<a href=/player/staur001>staur001</a>,Rusty Staub,New York Mets,METS,1,2,2,4,1975,1979,4,No,0,6.09,1.21,-4.88,575,71,-504,2407,95,-2312,284.0,578.0,294.0,110000.0,0.0,-110000.0
<a href=/player/staur001>staur001</a>,Rusty Staub,Detroit Tigers,TIGRS,1,1,2,3,1979,1979,0,No,0,0.03,0.0,-0.03,38,0,-38,101,0,-101,0.0,0.0,0.0,0.0,0.0,0.0
<a href=/player/staur001>staur001</a>,Rusty Staub,Montreal Expos,NATEX,2,2,3,5,1980,1986,6,No,0,1.65,1.2,-0.45,131,327,196,465,635,170,0.0,0.0,0.0,0.0,0.0,0.0
<a href=/player/stcle101>stcle101</a>,Ebba St. Claire,Pittsburgh Pirates,PIRATS,1,1,1,2,1948,1948,0,No,0,0.0,0.0,0.0,0,0,0,0,0,0,0.0,0.0,0.0,0.0,0.0,0.0
<a href=/player/stcle101>stcle101</a>,Ebba St. Claire,Milwaukee Braves,BRAVES,2,8,3,11,1954,1960,6,No,0,39.41,8.38,-31.03,1145,621,-524,1887,2335,448,6059.0,0.0,-6059.0,0.0,0.0,0.0
<a href=/player/stclr001>stclr001</a>,Randy St. Claire,Montreal Expos,NATEX,3,5,4,9,1988,1992,4,No,0,1.15,0.52,-0.63,739,280,-459,1881,660,-1221,41.0,0.0,-41.0,330000.0,0.0,-330000.0
<a href=/player/steaj001>steaj001</a>,John Stearns,Philadelphia Phillies,PHILS,2,4,4,8,1974,1984,10,No,0,23.16,7.68,-15.48,1035,1011,-24,3964,168,-3796,0.0,2166.0,2166.0,0.0,0.0,0.0
<a href=/player/steeb103>steeb103</a>,Bob Steele,St. Louis Cardinals,CARDS,5,8,7,15,1917,1928,11,No,0,8.64,27.59,18.95,1465,1547,82,4888,6229,1341,1090.0,0.0,-1090.0,36000.0,0.0,-36000.0
<a href=/player/steem101>steem101</a>,Morrie Steevens,Chicago Cubs,CUBS,1,1,1,2,1964,1964,0,No,0,-0.56,0.0,0.56,20,0,-20,0,0,0,16.0,0.0,-16.0,0.0,0.0,0.0
<a href=/player/stefj001>stefj001</a>,John Stefero,Baltimore Orioles,ORLS,2,3,2,5,1986,1991,5,No,0,29.01,1.13,-27.88,569,267,-302,791,631,-160,4827.0,0.0,-4827.0,630458.0,0.0,-630458.0
<a href=/player/stegd001>stegd001</a>,Dave Stegman,Detroit Tigers,TIGRS,1,1,1,2,1980,1981,1,No,0,0.0,-0.19,-0.19,0,6,6,0,0,0,0.0,11.0,11.0,0.0,0.0,0.0
<a href=/player/stegd001>stegd001</a>,Dave Stegman,San Diego Padres,PADRS,1,1,1,2,1981,1981,0,No,0,-0.03,0.0,0.03,2,0,-2,0,0,0,0.0,0.0,0.0,0.0,0.0,0.0
<a href=/player/steib001>steib001</a>,Bill Stein,St. Louis Cardinals,CARDS,1,1,1,2,1973,1975,2,No,0,0.0,-0.55,-0.55,0,30,30,0,47,47,0.0,0.0,0.0,0.0,0.0,0.0
<a href=/player/steib001>steib001</a>,Bill Stein,California Angels,ANGELS,1,1,2,3,1974,1974,0,No,0,0.75,0.0,-0.75,206,0,-206,720,0,-720,0.0,0.0,0.0,0.0,0.0,0.0
<a href=/player/steib002>steib002</a>,Blake Stein,St. Louis Cardinals,CARDS,1,3,1,4,1997,1997,0,No,0,-0.38,2.04,2.42,256,51,-205,9,224,215,1161.0,0.0,-1161.0,395000.0,0.0,-395000.0
<a href=/player/steib002>steib002</a>,Blake Stein,Oakland Athletics,ATLTCS,9,14,13,27,1999,2009,10,No,2,17.9,16.23,-1.67,1131,951,-180,1914,3253,1339,7029.0,1397.0,-5632.0,1148500.0,0.0,-1148500.0
<a href=/player/steih101>steih101</a>,Harry Steinfeldt,Cincinnati Reds,REDS,2,4,3,7,1905,1910,5,No,0,18.64,12.54,-6.1,746,275,-471,3017,389,-2628,9.0,2982.0,2973.0,0.0,0.0,0.0
<a href=/player/steih101>steih101</a>,Harry Steinfeldt,StPaul,StPaul,2,3,3,6,1911,1912,1,No,0,1.07,0.0,-1.07,144,0,-144,499,0,-499,0.0,0.0,0.0,0.0,0.0,0.0
<a href=/player/steij101>steij101</a>,Justin Stein,Philadelphia Phillies,PHILS,1,1,1,2,1938,1939,1,No,0,0.04,0.84,0.8,11,87,76,19,330,311,0.0,0.0,0.0,0.0,0.0,0.0
<a href=/player/steij101>steij101</a>,Justin Stein,Cincinnati Reds,REDS,1,1,1,2,1938,1938,0,No,0,0.0,0.68,0.68,0,35,35,0,106,106,0.0,0.0,0.0,0.0,0.0,0.0
<a href=/player/steir101>steir101</a>,Randy Stein,New York Yankees,YANKS,1,2,1,3,1977,1977,0,No,0,0.0,0.37,0.37,0,8,8,0,27,27,0.0,0.0,0.0,0.0,0.0,0.0
<a href=/player/steir101>steir101</a>,Randy Stein,Milwaukee Brewers,BREWRS,1,1,1,2,1979,1981,2,No,0,-0.94,0.72,1.66,28,35,7,0,0,0,152.0,493.0,341.0,0.0,0.0,0.0
<a href=/player/stelr101>stelr101</a>,Rick Stelmaszek,Texas Rangers,RNGRS,7,19,12,31,1973,1988,15,No,0,43.57,39.21,-4.36,2413,2544,131,8647,8625,-22,2773.0,4668.0,1895.0,457000.0,0.0,-457000.0
<a href=/player/stelr101>stelr101</a>,Rick Stelmaszek,California Angels,ANGELS,1,1,1,2,1974,1975,1,No,0,0.19,0.43,0.24,25,11,-14,56,0,-56,0.0,35.0,35.0,0.0,0.0,0.0
<a href=/player/stelr101>stelr101</a>,Rick Stelmaszek,Chicago Cubs,CUBS,1,1,1,2,1976,1978,2,No,0,0.0,0.0,0.0,0,0,0,0,0,0,0.0,0.0,0.0,0.0,0.0,0.0
<a href=/player/stemf101>stemf101</a>,Fred Stem,Boston Braves,BRAVES,1,1,1,2,1909,1910,1,No,0,0.0,-0.66,-0.66,0,65,65,0,234,234,0.0,0.0,0.0,0.0,0.0,0.0
<a href=/player/stenc101>stenc101</a>,Casey Stengel,Brooklyn Dodgers,DOGRS,2,3,4,7,1918,1929,11,No,0,13.23,38.94,25.71,700,1051,351,2619,1612,-1007,779.0,8893.0,8114.0,0.0,0.0,0.0
<a href=/player/stenc101>stenc101</a>,Casey Stengel,Pittsburgh Pirates,PIRATS,1,1,1,2,1919,1922,3,No,0,2.09,4.54,2.45,153,277,124,570,1156,586,0.0,0.0,0.0,4200.0,0.0,-4200.0
<a href=/player/stenc101>stenc101</a>,Casey Stengel,Philadelphia Phillies,PHILS,2,4,4,8,1921,1923,2,No,0,7.05,-3.87,-10.92,351,317,-34,1240,1284,44,0.0,0.0,0.0,5000.0,0.0,-5000.0
<a href=/player/stenc101>stenc101</a>,Casey Stengel,New York Giants,GIANTS,2,4,3,7,1923,1927,4,No,0,14.64,1.52,-13.12,912,442,-470,3712,1550,-2162,0.0,87.0,87.0,25500.0,0.0,-25500.0
<a href=/player/stend101>stend101</a>,Dave Stenhouse,Cincinnati Reds,REDS,1,2,2,4,1961,1966,5,No,0,3.64,1.4,-2.24,249,457,208,410,839,429,1116.0,326.0,-790.0,0.0,0.0,0.0
<a href=/player/stenj101>stenj101</a>,Jake Stenzel,Pittsburgh Pirates,PIRATS,1,4,2,6,1896,1898,2,No,0,3.6,0.48,-3.12,234,186,-48,984,763,-221,0.0,0.0,0.0,0.0,0.0,0.0
<a href=/player/stenj101>stenj101</a>,Jake Stenzel,Baltimore Orioles,BLN,1,2,2,4,1898,1903,5,No,0,2.47,4.06,1.59,268,251,-17,1122,1106,-16,0.0,0.0,0.0,0.0,0.0,0.0
<a href=/player/stenm001>stenm001</a>,Mike Stenhouse,Montreal Expos,NATEX,1,1,1,2,1985,1986,1,No,0,0.02,-0.32,-0.34,81,40,-41,209,0,-209,0.0,71.0,71.0,0.0,0.0,0.0
<a href=/player/stenm001>stenm001</a>,Mike Stenhouse,Minnesota Twins,TWINS,1,1,1,2,1985,1985,0,No,0,-0.11,0.0,0.11,21,0,-21,34,0,-34,0.0,0.0,0.0,0.0,0.0,0.0
<a href=/player/stepb102>stepb102</a>,Bob Stephenson,St. Louis Cardinals,CARDS,19,44,38,82,1956,1972,16,No,0,56.42,67.4,10.98,5645,3260,-2385,13530,9157,-4373,6309.0,6165.0,-144.0,120500.0,0.0,-120500.0
<a href=/player/stepb103>stepb103</a>,Bryan Stephens,Cleveland Indians,INDINS,1,4,2,6,1947,1949,2,No,0,3.17,0.88,-2.29,606,121,-485,1943,303,-1640,368.0,217.0,-151.0,0.0,0.0,0.0
<a href=/player/stepb104>stepb104</a>,Buzz Stephen,Milwaukee Brewers,BREWRS,2,4,2,6,1970,1974,4,No,0,1.37,11.49,10.12,187,678,491,473,2707,2234,0.0,0.0,0.0,0.0,0.0,0.0
<a href=/player/stepe101>stepe101</a>,Earl Stephenson,Chicago Cubs,CUBS,2,4,2,6,1971,1977,6,No,0,12.52,9.33,-3.19,493,821,328,508,3274,2766,3595.0,0.0,-3595.0,150000.0,0.0,-150000.0
<a href=/player/stepe101>stepe101</a>,Earl Stephenson,Milwaukee Brewers,BREWRS,3,6,5,11,1972,1984,12,No,0,7.41,27.71,20.3,475,1402,927,547,5127,4580,4062.0,1332.0,-2730.0,59800.0,0.0,-59800.0
<a href=/player/stepe101>stepe101</a>,Earl Stephenson,Montreal Expos,NATEX,1,1,1,2,1974,1974,0,No,0,0.0,0.0,0.0,0,0,0,0,0,0,0.0,0.0,0.0,0.0,0.0,0.0
<a href=/player/stepg001>stepg001</a>,Garrett Stephenson,Baltimore Orioles,ORLS,1,2,2,4,1996,1997,1,No,0,0.34,0.44,0.1,89,89,0,71,320,249,679.0,0.0,-679.0,0.0,0.0,0.0
<a href=/player/stepg001>stepg001</a>,Garrett Stephenson,Philadelphia Phillies,PHILS,3,4,5,9,1998,2002,4,No,0,4.86,4.39,-0.47,468,569,101,282,1029,747,2055.0,750.0,-1305.0,7696667.0,0.0,-7696667.0
<a href=/player/stepg101>stepg101</a>,Gene Stephens,Boston Red Sox,RSOX,1,1,1,2,1960,1960,0,No,0,1.46,0.31,-1.15,116,105,-11,292,448,156,0.0,0.0,0.0,0.0,0.0,0.0
<a href=/player/stepg101>stepg101</a>,Gene Stephens,Baltimore Orioles,ORLS,2,2,3,5,1961,1963,2,No,0,-0.94,-0.08,0.86,197,127,-70,619,311,-308,0.0,0.0,0.0,0.0,0.0,0.0
<a href=/player/stepj102>stepj102</a>,John Stephenson,New York Mets,METS,1,2,1,3,1967,1967,0,No,0,0.17,0.17,0.0,56,30,-26,61,24,-37,95.0,212.0,117.0,0.0,0.0,0.0
<a href=/player/stepj103>stepj103</a>,Jerry Stephenson,Milwaukee Brewers,BREWRS,1,1,1,2,1970,1970,0,No,0,-0.2,-0.04,0.16,6,2,-4,1,0,-1,20.0,6.0,-14.0,0.0,0.0,0.0
<a href=/player/stepp001>stepp001</a>,Phil Stephenson,Oakland Athletics,ATLTCS,1,2,2,4,1986,1986,0,No,0,-0.31,0.0,0.31,17,0,-17,23,0,-23,0.0,0.0,0.0,0.0,0.0,0.0
<a href=/player/stepp001>stepp001</a>,Phil Stephenson,Chicago Cubs,CUBS,1,3,2,5,1989,1992,3,No,0,9.01,-0.33,-9.34,632,454,-178,1598,1395,-203,382.0,0.0,-382.0,400000.0,0.0,-400000.0
<a href=/player/stepr002>stepr002</a>,Robert Stephenson,Cincinnati Reds,REDS,2,4,3,7,2020,2021,1,Yes,0,0.84,0.31,-0.53,95,46,-49,0,0,0,138.0,64.0,-74.0,0.0,0.0,0.0
<a href=/player/stepr101>stepr101</a>,Riggs Stephenson,Indianapolis,Indianapolis,1,2,3,5,1926,1926,0,No,0,24.0,0.0,-24.0,988,0,-988,3984,0,-3984,0.0,0.0,0.0,0.0,0.0,0.0
<a href=/player/stepv101>stepv101</a>,Vern Stephens,St.Louis Browns,ORLS,54,128,140,268,1947,1994,47,No,3,236.61,240.84,4.23,15655,22232,6577,39533,64017,24484,40519.0,30415.0,-10104.0,1142083.0,0.0,-1142083.0
<a href=/player/stepv101>stepv101</a>,Vern Stephens,Boston Red Sox,RSOX,1,1,3,4,1953,1955,2,No,0,0.29,1.18,0.89,66,202,136,207,118,-89,0.0,1116.0,1116.0,0.0,0.0,0.0
<a href=/player/stera001>stera001</a>,Adam Stern,Boston Red Sox,RSOX,1,2,1,3,2006,2007,1,No,0,0.0,-0.68,-0.68,2,18,16,0,65,65,0.0,0.0,0.0,335000.0,0.0,-335000.0
<a href=/player/stevd001>stevd001</a>,Dave Stevens,Chicago Cubs,CUBS,2,3,2,5,1993,1995,2,No,0,-2.42,-1.8,0.62,423,66,-357,1019,51,-968,662.0,450.0,-212.0,349000.0,0.0,-349000.0
<a href=/player/stevj001>stevj001</a>,Jeff Stevens,Cincinnati Reds,REDS,2,3,3,6,2006,2017,11,Yes,0,1.0,28.05,27.05,120,1614,1494,499,6899,6400,0.0,0.0,0.0,0.0,0.0,0.0
<a href=/player/stevj001>stevj001</a>,Jeff Stevens,Cleveland Indians,INDINS,2,4,3,7,2008,2013,5,No,0,-0.38,5.27,5.65,140,382,242,264,314,50,120.0,883.0,763.0,5500000.0,0.0,-5500000.0
<a href=/player/stevl001>stevl001</a>,Lee Stevens,California Angels,ANGELS,1,1,1,2,1993,1993,0,No,0,-0.62,0.0,0.62,338,0,-338,1374,0,-1374,0.0,0.0,0.0,0.0,0.0,0.0
<a href=/player/stevl001>stevl001</a>,Lee Stevens,Texas Rangers,RNGRS,2,2,3,5,2000,2001,1,No,0,0.34,-0.15,-0.49,395,229,-166,1619,901,-718,0.0,0.0,0.0,4325000.0,0.0,-4325000.0
<a href=/player/stevl001>stevl001</a>,Lee Stevens,Montreal Expos,NATEX,2,6,6,12,2002,2004,2,No,0,48.64,-2.57,-51.21,1323,330,-993,4723,156,-4567,4264.0,874.0,-3390.0,4000000.0,0.0,-4000000.0
<a href=/player/stevr101>stevr101</a>,R C Stevens,Pittsburgh Pirates,PIRATS,1,3,1,4,1960,1961,1,No,0,4.94,2.05,-2.89,573,87,-486,984,20,-964,2463.0,268.0,-2195.0,0.0,0.0,0.0
<a href=/player/stevt001>stevt001</a>,Todd Steverson,Detroit Tigers,TIGRS,8,20,15,35,1996,2002,6,No,1,8.66,7.11,-1.55,2368,1295,-1073,4185,3631,-554,2521.0,1620.0,-901.0,8560000.0,0.0,-8560000.0
<a href=/player/stewa101>stewa101</a>,Ace Stewart,Cincinnati Reds,REDS,1,5,3,8,1897,1900,3,No,0,8.1,12.35,4.25,718,395,-323,2747,1335,-1412,936.0,1747.0,811.0,0.0,0.0,0.0
<a href=/player/stewb101>stewb101</a>,Bud Stewart,New York Yankees,YANKS,1,1,2,3,1948,1948,0,No,0,3.69,0.0,-3.69,354,0,-354,1333,0,-1333,0.0,0.0,0.0,0.0,0.0,0.0
<a href=/player/stewb101>stewb101</a>,Bud Stewart,Washington Senators,TWINS,1,1,1,2,1950,1952,2,No,0,2.29,0.53,-1.76,258,81,-177,600,272,-328,0.0,0.0,0.0,0.0,0.0,0.0
<a href=/player/stewc001>stewc001</a>,Chris Stewart,Chicago White Sox,WSOX,1,1,1,2,2007,2007,0,No,0,-0.29,0.0,0.29,17,0,-17,43,0,-43,0.0,0.0,0.0,0.0,0.0,0.0
<a href=/player/stewc001>stewc001</a>,Chris Stewart,San Francisco Giants,GIANTS,1,1,1,2,2012,2017,5,No,0,0.83,3.38,2.55,164,579,415,497,10,-487,0.0,929.0,929.0,0.0,0.0,0.0
<a href=/player/stewc001>stewc001</a>,Chris Stewart,New York Yankees,YANKS,1,1,1,2,2013,2013,0,Yes,0,-0.19,0.0,0.19,192,0,-192,583,0,-583,0.0,0.0,0.0,515100.0,0.0,-515100.0
<a href=/player/stewd001>stewd001</a>,Dave Stewart,Los Angeles Dodgers,DOGRS,5,8,6,14,1983,1994,11,No,0,11.39,19.01,7.62,690,775,85,366,1238,872,3528.0,4504.0,976.0,3861000.0,0.0,-3861000.0
<a href=/player/stewd001>stewd001</a>,Dave Stewart,Texas Rangers,RNGRS,2,3,2,5,1985,1987,2,No,0,-0.22,-0.57,-0.35,24,23,-1,0,0,0,50.0,96.0,46.0,505000.0,0.0,-505000.0
<a href=/player/stewi001>stewi001</a>,Ian Stewart,Colorado Rockies,ROCKS,1,2,2,4,2011,2018,7,No,0,0.03,17.66,17.63,55,1081,1026,202,4267,4065,0.0,0.0,0.0,2287500.0,0.0,-2287500.0
<a href=/player/stewj102>stewj102</a>,Jimmy Stewart,Cincinnati Reds,REDS,7,9,14,23,1971,1982,11,No,1,32.36,75.99,43.63,1555,3237,1682,4173,10169,5996,5915.0,4444.0,-1471.0,0.0,0.0,0.0
<a href=/player/stewl101>stewl101</a>,Lefty Stewart,Detroit Tigers,TIGRS,2,5,4,9,1927,1934,7,No,0,25.64,16.62,-9.02,1182,957,-225,3618,3579,-39,3712.0,0.0,-3712.0,12500.0,0.0,-12500.0
<a href=/player/stewl101>stewl101</a>,Lefty Stewart,St.Louis Browns,ORLS,20,38,48,86,1932,1952,20,No,0,96.01,96.11,0.1,5218,8686,3468,17109,27646,10537,8613.0,15510.0,6897.0,185500.0,0.0,-185500.0
<a href=/player/stewl101>stewl101</a>,Lefty Stewart,Washington Senators,TWINS,1,1,1,2,1935,1935,0,No,0,-0.66,-0.22,0.44,48,20,-28,33,9,-24,273.0,93.0,-180.0,7000.0,0.0,-7000.0
<a href=/player/stews001>stews001</a>,Sammy Stewart,Baltimore Orioles,ORLS,1,1,1,2,1985,1988,3,No,0,0.3,-1.8,-2.1,27,64,37,0,153,153,191.0,0.0,-191.0,581250.0,0.0,-581250.0
<a href=/player/stews002>stews002</a>,Shannon Stewart,Toronto Blue Jays,BJAYS,4,6,4,10,2003,2013,10,No,1,7.01,7.32,0.31,637,503,-134,2571,1420,-1151,67.0,1516.0,1449.0,6200000.0,0.0,-6200000.0
<a href=/player/stews003>stews003</a>,Scott Stewart,Montreal Expos,NATEX,7,12,10,22,2004,2012,8,No,1,31.18,14.79,-16.39,2584,1552,-1032,7608,3578,-4030,729.0,1136.0,407.0,5079000.0,0.0,-5079000.0
<a href=/player/stews101>stews101</a>,Stuffy Stewart,St. Louis Cardinals,CARDS,4,7,6,13,1919,1928,9,No,0,6.49,22.08,15.59,1385,1345,-40,4793,5431,638,403.0,0.0,-403.0,33500.0,0.0,-33500.0
<a href=/player/stews101>stews101</a>,Stuffy Stewart,Washington Senators,TWINS,1,3,1,4,1929,1929,0,No,0,0.0,0.0,0.0,0,0,0,0,0,0,0.0,0.0,0.0,0.0,0.0,0.0
<a href=/player/stewz001>stewz001</a>,Zach Stewart,Cincinnati Reds,REDS,1,3,1,4,2009,2012,3,No,0,24.68,7.61,-17.07,1033,330,-703,4205,1298,-2907,160.0,0.0,-160.0,2425000.0,0.0,-2425000.0
<a href=/player/stewz001>stewz001</a>,Zach Stewart,Toronto Blue Jays,BJAYS,2,6,6,12,2011,2014,3,No,0,-0.73,6.64,7.37,396,443,47,89,1646,1557,842.0,15.0,-827.0,7829600.0,0.0,-7829600.0
<a href=/player/stewz001>stewz001</a>,Zach Stewart,Chicago White Sox,WSOX,1,2,2,4,2012,2012,0,No,0,-0.96,1.4,2.36,12,80,68,16,344,328,17.0,0.0,-17.0,0.0,0.0,0.0
<a href=/player/stewz001>stewz001</a>,Zach Stewart,Boston Red Sox,RSOX,1,1,1,2,2012,2012,0,No,0,0.0,0.0,0.0,0,0,0,0,0,0,0.0,0.0,0.0,481500.0,0.0,-481500.0
<a href=/player/stigd101>stigd101</a>,Dick Stigman,Cleveland Indians,INDINS,6,8,11,19,1962,1969,7,No,0,9.88,8.16,-1.72,1353,584,-769,1625,332,-1293,4119.0,3147.0,-972.0,97100.0,0.0,-97100.0
<a href=/player/stigd101>stigd101</a>,Dick Stigman,Minnesota Twins,TWINS,1,2,2,4,1966,1968,2,No,0,-1.3,-0.53,0.77,68,125,57,19,299,280,243.0,0.0,-243.0,0.0,0.0,0.0
<a href=/player/stigd101>stigd101</a>,Dick Stigman,Boston Red Sox,RSOX,1,3,1,4,1966,1966,0,No,0,0.0,0.6,0.6,0,12,12,0,10,10,0.0,93.0,93.0,18500.0,0.0,-18500.0
<a href=/player/stilk001>stilk001</a>,Kurt Stillwell,Cincinnati Reds,REDS,1,2,2,4,1987,1990,3,No,0,6.27,5.43,-0.84,546,156,-390,2022,182,-1840,241.0,1481.0,1240.0,580000.0,0.0,-580000.0
<a href=/player/stilr102>stilr102</a>,Royle Stillman,Los Angeles Dodgers,DOGRS,3,10,5,15,1971,1976,5,No,0,18.58,22.72,4.14,838,611,-227,2013,960,-1053,3623.0,2900.0,-723.0,259900.0,0.0,-259900.0
<a href=/player/stinb101>stinb101</a>,Bob Stinson,Los Angeles Dodgers,DOGRS,3,4,4,8,1970,1978,8,No,1,24.33,19.6,-4.73,1044,519,-525,4315,1112,-3203,0.0,3594.0,3594.0,125000.0,0.0,-125000.0
<a href=/player/stinb101>stinb101</a>,Bob Stinson,St. Louis Cardinals,CARDS,2,2,2,4,1971,1972,1,No,0,-1.0,-0.24,0.76,49,22,-27,82,26,-56,0.0,0.0,0.0,0.0,0.0,0.0
<a href=/player/stinb101>stinb101</a>,Bob Stinson,Montreal Expos,NATEX,2,2,2,4,1975,1977,2,No,0,2.74,-0.3,-3.04,142,33,-109,417,12,-405,0.0,62.0,62.0,0.0,0.0,0.0
<a href=/player/stink001>stink001</a>,Kelly Stinnett,New York Mets,METS,1,1,1,2,1996,1997,1,No,0,-0.45,0.35,0.8,44,105,61,68,6,-62,0.0,245.0,245.0,0.0,0.0,0.0
<a href=/player/stink001>stink001</a>,Kelly Stinnett,Cincinnati Reds,REDS,1,1,1,2,2003,2003,0,No,0,0.08,-0.3,-0.38,7,18,11,8,44,36,0.0,0.0,0.0,1300000.0,0.0,-1300000.0
<a href=/player/stinl101>stinl101</a>,Lee Stine,SanFrancisco,SanFrancisco,1,1,3,4,1934,1934,0,No,0,-0.14,0.0,0.14,10,0,-10,2,0,-2,39.0,0.0,-39.0,0.0,0.0,0.0
<a href=/player/stirs101>stirs101</a>,Snuffy Stirnweiss,New York Yankees,YANKS,2,8,4,12,1950,1954,4,No,0,21.38,0.72,-20.66,1235,437,-798,2252,180,-2072,6559.0,1785.0,-4774.0,29000.0,0.0,-29000.0
<a href=/player/stirs101>stirs101</a>,Snuffy Stirnweiss,St.Louis Browns,ORLS,2,4,3,7,1951,1952,1,No,0,-0.57,0.21,0.78,160,272,112,343,951,608,171.0,0.0,-171.0,6000.0,0.0,-6000.0
<a href=/player/stitm001>stitm001</a>,Matt Stites,San Diego Padres,PADRS,1,2,1,3,2013,2015,2,No,0,-1.32,1.52,2.84,205,142,-63,0,131,131,225.0,1280.0,1055.0,0.0,0.0,0.0
<a href=/player/stobc101>stobc101</a>,Chuck Stobbs,Boston Red Sox,RSOX,4,10,9,19,1951,1956,5,No,0,13.39,14.14,0.75,1557,1085,-472,4986,3287,-1699,2205.0,1545.0,-660.0,102000.0,0.0,-102000.0
<a href=/player/stobc101>stobc101</a>,Chuck Stobbs,Chicago White Sox,WSOX,3,6,4,10,1952,1961,9,No,0,29.42,7.92,-21.5,1605,736,-869,3412,1543,-1869,5853.0,1370.0,-4483.0,72000.0,0.0,-72000.0
<a href=/player/stock001>stock001</a>,Kevin Stocker,Philadelphia Phillies,PHILS,2,3,5,8,1997,2009,12,No,0,10.22,47.24,37.02,613,1399,786,2435,5885,3450,136.0,38.0,-98.0,17790000.0,0.0,-17790000.0
<a href=/player/stocm101>stocm101</a>,Milt Stock,Boston Braves,BRAVES,1,1,1,2,1913,1913,0,No,0,3.11,0.0,-3.11,122,0,-122,433,0,-433,0.0,0.0,0.0,0.0,0.0,0.0
<a href=/player/stocm101>stocm101</a>,Milt Stock,New York Giants,GIANTS,1,3,1,4,1915,1915,0,No,0,8.83,1.16,-7.67,856,106,-750,2811,431,-2380,1477.0,0.0,-1477.0,0.0,0.0,0.0
<a href=/player/stocm101>stocm101</a>,Milt Stock,Philadelphia Phillies,PHILS,4,9,10,19,1919,1929,10,No,0,27.15,17.61,-9.54,1789,754,-1035,5788,2055,-3733,4451.0,3446.0,-1005.0,8500.0,0.0,-8500.0
<a href=/player/stocm101>stocm101</a>,Milt Stock,St. Louis Cardinals,CARDS,3,4,3,7,1924,1928,4,No,0,5.25,10.3,5.05,1271,559,-712,4468,2053,-2415,0.0,0.0,0.0,30500.0,0.0,-30500.0
<a href=/player/stocw101>stocw101</a>,Wes Stock,Baltimore Orioles,ORLS,1,1,1,2,1964,1967,3,No,0,3.8,1.47,-2.33,296,159,-137,29,359,330,713.0,0.0,-713.0,13500.0,0.0,-13500.0
<a href=/player/stodb001>stodb001</a>,Bob Stoddard,Oakland Athletics,ATLTCS,1,2,1,3,1986,1987,1,No,0,0.5,0.04,-0.46,36,22,-14,1,42,41,70.0,0.0,-70.0,0.0,0.0,0.0
<a href=/player/stodt001>stodt001</a>,Tim Stoddard,Baltimore Orioles,ORLS,1,1,1,2,1983,1986,3,No,0,0.0,4.34,4.34,0,230,230,0,678,678,0.0,0.0,0.0,0.0,0.0,0.0
<a href=/player/stodt001>stodt001</a>,Tim Stoddard,Oakland Athletics,ATLTCS,1,1,2,3,1984,1984,0,No,0,0.61,0.0,-0.61,116,0,-116,12,0,-12,276.0,0.0,-276.0,0.0,0.0,0.0
<a href=/player/stodt001>stodt001</a>,Tim Stoddard,San Diego Padres,PADRS,1,1,1,2,1986,1986,0,No,0,0.95,-0.49,-1.44,109,34,-75,0,20,20,591.0,227.0,-364.0,675000.0,0.0,-675000.0
<a href=/player/stoka102>stoka102</a>,Al Stokes,Boston Red Sox,RSOX,1,4,2,6,1926,1926,0,No,0,0.0,0.0,0.0,0,0,0,0,0,0,0.0,0.0,0.0,15750.0,0.0,-15750.0
<a href=/player/stokb001>stokb001</a>,Brian Stokes,New York Mets,METS,1,1,2,3,2010,2010,0,No,0,-0.59,-0.59,0.0,16,36,20,0,65,65,50.0,0.0,-50.0,0.0,0.0,0.0
<a href=/player/stokt001>stokt001</a>,Troy Stokes,Pittsburgh Pirates,PIRATS,1,2,1,3,2021,2021,0,Yes,0,0.06,0.0,-0.06,26,0,-26,2,0,-2,55.0,0.0,-55.0,0.0,0.0,0.0
<a href=/player/stona101>stona101</a>,Arnie Stone,Pittsburgh Pirates,PIRATS,1,2,1,3,1924,1925,1,No,0,0.0,-0.02,-0.02,0,14,14,0,41,41,0.0,0.0,0.0,3600.0,0.0,-3600.0
<a href=/player/stond102>stond102</a>,Dean Stone,Washington Senators,TWINS,2,3,4,7,1957,1960,3,No,0,-2.93,-2.21,0.72,70,643,573,21,1367,1346,250.0,1860.0,1610.0,19500.0,0.0,-19500.0
<a href=/player/stond102>stond102</a>,Dean Stone,Boston Red Sox,RSOX,2,2,2,4,1959,1961,2,No,0,0.35,0.78,0.43,36,142,106,4,184,180,90.0,116.0,26.0,0.0,0.0,0.0
<a href=/player/stond102>stond102</a>,Dean Stone,Houston Astros,ASTROS,1,1,1,2,1962,1962,0,No,0,0.75,0.82,0.07,54,72,18,2,10,8,91.0,204.0,113.0,12500.0,0.0,-12500.0
<a href=/player/stong101>stong101</a>,George Stone,Boston Red Sox,RSOX,1,2,1,3,1904,1906,2,No,0,26.05,2.67,-23.38,846,148,-698,3645,654,-2991,0.0,0.0,0.0,0.0,0.0,0.0
<a href=/player/stong102>stong102</a>,George Stone,Atlanta Braves,BRAVES,2,3,3,6,1972,1978,6,No,0,10.9,-1.86,-12.76,922,458,-464,3059,568,-2491,1139.0,600.0,-539.0,0.0,0.0,0.0
<a href=/player/stong102>stong102</a>,George Stone,New York Mets,METS,1,1,1,2,1976,1976,0,No,0,0.0,0.0,0.0,0,0,0,0,0,0,0.0,0.0,0.0,0.0,0.0,0.0
<a href=/player/stonj001>stonj001</a>,Jeff Stone,Philadelphia Phillies,PHILS,2,4,3,7,1988,1988,0,No,0,-2.46,0.71,3.17,165,85,-80,504,178,-326,0.0,49.0,49.0,395000.0,0.0,-395000.0
<a href=/player/stonj102>stonj102</a>,John Stone,Detroit Tigers,TIGRS,1,1,1,2,1933,1937,4,No,0,15.44,9.25,-6.19,556,524,-32,2336,2216,-120,0.0,0.0,0.0,7000.0,0.0,-7000.0
<a href=/player/stonr102>stonr102</a>,Ron Stone,Baltimore Orioles,ORLS,1,1,1,2,1969,1969,0,No,0,-3.37,0.83,4.2,362,37,-325,903,94,-809,0.0,0.0,0.0,0.0,0.0,0.0
<a href=/player/stons101>stons101</a>,Steve Stone,San Francisco Giants,GIANTS,1,2,1,3,1972,1976,4,No,0,13.25,-0.15,-13.4,475,156,-319,1568,147,-1421,1787.0,1201.0,-586.0,0.0,0.0,0.0
<a href=/player/stons101>stons101</a>,Steve Stone,Chicago White Sox,WSOX,1,4,1,5,1973,1973,0,No,0,6.5,0.0,-6.5,800,0,-800,1477,0,-1477,2061.0,0.0,-2061.0,32700.0,0.0,-32700.0
<a href=/player/stooj001>stooj001</a>,Jim Stoops,San Francisco Giants,GIANTS,2,4,3,7,1998,2008,10,No,2,0.87,9.81,8.94,148,766,618,604,1616,1012,12.0,1082.0,1070.0,2750000.0,0.0,-2750000.0
<a href=/player/stora101>stora101</a>,Alan Storke,Pittsburgh Pirates,PIRATS,3,9,6,15,1909,1915,6,No,0,20.39,14.17,-6.22,2165,858,-1307,7822,3752,-4070,942.0,0.0,-942.0,19200.0,0.0,-19200.0
<a href=/player/stora101>stora101</a>,Alan Storke,St. Louis Cardinals,CARDS,1,2,3,5,1910,1914,4,No,0,0.92,4.47,3.55,70,779,709,75,3039,2964,641.0,470.0,-171.0,0.0,0.0,0.0
<a href=/player/stord001>stord001</a>,Drew Storen,Washington Nationals,NATEX,1,2,2,4,2016,2016,0,No,0,-0.54,-0.95,-0.41,42,103,61,0,375,375,100.0,0.0,-100.0,0.0,0.0,0.0
<a href=/player/stord001>stord001</a>,Drew Storen,Toronto Blue Jays,BJAYS,1,2,1,3,2016,2016,0,No,0,0.26,1.44,1.18,21,26,5,0,0,0,55.0,71.0,16.0,0.0,0.0,0.0
<a href=/player/stotm001>stotm001</a>,Mel Stottlemyre,Houston Astros,ASTROS,1,1,1,2,1987,1987,0,No,0,0.04,-0.55,-0.59,13,18,5,0,25,25,94.0,0.0,-94.0,0.0,0.0,0.0
<a href=/player/stott001>stott001</a>,Todd Stottlemyre,Oakland Athletics,ATLTCS,3,3,7,10,1996,2000,4,No,0,8.36,-0.62,-8.98,237,137,-100,221,363,142,2452.0,153.0,-2299.0,0.0,0.0,0.0
<a href=/player/stott001>stott001</a>,Todd Stottlemyre,St. Louis Cardinals,CARDS,6,9,11,20,1998,2004,6,No,1,9.85,14.81,4.96,1166,1148,-18,3977,1495,-2482,740.0,2465.0,1725.0,14483333.0,0.0,-14483333.0
<a href=/player/stoua101>stoua101</a>,Allyn Stout,St. Louis Cardinals,CARDS,2,4,7,11,1933,1941,8,No,0,35.44,3.4,-32.04,1483,791,-692,3153,2855,-298,8479.0,390.0,-8089.0,10000.0,0.0,-10000.0
<a href=/player/stoua101>stoua101</a>,Allyn Stout,Cincinnati Reds,REDS,3,4,5,9,1934,1942,8,No,0,0.78,14.44,13.66,253,956,703,577,3608,3031,264.0,0.0,-264.0,23000.0,0.0,-23000.0
<a href=/player/stovd001>stovd001</a>,DaRond Stovall,St. Louis Cardinals,CARDS,2,4,4,8,1995,1998,3,No,0,0.65,-1.89,-2.54,140,207,67,86,512,426,308.0,331.0,23.0,4525000.0,0.0,-4525000.0
<a href=/player/stovg101>stovg101</a>,George Stovall,Cleveland Indians,INDINS,1,1,1,2,1912,1912,0,No,0,1.15,-0.67,-1.82,205,22,-183,743,14,-729,0.0,133.0,133.0,0.0,0.0,0.0
<a href=/player/stovj101>stovj101</a>,Jesse Stovall,Cleveland Indians,INDINS,1,2,1,3,1904,1904,0,No,0,22.67,2.88,-19.79,462,138,-324,681,580,-101,5040.0,0.0,-5040.0,0.0,0.0,0.0
<a href=/player/stpim001>stpim001</a>,Max St. Pierre,Kansas City Royals,ROYALS,1,1,1,2,2007,2008,1,No,0,0.0,0.0,0.0,0,0,0,0,0,0,0.0,0.0,0.0,0.0,0.0,0.0
<a href=/player/straa102>straa102</a>,Alan Strange,Hollywood,Hollywood,1,1,3,4,1933,1942,9,No,0,-1.79,0.0,1.79,294,0,-294,1022,0,-1022,0.0,0.0,0.0,0.0,0.0,0.0
<a href=/player/straa102>straa102</a>,Alan Strange,St.Louis Browns,ORLS,13,24,33,57,1935,1952,17,No,0,55.71,59.14,3.43,2756,6712,3956,8050,20700,12650,6789.0,12669.0,5880.0,132500.0,0.0,-132500.0
<a href=/player/strab101>strab101</a>,Bob Strampe,Detroit Tigers,TIGRS,1,3,1,4,1974,1975,1,No,0,-0.19,-1.37,-1.18,91,45,-46,191,173,-18,0.0,0.0,0.0,79000.0,0.0,-79000.0
<a href=/player/strac001>strac001</a>,Chris Stratton,San Francisco Giants,GIANTS,1,1,1,2,2019,2019,0,No,0,-0.68,0.17,0.85,8,12,4,2,0,-2,88.0,20.0,-68.0,0.0,0.0,0.0
<a href=/player/strad002>strad002</a>,Doug Strange,Detroit Tigers,TIGRS,1,1,1,2,1990,1992,2,No,0,0.0,0.0,0.0,0,0,0,0,0,0,0.0,0.0,0.0,0.0,0.0,0.0
<a href=/player/strad003>strad003</a>,Dan Straily,Oakland Athletics,ATLTCS,2,6,6,12,2014,2020,6,Yes,0,10.93,24.37,13.44,708,1106,398,2216,4232,2016,860.0,540.0,-320.0,5345000.0,0.0,-5345000.0
<a href=/player/strad003>strad003</a>,Dan Straily,Chicago Cubs,CUBS,1,2,1,3,2015,2016,1,No,0,4.82,6.42,1.6,226,281,55,835,1241,406,50.0,0.0,-50.0,0.0,0.0,0.0
<a href=/player/strad003>strad003</a>,Dan Straily,Houston Astros,ASTROS,1,1,1,2,2016,2016,0,No,0,0.0,-0.55,-0.55,0,15,15,0,30,30,0.0,3.0,3.0,0.0,0.0,0.0
<a href=/player/strad003>strad003</a>,Dan Straily,Cincinnati Reds,REDS,1,1,3,4,2017,2018,1,Yes,0,1.87,1.79,-0.08,112,137,25,107,38,-69,912.0,478.0,-434.0,0.0,0.0,0.0
<a href=/player/straj101>straj101</a>,Joe Strain,San Francisco Giants,GIANTS,5,7,8,15,1980,1986,6,No,0,-0.94,5.74,6.68,341,455,114,825,812,-13,372.0,2489.0,2117.0,552000.0,0.0,-552000.0
<a href=/player/stram001>stram001</a>,Matt Strahm,Kansas City Royals,ROYALS,2,7,5,12,2017,2021,4,No,0,3.49,-0.89,-4.38,348,169,-179,52,6,-46,1021.0,694.0,-327.0,538900.0,0.0,-538900.0
<a href=/player/stram002>stram002</a>,Myles Straw,Houston Astros,ASTROS,1,1,2,3,2021,2021,0,Yes,0,1.78,-0.24,-2.02,60,31,-29,268,0,-268,0.0,76.0,76.0,0.0,0.0,0.0
<a href=/player/stram101>stram101</a>,Mike Strahler,Los Angeles Dodgers,DOGRS,1,5,2,7,1972,1976,4,No,0,16.6,19.03,2.43,596,356,-240,1923,542,-1381,1810.0,2591.0,781.0,251500.0,0.0,-251500.0
<a href=/player/stram101>stram101</a>,Mike Strahler,California Angels,ANGELS,1,1,1,2,1973,1975,2,No,0,0.46,0.22,-0.24,22,60,38,0,146,146,241.0,0.0,-241.0,0.0,0.0,0.0
<a href=/player/stram101>stram101</a>,Mike Strahler,Detroit Tigers,TIGRS,1,1,1,2,1973,1973,0,No,0,0.0,0.0,0.0,0,0,0,0,0,0,0.0,0.0,0.0,0.0,0.0,0.0
<a href=/player/strap101>strap101</a>,Paul Strand,SaltLakeCity,SaltLakeCity,2,2,5,7,1923,1924,1,No,0,-0.64,0.0,0.64,106,0,-106,374,0,-374,0.0,0.0,0.0,0.0,0.0,0.0
<a href=/player/strap101>strap101</a>,Paul Strand,Philadelphia Athletics,ATLTCS,1,3,1,4,1924,1927,3,No,0,0.0,4.07,4.07,0,425,425,0,1818,1818,0.0,0.0,0.0,12000.0,0.0,-12000.0
<a href=/player/stras101>stras101</a>,Scott Stratton,Louisville Colonels,LS3,1,1,1,2,1894,1900,6,No,0,0.41,0.13,-0.28,55,8,-47,136,37,-99,475.0,0.0,-475.0,0.0,0.0,0.0
<a href=/player/stras102>stras102</a>,Sammy Strang,Chicago Cubs,CUBS,1,3,1,4,1901,1902,1,No,0,10.49,-0.18,-10.67,648,75,-573,2353,299,-2054,0.0,0.0,0.0,0.0,0.0,0.0
<a href=/player/streg101>streg101</a>,Gabby Street,Washington Senators,TWINS,3,6,4,10,1912,1922,10,No,0,-0.55,4.17,4.72,29,440,411,95,1167,1072,0.0,0.0,0.0,4000.0,0.0,-4000.0
<a href=/player/streh001>streh001</a>,Huston Street,Oakland Athletics,ATLTCS,6,8,8,16,2008,2014,6,Yes,0,50.06,1.09,-48.97,2622,167,-2455,9256,628,-8628,794.0,101.0,-693.0,16800000.0,0.0,-16800000.0
<a href=/player/streh001>streh001</a>,Huston Street,Colorado Rockies,ROCKS,1,2,1,3,2011,2011,0,No,0,3.82,0.0,-3.82,253,0,-253,0,0,0,386.0,0.0,-386.0,7300000.0,0.0,-7300000.0
<a href=/player/streh001>streh001</a>,Huston Street,San Diego Padres,PADRS,3,5,8,13,2014,2019,5,Yes,0,2.1,2.53,0.43,243,302,59,4,1043,1039,1186.0,40.0,-1146.0,9925000.0,0.0,-9925000.0
<a href=/player/stric101>stric101</a>,Cub Stricker,Cleveland Spiders,CL4,1,2,1,3,1891,1899,8,No,0,0.0,34.84,34.84,0,1004,1004,0,4749,4749,0.0,0.0,0.0,0.0,0.0,0.0
<a href=/player/stric101>stric101</a>,Cub Stricker,St. Louis Cardinals,CARDS,1,1,1,2,1892,1892,0,No,0,0.0,1.68,1.68,0,24,24,0,40,40,0.0,276.0,276.0,0.0,0.0,0.0
<a href=/player/stric101>stric101</a>,Cub Stricker,Pittsburgh Pirates,PIRATS,1,1,1,2,1892,1897,5,No,0,0.38,5.48,5.1,75,115,40,302,185,-117,0.0,1232.0,1232.0,0.0,0.0,0.0
<a href=/player/strig102>strig102</a>,George Strickland,Pittsburgh Pirates,PIRATS,1,2,3,5,1952,1952,0,No,0,6.5,-0.35,-6.85,756,19,-737,2451,60,-2391,46.0,0.0,-46.0,0.0,0.0,0.0
<a href=/player/strih001>strih001</a>,Hunter Strickland,Boston Red Sox,RSOX,3,4,4,8,2009,2010,1,No,0,0.8,1.92,1.12,204,165,-39,735,496,-239,0.0,3.0,3.0,0.0,0.0,0.0
<a href=/player/strih001>strih001</a>,Hunter Strickland,Seattle Mariners,MARNRS,1,2,3,5,2019,2020,1,Yes,0,-0.26,0.45,0.71,55,27,-28,1,0,-1,72.0,60.0,-12.0,2210000.0,0.0,-2210000.0
<a href=/player/strij101>strij101</a>,Joe Stripp,Cincinnati Reds,REDS,5,9,12,21,1932,1942,10,No,0,46.0,30.81,-15.19,3034,1950,-1084,10521,6810,-3711,2379.0,542.0,-1837.0,5500.0,0.0,-5500.0
<a href=/player/strij101>strij101</a>,Joe Stripp,Brooklyn Dodgers,DOGRS,1,4,1,5,1937,1944,7,No,0,1.9,1.11,-0.79,125,343,218,330,1190,860,390.0,0.0,-390.0,10000.0,0.0,-10000.0
<a href=/player/strij101>strij101</a>,Joe Stripp,Boston Braves,BRAVES,1,1,1,2,1938,1940,2,No,0,0.0,0.42,0.42,0,46,46,0,8,8,0.0,114.0,114.0,0.0,0.0,0.0
<a href=/player/strij102>strij102</a>,Jake Striker,Cleveland Indians,INDINS,6,11,11,22,1959,1968,9,No,0,95.02,18.27,-76.75,3674,1436,-2238,12659,5344,-7315,4502.0,50.0,-4452.0,0.0,0.0,0.0
<a href=/player/strij104>strij104</a>,Jim Strickland,Minnesota Twins,TWINS,2,3,3,6,1973,1977,4,No,0,0.26,-0.78,-1.04,4,55,51,0,0,0,14.0,604.0,590.0,11000.0,0.0,-11000.0
<a href=/player/strin101>strin101</a>,Nick Strincevich,Boston Braves,BRAVES,2,2,2,4,1941,1946,5,No,0,8.45,1.67,-6.78,379,275,-104,431,177,-254,2222.0,1218.0,-1004.0,0.0,0.0,0.0
<a href=/player/strir001>strir001</a>,Ross Stripling,Los Angeles Dodgers,DOGRS,1,1,2,3,2020,2021,1,Yes,0,0.83,0.0,-0.83,32,0,-32,6,0,-6,351.0,0.0,-351.0,2100000.0,0.0,-2100000.0
<a href=/player/stris001>stris001</a>,Scott Strickland,Montreal Expos,NATEX,5,10,12,22,2002,2011,9,No,0,5.61,14.61,9.0,687,585,-102,161,612,451,1873.0,3946.0,2073.0,8655000.0,0.0,-8655000.0
<a href=/player/strob101>strob101</a>,Brent Strom,New York Mets,METS,1,2,1,3,1972,1972,0,No,0,0.32,0.0,-0.32,27,0,-27,0,0,0,369.0,0.0,-369.0,6000.0,0.0,-6000.0
<a href=/player/strob101>strob101</a>,Brent Strom,Cleveland Indians,INDINS,1,2,1,3,1974,1974,0,No,0,1.74,-1.01,-2.75,126,11,-115,121,0,-121,1043.0,131.0,-912.0,0.0,0.0,0.0
<a href=/player/stroe101>stroe101</a>,Ed Stroud,Chicago White Sox,WSOX,2,3,2,5,1967,1968,1,No,0,4.19,-0.43,-4.62,463,83,-380,1301,274,-1027,0.0,0.0,0.0,32500.0,0.0,-32500.0
<a href=/player/stroe101>stroe101</a>,Ed Stroud,Washington Senators,RNGRS,5,8,5,13,1971,1977,6,No,0,-0.82,1.98,2.8,387,300,-87,987,715,-272,759.0,568.0,-191.0,0.0,0.0,0.0
<a href=/player/stroj101>stroj101</a>,Jim Stroner,Wichita,Wichita,1,2,2,4,1928,1928,0,No,0,-0.01,0.0,0.01,6,0,-6,9,0,-9,0.0,0.0,0.0,0.0,0.0,0.0
<a href=/player/strom001>strom001</a>,Marcus Stroman,Toronto Blue Jays,BJAYS,2,4,3,7,2019,2021,2,Yes,0,4.89,1.43,-3.46,85,16,-69,81,2,-79,716.0,253.0,-463.0,7400000.0,0.0,-7400000.0
<a href=/player/strop001>strop001</a>,Pedro Strop,Texas Rangers,RNGRS,1,1,1,2,2011,2011,0,No,0,2.38,0.01,-2.37,116,7,-109,0,0,0,303.0,21.0,-282.0,416000.0,0.0,-416000.0
<a href=/player/strop001>strop001</a>,Pedro Strop,Baltimore Orioles,ORLS,2,4,4,8,2013,2019,6,No,0,26.47,2.52,-23.95,1116,493,-623,389,1879,1490,3793.0,272.0,-3521.0,514000.0,0.0,-514000.0
<a href=/player/stros101>stros101</a>,Steve Stroughter,Seattle Mariners,MARNRS,1,1,1,2,1980,1981,1,No,0,0.0,0.0,0.0,0,0,0,0,0,0,0.0,0.0,0.0,0.0,0.0,0.0
<a href=/player/strua102>strua102</a>,Amos Strunk,Philadelphia Athletics,ATLTCS,2,6,5,11,1917,1924,7,No,0,21.83,0.26,-21.57,730,281,-449,2197,867,-1330,2329.0,731.0,-1598.0,12000.0,0.0,-12000.0
<a href=/player/strua102>strua102</a>,Amos Strunk,Boston Red Sox,RSOX,14,27,32,59,1919,1937,18,No,0,90.7,63.54,-27.16,3925,3492,-433,10546,11886,1340,11819.0,5915.0,-5904.0,73300.0,0.0,-73300.0
<a href=/player/stryd101>stryd101</a>,Dutch Stryker,Boston Braves,BRAVES,15,35,27,62,1924,1952,28,No,0,61.82,121.75,59.93,3287,6434,3147,11058,21686,10628,3053.0,10767.0,7714.0,56700.0,0.0,-56700.0
<a href=/player/stuad101>stuad101</a>,Dick Stuart,Pittsburgh Pirates,PIRATS,2,3,3,6,1962,1967,5,No,0,1.35,11.96,10.61,573,824,251,1418,1789,371,1199.0,1482.0,283.0,30000.0,0.0,-30000.0
<a href=/player/stuad101>stuad101</a>,Dick Stuart,Boston Red Sox,RSOX,3,3,4,7,1964,1974,10,No,0,0.01,5.43,5.42,189,323,134,646,116,-530,79.0,1344.0,1265.0,61000.0,0.0,-61000.0
<a href=/player/stuad101>stuad101</a>,Dick Stuart,Philadelphia Phillies,PHILS,1,1,3,4,1966,1968,2,No,0,-0.09,-0.11,-0.02,31,10,-21,96,19,-77,0.0,0.0,0.0,0.0,0.0,0.0
<a href=/player/stual101>stual101</a>,Luke Stuart,Richmond,Richmond,1,1,2,3,1921,1921,0,No,0,0.08,0.0,-0.08,3,0,-3,3,0,-3,0.0,0.0,0.0,0.0,0.0,0.0
<a href=/player/stuam101>stuam101</a>,Marlin Stuart,Detroit Tigers,TIGRS,6,16,16,32,1952,1961,9,No,0,19.6,10.08,-9.52,1436,1371,-65,2274,3811,1537,4378.0,2214.0,-2164.0,23200.0,0.0,-23200.0
<a href=/player/stubd001>stubd001</a>,Drew Stubbs,Cincinnati Reds,REDS,1,2,3,5,2012,2013,1,No,0,0.85,4.63,3.78,146,154,8,481,712,231,0.0,0.0,0.0,527500.0,0.0,-527500.0
<a href=/player/stubd001>stubd001</a>,Drew Stubbs,Cleveland Indians,INDINS,2,2,2,4,2013,2014,1,No,0,2.39,0.36,-2.03,192,33,-159,538,0,-538,11.0,74.0,63.0,4075000.0,0.0,-4075000.0
<a href=/player/stubf001>stubf001</a>,Franklin Stubbs,Los Angeles Dodgers,DOGRS,1,1,1,2,1990,1990,0,No,0,2.79,-1.08,-3.87,146,10,-136,501,7,-494,0.0,62.0,62.0,0.0,0.0,0.0
<a href=/player/stubg001>stubg001</a>,Garrett Stubbs,Houston Astros,ASTROS,1,1,1,2,2021,2021,0,Yes,0,0.0,0.0,0.0,0,0,0,0,0,0,0.0,0.0,0.0,0.0,0.0,0.0
<a href=/player/stubm101>stubm101</a>,Moose Stubing,San Francisco Giants,GIANTS,1,1,1,2,1965,1965,0,No,0,0.0,0.0,0.0,0,0,0,0,0,0,0.0,0.0,0.0,0.0,0.0,0.0
<a href=/player/stueg101>stueg101</a>,George Stueland,Chicago Cubs,CUBS,1,2,2,4,1923,1931,8,No,0,0.0,12.05,12.05,0,628,628,0,625,625,0.0,5104.0,5104.0,3400.0,0.0,-3400.0
<a href=/player/stueg101>stueg101</a>,George Stueland,Chicago Cubs,CUBS,2,4,2,6,1925,1929,4,No,0,0.0,4.41,4.41,0,280,280,0,989,989,0.0,0.0,0.0,4000.0,0.0,-4000.0
<a href=/player/stule001>stule001</a>,Everett Stull,Montreal Expos,NATEX,2,2,2,4,1997,2002,5,No,0,0.0,-1.17,-1.17,0,186,186,0,49,49,0.0,614.0,614.0,220000.0,0.0,-220000.0
<a href=/player/stule002>stule002</a>,Eric Stults,Atlanta Braves,BRAVES,6,15,9,24,2015,2021,6,Yes,0,3.56,2.51,-1.05,557,291,-266,805,489,-316,986.0,676.0,-310.0,21307500.0,0.0,-21307500.0
<a href=/player/stumb101>stumb101</a>,Bill Stumpf,New York Yankees,YANKS,5,13,8,21,1913,1946,33,No,0,28.8,113.37,84.57,1052,3692,2640,1402,9991,8589,7730.0,15194.0,7464.0,42500.0,0.0,-42500.0
<a href=/player/stupj001>stupj001</a>,John Stuper,Pittsburgh Pirates,PIRATS,1,1,1,2,1979,1979,0,No,0,2.1,0.0,-2.1,156,0,-156,137,0,-137,1188.0,0.0,-1188.0,0.0,0.0,0.0
<a href=/player/stupj001>stupj001</a>,John Stuper,St. Louis Cardinals,CARDS,2,3,4,7,1984,1984,0,No,0,-0.19,-0.22,-0.03,234,13,-221,556,14,-542,297.0,0.0,-297.0,0.0,0.0,0.0
<a href=/player/stupj001>stupj001</a>,John Stuper,Cincinnati Reds,REDS,3,6,4,10,1985,1988,3,No,0,12.45,4.93,-7.52,892,228,-664,620,336,-284,4251.0,1549.0,-2702.0,1777500.0,0.0,-1777500.0
<a href=/player/sturb101>sturb101</a>,Bobby Sturgeon,Chicago Cubs,CUBS,1,1,2,3,1948,1948,0,No,0,-0.28,-0.05,0.23,34,48,14,82,105,23,0.0,0.0,0.0,0.0,0.0,0.0
<a href=/player/sturt001>sturt001</a>,Tanyon Sturtze,Chicago White Sox,WSOX,1,1,1,2,2000,2003,3,No,0,5.72,5.66,-0.06,98,291,193,13,881,868,1416.0,0.0,-1416.0,206000.0,0.0,-206000.0
<a href=/player/sturt001>sturt001</a>,Tanyon Sturtze,Los Angeles Dodgers,DOGRS,1,1,1,2,2004,2005,1,No,0,0.61,0.01,-0.6,117,19,-98,3,25,22,498.0,0.0,-498.0,0.0,0.0,0.0
<a href=/player/sturt101>sturt101</a>,Tom Sturdivant,New York Yankees,YANKS,3,7,5,12,1959,1966,7,No,0,10.26,14.71,4.45,1028,1524,496,3254,3264,10,1701.0,4103.0,2402.0,84000.0,0.0,-84000.0
<a href=/player/sturt101>sturt101</a>,Tom Sturdivant,Kansas City Athletics,ATLTCS,1,1,1,2,1959,1960,1,No,0,0.22,0.26,0.04,80,73,-7,24,243,219,304.0,0.0,-304.0,0.0,0.0,0.0
<a href=/player/sturt101>sturt101</a>,Tom Sturdivant,Washington Senators,RNGRS,1,1,1,2,1961,1961,0,No,0,3.47,-0.88,-4.35,130,23,-107,73,9,-64,658.0,89.0,-569.0,0.0,0.0,0.0
<a href=/player/styll101>styll101</a>,Lena Styles,Philadelphia Athletics,ATLTCS,1,1,1,2,1921,1922,1,No,0,0.0,-1.06,-1.06,0,44,44,0,20,20,0.0,205.0,205.0,0.0,0.0,0.0
<a href=/player/stync001>stync001</a>,Chris Stynes,Toronto Blue Jays,BJAYS,2,4,4,8,1995,1997,2,No,0,19.63,3.81,-15.82,207,44,-163,147,0,-147,2766.0,687.0,-2079.0,8000000.0,0.0,-8000000.0
<a href=/player/stync001>stync001</a>,Chris Stynes,Kansas City Royals,ROYALS,1,2,2,4,1997,1999,2,No,0,7.45,1.22,-6.23,503,193,-310,1598,1,-1597,0.0,629.0,629.0,0.0,0.0,0.0
<a href=/player/stync001>stync001</a>,Chris Stynes,Cincinnati Reds,REDS,4,5,6,11,2000,2013,13,No,0,-0.14,18.69,18.83,362,872,510,1099,1605,506,0.0,5071.0,5071.0,600000.0,0.0,-600000.0
<a href=/player/suare001>suare001</a>,Eugenio Suarez,Detroit Tigers,TIGRS,1,2,1,3,2014,2015,1,No,0,13.23,-0.51,-13.74,916,33,-883,3730,5,-3725,0.0,561.0,561.0,0.0,0.0,0.0
<a href=/player/suark101>suark101</a>,Ken Suarez,Cleveland Indians,INDINS,6,11,10,21,1971,1978,7,No,0,26.06,8.28,-17.78,1542,586,-956,3690,1786,-1904,2427.0,1183.0,-1244.0,83000.0,0.0,-83000.0
<a href=/player/suark101>suark101</a>,Ken Suarez,Texas Rangers,RNGRS,1,1,1,2,1974,1976,2,No,0,0.0,1.26,1.26,0,89,89,0,214,214,0.0,0.0,0.0,0.0,0.0,0.0
<a href=/player/suark101>suark101</a>,Ken Suarez,Cleveland Indians,INDINS,1,3,1,4,1974,1974,0,No,0,0.32,-0.11,-0.43,178,15,-163,399,61,-338,0.0,0.0,0.0,19750.0,0.0,-19750.0
<a href=/player/suchj101>suchj101</a>,Jim Suchecki,Boston Red Sox,RSOX,3,7,4,11,1951,1954,3,No,0,1.03,-2.94,-3.97,539,149,-390,1347,410,-937,675.0,0.0,-675.0,8500.0,0.0,-8500.0
<a href=/player/sucrj001>sucrj001</a>,Jesus Sucre,Seattle Mariners,MARNRS,1,1,1,2,2017,2017,0,No,0,-0.19,0.0,0.19,138,0,-138,390,0,-390,6.0,0.0,-6.0,0.0,0.0,0.0
<a href=/player/sudab101>sudab101</a>,Bill Sudakis,New York Mets,METS,1,1,1,2,1973,1973,0,No,0,1.38,0.0,-1.38,82,0,-82,263,0,-263,0.0,0.0,0.0,0.0,0.0,0.0
<a href=/player/sudab101>sudab101</a>,Bill Sudakis,New York Yankees,YANKS,1,1,1,2,1974,1975,1,No,0,-0.55,0.0,0.55,30,0,-30,73,0,-73,0.0,0.0,0.0,30000.0,0.0,-30000.0
<a href=/player/sudhw101>sudhw101</a>,Willie Sudhoff,St.Louis Browns,ORLS,2,3,2,5,1905,1907,2,No,0,-1.49,0.53,2.02,22,110,88,7,131,124,66.0,1108.0,1042.0,0.0,0.0,0.0
<a href=/player/suerw001>suerw001</a>,William Suero,Toronto Blue Jays,BJAYS,1,2,1,3,1991,1992,1,No,0,-0.04,3.8,3.84,33,189,156,34,768,734,0.0,0.0,0.0,0.0,0.0,0.0
<a href=/player/sugdj101>sugdj101</a>,Joe Sugden,Pittsburgh Pirates,PIRATS,1,1,1,2,1897,1898,1,No,0,0.64,-0.06,-0.7,89,5,-84,320,18,-302,0.0,0.0,0.0,0.0,0.0,0.0
<a href=/player/sugdj101>sugdj101</a>,Joe Sugden,Chicago White Sox,WSOX,1,1,1,2,1902,1902,0,No,0,4.95,3.2,-1.75,343,46,-297,1204,62,-1142,3.0,526.0,523.0,0.0,0.0,0.0
<a href=/player/suggg101>suggg101</a>,George Suggs,Detroit Tigers,TIGRS,1,3,1,4,1909,1909,0,No,0,0.0,-0.16,-0.16,0,8,8,0,8,8,0.0,60.0,60.0,0.0,0.0,0.0
<a href=/player/suhrg101>suhrg101</a>,Gus Suhr,Pittsburgh Pirates,PIRATS,1,1,1,2,1939,1946,7,No,0,1.65,14.95,13.3,70,406,336,265,430,165,0.0,3506.0,3506.0,8000.0,0.0,-8000.0
<a href=/player/suhrg101>suhrg101</a>,Gus Suhr,Brooklyn Dodgers,DOGRS,1,3,1,4,1941,1946,5,No,0,0.0,0.04,0.04,0,2,2,0,5,5,0.0,0.0,0.0,0.0,0.0,0.0
<a href=/player/sukec101>sukec101</a>,Clyde Sukeforth,Cincinnati Reds,REDS,5,9,12,21,1932,1942,10,No,0,46.0,30.81,-15.19,3034,1950,-1084,10521,6810,-3711,2379.0,542.0,-1837.0,5500.0,0.0,-5500.0
<a href=/player/sullb102>sullb102</a>,Billy Sullivan,GrandRapids,GrandRapids,1,1,1,2,1899,1899,0,No,0,0.37,0.0,-0.37,94,0,-94,329,0,-329,0.0,0.0,0.0,0.0,0.0,0.0
<a href=/player/sullb103>sullb103</a>,Billy Sullivan,Chicago White Sox,WSOX,1,3,1,4,1934,1934,0,No,0,0.0,0.0,0.0,0,0,0,0,0,0,0.0,0.0,0.0,2700.0,0.0,-2700.0
<a href=/player/sullb103>sullb103</a>,Billy Sullivan,Cleveland Indians,INDINS,1,3,1,4,1938,1941,3,No,0,1.14,1.94,0.8,388,390,2,935,1415,480,285.0,0.0,-285.0,0.0,0.0,0.0
<a href=/player/sullb103>sullb103</a>,Billy Sullivan,St.Louis Browns,ORLS,1,1,1,2,1940,1940,0,No,0,2.31,-0.71,-3.02,163,63,-100,525,18,-507,0.0,224.0,224.0,0.0,0.0,0.0
<a href=/player/sullf101>sullf101</a>,Frank Sullivan,Boston Red Sox,RSOX,1,1,1,2,1960,1964,4,No,0,-0.05,3.74,3.79,136,152,16,41,188,147,547.0,1447.0,900.0,0.0,0.0,0.0
<a href=/player/sullh101>sullh101</a>,Haywood Sullivan,Washington Senators,RNGRS,1,1,2,3,1960,1960,0,No,0,-0.08,0.0,0.08,252,0,-252,823,0,-823,0.0,0.0,0.0,0.0,0.0,0.0
<a href=/player/sullj101>sullj101</a>,Joe Sullivan,Philadelphia Phillies,PHILS,1,3,1,4,1896,1900,4,No,0,-0.5,6.22,6.72,240,440,200,1079,2080,1001,0.0,0.0,0.0,0.0,0.0,0.0
<a href=/player/sullj103>sullj103</a>,John Sullivan,Philadelphia Phillies,PHILS,1,2,1,3,1969,1969,0,No,0,0.0,-0.07,-0.07,0,13,13,0,14,14,0.0,0.0,0.0,0.0,0.0,0.0
<a href=/player/sullj103>sullj103</a>,John Sullivan,New York Mets,METS,1,2,1,3,1968,1969,1,No,0,0.12,0.0,-0.12,12,0,-12,20,0,-20,0.0,0.0,0.0,0.0,0.0,0.0
<a href=/player/sullj104>sullj104</a>,John Sullivan,Washington Senators,TWINS,19,34,35,69,1948,1963,15,No,0,46.33,1.08,-45.25,3341,4737,1396,11069,13056,1987,1598.0,4683.0,3085.0,53500.0,0.0,-53500.0
<a href=/player/sullj105>sullj105</a>,John Sullivan,Chicago Cubs,CUBS,2,8,5,13,1921,1926,5,No,0,29.39,11.6,-17.79,1120,351,-769,4097,694,-3403,1929.0,2961.0,1032.0,13500.0,0.0,-13500.0
<a href=/player/sullj108>sullj108</a>,Jim Sullivan,Baltimore,Baltimore,1,1,1,2,1921,1931,10,No,0,-1.06,0.0,1.06,44,0,-44,20,0,-20,205.0,0.0,-205.0,0.0,0.0,0.0
<a href=/player/sullm001>sullm001</a>,Marc Sullivan,Boston Red Sox,RSOX,1,1,1,2,1987,1987,0,No,0,0.0,0.0,0.0,0,0,0,0,0,0,0.0,0.0,0.0,150000.0,0.0,-150000.0
<a href=/player/sullm101>sullm101</a>,Mike Sullivan,Cincinnati Reds,REDS,3,6,3,9,1893,1898,5,No,0,6.54,9.57,3.03,667,550,-117,2741,2351,-390,620.0,786.0,166.0,0.0,0.0,0.0
<a href=/player/sulls001>sulls001</a>,Scott Sullivan,Cincinnati Reds,REDS,1,1,2,3,2003,2004,1,No,0,0.3,-1.28,-1.58,15,82,67,0,219,219,43.0,0.0,-43.0,2800000.0,0.0,-2800000.0
<a href=/player/sulsc001>sulsc001</a>,Cole Sulser,Cleveland Indians,INDINS,2,5,4,9,2018,2021,3,Yes,0,4.35,4.54,0.19,327,378,51,1228,1477,249,22.0,0.0,-22.0,18667000.0,0.0,-18667000.0
<a href=/player/summc001>summc001</a>,Champ Summers,Oakland Athletics,ATLTCS,2,3,2,5,1975,1978,3,No,0,-2.31,4.93,7.24,199,165,-34,247,0,-247,92.0,1056.0,964.0,0.0,0.0,0.0
<a href=/player/summc001>summc001</a>,Champ Summers,Chicago Cubs,CUBS,1,1,1,2,1977,1977,0,No,0,-0.12,0.0,0.12,99,0,-99,200,0,-200,0.0,0.0,0.0,0.0,0.0,0.0
<a href=/player/summc001>summc001</a>,Champ Summers,Cincinnati Reds,REDS,1,1,1,2,1979,1979,0,No,0,4.41,0.0,-4.41,274,0,-274,887,0,-887,0.0,0.0,0.0,0.0,0.0,0.0
<a href=/player/summc001>summc001</a>,Champ Summers,Detroit Tigers,TIGRS,1,1,2,3,1982,1983,1,No,0,-0.11,3.01,3.12,99,246,147,177,904,727,0.0,0.0,0.0,0.0,0.0,0.0
<a href=/player/summc001>summc001</a>,Champ Summers,San Francisco Giants,GIANTS,1,1,2,3,1983,1984,1,No,0,-0.1,-0.3,-0.2,47,17,-30,59,23,-36,0.0,0.0,0.0,0.0,0.0,0.0
<a href=/player/summh101>summh101</a>,Homer Summa,Philadelphia Athletics,ATLTCS,1,2,1,3,1930,1930,0,No,0,0.0,0.0,0.0,0,0,0,0,0,0,0.0,0.0,0.0,0.0,0.0,0.0
<a href=/player/sundb101>sundb101</a>,Billy Sunday,Pittsburgh Pirates,PIRATS,1,1,3,4,1890,1892,2,No,0,0.47,-0.87,-1.34,31,43,12,139,162,23,0.0,150.0,150.0,0.0,0.0,0.0
<a href=/player/sundj001>sundj001</a>,Jim Sundberg,Texas Rangers,RNGRS,1,1,2,3,1983,1985,2,No,0,3.15,-2.36,-5.51,110,80,-30,395,251,-144,0.0,0.0,0.0,0.0,0.0,0.0
<a href=/player/sundj001>sundj001</a>,Jim Sundberg,Milwaukee Brewers,BREWRS,3,4,6,10,1985,1991,6,No,0,23.75,18.35,-5.4,1450,817,-633,1291,1958,667,4939.0,4297.0,-642.0,700000.0,0.0,-700000.0
<a href=/player/sundj001>sundj001</a>,Jim Sundberg,Kansas City Royals,ROYALS,1,1,2,3,1987,1988,1,No,0,0.52,-0.74,-1.26,85,103,18,227,176,-51,0.0,58.0,58.0,0.0,0.0,0.0
<a href=/player/sunds101>sunds101</a>,Steve Sundra,Cleveland Indians,INDINS,1,2,1,3,1935,1940,5,No,0,14.33,18.91,4.58,396,307,-89,481,384,-97,3424.0,2789.0,-635.0,0.0,0.0,0.0
<a href=/player/sunds101>sunds101</a>,Steve Sundra,Washington Senators,TWINS,1,2,2,4,1942,1942,0,No,0,6.64,0.79,-5.85,330,98,-232,878,296,-582,1025.0,122.0,-903.0,7250.0,0.0,-7250.0
<a href=/player/sunkt101>sunkt101</a>,Tom Sunkel,St. Louis Cardinals,CARDS,1,1,2,3,1941,1943,2,No,0,-0.27,0.0,0.27,44,0,-44,25,0,-25,245.0,0.0,-245.0,0.0,0.0,0.0
<a href=/player/suppj001>suppj001</a>,Jeff Suppan,Pittsburgh Pirates,PIRATS,5,8,9,17,2003,2013,10,No,0,4.43,21.03,16.6,571,1401,830,955,4379,3424,773.0,467.0,-306.0,13800000.0,0.0,-13800000.0
<a href=/player/surhb001>surhb001</a>,B.J. Surhoff,Baltimore Orioles,ORLS,1,2,3,5,2000,2002,2,No,0,1.16,-0.42,-1.58,214,107,-107,759,224,-535,6.0,2.0,-4.0,4146789.0,0.0,-4146789.0
<a href=/player/surhr001>surhr001</a>,Rich Surhoff,Philadelphia Phillies,PHILS,1,1,1,2,1985,1986,1,No,0,-0.28,-0.22,0.06,7,24,17,0,0,0,25.0,50.0,25.0,0.0,0.0,0.0
<a href=/player/surhr001>surhr001</a>,Rich Surhoff,Texas Rangers,RNGRS,1,2,1,3,1986,1987,1,No,0,0.0,-0.29,-0.29,0,16,16,0,0,0,0.0,71.0,71.0,0.0,0.0,0.0
<a href=/player/surke001>surke001</a>,Eric Surkamp,Chicago White Sox,WSOX,1,1,1,2,2015,2015,0,No,0,-0.2,0.0,0.2,2,0,-2,1,0,-1,10.0,0.0,-10.0,0.0,0.0,0.0
<a href=/player/surkm101>surkm101</a>,Max Surkont,Chicago White Sox,WSOX,1,1,1,2,1950,1951,1,No,0,8.31,0.0,-8.31,210,0,-210,251,0,-251,2034.0,0.0,-2034.0,0.0,0.0,0.0
<a href=/player/surkm101>surkm101</a>,Max Surkont,Milwaukee Braves,BRAVES,2,10,2,12,1953,1960,7,No,0,8.19,12.74,4.55,794,729,-65,1824,3040,1216,2135.0,0.0,-2135.0,0.0,0.0,0.0
<a href=/player/surkm101>surkm101</a>,Max Surkont,Pittsburgh Pirates,PIRATS,2,2,2,4,1956,1958,2,No,0,-0.44,-0.66,-0.22,30,146,116,3,40,37,58.0,478.0,420.0,0.0,0.0,0.0
<a href=/player/susaa001>susaa001</a>,Andrew Susac,San Francisco Giants,GIANTS,1,2,1,3,2016,2019,3,No,0,-0.35,3.53,3.88,20,278,258,31,2,-29,6.0,410.0,404.0,0.0,0.0,0.0
<a href=/player/susaa001>susaa001</a>,Andrew Susac,Milwaukee Brewers,BREWRS,1,1,1,2,2018,2018,0,No,0,-0.33,0.0,0.33,9,0,-9,26,0,-26,0.0,0.0,0.0,0.0,0.0,0.0
<a href=/player/sutcr001>sutcr001</a>,Rick Sutcliffe,Los Angeles Dodgers,DOGRS,4,5,6,11,1981,1986,5,No,0,8.2,1.95,-6.25,273,439,166,478,515,37,1699.0,432.0,-1267.0,1085000.0,0.0,-1085000.0
<a href=/player/sutcr001>sutcr001</a>,Rick Sutcliffe,Cleveland Indians,INDINS,14,24,30,54,1984,2001,17,No,1,109.74,66.95,-42.79,6226,4765,-1461,18678,17797,-881,7708.0,2241.0,-5467.0,19613332.0,0.0,-19613332.0
<a href=/player/suthg101>suthg101</a>,Gary Sutherland,Montreal Expos,NATEX,1,1,2,3,1972,1972,0,No,0,-0.3,0.0,0.3,21,0,-21,66,0,-66,0.0,0.0,0.0,0.0,0.0,0.0
<a href=/player/suthg101>suthg101</a>,Gary Sutherland,Houston Astros,ASTROS,1,2,2,4,1973,1975,2,No,0,0.24,-0.75,-0.99,348,138,-210,1336,4,-1332,157.0,233.0,76.0,66000.0,0.0,-66000.0
<a href=/player/suthg101>suthg101</a>,Gary Sutherland,Detroit Tigers,TIGRS,1,1,1,2,1976,1976,0,No,0,-0.89,-1.04,-0.15,59,77,18,130,245,115,0.0,0.0,0.0,0.0,0.0,0.0
<a href=/player/suths101>suths101</a>,Suds Sutherland,Detroit Tigers,TIGRS,1,9,2,11,1921,1941,20,No,0,0.0,3.03,3.03,0,202,202,0,144,144,0.0,1168.0,1168.0,3000.0,0.0,-3000.0
<a href=/player/suttb001>suttb001</a>,Bruce Sutter,Chicago Cubs,CUBS,3,3,6,9,1980,1989,9,No,0,5.77,17.19,11.42,519,1190,671,95,4076,3981,1190.0,412.0,-778.0,2083333.0,0.0,-2083333.0
<a href=/player/suttd001>suttd001</a>,Don Sutton,Houston Astros,ASTROS,19,35,46,81,1982,2011,29,No,4,65.41,46.53,-18.88,5066,8057,2991,11217,20302,9085,8714.0,8239.0,-475.0,32819000.0,0.0,-32819000.0
<a href=/player/suttd001>suttd001</a>,Don Sutton,Milwaukee Brewers,BREWRS,1,1,3,4,1984,1986,2,No,0,2.63,1.47,-1.16,29,29,0,0,0,0,583.0,511.0,-72.0,625000.0,0.0,-625000.0
<a href=/player/suttd001>suttd001</a>,Don Sutton,Oakland Athletics,ATLTCS,1,1,2,3,1985,1985,0,No,0,4.61,0.0,-4.61,74,0,-74,0,0,0,1291.0,0.0,-1291.0,0.0,0.0,0.0
<a href=/player/suttd002>suttd002</a>,Drew Sutton,Houston Astros,ASTROS,2,2,3,5,2009,2012,3,No,0,-0.72,0.76,1.48,100,307,207,309,1107,798,0.0,160.0,160.0,2300000.0,0.0,-2300000.0
<a href=/player/suttj101>suttj101</a>,John Sutton,Texas Rangers,RNGRS,1,1,1,2,1976,1976,0,No,0,0.2,0.0,-0.2,28,0,-28,1,0,-1,73.0,0.0,-73.0,0.0,0.0,0.0
<a href=/player/suttl001>suttl001</a>,Larry Sutton,St. Louis Cardinals,CARDS,1,1,1,2,2001,2001,0,No,0,0.0,0.0,0.0,0,0,0,0,0,0,0.0,0.0,0.0,305000.0,0.0,-305000.0
<a href=/player/suzui001>suzui001</a>,Ichiro Suzuki,Seattle Mariners,MARNRS,5,8,8,16,2012,2017,5,Yes,0,12.61,3.47,-9.14,1452,363,-1089,5137,584,-4553,347.0,816.0,469.0,27679600.0,0.0,-27679600.0
<a href=/player/suzuk001>suzuk001</a>,Kurt Suzuki,Oakland Athletics,ATLTCS,2,4,2,6,2012,2014,2,No,0,0.75,-1.33,-2.08,243,41,-202,896,1,-895,0.0,121.0,121.0,0.0,0.0,0.0
<a href=/player/suzuk001>suzuk001</a>,Kurt Suzuki,Washington Nationals,NATEX,1,1,1,2,2013,2021,8,No,0,0.33,-0.13,-0.46,15,11,-4,35,0,-35,0.0,34.0,34.0,0.0,0.0,0.0
<a href=/player/suzum001>suzum001</a>,Mac Suzuki,Seattle Mariners,MARNRS,1,2,2,4,1999,1999,0,No,0,0.0,-0.48,-0.48,0,3,3,0,0,0,0.0,9.0,9.0,212000.0,0.0,-212000.0
<a href=/player/suzum001>suzum001</a>,Mac Suzuki,Kansas City Royals,ROYALS,1,2,1,3,2001,2003,2,No,0,-0.28,-0.5,-0.22,31,265,234,74,964,890,19.0,0.0,-19.0,320000.0,0.0,-320000.0
<a href=/player/sveud001>sveud001</a>,Dale Sveum,Milwaukee Brewers,BREWRS,1,1,1,2,1991,1992,1,No,0,-1.04,-1.17,-0.13,54,25,-29,153,0,-153,0.0,174.0,174.0,0.0,0.0,0.0
<a href=/player/sveud001>sveud001</a>,Dale Sveum,Philadelphia Phillies,PHILS,1,1,1,2,1992,1992,0,No,0,0.16,0.02,-0.14,40,24,-16,131,0,-131,0.0,66.0,66.0,375000.0,0.0,-375000.0
<a href=/player/swand001>swand001</a>,Dansby Swanson,Arizona Diamondbacks,DBACKS,2,5,3,8,2015,2018,3,No,0,16.27,-1.52,-17.79,1329,142,-1187,5122,368,-4754,281.0,417.0,136.0,513000.0,0.0,-513000.0
<a href=/player/swane001>swane001</a>,Erik Swanson,Texas Rangers,RNGRS,1,3,1,4,2016,2016,0,No,0,0.0,0.27,0.27,0,52,52,0,206,206,0.0,0.0,0.0,0.0,0.0,0.0
<a href=/player/swane001>swane001</a>,Erik Swanson,New York Yankees,YANKS,1,3,1,4,2018,2020,2,No,0,-1.57,1.84,3.41,118,37,-81,6,8,2,818.0,513.0,-305.0,0.0,0.0,0.0
<a href=/player/swane101>swane101</a>,Evar Swanson,St. Louis Cardinals,CARDS,1,1,2,3,1932,1936,4,No,0,5.38,1.87,-3.51,275,283,8,1205,1288,83,0.0,0.0,0.0,0.0,0.0,0.0
<a href=/player/swanr001>swanr001</a>,Russ Swan,San Francisco Giants,GIANTS,1,1,1,2,1990,1990,0,No,0,0.74,0.0,-0.74,152,0,-152,0,0,0,749.0,0.0,-749.0,100000.0,0.0,-100000.0
<a href=/player/swans101>swans101</a>,Stan Swanson,Cincinnati Reds,REDS,3,3,3,6,1971,1972,1,No,0,0.08,0.0,-0.08,60,0,-60,129,0,-129,0.0,0.0,0.0,0.0,0.0,0.0
<a href=/player/swara001>swara001</a>,Anthony Swarzak,Chicago White Sox,WSOX,1,1,1,2,2017,2019,2,No,0,0.9,-1.3,-2.2,56,116,60,0,287,287,87.0,0.0,-87.0,900000.0,0.0,-900000.0
<a href=/player/swara001>swara001</a>,Anthony Swarzak,New York Mets,METS,1,5,3,8,2018,2018,0,Yes,0,-0.49,0.0,0.49,191,0,-191,565,0,-565,376.0,0.0,-376.0,16500000.0,0.0,-16500000.0
<a href=/player/swara001>swara001</a>,Anthony Swarzak,Seattle Mariners,MARNRS,1,2,2,4,2019,2019,0,No,0,0.41,-0.53,-0.94,85,11,-74,0,0,0,119.0,33.0,-86.0,8500000.0,0.0,-8500000.0
<a href=/player/swarm101>swarm101</a>,Monty Swartz,Cincinnati Reds,REDS,1,3,1,4,1921,1926,5,No,0,0.0,8.24,8.24,0,602,602,0,2409,2409,0.0,0.0,0.0,0.0,0.0,0.0
<a href=/player/sweeb001>sweeb001</a>,Brian Sweeney,Seattle Mariners,MARNRS,2,4,5,9,2004,2008,4,No,0,-0.53,1.64,2.17,147,104,-43,117,144,27,212.0,123.0,-89.0,750000.0,0.0,-750000.0
<a href=/player/sweeb101>sweeb101</a>,Bill Sweeney,Detroit Tigers,TIGRS,2,5,3,8,1928,1933,5,No,0,12.96,10.92,-2.04,710,561,-149,2975,2358,-617,0.0,0.0,0.0,21000.0,0.0,-21000.0
<a href=/player/sweeb102>sweeb102</a>,Bill Sweeney,Chicago Cubs,CUBS,1,2,1,3,1907,1907,0,No,0,11.38,-0.4,-11.78,977,51,-926,4014,159,-3855,0.0,0.0,0.0,0.0,0.0,0.0
<a href=/player/sweeb102>sweeb102</a>,Bill Sweeney,Boston Braves,BRAVES,1,2,1,3,1914,1917,3,No,0,1.39,7.06,5.67,134,317,183,540,1353,813,0.0,0.0,0.0,0.0,0.0,0.0
<a href=/player/sweed001>sweed001</a>,Darnell Sweeney,Los Angeles Dodgers,DOGRS,1,2,2,4,2015,2018,3,No,0,-0.34,2.52,2.86,37,386,349,98,1246,1148,0.0,0.0,0.0,0.0,0.0,0.0
<a href=/player/sweed001>sweed001</a>,Darnell Sweeney,Philadelphia Phillies,PHILS,3,5,5,10,2016,2018,2,No,0,3.05,1.06,-1.99,238,68,-170,808,210,-598,0.0,0.0,0.0,10527000.0,0.0,-10527000.0
<a href=/player/sweem001>sweem001</a>,Mark Sweeney,California Angels,ANGELS,1,1,1,2,1995,1995,0,No,0,-0.25,0.36,0.61,179,28,-151,372,0,-372,0.0,98.0,98.0,0.0,0.0,0.0
<a href=/player/sweem001>sweem001</a>,Mark Sweeney,St. Louis Cardinals,CARDS,1,3,3,6,1997,1997,0,No,0,-0.21,-1.09,-0.88,425,93,-332,688,180,-508,185.0,68.0,-117.0,4942500.0,0.0,-4942500.0
<a href=/player/sweem001>sweem001</a>,Mark Sweeney,San Diego Padres,PADRS,4,8,9,17,1999,2006,7,No,1,6.95,24.07,17.12,734,1502,768,2481,5933,3452,0.0,4.0,4.0,8651680.0,0.0,-8651680.0
<a href=/player/sweem001>sweem001</a>,Mark Sweeney,Cincinnati Reds,REDS,3,4,5,9,2000,2004,4,No,0,0.58,5.78,5.2,321,456,135,1051,1700,649,0.0,0.0,0.0,3650000.0,0.0,-3650000.0
<a href=/player/sweem001>sweem001</a>,Mark Sweeney,Milwaukee Brewers,BREWRS,2,7,6,13,2002,2004,2,No,0,1.18,1.8,0.62,314,393,79,929,661,-268,437.0,1049.0,612.0,2750000.0,0.0,-2750000.0
<a href=/player/sweem001>sweem001</a>,Mark Sweeney,San Francisco Giants,GIANTS,1,1,1,2,2007,2008,1,No,0,-1.0,0.11,1.11,128,24,-104,142,42,-100,0.0,0.0,0.0,900000.0,0.0,-900000.0
<a href=/player/sweer001>sweer001</a>,Ryan Sweeney,Chicago White Sox,WSOX,2,5,4,9,2008,2011,3,No,0,24.92,-0.88,-25.8,1177,181,-996,4107,638,-3469,1718.0,20.0,-1698.0,3600000.0,0.0,-3600000.0
<a href=/player/sweer001>sweer001</a>,Ryan Sweeney,Oakland Athletics,ATLTCS,2,4,6,10,2011,2019,8,Yes,0,6.28,16.11,9.83,292,639,347,512,2366,1854,1216.0,614.0,-602.0,1865000.0,0.0,-1865000.0
<a href=/player/swifb001>swifb001</a>,Bill Swift,Seattle Mariners,MARNRS,2,4,3,7,1991,1993,2,No,0,19.75,1.34,-18.41,1114,134,-980,1118,402,-716,2994.0,104.0,-2890.0,5400000.0,0.0,-5400000.0
<a href=/player/swifb101>swifb101</a>,Bill Swift,KansasCity,KansasCity,1,1,2,3,1932,1935,3,No,0,21.31,0.0,-21.31,610,0,-610,603,0,-603,4663.0,0.0,-4663.0,0.0,0.0,0.0
<a href=/player/swifb101>swifb101</a>,Bill Swift,Pittsburgh Pirates,PIRATS,1,2,1,3,1939,1940,1,No,0,-0.39,0.77,1.16,8,70,62,3,29,26,28.0,274.0,246.0,7000.0,0.0,-7000.0
<a href=/player/swifb101>swifb101</a>,Bill Swift,Chicago White Sox,WSOX,1,3,1,4,1943,1943,0,No,0,0.0,0.0,0.0,0,0,0,0,0,0,0.0,0.0,0.0,8600.0,0.0,-8600.0
<a href=/player/swifb102>swifb102</a>,Bob Swift,New York Yankees,YANKS,1,2,1,3,1937,1937,0,No,0,-1.38,0.0,1.38,222,0,-222,709,0,-709,0.0,0.0,0.0,0.0,0.0,0.0
<a href=/player/swifb102>swifb102</a>,Bob Swift,St.Louis Browns,ORLS,3,4,5,9,1942,1952,10,No,0,5.24,7.57,2.33,522,583,61,1337,761,-576,901.0,2542.0,1641.0,21000.0,0.0,-21000.0
<a href=/player/swifb102>swifb102</a>,Bob Swift,Philadelphia Athletics,ATLTCS,1,2,1,3,1943,1946,3,No,0,0.19,0.0,-0.19,648,0,-648,1982,0,-1982,0.0,0.0,0.0,6000.0,0.0,-6000.0
<a href=/player/swihb001>swihb001</a>,Blake Swihart,Boston Red Sox,RSOX,1,2,1,3,2019,2019,0,Yes,0,-0.94,0.0,0.94,31,0,-31,70,0,-70,0.0,0.0,0.0,910000.0,0.0,-910000.0
<a href=/player/swing001>swing001</a>,Greg Swindell,Cleveland Indians,INDINS,1,1,3,4,1991,1993,2,No,0,4.96,-2.2,-7.16,62,60,-2,87,0,-87,641.0,839.0,198.0,2025000.0,0.0,-2025000.0
<a href=/player/swing001>swing001</a>,Greg Swindell,Minnesota Twins,TWINS,2,4,5,9,1998,2002,4,No,0,-0.39,0.81,1.2,167,43,-124,84,66,-18,831.0,325.0,-506.0,2100000.0,0.0,-2100000.0
<a href=/player/swisn001>swisn001</a>,Nick Swisher,Oakland Athletics,ATLTCS,17,32,32,64,2008,2019,11,Yes,0,47.93,48.81,0.88,3102,2736,-366,6703,7885,1182,8838.0,5246.0,-3592.0,12082501.0,0.0,-12082501.0
<a href=/player/swisn001>swisn001</a>,Nick Swisher,Chicago White Sox,WSOX,1,2,3,5,2008,2011,3,No,0,11.97,-0.72,-12.69,599,28,-571,2501,50,-2451,3.0,20.0,17.0,3600000.0,0.0,-3600000.0
<a href=/player/swisn001>swisn001</a>,Nick Swisher,Cleveland Indians,INDINS,1,3,1,4,2015,2015,0,No,0,-0.91,-0.23,0.68,92,27,-65,305,93,-212,0.0,0.0,0.0,0.0,0.0,0.0
<a href=/player/swiss101>swiss101</a>,Steve Swisher,Chicago White Sox,WSOX,1,4,1,5,1973,1973,0,No,0,6.5,0.0,-6.5,800,0,-800,1477,0,-1477,2061.0,0.0,-2061.0,32700.0,0.0,-32700.0
<a href=/player/swiss101>swiss101</a>,Steve Swisher,Chicago Cubs,CUBS,12,22,23,45,1977,1990,13,No,0,19.55,19.15,-0.4,3026,1816,-1210,7924,3345,-4579,1137.0,4804.0,3667.0,1020000.0,0.0,-1020000.0
<a href=/player/swiss101>swiss101</a>,Steve Swisher,St. Louis Cardinals,CARDS,12,29,23,52,1980,1998,18,No,5,83.63,121.95,38.32,6733,4994,-1739,20851,17148,-3703,6532.0,3025.0,-3507.0,1533333.0,0.0,-1533333.0
<a href=/player/swobr101>swobr101</a>,Ron Swoboda,New York Mets,METS,7,11,11,22,1971,1984,13,No,0,10.8,20.91,10.11,1517,1503,-14,1460,5043,3583,2280.0,196.0,-2084.0,90000.0,0.0,-90000.0
<a href=/player/swobr101>swobr101</a>,Ron Swoboda,Montreal Expos,NATEX,1,1,1,2,1971,1971,0,No,0,0.28,1.09,0.81,152,51,-101,350,159,-191,0.0,0.0,0.0,0.0,0.0,0.0
<a href=/player/sykeb101>sykeb101</a>,Bob Sykes,Detroit Tigers,TIGRS,2,4,3,7,1978,1985,7,No,0,-2.68,10.4,13.08,239,743,504,342,1333,991,691.0,2139.0,1448.0,0.0,0.0,0.0
<a href=/player/sykeb101>sykeb101</a>,Bob Sykes,St. Louis Cardinals,CARDS,4,5,8,13,1981,1994,13,No,2,1.02,39.1,38.08,307,1804,1497,1154,7358,6204,0.0,0.0,0.0,1500000.0,0.0,-1500000.0
<a href=/player/syndn001>syndn001</a>,Noah Syndergaard,Toronto Blue Jays,BJAYS,1,4,3,7,2012,2016,4,No,0,18.37,4.87,-13.5,742,311,-431,2152,493,-1659,2154.0,2473.0,319.0,0.0,0.0,0.0
<a href=/player/szczm001>szczm001</a>,Matt Szczur,Chicago Cubs,CUBS,1,1,1,2,2017,2018,1,No,0,0.03,0.32,0.29,161,20,-141,298,2,-296,0.0,37.0,37.0,0.0,0.0,0.0
<a href=/player/szumj001>szumj001</a>,Jason Szuminski,Kansas City Royals,ROYALS,1,2,1,3,2003,2004,1,No,0,-0.25,0.05,0.3,14,6,-8,1,1,0,30.0,0.0,-30.0,0.0,0.0,0.0
<a href=/player/tabaj001>tabaj001</a>,Jeff Tabaka,San Diego Padres,PADRS,1,2,1,3,1995,1995,0,No,0,-0.01,0.15,0.16,84,54,-30,3,165,162,134.0,0.0,-134.0,140000.0,0.0,-140000.0
<a href=/player/tabaj002>tabaj002</a>,Jose Tabata,New York Yankees,YANKS,1,4,2,6,2008,2011,3,No,0,7.23,0.52,-6.71,1088,146,-942,2084,276,-1808,3210.0,148.0,-3062.0,391425.0,0.0,-391425.0
<a href=/player/tabaj002>tabaj002</a>,Jose Tabata,Pittsburgh Pirates,PIRATS,1,1,2,3,2015,2016,1,No,0,0.0,-0.21,-0.21,0,51,51,0,90,90,0.0,0.0,0.0,4000000.0,0.0,-4000000.0
<a href=/player/tabel101>tabel101</a>,Lefty Taber,Philadelphia Phillies,PHILS,1,3,1,4,1928,1928,0,No,0,0.0,1.31,1.31,0,96,96,0,292,292,0.0,0.0,0.0,0.0,0.0,0.0
<a href=/player/tablp001>tablp001</a>,Pat Tabler,New York Yankees,YANKS,7,14,14,28,1981,1993,12,No,0,67.75,44.14,-23.61,3137,1398,-1739,9400,3277,-6123,6684.0,5010.0,-1674.0,2477500.0,0.0,-2477500.0
<a href=/player/tablp001>tablp001</a>,Pat Tabler,Chicago Cubs,CUBS,3,6,6,12,1983,1990,7,No,0,9.95,11.91,1.96,748,630,-118,2292,307,-1985,429.0,3028.0,2599.0,890000.0,0.0,-890000.0
<a href=/player/tablp001>tablp001</a>,Pat Tabler,Chicago White Sox,WSOX,1,1,1,2,1983,1985,2,No,0,7.4,0.49,-6.91,707,221,-486,2753,442,-2311,0.0,0.0,0.0,0.0,0.0,0.0
<a href=/player/tablp001>tablp001</a>,Pat Tabler,Cleveland Indians,INDINS,20,26,33,59,1988,2020,32,Yes,2,31.66,118.21,86.55,3541,3433,-108,10779,9199,-1580,4030.0,10939.0,6909.0,46229400.0,0.0,-46229400.0
<a href=/player/tablp001>tablp001</a>,Pat Tabler,Kansas City Royals,ROYALS,2,3,3,6,1990,1998,8,No,0,4.8,3.63,-1.17,369,159,-210,1163,0,-1163,0.0,1998.0,1998.0,725000.0,0.0,-725000.0
<a href=/player/tabog001>tabog001</a>,Greg Tabor,Texas Rangers,RNGRS,1,2,1,3,1988,1988,0,No,0,-0.02,-0.74,-0.72,2,12,10,5,0,-5,0.0,188.0,188.0,0.0,0.0,0.0
<a href=/player/tadak001>tadak001</a>,Kazuhito Tadano,Cleveland Indians,INDINS,1,1,1,2,2006,2006,0,No,0,0.0,0.0,0.0,0,0,0,0,0,0,0.0,0.0,0.0,0.0,0.0,0.0
<a href=/player/tailj001>tailj001</a>,Jameson Taillon,Pittsburgh Pirates,PIRATS,1,1,4,5,2021,2021,0,Yes,0,2.23,-0.2,-2.43,31,9,-22,2,3,1,433.0,54.0,-379.0,0.0,0.0,0.0
<a href=/player/taitd101>taitd101</a>,Doug Taitt,Boston Red Sox,RSOX,4,5,5,10,1929,1936,7,No,0,-0.03,21.89,21.92,236,1145,909,851,4811,3960,0.0,0.0,0.0,35000.0,0.0,-35000.0
<a href=/player/talbf101>talbf101</a>,Fred Talbot,Chicago White Sox,WSOX,19,37,35,72,1965,1985,20,No,1,67.23,101.41,34.18,5604,5055,-549,14828,15211,383,11632.0,9695.0,-1937.0,609700.0,0.0,-609700.0
<a href=/player/talbf101>talbf101</a>,Fred Talbot,Kansas City Athletics,ATLTCS,2,3,5,8,1966,1967,1,No,0,5.45,-1.25,-6.7,785,201,-584,1910,500,-1410,1121.0,300.0,-821.0,25000.0,0.0,-25000.0
<a href=/player/talbf101>talbf101</a>,Fred Talbot,New York Yankees,YANKS,2,2,2,4,1969,1973,4,No,0,1.79,4.54,2.75,242,385,143,56,473,417,736.0,593.0,-143.0,17000.0,0.0,-17000.0
<a href=/player/talbf101>talbf101</a>,Fred Talbot,Seattle Pilots,BREWRS,5,8,6,14,1969,1976,7,No,0,4.01,14.86,10.85,708,774,66,2221,2768,547,397.0,153.0,-244.0,159600.0,0.0,-159600.0
<a href=/player/talbm001>talbm001</a>,Mitch Talbot,Houston Astros,ASTROS,1,2,2,4,2006,2006,0,No,0,34.91,0.23,-34.68,1067,68,-999,4478,261,-4217,29.0,0.0,-29.0,0.0,0.0,0.0
<a href=/player/talbm001>talbm001</a>,Mitch Talbot,Tampa Bay Devil Rays,RAYS,1,1,1,2,2009,2011,2,No,0,-0.03,0.87,0.9,44,150,106,8,440,432,669.0,0.0,-669.0,0.0,0.0,0.0
<a href=/player/tallb001>tallb001</a>,Brian Tallet,Cleveland Indians,INDINS,1,1,1,2,2006,2006,0,No,0,0.61,0.0,-0.61,228,0,-228,3,0,-3,1234.0,0.0,-1234.0,0.0,0.0,0.0
<a href=/player/tallb001>tallb001</a>,Brian Tallet,St. Louis Cardinals,CARDS,5,8,8,16,2011,2019,8,Yes,2,7.33,0.78,-6.55,586,381,-205,1627,154,-1473,283.0,547.0,264.0,3193000.0,0.0,-3193000.0
<a href=/player/taltt101>taltt101</a>,Tim Talton,San Francisco Giants,GIANTS,1,1,1,2,1965,1965,0,No,0,0.69,0.0,-0.69,83,0,-83,123,0,-123,0.0,0.0,0.0,0.0,0.0,0.0
<a href=/player/tamaj101>tamaj101</a>,John Tamargo,St. Louis Cardinals,CARDS,1,1,1,2,1978,1979,1,No,0,-0.11,0.42,0.53,66,6,-60,180,4,-176,0.0,39.0,39.0,0.0,0.0,0.0
<a href=/player/tamaj101>tamaj101</a>,John Tamargo,San Francisco Giants,GIANTS,1,1,2,3,1979,1980,1,No,0,0.06,-0.31,-0.37,49,63,14,83,218,135,0.0,0.0,0.0,0.0,0.0,0.0
<a href=/player/tamuv101>tamuv101</a>,Vito Tamulis,New York Yankees,YANKS,1,1,1,2,1937,1937,0,No,0,-0.24,0.0,0.24,6,0,-6,6,0,-6,46.0,0.0,-46.0,0.0,0.0,0.0
<a href=/player/tamuv101>tamuv101</a>,Vito Tamulis,Brooklyn Dodgers,DOGRS,2,9,3,12,1940,1947,7,No,0,2.8,7.69,4.89,657,371,-286,1221,447,-774,1499.0,2793.0,1294.0,17500.0,0.0,-17500.0
<a href=/player/tamuv101>tamuv101</a>,Vito Tamulis,Philadelphia Phillies,PHILS,1,1,1,2,1941,1941,0,No,0,0.13,1.33,1.2,24,58,34,5,40,35,66.0,394.0,328.0,0.0,0.0,0.0
<a href=/player/tamuv101>tamuv101</a>,Vito Tamulis,Brooklyn Dodgers,DOGRS,1,1,2,3,1941,1947,6,No,0,0.0,-0.18,-0.18,0,33,33,0,24,24,0.0,74.0,74.0,0.0,0.0,0.0
<a href=/player/tanaf001>tanaf001</a>,Frank Tanana,California Angels,ANGELS,3,7,5,12,1981,1992,11,No,1,-0.2,18.35,18.55,173,631,458,348,1947,1599,512.0,2439.0,1927.0,0.0,0.0,0.0
<a href=/player/tanaf001>tanaf001</a>,Frank Tanana,Texas Rangers,RNGRS,1,1,1,2,1985,1985,0,No,0,13.09,0.0,-13.09,252,0,-252,1,0,-1,4654.0,0.0,-4654.0,590000.0,0.0,-590000.0
<a href=/player/tanaf001>tanaf001</a>,Frank Tanana,New York Mets,METS,1,1,1,2,1993,1994,1,No,0,0.21,0.09,-0.12,3,2,-1,0,0,0,59.0,3.0,-56.0,1500000.0,0.0,-1500000.0
<a href=/player/tankd001>tankd001</a>,Dennis Tankersley,Boston Red Sox,RSOX,1,2,1,3,2000,2000,0,No,0,-1.48,-0.14,1.34,52,33,-19,23,123,100,259.0,0.0,-259.0,0.0,0.0,0.0
<a href=/player/tankd001>tankd001</a>,Dennis Tankersley,San Diego Padres,PADRS,2,6,3,9,2004,2005,1,No,0,-0.69,-0.05,0.64,140,84,-56,489,11,-478,24.0,273.0,249.0,7550000.0,0.0,-7550000.0
<a href=/player/tannb001>tannb001</a>,Bruce Tanner,Chicago White Sox,WSOX,1,2,1,3,1986,1989,3,No,0,3.34,0.37,-2.97,291,194,-97,0,702,702,1471.0,0.0,-1471.0,240000.0,0.0,-240000.0
<a href=/player/tannc101>tannc101</a>,Chuck Tanner,Chicago Cubs,CUBS,2,2,2,4,1959,1959,0,No,0,-0.45,-0.17,0.28,24,43,19,6,91,85,88.0,2.0,-86.0,0.0,0.0,0.0
<a href=/player/tannc101>tannc101</a>,Chuck Tanner,Oakland Athletics,ATLTCS,3,3,6,9,1976,1980,4,No,1,-1.43,1.01,2.44,188,697,509,368,1923,1555,0.0,327.0,327.0,0.0,0.0,0.0
<a href=/player/tannj101>tannj101</a>,Jesse Tannehill,New York Yankees,YANKS,2,3,2,5,1903,1904,1,No,0,24.87,1.41,-23.46,923,85,-838,1185,123,-1062,8913.0,822.0,-8091.0,0.0,0.0,0.0
<a href=/player/tannj101>tannj101</a>,Jesse Tannehill,Boston Red Sox,RSOX,1,1,1,2,1908,1908,0,No,0,0.2,-0.31,-0.51,55,2,-53,87,1,-86,278.0,9.0,-269.0,0.0,0.0,0.0
<a href=/player/tapak001>tapak001</a>,Kevin Tapani,Oakland Athletics,ATLTCS,1,4,2,6,1987,1994,7,No,0,2.78,10.76,7.98,260,216,-44,78,1,-77,952.0,3814.0,2862.0,1137653.0,0.0,-1137653.0
<a href=/player/tapak001>tapak001</a>,Kevin Tapani,New York Mets,METS,2,6,3,9,1989,1991,2,No,2,34.39,9.58,-24.81,807,164,-643,0,204,204,6852.0,1699.0,-5153.0,378000.0,0.0,-378000.0
<a href=/player/tapak001>tapak001</a>,Kevin Tapani,Minnesota Twins,TWINS,2,3,5,8,1995,2000,5,No,0,1.39,-0.49,-1.88,429,829,400,30,2713,2683,819.0,618.0,-201.0,4612500.0,0.0,-4612500.0
<a href=/player/tappt101>tappt101</a>,Ted Tappe,Cincinnati Reds,REDS,2,7,3,10,1954,1960,6,No,0,0.48,13.19,12.71,599,458,-141,824,407,-417,733.0,2898.0,2165.0,18000.0,0.0,-18000.0
<a href=/player/tarat001>tarat001</a>,Tony Tarasco,Atlanta Braves,BRAVES,6,12,9,21,1995,2005,10,No,2,61.82,22.45,-39.37,2272,974,-1298,4447,2820,-1627,9346.0,423.0,-8923.0,4543000.0,0.0,-4543000.0
<a href=/player/tarat001>tarat001</a>,Tony Tarasco,Montreal Expos,NATEX,1,1,1,2,1996,1997,1,No,0,-0.19,-0.47,-0.28,131,130,-1,285,256,-29,0.0,0.0,0.0,0.0,0.0,0.0
<a href=/player/tarps001>tarps001</a>,Stephen Tarpley,Baltimore Orioles,ORLS,1,2,1,3,2015,2015,0,No,0,1.85,1.0,-0.85,210,69,-141,101,236,135,1030.0,0.0,-1030.0,0.0,0.0,0.0
<a href=/player/tarps001>tarps001</a>,Stephen Tarpley,Pittsburgh Pirates,PIRATS,2,3,3,6,2016,2018,2,Yes,0,2.04,3.15,1.11,68,138,70,5,140,135,662.0,1238.0,576.0,9167000.0,0.0,-9167000.0
<a href=/player/tarps001>tarps001</a>,Stephen Tarpley,New York Yankees,YANKS,1,1,2,3,2020,2020,0,Yes,0,-0.48,0.0,0.48,12,0,-12,0,0,0,33.0,0.0,-33.0,0.0,0.0,0.0
<a href=/player/tartd001>tartd001</a>,Danny Tartabull,Seattle Mariners,MARNRS,1,2,3,5,1986,1991,5,No,0,13.13,9.05,-4.08,676,330,-346,2684,625,-2059,71.0,1795.0,1724.0,85000.0,0.0,-85000.0
<a href=/player/tartd001>tartd001</a>,Danny Tartabull,New York Yankees,YANKS,2,3,3,6,1995,2000,5,No,0,-0.47,-0.06,0.41,70,303,233,278,1302,1024,0.0,0.0,0.0,11500000.0,0.0,-11500000.0
<a href=/player/tartd001>tartd001</a>,Danny Tartabull,Oakland Athletics,ATLTCS,1,1,2,3,1996,1997,1,No,0,0.57,-0.05,-0.62,132,12,-120,541,0,-541,0.0,89.0,89.0,0.0,0.0,0.0
<a href=/player/tartj101>tartj101</a>,Jose Tartabull,San Francisco Giants,GIANTS,1,1,1,2,1961,1962,1,No,0,1.56,0.11,-1.45,494,7,-487,1390,9,-1381,0.0,0.0,0.0,0.0,0.0,0.0
<a href=/player/tartj101>tartj101</a>,Jose Tartabull,Kansas City Athletics,ATLTCS,10,23,15,38,1966,1976,10,No,0,27.1,17.67,-9.43,4296,1831,-2465,8999,4813,-4186,5181.0,1373.0,-3808.0,355600.0,0.0,-355600.0
<a href=/player/tarvl001>tarvl001</a>,La Schelle Tarver,New York Mets,METS,6,12,11,23,1985,1994,9,No,0,8.23,9.35,1.12,636,686,50,644,1209,565,3320.0,3063.0,-257.0,4116666.0,0.0,-4116666.0
<a href=/player/tasbw101>tasbw101</a>,Willie Tasby,Baltimore Orioles,ORLS,3,3,4,7,1960,1963,3,No,0,-0.63,1.38,2.01,302,243,-59,1067,603,-464,0.0,0.0,0.0,0.0,0.0,0.0
<a href=/player/tasbw101>tasbw101</a>,Willie Tasby,Washington Senators,RNGRS,3,3,4,7,1962,1966,4,No,0,8.16,4.13,-4.03,769,613,-156,457,1604,1147,1507.0,990.0,-517.0,0.0,0.0,0.0
<a href=/player/tascj001>tascj001</a>,Jack Taschner,San Francisco Giants,GIANTS,2,2,2,4,2009,2009,0,No,0,1.91,0.0,-1.91,218,0,-218,612,0,-612,88.0,0.0,-88.0,0.0,0.0,0.0
<a href=/player/tateb101>tateb101</a>,Bennie Tate,Washington Senators,TWINS,1,2,1,3,1930,1930,0,No,0,0.86,0.43,-0.43,237,38,-199,612,91,-521,414.0,0.0,-414.0,13500.0,0.0,-13500.0
<a href=/player/tateb101>tateb101</a>,Bennie Tate,Chicago White Sox,WSOX,3,8,5,13,1932,1935,3,No,0,3.4,4.58,1.18,902,283,-619,3430,766,-2664,0.0,735.0,735.0,34500.0,0.0,-34500.0
<a href=/player/tated001>tated001</a>,Dillon Tate,Texas Rangers,RNGRS,1,3,1,4,2016,2016,0,No,0,0.0,0.27,0.27,0,52,52,0,206,206,0.0,0.0,0.0,0.0,0.0,0.0
<a href=/player/tated001>tated001</a>,Dillon Tate,New York Yankees,YANKS,1,3,1,4,2018,2019,1,Yes,0,-0.19,2.71,2.9,121,97,-24,0,0,0,451.0,259.0,-192.0,0.0,0.0,0.0
<a href=/player/tatif001>tatif001</a>,Fernando Tatis,Texas Rangers,RNGRS,10,22,21,43,1998,2013,15,No,6,69.97,35.86,-34.11,3830,2430,-1400,13190,7848,-5342,3667.0,3730.0,63.0,14990260.0,0.0,-14990260.0
<a href=/player/tatif001>tatif001</a>,Fernando Tatis,St. Louis Cardinals,CARDS,4,6,7,13,2000,2004,4,No,0,4.8,5.31,0.51,823,756,-67,2678,110,-2568,559.0,1705.0,1146.0,6083333.0,0.0,-6083333.0
<a href=/player/tatif002>tatif002</a>,Fernando Tatis,Chicago White Sox,WSOX,1,2,2,4,2016,2018,2,No,0,12.87,0.14,-12.73,280,82,-198,1180,11,-1169,59.0,1308.0,1249.0,0.0,0.0,0.0
<a href=/player/tatuj101>tatuj101</a>,Jarvis Tatum,California Angels,ANGELS,3,6,8,14,1970,1974,4,No,0,2.03,2.21,0.18,1109,432,-677,3640,1513,-2127,261.0,88.0,-173.0,44000.0,0.0,-44000.0
<a href=/player/tatuk101>tatuk101</a>,Ken Tatum,California Angels,ANGELS,3,6,8,14,1970,1974,4,No,0,2.03,2.21,0.18,1109,432,-677,3640,1513,-2127,261.0,88.0,-173.0,44000.0,0.0,-44000.0
<a href=/player/tatuk101>tatuk101</a>,Ken Tatum,Boston Red Sox,RSOX,5,10,8,18,1973,1987,14,No,0,23.48,30.66,7.18,1104,1173,69,2926,3213,287,3997.0,6340.0,2343.0,120000.0,0.0,-120000.0
<a href=/player/tatuk101>tatuk101</a>,Ken Tatum,St. Louis Cardinals,CARDS,6,8,7,15,1974,1977,3,No,0,-1.89,-0.71,1.18,576,98,-478,1332,140,-1192,128.0,23.0,-105.0,0.0,0.0,0.0
<a href=/player/tatut101>tatut101</a>,Tommy Tatum,Nashville,Nashville,1,2,1,3,1941,1941,0,No,0,-0.18,0.0,0.18,33,0,-33,24,0,-24,74.0,0.0,-74.0,0.0,0.0,0.0
<a href=/player/taube001>taube001</a>,Ed Taubensee,Cleveland Indians,INDINS,16,22,27,49,1991,2020,29,Yes,2,33.95,111.42,77.47,3251,3340,89,9795,9199,-596,3983.0,9391.0,5408.0,44654400.0,0.0,-44654400.0
<a href=/player/taube001>taube001</a>,Ed Taubensee,Houston Astros,ASTROS,1,1,2,3,1994,1995,1,No,0,5.01,-0.51,-5.52,694,54,-640,2324,0,-2324,0.0,49.0,49.0,275000.0,0.0,-275000.0
<a href=/player/taube001>taube001</a>,Ed Taubensee,Cincinnati Reds,REDS,2,2,3,5,2000,2003,3,No,0,-0.31,2.29,2.6,112,212,100,133,37,-96,123.0,625.0,502.0,1650000.0,0.0,-1650000.0
<a href=/player/taubt001>taubt001</a>,Ty Taubenheim,Milwaukee Brewers,BREWRS,4,8,7,15,2005,2012,7,No,2,36.63,9.25,-27.38,2335,589,-1746,9079,878,-8201,310.0,3140.0,2830.0,860000.0,0.0,-860000.0
<a href=/player/taucm001>taucm001</a>,Mike Tauchman,Colorado Rockies,ROCKS,1,1,1,2,2019,2021,2,No,0,3.86,-0.25,-4.11,141,26,-115,423,0,-423,0.0,40.0,40.0,0.0,0.0,0.0
<a href=/player/taucm001>taucm001</a>,Mike Tauchman,New York Yankees,YANKS,1,1,2,3,2021,2021,0,Yes,0,0.0,0.95,0.95,65,52,-13,175,0,-175,3.0,128.0,125.0,0.0,0.0,0.0
<a href=/player/tausw101>tausw101</a>,Walt Tauscher,Washington Senators,TWINS,1,5,1,6,1931,1939,8,No,0,0.0,8.51,8.51,0,385,385,0,407,407,0.0,3095.0,3095.0,6500.0,0.0,-6500.0
<a href=/player/tavaj001>tavaj001</a>,Julian Tavarez,Cleveland Indians,INDINS,3,6,6,12,1996,2001,5,No,0,40.02,3.44,-36.58,2173,212,-1961,7166,649,-6517,933.0,172.0,-761.0,7541666.0,0.0,-7541666.0
<a href=/player/tavaj001>tavaj001</a>,Julian Tavarez,Chicago Cubs,CUBS,2,5,3,8,2002,2004,2,No,1,19.76,10.92,-8.84,396,427,31,455,211,-244,3529.0,2185.0,-1344.0,0.0,0.0,0.0
<a href=/player/tavaj002>tavaj002</a>,Jesus Tavarez,Florida Marlins,MARLNS,1,1,1,2,1996,1996,0,No,0,-0.28,0.0,0.28,42,0,-42,74,0,-74,0.0,0.0,0.0,134000.0,0.0,-134000.0
<a href=/player/tavea101>tavea101</a>,Alex Taveras,Houston Astros,ASTROS,1,2,1,3,1977,1978,1,No,0,0.09,-0.34,-0.43,21,13,-8,7,21,14,0.0,0.0,0.0,0.0,0.0,0.0
<a href=/player/tavef101>tavef101</a>,Frank Taveras,Pittsburgh Pirates,PIRATS,14,19,23,42,1979,2001,22,No,2,29.26,38.44,9.18,2250,3190,940,6396,7192,796,5336.0,7958.0,2622.0,2732500.0,0.0,-2732500.0
<a href=/player/tavef101>tavef101</a>,Frank Taveras,New York Mets,METS,1,1,2,3,1981,1981,0,No,0,-0.53,0.0,0.53,48,0,-48,98,0,-98,0.0,0.0,0.0,195000.0,0.0,-195000.0
<a href=/player/tavej101>tavej101</a>,Jackie Tavener,Detroit Tigers,TIGRS,1,2,1,3,1928,1933,5,No,0,1.66,19.39,17.73,166,319,153,343,408,65,447.0,2479.0,2032.0,0.0,0.0,0.0
<a href=/player/tavew001>tavew001</a>,Willy Taveras,Houston Astros,ASTROS,1,3,2,5,2006,2007,1,No,0,4.59,-0.73,-5.32,489,38,-451,1012,30,-982,873.0,297.0,-576.0,727000.0,0.0,-727000.0
<a href=/player/tavew001>tavew001</a>,Willy Taveras,Cincinnati Reds,REDS,1,2,2,4,2010,2010,0,No,0,1.98,0.0,-1.98,268,0,-268,835,0,-835,0.0,0.0,0.0,0.0,0.0,0.0
<a href=/player/tayla001>tayla001</a>,Aaron Taylor,Seattle Mariners,MARNRS,9,17,17,34,2004,2015,11,No,0,0.83,33.05,32.22,1230,1934,704,2304,5785,3481,1045.0,3331.0,2286.0,19030000.0,0.0,-19030000.0
<a href=/player/taylb001>taylb001</a>,Billy Taylor,Oakland Athletics,ATLTCS,2,2,4,6,1999,2001,2,No,2,-0.38,4.14,4.52,36,174,138,0,0,0,40.0,542.0,502.0,2500000.0,0.0,-2500000.0
<a href=/player/taylb004>taylb004</a>,Blake Taylor,Pittsburgh Pirates,PIRATS,1,2,1,3,2014,2014,0,No,0,0.0,-0.07,-0.07,0,131,131,0,397,397,0.0,0.0,0.0,0.0,0.0,0.0
<a href=/player/taylb004>taylb004</a>,Blake Taylor,New York Mets,METS,1,2,1,3,2019,2020,1,No,0,1.02,0.19,-0.83,78,16,-62,0,34,34,190.0,0.0,-190.0,0.0,0.0,0.0
<a href=/player/taylb102>taylb102</a>,Bill Taylor,Oakland,Oakland,1,2,2,4,1950,1950,0,No,0,-0.62,0.0,0.62,132,0,-132,152,0,-152,0.0,0.0,0.0,0.0,0.0,0.0
<a href=/player/taylb106>taylb106</a>,Ben Taylor,Brooklyn Dodgers,DOGRS,1,1,3,4,1951,1951,0,No,0,-0.18,0.0,0.18,33,0,-33,104,0,-104,0.0,0.0,0.0,0.0,0.0,0.0
<a href=/player/taylb106>taylb106</a>,Ben Taylor,St.Louis Browns,ORLS,23,51,48,99,1952,1994,42,No,3,84.08,155.33,71.25,5312,9112,3800,11244,26050,14806,18662.0,17928.0,-734.0,984333.0,0.0,-984333.0
<a href=/player/taylb106>taylb106</a>,Ben Taylor,Detroit Tigers,TIGRS,1,1,1,2,1952,1952,0,No,0,0.0,0.0,0.0,0,0,0,0,0,0,0.0,0.0,0.0,0.0,0.0,0.0
<a href=/player/taylb106>taylb106</a>,Ben Taylor,Dallas,Dallas,1,4,2,6,1954,1954,0,No,0,0.0,0.0,0.0,0,0,0,0,0,0,0.0,0.0,0.0,0.0,0.0,0.0
<a href=/player/taylc001>taylc001</a>,Chris Taylor,Seattle Mariners,MARNRS,1,1,1,2,2016,2016,0,No,0,14.83,0.0,-14.83,657,0,-657,2444,0,-2444,0.0,0.0,0.0,0.0,0.0,0.0
<a href=/player/taylc101>taylc101</a>,Chuck Taylor,St. Louis Cardinals,CARDS,1,2,1,3,1964,1965,1,No,0,-0.99,-0.76,0.23,78,138,60,148,253,105,0.0,0.0,0.0,0.0,0.0,0.0
<a href=/player/taylc101>taylc101</a>,Chuck Taylor,Houston Astros,ASTROS,3,6,5,11,1965,1970,5,No,0,24.19,12.71,-11.48,1107,622,-485,906,1206,300,7567.0,2468.0,-5099.0,0.0,0.0,0.0
<a href=/player/taylc101>taylc101</a>,Chuck Taylor,St. Louis Cardinals,CARDS,9,16,14,30,1971,1976,5,No,0,14.55,3.01,-11.54,1564,430,-1134,3017,530,-2487,3834.0,1012.0,-2822.0,0.0,0.0,0.0
<a href=/player/taylc102>taylc102</a>,Carl Taylor,Pittsburgh Pirates,PIRATS,6,12,13,25,1969,1988,19,No,0,54.34,40.3,-14.04,3033,2509,-524,9949,6676,-3273,5429.0,2003.0,-3426.0,819000.0,0.0,-819000.0
<a href=/player/taylc102>taylc102</a>,Carl Taylor,St. Louis Cardinals,CARDS,1,2,3,5,1970,1972,2,No,0,0.0,0.71,0.71,0,95,95,0,203,203,0.0,0.0,0.0,17500.0,0.0,-17500.0
<a href=/player/taylc102>taylc102</a>,Carl Taylor,Milwaukee Brewers,BREWRS,4,8,8,16,1971,1978,7,No,0,7.91,9.79,1.88,698,534,-164,1896,1479,-417,524.0,1634.0,1110.0,168301.0,0.0,-168301.0
<a href=/player/tayld001>tayld001</a>,Dwight Taylor,Cleveland Indians,INDINS,1,1,1,2,1985,1986,1,No,0,-0.07,0.31,0.38,4,15,11,2,0,-2,0.0,186.0,186.0,0.0,0.0,0.0
<a href=/player/tayld001>tayld001</a>,Dwight Taylor,Cleveland Indians,INDINS,1,2,2,4,1990,1990,0,No,0,0.0,0.0,0.0,0,0,0,0,0,0,0.0,0.0,0.0,0.0,0.0,0.0
<a href=/player/tayld002>tayld002</a>,Dorn Taylor,Pittsburgh Pirates,PIRATS,1,1,1,2,1990,1990,0,No,0,-0.07,0.11,0.18,4,10,6,0,0,0,11.0,21.0,10.0,0.0,0.0,0.0
<a href=/player/tayld101>tayld101</a>,Danny Taylor,Washington Senators,TWINS,2,8,2,10,1926,1941,15,No,0,14.54,44.02,29.48,801,1602,801,1696,6582,4886,3390.0,957.0,-2433.0,24000.0,0.0,-24000.0
<a href=/player/tayld101>tayld101</a>,Danny Taylor,Memphis,Memphis,1,1,2,3,1928,1931,3,No,0,1.97,0.0,-1.97,170,0,-170,586,0,-586,0.0,0.0,0.0,0.0,0.0,0.0
<a href=/player/tayle101>tayle101</a>,Ed Taylor,Boston Braves,BRAVES,1,1,2,3,1928,1929,1,No,0,0.0,-1.24,-1.24,0,94,94,0,291,291,0.0,20.0,20.0,0.0,0.0,0.0
<a href=/player/taylh102>taylh102</a>,Hawk Taylor,New York Mets,METS,1,1,2,3,1967,1967,0,No,0,0.59,0.0,-0.59,23,0,-23,56,0,-56,0.0,0.0,0.0,13000.0,0.0,-13000.0
<a href=/player/taylh102>taylh102</a>,Hawk Taylor,Kansas City Royals,ROYALS,1,1,1,2,1971,1971,0,No,0,0.0,0.0,0.0,0,0,0,0,0,0,0.0,0.0,0.0,0.0,0.0,0.0
<a href=/player/taylh104>taylh104</a>,Harry Taylor,Louisville Colonels,LS3,1,2,1,3,1893,1894,1,No,0,35.58,1.66,-33.92,755,147,-608,3472,687,-2785,0.0,0.0,0.0,0.0,0.0,0.0
<a href=/player/taylj001>taylj001</a>,Josh Taylor,Arizona Diamondbacks,DBACKS,1,1,1,2,2018,2018,0,No,0,2.44,-0.36,-2.8,129,49,-80,0,85,85,307.0,0.0,-307.0,0.0,0.0,0.0
<a href=/player/taylj001>taylj001</a>,Josh Taylor,Philadelphia Phillies,PHILS,1,3,1,4,2015,2015,0,No,0,0.0,0.0,0.0,0,0,0,0,0,0,0.0,0.0,0.0,0.0,0.0,0.0
<a href=/player/taylj101>taylj101</a>,Jack Taylor,Chicago Cubs,CUBS,2,4,3,7,1903,1912,9,No,0,14.83,52.1,37.27,532,1045,513,1056,2195,1139,4091.0,6835.0,2744.0,0.0,0.0,0.0
<a href=/player/taylj101>taylj101</a>,Jack Taylor,St. Louis Cardinals,CARDS,2,3,6,9,1906,1914,8,No,0,1.56,6.72,5.16,140,1071,931,180,3501,3321,1449.0,3031.0,1582.0,0.0,0.0,0.0
<a href=/player/taylj102>taylj102</a>,Jack Taylor,Philadelphia Phillies,PHILS,1,5,3,8,1897,1902,5,No,0,9.88,14.87,4.99,647,845,198,2475,2785,310,1192.0,3296.0,2104.0,0.0,0.0,0.0
<a href=/player/taylj102>taylj102</a>,Jack Taylor,St. Louis Cardinals,CARDS,1,1,2,3,1898,1899,1,No,0,1.29,0.0,-1.29,50,0,-50,74,0,-74,541.0,0.0,-541.0,0.0,0.0,0.0
<a href=/player/taylj103>taylj103</a>,Joe Taylor,Cincinnati Reds,REDS,3,6,6,12,1957,1960,3,No,0,46.58,-0.35,-46.93,2142,12,-2130,7009,0,-7009,805.0,19.0,-786.0,0.0,0.0,0.0
<a href=/player/taylm001>taylm001</a>,Michael Taylor,Philadelphia Phillies,PHILS,1,3,2,5,2009,2013,4,No,0,-0.14,16.2,16.34,41,202,161,2,264,262,517.0,2108.0,1591.0,0.0,0.0,0.0
<a href=/player/taylm001>taylm001</a>,Michael Taylor,Toronto Blue Jays,BJAYS,3,3,3,6,2009,2019,10,No,0,-0.55,7.38,7.93,507,518,11,1794,1862,68,0.0,0.0,0.0,0.0,0.0,0.0
<a href=/player/taylm001>taylm001</a>,Michael Taylor,Oakland Athletics,ATLTCS,1,1,1,2,2014,2014,0,Yes,0,0.15,0.0,-0.15,11,0,-11,33,0,-33,0.0,0.0,0.0,0.0,0.0,0.0
<a href=/player/taylr001>taylr001</a>,Reggie Taylor,Philadelphia Phillies,PHILS,1,1,1,2,2002,2003,1,No,0,-0.16,-0.39,-0.23,235,87,-148,505,6,-499,0.0,173.0,173.0,0.0,0.0,0.0
<a href=/player/taylr001>taylr001</a>,Reggie Taylor,Colorado Rockies,ROCKS,1,1,1,2,2005,2005,0,No,0,-0.04,-0.31,-0.27,11,31,20,24,0,-24,0.0,35.0,35.0,0.0,0.0,0.0
<a href=/player/taylr101>taylr101</a>,Ron Taylor,Cleveland Indians,INDINS,2,5,2,7,1962,1968,6,No,0,3.21,3.85,0.64,600,709,109,441,2271,1830,1817.0,0.0,-1817.0,27000.0,0.0,-27000.0
<a href=/player/taylr101>taylr101</a>,Ron Taylor,St. Louis Cardinals,CARDS,10,18,16,34,1965,1976,11,No,0,25.61,13.65,-11.96,1956,974,-982,3292,632,-2660,6302.0,2494.0,-3808.0,0.0,0.0,0.0
<a href=/player/tayls002>tayls002</a>,Scott Taylor,Seattle Mariners,MARNRS,1,1,1,2,1990,1990,0,No,0,0.0,0.0,0.0,0,0,0,0,0,0,0.0,0.0,0.0,0.0,0.0,0.0
<a href=/player/tayls002>tayls002</a>,Scott Taylor,Milwaukee Brewers,BREWRS,1,1,1,2,1995,1996,1,No,0,-0.4,-1.45,-1.05,3,200,197,0,491,491,46.0,0.0,-46.0,0.0,0.0,0.0
<a href=/player/tayls102>tayls102</a>,Sammy Taylor,Milwaukee Braves,BRAVES,2,5,5,10,1957,1961,4,No,0,-0.24,3.65,3.89,692,187,-505,1842,252,-1590,561.0,791.0,230.0,0.0,0.0,0.0
<a href=/player/tayls102>tayls102</a>,Sammy Taylor,Chicago Cubs,CUBS,6,11,8,19,1962,1977,15,No,0,12.5,38.57,26.07,818,2457,1639,610,6362,5752,3515.0,5246.0,1731.0,122500.0,0.0,-122500.0
<a href=/player/tayls102>tayls102</a>,Sammy Taylor,New York Mets,METS,3,5,4,9,1963,1970,7,No,0,0.13,2.94,2.81,256,564,308,368,1104,736,516.0,1427.0,911.0,0.0,0.0,0.0
<a href=/player/tayls102>tayls102</a>,Sammy Taylor,Cincinnati Reds,REDS,1,1,1,2,1963,1963,0,No,0,0.12,-0.27,-0.39,4,15,11,10,32,22,0.0,0.0,0.0,0.0,0.0,0.0
<a href=/player/taylt101>taylt101</a>,Tony Taylor,Chicago Cubs,CUBS,17,29,28,57,1960,1982,22,No,0,71.82,137.22,65.4,4054,6789,2735,10993,16906,5913,10563.0,17980.0,7417.0,552500.0,0.0,-552500.0
<a href=/player/taylt101>taylt101</a>,Tony Taylor,Philadelphia Phillies,PHILS,1,1,2,3,1971,1971,0,No,0,3.07,0.0,-3.07,217,0,-217,745,0,-745,0.0,0.0,0.0,60000.0,0.0,-60000.0
<a href=/player/taylt102>taylt102</a>,Tommy Taylor,Memphis,Memphis,2,3,3,6,1924,1924,0,No,0,0.84,0.0,-0.84,204,0,-204,334,0,-334,684.0,0.0,-684.0,0.0,0.0,0.0
<a href=/player/taylt102>taylt102</a>,Tommy Taylor,Washington Senators,TWINS,4,11,5,16,1924,1941,17,No,0,16.54,44.06,27.52,920,1674,754,2170,6771,4601,3390.0,1035.0,-2355.0,27200.0,0.0,-27200.0
<a href=/player/taylw001>taylw001</a>,Wade Taylor,Seattle Mariners,MARNRS,4,7,6,13,1987,1995,8,No,0,7.57,0.25,-7.32,518,728,210,671,2089,1418,1950.0,271.0,-1679.0,982500.0,0.0,-982500.0
<a href=/player/taylz101>taylz101</a>,Zack Taylor,Brooklyn Dodgers,DOGRS,2,5,4,9,1925,1927,2,No,0,6.65,0.24,-6.41,787,339,-448,3022,1227,-1795,0.0,0.0,0.0,27500.0,0.0,-27500.0
<a href=/player/taylz101>taylz101</a>,Zack Taylor,Boston Braves,BRAVES,7,13,11,24,1927,1938,11,No,0,17.24,17.06,-0.18,1140,2433,1293,3084,9081,5997,3328.0,1364.0,-1964.0,42000.0,0.0,-42000.0
<a href=/player/teacb101>teacb101</a>,Bud Teachout,Chicago Cubs,CUBS,1,2,1,3,1931,1933,2,No,0,-0.02,-0.44,-0.42,2,94,92,0,73,73,3.0,633.0,630.0,33000.0,0.0,-33000.0
<a href=/player/teagt001>teagt001</a>,Taylor Teagarden,Texas Rangers,RNGRS,1,1,2,3,2011,2011,0,No,0,-0.52,0.0,0.52,45,0,-45,126,0,-126,0.0,0.0,0.0,0.0,0.0,0.0
<a href=/player/teahm001>teahm001</a>,Mark Teahen,Oakland Athletics,ATLTCS,1,2,1,3,2004,2005,1,No,0,4.64,1.22,-3.42,770,62,-708,2737,0,-2737,839.0,198.0,-641.0,0.0,0.0,0.0
<a href=/player/teahm001>teahm001</a>,Mark Teahen,Kansas City Royals,ROYALS,1,1,2,3,2009,2013,4,No,0,-1.63,1.37,3.0,128,345,217,392,1174,782,0.0,0.0,0.0,3575000.0,0.0,-3575000.0
<a href=/player/teahm001>teahm001</a>,Mark Teahen,Chicago White Sox,WSOX,4,6,7,13,2011,2016,5,Yes,0,-1.99,0.09,2.08,103,232,129,66,344,278,233.0,625.0,392.0,13500000.0,0.0,-13500000.0
<a href=/player/tebbb101>tebbb101</a>,Birdie Tebbetts,Detroit Tigers,TIGRS,1,1,1,2,1947,1948,1,No,0,3.02,0.99,-2.03,419,125,-294,1601,355,-1246,0.0,0.0,0.0,0.0,0.0,0.0
<a href=/player/teixm001>teixm001</a>,Mark Teixeira,Texas Rangers,RNGRS,8,20,28,48,2007,2021,14,Yes,0,23.19,61.95,38.76,1540,2663,1123,4320,8186,3866,2620.0,5087.0,2467.0,14431080.0,0.0,-14431080.0
<a href=/player/teixm001>teixm001</a>,Mark Teixeira,Atlanta Braves,BRAVES,2,2,3,5,2008,2009,1,No,0,3.87,2.69,-1.18,93,187,94,329,753,424,0.0,0.0,0.0,15385000.0,0.0,-15385000.0
<a href=/player/tejam001>tejam001</a>,Miguel Tejada,Baltimore Orioles,ORLS,2,2,7,9,2007,2014,7,No,0,3.91,11.78,7.87,332,910,578,1340,1971,631,22.0,1330.0,1308.0,13811415.0,0.0,-13811415.0
<a href=/player/tejam001>tejam001</a>,Miguel Tejada,Baltimore Orioles,ORLS,1,2,1,3,2010,2010,0,No,0,1.18,0.0,-1.18,59,0,-59,253,0,-253,0.0,0.0,0.0,6000000.0,0.0,-6000000.0
<a href=/player/tejaw001>tejaw001</a>,Wilfredo Tejada,Montreal Expos,NATEX,1,1,1,2,1988,1988,0,No,0,0.0,0.0,0.0,0,0,0,0,0,0,0.0,0.0,0.0,0.0,0.0,0.0
<a href=/player/tejer001>tejer001</a>,Rob Tejeda,Philadelphia Phillies,PHILS,3,6,5,11,2006,2015,9,No,2,-0.97,17.81,18.78,83,373,290,9,599,590,1042.0,2436.0,1394.0,0.0,0.0,0.0
<a href=/player/tekob001>tekob001</a>,Blake Tekotte,San Diego Padres,PADRS,1,1,1,2,2012,2012,0,No,0,-0.19,0.0,0.19,20,0,-20,36,0,-36,0.0,0.0,0.0,0.0,0.0,0.0
<a href=/player/tekuk001>tekuk001</a>,Kent Tekulve,Pittsburgh Pirates,PIRATS,5,9,11,20,1985,2001,16,No,2,16.4,23.37,6.97,1130,1731,601,785,2237,1452,3771.0,7235.0,3464.0,2120000.0,0.0,-2120000.0
<a href=/player/telit001>telit001</a>,Tomas Telis,Texas Rangers,RNGRS,2,4,2,6,2015,2017,2,Yes,0,2.24,2.95,0.71,421,128,-293,185,0,-185,487.0,355.0,-132.0,0.0,0.0,0.0
<a href=/player/tellr001>tellr001</a>,Rowdy Tellez,Toronto Blue Jays,BJAYS,1,1,2,3,2021,2021,0,Yes,0,0.23,0.58,0.35,56,34,-22,174,0,-174,0.0,98.0,98.0,0.0,0.0,0.0
<a href=/player/tellt001>tellt001</a>,Tom Tellmann,San Diego Padres,PADRS,1,1,2,3,1982,1982,0,No,0,4.1,0.0,-4.1,94,0,-94,0,0,0,542.0,0.0,-542.0,0.0,0.0,0.0
<a href=/player/tempg001>tempg001</a>,Garry Templeton,St. Louis Cardinals,CARDS,1,3,3,6,1981,1992,11,No,0,19.37,59.81,40.44,1893,1695,-198,5833,6828,995,883.0,553.0,-330.0,793333.0,0.0,-793333.0
<a href=/player/tempg001>tempg001</a>,Garry Templeton,San Diego Padres,PADRS,1,1,1,2,1991,1993,2,No,0,-1.06,2.4,3.46,80,294,214,234,873,639,0.0,0.0,0.0,530000.0,0.0,-530000.0
<a href=/player/tempj101>tempj101</a>,Johnny Temple,Cincinnati Reds,REDS,2,3,4,7,1959,1963,4,No,0,15.51,0.98,-14.53,676,413,-263,1467,1285,-182,3599.0,454.0,-3145.0,0.0,0.0,0.0
<a href=/player/tempj101>tempj101</a>,Johnny Temple,Cleveland Indians,INDINS,2,2,4,6,1961,1965,4,No,0,0.95,1.11,0.16,254,127,-127,658,440,-218,0.0,0.0,0.0,7500.0,0.0,-7500.0
<a href=/player/tenag101>tenag101</a>,Gene Tenace,San Diego Padres,PADRS,12,21,25,46,1980,1993,13,No,1,78.65,50.21,-28.44,3246,4423,1177,10088,11380,1292,4862.0,3507.0,-1355.0,3006667.0,0.0,-3006667.0
<a href=/player/tennf102>tennf102</a>,Fred Tenney,Boston Braves,BRAVES,2,4,6,10,1907,1911,4,No,0,19.52,11.83,-7.69,821,855,34,3252,2714,-538,0.0,1733.0,1733.0,0.0,0.0,0.0
<a href=/player/tepef101>tepef101</a>,Frank Tepedino,New York Yankees,YANKS,16,31,27,58,1971,2001,30,No,1,121.02,35.99,-85.03,6582,2374,-4208,14853,5748,-9105,21228.0,6192.0,-15036.0,4415000.0,0.0,-4415000.0
<a href=/player/tepef101>tepef101</a>,Frank Tepedino,New York Yankees,YANKS,6,12,9,21,1973,1983,10,No,0,29.7,21.37,-8.33,2028,936,-1092,2549,2957,408,5698.0,1893.0,-3805.0,79000.0,0.0,-79000.0
<a href=/player/teper001>teper001</a>,Ryan Tepera,Chicago Cubs,CUBS,1,1,1,2,2021,2021,0,Yes,0,0.63,0.0,-0.63,25,0,-25,0,0,0,54.0,0.0,-54.0,800000.0,0.0,-800000.0
<a href=/player/terlg101>terlg101</a>,Greg Terlecky,St. Louis Cardinals,CARDS,1,2,1,3,1975,1976,1,No,0,0.63,-0.55,-1.18,80,66,-14,258,97,-161,0.0,0.0,0.0,0.0,0.0,0.0
<a href=/player/terpj101>terpj101</a>,Jeff Terpko,Washington Senators,RNGRS,8,16,13,29,1970,1982,12,No,0,21.36,8.18,-13.18,1080,728,-352,2708,1819,-889,4391.0,989.0,-3402.0,326500.0,0.0,-326500.0
<a href=/player/terpj101>terpj101</a>,Jeff Terpko,Philadelphia Phillies,PHILS,1,2,3,5,1970,1977,7,No,0,1.17,0.0,-1.17,48,0,-48,40,0,-40,179.0,0.0,-179.0,0.0,0.0,0.0
<a href=/player/terpj101>terpj101</a>,Jeff Terpko,Texas Rangers,RNGRS,7,13,11,24,1977,1982,5,No,0,21.36,6.59,-14.77,1080,693,-387,2708,1819,-889,4391.0,810.0,-3581.0,313000.0,0.0,-313000.0
<a href=/player/terra101>terra101</a>,Adonis Terry,Baltimore Orioles,BLN,1,1,1,2,1892,1892,0,No,0,5.48,0.38,-5.1,115,75,-40,185,302,117,1232.0,0.0,-1232.0,0.0,0.0,0.0
<a href=/player/terrr101>terrr101</a>,Ralph Terry,New York Yankees,YANKS,3,9,7,16,1957,1962,5,No,0,10.27,3.25,-7.02,1508,714,-794,3698,610,-3088,2854.0,1762.0,-1092.0,12500.0,0.0,-12500.0
<a href=/player/terrr101>terrr101</a>,Ralph Terry,Kansas City Athletics,ATLTCS,17,36,31,67,1959,1976,17,No,0,68.33,55.7,-12.63,8021,5164,-2857,18125,17078,-1047,14086.0,3207.0,-10879.0,387100.0,0.0,-387100.0
<a href=/player/terrr101>terrr101</a>,Ralph Terry,New York Yankees,YANKS,2,4,3,7,1964,1966,2,No,0,1.12,2.59,1.47,72,260,188,65,33,-32,521.0,611.0,90.0,84000.0,0.0,-84000.0
<a href=/player/terrr101>terrr101</a>,Ralph Terry,Cleveland Indians,INDINS,4,5,7,12,1966,1969,3,No,0,-0.01,3.11,3.12,516,278,-238,84,92,8,1577.0,1093.0,-484.0,75600.0,0.0,-75600.0
<a href=/player/terrs001>terrs001</a>,Scott Terry,Cincinnati Reds,REDS,2,3,2,5,1987,1988,1,No,0,5.7,-0.03,-5.73,528,69,-459,113,58,-55,1552.0,108.0,-1444.0,132500.0,0.0,-132500.0
<a href=/player/terrw001>terrw001</a>,Walt Terrell,Texas Rangers,RNGRS,2,3,2,5,1982,1984,2,No,0,21.02,0.29,-20.73,680,235,-445,875,838,-37,5969.0,0.0,-5969.0,400000.0,0.0,-400000.0
<a href=/player/terrw001>terrw001</a>,Walt Terrell,New York Mets,METS,2,2,2,4,1984,1993,9,No,1,7.72,22.03,14.31,218,1154,936,0,4591,4591,3984.0,0.0,-3984.0,111000.0,0.0,-111000.0
<a href=/player/terrw001>terrw001</a>,Walt Terrell,Detroit Tigers,TIGRS,2,2,3,5,1988,1990,2,No,0,0.12,1.07,0.95,71,125,54,155,406,251,370.0,283.0,-87.0,2148333.0,0.0,-2148333.0
<a href=/player/terrw001>terrw001</a>,Walt Terrell,San Diego Padres,PADRS,1,2,2,4,1989,1990,1,No,0,-0.36,-0.39,-0.03,13,192,179,0,619,619,249.0,73.0,-176.0,775000.0,0.0,-775000.0
<a href=/player/terww101>terww101</a>,Wayne Terwilliger,Chicago Cubs,CUBS,9,26,24,50,1951,1965,14,No,0,14.31,21.74,7.43,2452,2862,410,6527,5620,-907,3090.0,5461.0,2371.0,143500.0,0.0,-143500.0
<a href=/player/terww101>terww101</a>,Wayne Terwilliger,San Francisco Giants,GIANTS,1,1,1,2,1957,1957,0,No,0,0.0,0.0,0.0,0,0,0,0,0,0,0.0,0.0,0.0,0.0,0.0,0.0
<a href=/player/tessj001>tessj001</a>,Jay Tessmer,New York Yankees,YANKS,2,3,2,5,2001,2001,0,No,0,0.68,0.25,-0.43,79,11,-68,1,0,-1,146.0,32.0,-114.0,0.0,0.0,0.0
<a href=/player/tettd101>tettd101</a>,Dick Tettelbach,New York Yankees,YANKS,7,20,15,35,1956,1970,14,No,0,3.04,33.17,30.13,2442,2492,50,6615,5619,-996,2999.0,5239.0,2240.0,115500.0,0.0,-115500.0
<a href=/player/tettd101>tettd101</a>,Dick Tettelbach,Washington Senators,TWINS,1,2,1,3,1957,1957,0,No,0,0.92,-0.4,-1.32,46,96,50,9,331,322,120.0,0.0,-120.0,8000.0,0.0,-8000.0
<a href=/player/tettm001>tettm001</a>,Mickey Tettleton,Baltimore Orioles,ORLS,1,1,1,2,1991,1991,0,No,0,14.83,-0.4,-15.23,570,21,-549,2343,0,-2343,0.0,313.0,313.0,0.0,0.0,0.0
<a href=/player/teuft001>teuft001</a>,Tim Teufel,Minnesota Twins,TWINS,5,6,7,13,1986,1989,3,No,0,8.22,-2.13,-10.35,574,122,-452,1466,209,-1257,305.0,169.0,-136.0,0.0,0.0,0.0
<a href=/player/teuft001>teuft001</a>,Tim Teufel,New York Mets,METS,1,1,1,2,1991,1991,0,No,0,2.4,-1.06,-3.46,294,80,-214,873,234,-639,0.0,0.0,0.0,637500.0,0.0,-637500.0
<a href=/player/teutn001>teutn001</a>,Nate Teut,Chicago Cubs,CUBS,1,1,1,2,2001,2002,1,No,0,-0.36,-0.46,-0.1,4,16,12,2,1,-1,22.0,25.0,3.0,0.0,0.0,0.0
<a href=/player/tewkb001>tewkb001</a>,Bob Tewksbury,New York Yankees,YANKS,6,14,8,22,1987,2001,14,No,1,22.68,17.2,-5.48,1957,1291,-666,5757,3988,-1769,3742.0,1690.0,-2052.0,2485000.0,0.0,-2485000.0
<a href=/player/texek001>texek001</a>,Kanekoa Texeira,Chicago White Sox,WSOX,1,2,3,5,2008,2011,3,No,0,11.97,-0.72,-12.69,599,28,-571,2501,50,-2451,3.0,20.0,17.0,3600000.0,0.0,-3600000.0
<a href=/player/thacm101>thacm101</a>,Moe Thacker,Chicago Cubs,CUBS,16,27,26,53,1962,1982,20,No,0,54.43,129.03,74.6,2307,6354,4047,4353,15923,11570,10563.0,16087.0,5524.0,552500.0,0.0,-552500.0
<a href=/player/thame001>thame001</a>,Eric Thames,Toronto Blue Jays,BJAYS,1,1,1,2,2012,2016,4,No,0,0.0,0.53,0.53,40,150,110,130,0,-130,0.0,429.0,429.0,485900.0,0.0,-485900.0
<a href=/player/thame001>thame001</a>,Eric Thames,Seattle Mariners,MARNRS,2,2,2,4,2013,2017,4,No,0,0.0,0.24,0.24,0,14,14,0,5,5,0.0,187.0,187.0,0.0,0.0,0.0
<a href=/player/thamm001>thamm001</a>,Marcus Thames,New York Yankees,YANKS,1,1,1,2,2003,2005,2,No,0,-0.44,-0.52,-0.08,30,231,201,84,708,624,0.0,0.0,0.0,0.0,0.0,0.0
<a href=/player/thatj001>thatj001</a>,Joe Thatcher,Milwaukee Brewers,BREWRS,2,4,2,6,2007,2007,0,No,1,2.56,0.04,-2.52,559,54,-505,1,1,0,595.0,76.0,-519.0,0.0,0.0,0.0
<a href=/player/thatj001>thatj001</a>,Joe Thatcher,San Diego Padres,PADRS,1,2,1,3,2013,2015,2,No,0,-1.32,1.52,2.84,205,142,-63,0,131,131,225.0,1280.0,1055.0,0.0,0.0,0.0
<a href=/player/thatj001>thatj001</a>,Joe Thatcher,Arizona Diamondbacks,DBACKS,1,2,2,4,2014,2019,5,Yes,0,-0.49,0.11,0.6,34,4,-30,15,0,-15,19.0,9.0,-10.0,2884500.0,0.0,-2884500.0
<a href=/player/thayd001>thayd001</a>,Dale Thayer,San Diego Padres,PADRS,1,2,1,3,2006,2007,1,No,0,-0.26,0.94,1.2,13,88,75,1,235,234,47.0,0.0,-47.0,0.0,0.0,0.0
<a href=/player/theor101>theor101</a>,Ron Theobald,Washington Senators,RNGRS,1,2,1,3,1970,1970,0,No,0,4.46,0.11,-4.35,279,77,-202,994,154,-840,0.0,0.0,0.0,19000.0,0.0,-19000.0
<a href=/player/therr001>therr001</a>,Ryan Theriot,Chicago Cubs,CUBS,1,3,3,6,2010,2012,2,No,0,3.28,-0.26,-3.54,168,192,24,342,477,135,1023.0,0.0,-1023.0,15600000.0,0.0,-15600000.0
<a href=/player/therr001>therr001</a>,Ryan Theriot,Los Angeles Dodgers,DOGRS,1,1,1,2,2010,2012,2,No,0,0.34,-0.37,-0.71,132,96,-36,483,1,-482,0.0,159.0,159.0,0.0,0.0,0.0
<a href=/player/thevt101>thevt101</a>,Tommy Thevenow,St. Louis Cardinals,CARDS,1,1,2,3,1928,1928,0,No,0,-5.14,0.0,5.14,246,0,-246,978,0,-978,0.0,0.0,0.0,6000.0,0.0,-6000.0
<a href=/player/thevt101>thevt101</a>,Tommy Thevenow,Philadelphia Phillies,PHILS,2,3,6,9,1930,1936,6,No,0,25.37,8.0,-17.37,1352,958,-394,5364,4215,-1149,77.0,0.0,-77.0,24000.0,0.0,-24000.0
<a href=/player/thevt101>thevt101</a>,Tommy Thevenow,New York Giants,GIANTS,1,1,1,2,1937,1937,0,No,0,-0.06,0.0,0.06,21,0,-21,39,0,-39,0.0,0.0,0.0,0.0,0.0,0.0
<a href=/player/thiej102>thiej102</a>,Jake Thielman,Cleveland Indians,INDINS,2,3,2,5,1908,1914,6,No,0,-0.3,-1.58,-1.28,2,95,93,0,309,309,2.0,0.0,-2.0,0.0,0.0,0.0
<a href=/player/thigb001>thigb001</a>,Bobby Thigpen,Chicago White Sox,WSOX,2,2,2,4,1993,1995,2,No,0,-0.39,1.47,1.86,48,101,53,3,0,-3,83.0,464.0,381.0,4121667.0,0.0,-4121667.0
<a href=/player/thobj001>thobj001</a>,J.J. Thobe,Cleveland Indians,INDINS,2,4,2,6,1994,1994,0,No,0,-0.31,-0.66,-0.35,27,19,-8,0,0,0,177.0,71.0,-106.0,1850000.0,0.0,-1850000.0
<a href=/player/tholj001>tholj001</a>,Josh Thole,New York Mets,METS,5,10,9,19,2012,2021,9,Yes,0,5.89,21.61,15.72,446,1069,623,898,3007,2109,2473.0,2300.0,-173.0,18229800.0,0.0,-18229800.0
<a href=/player/thoma003>thoma003</a>,Aaron Thompson,Florida Marlins,MARLNS,1,1,1,2,2009,2009,0,No,0,0.0,0.35,0.35,0,35,35,0,150,150,0.0,0.0,0.0,0.0,0.0,0.0
<a href=/player/thomb105>thomb105</a>,Bobby Thomson,New York Giants,GIANTS,15,30,31,61,1954,1968,14,No,0,48.23,65.72,17.49,4661,4032,-629,15306,7933,-7373,2020.0,13164.0,11144.0,128000.0,0.0,-128000.0
<a href=/player/thomb105>thomb105</a>,Bobby Thomson,Milwaukee Braves,BRAVES,1,3,1,4,1957,1960,3,No,0,3.25,5.66,2.41,395,272,-123,1122,1140,18,434.0,0.0,-434.0,0.0,0.0,0.0
<a href=/player/thomb105>thomb105</a>,Bobby Thomson,San Francisco Giants,GIANTS,1,1,2,3,1958,1958,0,No,0,4.43,0.19,-4.24,274,66,-208,1032,84,-948,0.0,0.0,0.0,0.0,0.0,0.0
<a href=/player/thomb105>thomb105</a>,Bobby Thomson,Chicago Cubs,CUBS,1,1,1,2,1959,1961,2,No,0,0.73,-0.19,-0.92,40,4,-36,127,1,-126,0.0,8.0,8.0,0.0,0.0,0.0
<a href=/player/thomc001>thomc001</a>,Charles Thomas,Atlanta Braves,BRAVES,1,3,1,4,2004,2013,9,No,0,-3.0,25.61,28.61,78,476,398,55,578,523,230.0,4719.0,4489.0,370000.0,0.0,-370000.0
<a href=/player/thomc001>thomc001</a>,Charles Thomas,Oakland Athletics,ATLTCS,1,1,1,2,2007,2007,0,No,0,0.0,0.0,0.0,0,0,0,0,0,0,0.0,0.0,0.0,0.0,0.0,0.0
<a href=/player/thomd001>thomd001</a>,Derrel Thomas,Houston Astros,ASTROS,7,14,10,24,1971,1989,18,No,0,9.86,19.8,9.94,2403,1970,-433,5583,4832,-751,5444.0,4390.0,-1054.0,22500.0,0.0,-22500.0
<a href=/player/thomd001>thomd001</a>,Derrel Thomas,San Diego Padres,PADRS,3,4,5,9,1974,1982,8,No,0,3.97,1.27,-2.7,511,929,418,1498,1651,153,340.0,1465.0,1125.0,0.0,0.0,0.0
<a href=/player/thomd001>thomd001</a>,Derrel Thomas,San Francisco Giants,GIANTS,9,11,16,27,1978,1998,20,No,0,9.76,25.98,16.22,738,2478,1740,1752,8190,6438,1958.0,443.0,-1515.0,7402778.0,0.0,-7402778.0
<a href=/player/thomd003>thomd003</a>,Daryl Thompson,Washington Nationals,NATEX,1,5,3,8,2006,2009,3,No,0,-0.61,0.43,1.04,705,795,90,181,2860,2679,809.0,139.0,-670.0,1352000.0,0.0,-1352000.0
<a href=/player/thomd102>thomd102</a>,Don Thompson,Boston Braves,BRAVES,4,14,5,19,1949,1960,11,No,0,7.36,21.56,14.2,1117,1270,153,2487,5255,2768,2162.0,0.0,-2162.0,6600.0,0.0,-6600.0
<a href=/player/thomd103>thomd103</a>,Danny Thompson,Minnesota Twins,TWINS,10,17,22,39,1976,1995,19,No,3,25.7,52.26,26.56,1493,3238,1745,3699,9266,5567,4606.0,5223.0,617.0,2325000.0,0.0,-2325000.0
<a href=/player/thomf102>thomf102</a>,Fred Thomas,Cleveland Indians,INDINS,1,3,1,4,1916,1927,11,No,0,11.98,74.79,62.81,369,1519,1150,563,6634,6071,3136.0,0.0,-3136.0,0.0,0.0,0.0
<a href=/player/thomf102>thomf102</a>,Fred Thomas,Washington Senators,TWINS,2,3,2,5,1920,1924,4,No,0,4.25,3.02,-1.23,196,364,168,615,1337,722,26.0,0.0,-26.0,0.0,0.0,0.0
<a href=/player/thomf103>thomf103</a>,Frank Thomas,Pittsburgh Pirates,PIRATS,9,16,18,34,1959,1973,14,No,0,-0.94,37.67,38.61,564,1623,1059,1204,4862,3658,386.0,2327.0,1941.0,17500.0,0.0,-17500.0
<a href=/player/thomf103>thomf103</a>,Frank Thomas,Cincinnati Reds,REDS,3,4,7,11,1959,1965,6,No,0,25.72,11.28,-14.44,1639,857,-782,5251,1135,-4116,272.0,935.0,663.0,0.0,0.0,0.0
<a href=/player/thomf103>thomf103</a>,Frank Thomas,Chicago Cubs,CUBS,2,2,3,5,1961,1961,0,No,0,2.63,-0.43,-3.06,139,23,-116,500,42,-458,0.0,0.0,0.0,0.0,0.0,0.0
<a href=/player/thomf103>thomf103</a>,Frank Thomas,Milwaukee Braves,BRAVES,1,2,2,4,1961,1964,3,No,0,3.7,0.59,-3.11,377,85,-292,1356,234,-1122,0.0,0.0,0.0,0.0,0.0,0.0
<a href=/player/thomf103>thomf103</a>,Frank Thomas,New York Mets,METS,3,5,6,11,1964,1966,2,No,0,1.26,-0.39,-1.65,104,131,27,259,161,-98,71.0,326.0,255.0,0.0,0.0,0.0
<a href=/player/thomf103>thomf103</a>,Frank Thomas,Houston Astros,ASTROS,2,4,2,6,1965,1968,3,No,0,0.18,0.0,-0.18,376,0,-376,1109,0,-1109,0.0,0.0,0.0,0.0,0.0,0.0
<a href=/player/thomf105>thomf105</a>,Fay Thomas,St.Louis Browns,ORLS,1,1,1,2,1935,1936,1,No,0,0.0,-0.2,-0.2,0,18,18,0,2,2,0.0,58.0,58.0,4000.0,0.0,-4000.0
<a href=/player/thomf106>thomf106</a>,Fresco Thompson,New York Giants,GIANTS,6,15,10,25,1927,1949,22,No,0,30.29,66.01,35.72,2286,3209,923,6995,11614,4619,4737.0,1177.0,-3560.0,10500.0,0.0,-10500.0
<a href=/player/thomf106>thomf106</a>,Fresco Thompson,Philadelphia Phillies,PHILS,5,12,10,22,1930,1941,11,No,0,17.23,29.97,12.74,1414,1700,286,5405,4168,-1237,324.0,4825.0,4501.0,17000.0,0.0,-17000.0
<a href=/player/thomf106>thomf106</a>,Fresco Thompson,Omaha,Omaha,1,1,2,3,1924,1924,0,No,0,-0.02,0.0,0.02,14,0,-14,41,0,-41,0.0,0.0,0.0,0.0,0.0,0.0
<a href=/player/thomg001>thomg001</a>,Gorman Thomas,Milwaukee Brewers,BREWRS,1,1,1,2,1977,1978,1,No,0,0.0,0.16,0.16,0,29,29,0,88,88,0.0,0.0,0.0,0.0,0.0,0.0
<a href=/player/thomg001>thomg001</a>,Gorman Thomas,Milwaukee Brewers,BREWRS,1,3,2,5,1983,1987,4,No,0,7.32,0.25,-7.07,394,574,180,437,1374,937,1362.0,450.0,-912.0,600000.0,0.0,-600000.0
<a href=/player/thomg001>thomg001</a>,Gorman Thomas,Cleveland Indians,INDINS,3,4,4,8,1983,1989,6,No,0,6.14,3.15,-2.99,575,539,-36,2408,2048,-360,0.0,224.0,224.0,630000.0,0.0,-630000.0
<a href=/player/thomg101>thomg101</a>,Gary Thomasson,San Francisco Giants,GIANTS,4,14,8,22,1978,1992,14,No,0,8.18,23.62,15.44,767,1277,510,1656,1600,-56,2714.0,7759.0,5045.0,0.0,0.0,0.0
<a href=/player/thomg101>thomg101</a>,Gary Thomasson,Oakland Athletics,ATLTCS,1,1,3,4,1978,1982,4,No,0,0.98,-2.09,-3.07,54,227,173,130,698,568,0.0,0.0,0.0,0.0,0.0,0.0
<a href=/player/thomg101>thomg101</a>,Gary Thomasson,New York Yankees,YANKS,7,12,12,24,1979,1992,13,No,0,8.38,13.81,5.43,1369,688,-681,2988,2039,-949,2564.0,669.0,-1895.0,913333.0,0.0,-913333.0
<a href=/player/thomg102>thomg102</a>,George Thomas,Los Angeles Angels,ANGELS,5,8,8,16,1963,1968,5,No,0,-0.19,2.29,2.48,637,490,-147,1176,840,-336,443.0,1488.0,1045.0,44000.0,0.0,-44000.0
<a href=/player/thomg102>thomg102</a>,George Thomas,Detroit Tigers,TIGRS,1,3,1,4,1965,1967,2,No,0,0.26,-0.68,-0.94,350,64,-286,935,31,-904,0.0,314.0,314.0,32800.0,0.0,-32800.0
<a href=/player/thomh102>thomh102</a>,Herb Thomas,Boston Braves,BRAVES,7,13,11,24,1927,1938,11,No,0,17.24,17.06,-0.18,1140,2433,1293,3084,9081,5997,3328.0,1364.0,-1964.0,42000.0,0.0,-42000.0
<a href=/player/thomh104>thomh104</a>,Harry Thompson,Washington Senators,TWINS,1,1,1,2,1919,1919,0,No,0,-0.24,-0.87,-0.63,8,24,16,6,84,78,36.0,0.0,-36.0,0.0,0.0,0.0
<a href=/player/thomi001>thomi001</a>,Ian Thomas,Atlanta Braves,BRAVES,6,15,9,24,2015,2021,6,Yes,0,3.56,2.51,-1.05,557,291,-266,805,489,-316,986.0,676.0,-310.0,21307500.0,0.0,-21307500.0
<a href=/player/thomj001>thomj001</a>,Jason Thompson,Detroit Tigers,TIGRS,1,1,1,2,1980,1982,2,No,0,3.58,1.49,-2.09,102,193,91,387,736,349,0.0,0.0,0.0,0.0,0.0,0.0
<a href=/player/thomj001>thomj001</a>,Jason Thompson,California Angels,ANGELS,1,1,2,3,1981,1983,2,No,0,9.75,0.89,-8.86,671,87,-584,2696,282,-2414,0.0,43.0,43.0,0.0,0.0,0.0
<a href=/player/thomj001>thomj001</a>,Jason Thompson,Pittsburgh Pirates,PIRATS,1,1,2,3,1986,1986,0,No,0,-0.23,0.0,0.23,30,0,-30,69,0,-69,0.0,0.0,0.0,0.0,0.0,0.0
<a href=/player/thomj002>thomj002</a>,Jim Thome,Philadelphia Phillies,PHILS,6,11,9,20,2005,2011,6,No,2,29.38,11.98,-17.4,1045,531,-514,2960,1385,-1575,4221.0,945.0,-3276.0,13966667.0,0.0,-13966667.0
<a href=/player/thomj002>thomj002</a>,Jim Thome,Chicago White Sox,WSOX,1,2,1,3,2009,2009,0,No,0,0.0,0.0,0.0,17,0,-17,17,0,-17,0.0,0.0,0.0,13000000.0,0.0,-13000000.0
<a href=/player/thomj002>thomj002</a>,Jim Thome,Philadelphia Phillies,PHILS,1,1,2,3,2012,2012,0,No,0,0.0,0.0,0.0,28,0,-28,115,0,-115,0.0,0.0,0.0,1250000.0,0.0,-1250000.0
<a href=/player/thomj003>thomj003</a>,Justin Thompson,Detroit Tigers,TIGRS,3,8,6,14,1999,2006,7,No,2,20.76,5.57,-15.19,1380,450,-930,3548,496,-3052,1196.0,1028.0,-168.0,1937500.0,0.0,-1937500.0
<a href=/player/thomj005>thomj005</a>,John Thomson,Colorado Rockies,ROCKS,1,2,3,5,2002,2003,1,No,0,-0.58,3.78,4.36,21,232,211,25,840,815,163.0,36.0,-127.0,1350000.0,0.0,-1350000.0
<a href=/player/thomj007>thomj007</a>,Jake Thompson,Detroit Tigers,TIGRS,2,3,2,5,2014,2021,7,No,0,0.73,1.99,1.26,58,412,354,0,1195,1195,80.0,156.0,76.0,7000000.0,0.0,-7000000.0
<a href=/player/thomj007>thomj007</a>,Jake Thompson,Texas Rangers,RNGRS,5,14,16,30,2015,2021,6,Yes,0,11.03,13.28,2.25,790,293,-497,1664,16,-1648,2536.0,2164.0,-372.0,3762500.0,0.0,-3762500.0
<a href=/player/thomk101>thomk101</a>,Kite Thomas,Washington Senators,TWINS,1,1,1,2,1954,1954,0,No,0,0.0,0.35,0.35,0,76,76,0,192,192,0.0,0.0,0.0,0.0,0.0,0.0
<a href=/player/thoml001>thoml001</a>,Larry Thomas,Chicago White Sox,WSOX,1,2,1,3,1997,1998,1,No,0,0.48,0.0,-0.48,32,0,-32,0,0,0,174.0,0.0,-174.0,157500.0,0.0,-157500.0
<a href=/player/thoml002>thoml002</a>,Lane Thomas,Toronto Blue Jays,BJAYS,1,1,1,2,2017,2017,0,No,0,-0.02,0.0,0.02,84,0,-84,142,0,-142,0.0,0.0,0.0,0.0,0.0,0.0
<a href=/player/thoml002>thoml002</a>,Lane Thomas,St. Louis Cardinals,CARDS,1,1,1,2,2021,2021,0,No,0,1.31,0.07,-1.24,45,23,-22,206,22,-184,0.0,198.0,198.0,0.0,0.0,0.0
<a href=/player/thoml102>thoml102</a>,Leo Thomas,St.Louis Browns,ORLS,11,21,24,45,1950,1960,10,No,0,30.8,26.53,-4.27,2470,2935,465,5868,7663,1795,6528.0,5672.0,-856.0,55500.0,0.0,-55500.0
<a href=/player/thoml102>thoml102</a>,Leo Thomas,Portland,Portland,1,1,3,4,1951,1951,0,No,0,-0.01,0.0,0.01,41,0,-41,146,0,-146,0.0,0.0,0.0,0.0,0.0,0.0
<a href=/player/thoml102>thoml102</a>,Leo Thomas,St.Louis Browns,ORLS,1,2,2,4,1952,1952,0,No,0,0.64,0.34,-0.3,156,55,-101,332,173,-159,0.0,0.0,0.0,0.0,0.0,0.0
<a href=/player/thoml103>thoml103</a>,Lee Thomas,New York Yankees,YANKS,1,3,2,5,1961,1962,1,No,0,3.35,0.73,-2.62,729,113,-616,2005,155,-1850,725.0,95.0,-630.0,0.0,0.0,0.0
<a href=/player/thoml103>thoml103</a>,Lee Thomas,Los Angeles Angels,ANGELS,1,1,1,2,1964,1965,1,No,0,2.14,-0.36,-2.5,258,180,-78,1045,593,-452,0.0,0.0,0.0,0.0,0.0,0.0
<a href=/player/thoml103>thoml103</a>,Lee Thomas,Boston Red Sox,RSOX,1,3,2,5,1965,1968,3,No,0,0.78,1.64,0.86,187,156,-31,154,15,-139,353.0,393.0,40.0,12500.0,0.0,-12500.0
<a href=/player/thoml103>thoml103</a>,Lee Thomas,Atlanta Braves,BRAVES,1,1,1,2,1966,1966,0,No,0,-1.51,-0.11,1.4,152,76,-76,379,9,-370,0.0,196.0,196.0,0.0,0.0,0.0
<a href=/player/thoml103>thoml103</a>,Lee Thomas,Chicago Cubs,CUBS,1,1,2,3,1968,1968,0,No,0,-1.85,0.0,1.85,90,0,-90,221,0,-221,0.0,0.0,0.0,0.0,0.0,0.0
<a href=/player/thomm001>thomm001</a>,Milt Thompson,Atlanta Braves,BRAVES,2,3,3,6,1985,1994,9,No,0,11.78,9.36,-2.42,1062,684,-378,2024,1673,-351,1256.0,1991.0,735.0,1575000.0,0.0,-1575000.0
<a href=/player/thomm001>thomm001</a>,Milt Thompson,Philadelphia Phillies,PHILS,1,1,2,3,1988,1991,3,No,0,10.67,-1.11,-11.78,514,275,-239,1641,597,-1044,0.0,0.0,0.0,240000.0,0.0,-240000.0
<a href=/player/thomm001>thomm001</a>,Milt Thompson,Philadelphia Phillies,PHILS,1,1,1,2,1994,1994,0,No,0,0.12,0.14,0.02,101,6,-95,172,0,-172,0.0,12.0,12.0,1375000.0,0.0,-1375000.0
<a href=/player/thomm003>thomm003</a>,Mike Thomas,New York Mets,METS,2,3,2,5,1991,1992,1,No,0,-0.46,-0.67,-0.21,29,186,157,7,7,0,134.0,344.0,210.0,4233334.0,0.0,-4233334.0
<a href=/player/thomm005>thomm005</a>,Mason Thompson,San Diego Padres,PADRS,1,2,1,3,2021,2021,0,No,0,-0.22,-0.24,-0.02,54,45,-9,0,0,0,65.0,57.0,-8.0,0.0,0.0,0.0
<a href=/player/thomm101>thomm101</a>,Myles Thomas,Toronto,Toronto,1,1,1,2,1925,1925,0,No,0,-1.0,0.0,1.0,143,0,-143,97,0,-97,827.0,0.0,-827.0,0.0,0.0,0.0
<a href=/player/thomm101>thomm101</a>,Myles Thomas,New York Yankees,YANKS,2,5,3,8,1932,1940,8,No,0,1.79,6.34,4.55,337,462,125,641,986,345,1980.0,2260.0,280.0,0.0,0.0,0.0
<a href=/player/thomm102>thomm102</a>,Mike Thompson,Texas Rangers,RNGRS,5,9,7,16,1973,1978,5,No,0,27.38,17.18,-10.2,597,193,-404,206,0,-206,7753.0,3742.0,-4011.0,60000.0,0.0,-60000.0
<a href=/player/thomm102>thomm102</a>,Mike Thompson,Atlanta Braves,BRAVES,1,1,1,2,1976,1976,0,No,0,0.0,0.0,0.0,0,7,7,0,7,7,0.0,0.0,0.0,0.0,0.0,0.0
<a href=/player/thomm102>thomm102</a>,Mike Thompson,Cincinnati Reds,REDS,1,1,1,2,1976,1976,0,No,0,0.0,0.0,0.0,0,0,0,0,0,0,0.0,0.0,0.0,0.0,0.0,0.0
<a href=/player/thomp101>thomp101</a>,Pinch Thomas,Boston Red Sox,RSOX,22,48,61,109,1917,1937,20,No,0,205.66,131.1,-74.56,9653,6423,-3230,27902,20755,-7147,27230.0,14799.0,-12431.0,136800.0,0.0,-136800.0
<a href=/player/thomr001>thomr001</a>,Roy Thomas,Philadelphia Phillies,PHILS,1,3,2,5,1975,1979,4,No,0,0.71,0.93,0.22,442,215,-227,1620,199,-1421,0.0,1610.0,1610.0,0.0,0.0,0.0
<a href=/player/thomr001>thomr001</a>,Roy Thomas,Seattle Mariners,MARNRS,2,3,3,6,1977,1986,9,No,0,0.93,-0.1,-1.03,116,416,300,284,1201,917,19.0,0.0,-19.0,0.0,0.0,0.0
<a href=/player/thomr001>thomr001</a>,Roy Thomas,Oakland Athletics,ATLTCS,4,7,6,13,1981,1985,4,No,0,8.77,6.3,-2.47,225,81,-144,0,4,4,2629.0,1218.0,-1411.0,600000.0,0.0,-600000.0
<a href=/player/thomr002>thomr002</a>,Rich Thompson,Cleveland Indians,INDINS,1,1,1,2,1985,1985,0,No,0,0.0,0.0,0.0,0,0,0,0,0,0,0.0,0.0,0.0,0.0,0.0,0.0
<a href=/player/thomr004>thomr004</a>,Ryan Thompson,Toronto Blue Jays,BJAYS,4,7,7,14,1992,1997,5,No,2,31.44,9.8,-21.64,988,69,-919,3245,0,-3245,2766.0,1237.0,-1529.0,8109000.0,0.0,-8109000.0
<a href=/player/thomr004>thomr004</a>,Ryan Thompson,New York Mets,METS,8,17,14,31,1996,2005,9,No,0,5.29,6.22,0.93,1355,2056,701,1632,3118,1486,2422.0,2738.0,316.0,19588333.0,0.0,-19588333.0
<a href=/player/thomr004>thomr004</a>,Ryan Thompson,Cleveland Indians,INDINS,1,1,1,2,1997,1998,1,No,0,0.0,-0.29,-0.29,0,31,31,0,70,70,0.0,0.0,0.0,0.0,0.0,0.0
<a href=/player/thomr005>thomr005</a>,Rich Thompson,Toronto Blue Jays,BJAYS,1,1,1,2,2003,2003,0,No,0,0.0,-0.6,-0.6,0,3,3,0,0,0,0.0,15.0,15.0,0.0,0.0,0.0
<a href=/player/thomr005>thomr005</a>,Rich Thompson,San Diego Padres,PADRS,1,1,2,3,2003,2004,1,No,0,0.05,-0.25,-0.3,6,14,8,1,1,0,0.0,30.0,30.0,0.0,0.0,0.0
<a href=/player/thomr005>thomr005</a>,Rich Thompson,Philadelphia Phillies,PHILS,1,1,1,2,2012,2012,0,No,0,-0.52,0.0,0.52,23,0,-23,24,0,-24,0.0,0.0,0.0,0.0,0.0,0.0
<a href=/player/thoms001>thoms001</a>,Scot Thompson,San Francisco Giants,GIANTS,1,2,1,3,1985,1986,1,No,0,-1.74,-0.39,1.35,56,69,13,46,222,176,103.0,0.0,-103.0,552000.0,0.0,-552000.0
<a href=/player/thoms102>thoms102</a>,Stan Thomas,Texas Rangers,RNGRS,1,2,1,3,1975,1982,7,No,0,2.82,-1.21,-4.03,325,301,-24,802,863,61,317.0,0.0,-317.0,0.0,0.0,0.0
<a href=/player/thoms102>thoms102</a>,Stan Thomas,New York Yankees,YANKS,23,56,45,101,1977,2001,24,No,2,75.35,66.74,-8.61,5613,5346,-267,15613,16763,1150,13442.0,4403.0,-9039.0,3944706.0,0.0,-3944706.0
<a href=/player/thomt002>thomt002</a>,Trayce Thompson,Chicago White Sox,WSOX,3,7,6,13,2015,2017,2,Yes,0,4.46,5.75,1.29,441,251,-190,564,1001,437,693.0,30.0,-663.0,12535000.0,0.0,-12535000.0
<a href=/player/thomt002>thomt002</a>,Trayce Thompson,Oakland Athletics,ATLTCS,1,1,1,2,2018,2018,0,No,0,-1.05,0.0,1.05,48,0,-48,130,0,-130,0.0,0.0,0.0,0.0,0.0,0.0
<a href=/player/thomt103>thomt103</a>,Tommy Thomas,Washington Senators,TWINS,1,3,1,4,1935,1935,0,No,0,-0.51,0.0,0.51,66,0,-66,27,0,-27,256.0,0.0,-256.0,0.0,0.0,0.0
<a href=/player/thomt103>thomt103</a>,Tommy Thomas,Baltimore,Baltimore,1,2,1,3,1925,1925,0,No,0,22.29,0.0,-22.29,491,0,-491,595,0,-595,4665.0,0.0,-4665.0,0.0,0.0,0.0
<a href=/player/thomt105>thomt105</a>,Tommy Thompson,Boston Braves,BRAVES,7,21,11,32,1936,1952,16,No,0,22.0,38.45,16.45,1506,1907,401,5516,6570,1054,0.0,2449.0,2449.0,12500.0,0.0,-12500.0
<a href=/player/thomt106>thomt106</a>,Tim Thompson,Brooklyn Dodgers,DOGRS,1,1,3,4,1956,1956,0,No,0,-0.25,0.0,0.25,173,0,-173,537,0,-537,0.0,0.0,0.0,0.0,0.0,0.0
<a href=/player/thomt106>thomt106</a>,Tim Thompson,Kansas City Athletics,ATLTCS,31,62,61,123,1957,1976,19,No,0,95.85,56.38,-39.47,9593,6643,-2950,23097,19018,-4079,12004.0,6179.0,-5825.0,476100.0,0.0,-476100.0
<a href=/player/thomv101>thomv101</a>,Valmy Thomas,San Francisco Giants,GIANTS,1,2,1,3,1958,1965,7,No,0,-2.23,13.08,15.31,168,471,303,186,541,355,408.0,4217.0,3809.0,0.0,0.0,0.0
<a href=/player/thond001>thond001</a>,Dickie Thon,California Angels,ANGELS,1,1,1,2,1981,1985,4,No,0,16.04,9.21,-6.83,566,90,-476,2013,0,-2013,0.0,1850.0,1850.0,0.0,0.0,0.0
<a href=/player/thonj101>thonj101</a>,Jack Thoney,Toronto,Toronto,1,1,2,3,1907,1907,0,No,0,0.74,0.0,-0.74,148,0,-148,508,0,-508,0.0,0.0,0.0,0.0,0.0,0.0
<a href=/player/thonj101>thonj101</a>,Jack Thoney,Boston Red Sox,RSOX,9,25,23,48,1912,1935,23,No,0,51.77,27.05,-24.72,3792,3039,-753,15081,11185,-3896,0.0,1203.0,1203.0,45050.0,0.0,-45050.0
<a href=/player/thora001>thora001</a>,Andre Thornton,Philadelphia Phillies,PHILS,1,2,2,4,1972,1973,1,No,0,-1.32,-1.5,-0.18,90,36,-54,4,15,11,108.0,168.0,60.0,0.0,0.0,0.0
<a href=/player/thora001>thora001</a>,Andre Thornton,Atlanta Braves,BRAVES,1,1,1,2,1973,1973,0,No,0,5.17,-0.15,-5.32,271,3,-268,980,12,-968,0.0,0.0,0.0,0.0,0.0,0.0
<a href=/player/thora001>thora001</a>,Andre Thornton,Chicago Cubs,CUBS,7,8,9,17,1976,1988,12,No,1,3.03,7.04,4.01,422,1292,870,1183,4053,2870,160.0,685.0,525.0,0.0,0.0,0.0
<a href=/player/thora001>thora001</a>,Andre Thornton,Montreal Expos,NATEX,1,1,1,2,1976,1978,2,No,0,19.05,-0.41,-19.46,1225,84,-1141,5096,61,-5035,0.0,557.0,557.0,0.0,0.0,0.0
<a href=/player/thorb102>thorb102</a>,Bob Thorpe,Detroit Tigers,TIGRS,2,2,2,4,1957,1958,1,No,0,-0.68,1.06,1.74,8,50,42,1,41,40,26.0,328.0,302.0,0.0,0.0,0.0
<a href=/player/thorh101>thorh101</a>,Hank Thormahlen,New York Yankees,YANKS,4,8,10,18,1920,1931,11,No,0,18.87,48.71,29.84,1297,1673,376,4337,4022,-315,1020.0,6917.0,5897.0,44500.0,0.0,-44500.0
<a href=/player/thorj101>thorj101</a>,Jim Thorpe,New York Giants,GIANTS,1,1,1,2,1919,1919,0,No,0,0.58,0.42,-0.16,60,14,-46,168,8,-160,0.0,68.0,68.0,3913.0,0.0,-3913.0
<a href=/player/thorj102>thorj102</a>,John Thornton,Milwaukee,Milwaukee,1,1,2,3,1891,1901,10,No,0,1.61,0.0,-1.61,84,0,-84,138,0,-138,843.0,0.0,-843.0,0.0,0.0,0.0
<a href=/player/thorl001>thorl001</a>,Lou Thornton,Milwaukee Brewers,BREWRS,1,1,1,2,1989,1989,0,No,0,0.0,0.0,0.0,0,0,0,0,0,0,0.0,0.0,0.0,0.0,0.0,0.0
<a href=/player/thorm001>thorm001</a>,Matt Thornton,Seattle Mariners,MARNRS,1,1,1,2,2006,2006,0,No,0,10.77,-0.06,-10.83,545,6,-539,1,9,8,1390.0,0.0,-1390.0,0.0,0.0,0.0
<a href=/player/thorm001>thorm001</a>,Matt Thornton,Chicago White Sox,WSOX,4,7,6,13,2013,2020,7,Yes,0,3.55,16.12,12.57,359,440,81,1313,1933,620,399.0,102.0,-297.0,3255000.0,0.0,-3255000.0
<a href=/player/thorp101>thorp101</a>,Paul Thormodsgard,Minnesota Twins,TWINS,1,1,1,2,1979,1981,2,No,0,0.0,-0.3,-0.3,0,185,185,0,579,579,0.0,0.0,0.0,0.0,0.0,0.0
<a href=/player/thort001>thort001</a>,Tyler Thornburg,Milwaukee Brewers,BREWRS,2,2,6,8,2016,2019,3,Yes,0,1.72,7.43,5.71,199,464,265,473,1467,994,128.0,121.0,-7.0,513900.0,0.0,-513900.0
<a href=/player/thort002>thort002</a>,Trent Thornton,Houston Astros,ASTROS,1,1,1,2,2018,2018,0,Yes,0,1.08,0.0,-1.08,77,0,-77,3,0,-3,627.0,0.0,-627.0,0.0,0.0,0.0
<a href=/player/throf101>throf101</a>,Faye Throneberry,Boston Red Sox,RSOX,3,5,4,9,1957,1961,4,No,0,-1.86,-2.15,-0.29,679,212,-467,1371,205,-1166,1950.0,366.0,-1584.0,0.0,0.0,0.0
<a href=/player/throg101>throg101</a>,George Throop,Kansas City Royals,ROYALS,1,1,1,2,1979,1980,1,No,0,-0.01,0.0,0.01,28,0,-28,3,0,-3,67.0,0.0,-67.0,0.0,0.0,0.0
<a href=/player/throm101>throm101</a>,Marv Throneberry,New York Yankees,YANKS,4,7,6,13,1959,1969,10,No,0,14.99,27.57,12.58,1233,1032,-201,4340,4017,-323,296.0,0.0,-296.0,175000.0,0.0,-175000.0
<a href=/player/throm101>throm101</a>,Marv Throneberry,Kansas City Athletics,ATLTCS,1,1,1,2,1961,1963,2,No,0,-0.46,-1.04,-0.58,65,67,2,121,208,87,0.0,0.0,0.0,0.0,0.0,0.0
<a href=/player/throm101>throm101</a>,Marv Throneberry,Baltimore Orioles,ORLS,1,1,2,3,1962,1963,1,No,0,0.1,0.38,0.28,130,62,-68,411,190,-221,0.0,0.0,0.0,0.0,0.0,0.0
<a href=/player/thurm001>thurm001</a>,Mark Thurmond,San Diego Padres,PADRS,1,1,1,2,1986,1986,0,No,0,1.85,-0.32,-2.17,75,48,-27,0,12,12,340.0,184.0,-156.0,270000.0,0.0,-270000.0
<a href=/player/thurm001>thurm001</a>,Mark Thurmond,Detroit Tigers,TIGRS,1,1,1,2,1988,1988,0,No,0,-0.03,-1.01,-0.98,92,105,13,0,327,327,494.0,0.0,-494.0,0.0,0.0,0.0
<a href=/player/thurs101>thurs101</a>,Sloppy Thurston,Chicago White Sox,WSOX,1,2,1,3,1927,1927,0,No,0,2.1,1.22,-0.88,71,68,-3,101,246,145,616.0,0.0,-616.0,0.0,0.0,0.0
<a href=/player/thurs101>thurs101</a>,Sloppy Thurston,Brooklyn Dodgers,DOGRS,1,4,1,5,1933,1933,0,No,0,0.0,0.0,0.0,0,0,0,0,0,0,0.0,0.0,0.0,0.0,0.0,0.0
<a href=/player/tianl101>tianl101</a>,Luis Tiant,Cleveland Indians,INDINS,15,21,26,47,1969,1984,15,No,0,48.37,39.17,-9.2,3144,4059,915,8529,12020,3491,2855.0,3764.0,909.0,351750.0,0.0,-351750.0
<a href=/player/tibbj001>tibbj001</a>,Jay Tibbs,New York Mets,METS,1,3,1,4,1984,1987,3,No,0,3.5,-0.12,-3.62,99,72,-27,111,61,-50,956.0,505.0,-451.0,0.0,0.0,0.0
<a href=/player/tibbj001>tibbj001</a>,Jay Tibbs,Cincinnati Reds,REDS,3,6,4,10,1985,1988,3,No,0,12.45,4.93,-7.52,892,228,-664,620,336,-284,4251.0,1549.0,-2702.0,1777500.0,0.0,-1777500.0
<a href=/player/tibbj001>tibbj001</a>,Jay Tibbs,Montreal Expos,NATEX,4,6,7,13,1988,1996,8,No,0,-0.35,1.55,1.9,76,567,491,0,268,268,1095.0,805.0,-290.0,625000.0,0.0,-625000.0
<a href=/player/tibbj001>tibbj001</a>,Jay Tibbs,Baltimore Orioles,ORLS,1,1,1,2,1990,1990,0,No,0,0.11,-0.07,-0.18,10,4,-6,0,0,0,21.0,11.0,-10.0,335000.0,0.0,-335000.0
<a href=/player/tidrd001>tidrd001</a>,Dick Tidrow,Cleveland Indians,INDINS,5,10,12,22,1974,1980,6,No,0,19.8,1.33,-18.47,1334,439,-895,4058,397,-3661,2358.0,2962.0,604.0,38000.0,0.0,-38000.0
<a href=/player/tidrd001>tidrd001</a>,Dick Tidrow,New York Yankees,YANKS,1,1,1,2,1979,1979,0,No,0,5.44,-0.93,-6.37,526,15,-511,29,0,-29,1191.0,83.0,-1108.0,0.0,0.0,0.0
<a href=/player/tidrd001>tidrd001</a>,Dick Tidrow,Chicago Cubs,CUBS,3,6,6,12,1983,1990,7,No,0,9.95,11.91,1.96,748,630,-118,2292,307,-1985,429.0,3028.0,2599.0,890000.0,0.0,-890000.0
<a href=/player/tiefb101>tiefb101</a>,Bobby Tiefenauer,St. Louis Cardinals,CARDS,2,4,3,7,1955,1958,3,No,0,5.63,6.35,0.72,262,260,-2,209,244,35,1575.0,1954.0,379.0,0.0,0.0,0.0
<a href=/player/tiefb101>tiefb101</a>,Bobby Tiefenauer,Detroit Tigers,TIGRS,1,2,2,4,1956,1956,0,No,0,0.0,0.0,0.0,0,0,0,0,0,0,0.0,0.0,0.0,0.0,0.0,0.0
<a href=/player/tiefb101>tiefb101</a>,Bobby Tiefenauer,Toronto,Toronto,1,1,2,3,1958,1958,0,No,0,-0.02,0.0,0.02,52,0,-52,3,0,-3,128.0,0.0,-128.0,0.0,0.0,0.0
<a href=/player/tiefb101>tiefb101</a>,Bobby Tiefenauer,Houston Astros,ASTROS,1,1,1,2,1963,1963,0,No,0,0.0,0.0,0.0,0,0,0,0,0,0,0.0,0.0,0.0,0.0,0.0,0.0
<a href=/player/tiefb101>tiefb101</a>,Bobby Tiefenauer,St. Louis Cardinals,CARDS,1,1,1,2,1963,1964,1,No,0,1.09,0.0,-1.09,128,0,-128,23,0,-23,329.0,0.0,-329.0,0.0,0.0,0.0
<a href=/player/tiefb101>tiefb101</a>,Bobby Tiefenauer,Milwaukee Braves,BRAVES,2,4,4,8,1965,1970,5,No,0,-2.43,0.0,2.43,280,0,-280,53,0,-53,470.0,0.0,-470.0,12000.0,0.0,-12000.0
<a href=/player/tiefb101>tiefb101</a>,Bobby Tiefenauer,Cleveland Indians,INDINS,2,2,2,4,1968,1969,1,No,0,-0.71,-0.19,0.52,64,10,-54,37,0,-37,362.0,8.0,-354.0,0.0,0.0,0.0
<a href=/player/tiefv101>tiefv101</a>,Verle Tiefenthaler,San Francisco Giants,GIANTS,1,4,2,6,1962,1964,2,No,0,7.93,4.13,-3.8,685,341,-344,242,140,-102,2569.0,1260.0,-1309.0,0.0,0.0,0.0
<a href=/player/tierc101>tierc101</a>,Cotton Tierney,Pittsburgh Pirates,PIRATS,1,3,2,5,1923,1926,3,No,0,3.4,4.98,1.58,247,281,34,625,924,299,954.0,681.0,-273.0,4200.0,0.0,-4200.0
<a href=/player/tierc101>tierc101</a>,Cotton Tierney,Philadelphia Phillies,PHILS,1,1,2,3,1923,1925,2,No,0,-0.32,-0.04,0.28,136,145,9,539,576,37,0.0,0.0,0.0,0.0,0.0,0.0
<a href=/player/tierc101>tierc101</a>,Cotton Tierney,Boston Braves,BRAVES,1,1,1,2,1925,1926,1,No,0,-0.53,1.22,1.75,93,136,43,284,503,219,0.0,0.0,0.0,0.0,0.0,0.0
<a href=/player/tierc101>tierc101</a>,Cotton Tierney,Brooklyn Dodgers,DOGRS,3,9,3,12,1926,1934,8,No,0,0.53,8.67,8.14,100,822,722,99,3036,2937,677.0,0.0,-677.0,30000.0,0.0,-30000.0
<a href=/player/tietl101>tietl101</a>,Les Tietje,Chicago White Sox,WSOX,1,1,1,2,1936,1936,0,No,0,-0.39,1.9,2.29,75,61,-14,50,79,29,427.0,586.0,159.0,0.0,0.0,0.0
<a href=/player/tillb101>tillb101</a>,Bob Tillman,New York Yankees,YANKS,1,2,1,3,1967,1970,3,No,0,0.07,0.93,0.86,226,220,-6,711,719,8,0.0,0.0,0.0,6000.0,0.0,-6000.0
<a href=/player/tillb101>tillb101</a>,Bob Tillman,Atlanta Braves,BRAVES,1,1,3,4,1970,1971,1,No,0,0.0,0.0,0.0,0,0,0,0,0,0,0.0,0.0,0.0,0.0,0.0,0.0
<a href=/player/tillc001>tillc001</a>,Chris Tillman,Seattle Mariners,MARNRS,4,9,5,14,2008,2013,5,No,0,43.53,3.71,-39.82,1975,169,-1806,6859,413,-6446,3908.0,766.0,-3142.0,1000000.0,0.0,-1000000.0
<a href=/player/tillr001>tillr001</a>,Rusty Tillman,New York Mets,METS,1,1,1,2,1985,1985,0,No,0,0.0,0.0,0.0,0,0,0,0,0,0,0.0,0.0,0.0,0.0,0.0,0.0
<a href=/player/tillr001>tillr001</a>,Rusty Tillman,San Diego Padres,PADRS,1,1,2,3,1986,1986,0,No,0,0.04,0.5,0.46,22,36,14,42,1,-41,0.0,70.0,70.0,0.0,0.0,0.0
<a href=/player/tillt101>tillt101</a>,Thad Tillotson,Los Angeles Dodgers,DOGRS,1,2,1,3,1966,1967,1,No,0,-0.61,1.03,1.64,100,104,4,20,351,331,326.0,0.0,-326.0,0.0,0.0,0.0
<a href=/player/tilsc001>tilsc001</a>,Charlie Tilson,St. Louis Cardinals,CARDS,1,1,1,2,2016,2017,1,No,0,-1.57,1.15,2.72,96,107,11,280,0,-280,0.0,125.0,125.0,0.0,0.0,0.0
<a href=/player/timlm001>timlm001</a>,Mike Timlin,Toronto Blue Jays,BJAYS,1,2,1,3,1997,2002,5,No,0,1.41,11.51,10.1,180,698,518,0,2901,2901,633.0,0.0,-633.0,1485000.0,0.0,-1485000.0
<a href=/player/timlm001>timlm001</a>,Mike Timlin,Baltimore Orioles,ORLS,2,3,3,6,2000,2004,4,No,0,1.52,3.04,1.52,282,270,-12,37,1020,983,490.0,0.0,-490.0,4250000.0,0.0,-4250000.0
<a href=/player/timlm001>timlm001</a>,Mike Timlin,St. Louis Cardinals,CARDS,2,4,4,8,2002,2009,7,No,0,23.28,30.12,6.84,951,826,-125,3803,3406,-397,107.0,0.0,-107.0,7000000.0,0.0,-7000000.0
<a href=/player/timmo001>timmo001</a>,Ozzie Timmons,Chicago Cubs,CUBS,1,2,1,3,1997,1997,0,No,0,0.02,0.0,-0.02,6,0,-6,9,0,-9,0.0,0.0,0.0,0.0,0.0,0.0
<a href=/player/timmt101>timmt101</a>,Tom Timmermann,Detroit Tigers,TIGRS,2,4,2,6,1973,1975,2,No,0,0.22,-0.05,-0.27,33,98,65,0,215,215,403.0,135.0,-268.0,27500.0,0.0,-27500.0
<a href=/player/tingr001>tingr001</a>,Ron Tingley,San Diego Padres,PADRS,1,1,1,2,1984,1984,0,No,0,0.0,0.0,0.0,0,0,0,0,0,0,0.0,0.0,0.0,0.0,0.0,0.0
<a href=/player/tingr001>tingr001</a>,Ron Tingley,Cleveland Indians,INDINS,1,1,1,2,1989,1990,1,No,0,0.65,-0.22,-0.87,183,8,-175,387,12,-375,0.0,0.0,0.0,0.0,0.0,0.0
<a href=/player/tinkj101>tinkj101</a>,Joe Tinker,Chicago Cubs,CUBS,1,3,5,8,1912,1913,1,No,0,3.8,1.08,-2.72,112,82,-30,420,326,-94,0.0,0.0,0.0,7925.0,0.0,-7925.0
<a href=/player/tinnb101>tinnb101</a>,Bud Tinning,Chicago Cubs,CUBS,1,3,1,4,1934,1940,6,No,0,-0.12,5.38,5.5,10,264,254,1,289,288,23.0,2233.0,2210.0,0.0,0.0,0.0
<a href=/player/tinoj001>tinoj001</a>,Jesus Tinoco,Toronto Blue Jays,BJAYS,1,4,2,6,2015,2018,3,No,0,-2.36,5.17,7.53,267,257,-10,284,987,703,875.0,49.0,-826.0,0.0,0.0,0.0
<a href=/player/tinoj001>tinoj001</a>,Jesus Tinoco,Colorado Rockies,ROCKS,1,1,1,2,2020,2020,0,Yes,0,0.2,0.0,-0.2,3,0,-3,0,0,0,15.0,0.0,-15.0,0.0,0.0,0.0
<a href=/player/tinsl001>tinsl001</a>,Lee Tinsley,Oakland Athletics,ATLTCS,1,2,1,3,1991,1991,0,No,0,0.0,-0.69,-0.69,0,56,56,0,204,204,0.0,0.0,0.0,0.0,0.0,0.0
<a href=/player/tinsl001>tinsl001</a>,Lee Tinsley,Seattle Mariners,MARNRS,1,1,1,2,1994,2009,15,No,0,2.69,0.0,-2.69,270,0,-270,768,0,-768,0.0,0.0,0.0,0.0,0.0,0.0
<a href=/player/tinsl001>tinsl001</a>,Lee Tinsley,Boston Red Sox,RSOX,8,14,15,29,1996,2020,24,Yes,4,-2.56,56.84,59.4,788,2785,1997,802,6826,6024,1145.0,5281.0,4136.0,26826923.0,0.0,-26826923.0
<a href=/player/tinsl001>tinsl001</a>,Lee Tinsley,Philadelphia Phillies,PHILS,1,1,1,2,1996,1996,0,No,0,-0.62,0.0,0.62,92,0,-92,209,0,-209,0.0,0.0,0.0,225000.0,0.0,-225000.0
<a href=/player/tipte101>tipte101</a>,Eric Tipton,Philadelphia Athletics,ATLTCS,1,2,1,3,1941,1941,0,No,0,0.0,0.0,0.0,0,0,0,0,0,0,0.0,0.0,0.0,7500.0,0.0,-7500.0
<a href=/player/tipte101>tipte101</a>,Eric Tipton,New York Yankees,YANKS,1,1,2,3,1942,1942,0,No,0,8.15,0.0,-8.15,451,0,-451,1756,0,-1756,0.0,0.0,0.0,0.0,0.0,0.0
<a href=/player/tiptj101>tiptj101</a>,Joe Tipton,Cleveland Indians,INDINS,15,27,25,52,1948,1968,20,No,0,162.56,72.5,-90.06,7529,3103,-4426,24130,8852,-15278,13186.0,8500.0,-4686.0,30900.0,0.0,-30900.0
<a href=/player/tiptj101>tiptj101</a>,Joe Tipton,Chicago White Sox,WSOX,7,9,10,19,1949,1976,27,No,0,1.76,48.29,46.53,980,3043,2063,2144,11322,9178,489.0,1217.0,728.0,27000.0,0.0,-27000.0
<a href=/player/tiptj101>tiptj101</a>,Joe Tipton,Cleveland Indians,INDINS,1,1,1,2,1954,1954,0,No,0,0.59,0.08,-0.51,54,4,-50,193,8,-185,0.0,0.0,0.0,0.0,0.0,0.0
<a href=/player/tituj101>tituj101</a>,John Titus,Philadelphia Phillies,PHILS,1,1,1,2,1912,1913,1,No,0,3.7,0.46,-3.24,183,136,-47,734,285,-449,0.0,0.0,0.0,0.0,0.0,0.0
<a href=/player/tobid001>tobid001</a>,Dave Tobik,Detroit Tigers,TIGRS,1,1,1,2,1983,1987,4,No,0,1.06,4.64,3.58,51,361,310,0,939,939,259.0,0.0,-259.0,0.0,0.0,0.0
<a href=/player/tobij101>tobij101</a>,Jack Tobin,St.Louis Browns,ORLS,23,43,52,95,1926,1952,26,No,0,132.07,125.15,-6.92,6541,9540,2999,21287,29892,8605,12928.0,19199.0,6271.0,217500.0,0.0,-217500.0
<a href=/player/tobij103>tobij103</a>,Jim Tobin,Pittsburgh Pirates,PIRATS,1,2,1,3,1939,1947,8,No,0,20.23,6.51,-13.72,447,292,-155,628,168,-460,4101.0,1592.0,-2509.0,10000.0,0.0,-10000.0
<a href=/player/todda101>todda101</a>,Al Todd,Philadelphia Phillies,PHILS,6,6,12,18,1935,1946,11,No,0,47.95,20.5,-27.45,1477,1508,31,3069,3345,276,8600.0,5759.0,-2841.0,8000.0,0.0,-8000.0
<a href=/player/todda101>todda101</a>,Al Todd,Pittsburgh Pirates,PIRATS,1,3,1,4,1938,1941,3,No,0,0.0,-0.2,-0.2,0,90,90,0,209,209,0.0,0.0,0.0,0.0,0.0,0.0
<a href=/player/todda101>todda101</a>,Al Todd,Boston Braves,BRAVES,1,1,1,2,1939,1946,7,No,0,0.42,0.29,-0.13,86,210,124,266,200,-66,0.0,1618.0,1618.0,0.0,0.0,0.0
<a href=/player/todda101>todda101</a>,Al Todd,Brooklyn Dodgers,DOGRS,2,4,3,7,1939,1949,10,No,0,-0.11,3.64,3.75,242,623,381,841,2080,1239,0.0,101.0,101.0,10000.0,0.0,-10000.0
<a href=/player/toddj001>toddj001</a>,Jess Todd,St. Louis Cardinals,CARDS,2,3,2,5,2009,2009,0,No,1,4.0,0.42,-3.58,311,68,-243,0,262,262,883.0,0.0,-883.0,0.0,0.0,0.0
<a href=/player/toddj101>toddj101</a>,Jackson Todd,New York Mets,METS,1,1,1,2,1978,1978,0,No,0,0.0,0.0,0.0,0,0,0,0,0,0,0.0,0.0,0.0,0.0,0.0,0.0
<a href=/player/toddj102>toddj102</a>,Jim Todd,Chicago Cubs,CUBS,2,2,3,5,1975,1977,2,No,0,-0.16,-0.83,-0.67,260,159,-101,200,245,45,857.0,0.0,-857.0,0.0,0.0,0.0
<a href=/player/toddj102>toddj102</a>,Jim Todd,Oakland Athletics,ATLTCS,1,1,1,2,1977,1978,1,No,0,-1.48,3.4,4.88,40,55,15,2,0,-2,92.0,442.0,350.0,0.0,0.0,0.0
<a href=/player/toddj102>toddj102</a>,Jim Todd,Chicago Cubs,CUBS,3,4,4,8,1977,1979,2,No,0,4.22,1.01,-3.21,882,153,-729,2458,300,-2158,817.0,108.0,-709.0,0.0,0.0,0.0
<a href=/player/todtp101>todtp101</a>,Phil Todt,Philadelphia Athletics,ATLTCS,4,8,4,12,1931,1934,3,No,0,0.0,-0.85,-0.85,0,42,42,0,71,71,0.0,34.0,34.0,7600.0,0.0,-7600.0
<a href=/player/todtp101>todtp101</a>,Phil Todt,SanAntonio,SanAntonio,1,5,1,6,1923,1923,0,No,0,9.54,0.0,-9.54,1176,0,-1176,4721,0,-4721,0.0,0.0,0.0,0.0,0.0,0.0
<a href=/player/tolab101>tolab101</a>,Bobby Tolan,St. Louis Cardinals,CARDS,4,7,5,12,1968,1971,3,No,0,20.24,2.27,-17.97,1458,401,-1057,4171,1565,-2606,1006.0,0.0,-1006.0,87500.0,0.0,-87500.0
<a href=/player/tolab101>tolab101</a>,Bobby Tolan,Cincinnati Reds,REDS,3,4,4,8,1973,1977,4,No,0,0.21,0.35,0.14,831,242,-589,1153,359,-794,1183.0,1024.0,-159.0,0.0,0.0,0.0
<a href=/player/tolej001>tolej001</a>,Jose Tolentino,Oakland Athletics,ATLTCS,1,1,2,3,1987,1987,0,No,0,0.0,0.0,0.0,0,0,0,0,0,0,0.0,0.0,0.0,0.0,0.0,0.0
<a href=/player/tolif001>tolif001</a>,Freddie Toliver,New York Yankees,YANKS,2,4,3,7,1981,1988,7,No,0,1.81,9.6,7.79,277,868,591,978,3230,2252,30.0,0.0,-30.0,1050000.0,0.0,-1050000.0
<a href=/player/tolif001>tolif001</a>,Freddie Toliver,Cincinnati Reds,REDS,1,3,2,5,1985,1989,4,No,0,0.22,4.93,4.71,144,460,316,269,1695,1426,243.0,0.0,-243.0,117500.0,0.0,-117500.0
<a href=/player/tolif001>tolif001</a>,Freddie Toliver,Philadelphia Phillies,PHILS,1,1,1,2,1988,1988,0,No,0,0.39,0.0,-0.39,29,0,-29,0,0,0,431.0,0.0,-431.0,0.0,0.0,0.0
<a href=/player/tolif001>tolif001</a>,Freddie Toliver,Minnesota Twins,TWINS,1,1,1,2,1989,1989,0,No,0,-0.42,0.08,0.5,18,7,-11,0,0,0,42.0,26.0,-16.0,0.0,0.0,0.0
<a href=/player/tolif001>tolif001</a>,Freddie Toliver,San Diego Padres,PADRS,1,2,2,4,1989,1990,1,No,0,-0.36,-0.39,-0.03,13,192,179,0,619,619,249.0,73.0,-176.0,775000.0,0.0,-775000.0
<a href=/player/tollb001>tollb001</a>,Brian Tollberg,Milwaukee Brewers,BREWRS,1,1,1,2,1997,1997,0,No,0,2.13,0.0,-2.13,104,0,-104,110,0,-110,922.0,0.0,-922.0,0.0,0.0,0.0
<a href=/player/tollw001>tollw001</a>,Wayne Tolleson,Texas Rangers,RNGRS,5,8,10,18,1985,1992,7,No,0,27.49,15.69,-11.8,1300,776,-524,3930,3021,-909,3469.0,327.0,-3142.0,2890539.0,0.0,-2890539.0
<a href=/player/tollw001>tollw001</a>,Wayne Tolleson,Chicago White Sox,WSOX,1,3,3,6,1986,1991,5,No,0,0.75,-0.11,-0.86,650,316,-334,1809,1056,-753,0.0,0.0,0.0,475000.0,0.0,-475000.0
<a href=/player/tolsc101>tolsc101</a>,Chick Tolson,Chicago Cubs,CUBS,1,2,1,3,1930,1931,1,No,0,0.0,0.38,0.38,0,39,39,0,178,178,0.0,0.0,0.0,10500.0,0.0,-10500.0
<a href=/player/tomad101>tomad101</a>,Dick Tomanek,Cleveland Indians,INDINS,18,28,30,58,1958,1984,26,No,0,63.62,52.24,-11.38,5094,5420,326,14869,17997,3128,4436.0,3464.0,-972.0,307350.0,0.0,-307350.0
<a href=/player/tomkb001>tomkb001</a>,Brett Tomko,Cincinnati Reds,REDS,2,6,3,9,2000,2013,13,No,0,18.66,15.9,-2.76,696,1440,744,2678,3953,1275,381.0,721.0,340.0,8282695.0,0.0,-8282695.0
<a href=/player/tomkb001>tomkb001</a>,Brett Tomko,Seattle Mariners,MARNRS,12,24,25,49,2001,2015,14,No,0,25.13,36.61,11.48,2313,2617,304,5473,8533,3060,4049.0,2794.0,-1255.0,29602500.0,0.0,-29602500.0
<a href=/player/tomkb001>tomkb001</a>,Brett Tomko,San Diego Padres,PADRS,1,1,2,3,2002,2003,1,No,0,0.08,-1.26,-1.34,65,128,63,78,2,-76,608.0,230.0,-378.0,1100000.0,0.0,-1100000.0
<a href=/player/tomld001>tomld001</a>,Dave Tomlin,Cincinnati Reds,REDS,3,4,4,8,1973,1977,4,No,0,0.21,0.35,0.14,831,242,-589,1153,359,-794,1183.0,1024.0,-159.0,0.0,0.0,0.0
<a href=/player/tomld001>tomld001</a>,Dave Tomlin,San Diego Padres,PADRS,5,10,7,17,1978,1984,6,No,0,16.75,8.81,-7.94,1038,562,-476,3623,1933,-1690,529.0,1480.0,951.0,0.0,0.0,0.0
<a href=/player/tompr101>tompr101</a>,Ron Tompkins,Oakland Athletics,ATLTCS,3,6,4,10,1967,1972,5,No,0,-0.2,0.87,1.07,128,137,9,155,280,125,313.0,17.0,-296.0,33250.0,0.0,-33250.0
<a href=/player/tompr101>tompr101</a>,Ron Tompkins,Atlanta Braves,BRAVES,1,1,1,2,1969,1969,0,No,0,0.0,0.0,0.0,0,0,0,0,0,0,0.0,0.0,0.0,0.0,0.0,0.0
<a href=/player/tomst101>tomst101</a>,Tommy Toms,St. Louis Cardinals,CARDS,1,1,1,2,1979,1979,0,No,0,0.0,0.14,0.14,0,6,6,0,13,13,0.0,0.0,0.0,0.0,0.0,0.0
<a href=/player/tonef101>tonef101</a>,Fred Toney,New York Giants,GIANTS,3,8,5,13,1922,1930,8,No,0,4.92,14.44,9.52,1096,750,-346,1706,1477,-229,6029.0,4662.0,-1367.0,17500.0,0.0,-17500.0
<a href=/player/toolb101>toolb101</a>,Bert Tooley,Brooklyn Dodgers,DOGRS,1,1,1,2,1912,1914,2,No,0,0.0,0.1,0.1,0,80,80,0,200,200,0.0,0.0,0.0,2100.0,0.0,-2100.0
<a href=/player/topos101>topos101</a>,Specs Toporcer,Syracuse,Syracuse,1,1,3,4,1921,1933,12,No,0,6.03,0.0,-6.03,546,0,-546,1779,0,-1779,0.0,0.0,0.0,0.0,0.0,0.0
<a href=/player/torbj101>torbj101</a>,Jeff Torborg,California Angels,ANGELS,1,1,1,2,1973,1973,0,No,0,0.0,0.0,0.0,0,0,0,0,0,0,0.0,0.0,0.0,30000.0,0.0,-30000.0
<a href=/player/torge101>torge101</a>,Earl Torgeson,Seattle,Seattle,1,1,2,3,1946,1946,0,No,0,19.04,0.0,-19.04,720,0,-720,3001,0,-3001,0.0,0.0,0.0,0.0,0.0,0.0
<a href=/player/torge101>torge101</a>,Earl Torgeson,Milwaukee Braves,BRAVES,5,8,10,18,1953,1966,13,No,0,4.65,28.76,24.11,447,1818,1371,1596,5886,4290,15.0,0.0,-15.0,0.0,0.0,0.0
<a href=/player/torge101>torge101</a>,Earl Torgeson,Detroit Tigers,TIGRS,1,1,1,2,1957,1957,0,No,0,4.81,0.01,-4.8,397,65,-332,984,181,-803,0.0,0.0,0.0,0.0,0.0,0.0
<a href=/player/toroa001>toroa001</a>,Abraham Toro,Houston Astros,ASTROS,1,2,2,4,2021,2021,0,Yes,0,1.64,0.78,-0.86,83,33,-50,253,0,-253,54.0,87.0,33.0,4000000.0,0.0,-4000000.0
<a href=/player/torra001>torra001</a>,Andres Torres,San Francisco Giants,GIANTS,1,2,1,3,2011,2016,5,No,0,1.51,6.46,4.95,247,583,336,434,2471,2037,191.0,0.0,-191.0,3850000.0,0.0,-3850000.0
<a href=/player/torra002>torra002</a>,Alex Torres,Anaheim Angels,ANGELS,1,3,1,4,2009,2011,2,No,0,9.82,-0.01,-9.83,598,38,-560,1637,7,-1630,198.0,564.0,366.0,405000.0,0.0,-405000.0
<a href=/player/torra002>torra002</a>,Alex Torres,Tampa Bay Devil Rays,RAYS,6,8,11,19,2014,2020,6,Yes,0,-0.42,14.29,14.71,628,826,198,687,1868,1181,884.0,1581.0,697.0,2158000.0,0.0,-2158000.0
<a href=/player/torra002>torra002</a>,Alex Torres,San Diego Padres,PADRS,2,2,3,5,2015,2019,4,No,0,0.89,-1.48,-2.37,134,87,-47,1,2,1,187.0,126.0,-61.0,0.0,0.0,0.0
<a href=/player/torra101>torra101</a>,Angel Torres,St. Louis Cardinals,CARDS,7,10,11,21,1976,1992,16,No,0,18.25,16.78,-1.47,1455,1377,-78,2974,3172,198,3388.0,4921.0,1533.0,1943333.0,0.0,-1943333.0
<a href=/player/torra101>torra101</a>,Angel Torres,Montreal Expos,NATEX,1,2,1,3,1977,1978,1,No,0,0.21,-0.44,-0.65,10,62,52,0,27,27,25.0,305.0,280.0,0.0,0.0,0.0
<a href=/player/torrg001>torrg001</a>,Gleyber Torres,Chicago Cubs,CUBS,1,4,1,5,2016,2016,0,No,0,9.71,1.2,-8.51,545,54,-491,1768,0,-1768,353.0,80.0,-273.0,0.0,0.0,0.0
<a href=/player/torrh101>torrh101</a>,Hector Torres,San Francisco Giants,GIANTS,3,4,4,8,1966,1971,5,No,0,8.87,-1.67,-10.54,806,276,-530,1416,715,-701,1801.0,0.0,-1801.0,0.0,0.0,0.0
<a href=/player/torrh101>torrh101</a>,Hector Torres,California Angels,ANGELS,1,1,1,2,1967,1967,0,No,0,-2.95,0.23,3.18,231,26,-205,719,7,-712,0.0,91.0,91.0,0.0,0.0,0.0
<a href=/player/torrh101>torrh101</a>,Hector Torres,Houston Astros,ASTROS,1,1,1,2,1970,1978,8,No,0,-0.04,4.23,4.27,31,1021,990,63,4100,4037,0.0,0.0,0.0,0.0,0.0,0.0
<a href=/player/torrh101>torrh101</a>,Hector Torres,Chicago Cubs,CUBS,1,2,2,4,1972,1972,0,No,0,0.36,-1.6,-1.96,335,85,-250,844,8,-836,2.0,188.0,186.0,0.0,0.0,0.0
<a href=/player/torrh101>torrh101</a>,Hector Torres,Houston Astros,ASTROS,1,1,1,2,1973,1973,0,No,0,0.0,0.0,0.0,0,0,0,0,0,0,0.0,0.0,0.0,16000.0,0.0,-16000.0
<a href=/player/torrh101>torrh101</a>,Hector Torres,San Diego Padres,PADRS,2,4,2,6,1976,1981,5,No,0,20.22,7.28,-12.94,1143,413,-730,4572,857,-3715,0.0,1243.0,1243.0,0.0,0.0,0.0
<a href=/player/torrh101>torrh101</a>,Hector Torres,Cleveland Indians,INDINS,3,5,6,11,1977,1980,3,No,0,-0.98,0.01,0.99,287,197,-90,716,415,-301,0.0,597.0,597.0,0.0,0.0,0.0
<a href=/player/torrj001>torrj001</a>,Jose Torres,Oakland Athletics,ATLTCS,4,8,5,13,2015,2018,3,Yes,0,5.93,2.94,-2.99,610,354,-256,992,1020,28,691.0,108.0,-583.0,4517500.0,0.0,-4517500.0
<a href=/player/torrj101>torrj101</a>,Joe Torre,Atlanta Braves,BRAVES,2,2,2,4,1969,1973,4,No,0,22.48,7.01,-15.47,921,431,-490,3912,1646,-2266,0.0,162.0,162.0,0.0,0.0,0.0
<a href=/player/torrj101>torrj101</a>,Joe Torre,St. Louis Cardinals,CARDS,6,8,8,16,1974,1978,4,No,0,12.43,5.6,-6.83,1504,362,-1142,1454,839,-615,2982.0,616.0,-2366.0,202000.0,0.0,-202000.0
<a href=/player/torrl001>torrl001</a>,Luis Torrens,Cincinnati Reds,REDS,2,3,3,6,2016,2020,4,No,0,-1.12,0.1,1.22,206,115,-91,536,298,-238,0.0,23.0,23.0,0.0,0.0,0.0
<a href=/player/torrl001>torrl001</a>,Luis Torrens,San Diego Padres,PADRS,1,4,3,7,2020,2021,1,Yes,0,5.43,0.42,-5.01,353,36,-317,1365,75,-1290,2.0,42.0,40.0,0.0,0.0,0.0
<a href=/player/torrm001>torrm001</a>,Mike Torrez,St. Louis Cardinals,CARDS,3,5,4,9,1971,1971,0,No,0,3.53,0.17,-3.36,337,40,-297,618,85,-533,1940.0,21.0,-1919.0,27000.0,0.0,-27000.0
<a href=/player/torrm001>torrm001</a>,Mike Torrez,Montreal Expos,NATEX,1,2,3,5,1974,1976,2,No,0,33.5,-0.16,-33.66,1482,37,-1445,6072,69,-6003,812.0,232.0,-580.0,98500.0,0.0,-98500.0
<a href=/player/torrm001>torrm001</a>,Mike Torrez,Baltimore Orioles,ORLS,11,24,22,46,1976,1994,18,No,3,56.21,91.98,35.77,2586,4496,1910,5425,11173,5748,12108.0,13984.0,1876.0,713333.0,0.0,-713333.0
<a href=/player/torrm001>torrm001</a>,Mike Torrez,Oakland Athletics,ATLTCS,1,1,3,4,1977,1978,1,No,0,2.42,-2.3,-4.72,31,228,197,0,609,609,651.0,78.0,-573.0,100000.0,0.0,-100000.0
<a href=/player/torrm001>torrm001</a>,Mike Torrez,Boston Red Sox,RSOX,1,1,1,2,1983,1983,0,No,0,-0.77,0.0,0.77,96,0,-96,85,0,-85,780.0,0.0,-780.0,0.0,0.0,0.0
<a href=/player/torrp101>torrp101</a>,Pablo Torrealba,Oakland Athletics,ATLTCS,4,4,5,9,1978,2000,22,No,3,-0.37,15.11,15.48,28,1067,1039,0,3032,3032,189.0,453.0,264.0,0.0,0.0,0.0
<a href=/player/torrr001>torrr001</a>,Ronald Torreyes,Cincinnati Reds,REDS,1,3,1,4,2011,2015,4,No,0,7.63,1.09,-6.54,509,203,-306,388,0,-388,2074.0,256.0,-1818.0,422500.0,0.0,-422500.0
<a href=/player/torrr001>torrr001</a>,Ronald Torreyes,Los Angeles Dodgers,DOGRS,1,2,2,4,2016,2016,0,Yes,0,1.39,0.0,-1.39,222,40,-182,607,83,-524,8.0,0.0,-8.0,0.0,0.0,0.0
<a href=/player/torrr001>torrr001</a>,Ronald Torreyes,New York Yankees,YANKS,1,1,1,2,2018,2018,0,No,0,0.0,0.0,0.0,0,0,0,0,0,0,0.0,0.0,0.0,615500.0,0.0,-615500.0
<a href=/player/torrr101>torrr101</a>,Rusty Torres,New York Yankees,YANKS,5,8,9,17,1972,1987,15,No,0,9.09,48.73,39.64,1757,1810,53,5603,6602,999,883.0,1959.0,1076.0,246600.0,0.0,-246600.0
<a href=/player/torrr101>torrr101</a>,Rusty Torres,Cleveland Indians,INDINS,1,3,1,4,1974,1974,0,No,0,0.32,-0.11,-0.43,178,15,-163,399,61,-338,0.0,0.0,0.0,19750.0,0.0,-19750.0
<a href=/player/torrr101>torrr101</a>,Rusty Torres,Texas Rangers,RNGRS,5,9,9,18,1978,1982,4,No,0,22.0,5.65,-16.35,909,552,-357,2290,1222,-1068,4197.0,810.0,-3387.0,313000.0,0.0,-313000.0
<a href=/player/torrs001>torrs001</a>,Salomon Torres,San Francisco Giants,GIANTS,4,5,6,11,1995,2002,7,No,0,1.56,13.92,12.36,217,677,460,467,1531,1064,771.0,2970.0,2199.0,4725000.0,0.0,-4725000.0
<a href=/player/torrs001>torrs001</a>,Salomon Torres,Pittsburgh Pirates,PIRATS,1,1,2,3,2007,2008,1,No,0,0.79,-0.41,-1.2,140,24,-116,1,0,-1,240.0,51.0,-189.0,2733333.0,0.0,-2733333.0
<a href=/player/torry001>torry001</a>,Yorvit Torrealba,San Francisco Giants,GIANTS,1,2,1,3,2005,2009,4,No,0,0.09,12.27,12.18,42,666,624,119,2799,2680,0.0,0.0,0.0,715000.0,0.0,-715000.0
<a href=/player/torry001>torry001</a>,Yorvit Torrealba,Seattle Mariners,MARNRS,2,2,2,4,2005,2006,1,No,0,0.94,0.0,-0.94,373,0,-373,1383,0,-1383,0.0,0.0,0.0,0.0,0.0,0.0
<a href=/player/torvk001>torvk001</a>,Kelvin Torve,San Francisco Giants,GIANTS,1,1,1,2,1985,1985,0,No,0,0.0,0.0,0.0,0,0,0,0,0,0,0.0,0.0,0.0,0.0,0.0,0.0
<a href=/player/tostl101>tostl101</a>,Lou Tost,Hollywood,Hollywood,1,1,1,2,1941,1941,0,No,0,1.35,0.0,-1.35,76,0,-76,56,0,-56,460.0,0.0,-460.0,0.0,0.0,0.0
<a href=/player/tothp101>tothp101</a>,Paul Toth,St. Louis Cardinals,CARDS,1,1,1,2,1962,1962,0,No,0,1.69,-0.06,-1.75,74,2,-72,59,1,-58,526.0,15.0,-511.0,0.0,0.0,0.0
<a href=/player/tothp101>tothp101</a>,Paul Toth,Chicago Cubs,CUBS,2,4,4,8,1964,1966,2,No,0,41.31,1.04,-40.27,2470,267,-2203,10220,596,-9624,9.0,335.0,326.0,12000.0,0.0,-12000.0
<a href=/player/tothp101>tothp101</a>,Paul Toth,New York Yankees,YANKS,1,2,1,3,1967,1968,1,No,0,0.0,0.0,0.0,0,0,0,0,0,0,0.0,0.0,0.0,0.0,0.0,0.0
<a href=/player/toust001>toust001</a>,Touki Toussaint,Arizona Diamondbacks,DBACKS,2,3,2,5,2015,2017,2,Yes,0,-1.46,1.06,2.52,118,146,28,80,316,236,435.0,0.0,-435.0,0.0,0.0,0.0
<a href=/player/tovac101>tovac101</a>,Cesar Tovar,Cincinnati Reds,REDS,2,2,3,5,1964,1966,2,No,0,26.68,-0.65,-27.33,1125,61,-1064,4607,13,-4594,133.0,184.0,51.0,0.0,0.0,0.0
<a href=/player/tovac101>tovac101</a>,Cesar Tovar,Minnesota Twins,TWINS,2,2,4,6,1972,1974,2,No,0,0.75,-1.38,-2.13,99,154,55,364,334,-30,22.0,133.0,111.0,55000.0,0.0,-55000.0
<a href=/player/townh101>townh101</a>,Happy Townsend,Washington Senators,TWINS,1,1,1,2,1905,1907,2,No,0,0.0,1.73,1.73,0,73,73,0,101,101,0.0,688.0,688.0,0.0,0.0,0.0
<a href=/player/townh101>townh101</a>,Happy Townsend,Detroit Tigers,TIGRS,1,1,1,2,1905,1905,0,No,0,-0.74,0.0,0.74,34,0,-34,33,0,-33,278.0,0.0,-278.0,0.0,0.0,0.0
<a href=/player/trabb001>trabb001</a>,Billy Traber,New York Mets,METS,3,9,8,17,2001,2008,7,No,0,12.43,-0.5,-12.93,1334,336,-998,2309,1012,-1297,1613.0,327.0,-1286.0,8000000.0,0.0,-8000000.0
<a href=/player/tracd101>tracd101</a>,Dick Tracewski,Los Angeles Dodgers,DOGRS,4,5,5,10,1965,1970,5,No,0,16.33,5.42,-10.91,1557,311,-1246,3120,174,-2946,1193.0,662.0,-531.0,36500.0,0.0,-36500.0
<a href=/player/tracj101>tracj101</a>,Jim Tracy,Chicago Cubs,CUBS,1,1,1,2,1981,1986,5,No,0,0.0,0.76,0.76,0,378,378,0,690,690,0.0,0.0,0.0,0.0,0.0,0.0
<a href=/player/tracs001>tracs001</a>,Steve Trachsel,Tampa Bay Devil Rays,RAYS,1,2,1,3,2000,2003,3,No,0,1.0,0.98,-0.02,34,198,164,0,846,846,251.0,0.0,-251.0,1000000.0,0.0,-1000000.0
<a href=/player/tracs001>tracs001</a>,Steve Trachsel,Baltimore Orioles,ORLS,1,1,2,3,2007,2010,3,No,0,-0.48,-1.45,-0.97,8,90,82,7,155,148,52.0,100.0,48.0,3000000.0,0.0,-3000000.0
<a href=/player/tragw101>tragw101</a>,Walt Tragesser,Philadelphia Phillies,PHILS,1,1,1,2,1921,1922,1,No,0,0.0,0.6,0.6,0,96,96,0,306,306,0.0,0.0,0.0,0.0,0.0,0.0
<a href=/player/tramb001>tramb001</a>,Bubba Trammell,Tampa Bay Devil Rays,RAYS,1,2,2,4,2000,2003,3,No,0,0.01,4.03,4.02,189,316,127,73,802,729,294.0,1188.0,894.0,863000.0,0.0,-863000.0
<a href=/player/tramb001>tramb001</a>,Bubba Trammell,New York Mets,METS,1,1,1,2,2000,2001,1,No,0,2.0,0.0,-2.0,275,64,-211,1011,0,-1011,0.0,128.0,128.0,0.0,0.0,0.0
<a href=/player/tramb001>tramb001</a>,Bubba Trammell,San Diego Padres,PADRS,3,5,4,9,2003,2004,1,No,0,0.21,1.96,1.75,115,115,0,147,449,302,127.0,0.0,-127.0,5500000.0,0.0,-5500000.0
<a href=/player/tramt001>tramt001</a>,Taylor Trammell,Cincinnati Reds,REDS,1,3,1,4,2019,2020,1,No,0,0.0,2.49,2.49,0,30,30,0,16,16,0.0,388.0,388.0,9700000.0,0.0,-9700000.0
<a href=/player/tramt001>tramt001</a>,Taylor Trammell,San Diego Padres,PADRS,1,4,3,7,2020,2021,1,Yes,0,5.43,0.42,-5.01,353,36,-317,1365,75,-1290,2.0,42.0,40.0,0.0,0.0,0.0
<a href=/player/trauj001>trauj001</a>,John Trautwein,Montreal Expos,NATEX,2,2,2,4,1988,1989,1,No,0,-0.61,0.0,0.61,9,0,-9,0,0,0,48.0,0.0,-48.0,0.0,0.0,0.0
<a href=/player/travd001>travd001</a>,Devon Travis,Detroit Tigers,TIGRS,1,1,1,2,2014,2017,3,No,0,5.83,0.44,-5.39,316,170,-146,1246,636,-610,0.0,0.0,0.0,0.0,0.0,0.0
<a href=/player/travs001>travs001</a>,Sam Travis,Boston Red Sox,RSOX,2,4,3,7,2020,2021,1,Yes,0,0.11,-0.27,-0.38,61,16,-45,0,0,0,216.0,61.0,-155.0,0.0,0.0,0.0
<a href=/player/treag101>treag101</a>,George Treadway,Baltimore Orioles,BLN,1,2,2,4,1894,1899,5,No,0,9.18,29.72,20.54,830,772,-58,3686,3764,78,0.0,0.0,0.0,0.0,0.0,0.0
<a href=/player/treaj001>treaj001</a>,Jeff Treadway,Los Angeles Dodgers,DOGRS,2,4,3,7,1995,1996,1,No,0,1.62,-0.16,-1.78,426,245,-181,1244,564,-680,244.0,191.0,-53.0,305000.0,0.0,-305000.0
<a href=/player/tream001>tream001</a>,Matt Treanor,Kansas City Royals,ROYALS,1,1,1,2,1997,1999,2,No,0,2.01,0.2,-1.81,274,152,-122,832,0,-832,0.0,358.0,358.0,0.0,0.0,0.0
<a href=/player/tream001>tream001</a>,Matt Treanor,Milwaukee Brewers,BREWRS,1,1,1,2,2010,2010,0,No,0,-0.58,0.0,0.58,89,0,-89,284,0,-284,0.0,0.0,0.0,0.0,0.0,0.0
<a href=/player/trecf101>trecf101</a>,Frank Trechock,Washington Senators,TWINS,2,7,2,9,1940,1943,3,No,0,7.97,0.58,-7.39,391,342,-49,1546,1354,-192,0.0,0.0,0.0,0.0,0.0,0.0
<a href=/player/trecf101>trecf101</a>,Frank Trechock,New York Giants,GIANTS,2,7,5,12,1948,1954,6,No,0,0.0,-0.44,-0.44,0,186,186,0,308,308,0.0,172.0,172.0,0.0,0.0,0.0
<a href=/player/treib001>treib001</a>,Blake Treinen,Oakland Athletics,ATLTCS,8,15,10,25,2013,2018,5,Yes,0,10.44,2.58,-7.86,1089,362,-727,2080,1057,-1023,1184.0,312.0,-872.0,8300001.0,0.0,-8300001.0
<a href=/player/treib001>treib001</a>,Blake Treinen,Washington Nationals,NATEX,2,4,3,7,2017,2020,3,Yes,0,5.92,4.82,-1.1,246,410,164,62,3,-59,883.0,620.0,-263.0,8230366.0,0.0,-8230366.0
<a href=/player/tresm101>tresm101</a>,Mike Tresh,Detroit Tigers,TIGRS,5,17,11,28,1937,1952,15,No,0,24.1,51.38,27.28,3640,2564,-1076,12152,7653,-4499,3951.0,7313.0,3362.0,74300.0,0.0,-74300.0
<a href=/player/trest101>trest101</a>,Tom Tresh,New York Yankees,YANKS,2,2,2,4,1969,1973,4,No,0,3.28,1.33,-1.95,467,344,-123,1321,850,-471,0.0,0.0,0.0,16000.0,0.0,-16000.0
<a href=/player/treva001>treva001</a>,Alex Trevino,New York Mets,METS,1,3,1,4,1982,1986,4,No,0,1.8,4.68,2.88,378,655,277,630,2610,1980,505.0,0.0,-505.0,0.0,0.0,0.0
<a href=/player/treva001>treva001</a>,Alex Trevino,Atlanta Braves,BRAVES,1,1,1,2,1985,1987,2,No,0,0.49,-0.06,-0.55,57,3,-54,179,2,-177,0.0,0.0,0.0,0.0,0.0,0.0
<a href=/player/treva001>treva001</a>,Alex Trevino,San Francisco Giants,GIANTS,2,2,2,4,1985,1990,5,No,1,1.71,4.89,3.18,161,522,361,389,1862,1473,0.0,0.0,0.0,462500.0,0.0,-462500.0
<a href=/player/triag101>triag101</a>,Gus Triandos,New York Yankees,YANKS,12,33,27,60,1954,1970,16,No,0,40.55,76.98,36.43,5201,4368,-833,16466,10777,-5689,3212.0,10751.0,7539.0,302500.0,0.0,-302500.0
<a href=/player/triag101>triag101</a>,Gus Triandos,Baltimore Orioles,ORLS,1,2,1,3,1962,1962,0,No,0,0.46,0.0,-0.46,158,0,-158,435,0,-435,0.0,0.0,0.0,0.0,0.0,0.0
<a href=/player/triag101>triag101</a>,Gus Triandos,Detroit Tigers,TIGRS,2,4,4,8,1963,1970,7,No,0,32.41,16.87,-15.54,651,629,-22,1145,1412,267,4562.0,2945.0,-1617.0,39000.0,0.0,-39000.0
<a href=/player/trilm001>trilm001</a>,Manny Trillo,Oakland Athletics,ATLTCS,1,3,1,4,1974,1976,2,No,0,1.24,1.92,0.68,1157,275,-882,3065,1015,-2050,578.0,0.0,-578.0,69800.0,0.0,-69800.0
<a href=/player/trilm001>trilm001</a>,Manny Trillo,Chicago Cubs,CUBS,9,17,19,36,1979,1990,11,No,0,20.77,12.9,-7.87,2689,1303,-1386,6948,2680,-4268,1072.0,3217.0,2145.0,890000.0,0.0,-890000.0
<a href=/player/trilm001>trilm001</a>,Manny Trillo,Philadelphia Phillies,PHILS,5,11,8,19,1982,1999,17,No,0,22.81,28.42,5.61,2142,1948,-194,7615,5685,-1930,390.0,1257.0,867.0,2950000.0,0.0,-2950000.0
<a href=/player/trilm001>trilm001</a>,Manny Trillo,Cleveland Indians,INDINS,1,1,2,3,1983,1983,0,No,0,0.28,0.0,-0.28,31,0,-31,136,0,-136,0.0,0.0,0.0,375000.0,0.0,-375000.0
<a href=/player/trilm001>trilm001</a>,Manny Trillo,San Francisco Giants,GIANTS,1,1,1,2,1985,1986,1,No,0,0.74,0.0,-0.74,265,0,-265,593,0,-593,0.0,0.0,0.0,709714.0,0.0,-709714.0
<a href=/player/tripc101>tripc101</a>,Coaker Triplett,St. Louis Cardinals,CARDS,1,3,2,5,1943,1946,3,No,0,7.07,3.43,-3.64,654,226,-428,2414,842,-1572,0.0,0.0,0.0,0.0,0.0,0.0
<a href=/player/trlir001>trlir001</a>,Ricky Trlicek,Atlanta Braves,BRAVES,1,1,2,3,1989,1990,1,No,0,-0.11,-1.22,-1.11,2,67,65,0,204,204,5.0,0.0,-5.0,0.0,0.0,0.0
<a href=/player/trlir001>trlir001</a>,Ricky Trlicek,Boston Red Sox,RSOX,1,1,1,2,1997,1997,0,No,0,-0.32,-0.16,0.16,18,3,-15,0,0,0,27.0,10.0,-17.0,184250.0,0.0,-184250.0
<a href=/player/tromm001>tromm001</a>,Mike Trombley,Baltimore Orioles,ORLS,1,1,2,3,2001,2006,5,No,0,-0.47,1.42,1.89,38,279,241,0,871,871,70.0,30.0,-40.0,2333333.0,0.0,-2333333.0
<a href=/player/tropn001>tropn001</a>,Nick Tropeano,Houston Astros,ASTROS,1,2,1,3,2014,2015,1,No,0,3.0,0.42,-2.58,223,73,-150,597,229,-368,587.0,0.0,-587.0,0.0,0.0,0.0
<a href=/player/trotb101>trotb101</a>,Bill Trotter,St.Louis Browns,ORLS,1,2,2,4,1942,1947,5,No,0,0.79,6.64,5.85,98,330,232,296,878,582,122.0,1025.0,903.0,7500.0,0.0,-7500.0
<a href=/player/troud101>troud101</a>,Dizzy Trout,Indianapolis,Indianapolis,1,2,3,5,1936,1936,0,No,0,49.01,0.0,-49.01,1002,0,-1002,1002,0,-1002,7777.0,0.0,-7777.0,0.0,0.0,0.0
<a href=/player/troud101>troud101</a>,Dizzy Trout,Detroit Tigers,TIGRS,18,41,43,84,1952,1964,12,No,0,49.33,53.4,4.07,4601,4657,56,11266,12496,1230,8483.0,9258.0,775.0,157700.0,0.0,-157700.0
<a href=/player/trous001>trous001</a>,Steve Trout,Chicago White Sox,WSOX,4,9,10,19,1983,1991,8,No,0,34.9,10.9,-24.0,2508,1101,-1407,7089,2979,-4110,3712.0,567.0,-3145.0,640000.0,0.0,-640000.0
<a href=/player/trous001>trous001</a>,Steve Trout,Chicago Cubs,CUBS,2,2,4,6,1987,1990,3,No,0,-0.54,-0.95,-0.41,14,52,38,0,9,9,139.0,133.0,-6.0,890000.0,0.0,-890000.0
<a href=/player/trous001>trous001</a>,Steve Trout,New York Yankees,YANKS,5,11,7,18,1987,2001,14,No,1,23.63,17.74,-5.89,1905,1277,-628,5748,3988,-1760,3609.0,1551.0,-2058.0,2400000.0,0.0,-2400000.0
<a href=/player/trubc001>trubc001</a>,Chris Truby,Houston Astros,ASTROS,2,2,2,4,2002,2009,7,No,0,-0.8,5.27,6.07,147,469,322,481,1028,547,0.0,1403.0,1403.0,1500000.0,0.0,-1500000.0
<a href=/player/trubc001>trubc001</a>,Chris Truby,Montreal Expos,NATEX,2,2,2,4,2002,2003,1,No,0,-2.04,-0.82,1.22,299,201,-98,686,540,-146,0.0,0.0,0.0,1095000.0,0.0,-1095000.0
<a href=/player/trubh101>trubh101</a>,Harry Truby,Pittsburgh Pirates,PIRATS,1,4,2,6,1896,1898,2,No,0,3.6,0.48,-3.12,234,186,-48,984,763,-221,0.0,0.0,0.0,0.0,0.0,0.0
<a href=/player/trucv101>trucv101</a>,Virgil Trucks,Detroit Tigers,TIGRS,13,25,26,51,1952,1968,16,No,0,25.92,52.07,26.15,2610,3104,494,6934,6097,-837,4331.0,10073.0,5742.0,79500.0,0.0,-79500.0
<a href=/player/trucv101>trucv101</a>,Virgil Trucks,St.Louis Browns,ORLS,22,48,46,94,1953,1994,41,No,3,94.31,149.93,55.62,5238,8648,3410,10875,24828,13953,20367.0,16826.0,-3541.0,970833.0,0.0,-970833.0
<a href=/player/trucv101>trucv101</a>,Virgil Trucks,Chicago White Sox,WSOX,6,9,11,20,1955,1969,14,No,0,12.94,20.18,7.24,1394,1327,-67,4462,4906,444,852.0,12.0,-840.0,77250.0,0.0,-77250.0
<a href=/player/trucv101>trucv101</a>,Virgil Trucks,Detroit Tigers,TIGRS,4,10,9,19,1956,1961,5,No,0,13.15,0.77,-12.38,602,579,-23,394,1616,1222,3228.0,40.0,-3188.0,13200.0,0.0,-13200.0
<a href=/player/trucv101>trucv101</a>,Virgil Trucks,Kansas City Athletics,ATLTCS,3,4,4,8,1958,1960,2,No,0,-3.45,4.79,8.24,286,319,33,181,498,317,1056.0,779.0,-277.0,12500.0,0.0,-12500.0
<a href=/player/trujm001>trujm001</a>,Mike Trujillo,Chicago White Sox,WSOX,1,2,1,3,1984,1985,1,No,0,0.0,-0.28,-0.28,0,12,12,0,16,16,0.0,0.0,0.0,0.0,0.0,0.0
<a href=/player/trujm001>trujm001</a>,Mike Trujillo,Boston Red Sox,RSOX,3,7,5,12,1986,1993,7,No,0,7.37,8.49,1.12,984,1130,146,3351,3154,-197,369.0,1455.0,1086.0,1275000.0,0.0,-1275000.0
<a href=/player/trumm001>trumm001</a>,Mark Trumbo,Anaheim Angels,ANGELS,2,4,5,9,2013,2018,5,Yes,0,-0.66,6.84,7.5,224,159,-65,546,24,-522,593.0,2315.0,1722.0,540000.0,0.0,-540000.0
<a href=/player/trumm001>trumm001</a>,Mark Trumbo,Arizona Diamondbacks,DBACKS,1,2,4,6,2015,2018,3,No,0,2.85,2.85,0.0,190,248,58,363,765,402,400.0,92.0,-308.0,0.0,0.0,0.0
<a href=/player/trumm001>trumm001</a>,Mark Trumbo,Seattle Mariners,MARNRS,1,2,1,3,2015,2015,0,Yes,0,1.72,0.0,-1.72,407,0,-407,1659,0,-1659,0.0,0.0,0.0,6900000.0,0.0,-6900000.0
<a href=/player/tsitj101>tsitj101</a>,John Tsitouris,Detroit Tigers,TIGRS,4,12,12,24,1957,1964,7,No,0,6.47,14.38,7.91,1197,947,-250,3186,1303,-1883,1459.0,3692.0,2233.0,20000.0,0.0,-20000.0
<a href=/player/tsitj101>tsitj101</a>,John Tsitouris,Kansas City Athletics,ATLTCS,1,2,1,3,1961,1961,0,No,0,1.89,1.04,-0.85,216,93,-123,188,76,-112,1621.0,384.0,-1237.0,0.0,0.0,0.0
<a href=/player/tsuty001>tsuty001</a>,Yoshi Tsutsugo,Tampa Bay Devil Rays,RAYS,1,1,1,2,2021,2021,0,No,0,-0.08,0.0,0.08,12,0,-12,31,0,-31,0.0,0.0,0.0,7000000.0,0.0,-7000000.0
<a href=/player/tubbg001>tubbg001</a>,Greg Tubbs,Atlanta Braves,BRAVES,2,2,2,4,1990,1991,1,No,0,1.07,-0.04,-1.11,105,5,-100,275,1,-274,0.0,0.0,0.0,0.0,0.0,0.0
<a href=/player/tucke001>tucke001</a>,Eddie Tucker,Houston Astros,ASTROS,1,1,1,2,1995,1996,1,No,0,-0.14,0.0,0.14,17,0,-17,27,0,-27,0.0,0.0,0.0,0.0,0.0,0.0
<a href=/player/tuckm001>tuckm001</a>,Michael Tucker,Kansas City Royals,ROYALS,2,3,3,6,1997,2002,5,No,0,6.48,5.78,-0.7,926,799,-127,2620,3080,460,0.0,181.0,181.0,3800000.0,0.0,-3800000.0
<a href=/player/tuckm001>tuckm001</a>,Michael Tucker,Atlanta Braves,BRAVES,9,20,18,38,1998,2015,17,No,3,84.77,19.25,-65.52,4465,2071,-2394,14759,4939,-9820,5099.0,1624.0,-3475.0,29165000.0,0.0,-29165000.0
<a href=/player/tuckm001>tuckm001</a>,Michael Tucker,Cincinnati Reds,REDS,2,2,3,5,2001,2005,4,No,0,1.18,-0.11,-1.29,63,28,-35,235,1,-234,0.0,76.0,76.0,1800000.0,0.0,-1800000.0
<a href=/player/tuckm001>tuckm001</a>,Michael Tucker,Chicago Cubs,CUBS,1,1,1,2,2001,2002,1,No,0,0.26,0.0,-0.26,248,0,-248,981,0,-981,0.0,0.0,0.0,0.0,0.0,0.0
<a href=/player/tuckm001>tuckm001</a>,Michael Tucker,San Francisco Giants,GIANTS,1,1,1,2,2005,2005,0,No,0,-0.05,0.0,0.05,22,0,-22,21,0,-21,0.0,0.0,0.0,2000000.0,0.0,-2000000.0
<a href=/player/tuckp001>tuckp001</a>,Preston Tucker,Houston Astros,ASTROS,1,1,1,2,2017,2017,0,No,0,-0.01,0.0,0.01,80,0,-80,142,0,-142,0.0,0.0,0.0,0.0,0.0,0.0
<a href=/player/tuckp001>tuckp001</a>,Preston Tucker,Atlanta Braves,BRAVES,1,3,1,4,2018,2020,2,No,0,1.47,1.06,-0.41,203,131,-72,53,396,343,403.0,0.0,-403.0,565000.0,0.0,-565000.0
<a href=/player/tuckt102>tuckt102</a>,Thurman Tucker,Chicago White Sox,WSOX,1,1,1,2,1948,1949,1,No,0,0.34,-0.44,-0.78,221,66,-155,608,179,-429,0.0,0.0,0.0,0.0,0.0,0.0
<a href=/player/tudoj001>tudoj001</a>,John Tudor,Boston Red Sox,RSOX,3,3,3,6,1983,1987,4,No,0,5.36,6.23,0.87,299,579,280,871,2393,1522,636.0,0.0,-636.0,225000.0,0.0,-225000.0
<a href=/player/tudoj001>tudoj001</a>,John Tudor,Pittsburgh Pirates,PIRATS,5,10,11,21,1984,2001,17,No,2,29.07,20.82,-8.25,851,1724,873,1168,2507,1339,5314.0,7059.0,1745.0,1290000.0,0.0,-1290000.0
<a href=/player/tudoj001>tudoj001</a>,John Tudor,St. Louis Cardinals,CARDS,1,1,1,2,1988,1992,4,No,0,1.28,1.7,0.42,30,500,470,18,2026,2008,200.0,0.0,-200.0,1100000.0,0.0,-1100000.0
<a href=/player/tuftb101>tuftb101</a>,Bob Tufts,San Francisco Giants,GIANTS,3,6,7,13,1982,1992,10,No,0,0.93,10.52,9.59,146,1038,892,148,1280,1132,952.0,5228.0,4276.0,0.0,0.0,0.0
<a href=/player/tuftb101>tuftb101</a>,Bob Tufts,Kansas City Royals,ROYALS,2,3,3,6,1983,1990,7,No,0,8.3,23.07,14.77,256,327,71,214,512,298,1914.0,3771.0,1857.0,1318000.0,0.0,-1318000.0
<a href=/player/tuivs001>tuivs001</a>,Sam Tuivailala,St. Louis Cardinals,CARDS,1,1,1,2,2018,2018,0,Yes,0,1.02,0.0,-1.02,29,0,-29,0,0,0,85.0,0.0,-85.0,554600.0,0.0,-554600.0
<a href=/player/tulot001>tulot001</a>,Troy Tulowitzki,Colorado Rockies,ROCKS,4,6,8,14,2015,2020,5,Yes,0,9.83,-2.06,-11.89,514,266,-248,1003,284,-719,1008.0,871.0,-137.0,0.0,0.0,0.0
<a href=/player/turbg101>turbg101</a>,George Turbeville,Philadelphia Athletics,ATLTCS,2,4,2,6,1938,1947,9,No,0,0.0,6.93,6.93,0,1140,1140,0,4751,4751,0.0,0.0,0.0,12000.0,0.0,-12000.0
<a href=/player/turlb101>turlb101</a>,Bob Turley,Baltimore Orioles,ORLS,21,46,43,89,1954,1994,40,No,3,83.66,150.67,67.01,4979,8510,3531,10385,24729,14344,18519.0,15968.0,-2551.0,970833.0,0.0,-970833.0
<a href=/player/turnj001>turnj001</a>,Justin Turner,Cincinnati Reds,REDS,2,4,3,7,2008,2012,4,No,1,-0.23,1.51,1.74,26,269,243,51,1011,960,0.0,0.0,0.0,3000000.0,0.0,-3000000.0
<a href=/player/turnj002>turnj002</a>,Jacob Turner,Detroit Tigers,TIGRS,1,3,2,5,2012,2017,5,No,0,-1.8,11.54,13.34,208,344,136,437,741,304,809.0,2395.0,1586.0,1175000.0,0.0,-1175000.0
<a href=/player/turnj002>turnj002</a>,Jacob Turner,Miami Marlins,MARLNS,1,1,2,3,2014,2014,0,Yes,0,-0.66,0.0,0.66,15,0,-15,10,0,-10,104.0,0.0,-104.0,0.0,0.0,0.0
<a href=/player/turnj102>turnj102</a>,Jim Turner,Indianapolis,Indianapolis,1,1,1,2,1936,1936,0,No,0,9.04,0.0,-9.04,192,0,-192,270,0,-270,2042.0,0.0,-2042.0,0.0,0.0,0.0
<a href=/player/turnj102>turnj102</a>,Jim Turner,Boston Braves,BRAVES,1,1,2,3,1939,1940,1,No,0,3.89,0.15,-3.74,101,18,-83,121,64,-57,909.0,0.0,-909.0,12500.0,0.0,-12500.0
<a href=/player/turnj102>turnj102</a>,Jim Turner,Cincinnati Reds,REDS,1,3,1,4,1942,1942,0,No,0,-0.7,0.0,0.7,176,38,-138,37,128,91,438.0,0.0,-438.0,0.0,0.0,0.0
<a href=/player/turnm001>turnm001</a>,Matt Turner,Atlanta Braves,BRAVES,1,2,1,3,1991,1991,0,No,0,0.0,-0.43,-0.43,0,48,48,0,3,3,0.0,104.0,104.0,0.0,0.0,0.0
<a href=/player/turnm001>turnm001</a>,Matt Turner,Florida Marlins,MARLNS,1,1,1,2,1994,1994,0,No,0,0.21,0.39,0.18,9,42,33,0,1,1,38.0,70.0,32.0,0.0,0.0,0.0
<a href=/player/turns001>turns001</a>,Shane Turner,New York Yankees,YANKS,1,2,1,3,1987,1987,0,No,0,-0.56,-0.16,0.4,55,65,10,124,184,60,0.0,0.0,0.0,62500.0,0.0,-62500.0
<a href=/player/turns001>turns001</a>,Shane Turner,Philadelphia Phillies,PHILS,1,1,1,2,1989,1989,0,No,0,-0.02,0.0,0.02,4,0,-4,1,0,-1,0.0,0.0,0.0,0.0,0.0,0.0
<a href=/player/turnt001>turnt001</a>,Trea Turner,San Diego Padres,PADRS,2,6,5,11,2014,2020,6,Yes,0,27.48,-0.67,-28.15,849,63,-786,2993,31,-2962,1330.0,78.0,-1252.0,0.0,0.0,0.0
<a href=/player/turnt001>turnt001</a>,Trea Turner,Washington Nationals,NATEX,1,2,4,6,2021,2021,0,Yes,0,4.89,0.24,-4.65,74,47,-27,252,110,-142,205.0,188.0,-17.0,47503480.0,0.0,-47503480.0
<a href=/player/turnt101>turnt101</a>,Tuck Turner,Philadelphia Phillies,PHILS,1,3,1,4,1896,1900,4,No,0,-0.5,6.22,6.72,240,440,200,1079,2080,1001,0.0,0.0,0.0,0.0,0.0,0.0
<a href=/player/turnt105>turnt105</a>,Terry Turner,Columbus,Columbus,1,1,2,3,1903,1905,2,No,0,38.48,0.0,-38.48,1619,0,-1619,6493,0,-6493,0.0,0.0,0.0,0.0,0.0,0.0
<a href=/player/tuttb101>tuttb101</a>,Bill Tuttle,Detroit Tigers,TIGRS,4,12,12,24,1957,1964,7,No,0,6.47,14.38,7.91,1197,947,-250,3186,1303,-1883,1459.0,3692.0,2233.0,20000.0,0.0,-20000.0
<a href=/player/tuttb101>tuttb101</a>,Bill Tuttle,Kansas City Athletics,ATLTCS,2,3,5,8,1961,1963,2,No,0,-0.83,2.26,3.09,294,240,-54,628,222,-406,40.0,738.0,698.0,0.0,0.0,0.0
<a href=/player/twitw101>twitw101</a>,Wayne Twitchell,Milwaukee Brewers,BREWRS,10,24,23,47,1971,1984,13,No,0,40.35,84.88,44.53,2851,4171,1320,6365,14852,8487,12446.0,5331.0,-7115.0,466901.0,0.0,-466901.0
<a href=/player/twitw101>twitw101</a>,Wayne Twitchell,Philadelphia Phillies,PHILS,12,28,21,49,1977,1999,22,No,0,39.49,55.77,16.28,5043,4716,-327,14497,10321,-4176,7936.0,3859.0,-4077.0,2950000.0,0.0,-2950000.0
<a href=/player/twomb101>twomb101</a>,Babe Twombly,Chicago Cubs,CUBS,2,8,5,13,1921,1926,5,No,0,29.39,11.6,-17.79,1120,351,-769,4097,694,-3403,1929.0,2961.0,1032.0,13500.0,0.0,-13500.0
<a href=/player/tyacj101>tyacj101</a>,Jim Tyack,Philadelphia Athletics,ATLTCS,1,1,1,2,1943,1944,1,No,0,0.0,-0.63,-0.63,0,32,32,0,138,138,0.0,0.0,0.0,3500.0,0.0,-3500.0
<a href=/player/tyacj101>tyacj101</a>,Jim Tyack,Philadelphia Athletics,ATLTCS,1,1,1,2,1943,1944,1,No,0,0.0,-0.63,-0.63,0,32,32,0,138,138,0.0,0.0,0.0,3500.0,0.0,-3500.0
<a href=/player/tylel101>tylel101</a>,Lefty Tyler,Boston Braves,BRAVES,3,4,6,10,1918,1921,3,No,0,32.45,6.15,-26.3,1008,651,-357,2505,2581,76,5076.0,0.0,-5076.0,0.0,0.0,0.0
<a href=/player/tynej001>tynej001</a>,Jason Tyner,New York Mets,METS,2,3,3,6,2000,2001,1,No,0,6.03,0.01,-6.02,591,253,-338,1813,73,-1740,1188.0,422.0,-766.0,0.0,0.0,0.0
<a href=/player/tyroj101>tyroj101</a>,Jim Tyrone,Chicago Cubs,CUBS,1,1,1,2,1977,1977,0,No,0,0.27,0.0,-0.27,96,0,-96,328,0,-328,0.0,0.0,0.0,0.0,0.0,0.0
<a href=/player/tysom101>tysom101</a>,Mike Tyson,St. Louis Cardinals,CARDS,1,1,1,2,1979,1981,2,No,0,-1.51,-0.16,1.35,173,22,-151,466,6,-460,0.0,65.0,65.0,0.0,0.0,0.0
<a href=/player/tysot102>tysot102</a>,Ty Tyson,Louisville,Louisville,2,2,3,5,1925,1926,1,No,0,3.49,0.0,-3.49,304,0,-304,1085,0,-1085,0.0,0.0,0.0,0.0,0.0,0.0
<a href=/player/tysot102>tysot102</a>,Ty Tyson,Buffalo,Buffalo,1,1,2,3,1927,1928,1,No,0,-0.16,0.0,0.16,59,0,-59,229,0,-229,0.0,0.0,0.0,0.0,0.0,0.0
<a href=/player/ueckb101>ueckb101</a>,Bob Uecker,Milwaukee Braves,BRAVES,2,2,3,5,1964,1965,1,No,0,-0.33,-0.91,-0.58,133,91,-42,390,156,-234,0.0,0.0,0.0,0.0,0.0,0.0
<a href=/player/ueckb101>ueckb101</a>,Bob Uecker,St. Louis Cardinals,CARDS,11,23,19,42,1965,1972,7,No,0,31.6,1.61,-29.99,3237,670,-2567,8420,1434,-6986,1865.0,703.0,-1162.0,32500.0,0.0,-32500.0
<a href=/player/ueckb101>ueckb101</a>,Bob Uecker,Philadelphia Phillies,PHILS,3,4,4,8,1967,1974,7,No,0,-1.15,1.59,2.74,159,477,318,337,1585,1248,624.0,0.0,-624.0,32000.0,0.0,-32000.0
<a href=/player/uehak001>uehak001</a>,Koji Uehara,Baltimore Orioles,ORLS,2,2,3,5,2011,2016,5,Yes,0,1.34,20.41,19.07,98,1005,907,0,3248,3248,209.0,1190.0,981.0,7650000.0,0.0,-7650000.0
<a href=/player/uggld001>uggld001</a>,Dan Uggla,Florida Marlins,MARLNS,4,6,8,14,2010,2016,6,Yes,0,15.72,5.36,-10.36,961,1222,261,2736,1427,-1309,2987.0,1776.0,-1211.0,15800000.0,0.0,-15800000.0
<a href=/player/uhalf101>uhalf101</a>,Frenchy Uhalt,Oakland,Oakland,1,1,2,3,1933,1933,0,No,0,-0.04,0.0,0.04,57,0,-57,199,0,-199,0.0,0.0,0.0,0.0,0.0,0.0
<a href=/player/uhlat101>uhlat101</a>,Ted Uhlaender,Minnesota Twins,TWINS,2,5,4,9,1969,1971,2,No,0,19.42,3.86,-15.56,887,264,-623,3069,67,-3002,587.0,852.0,265.0,120000.0,0.0,-120000.0
<a href=/player/uhlat101>uhlat101</a>,Ted Uhlaender,Cleveland Indians,INDINS,4,5,7,12,1971,1983,12,No,0,3.02,13.82,10.8,466,736,270,144,826,682,1581.0,2898.0,1317.0,116000.0,0.0,-116000.0
<a href=/player/uhleg101>uhleg101</a>,George Uhle,Cleveland Indians,INDINS,1,1,2,3,1928,1930,2,No,0,19.39,1.63,-17.76,319,74,-245,408,56,-352,2479.0,447.0,-2032.0,0.0,0.0,0.0
<a href=/player/uhlem101>uhlem101</a>,Maury Uhler,Cincinnati Reds,REDS,3,6,6,12,1914,1930,16,No,0,6.12,48.22,42.1,494,2027,1533,2101,8451,6350,0.0,27.0,27.0,0.0,0.0,0.0
<a href=/player/umbaa101>umbaa101</a>,Arnold Umbach,Atlanta Braves,BRAVES,1,3,2,5,1966,1968,2,No,0,0.94,-0.28,-1.22,101,10,-91,383,29,-354,0.0,0.0,0.0,57500.0,0.0,-57500.0
<a href=/player/umbaj101>umbaj101</a>,Jim Umbarger,Texas Rangers,RNGRS,6,12,10,22,1977,1982,5,No,0,21.67,6.59,-15.08,1054,693,-361,2707,1819,-888,4329.0,810.0,-3519.0,313000.0,0.0,-313000.0
<a href=/player/umbrj101>umbrj101</a>,Jim Umbricht,Milwaukee Braves,BRAVES,1,1,1,2,1959,1959,0,No,0,-0.2,0.0,0.2,38,0,-38,10,0,-10,153.0,0.0,-153.0,0.0,0.0,0.0
<a href=/player/umpht101>umpht101</a>,Tom Umphlett,Boston Red Sox,RSOX,1,2,1,3,1953,1953,0,No,0,2.57,0.0,-2.57,409,0,-409,921,0,-921,1057.0,0.0,-1057.0,0.0,0.0,0.0
<a href=/player/umpht101>umpht101</a>,Tom Umphlett,Washington Senators,TWINS,7,16,14,30,1955,1963,8,No,0,11.54,-1.9,-13.44,1150,1625,475,3478,3777,299,832.0,1792.0,960.0,17500.0,0.0,-17500.0
<a href=/player/umpht101>umpht101</a>,Tom Umphlett,Boston Red Sox,RSOX,1,2,1,3,1962,1963,1,No,0,0.0,-0.22,-0.22,0,89,89,0,301,301,0.0,0.0,0.0,0.0,0.0,0.0
<a href=/player/unded001>unded001</a>,Duane Underwood,Chicago Cubs,CUBS,1,1,1,2,2021,2021,0,Yes,0,0.17,0.0,-0.17,82,0,-82,4,0,-4,218.0,0.0,-218.0,0.0,0.0,0.0
<a href=/player/undep101>undep101</a>,Pat Underwood,Detroit Tigers,TIGRS,1,1,1,2,1983,1983,0,No,0,0.0,0.75,0.75,0,59,59,0,149,149,0.0,0.0,0.0,0.0,0.0,0.0
<a href=/player/undet001>undet001</a>,Tom Underwood,Philadelphia Phillies,PHILS,3,5,4,9,1977,1983,6,No,0,1.29,13.57,12.28,795,776,-19,1705,2597,892,551.0,251.0,-300.0,300000.0,0.0,-300000.0
<a href=/player/undet001>undet001</a>,Tom Underwood,St. Louis Cardinals,CARDS,10,22,18,40,1977,1998,21,No,4,72.28,127.33,55.05,5696,4654,-1042,17434,16355,-1079,7151.0,4578.0,-2573.0,1533333.0,0.0,-1533333.0
<a href=/player/undet001>undet001</a>,Tom Underwood,Toronto Blue Jays,BJAYS,5,9,9,18,1979,1987,8,No,0,10.29,14.89,4.6,1883,1679,-204,6026,5403,-623,668.0,1848.0,1180.0,0.0,0.0,0.0
<a href=/player/undet001>undet001</a>,Tom Underwood,New York Yankees,YANKS,2,5,4,9,1981,1983,2,No,0,0.32,-0.84,-1.16,265,132,-133,447,432,-15,1046.0,0.0,-1046.0,250000.0,0.0,-250000.0
<a href=/player/unglb101>unglb101</a>,Bob Unglaub,New York Yankees,YANKS,1,1,1,2,1904,1906,2,No,0,2.47,1.13,-1.34,263,234,-29,1019,989,-30,0.0,0.0,0.0,0.0,0.0,0.0
<a href=/player/unsed101>unsed101</a>,Del Unser,Texas Rangers,RNGRS,15,34,23,57,1971,1988,17,No,0,48.57,49.18,0.61,3015,3170,155,9911,9907,-4,4375.0,6620.0,2245.0,528000.0,0.0,-528000.0
<a href=/player/unsed101>unsed101</a>,Del Unser,Cleveland Indians,INDINS,4,5,5,10,1972,1978,6,No,0,17.47,7.73,-9.74,1096,443,-653,3100,1364,-1736,0.0,1052.0,1052.0,33000.0,0.0,-33000.0
<a href=/player/unsed101>unsed101</a>,Del Unser,Philadelphia Phillies,PHILS,2,4,4,8,1974,1984,10,No,0,23.16,7.68,-15.48,1035,1011,-24,3964,168,-3796,0.0,2166.0,2166.0,0.0,0.0,0.0
<a href=/player/unsed101>unsed101</a>,Del Unser,New York Mets,METS,3,4,4,8,1976,1978,2,No,0,2.45,0.15,-2.3,488,71,-417,1259,171,-1088,0.0,0.0,0.0,0.0,0.0,0.0
<a href=/player/uprid101>uprid101</a>,Dixie Upright,Chicago White Sox,WSOX,30,58,56,114,1953,1971,18,No,0,64.71,123.68,58.97,7642,8383,741,20635,20225,-410,7158.0,13512.0,6354.0,248750.0,0.0,-248750.0
<a href=/player/upshc101>upshc101</a>,Cecil Upshaw,Atlanta Braves,BRAVES,1,1,1,2,1973,1974,1,No,0,-0.14,0.12,0.26,70,51,-19,2,60,58,115.0,0.0,-115.0,37000.0,0.0,-37000.0
<a href=/player/upshc101>upshc101</a>,Cecil Upshaw,Houston Astros,ASTROS,1,1,1,2,1973,1974,1,No,0,-0.05,-0.48,-0.43,7,68,61,0,1,1,24.0,135.0,111.0,0.0,0.0,0.0
<a href=/player/upshc101>upshc101</a>,Cecil Upshaw,Cleveland Indians,INDINS,5,10,12,22,1974,1980,6,No,0,19.8,1.33,-18.47,1334,439,-895,4058,397,-3661,2358.0,2962.0,604.0,38000.0,0.0,-38000.0
<a href=/player/upshc101>upshc101</a>,Cecil Upshaw,New York Yankees,YANKS,1,1,1,2,1974,1975,1,No,0,0.79,0.0,-0.79,29,1,-28,0,0,0,142.0,0.0,-142.0,0.0,0.0,0.0
<a href=/player/uptob001>uptob001</a>,Melvin Upton,Atlanta Braves,BRAVES,4,8,11,19,2015,2021,6,Yes,0,6.43,9.54,3.11,663,1279,616,1140,3485,2345,998.0,1493.0,495.0,8100000.0,0.0,-8100000.0
<a href=/player/uptob001>uptob001</a>,Melvin Upton,San Diego Padres,PADRS,1,2,1,3,2016,2016,0,Yes,0,-0.4,0.0,0.4,57,0,-57,165,0,-165,0.0,0.0,0.0,0.0,0.0,0.0
<a href=/player/uptob101>uptob101</a>,Bill Upton,Cleveland Indians,INDINS,1,3,1,4,1954,1955,1,No,0,-0.18,-0.05,0.13,26,176,150,8,639,631,106.0,0.0,-106.0,0.0,0.0,0.0
<a href=/player/uptoj001>uptoj001</a>,Justin Upton,Arizona Diamondbacks,DBACKS,5,9,11,20,2013,2019,6,Yes,0,9.33,5.76,-3.57,709,1160,451,2798,2556,-242,0.0,1347.0,1347.0,0.0,0.0,0.0
<a href=/player/uptoj001>uptoj001</a>,Justin Upton,Atlanta Braves,BRAVES,2,4,6,10,2014,2019,5,Yes,0,3.78,1.55,-2.23,316,457,141,1233,1449,216,47.0,147.0,100.0,14250000.0,0.0,-14250000.0
<a href=/player/uptoj001>uptoj001</a>,Justin Upton,Detroit Tigers,TIGRS,1,1,2,3,2017,2017,0,Yes,0,2.06,0.0,-2.06,366,0,-366,1512,0,-1512,0.0,0.0,0.0,0.0,0.0,0.0
<a href=/player/uptot101>uptot101</a>,Tom Upton,St.Louis Browns,ORLS,40,98,101,199,1951,1994,43,No,3,172.85,216.49,43.64,11423,17730,6307,26850,53504,26654,34401.0,21386.0,-13015.0,1044583.0,0.0,-1044583.0
<a href=/player/uptot101>uptot101</a>,Tom Upton,Chicago White Sox,WSOX,1,1,1,2,1951,1953,2,No,0,-0.1,-0.6,-0.5,5,64,59,7,155,148,0.0,0.0,0.0,0.0,0.0,0.0
<a href=/player/uptot101>uptot101</a>,Tom Upton,Washington Senators,TWINS,17,30,33,63,1952,1963,11,No,0,45.18,4.68,-40.5,3039,4336,1297,10601,11469,868,1213.0,4683.0,3470.0,38500.0,0.0,-38500.0
<a href=/player/urbab101>urbab101</a>,Billy Urbanski,Boston Braves,BRAVES,1,1,1,2,1937,1938,1,No,0,0.0,-0.06,-0.06,0,21,21,0,39,39,0.0,0.0,0.0,0.0,0.0,0.0
<a href=/player/urbaj101>urbaj101</a>,Jack Urban,New York Yankees,YANKS,6,15,13,28,1957,1970,13,No,0,5.72,32.98,27.26,1633,2423,790,4235,5558,1323,2553.0,4978.0,2425.0,115500.0,0.0,-115500.0
<a href=/player/urbaj101>urbaj101</a>,Jack Urban,Kansas City Athletics,ATLTCS,1,1,1,2,1959,1960,1,No,0,0.0,-0.22,-0.22,0,6,6,0,0,0,0.0,11.0,11.0,0.0,0.0,0.0
<a href=/player/urbal101>urbal101</a>,Luke Urban,Boston Braves,BRAVES,1,3,1,4,1928,1928,0,No,0,0.0,-0.51,-0.51,0,14,14,0,6,6,0.0,65.0,65.0,10080.0,0.0,-10080.0
<a href=/player/urbat001>urbat001</a>,Tom Urbani,St. Louis Cardinals,CARDS,1,2,2,4,1996,1997,1,No,0,-0.3,0.33,0.63,16,17,1,0,37,37,71.0,0.0,-71.0,180000.0,0.0,-180000.0
<a href=/player/urbiu001>urbiu001</a>,Ugueth Urbina,Montreal Expos,NATEX,2,2,3,5,2001,2005,4,No,0,3.55,9.62,6.07,161,226,65,78,284,206,910.0,1755.0,845.0,6950000.0,0.0,-6950000.0
<a href=/player/urbiu001>urbiu001</a>,Ugueth Urbina,Texas Rangers,RNGRS,2,4,6,10,2003,2007,4,No,0,30.69,2.87,-27.82,1192,174,-1018,3926,206,-3720,1767.0,481.0,-1286.0,4500000.0,0.0,-4500000.0
<a href=/player/urbiu001>urbiu001</a>,Ugueth Urbina,Detroit Tigers,TIGRS,1,2,1,3,2005,2009,4,No,0,-0.18,19.15,19.33,143,632,489,65,2819,2754,157.0,0.0,-157.0,5025000.0,0.0,-5025000.0
<a href=/player/urial001>urial001</a>,Luis Urias,San Diego Padres,PADRS,2,8,4,12,2019,2020,1,Yes,0,4.06,1.62,-2.44,306,12,-294,771,0,-771,833.0,208.0,-625.0,6368900.0,0.0,-6368900.0
<a href=/player/uribj001>uribj001</a>,Jose Uribe,St. Louis Cardinals,CARDS,3,6,5,11,1985,1998,13,No,4,10.04,29.74,19.7,1204,965,-239,3785,3877,92,620.0,0.0,-620.0,0.0,0.0,0.0
<a href=/player/uribj002>uribj002</a>,Juan Uribe,Colorado Rockies,ROCKS,2,3,2,5,2003,2006,3,No,0,9.11,0.43,-8.68,1175,364,-811,4011,914,-3097,15.0,134.0,119.0,626000.0,0.0,-626000.0
<a href=/player/uribj002>uribj002</a>,Juan Uribe,Los Angeles Dodgers,DOGRS,1,2,4,6,2015,2016,1,Yes,0,1.24,-0.01,-1.25,134,78,-56,167,142,-25,113.0,54.0,-59.0,0.0,0.0,0.0
<a href=/player/uribj002>uribj002</a>,Juan Uribe,Atlanta Braves,BRAVES,5,11,7,18,2015,2021,6,Yes,0,3.57,1.27,-2.3,479,157,-322,663,322,-341,932.0,563.0,-369.0,21307500.0,0.0,-21307500.0
<a href=/player/urrej101>urrej101</a>,John Urrea,St. Louis Cardinals,CARDS,12,29,23,52,1980,1998,18,No,5,83.63,121.95,38.32,6733,4994,-1739,20851,17148,-3703,6532.0,3025.0,-3507.0,1533333.0,0.0,-1533333.0
<a href=/player/urshg001>urshg001</a>,Giovanny Urshela,Cleveland Indians,INDINS,1,1,1,2,2018,2018,0,No,0,-0.4,0.0,0.4,19,0,-19,46,0,-46,0.0,0.0,0.0,0.0,0.0,0.0
<a href=/player/usheb101>usheb101</a>,Bob Usher,Cincinnati Reds,REDS,10,20,25,45,1951,1965,14,No,0,82.49,29.43,-53.06,4608,2904,-1704,14725,6918,-7807,2749.0,1517.0,-1232.0,76250.0,0.0,-76250.0
<a href=/player/usheb101>usheb101</a>,Bob Usher,Cleveland Indians,INDINS,1,1,2,3,1957,1957,0,No,0,-0.4,0.0,0.4,96,0,-96,331,0,-331,0.0,0.0,0.0,0.0,0.0,0.0
<a href=/player/utlec001>utlec001</a>,Chase Utley,Philadelphia Phillies,PHILS,4,7,7,14,2015,2018,3,Yes,0,5.57,0.72,-4.85,624,105,-519,2054,308,-1746,0.0,0.0,0.0,10527000.0,0.0,-10527000.0
<a href=/player/vacht101>vacht101</a>,Tex Vache,Boston Red Sox,RSOX,1,2,1,3,1925,1927,2,No,0,0.0,1.87,1.87,0,185,185,0,714,714,0.0,0.0,0.0,7200.0,0.0,-7200.0
<a href=/player/vacht101>vacht101</a>,Tex Vache,Detroit Tigers,TIGRS,3,7,6,13,1925,1934,9,No,0,25.64,16.48,-9.16,1182,968,-214,3618,3598,-20,3712.0,0.0,-3712.0,12500.0,0.0,-12500.0
<a href=/player/vailm001>vailm001</a>,Mike Vail,St. Louis Cardinals,CARDS,4,5,5,10,1974,1977,3,No,0,-1.77,-0.4,1.37,404,34,-370,964,23,-941,66.0,23.0,-43.0,0.0,0.0,0.0
<a href=/player/vailm001>vailm001</a>,Mike Vail,Cleveland Indians,INDINS,8,13,14,27,1978,2011,33,No,2,35.46,55.83,20.37,1913,2966,1053,6764,10177,3413,2682.0,4370.0,1688.0,1767500.0,0.0,-1767500.0
<a href=/player/vailm001>vailm001</a>,Mike Vail,Chicago Cubs,CUBS,1,1,1,2,1980,1982,2,No,0,-0.4,-0.02,0.38,109,70,-39,228,148,-80,0.0,0.0,0.0,0.0,0.0,0.0
<a href=/player/vailm001>vailm001</a>,Mike Vail,Cincinnati Reds,REDS,1,1,1,2,1983,1983,0,No,0,-0.2,-1.57,-1.37,18,66,48,27,24,-3,0.0,269.0,269.0,0.0,0.0,0.0
<a href=/player/vailm001>vailm001</a>,Mike Vail,San Francisco Giants,GIANTS,1,1,1,2,1983,1984,1,No,0,0.56,-0.17,-0.73,34,7,-27,62,8,-54,0.0,0.0,0.0,0.0,0.0,0.0
<a href=/player/valbl001>valbl001</a>,Luis Valbuena,Seattle Mariners,MARNRS,8,16,16,32,2008,2015,7,No,0,2.79,32.43,29.64,1083,1763,680,2877,5784,2907,720.0,2794.0,2074.0,18727500.0,0.0,-18727500.0
<a href=/player/valbl001>valbl001</a>,Luis Valbuena,Chicago Cubs,CUBS,1,2,1,3,2015,2016,1,No,0,4.82,6.42,1.6,226,281,55,835,1241,406,50.0,0.0,-50.0,0.0,0.0,0.0
<a href=/player/valdc003>valdc003</a>,Cesar Valdez,Arizona Diamondbacks,DBACKS,1,1,1,2,2010,2011,1,No,0,0.0,0.13,0.13,0,41,41,0,23,23,0.0,230.0,230.0,0.0,0.0,0.0
<a href=/player/valdi001>valdi001</a>,Ismael Valdez,Los Angeles Dodgers,DOGRS,6,10,12,22,1999,2013,14,No,2,3.76,16.28,12.52,757,1664,907,2628,3589,961,416.0,2617.0,2201.0,12585000.0,0.0,-12585000.0
<a href=/player/valdi001>valdi001</a>,Ismael Valdez,Chicago Cubs,CUBS,1,1,3,4,2000,2002,2,No,0,-0.49,-0.56,-0.07,18,24,6,13,10,-3,120.0,98.0,-22.0,5737500.0,0.0,-5737500.0
<a href=/player/valdi001>valdi001</a>,Ismael Valdez,Texas Rangers,RNGRS,1,1,2,3,2002,2003,1,No,0,0.16,-0.48,-0.64,8,24,16,0,54,54,148.0,0.0,-148.0,2500000.0,0.0,-2500000.0
<a href=/player/valdi001>valdi001</a>,Ismael Valdez,San Diego Padres,PADRS,2,3,2,5,2004,2005,1,No,0,0.37,0.54,0.17,54,58,4,37,241,204,340.0,0.0,-340.0,800000.0,0.0,-800000.0
<a href=/player/valdm001>valdm001</a>,Marc Valdes,Tampa Bay Devil Rays,RAYS,2,3,2,5,2000,2003,3,No,0,-0.29,3.35,3.64,103,238,135,3,757,754,170.0,0.0,-170.0,575000.0,0.0,-575000.0
<a href=/player/valdm002>valdm002</a>,Mario Valdez,Minnesota Twins,TWINS,1,1,1,2,2000,2001,1,No,0,-0.21,-0.17,0.04,37,15,-22,79,40,-39,0.0,0.0,0.0,0.0,0.0,0.0
<a href=/player/valdm003>valdm003</a>,Merkin Valdez,Atlanta Braves,BRAVES,1,2,1,3,2002,2004,2,No,0,0.14,4.84,4.7,172,133,-39,38,153,115,546.0,1251.0,705.0,215000.0,0.0,-215000.0
<a href=/player/valdr002>valdr002</a>,Raul Valdes,Houston Astros,ASTROS,1,1,1,2,2014,2014,0,No,0,0.0,0.0,0.0,0,0,0,0,0,0,0.0,0.0,0.0,0.0,0.0,0.0
<a href=/player/valds001>valds001</a>,Sergio Valdez,Montreal Expos,NATEX,6,12,13,25,1989,2001,12,No,3,21.4,30.38,8.98,1830,1831,1,4276,2869,-1407,3122.0,2278.0,-844.0,1435000.0,0.0,-1435000.0
<a href=/player/valds101>valds101</a>,Sandy Valdespino,Atlanta Braves,BRAVES,1,1,1,2,1968,1969,1,No,0,-0.29,1.16,1.45,41,72,31,137,3,-134,0.0,117.0,117.0,0.0,0.0,0.0
<a href=/player/valds101>valds101</a>,Sandy Valdespino,Houston Astros,ASTROS,1,2,1,3,1969,1970,1,No,0,-0.73,-0.15,0.58,198,81,-117,682,308,-374,0.0,0.0,0.0,12000.0,0.0,-12000.0
<a href=/player/valdw001>valdw001</a>,Wilson Valdez,Florida Marlins,MARLNS,1,2,1,3,2004,2004,0,No,0,0.33,0.26,-0.07,19,45,26,46,0,-46,0.0,77.0,77.0,0.0,0.0,0.0
<a href=/player/valdw001>valdw001</a>,Wilson Valdez,Seattle Mariners,MARNRS,1,1,2,3,2005,2005,0,No,0,0.14,0.0,-0.14,9,0,-9,15,0,-15,0.0,0.0,0.0,316000.0,0.0,-316000.0
<a href=/player/valdw001>valdw001</a>,Wilson Valdez,Kansas City Royals,ROYALS,1,1,1,2,2006,2006,0,No,0,0.41,0.0,-0.41,41,0,-41,80,0,-80,0.0,0.0,0.0,0.0,0.0,0.0
<a href=/player/valdw001>valdw001</a>,Wilson Valdez,Philadelphia Phillies,PHILS,1,1,1,2,2012,2014,2,No,0,-1.68,0.43,2.11,77,118,41,208,0,-208,0.0,172.0,172.0,0.0,0.0,0.0
<a href=/player/valeb001>valeb001</a>,Breyvic Valera,St. Louis Cardinals,CARDS,1,1,1,2,2018,2018,0,Yes,0,-0.2,0.0,0.2,20,0,-20,34,0,-34,0.0,0.0,0.0,0.0,0.0,0.0
<a href=/player/valeb001>valeb001</a>,Breyvic Valera,Los Angeles Dodgers,DOGRS,1,5,1,6,2018,2018,0,No,0,-0.21,2.49,2.7,29,66,37,41,296,255,217.0,0.0,-217.0,0.0,0.0,0.0
<a href=/player/valeb101>valeb101</a>,Benny Valenzuela,St. Louis Cardinals,CARDS,2,6,5,11,1958,1965,7,No,0,0.78,23.86,23.08,573,513,-60,1253,888,-365,694.0,3387.0,2693.0,0.0,0.0,0.0
<a href=/player/valeb102>valeb102</a>,Bobby Valentine,Los Angeles Dodgers,DOGRS,1,5,2,7,1972,1976,4,No,0,16.6,19.03,2.43,596,356,-240,1923,542,-1381,1810.0,2591.0,781.0,251500.0,0.0,-251500.0
<a href=/player/valeb102>valeb102</a>,Bobby Valentine,California Angels,ANGELS,1,2,1,3,1975,1975,0,No,0,0.37,0.02,-0.35,66,1,-65,152,0,-152,0.0,15.0,15.0,0.0,0.0,0.0
<a href=/player/valeb102>valeb102</a>,Bobby Valentine,San Diego Padres,PADRS,1,2,1,3,1977,1977,0,No,0,-0.17,0.36,0.53,215,56,-159,280,187,-93,168.0,0.0,-168.0,0.0,0.0,0.0
<a href=/player/valec101>valec101</a>,Corky Valentine,Cincinnati Reds,REDS,4,7,9,16,1956,1966,10,No,0,6.9,8.42,1.52,812,960,148,2097,3305,1208,111.0,126.0,15.0,0.0,0.0,0.0
<a href=/player/valed001>valed001</a>,Danny Valencia,Minnesota Twins,TWINS,1,1,1,2,2012,2012,0,No,0,-0.13,0.0,0.13,10,0,-10,29,0,-29,0.0,0.0,0.0,515000.0,0.0,-515000.0
<a href=/player/valed001>valed001</a>,Danny Valencia,Baltimore Orioles,ORLS,1,1,1,2,2013,2015,2,No,0,0.33,1.32,0.99,36,196,160,119,341,222,0.0,0.0,0.0,0.0,0.0,0.0
<a href=/player/valed001>valed001</a>,Danny Valencia,Kansas City Royals,ROYALS,2,2,3,5,2014,2015,1,Yes,0,1.34,-0.13,-1.47,175,23,-152,339,36,-303,234.0,58.0,-176.0,1065000.0,0.0,-1065000.0
<a href=/player/valed001>valed001</a>,Danny Valencia,Oakland Athletics,ATLTCS,1,1,1,2,2016,2016,0,Yes,0,1.0,0.0,-1.0,130,0,-130,500,0,-500,0.0,0.0,0.0,3150000.0,0.0,-3150000.0
<a href=/player/valee001>valee001</a>,Ellis Valentine,Montreal Expos,NATEX,10,15,18,33,1981,1996,15,No,0,5.79,9.59,3.8,1470,1819,349,2699,1445,-1254,2901.0,3210.0,309.0,955000.0,0.0,-955000.0
<a href=/player/valee002>valee002</a>,Eric Valent,Philadelphia Phillies,PHILS,1,1,1,2,2003,2003,0,No,0,-0.3,0.08,0.38,18,7,-11,44,8,-36,0.0,0.0,0.0,0.0,0.0,0.0
<a href=/player/valef001>valef001</a>,Fernando Valenzuela,San Diego Padres,PADRS,5,11,12,23,1997,2006,9,No,1,5.86,22.51,16.65,827,1744,917,2661,6285,3624,68.0,189.0,121.0,10901680.0,0.0,-10901680.0
<a href=/player/valef101>valef101</a>,Fred Valentine,Washington Senators,RNGRS,1,1,1,2,1968,1968,0,No,0,-0.23,-0.83,-0.6,47,26,-21,99,16,-83,0.0,146.0,146.0,0.0,0.0,0.0
<a href=/player/valej001>valej001</a>,Julio Valera,New York Mets,METS,1,1,2,3,1992,1992,0,No,0,2.22,2.15,-0.07,49,142,93,0,498,498,723.0,0.0,-723.0,0.0,0.0,0.0
<a href=/player/valej003>valej003</a>,Jose Valentin,San Diego Padres,PADRS,3,6,6,12,1992,2008,16,No,0,33.52,31.92,-1.6,1981,2091,110,6462,948,-5514,2787.0,3132.0,345.0,3375000.0,0.0,-3375000.0
<a href=/player/valej003>valej003</a>,Jose Valentin,Milwaukee Brewers,BREWRS,1,2,2,4,2000,2000,0,No,0,18.62,-2.6,-21.22,696,55,-641,2756,47,-2709,354.0,437.0,83.0,0.0,0.0,0.0
<a href=/player/valej004>valej004</a>,Javier Valentin,Minnesota Twins,TWINS,1,2,2,4,2002,2002,0,No,0,-0.32,0.0,0.32,128,0,-128,72,0,-72,759.0,0.0,-759.0,0.0,0.0,0.0
<a href=/player/valej004>valej004</a>,Javier Valentin,Milwaukee Brewers,BREWRS,1,1,1,2,2003,2003,0,No,0,-0.18,-0.18,0.0,49,30,-19,142,52,-90,0.0,0.0,0.0,0.0,0.0,0.0
<a href=/player/valej005>valej005</a>,Joe Valentine,Chicago White Sox,WSOX,4,7,9,16,2002,2011,9,No,0,3.51,0.6,-2.91,386,338,-48,35,47,12,766.0,905.0,139.0,11095000.0,0.0,-11095000.0
<a href=/player/valej005>valej005</a>,Joe Valentine,Oakland Athletics,ATLTCS,1,3,1,4,2003,2003,0,No,0,14.51,0.2,-14.31,509,45,-464,479,186,-293,4166.0,0.0,-4166.0,0.0,0.0,0.0
<a href=/player/valej006>valej006</a>,Jesmuel Valentin,Los Angeles Dodgers,DOGRS,1,2,1,3,2014,2014,0,No,0,1.78,-0.44,-2.22,191,18,-173,89,15,-74,227.0,131.0,-96.0,0.0,0.0,0.0
<a href=/player/valev101>valev101</a>,Vito Valentinetti,Chicago Cubs,CUBS,1,2,1,3,1957,1965,8,No,0,-0.13,9.65,9.78,10,894,884,1,138,137,23.0,2255.0,2232.0,0.0,0.0,0.0
<a href=/player/valev101>valev101</a>,Vito Valentinetti,Cleveland Indians,INDINS,1,2,2,4,1958,1958,0,No,0,0.0,0.0,0.0,54,0,-54,37,0,-37,56.0,0.0,-56.0,0.0,0.0,0.0
<a href=/player/valev101>valev101</a>,Vito Valentinetti,Detroit Tigers,TIGRS,2,3,4,7,1958,1964,6,No,0,0.54,14.8,14.26,185,334,149,295,362,67,451.0,2919.0,2468.0,0.0,0.0,0.0
<a href=/player/valev101>valev101</a>,Vito Valentinetti,Washington Senators,TWINS,1,1,1,2,1959,1962,3,No,0,0.0,0.0,0.0,0,0,0,0,0,0,0.0,0.0,0.0,0.0,0.0,0.0
<a href=/player/valld001>valld001</a>,Dave Valle,Boston Red Sox,RSOX,1,1,1,2,1994,1994,0,No,0,0.5,0.23,-0.27,16,48,32,46,204,158,0.0,0.0,0.0,1200000.0,0.0,-1200000.0
<a href=/player/vallh101>vallh101</a>,Hector Valle,New York Mets,METS,1,1,1,2,1968,1969,1,No,0,0.0,1.13,1.13,0,46,46,0,12,12,0.0,191.0,191.0,0.0,0.0,0.0
<a href=/player/valoe101>valoe101</a>,Elmer Valo,Philadelphia Phillies,PHILS,2,8,4,12,1957,1962,5,No,0,1.07,-3.22,-4.29,707,621,-86,1985,2063,78,115.0,0.0,-115.0,9000.0,0.0,-9000.0
<a href=/player/valvj001>valvj001</a>,Jose Valverde,Arizona Diamondbacks,DBACKS,2,2,4,6,2007,2011,4,No,0,2.28,-1.01,-3.29,270,701,431,1,203,202,441.0,929.0,488.0,6185000.0,0.0,-6185000.0
<a href=/player/vanca101>vanca101</a>,Al Van Camp,Boston Red Sox,RSOX,9,16,13,29,1933,1943,10,No,0,54.55,36.98,-17.57,2815,1996,-819,9804,5822,-3982,4236.0,5439.0,1203.0,60350.0,0.0,-60350.0
<a href=/player/vancd101>vancd101</a>,Dazzy Vance,Brooklyn Dodgers,DOGRS,1,2,2,4,1933,1934,1,No,0,1.18,1.07,-0.11,133,145,12,117,327,210,474.0,679.0,205.0,0.0,0.0,0.0
<a href=/player/vande001>vande001</a>,Ed Vande Berg,Seattle Mariners,MARNRS,1,1,1,2,1985,1986,1,No,0,0.6,-0.02,-0.62,120,50,-70,1,146,145,214.0,0.0,-214.0,315000.0,0.0,-315000.0
<a href=/player/vandj001>vandj001</a>,John Vander Wal,Colorado Rockies,ROCKS,1,1,1,2,1998,1998,0,No,0,0.94,0.0,-0.94,152,0,-152,319,0,-319,0.0,0.0,0.0,560000.0,0.0,-560000.0
<a href=/player/vandj001>vandj001</a>,John Vander Wal,San Diego Padres,PADRS,2,4,4,8,2000,2002,2,No,0,4.18,0.64,-3.54,373,277,-96,1290,508,-782,0.0,215.0,215.0,1750000.0,0.0,-1750000.0
<a href=/player/vandj001>vandj001</a>,John Vander Wal,Pittsburgh Pirates,PIRATS,1,2,2,4,2001,2006,5,No,0,22.58,-2.33,-24.91,365,279,-86,551,301,-250,3209.0,841.0,-2368.0,5050000.0,0.0,-5050000.0
<a href=/player/vandj001>vandj001</a>,John Vander Wal,San Francisco Giants,GIANTS,1,1,1,2,2001,2002,1,No,0,0.36,1.38,1.02,84,86,2,245,5,-240,0.0,205.0,205.0,0.0,0.0,0.0
<a href=/player/vandr001>vandr001</a>,Rick van den Hurk,Florida Marlins,MARLNS,1,1,1,2,2010,2010,0,No,0,-0.24,0.05,0.29,11,34,23,0,0,0,76.0,36.0,-40.0,0.0,0.0,0.0
<a href=/player/vanej001>vanej001</a>,Jonathan Van Every,Boston Red Sox,RSOX,1,1,1,2,2010,2010,0,No,0,0.0,0.0,0.0,0,0,0,0,0,0,0.0,0.0,0.0,0.0,0.0,0.0
<a href=/player/vanej001>vanej001</a>,Jonathan Van Every,Pittsburgh Pirates,PIRATS,1,1,1,2,2010,2010,0,No,0,-0.08,0.0,0.08,22,0,-22,21,0,-21,3.0,0.0,-3.0,0.0,0.0,0.0
<a href=/player/vange101>vange101</a>,Elam Vangilder,St.Louis Browns,ORLS,22,44,51,95,1927,1952,25,No,0,139.77,131.99,-7.78,6854,9855,3001,22708,32907,10199,12609.0,15510.0,2901.0,213500.0,0.0,-213500.0
<a href=/player/vanha001>vanha001</a>,Andy Van Hekken,Seattle Mariners,MARNRS,1,2,1,3,1999,2000,1,No,0,0.81,-1.0,-1.81,5,121,116,0,527,527,90.0,0.0,-90.0,0.0,0.0,0.0
<a href=/player/vanhg101>vanhg101</a>,George Van Haltren,Pittsburgh Pirates,PIRATS,1,2,1,3,1887,1887,0,No,0,5.98,2.8,-3.18,310,72,-238,1158,138,-1020,1220.0,967.0,-253.0,0.0,0.0,0.0
<a href=/player/vanhg101>vanhg101</a>,George Van Haltren,Baltimore Orioles,BLN,1,1,2,3,1892,1899,7,No,0,3.2,31.31,28.11,137,781,644,667,3624,2957,0.0,0.0,0.0,3500.0,0.0,-3500.0
<a href=/player/vanmj001>vanmj001</a>,Josh VanMeter,San Diego Padres,PADRS,2,5,4,9,2016,2021,5,Yes,0,5.2,-0.79,-5.99,462,106,-356,1663,243,-1420,2.0,42.0,40.0,0.0,0.0,0.0
<a href=/player/vanmj001>vanmj001</a>,Josh VanMeter,Cincinnati Reds,REDS,1,2,2,4,2020,2020,0,No,0,0.09,0.33,0.24,136,6,-130,368,0,-368,0.0,23.0,23.0,0.0,0.0,0.0
<a href=/player/vanpt001>vanpt001</a>,Todd Van Poppel,Texas Rangers,RNGRS,6,10,9,19,1998,2015,17,No,0,5.51,25.74,20.23,761,2021,1260,2144,8331,6187,1539.0,1259.0,-280.0,19651100.0,0.0,-19651100.0
<a href=/player/vanrb001>vanrb001</a>,Ben VanRyn,Montreal Expos,NATEX,1,1,1,2,1991,1991,0,No,0,0.0,0.0,0.0,0,0,0,0,0,0,0.0,0.0,0.0,0.0,0.0,0.0
<a href=/player/vanrb001>vanrb001</a>,Ben VanRyn,Los Angeles Dodgers,DOGRS,1,1,1,2,1994,1998,4,No,0,0.0,-0.13,-0.13,0,3,3,0,0,0,0.0,7.0,7.0,0.0,0.0,0.0
<a href=/player/vanrb001>vanrb001</a>,Ben VanRyn,California Angels,ANGELS,2,2,2,4,1996,1997,1,No,0,-0.03,0.05,0.08,31,22,-9,102,61,-41,0.0,15.0,15.0,0.0,0.0,0.0
<a href=/player/vanrb001>vanrb001</a>,Ben VanRyn,Chicago Cubs,CUBS,1,1,1,2,1998,1998,0,No,0,-0.14,0.13,0.27,12,44,32,0,15,15,8.0,149.0,141.0,170000.0,0.0,-170000.0
<a href=/player/vansa001>vansa001</a>,Andy Van Slyke,St. Louis Cardinals,CARDS,2,4,3,7,1987,1997,10,No,2,43.01,2.09,-40.92,1782,407,-1375,6646,1438,-5208,1043.0,0.0,-1043.0,0.0,0.0,0.0
<a href=/player/vansa001>vansa001</a>,Andy Van Slyke,Baltimore Orioles,ORLS,1,1,1,2,1995,1995,0,No,0,0.25,0.05,-0.2,63,3,-60,247,0,-247,0.0,12.0,12.0,600000.0,0.0,-600000.0
<a href=/player/vanss001>vanss001</a>,Scott Van Slyke,Los Angeles Dodgers,DOGRS,2,4,3,7,2017,2019,2,No,0,0.0,-0.41,-0.41,0,127,127,0,39,39,0.0,126.0,126.0,1325000.0,0.0,-1325000.0
<a href=/player/vargc001>vargc001</a>,Claudio Vargas,Florida Marlins,MARLNS,3,7,8,15,2002,2012,10,No,2,-0.85,8.19,9.04,199,784,585,190,1558,1368,741.0,2057.0,1316.0,6500000.0,0.0,-6500000.0
<a href=/player/vargc001>vargc001</a>,Claudio Vargas,Arizona Diamondbacks,DBACKS,7,17,19,36,2006,2018,12,Yes,0,24.81,35.93,11.12,1150,1382,232,1829,2226,397,7355.0,7967.0,612.0,18358000.0,0.0,-18358000.0
<a href=/player/vargc001>vargc001</a>,Claudio Vargas,Los Angeles Dodgers,DOGRS,1,1,1,2,2009,2009,0,No,0,0.64,0.0,-0.64,89,0,-89,3,0,-3,150.0,0.0,-150.0,400000.0,0.0,-400000.0
<a href=/player/vargj001>vargj001</a>,Jason Vargas,Florida Marlins,MARLNS,2,3,5,8,2006,2009,3,No,0,0.88,2.31,1.43,194,420,226,65,1,-64,750.0,584.0,-166.0,737000.0,0.0,-737000.0
<a href=/player/vargj001>vargj001</a>,Jason Vargas,New York Mets,METS,1,7,3,10,2008,2010,2,No,0,8.89,-1.25,-10.14,554,358,-196,1346,179,-1167,2162.0,325.0,-1837.0,3398000.0,0.0,-3398000.0
<a href=/player/vargj001>vargj001</a>,Jason Vargas,Seattle Mariners,MARNRS,1,1,1,2,2012,2013,1,No,0,1.95,2.86,0.91,24,156,132,0,657,657,450.0,0.0,-450.0,4850000.0,0.0,-4850000.0
<a href=/player/vargj001>vargj001</a>,Jason Vargas,New York Mets,METS,1,1,1,2,2019,2019,0,Yes,0,-0.5,0.0,0.5,21,0,-21,14,0,-14,166.0,0.0,-166.0,8000000.0,0.0,-8000000.0
<a href=/player/varij001>varij001</a>,Jason Varitek,Seattle Mariners,MARNRS,1,2,1,3,1997,1998,1,No,0,43.6,0.43,-43.17,1956,90,-1866,5862,0,-5862,3111.0,288.0,-2823.0,0.0,0.0,0.0
<a href=/player/varnp101>varnp101</a>,Pete Varney,Chicago White Sox,WSOX,1,1,1,2,1976,1977,1,No,0,-0.29,-0.38,-0.09,5,8,3,10,0,-10,0.0,84.0,84.0,0.0,0.0,0.0
<a href=/player/varsg001>varsg001</a>,Gary Varsho,Chicago Cubs,CUBS,1,1,1,2,1991,1991,0,No,0,0.39,0.0,-0.39,269,0,-269,473,0,-473,0.0,0.0,0.0,0.0,0.0,0.0
<a href=/player/varva001>varva001</a>,Anthony Varvaro,Atlanta Braves,BRAVES,1,1,2,3,2014,2014,0,Yes,0,0.13,0.0,-0.13,9,0,-9,0,0,0,33.0,0.0,-33.0,515000.0,0.0,-515000.0
<a href=/player/vasqa002>vasqa002</a>,Andrew Vasquez,Minnesota Twins,TWINS,1,1,1,2,2021,2021,0,Yes,0,0.08,0.0,-0.08,4,0,-4,0,0,0,5.0,0.0,-5.0,0.0,0.0,0.0
<a href=/player/vasqj001>vasqj001</a>,Jorge Vasquez,Kansas City Royals,ROYALS,2,3,3,6,2004,2005,1,No,0,0.31,-1.05,-1.36,34,32,-2,57,100,43,27.0,0.0,-27.0,3200000.0,0.0,-3200000.0
<a href=/player/vasqr101>vasqr101</a>,Rafael Vasquez,Pittsburgh Pirates,PIRATS,1,3,3,6,1978,1978,0,No,0,-3.43,0.0,3.43,296,0,-296,706,0,-706,404.0,0.0,-404.0,0.0,0.0,0.0
<a href=/player/vasqr101>vasqr101</a>,Rafael Vasquez,Seattle Mariners,MARNRS,1,3,1,4,1979,1981,2,No,0,2.1,-0.37,-2.47,64,83,19,0,269,269,447.0,0.0,-447.0,0.0,0.0,0.0
<a href=/player/vasqr101>vasqr101</a>,Rafael Vasquez,Cleveland Indians,INDINS,6,11,12,23,1980,2011,31,No,2,35.2,55.22,20.02,1530,2690,1160,5654,9199,3545,2682.0,4370.0,1688.0,1767500.0,0.0,-1767500.0
<a href=/player/vasqv001>vasqv001</a>,Virgil Vasquez,Pittsburgh Pirates,PIRATS,1,1,1,2,2010,2010,0,No,0,0.0,0.0,0.0,0,0,0,0,0,0,0.0,0.0,0.0,0.0,0.0,0.0
<a href=/player/vastj001>vastj001</a>,Jerry Vasto,Colorado Rockies,ROCKS,1,1,2,3,2018,2018,0,No,0,0.0,0.02,0.02,5,10,5,0,16,16,11.0,0.0,-11.0,0.0,0.0,0.0
<a href=/player/vatcj001>vatcj001</a>,Jim Vatcher,Philadelphia Phillies,PHILS,1,3,2,5,1990,1996,6,No,0,0.28,7.71,7.43,106,447,341,38,1122,1084,145.0,1741.0,1596.0,750000.0,0.0,-750000.0
<a href=/player/vauga101>vauga101</a>,Arky Vaughan,Pittsburgh Pirates,PIRATS,3,4,6,10,1941,1946,5,No,0,11.58,5.96,-5.62,464,1100,636,1609,4195,2586,570.0,336.0,-234.0,0.0,0.0,0.0
<a href=/player/vaugg001>vaugg001</a>,Greg Vaughn,Milwaukee Brewers,BREWRS,8,13,15,28,1996,2006,10,No,0,13.14,4.75,-8.39,1056,1863,807,2193,3091,898,1015.0,2798.0,1783.0,17862000.0,0.0,-17862000.0
<a href=/player/vaugg001>vaugg001</a>,Greg Vaughn,San Diego Padres,PADRS,4,8,9,17,1999,2006,7,No,1,6.95,24.07,17.12,734,1502,768,2481,5933,3452,0.0,4.0,4.0,8651680.0,0.0,-8651680.0
<a href=/player/vaugh101>vaugh101</a>,Hippo Vaughn,Washington Senators,TWINS,2,4,4,8,1912,1919,7,No,0,0.15,11.96,11.81,110,595,485,129,1405,1276,1048.0,2565.0,1517.0,3200.0,0.0,-3200.0
<a href=/player/vaugh101>vaugh101</a>,Hippo Vaughn,KansasCity,KansasCity,1,1,1,2,1913,1913,0,No,0,40.38,0.0,-40.38,612,0,-612,821,0,-821,6642.0,0.0,-6642.0,0.0,0.0,0.0
<a href=/player/vaugm001>vaugm001</a>,Mo Vaughn,Anaheim Angels,ANGELS,1,1,1,2,2001,2003,2,No,0,-1.24,1.49,2.73,166,55,-111,654,9,-645,0.0,843.0,843.0,0.0,0.0,0.0
<a href=/player/vazqj001>vazqj001</a>,Javier Vazquez,Montreal Expos,NATEX,6,9,8,17,2003,2012,9,No,1,22.54,17.36,-5.18,1678,1024,-654,5174,3425,-1749,1287.0,826.0,-461.0,11812000.0,0.0,-11812000.0
<a href=/player/vazqj001>vazqj001</a>,Javier Vazquez,New York Yankees,YANKS,7,16,12,28,2005,2014,9,Yes,2,13.28,19.25,5.97,1549,974,-575,2912,2867,-45,5079.0,1808.0,-3271.0,1556425.0,0.0,-1556425.0
<a href=/player/vazqj001>vazqj001</a>,Javier Vazquez,Arizona Diamondbacks,DBACKS,8,18,14,32,2005,2017,12,Yes,0,11.66,26.28,14.62,663,1746,1083,1106,4655,3549,3122.0,1995.0,-1127.0,34900000.0,0.0,-34900000.0
<a href=/player/vazqj001>vazqj001</a>,Javier Vazquez,Chicago White Sox,WSOX,2,4,6,10,2008,2015,7,No,0,5.25,6.88,1.63,121,767,646,107,2238,2131,727.0,0.0,-727.0,11905000.0,0.0,-11905000.0
<a href=/player/vazqj001>vazqj001</a>,Javier Vazquez,Atlanta Braves,BRAVES,3,6,8,14,2009,2014,5,No,0,9.14,2.66,-6.48,1368,918,-450,996,2818,1822,2035.0,774.0,-1261.0,14152500.0,0.0,-14152500.0
<a href=/player/vazqr001>vazqr001</a>,Ramon Vazquez,Seattle Mariners,MARNRS,12,24,25,49,2001,2015,14,No,0,25.13,36.61,11.48,2313,2617,304,5473,8533,3060,4049.0,2794.0,-1255.0,29602500.0,0.0,-29602500.0
<a href=/player/vazqr001>vazqr001</a>,Ramon Vazquez,San Diego Padres,PADRS,3,7,4,11,2004,2011,7,No,2,31.04,4.47,-26.57,314,404,90,240,1711,1471,4110.0,0.0,-4110.0,1842500.0,0.0,-1842500.0
<a href=/player/vazqr001>vazqr001</a>,Ramon Vazquez,Boston Red Sox,RSOX,1,1,1,2,2005,2008,3,No,0,-1.15,2.32,3.47,46,301,255,103,791,688,0.0,0.0,0.0,700000.0,0.0,-700000.0
<a href=/player/veacb101>veacb101</a>,Bobby Veach,Boston Red Sox,RSOX,1,2,2,4,1925,1925,0,No,0,-1.49,-0.59,0.9,98,12,-86,146,10,-136,166.0,84.0,-82.0,14000.0,0.0,-14000.0
<a href=/player/vealc101>vealc101</a>,Coot Veal,Los Angeles Angels,ANGELS,1,1,1,2,1960,1961,1,No,0,-0.75,0.58,1.33,69,66,-3,252,276,24,0.0,0.0,0.0,0.0,0.0,0.0
<a href=/player/vealc101>vealc101</a>,Coot Veal,Pittsburgh Pirates,PIRATS,1,1,1,2,1962,1962,0,No,0,-0.19,0.0,0.19,15,0,-15,37,0,-37,0.0,0.0,0.0,0.0,0.0,0.0
<a href=/player/velaa001>velaa001</a>,Andrew Velazquez,Arizona Diamondbacks,DBACKS,3,7,4,11,2014,2019,5,Yes,0,3.79,-0.16,-3.95,192,125,-67,130,321,191,1136.0,438.0,-698.0,4275000.0,0.0,-4275000.0
<a href=/player/velaa001>velaa001</a>,Andrew Velazquez,Tampa Bay Devil Rays,RAYS,1,1,1,2,2019,2019,0,No,0,0.01,0.0,-0.01,5,0,-5,12,0,-12,0.0,0.0,0.0,0.0,0.0,0.0
<a href=/player/velah001>velah001</a>,Hector Velazquez,Baltimore Orioles,ORLS,1,1,1,2,2020,2020,0,Yes,0,0.0,0.0,0.0,0,0,0,0,0,0,0.0,0.0,0.0,0.0,0.0,0.0
<a href=/player/velaj001>velaj001</a>,Jorge Velandia,Detroit Tigers,TIGRS,1,2,1,3,1994,1994,0,No,0,0.37,-0.32,-0.69,295,11,-284,639,0,-639,0.0,34.0,34.0,365000.0,0.0,-365000.0
<a href=/player/velaj001>velaj001</a>,Jorge Velandia,San Diego Padres,PADRS,3,4,4,8,1997,2000,3,No,0,-0.13,-0.75,-0.62,150,123,-27,122,262,140,149.0,49.0,-100.0,693000.0,0.0,-693000.0
<a href=/player/velaj001>velaj001</a>,Jorge Velandia,Oakland Athletics,ATLTCS,2,3,2,5,2000,2006,6,No,0,-0.54,-0.87,-0.33,133,51,-82,102,156,54,151.0,0.0,-151.0,219500.0,0.0,-219500.0
<a href=/player/velar001>velar001</a>,Randy Velarde,Chicago White Sox,WSOX,6,11,12,23,1987,1997,10,No,0,68.61,10.72,-57.89,2705,1926,-779,10284,5529,-4755,1119.0,1575.0,456.0,1600000.0,0.0,-1600000.0
<a href=/player/velar001>velar001</a>,Randy Velarde,Anaheim Angels,ANGELS,1,2,3,5,1999,2005,6,No,0,5.25,4.59,-0.66,273,402,129,988,1145,157,548.0,0.0,-548.0,3425000.0,0.0,-3425000.0
<a href=/player/velar001>velar001</a>,Randy Velarde,Oakland Athletics,ATLTCS,2,4,3,7,2000,2003,3,No,0,16.02,0.77,-15.25,587,71,-516,813,190,-623,4166.0,326.0,-3840.0,3050000.0,0.0,-3050000.0
<a href=/player/velar001>velar001</a>,Randy Velarde,Texas Rangers,RNGRS,1,1,2,3,2001,2005,4,No,0,0.36,-0.24,-0.6,15,75,60,55,0,-55,0.0,195.0,195.0,3150000.0,0.0,-3150000.0
<a href=/player/velav001>velav001</a>,Vincent Velasquez,Houston Astros,ASTROS,2,8,3,11,2015,2020,5,No,0,7.89,4.62,-3.27,397,276,-121,183,0,-183,2153.0,753.0,-1400.0,5115800.0,0.0,-5115800.0
<a href=/player/venam001>venam001</a>,Max Venable,San Francisco Giants,GIANTS,3,6,4,10,1984,1992,8,No,0,-0.38,4.13,4.51,126,534,408,225,652,427,93.0,2798.0,2705.0,0.0,0.0,0.0
<a href=/player/venam001>venam001</a>,Max Venable,Montreal Expos,NATEX,2,3,3,6,1985,1992,7,No,0,0.8,2.75,1.95,294,716,422,339,1893,1554,201.0,144.0,-57.0,415000.0,0.0,-415000.0
<a href=/player/venam002>venam002</a>,Mike Venafro,Texas Rangers,RNGRS,6,7,11,18,2002,2013,11,No,0,4.52,9.79,5.27,476,622,146,1358,1735,377,495.0,2132.0,1637.0,1600000.0,0.0,-1600000.0
<a href=/player/venam002>venam002</a>,Mike Venafro,Kansas City Royals,ROYALS,1,1,1,2,2004,2004,0,No,0,0.03,0.0,-0.03,34,0,-34,0,0,0,27.0,0.0,-27.0,0.0,0.0,0.0
<a href=/player/venaw001>venaw001</a>,Will Venable,San Diego Padres,PADRS,1,1,2,3,2015,2017,2,Yes,0,-0.05,0.11,0.16,37,22,-15,82,0,-82,0.0,32.0,32.0,4250000.0,0.0,-4250000.0
<a href=/player/vendp001>vendp001</a>,Pat Venditte,Toronto Blue Jays,BJAYS,1,1,1,2,2016,2018,2,No,0,-0.15,0.0,0.15,7,0,-7,0,0,0,40.0,0.0,-40.0,0.0,0.0,0.0
<a href=/player/vendp001>vendp001</a>,Pat Venditte,Seattle Mariners,MARNRS,1,1,1,2,2017,2017,0,Yes,0,0.0,0.0,0.0,0,0,0,0,0,0,0.0,0.0,0.0,0.0,0.0,0.0
<a href=/player/ventj001>ventj001</a>,Jonny Venters,Tampa Bay Devil Rays,RAYS,1,1,1,2,2018,2018,0,No,0,-0.78,0.0,0.78,74,0,-74,0,0,0,75.0,0.0,-75.0,0.0,0.0,0.0
<a href=/player/ventr001>ventr001</a>,Robin Ventura,New York Mets,METS,2,2,3,5,2001,2005,4,No,0,7.09,0.66,-6.43,348,175,-173,1359,14,-1345,0.0,284.0,284.0,8000000.0,0.0,-8000000.0
<a href=/player/ventr001>ventr001</a>,Robin Ventura,New York Yankees,YANKS,4,6,6,12,2003,2013,10,Yes,1,-0.94,12.92,13.86,321,1121,800,352,3051,2699,235.0,682.0,447.0,6620923.0,0.0,-6620923.0
<a href=/player/verad001>verad001</a>,Dario Veras,San Diego Padres,PADRS,4,8,7,15,1998,2002,4,No,0,4.23,0.82,-3.41,472,389,-83,1448,834,-614,139.0,215.0,76.0,3650000.0,0.0,-3650000.0
<a href=/player/veraj001>veraj001</a>,Jose Veras,Pittsburgh Pirates,PIRATS,2,2,2,4,2011,2012,1,No,0,-0.13,0.08,0.21,161,126,-35,59,293,234,201.0,41.0,-160.0,2537500.0,0.0,-2537500.0
<a href=/player/veraj001>veraj001</a>,Jose Veras,Houston Astros,ASTROS,2,4,3,7,2013,2020,7,Yes,0,2.74,2.61,-0.13,120,107,-13,0,0,0,313.0,384.0,71.0,4600000.0,0.0,-4600000.0
<a href=/player/veraq001>veraq001</a>,Quilvio Veras,New York Mets,METS,3,3,3,6,1994,1998,4,No,0,13.47,2.48,-10.99,517,448,-69,1904,1221,-683,114.0,81.0,-33.0,704000.0,0.0,-704000.0
<a href=/player/veraq001>veraq001</a>,Quilvio Veras,Florida Marlins,MARLNS,5,10,10,20,1996,2012,16,No,2,13.89,25.06,11.17,984,1421,437,2411,4127,1716,3020.0,2057.0,-963.0,6730000.0,0.0,-6730000.0
<a href=/player/veraq001>veraq001</a>,Quilvio Veras,San Diego Padres,PADRS,2,4,4,8,1999,2006,7,No,1,3.54,15.79,12.25,377,961,584,1296,3858,2562,0.0,4.0,4.0,8651680.0,0.0,-8651680.0
<a href=/player/verbe101>verbe101</a>,Emil Verban,St. Louis Cardinals,CARDS,1,1,1,2,1946,1946,0,No,0,1.87,0.31,-1.56,348,52,-296,1271,151,-1120,0.0,0.0,0.0,0.0,0.0,0.0
<a href=/player/verbe101>verbe101</a>,Emil Verban,Boston Braves,BRAVES,1,3,1,4,1950,1955,5,No,0,0.0,4.71,4.71,0,200,200,0,221,221,0.0,1757.0,1757.0,0.0,0.0,0.0
<a href=/player/verbj101>verbj101</a>,Joe Verbanic,Philadelphia Phillies,PHILS,1,2,1,3,1966,1967,1,No,0,2.28,-0.25,-2.53,150,12,-138,53,1,-52,579.0,24.0,-555.0,6000.0,0.0,-6000.0
<a href=/player/verda001>verda001</a>,Alex Verdugo,Los Angeles Dodgers,DOGRS,1,3,3,6,2020,2020,0,Yes,0,4.62,3.6,-1.02,205,55,-150,839,246,-593,0.0,0.0,0.0,0.0,0.0,0.0
<a href=/player/verdr001>verdr001</a>,Ryan Verdugo,San Francisco Giants,GIANTS,1,2,1,3,2011,2012,1,No,0,-1.57,4.82,6.39,14,113,99,2,501,499,165.0,0.0,-165.0,4800000.0,0.0,-4800000.0
<a href=/player/vered001>vered001</a>,Dave Veres,Oakland Athletics,ATLTCS,1,1,1,2,1991,1993,2,No,0,0.0,-0.19,-0.19,0,57,57,0,0,0,0.0,312.0,312.0,0.0,0.0,0.0
<a href=/player/vered001>vered001</a>,Dave Veres,Houston Astros,ASTROS,1,2,1,3,1995,1998,3,No,0,1.28,3.85,2.57,256,330,74,42,1150,1108,419.0,0.0,-419.0,125000.0,0.0,-125000.0
<a href=/player/vered001>vered001</a>,Dave Veres,Montreal Expos,NATEX,1,2,2,4,1997,1999,2,No,0,4.68,1.62,-3.06,267,77,-190,4,314,310,460.0,0.0,-460.0,725000.0,0.0,-725000.0
<a href=/player/vered001>vered001</a>,Dave Veres,Colorado Rockies,ROCKS,13,23,24,47,1999,2003,4,No,0,20.8,11.07,-9.73,2188,1626,-562,1402,1034,-368,5980.0,2442.0,-3538.0,24071314.0,0.0,-24071314.0
<a href=/player/verer001>verer001</a>,Randy Veres,Florida Marlins,MARLNS,1,1,1,2,1996,1996,0,No,0,-0.7,0.0,0.7,25,0,-25,0,0,0,91.0,0.0,-91.0,0.0,0.0,0.0
<a href=/player/vergj101>vergj101</a>,Johnny Vergez,New York Giants,GIANTS,3,12,5,17,1934,1949,15,No,0,8.76,66.74,57.98,1268,2382,1114,4502,9585,5083,296.0,0.0,-296.0,0.0,0.0,0.0
<a href=/player/verhj101>verhj101</a>,John Verhoeven,California Angels,ANGELS,1,3,1,4,1977,1979,2,No,0,0.12,1.23,1.11,29,53,24,3,0,-3,151.0,726.0,575.0,0.0,0.0,0.0
<a href=/player/verlj001>verlj001</a>,Justin Verlander,Detroit Tigers,TIGRS,1,3,3,6,2017,2017,0,Yes,0,16.16,0.0,-16.16,77,0,-77,7,0,-7,1431.0,0.0,-1431.0,0.0,0.0,0.0
<a href=/player/vernm101>vernm101</a>,Mickey Vernon,Washington Senators,TWINS,13,25,27,52,1948,1963,15,No,0,65.65,20.21,-45.44,3128,2926,-202,8413,6562,-1851,9264.0,7302.0,-1962.0,32000.0,0.0,-32000.0
<a href=/player/vernm101>vernm101</a>,Mickey Vernon,Cleveland Indians,INDINS,5,9,8,17,1950,1960,10,No,0,47.08,3.02,-44.06,2365,489,-1876,7147,530,-6617,4632.0,1673.0,-2959.0,15900.0,0.0,-15900.0
<a href=/player/vernm101>vernm101</a>,Mickey Vernon,Washington Senators,TWINS,7,16,14,30,1955,1963,8,No,0,11.54,-1.9,-13.44,1150,1625,475,3478,3777,299,832.0,1792.0,960.0,17500.0,0.0,-17500.0
<a href=/player/vernm101>vernm101</a>,Mickey Vernon,Cleveland Indians,INDINS,2,2,2,4,1959,1959,0,No,0,1.75,-0.34,-2.09,202,37,-165,122,69,-53,368.0,26.0,-342.0,0.0,0.0,0.0
<a href=/player/versz101>versz101</a>,Zoilo Versalles,Minnesota Twins,TWINS,3,7,7,14,1967,1971,4,No,0,19.69,11.71,-7.98,1089,1188,99,3536,1015,-2521,872.0,2508.0,1636.0,193000.0,0.0,-193000.0
<a href=/player/versz101>versz101</a>,Zoilo Versalles,San Diego Padres,PADRS,2,3,3,6,1968,1970,2,No,0,0.13,-0.12,-0.25,138,118,-20,364,329,-35,0.0,0.0,0.0,7500.0,0.0,-7500.0
<a href=/player/veryt001>veryt001</a>,Tom Veryzer,Detroit Tigers,TIGRS,1,1,1,2,1977,1978,1,No,0,-0.46,0.01,0.47,463,10,-453,1581,32,-1549,0.0,0.0,0.0,40000.0,0.0,-40000.0
<a href=/player/veryt001>veryt001</a>,Tom Veryzer,Cleveland Indians,INDINS,1,1,1,2,1982,1982,0,No,0,-0.21,0.0,0.21,40,0,-40,58,0,-58,0.0,0.0,0.0,0.0,0.0,0.0
<a href=/player/veryt001>veryt001</a>,Tom Veryzer,New York Mets,METS,1,1,2,3,1983,1983,0,No,0,-1.38,0.0,1.38,103,0,-103,175,0,-175,0.0,0.0,0.0,0.0,0.0,0.0
<a href=/player/veseb101>veseb101</a>,Bob Veselic,Minnesota Twins,TWINS,1,1,1,2,1983,1985,2,No,0,0.0,0.29,0.29,0,132,132,0,0,0,0.0,728.0,728.0,0.0,0.0,0.0
<a href=/player/vesia001>vesia001</a>,Alex Vesia,Miami Marlins,MARLNS,1,2,1,3,2021,2021,0,Yes,0,0.61,1.46,0.85,82,133,51,4,0,-4,120.0,192.0,72.0,0.0,0.0,0.0
<a href=/player/vicks101>vicks101</a>,Sammy Vick,New York Yankees,YANKS,4,8,10,18,1920,1931,11,No,0,18.87,48.71,29.84,1297,1673,376,4337,4022,-315,1020.0,6917.0,5897.0,44500.0,0.0,-44500.0
<a href=/player/vickt101>vickt101</a>,Tom Vickery,Philadelphia Phillies,PHILS,1,2,1,3,1891,1891,0,No,0,0.0,2.31,2.31,0,76,76,0,125,125,0.0,807.0,807.0,0.0,0.0,0.0
<a href=/player/vicos101>vicos101</a>,Sam Vico,Detroit Tigers,TIGRS,1,2,1,3,1951,1951,0,No,0,0.0,-0.4,-0.4,0,12,12,0,2,2,0.0,32.0,32.0,0.0,0.0,0.0
<a href=/player/victs001>victs001</a>,Shane Victorino,Philadelphia Phillies,PHILS,4,7,7,14,2012,2015,3,No,0,1.82,-2.18,-4.0,133,216,83,372,522,150,193.0,209.0,16.0,9996000.0,0.0,-9996000.0
<a href=/player/victs001>victs001</a>,Shane Victorino,Boston Red Sox,RSOX,1,2,1,3,2015,2016,1,No,0,-0.33,0.17,0.5,38,67,29,98,141,43,0.0,0.0,0.0,13000000.0,0.0,-13000000.0
<a href=/player/vidaj101>vidaj101</a>,Jose Vidal,Seattle Pilots,BREWRS,3,4,3,7,1969,1970,1,No,0,2.45,-0.52,-2.97,213,90,-123,45,101,56,485.0,396.0,-89.0,60000.0,0.0,-60000.0
<a href=/player/vidrj001>vidrj001</a>,Jose Vidro,Washington Nationals,NATEX,9,14,14,28,2006,2020,14,Yes,0,5.07,16.75,11.68,804,1666,862,1696,2244,548,1207.0,2502.0,1295.0,16181616.0,0.0,-16181616.0
<a href=/player/vieit001>vieit001</a>,Thyago Vieira,Seattle Mariners,MARNRS,1,1,1,2,2017,2017,0,No,0,-0.43,0.0,0.43,23,0,-23,0,0,0,74.0,0.0,-74.0,0.0,0.0,0.0
<a href=/player/viele001>viele001</a>,Engelb Vielma,San Francisco Giants,GIANTS,1,1,1,2,2018,2018,0,No,0,-0.02,0.0,0.02,6,0,-6,8,0,-8,0.0,0.0,0.0,0.0,0.0,0.0
<a href=/player/villb001>villb001</a>,Brandon Villafuerte,New York Mets,METS,3,6,4,10,1998,2002,4,No,0,4.04,-0.58,-4.62,267,21,-246,904,25,-879,36.0,163.0,127.0,362500.0,0.0,-362500.0
<a href=/player/villb001>villb001</a>,Brandon Villafuerte,Florida Marlins,MARLNS,1,1,1,2,1999,1999,0,No,0,-0.11,0.0,0.11,3,0,-3,0,0,0,13.0,0.0,-13.0,0.0,0.0,0.0
<a href=/player/villb001>villb001</a>,Brandon Villafuerte,Detroit Tigers,TIGRS,1,2,1,3,2000,2002,2,No,0,-0.26,-0.7,-0.44,6,35,29,0,0,0,17.0,149.0,132.0,0.0,0.0,0.0
<a href=/player/villb002>villb002</a>,Brayan Villarreal,Detroit Tigers,TIGRS,1,2,1,3,2013,2018,5,No,0,0.0,7.04,7.04,2,558,556,0,2068,2068,0.0,0.0,0.0,0.0,0.0,0.0
<a href=/player/villc001>villc001</a>,Carlos Villanueva,San Francisco Giants,GIANTS,1,2,2,4,2004,2005,1,No,0,2.11,-0.79,-2.9,447,88,-359,72,5,-67,1275.0,156.0,-1119.0,0.0,0.0,0.0
<a href=/player/villc002>villc002</a>,Christian Villanueva,Texas Rangers,RNGRS,1,2,1,3,2012,2012,0,No,0,22.27,0.17,-22.1,395,12,-383,404,0,-404,3685.0,207.0,-3478.0,0.0,0.0,0.0
<a href=/player/ville001>ville001</a>,Eduardo Villacis,Colorado Rockies,ROCKS,1,1,1,2,2002,2002,0,No,0,-0.19,0.0,0.19,1,0,-1,0,0,0,10.0,0.0,-10.0,0.0,0.0,0.0
<a href=/player/villi001>villi001</a>,Ismael Villegas,Chicago Cubs,CUBS,3,3,3,6,1996,2003,7,No,0,-0.22,-0.8,-0.58,15,461,446,31,1239,1208,8.0,0.0,-8.0,715000.0,0.0,-715000.0
<a href=/player/villj001>villj001</a>,Jonathan Villar,Philadelphia Phillies,PHILS,1,3,1,4,2010,2011,1,No,0,1.12,5.11,3.99,320,74,-246,775,83,-692,998.0,665.0,-333.0,470000.0,0.0,-470000.0
<a href=/player/villj001>villj001</a>,Jonathan Villar,Houston Astros,ASTROS,1,1,1,2,2015,2020,5,No,0,4.6,-0.41,-5.01,365,26,-339,1394,0,-1394,0.0,116.0,116.0,0.0,0.0,0.0
<a href=/player/villj001>villj001</a>,Jonathan Villar,Milwaukee Brewers,BREWRS,1,3,1,4,2018,2018,0,No,0,5.49,-0.04,-5.53,219,46,-173,950,134,-816,17.0,0.0,-17.0,2550000.0,0.0,-2550000.0
<a href=/player/villj001>villj001</a>,Jonathan Villar,Baltimore Orioles,ORLS,1,1,1,2,2019,2019,0,Yes,0,-0.04,0.0,0.04,30,0,-30,128,0,-128,0.0,0.0,0.0,4825000.0,0.0,-4825000.0
<a href=/player/villj001>villj001</a>,Jonathan Villar,Miami Marlins,MARLNS,1,1,1,2,2020,2020,0,Yes,0,-0.1,0.0,0.1,22,0,-22,79,0,-79,0.0,0.0,0.0,8200000.0,0.0,-8200000.0
<a href=/player/villo001>villo001</a>,Oscar Villarreal,Arizona Diamondbacks,DBACKS,8,19,20,39,2005,2018,13,Yes,0,24.88,36.62,11.74,1440,1497,57,1874,2669,795,8219.0,7967.0,-252.0,18358000.0,0.0,-18358000.0
<a href=/player/villo001>villo001</a>,Oscar Villarreal,Atlanta Braves,BRAVES,2,2,2,4,2007,2009,2,No,0,-0.62,1.24,1.86,142,40,-102,176,146,-30,113.0,0.0,-113.0,925000.0,0.0,-925000.0
<a href=/player/villr001>villr001</a>,Ron Villone,Seattle Mariners,MARNRS,1,2,2,4,1995,1995,0,No,0,0.73,0.19,-0.54,185,12,-173,270,0,-270,132.0,189.0,57.0,224000.0,0.0,-224000.0
<a href=/player/villr001>villr001</a>,Ron Villone,San Diego Padres,PADRS,5,11,11,22,1996,2006,10,No,1,7.75,31.03,23.28,1053,1823,770,3065,7183,4118,514.0,4.0,-510.0,9096680.0,0.0,-9096680.0
<a href=/player/villr001>villr001</a>,Ron Villone,Milwaukee Brewers,BREWRS,2,5,3,8,1997,2001,4,No,0,0.99,0.01,-0.98,271,614,343,839,2349,1510,81.0,415.0,334.0,6930000.0,0.0,-6930000.0
<a href=/player/villr001>villr001</a>,Ron Villone,Cincinnati Reds,REDS,1,1,2,3,2000,2000,0,No,0,-0.48,0.0,0.48,44,0,-44,11,0,-11,140.0,0.0,-140.0,1600000.0,0.0,-1600000.0
<a href=/player/villr001>villr001</a>,Ron Villone,Colorado Rockies,ROCKS,1,1,1,2,2001,2001,0,No,0,0.55,0.67,0.12,98,75,-23,59,0,-59,524.0,116.0,-408.0,2800000.0,0.0,-2800000.0
<a href=/player/villr001>villr001</a>,Ron Villone,Seattle Mariners,MARNRS,2,2,3,5,2005,2008,3,No,0,-0.3,0.0,0.3,69,0,-69,1,0,-1,151.0,0.0,-151.0,1950000.0,0.0,-1950000.0
<a href=/player/villr001>villr001</a>,Ron Villone,Florida Marlins,MARLNS,1,1,1,2,2005,2005,0,No,0,0.68,0.0,-0.68,117,0,-117,0,0,0,368.0,0.0,-368.0,0.0,0.0,0.0
<a href=/player/vinaf001>vinaf001</a>,Fernando Vina,New York Mets,METS,1,2,1,3,1994,1996,2,No,0,5.97,0.34,-5.63,528,218,-310,2187,7,-2180,0.0,427.0,427.0,120000.0,0.0,-120000.0
<a href=/player/vinaf001>vinaf001</a>,Fernando Vina,Milwaukee Brewers,BREWRS,3,5,8,13,1999,2004,5,No,0,6.18,4.51,-1.67,713,592,-121,2226,61,-2165,355.0,1056.0,701.0,3700000.0,0.0,-3700000.0
<a href=/player/vincn001>vincn001</a>,Nick Vincent,San Diego Padres,PADRS,1,1,1,2,2016,2016,0,No,0,2.34,0.0,-2.34,205,0,-205,0,0,0,544.0,0.0,-544.0,0.0,0.0,0.0
<a href=/player/vinik001>vinik001</a>,Ken Vining,San Francisco Giants,GIANTS,4,11,8,19,1997,2001,4,No,4,22.98,0.1,-22.88,1111,210,-901,1153,268,-885,2846.0,875.0,-1971.0,0.0,0.0,0.0
<a href=/player/violf001>violf001</a>,Frank Viola,Minnesota Twins,TWINS,5,6,13,19,1989,2000,11,No,0,15.8,32.13,16.33,867,1585,718,294,2714,2420,3364.0,8064.0,4700.0,11729166.0,0.0,-11729166.0
<a href=/player/virdb101>virdb101</a>,Bill Virdon,New York Yankees,YANKS,2,5,3,8,1954,1955,1,No,0,3.52,0.32,-3.2,493,79,-414,1250,164,-1086,274.0,0.0,-274.0,20000.0,0.0,-20000.0
<a href=/player/virdb101>virdb101</a>,Bill Virdon,St. Louis Cardinals,CARDS,22,48,42,90,1956,1972,16,No,0,75.15,67.05,-8.1,7158,3428,-3730,19510,9607,-9903,6403.0,6194.0,-209.0,130500.0,0.0,-130500.0
<a href=/player/virgo001>virgo001</a>,Ozzie Virgil,Philadelphia Phillies,PHILS,7,11,13,24,1985,2002,17,No,0,26.27,18.31,-7.96,2374,2693,319,6477,5504,-973,2850.0,5172.0,2322.0,2160000.0,0.0,-2160000.0
<a href=/player/virgo101>virgo101</a>,Ozzie Virgil,San Francisco Giants,GIANTS,2,3,4,7,1958,1958,0,No,0,0.51,0.0,-0.51,435,23,-412,1397,29,-1368,0.0,0.0,0.0,0.0,0.0,0.0
<a href=/player/virgo101>virgo101</a>,Ozzie Virgil,Detroit Tigers,TIGRS,1,2,2,4,1961,1961,0,No,0,2.6,-0.03,-2.63,199,50,-149,85,51,-34,733.0,40.0,-693.0,0.0,0.0,0.0
<a href=/player/virgo101>virgo101</a>,Ozzie Virgil,Baltimore Orioles,ORLS,1,1,1,2,1963,1963,0,No,0,0.0,0.0,0.0,0,0,0,0,0,0,0.0,0.0,0.0,0.0,0.0,0.0
<a href=/player/virgo101>virgo101</a>,Ozzie Virgil,Pittsburgh Pirates,PIRATS,5,8,9,17,1965,1978,13,No,0,5.88,26.82,20.94,656,1597,941,1421,5058,3637,1342.0,1651.0,309.0,94500.0,0.0,-94500.0
<a href=/player/vitij001>vitij001</a>,Joe Vitiello,San Francisco Giants,GIANTS,1,1,1,2,2003,2003,0,No,0,0.84,0.0,-0.84,38,0,-38,86,0,-86,0.0,0.0,0.0,0.0,0.0,0.0
<a href=/player/vitto101>vitto101</a>,Ossie Vitt,Detroit Tigers,TIGRS,1,1,3,4,1919,1921,2,No,0,2.61,4.52,1.91,298,565,267,1243,1738,495,0.0,269.0,269.0,0.0,0.0,0.0
<a href=/player/vizca001>vizca001</a>,Arodys Vizcaino,New York Yankees,YANKS,2,5,3,8,2001,2013,12,No,1,3.9,2.44,-1.46,585,309,-276,511,6,-505,625.0,1000.0,375.0,1800000.0,0.0,-1800000.0
<a href=/player/vizca001>vizca001</a>,Arodys Vizcaino,Atlanta Braves,BRAVES,1,2,3,5,2012,2013,1,No,0,0.12,-0.62,-0.74,37,188,151,0,323,323,51.0,665.0,614.0,0.0,0.0,0.0
<a href=/player/vizca001>vizca001</a>,Arodys Vizcaino,Chicago Cubs,CUBS,2,2,2,4,2014,2018,4,Yes,0,5.93,1.45,-4.48,462,304,-158,438,587,149,516.0,4.0,-512.0,950000.0,0.0,-950000.0
<a href=/player/vizca001>vizca001</a>,Arodys Vizcaino,Atlanta Braves,BRAVES,1,2,2,4,2019,2019,0,No,0,-0.53,0.41,0.94,11,85,74,0,0,0,33.0,119.0,86.0,5375000.0,0.0,-5375000.0
<a href=/player/vizcj001>vizcj001</a>,Jose Vizcaino,Los Angeles Dodgers,DOGRS,1,1,1,2,1990,1990,0,No,0,2.05,0.0,-2.05,330,0,-330,1076,0,-1076,0.0,0.0,0.0,0.0,0.0,0.0
<a href=/player/vizcj001>vizcj001</a>,Jose Vizcaino,Chicago Cubs,CUBS,1,1,2,3,1994,1995,1,No,0,2.33,1.32,-1.01,334,104,-230,1419,42,-1377,0.0,468.0,468.0,0.0,0.0,0.0
<a href=/player/vizcj001>vizcj001</a>,Jose Vizcaino,New York Mets,METS,1,2,2,4,1996,1998,2,No,0,0.91,1.15,0.24,87,354,267,307,1284,977,0.0,0.0,0.0,4160000.0,0.0,-4160000.0
<a href=/player/vizcj001>vizcj001</a>,Jose Vizcaino,Cleveland Indians,INDINS,3,6,6,12,1996,2001,5,No,0,40.02,3.44,-36.58,2173,212,-1961,7166,649,-6517,933.0,172.0,-761.0,7541666.0,0.0,-7541666.0
<a href=/player/vizcj001>vizcj001</a>,Jose Vizcaino,Los Angeles Dodgers,DOGRS,1,2,1,3,2000,2000,0,No,0,0.24,-0.61,-0.85,73,41,-32,191,68,-123,0.0,0.0,0.0,3500000.0,0.0,-3500000.0
<a href=/player/vizcl001>vizcl001</a>,Luis Vizcaino,Oakland Athletics,ATLTCS,1,1,1,2,2002,2010,8,No,0,0.0,10.58,10.58,0,229,229,0,6,6,0.0,1320.0,1320.0,0.0,0.0,0.0
<a href=/player/vizcl001>vizcl001</a>,Luis Vizcaino,Texas Rangers,RNGRS,1,1,1,2,2002,2002,0,No,0,1.66,0.0,-1.66,440,0,-440,2,0,-2,646.0,0.0,-646.0,0.0,0.0,0.0
<a href=/player/vizcl001>vizcl001</a>,Luis Vizcaino,Milwaukee Brewers,BREWRS,11,22,22,44,2004,2020,16,Yes,1,50.21,29.77,-20.44,4158,1927,-2231,15837,5622,-10215,987.0,3218.0,2231.0,29855500.0,0.0,-29855500.0
<a href=/player/vizcl001>vizcl001</a>,Luis Vizcaino,Chicago White Sox,WSOX,3,7,7,14,2005,2015,10,No,0,21.04,18.91,-2.13,1161,870,-291,3709,2249,-1460,1060.0,1883.0,823.0,16705000.0,0.0,-16705000.0
<a href=/player/vizcl001>vizcl001</a>,Luis Vizcaino,Arizona Diamondbacks,DBACKS,1,4,2,6,2007,2008,1,No,0,-0.71,4.28,4.99,171,78,-93,110,78,-32,366.0,722.0,356.0,0.0,0.0,0.0
<a href=/player/vizcl001>vizcl001</a>,Luis Vizcaino,Colorado Rockies,ROCKS,2,2,2,4,2009,2009,0,No,1,0.25,3.48,3.23,8,69,61,0,75,75,11.0,648.0,637.0,0.0,0.0,0.0
<a href=/player/vizqo001>vizqo001</a>,Omar Vizquel,Seattle Mariners,MARNRS,1,1,3,4,1993,1996,3,No,0,30.23,-0.2,-30.43,1478,237,-1241,6542,811,-5731,0.0,0.0,0.0,1112500.0,0.0,-1112500.0
<a href=/player/voged001>voged001</a>,Daniel Vogelbach,Chicago Cubs,CUBS,4,5,5,10,2016,2020,4,Yes,0,4.67,3.17,-1.5,619,278,-341,1969,187,-1782,208.0,960.0,752.0,2440000.0,0.0,-2440000.0
<a href=/player/voger001>voger001</a>,Ryan Vogelsong,San Francisco Giants,GIANTS,4,5,6,11,2001,2013,12,No,2,-2.21,26.82,29.03,411,647,236,569,1403,834,1088.0,3414.0,2326.0,310000.0,0.0,-310000.0
<a href=/player/vogts001>vogts001</a>,Stephen Vogt,Arizona Diamondbacks,DBACKS,1,1,1,2,2021,2021,0,Yes,0,-0.32,0.0,0.32,26,0,-26,87,0,-87,0.0,0.0,0.0,3500000.0,0.0,-3500000.0
<a href=/player/voigj001>voigj001</a>,Jack Voigt,Baltimore Orioles,ORLS,1,1,1,2,1995,1995,0,No,0,-0.37,0.0,0.37,38,0,-38,82,0,-82,0.0,0.0,0.0,0.0,0.0,0.0
<a href=/player/voigj001>voigj001</a>,Jack Voigt,Texas Rangers,RNGRS,1,1,1,2,1995,1995,0,No,0,0.0,0.15,0.15,0,4,4,0,0,0,0.0,12.0,12.0,155000.0,0.0,-155000.0
<a href=/player/voisb101>voisb101</a>,Bill Voiselle,New York Giants,GIANTS,1,2,1,3,1947,1948,1,No,0,4.92,-0.4,-5.32,178,16,-162,203,17,-186,1549.0,110.0,-1439.0,0.0,0.0,0.0
<a href=/player/voisb101>voisb101</a>,Bill Voiselle,Boston Braves,BRAVES,1,1,2,3,1949,1951,2,No,0,-0.51,-0.08,0.43,38,67,29,13,165,152,154.0,0.0,-154.0,0.0,0.0,0.0
<a href=/player/voitl001>voitl001</a>,Luke Voit,St. Louis Cardinals,CARDS,1,2,2,4,2018,2019,1,Yes,0,4.54,0.23,-4.31,281,49,-232,1133,2,-1131,0.0,54.0,54.0,0.0,0.0,0.0
<a href=/player/vollc101>vollc101</a>,Clyde Vollmer,Cincinnati Reds,REDS,1,1,1,2,1948,1948,0,No,0,0.48,0.0,-0.48,316,0,-316,1112,0,-1112,0.0,0.0,0.0,0.0,0.0,0.0
<a href=/player/vollc101>vollc101</a>,Clyde Vollmer,Washington Senators,TWINS,1,1,2,3,1950,1950,0,No,0,2.98,0.17,-2.81,263,40,-223,929,137,-792,0.0,0.0,0.0,0.0,0.0,0.0
<a href=/player/volqe001>volqe001</a>,Edinson Volquez,Texas Rangers,RNGRS,3,4,4,8,2007,2017,10,No,1,4.01,22.59,18.58,363,682,319,148,2814,2666,1527.0,137.0,-1390.0,0.0,0.0,0.0
<a href=/player/volqe001>volqe001</a>,Edinson Volquez,Cincinnati Reds,REDS,2,5,3,8,2011,2020,9,No,0,8.75,14.41,5.66,882,376,-506,2596,411,-2185,1389.0,3437.0,2048.0,9475000.0,0.0,-9475000.0
<a href=/player/volsc001>volsc001</a>,Chris Volstad,Miami Marlins,MARLNS,1,1,2,3,2012,2012,0,No,0,-1.46,0.72,2.18,42,67,25,34,36,2,334.0,397.0,63.0,0.0,0.0,0.0
<a href=/player/vosbe001>vosbe001</a>,Ed Vosberg,San Diego Padres,PADRS,1,1,1,2,1988,1993,5,No,0,0.0,0.08,0.08,0,84,84,0,296,296,0.0,0.0,0.0,0.0,0.0,0.0
<a href=/player/vosbe001>vosbe001</a>,Ed Vosberg,Houston Astros,ASTROS,1,1,1,2,1989,1991,2,No,0,0.0,0.57,0.57,0,77,77,0,187,187,0.0,0.0,0.0,0.0,0.0,0.0
<a href=/player/vosbe001>vosbe001</a>,Ed Vosberg,Texas Rangers,RNGRS,1,1,1,2,1997,2001,4,No,0,-0.08,13.58,13.66,33,155,122,0,20,20,36.0,2770.0,2734.0,450000.0,0.0,-450000.0
<a href=/player/vosbe001>vosbe001</a>,Ed Vosberg,Florida Marlins,MARLNS,1,1,1,2,1997,1997,0,No,0,-0.72,0.0,0.72,30,0,-30,0,0,0,25.0,0.0,-25.0,0.0,0.0,0.0
<a href=/player/voslj001>voslj001</a>,Jason Vosler,Chicago Cubs,CUBS,1,1,1,2,2018,2018,0,Yes,0,0.0,0.0,0.0,0,0,0,0,0,0,0.0,0.0,0.0,0.0,0.0,0.0
<a href=/player/vosmj101>vosmj101</a>,Joe Vosmik,Cleveland Indians,INDINS,1,3,3,6,1937,1939,2,No,0,6.18,8.46,2.28,372,600,228,1331,2387,1056,1093.0,179.0,-914.0,0.0,0.0,0.0
<a href=/player/vosmj101>vosmj101</a>,Joe Vosmik,St.Louis Browns,ORLS,9,17,25,42,1937,1952,15,No,0,43.78,53.09,9.31,1937,5273,3336,5181,15101,9920,6172.0,11573.0,5401.0,123000.0,0.0,-123000.0
<a href=/player/vossb101>vossb101</a>,Bill Voss,Chicago White Sox,WSOX,2,3,2,5,1969,1969,0,No,0,1.28,-1.35,-2.63,213,36,-177,599,8,-591,0.0,125.0,125.0,27500.0,0.0,-27500.0
<a href=/player/vossb101>vossb101</a>,Bill Voss,California Angels,ANGELS,1,1,1,2,1971,1971,0,No,0,0.01,0.0,-0.01,124,0,-124,345,0,-345,0.0,0.0,0.0,0.0,0.0,0.0
<a href=/player/vossb101>vossb101</a>,Bill Voss,Milwaukee Brewers,BREWRS,2,3,3,6,1972,1972,0,No,0,0.08,-0.41,-0.49,40,64,24,109,140,31,0.0,0.0,0.0,37000.0,0.0,-37000.0
<a href=/player/vossb101>vossb101</a>,Bill Voss,Oakland Athletics,ATLTCS,2,3,3,6,1972,1973,1,No,0,1.29,0.41,-0.88,134,35,-99,556,136,-420,0.0,22.0,22.0,100000.0,0.0,-100000.0
<a href=/player/vossb101>vossb101</a>,Bill Voss,St. Louis Cardinals,CARDS,1,1,1,2,1972,1972,0,No,0,0.0,0.0,0.0,0,0,0,0,0,0,0.0,0.0,0.0,0.0,0.0,0.0
<a href=/player/voylb001>voylb001</a>,Brad Voyles,Atlanta Braves,BRAVES,1,2,1,3,2001,2001,0,No,0,-0.65,0.03,0.68,44,49,5,1,163,162,205.0,0.0,-205.0,0.0,0.0,0.0
<a href=/player/vuckp001>vuckp001</a>,Pete Vuckovich,Toronto Blue Jays,BJAYS,8,15,14,29,1977,1987,10,No,0,28.86,22.15,-6.71,2801,2757,-44,8515,8792,277,3123.0,3581.0,458.0,669000.0,0.0,-669000.0
<a href=/player/vuckp001>vuckp001</a>,Pete Vuckovich,St. Louis Cardinals,CARDS,8,19,15,34,1980,1998,18,No,4,64.49,118.5,54.01,5600,4432,-1168,17434,16118,-1316,5735.0,2617.0,-3118.0,1533333.0,0.0,-1533333.0
<a href=/player/vukog001>vukog001</a>,George Vukovich,Philadelphia Phillies,PHILS,5,11,8,19,1982,1999,17,No,0,22.81,28.42,5.61,2142,1948,-194,7615,5685,-1930,390.0,1257.0,867.0,2950000.0,0.0,-2950000.0
<a href=/player/vukoj101>vukoj101</a>,John Vukovich,Philadelphia Phillies,PHILS,3,7,6,13,1972,1979,7,No,0,31.4,20.05,-11.35,1669,1025,-644,5610,3103,-2507,2357.0,4062.0,1705.0,29500.0,0.0,-29500.0
<a href=/player/vukoj101>vukoj101</a>,John Vukovich,Milwaukee Brewers,BREWRS,2,2,2,4,1974,1975,1,No,0,-0.05,-0.17,-0.12,31,6,-25,46,0,-46,0.0,35.0,35.0,34000.0,0.0,-34000.0
<a href=/player/vukoj101>vukoj101</a>,John Vukovich,Cincinnati Reds,REDS,3,3,3,6,1975,1979,4,No,0,3.94,-0.12,-4.06,350,99,-251,980,200,-780,0.0,0.0,0.0,0.0,0.0,0.0
<a href=/player/waddr101>waddr101</a>,Rube Waddell,Louisville Colonels,LS3,1,12,5,17,1899,1900,1,No,0,267.1,0.0,-267.1,7388,0,-7388,29004,0,-29004,7568.0,0.0,-7568.0,4350.0,0.0,-4350.0
<a href=/player/waddr101>waddr101</a>,Rube Waddell,Pittsburgh Pirates,PIRATS,1,1,1,2,1900,1901,1,No,0,0.0,-0.04,-0.04,0,4,4,0,3,3,0.0,24.0,24.0,0.0,0.0,0.0
<a href=/player/wadeb101>wadeb101</a>,Ben Wade,St. Louis Cardinals,CARDS,2,3,2,5,1955,1956,1,No,0,1.12,2.31,1.19,44,114,70,11,20,9,165.0,277.0,112.0,0.0,0.0,0.0
<a href=/player/wadeg101>wadeg101</a>,Gale Wade,Cleveland Indians,INDINS,1,3,1,4,1954,1955,1,No,0,4.04,0.12,-3.92,157,113,-44,207,390,183,1291.0,0.0,-1291.0,0.0,0.0,0.0
<a href=/player/wadej101>wadej101</a>,Jake Wade,Detroit Tigers,TIGRS,1,3,2,5,1938,1946,8,No,0,-0.33,15.76,16.09,102,1005,903,69,3681,3612,596.0,671.0,75.0,19500.0,0.0,-19500.0
<a href=/player/wadej101>wadej101</a>,Jake Wade,Chicago White Sox,WSOX,1,1,1,2,1944,1947,3,No,0,0.97,-0.17,-1.14,26,58,32,10,18,8,106.0,209.0,103.0,5600.0,0.0,-5600.0
<a href=/player/wadej101>wadej101</a>,Jake Wade,New York Giants,GIANTS,1,4,1,5,1947,1953,6,No,0,0.0,-0.83,-0.83,0,19,19,0,46,46,0.0,19.0,19.0,0.0,0.0,0.0
<a href=/player/wadek001>wadek001</a>,Konner Wade,Colorado Rockies,ROCKS,1,1,1,2,2017,2017,0,No,0,-0.4,0.0,0.4,7,0,-7,0,0,0,37.0,0.0,-37.0,0.0,0.0,0.0
<a href=/player/wadel001>wadel001</a>,LaMonte Wade,Minnesota Twins,TWINS,1,1,1,2,2021,2021,0,No,0,1.22,-0.46,-1.68,109,4,-105,381,0,-381,0.0,26.0,26.0,0.0,0.0,0.0
<a href=/player/wadet002>wadet002</a>,Tyler Wade,New York Yankees,YANKS,1,1,1,2,2021,2021,0,No,0,0.0,0.0,0.0,0,0,0,0,0,0,0.0,0.0,0.0,0.0,0.0,0.0
<a href=/player/wadsj101>wadsj101</a>,Jack Wadsworth,Louisville Colonels,LS3,1,12,5,17,1899,1900,1,No,0,267.1,0.0,-267.1,7388,0,-7388,29004,0,-29004,7568.0,0.0,-7568.0,4350.0,0.0,-4350.0
<a href=/player/wagnb001>wagnb001</a>,Billy Wagner,Houston Astros,ASTROS,2,4,5,9,2003,2007,4,No,0,8.53,-4.45,-12.98,725,187,-538,1017,101,-916,1251.0,1063.0,-188.0,8727000.0,0.0,-8727000.0
<a href=/player/wagnb001>wagnb001</a>,Billy Wagner,New York Mets,METS,1,1,2,3,2009,2010,1,No,0,0.34,-0.21,-0.55,15,100,85,0,180,180,41.0,0.0,-41.0,10500000.0,0.0,-10500000.0
<a href=/player/wagng101>wagng101</a>,Gary Wagner,Philadelphia Phillies,PHILS,1,1,1,2,1969,1971,2,No,0,-0.15,0.3,0.45,88,10,-78,10,1,-9,170.0,19.0,-151.0,15000.0,0.0,-15000.0
<a href=/player/wagnh101>wagnh101</a>,Honus Wagner,Louisville Colonels,LS3,1,12,5,17,1899,1900,1,No,0,267.1,0.0,-267.1,7388,0,-7388,29004,0,-29004,7568.0,0.0,-7568.0,4350.0,0.0,-4350.0
<a href=/player/wagnh102>wagnh102</a>,Hal Wagner,Philadelphia Athletics,ATLTCS,1,1,1,2,1944,1946,2,No,0,2.46,0.58,-1.88,204,136,-68,778,556,-222,0.0,0.0,0.0,6000.0,0.0,-6000.0
<a href=/player/wagnh102>wagnh102</a>,Hal Wagner,Boston Red Sox,RSOX,1,1,1,2,1947,1950,3,No,0,0.99,3.02,2.03,125,419,294,355,1601,1246,0.0,0.0,0.0,0.0,0.0,0.0
<a href=/player/wagnl101>wagnl101</a>,Leon Wagner,San Francisco Giants,GIANTS,10,19,14,33,1959,1972,13,No,0,26.08,20.98,-5.1,2290,1750,-540,7278,3376,-3902,1334.0,4789.0,3455.0,50000.0,0.0,-50000.0
<a href=/player/wagnl101>wagnl101</a>,Leon Wagner,St. Louis Cardinals,CARDS,1,4,1,5,1960,1961,1,No,0,0.0,0.08,0.08,0,58,58,0,21,21,0.0,225.0,225.0,0.0,0.0,0.0
<a href=/player/wagnl101>wagnl101</a>,Leon Wagner,Toronto,Toronto,1,1,1,2,1961,1961,0,No,0,6.42,0.0,-6.42,442,0,-442,1801,0,-1801,0.0,0.0,0.0,0.0,0.0,0.0
<a href=/player/wagnl101>wagnl101</a>,Leon Wagner,Los Angeles Angels,ANGELS,2,2,4,6,1963,1970,7,No,0,4.21,3.61,-0.6,770,439,-331,2474,1110,-1364,542.0,509.0,-33.0,20000.0,0.0,-20000.0
<a href=/player/wagnl101>wagnl101</a>,Leon Wagner,Cleveland Indians,INDINS,8,14,14,28,1968,1978,10,No,0,23.2,10.4,-12.8,1797,1040,-757,4294,3309,-985,2427.0,1183.0,-1244.0,115500.0,0.0,-115500.0
<a href=/player/wagnm001>wagnm001</a>,Mark Wagner,Detroit Tigers,TIGRS,1,1,1,2,1980,1983,3,No,0,1.16,2.21,1.05,112,70,-42,293,0,-293,0.0,268.0,268.0,0.0,0.0,0.0
<a href=/player/wagnm002>wagnm002</a>,Matt Wagner,Seattle Mariners,MARNRS,2,4,3,7,1996,1999,3,No,0,0.25,7.02,6.77,475,103,-372,1514,15,-1499,341.0,1794.0,1453.0,5016667.0,0.0,-5016667.0
<a href=/player/wagnr001>wagnr001</a>,Ryan Wagner,Cincinnati Reds,REDS,1,3,5,8,2006,2012,6,No,0,0.43,-0.61,-1.04,795,705,-90,2860,181,-2679,139.0,809.0,670.0,4550000.0,0.0,-4550000.0
<a href=/player/wagnt001>wagnt001</a>,Tyler Wagner,Milwaukee Brewers,BREWRS,6,11,10,21,2016,2020,4,Yes,0,-0.37,15.97,16.34,772,552,-220,2514,1371,-1143,401.0,1885.0,1484.0,6500000.0,0.0,-6500000.0
<a href=/player/waguj001>waguj001</a>,Jacob Waguespack,Philadelphia Phillies,PHILS,1,1,1,2,2018,2018,0,No,0,0.26,0.09,-0.17,29,18,-11,3,0,-3,287.0,12.0,-275.0,0.0,0.0,0.0
<a href=/player/wahlb001>wahlb001</a>,Bobby Wahl,Oakland Athletics,ATLTCS,1,3,1,4,2018,2018,0,No,0,-0.32,0.3,0.62,13,30,17,0,0,0,16.0,94.0,78.0,0.0,0.0,0.0
<a href=/player/wahlb001>wahlb001</a>,Bobby Wahl,New York Mets,METS,2,4,2,6,2019,2019,0,No,0,-0.03,-0.49,-0.46,40,34,-6,112,53,-59,7.0,0.0,-7.0,571765.0,0.0,-571765.0
<a href=/player/wahlk101>wahlk101</a>,Kermit Wahl,Cincinnati Reds,REDS,1,2,1,3,1949,1950,1,No,0,0.0,0.76,0.76,0,138,138,0,500,500,0.0,0.0,0.0,0.0,0.0,0.0
<a href=/player/wahlk101>wahlk101</a>,Kermit Wahl,Brooklyn Dodgers,DOGRS,1,1,2,3,1949,1949,0,No,0,-0.74,0.0,0.74,109,0,-109,389,0,-389,0.0,0.0,0.0,0.0,0.0,0.0
<a href=/player/wahlk101>wahlk101</a>,Kermit Wahl,Philadelphia Athletics,ATLTCS,1,1,1,2,1951,1952,1,No,0,0.0,2.8,2.8,0,123,123,0,503,503,0.0,0.0,0.0,0.0,0.0,0.0
<a href=/player/wahlk101>wahlk101</a>,Kermit Wahl,Chicago White Sox,WSOX,27,53,44,97,1951,1969,18,No,0,83.35,62.63,-20.72,6936,5271,-1665,17430,11733,-5697,13187.0,9922.0,-3265.0,288750.0,0.0,-288750.0
<a href=/player/wahlk101>wahlk101</a>,Kermit Wahl,St.Louis Browns,ORLS,24,54,49,103,1951,1994,43,No,3,83.31,156.11,72.8,5380,9168,3788,11255,26279,15024,18826.0,17928.0,-898.0,984333.0,0.0,-984333.0
<a href=/player/waina001>waina001</a>,Adam Wainwright,Atlanta Braves,BRAVES,2,5,3,8,2003,2005,2,No,0,48.74,10.63,-38.11,1422,247,-1175,1200,926,-274,9241.0,27.0,-9214.0,3968000.0,0.0,-3968000.0
<a href=/player/waind001>waind001</a>,Dave Wainhouse,Montreal Expos,NATEX,1,2,2,4,1992,1993,1,No,0,-0.6,-0.77,-0.17,3,95,92,0,242,242,7.0,0.0,-7.0,0.0,0.0,0.0
<a href=/player/waite101>waite101</a>,Eddie Waitkus,Chicago Cubs,CUBS,2,3,3,6,1948,1953,5,No,0,8.13,13.76,5.63,675,587,-88,2640,227,-2413,597.0,2431.0,1834.0,16000.0,0.0,-16000.0
<a href=/player/waitr001>waitr001</a>,Rick Waits,Texas Rangers,RNGRS,2,5,3,8,1975,1978,3,No,0,27.68,13.0,-14.68,537,88,-449,186,0,-186,7504.0,2017.0,-5487.0,60000.0,0.0,-60000.0
<a href=/player/waitr001>waitr001</a>,Rick Waits,Cleveland Indians,INDINS,4,6,7,13,1983,1989,6,No,0,6.39,10.47,4.08,1149,933,-216,3782,2485,-1297,450.0,1586.0,1136.0,1515000.0,0.0,-1515000.0
<a href=/player/wakeb101>wakeb101</a>,Bill Wakefield,St. Louis Cardinals,CARDS,2,4,2,6,1963,1966,3,No,0,0.61,-0.46,-1.07,354,142,-212,526,97,-429,552.0,871.0,319.0,0.0,0.0,0.0
<a href=/player/waked101>waked101</a>,Dick Wakefield,Detroit Tigers,TIGRS,12,27,25,52,1949,1961,12,No,0,21.38,16.07,-5.31,2122,2387,265,3941,7076,3135,5639.0,2357.0,-3282.0,45200.0,0.0,-45200.0
<a href=/player/wakeh101>wakeh101</a>,Howard Wakefield,Cleveland Indians,INDINS,1,2,1,3,1907,1907,0,No,0,-0.05,-0.01,0.04,39,12,-27,151,47,-104,0.0,0.0,0.0,0.0,0.0,0.0
<a href=/player/walbm001>walbm001</a>,Matt Walbeck,Chicago Cubs,CUBS,2,3,2,5,1993,1995,2,No,0,-2.42,-1.8,0.62,423,66,-357,1019,51,-968,662.0,450.0,-212.0,349000.0,0.0,-349000.0
<a href=/player/walbm001>walbm001</a>,Matt Walbeck,Minnesota Twins,TWINS,1,1,1,2,1996,1996,0,No,0,-1.37,0.0,1.37,133,0,-133,384,0,-384,0.0,0.0,0.0,225000.0,0.0,-225000.0
<a href=/player/walbm001>walbm001</a>,Matt Walbeck,Detroit Tigers,TIGRS,1,2,1,3,1997,1997,0,No,0,-0.94,0.0,0.94,337,0,-337,1117,0,-1117,0.0,0.0,0.0,728000.0,0.0,-728000.0
<a href=/player/walbm001>walbm001</a>,Matt Walbeck,San Diego Padres,PADRS,1,2,2,4,2002,2002,0,No,0,-0.26,-0.46,-0.2,167,15,-152,507,42,-465,0.0,0.0,0.0,0.0,0.0,0.0
<a href=/player/walbr101>walbr101</a>,Rube Walberg,Philadelphia Athletics,ATLTCS,1,3,3,6,1933,1936,3,No,0,51.32,1.87,-49.45,848,361,-487,1283,1356,73,5977.0,119.0,-5858.0,31000.0,0.0,-31000.0
<a href=/player/walbr101>walbr101</a>,Rube Walberg,Portland,Portland,1,1,2,3,1922,1922,0,No,0,0.03,0.0,-0.03,4,0,-4,1,0,-1,15.0,0.0,-15.0,0.0,0.0,0.0
<a href=/player/waldj001>waldj001</a>,Jordan Walden,Anaheim Angels,ANGELS,1,1,1,2,2012,2013,1,No,0,1.18,-0.38,-1.56,211,15,-196,0,0,0,291.0,219.0,-72.0,495000.0,0.0,-495000.0
<a href=/player/waldj001>waldj001</a>,Jordan Walden,Atlanta Braves,BRAVES,3,6,6,12,2014,2021,7,Yes,0,6.17,11.17,5.0,236,884,648,658,2525,1867,448.0,1265.0,817.0,6525000.0,0.0,-6525000.0
<a href=/player/walkb001>walkb001</a>,Bob Walk,Philadelphia Phillies,PHILS,4,7,5,12,1981,1986,5,No,0,7.41,4.36,-3.05,1382,627,-755,3921,1660,-2261,861.0,557.0,-304.0,0.0,0.0,0.0
<a href=/player/walkb101>walkb101</a>,Bill Walker,New York Giants,GIANTS,3,11,6,17,1932,1949,17,No,0,15.21,55.77,40.56,1303,2528,1225,3690,9780,6090,2269.0,40.0,-2229.0,0.0,0.0,0.0
<a href=/player/walkb101>walkb101</a>,Bill Walker,St. Louis Cardinals,CARDS,1,2,1,3,1936,1939,3,No,0,0.0,2.32,2.32,0,112,112,0,94,94,0.0,807.0,807.0,0.0,0.0,0.0
<a href=/player/walkc001>walkc001</a>,Chico Walker,Chicago Cubs,CUBS,1,1,1,2,1987,1987,0,No,0,-0.63,0.0,0.63,33,0,-33,86,0,-86,0.0,0.0,0.0,0.0,0.0,0.0
<a href=/player/walkc101>walkc101</a>,Curt Walker,New York Giants,GIANTS,1,3,1,4,1921,1926,5,No,0,11.79,12.89,1.1,909,765,-144,3326,3232,-94,0.0,0.0,0.0,5400.0,0.0,-5400.0
<a href=/player/walkc101>walkc101</a>,Curt Walker,Philadelphia Phillies,PHILS,7,15,13,28,1924,1941,17,No,0,41.73,36.54,-5.19,2531,2703,172,10014,8113,-1901,324.0,5521.0,5197.0,21500.0,0.0,-21500.0
<a href=/player/walkd001>walkd001</a>,Duane Walker,Cincinnati Reds,REDS,2,3,2,5,1985,1988,3,No,0,10.64,5.16,-5.48,575,386,-189,438,1599,1161,2258.0,0.0,-2258.0,790909.0,0.0,-790909.0
<a href=/player/walkd101>walkd101</a>,Dixie Walker,Chicago White Sox,WSOX,2,4,5,9,1937,1950,13,No,0,5.83,16.69,10.86,429,2282,1853,1515,8577,7062,633.0,270.0,-363.0,37500.0,0.0,-37500.0
<a href=/player/walkd101>walkd101</a>,Dixie Walker,Brooklyn Dodgers,DOGRS,3,7,9,16,1947,1954,7,No,0,6.69,26.56,19.87,628,1156,528,1259,3340,2081,1417.0,3832.0,2415.0,38000.0,0.0,-38000.0
<a href=/player/walke101>walke101</a>,Ernie Walker,St.Louis Browns,ORLS,1,4,2,6,1915,1924,9,No,0,0.0,-0.32,-0.32,0,2,2,0,1,1,0.0,10.0,10.0,0.0,0.0,0.0
<a href=/player/walkg101>walkg101</a>,Gee Walker,Detroit Tigers,TIGRS,5,17,11,28,1937,1952,15,No,0,24.1,51.38,27.28,3640,2564,-1076,12152,7653,-4499,3951.0,7313.0,3362.0,74300.0,0.0,-74300.0
<a href=/player/walkg101>walkg101</a>,Gee Walker,Chicago White Sox,WSOX,1,1,2,3,1939,1948,9,No,0,1.25,11.88,10.63,140,825,685,620,3004,2384,0.0,270.0,270.0,12500.0,0.0,-12500.0
<a href=/player/walkg101>walkg101</a>,Gee Walker,Washington Senators,TWINS,4,6,5,11,1940,1946,6,No,0,3.39,-0.87,-4.26,1062,351,-711,4332,1228,-3104,0.0,315.0,315.0,30000.0,0.0,-30000.0
<a href=/player/walkg101>walkg101</a>,Gee Walker,Boston Red Sox,RSOX,4,12,11,23,1940,1956,16,No,0,20.74,30.94,10.2,2288,1730,-558,6966,4243,-2723,4828.0,6235.0,1407.0,124000.0,0.0,-124000.0
<a href=/player/walkh102>walkh102</a>,Harry Walker,St. Louis Cardinals,CARDS,2,4,2,6,1947,1952,5,No,0,7.58,4.01,-3.57,327,364,37,1048,1141,93,230.0,0.0,-230.0,9000.0,0.0,-9000.0
<a href=/player/walkh102>walkh102</a>,Harry Walker,Philadelphia Phillies,PHILS,1,1,1,2,1948,1953,5,No,0,0.07,3.84,3.77,42,317,275,172,792,620,0.0,0.0,0.0,0.0,0.0,0.0
<a href=/player/walkh102>walkh102</a>,Harry Walker,Chicago Cubs,CUBS,4,8,7,15,1949,1958,9,No,0,10.8,25.37,14.57,1114,1705,591,3490,6393,2903,130.0,197.0,67.0,0.0,0.0,0.0
<a href=/player/walkh102>walkh102</a>,Harry Walker,Cincinnati Reds,REDS,2,2,3,5,1949,1951,2,No,0,-0.06,0.2,0.26,133,95,-38,336,282,-54,0.0,0.0,0.0,0.0,0.0,0.0
<a href=/player/walkj001>walkj001</a>,Jamie Walker,Atlanta Braves,BRAVES,10,22,20,42,1997,2015,18,No,3,92.83,25.73,-67.1,5070,2997,-2073,17034,7559,-9475,5280.0,1624.0,-3656.0,29165000.0,0.0,-29165000.0
<a href=/player/walkj102>walkj102</a>,Jim Walkup,St.Louis Browns,ORLS,6,10,14,24,1939,1952,13,No,0,23.39,27.61,4.22,1164,2723,1559,2963,7190,4227,3417.0,6493.0,3076.0,67500.0,0.0,-67500.0
<a href=/player/walkj103>walkj103</a>,Johnny Walker,Philadelphia Athletics,ATLTCS,2,5,2,7,1922,1932,10,No,0,0.0,50.75,50.75,0,1434,1434,0,6162,6162,0.0,0.0,0.0,9900.0,0.0,-9900.0
<a href=/player/walkj104>walkj104</a>,Jerry Walker,Baltimore Orioles,ORLS,2,3,3,6,1961,1968,7,No,0,0.91,10.3,9.39,413,715,302,408,702,294,1330.0,1894.0,564.0,21750.0,0.0,-21750.0
<a href=/player/walkj104>walkj104</a>,Jerry Walker,Kansas City Athletics,ATLTCS,1,1,1,2,1963,1963,0,No,0,-0.74,-1.47,-0.73,90,101,11,23,254,231,293.0,0.0,-293.0,0.0,0.0,0.0
<a href=/player/walkl001>walkl001</a>,Larry Walker,Colorado Rockies,ROCKS,4,6,7,13,2004,2007,3,No,0,3.29,2.51,-0.78,196,277,81,584,129,-455,352.0,1323.0,971.0,15166667.0,0.0,-15166667.0
<a href=/player/walkm002>walkm002</a>,Mike Walker,Pittsburgh Pirates,PIRATS,1,3,2,5,1989,1989,0,No,0,-1.22,-1.21,0.01,20,71,51,0,253,253,300.0,0.0,-300.0,222500.0,0.0,-222500.0
<a href=/player/walkn001>walkn001</a>,Neil Walker,Pittsburgh Pirates,PIRATS,2,2,3,5,2015,2017,2,No,0,2.96,-0.18,-3.14,197,117,-80,758,34,-724,33.0,429.0,396.0,8000000.0,0.0,-8000000.0
<a href=/player/walkn001>walkn001</a>,Neil Walker,New York Mets,METS,1,2,1,3,2017,2019,2,No,0,0.43,-0.06,-0.49,38,6,-32,149,0,-149,0.0,7.0,7.0,17200000.0,0.0,-17200000.0
<a href=/player/walkp001>walkp001</a>,Pete Walker,New York Mets,METS,2,3,3,6,1996,1998,2,No,0,0.54,-0.29,-0.83,36,62,26,79,131,52,2.0,0.0,-2.0,0.0,0.0,0.0
<a href=/player/walkr101>walkr101</a>,Rube Walker,Chicago Cubs,CUBS,9,26,24,50,1951,1965,14,No,0,14.31,21.74,7.43,2452,2862,410,6527,5620,-907,3090.0,5461.0,2371.0,143500.0,0.0,-143500.0
<a href=/player/walkt001>walkt001</a>,Tony Walker,Cincinnati Reds,REDS,2,5,3,8,1983,1989,6,No,0,5.92,4.25,-1.67,542,577,35,401,2023,1622,1019.0,0.0,-1019.0,117500.0,0.0,-117500.0
<a href=/player/walkt002>walkt002</a>,Todd Walker,Minnesota Twins,TWINS,2,3,3,6,2000,2003,3,No,0,3.0,-0.02,-3.02,196,31,-165,636,86,-550,0.0,0.0,0.0,822500.0,0.0,-822500.0
<a href=/player/walkt002>walkt002</a>,Todd Walker,Colorado Rockies,ROCKS,2,5,4,9,2001,2002,1,No,0,3.51,-0.39,-3.9,333,251,-82,1296,922,-374,0.0,3.0,3.0,1050000.0,0.0,-1050000.0
<a href=/player/walkt002>walkt002</a>,Todd Walker,Cincinnati Reds,REDS,1,1,2,3,2002,2004,2,No,0,1.1,0.0,-1.1,144,0,-144,647,0,-647,0.0,0.0,0.0,2050000.0,0.0,-2050000.0
<a href=/player/walkt002>walkt002</a>,Todd Walker,Chicago Cubs,CUBS,2,2,2,4,2006,2009,3,No,0,0.86,0.05,-0.81,93,142,49,144,0,-144,87.0,206.0,119.0,2500000.0,0.0,-2500000.0
<a href=/player/walkt003>walkt003</a>,Tyler Walker,San Francisco Giants,GIANTS,1,1,1,2,2006,2006,0,No,0,0.12,0.0,-0.12,20,0,-20,0,0,0,60.0,0.0,-60.0,387000.0,0.0,-387000.0
<a href=/player/walkt004>walkt004</a>,Taijuan Walker,Seattle Mariners,MARNRS,4,9,8,17,2016,2019,3,Yes,0,31.56,9.44,-22.12,1249,337,-912,4632,1487,-3145,656.0,14.0,-642.0,18394000.0,0.0,-18394000.0
<a href=/player/walkt004>walkt004</a>,Taijuan Walker,Seattle Mariners,MARNRS,1,1,1,2,2020,2020,0,Yes,0,0.95,0.0,-0.95,6,0,-6,0,0,0,79.0,0.0,-79.0,2000000.0,0.0,-2000000.0
<a href=/player/walkt101>walkt101</a>,Tillie Walker,Washington Senators,TWINS,2,4,4,8,1912,1919,7,No,0,0.15,11.96,11.81,110,595,485,129,1405,1276,1048.0,2565.0,1517.0,3200.0,0.0,-3200.0
<a href=/player/walkt101>walkt101</a>,Tillie Walker,Boston Red Sox,RSOX,8,19,22,41,1918,1935,17,No,0,51.77,23.6,-28.17,3792,2718,-1074,15081,10291,-4790,0.0,1203.0,1203.0,45050.0,0.0,-45050.0
<a href=/player/walkt101>walkt101</a>,Tillie Walker,KansasCity,KansasCity,1,1,4,5,1913,1915,2,No,0,8.53,0.0,-8.53,318,0,-318,1249,0,-1249,0.0,0.0,0.0,0.0,0.0,0.0
<a href=/player/walkt103>walkt103</a>,Tom Walker,Montreal Expos,NATEX,4,6,5,11,1974,1990,16,No,1,-1.98,16.18,18.16,252,1065,813,89,2006,1917,1002.0,2687.0,1685.0,39500.0,0.0,-39500.0
<a href=/player/wallb001>wallb001</a>,Brett Wallace,St. Louis Cardinals,CARDS,1,3,1,4,2009,2016,7,No,0,-0.87,23.07,23.94,9,982,973,8,4121,4113,101.0,0.0,-101.0,0.0,0.0,0.0
<a href=/player/wallb001>wallb001</a>,Brett Wallace,Oakland Athletics,ATLTCS,2,2,2,4,2009,2014,5,Yes,0,0.15,-0.84,-0.99,11,26,15,33,81,48,0.0,0.0,0.0,0.0,0.0,0.0
<a href=/player/wallb001>wallb001</a>,Brett Wallace,Toronto Blue Jays,BJAYS,2,2,2,4,2010,2019,9,No,0,0.29,7.38,7.09,481,518,37,1713,1862,149,0.0,0.0,0.0,0.0,0.0,0.0
<a href=/player/wallc001>wallc001</a>,Chad Wallach,Miami Marlins,MARLNS,2,5,4,9,2014,2015,1,Yes,0,5.93,0.44,-5.49,229,31,-198,228,27,-201,1943.0,265.0,-1678.0,9400000.0,0.0,-9400000.0
<a href=/player/walld001>walld001</a>,Denny Walling,Oakland Athletics,ATLTCS,1,2,1,3,1977,1977,0,No,0,13.96,-0.94,-14.9,1072,59,-1013,2929,157,-2772,0.0,0.0,0.0,0.0,0.0,0.0
<a href=/player/walld001>walld001</a>,Denny Walling,Houston Astros,ASTROS,1,1,1,2,1988,1989,1,No,0,-1.07,-2.33,-1.26,166,86,-80,290,38,-252,0.0,408.0,408.0,575000.0,0.0,-575000.0
<a href=/player/walld002>walld002</a>,Donne Wall,Cincinnati Reds,REDS,1,2,1,3,1997,1998,1,No,0,0.65,-0.13,-0.78,96,83,-13,333,147,-186,0.0,0.0,0.0,0.0,0.0,0.0
<a href=/player/walld002>walld002</a>,Donne Wall,Detroit Tigers,TIGRS,2,5,3,8,1997,1998,1,No,0,5.42,-0.93,-6.35,622,96,-526,194,193,-1,1023.0,185.0,-838.0,1475000.0,0.0,-1475000.0
<a href=/player/walld002>walld002</a>,Donne Wall,San Diego Padres,PADRS,4,6,5,11,2000,2004,4,No,0,0.21,3.96,3.75,179,390,211,147,1460,1313,255.0,0.0,-255.0,6200000.0,0.0,-6200000.0
<a href=/player/walld003>walld003</a>,Derek Wallace,Chicago Cubs,CUBS,3,6,5,11,1995,2001,6,No,0,3.42,12.38,8.96,1105,1119,14,1379,4029,2650,1216.0,830.0,-386.0,9308333.0,0.0,-9308333.0
<a href=/player/walld003>walld003</a>,Derek Wallace,Kansas City Royals,ROYALS,1,3,2,5,1995,1999,4,No,0,-0.09,-0.06,0.03,38,81,43,0,0,0,74.0,445.0,371.0,0.0,0.0,0.0
<a href=/player/walld003>walld003</a>,Derek Wallace,New York Mets,METS,1,1,1,2,1999,1999,0,No,0,0.15,0.0,-0.15,8,0,-8,0,0,0,25.0,0.0,-25.0,0.0,0.0,0.0
<a href=/player/walld102>walld102</a>,Don Wallace,California Angels,ANGELS,1,2,1,3,1967,1968,1,No,0,0.0,0.59,0.59,0,23,23,0,56,56,0.0,0.0,0.0,8000.0,0.0,-8000.0
<a href=/player/wallj001>wallj001</a>,Jeff Wallace,Kansas City Royals,ROYALS,2,5,4,9,1996,2005,9,No,2,2.49,4.96,2.47,410,202,-208,728,666,-62,275.0,712.0,437.0,120000.0,0.0,-120000.0
<a href=/player/wallj002>wallj002</a>,Josh Wall,Los Angeles Dodgers,DOGRS,1,3,2,5,2013,2013,0,No,0,0.0,0.91,0.91,8,31,23,0,30,30,12.0,261.0,249.0,0.0,0.0,0.0
<a href=/player/wallj101>wallj101</a>,Joe Wallis,Chicago Cubs,CUBS,2,2,2,4,1978,1982,4,No,0,-0.4,1.94,2.34,109,345,236,228,856,628,0.0,0.0,0.0,0.0,0.0,0.0
<a href=/player/wallj101>wallj101</a>,Joe Wallis,Cleveland Indians,INDINS,7,12,13,25,1978,2011,33,No,2,33.5,55.83,22.33,1638,2966,1328,6056,10177,4121,2682.0,4370.0,1688.0,1767500.0,0.0,-1767500.0
<a href=/player/walll101>walll101</a>,Lee Walls,Pittsburgh Pirates,PIRATS,3,4,5,9,1957,1959,2,No,0,9.68,2.34,-7.34,949,404,-545,3178,1303,-1875,0.0,0.0,0.0,0.0,0.0,0.0
<a href=/player/walll101>walll101</a>,Lee Walls,Chicago Cubs,CUBS,3,5,4,9,1959,1961,2,No,0,8.16,-0.89,-9.05,620,173,-447,633,602,-31,802.0,0.0,-802.0,0.0,0.0,0.0
<a href=/player/walll101>walll101</a>,Lee Walls,Cincinnati Reds,REDS,1,2,3,5,1960,1963,3,No,0,24.2,5.52,-18.68,1274,332,-942,4678,994,-3684,0.0,0.0,0.0,0.0,0.0,0.0
<a href=/player/walll101>walll101</a>,Lee Walls,New York Mets,METS,4,7,6,13,1961,1970,9,No,0,0.46,4.8,4.34,417,826,409,613,1978,1365,516.0,1616.0,1100.0,0.0,0.0,0.0
<a href=/player/wallm101>wallm101</a>,Murray Wall,Milwaukee Braves,BRAVES,1,1,1,2,1955,1955,0,No,0,0.0,0.0,0.0,0,0,0,0,0,0,0.0,0.0,0.0,0.0,0.0,0.0
<a href=/player/wallm101>wallm101</a>,Murray Wall,Boston Red Sox,RSOX,1,2,2,4,1959,1960,1,No,0,0.88,-0.17,-1.05,192,13,-179,454,12,-442,4.0,0.0,-4.0,0.0,0.0,0.0
<a href=/player/wallm102>wallm102</a>,Mike Wallace,Philadelphia Phillies,PHILS,1,1,1,2,1974,1974,0,No,0,0.48,0.0,-0.48,26,0,-26,0,0,0,170.0,0.0,-170.0,0.0,0.0,0.0
<a href=/player/wallm102>wallm102</a>,Mike Wallace,St. Louis Cardinals,CARDS,1,1,1,2,1976,1977,1,No,0,-0.15,0.2,0.35,5,28,23,0,1,1,25.0,73.0,48.0,0.0,0.0,0.0
<a href=/player/wallt001>wallt001</a>,Tim Wallach,Montreal Expos,NATEX,1,1,1,2,1992,1992,0,No,0,1.46,0.0,-1.46,388,0,-388,1525,0,-1525,0.0,0.0,0.0,1906500.0,0.0,-1906500.0
<a href=/player/wallt002>wallt002</a>,Ty Waller,St. Louis Cardinals,CARDS,2,4,2,6,1980,1984,4,No,1,14.5,6.0,-8.5,1050,498,-552,4046,39,-4007,0.0,1190.0,1190.0,0.0,0.0,0.0
<a href=/player/wallt002>wallt002</a>,Ty Waller,Chicago Cubs,CUBS,1,1,1,2,1982,1986,4,No,0,0.0,0.79,0.79,0,32,32,0,23,23,0.0,191.0,191.0,0.0,0.0,0.0
<a href=/player/walsj108>walsj108</a>,Jimmy Walsh,Baltimore,Baltimore,2,3,5,8,1912,1914,2,No,0,9.51,0.0,-9.51,886,0,-886,3679,0,-3679,0.0,0.0,0.0,0.0,0.0,0.0
<a href=/player/walsj108>walsj108</a>,Jimmy Walsh,New York Yankees,YANKS,1,1,1,2,1914,1914,0,No,0,2.93,1.39,-1.54,299,69,-230,1224,238,-986,0.0,0.0,0.0,0.0,0.0,0.0
<a href=/player/walsj108>walsj108</a>,Jimmy Walsh,Philadelphia Athletics,ATLTCS,1,1,1,2,1916,1916,0,No,0,0.94,1.24,0.3,71,34,-37,237,115,-122,0.0,0.0,0.0,0.0,0.0,0.0
<a href=/player/waltb102>waltb102</a>,Bucky Walters,Boston Braves,BRAVES,3,7,4,11,1932,1940,8,No,0,0.0,6.35,6.35,0,477,477,0,1162,1162,0.0,2031.0,2031.0,0.0,0.0,0.0
<a href=/player/waltb102>waltb102</a>,Bucky Walters,Philadelphia Phillies,PHILS,2,2,4,6,1938,1940,2,No,0,43.86,2.13,-41.73,653,301,-352,968,820,-148,7065.0,703.0,-6362.0,5500.0,0.0,-5500.0
<a href=/player/waltc101>waltc101</a>,Charlie Walters,Minnesota Twins,TWINS,1,2,1,3,1970,1971,1,No,0,0.8,0.53,-0.27,190,173,-17,21,478,457,465.0,0.0,-465.0,0.0,0.0,0.0
<a href=/player/waltd001>waltd001</a>,Dan Walters,Houston Astros,ASTROS,2,2,2,4,1988,1991,3,No,0,0.08,0.57,0.49,84,77,-7,296,187,-109,0.0,0.0,0.0,0.0,0.0,0.0
<a href=/player/waltd101>waltd101</a>,Danny Walton,Houston Astros,ASTROS,1,2,1,3,1969,1970,1,No,0,-0.73,-0.15,0.58,198,81,-117,682,308,-374,0.0,0.0,0.0,12000.0,0.0,-12000.0
<a href=/player/waltd101>waltd101</a>,Danny Walton,Milwaukee Brewers,BREWRS,1,1,2,3,1971,1972,1,No,0,-0.35,-0.35,0.0,5,88,83,14,173,159,0.0,0.0,0.0,18000.0,0.0,-18000.0
<a href=/player/waltd101>waltd101</a>,Danny Walton,New York Yankees,YANKS,15,29,26,55,1972,2001,29,No,1,120.82,36.34,-84.48,6266,2369,-3897,14091,5734,-8357,21228.0,6192.0,-15036.0,4415000.0,0.0,-4415000.0
<a href=/player/waltd101>waltd101</a>,Danny Walton,Minnesota Twins,TWINS,1,1,1,2,1975,1980,5,No,0,0.0,3.77,3.77,18,460,442,17,1491,1474,0.0,0.0,0.0,0.0,0.0,0.0
<a href=/player/waltd101>waltd101</a>,Danny Walton,Los Angeles Dodgers,DOGRS,1,1,2,3,1977,1978,1,No,0,-0.34,0.0,0.34,13,0,-13,21,0,-21,0.0,0.0,0.0,0.0,0.0,0.0
<a href=/player/waltd101>waltd101</a>,Danny Walton,Texas Rangers,RNGRS,1,2,2,4,1980,1983,3,No,0,0.0,-0.43,-0.43,0,24,24,0,73,73,0.0,0.0,0.0,0.0,0.0,0.0
<a href=/player/waltg001>waltg001</a>,Gene Walter,San Diego Padres,PADRS,11,19,22,41,1986,2002,16,No,3,34.86,29.08,-5.78,2329,2441,112,6347,4213,-2134,2952.0,6040.0,3088.0,11083333.0,0.0,-11083333.0
<a href=/player/waltg001>waltg001</a>,Gene Walter,New York Mets,METS,1,1,1,2,1988,1989,1,No,0,-0.1,0.04,0.14,16,20,4,0,0,0,79.0,42.0,-37.0,111600.0,0.0,-111600.0
<a href=/player/waltk101>waltk101</a>,Ken Walters,Detroit Tigers,TIGRS,5,9,7,16,1959,1967,8,No,0,4.29,0.05,-4.24,724,813,89,2270,1691,-579,122.0,890.0,768.0,38000.0,0.0,-38000.0
<a href=/player/waltm001>waltm001</a>,Mike Walters,California Angels,ANGELS,1,3,2,5,1982,1987,5,No,0,16.27,3.87,-12.4,962,569,-393,3760,1197,-2563,264.0,852.0,588.0,0.0,0.0,0.0
<a href=/player/waltp001>waltp001</a>,P.J. Walters,St. Louis Cardinals,CARDS,5,8,8,16,2011,2019,8,Yes,2,7.33,0.78,-6.55,586,381,-205,1627,154,-1473,283.0,547.0,264.0,3193000.0,0.0,-3193000.0
<a href=/player/waltr102>waltr102</a>,Roxy Walters,New York Yankees,YANKS,5,19,8,27,1918,1928,10,No,0,9.22,7.55,-1.67,1051,1233,182,2808,4705,1897,3476.0,418.0,-3058.0,39950.0,0.0,-39950.0
<a href=/player/waltr102>waltr102</a>,Roxy Walters,Boston Red Sox,RSOX,2,5,5,10,1924,1925,1,No,0,9.31,0.12,-9.19,860,387,-473,3360,1555,-1805,0.0,0.0,0.0,3300.0,0.0,-3300.0
<a href=/player/waltz001>waltz001</a>,Zach Walters,Arizona Diamondbacks,DBACKS,1,1,1,2,2011,2011,0,No,0,0.48,-0.85,-1.33,40,6,-34,52,4,-48,0.0,34.0,34.0,0.0,0.0,0.0
<a href=/player/waltz001>waltz001</a>,Zach Walters,Washington Nationals,NATEX,1,1,2,3,2014,2014,0,No,0,-0.51,0.42,0.93,42,49,7,124,200,76,0.0,0.0,0.0,0.0,0.0,0.0
<a href=/player/wambb101>wambb101</a>,Bill Wambsganss,Cleveland Indians,INDINS,1,4,3,7,1924,1928,4,No,0,0.12,9.37,9.25,387,855,468,1555,3344,1789,0.0,0.0,0.0,0.0,0.0,0.0
<a href=/player/wambb101>wambb101</a>,Bill Wambsganss,Philadelphia Athletics,ATLTCS,1,2,1,3,1926,1927,1,No,0,0.0,-0.86,-0.86,0,30,30,0,102,102,0.0,0.0,0.0,7500.0,0.0,-7500.0
<a href=/player/wanel101>wanel101</a>,Lloyd Waner,Pittsburgh Pirates,PIRATS,1,1,1,2,1941,1948,7,No,0,0.56,9.1,8.54,19,324,305,53,256,203,0.0,2222.0,2222.0,0.0,0.0,0.0
<a href=/player/wanel101>wanel101</a>,Lloyd Waner,Boston Braves,BRAVES,1,1,1,2,1941,1946,5,No,0,-0.65,1.11,1.76,55,256,201,175,124,-51,0.0,1218.0,1218.0,0.0,0.0,0.0
<a href=/player/wanel101>wanel101</a>,Lloyd Waner,Philadelphia Phillies,PHILS,2,3,3,6,1943,1943,0,No,0,0.73,1.46,0.73,404,136,-268,1520,565,-955,0.0,0.0,0.0,0.0,0.0,0.0
<a href=/player/wannp101>wannp101</a>,Pee-Wee Wanninger,New York Yankees,YANKS,1,2,1,3,1925,1928,3,No,0,0.0,5.57,5.57,0,264,264,0,860,860,0.0,0.0,0.0,1800.0,0.0,-1800.0
<a href=/player/wannp101>wannp101</a>,Pee-Wee Wanninger,StPaul,StPaul,5,7,11,18,1926,1930,4,No,0,0.96,0.0,-0.96,661,0,-661,1974,0,-1974,611.0,0.0,-611.0,0.0,0.0,0.0
<a href=/player/wapns001>wapns001</a>,Steve Wapnick,Toronto Blue Jays,BJAYS,1,2,1,3,1991,1991,0,No,0,-0.18,-0.65,-0.47,19,21,2,18,54,36,15.0,0.0,-15.0,0.0,0.0,0.0
<a href=/player/warda101>warda101</a>,Aaron Ward,New York Yankees,YANKS,2,4,3,7,1927,1930,3,No,0,2.12,-0.44,-2.56,145,285,140,550,851,301,0.0,0.0,0.0,15000.0,0.0,-15000.0
<a href=/player/wardc001>wardc001</a>,Curt Wardle,Minnesota Twins,TWINS,4,9,7,16,1985,1995,10,No,0,10.17,8.8,-1.37,960,260,-700,2169,213,-1956,3138.0,2882.0,-256.0,1000000.0,0.0,-1000000.0
<a href=/player/wardc001>wardc001</a>,Curt Wardle,Cleveland Indians,INDINS,1,1,1,2,1987,1990,3,No,0,0.0,-0.28,-0.28,0,16,16,0,0,0,0.0,67.0,67.0,0.0,0.0,0.0
<a href=/player/wardc002>wardc002</a>,Colin Ward,Detroit Tigers,TIGRS,1,1,1,2,1984,1984,0,No,0,0.02,0.0,-0.02,12,0,-12,2,0,-2,37.0,0.0,-37.0,0.0,0.0,0.0
<a href=/player/wardc002>wardc002</a>,Colin Ward,San Francisco Giants,GIANTS,1,2,2,4,1987,1988,1,No,0,0.0,0.35,0.35,0,47,47,0,92,92,0.0,0.0,0.0,0.0,0.0,0.0
<a href=/player/wardc002>wardc002</a>,Colin Ward,San Francisco Giants,GIANTS,1,1,1,2,1985,1989,4,No,0,0.0,0.0,0.0,0,0,0,0,0,0,0.0,0.0,0.0,0.0,0.0,0.0
<a href=/player/wardc003>wardc003</a>,Colby Ward,California Angels,ANGELS,1,1,1,2,1989,1996,7,No,0,0.15,0.0,-0.15,22,0,-22,0,0,0,108.0,0.0,-108.0,0.0,0.0,0.0
<a href=/player/wardc102>wardc102</a>,Chuck Ward,Pittsburgh Pirates,PIRATS,2,4,3,7,1918,1922,4,No,0,39.97,14.96,-25.01,1164,899,-265,2135,3669,1534,8893.0,0.0,-8893.0,4200.0,0.0,-4200.0
<a href=/player/wardd001>wardd001</a>,Duane Ward,Atlanta Braves,BRAVES,2,2,2,4,1986,2008,22,No,0,16.77,73.29,56.52,531,1476,945,0,1238,1238,3573.0,10890.0,7317.0,650000.0,0.0,-650000.0
<a href=/player/wardd002>wardd002</a>,Daryle Ward,Detroit Tigers,TIGRS,6,13,15,28,1996,2010,14,No,1,13.89,24.32,10.43,4127,1434,-2693,10052,2196,-7856,4562.0,6757.0,2195.0,11529000.0,0.0,-11529000.0
<a href=/player/wardd002>wardd002</a>,Daryle Ward,Houston Astros,ASTROS,1,1,1,2,2003,2004,1,No,0,-1.07,0.0,1.07,52,0,-52,114,0,-114,0.0,0.0,0.0,0.0,0.0,0.0
<a href=/player/wardd002>wardd002</a>,Daryle Ward,Washington Nationals,NATEX,1,1,1,2,2006,2011,5,No,0,0.15,-0.89,-1.04,20,29,9,27,27,0,0.0,257.0,257.0,700000.0,0.0,-700000.0
<a href=/player/wardd101>wardd101</a>,Dick Ward,Chicago Cubs,CUBS,1,3,1,4,1934,1940,6,No,0,-0.12,5.38,5.5,10,264,254,1,289,288,23.0,2233.0,2210.0,0.0,0.0,0.0
<a href=/player/wardg001>wardg001</a>,Gary Ward,Minnesota Twins,TWINS,8,14,15,29,1983,2007,24,No,6,16.91,44.59,27.68,1528,1790,262,4098,5077,979,3115.0,6166.0,3051.0,738500.0,0.0,-738500.0
<a href=/player/wardj103>wardj103</a>,Jay Ward,Kansas City Athletics,ATLTCS,2,4,3,7,1961,1962,1,No,0,-0.07,-0.09,-0.02,40,20,-20,51,37,-14,0.0,0.0,0.0,0.0,0.0,0.0
<a href=/player/wardj103>wardj103</a>,Jay Ward,Los Angeles Dodgers,DOGRS,1,1,1,2,1962,1962,0,No,0,-0.14,0.0,0.14,21,0,-21,53,0,-53,0.0,0.0,0.0,0.0,0.0,0.0
<a href=/player/wardj103>wardj103</a>,Jay Ward,Cleveland Indians,INDINS,2,2,2,4,1970,1973,3,No,0,5.62,2.87,-2.75,277,239,-38,6,11,5,1317.0,439.0,-878.0,0.0,0.0,0.0
<a href=/player/wardp101>wardp101</a>,Preston Ward,Chicago Cubs,CUBS,7,18,16,34,1953,1965,12,No,0,5.64,21.93,16.29,1405,1825,420,3839,2173,-1666,1451.0,4951.0,3500.0,82000.0,0.0,-82000.0
<a href=/player/wardp101>wardp101</a>,Preston Ward,Pittsburgh Pirates,PIRATS,2,4,2,6,1956,1961,5,No,0,0.64,4.92,4.28,352,489,137,904,1463,559,547.0,0.0,-547.0,0.0,0.0,0.0
<a href=/player/wardp101>wardp101</a>,Preston Ward,Cleveland Indians,INDINS,18,28,30,58,1958,1984,26,No,0,63.62,52.24,-11.38,5094,5420,326,14869,17997,3128,4436.0,3464.0,-972.0,307350.0,0.0,-307350.0
<a href=/player/wardp102>wardp102</a>,Pete Ward,Baltimore Orioles,ORLS,4,10,7,17,1963,1973,10,No,0,64.06,37.52,-26.54,3307,1677,-1630,9685,6745,-2940,2176.0,306.0,-1870.0,108500.0,0.0,-108500.0
<a href=/player/wardp102>wardp102</a>,Pete Ward,Chicago White Sox,WSOX,2,2,3,5,1969,1970,1,No,0,0.75,0.0,-0.75,97,0,-97,90,0,-90,74.0,0.0,-74.0,28500.0,0.0,-28500.0
<a href=/player/wardp103>wardp103</a>,Piggy Ward,Baltimore Orioles,BLN,2,3,2,5,1893,1894,1,No,0,0.56,3.4,2.84,50,114,64,211,180,-31,99.0,1102.0,1003.0,0.0,0.0,0.0
<a href=/player/wardt001>wardt001</a>,Turner Ward,New York Yankees,YANKS,1,2,1,3,1989,1992,3,No,0,1.27,3.12,1.85,281,519,238,803,1911,1108,0.0,0.0,0.0,0.0,0.0,0.0
<a href=/player/wardt001>wardt001</a>,Turner Ward,Cleveland Indians,INDINS,4,5,9,14,1991,1996,5,No,0,12.63,7.08,-5.55,801,582,-219,2368,1823,-545,1452.0,1275.0,-177.0,3575000.0,0.0,-3575000.0
<a href=/player/wareb101>wareb101</a>,Buzzy Wares,St.Louis Browns,ORLS,1,4,2,6,1915,1924,9,No,0,0.0,-0.32,-0.32,0,2,2,0,1,1,0.0,10.0,10.0,0.0,0.0,0.0
<a href=/player/wareb101>wareb101</a>,Buzzy Wares,Montgomery,Montgomery,1,3,2,5,1912,1913,1,No,0,-0.14,0.0,0.14,252,0,-252,843,0,-843,0.0,0.0,0.0,0.0,0.0,0.0
<a href=/player/warnj101>warnj101</a>,Jack Warner,Vernon,Vernon,1,1,5,6,1925,1927,2,No,0,1.07,0.0,-1.07,324,0,-324,1271,0,-1271,0.0,0.0,0.0,0.0,0.0,0.0
<a href=/player/warnj101>warnj101</a>,Jack Warner,Detroit Tigers,TIGRS,1,1,1,2,1928,1928,0,No,0,0.0,0.0,0.0,0,0,0,0,0,0,0.0,0.0,0.0,0.0,0.0,0.0
<a href=/player/warnj101>warnj101</a>,Jack Warner,Brooklyn Dodgers,DOGRS,6,13,10,23,1932,1948,16,No,0,22.8,18.44,-4.36,1723,1313,-410,5249,4047,-1202,2633.0,2535.0,-98.0,0.0,0.0,0.0
<a href=/player/warnj101>warnj101</a>,Jack Warner,Philadelphia Phillies,PHILS,1,3,1,4,1933,1934,1,No,0,0.0,-0.13,-0.13,0,10,10,0,32,32,0.0,0.0,0.0,0.0,0.0,0.0
<a href=/player/warnj102>warnj102</a>,Jackie Warner,California Angels,ANGELS,4,5,5,10,1967,1974,7,No,0,-0.7,4.94,5.64,265,604,339,780,1757,977,66.0,0.0,-66.0,57000.0,0.0,-57000.0
<a href=/player/warnl101>warnl101</a>,Lon Warneke,Chicago Cubs,CUBS,1,1,2,3,1936,1941,5,No,0,15.14,2.86,-12.28,366,328,-38,461,1111,650,3473.0,437.0,-3036.0,15500.0,0.0,-15500.0
<a href=/player/warra001>warra001</a>,Adam Warren,New York Yankees,YANKS,2,5,2,7,2015,2017,2,Yes,0,1.29,3.2,1.91,400,263,-137,1373,1083,-290,113.0,0.0,-113.0,12429743.0,0.0,-12429743.0
<a href=/player/warra001>warra001</a>,Adam Warren,Chicago Cubs,CUBS,1,4,1,5,2016,2016,0,No,0,9.71,1.2,-8.51,545,54,-491,1768,0,-1768,353.0,80.0,-273.0,0.0,0.0,0.0
<a href=/player/warra001>warra001</a>,Adam Warren,New York Yankees,YANKS,1,1,1,2,2018,2018,0,No,0,0.39,0.0,-0.39,24,0,-24,0,0,0,65.0,0.0,-65.0,3315000.0,0.0,-3315000.0
<a href=/player/warrm001>warrm001</a>,Mike Warren,Milwaukee Brewers,BREWRS,1,2,1,3,1982,1983,1,No,0,-0.85,-0.28,0.57,52,36,-16,0,52,52,614.0,0.0,-614.0,0.0,0.0,0.0
<a href=/player/warsr101>warsr101</a>,Rabbit Warstler,Boston Red Sox,RSOX,1,3,3,6,1933,1937,4,No,0,1.87,9.37,7.5,361,417,56,1356,657,-699,119.0,1357.0,1238.0,8500.0,0.0,-8500.0
<a href=/player/warsr101>warsr101</a>,Rabbit Warstler,Indianapolis,Indianapolis,1,1,3,4,1930,1945,15,No,0,-1.81,0.0,1.81,327,0,-327,1185,0,-1185,0.0,0.0,0.0,0.0,0.0,0.0
<a href=/player/wartd101>wartd101</a>,Dan Warthen,Montreal Expos,NATEX,1,2,2,4,1977,1979,2,No,0,-0.51,-1.74,-1.23,63,126,63,93,101,8,11.0,753.0,742.0,0.0,0.0,0.0
<a href=/player/wartd101>wartd101</a>,Dan Warthen,Philadelphia Phillies,PHILS,4,9,6,15,1978,1988,10,No,0,16.49,18.27,1.78,2081,1091,-990,4349,640,-3709,6661.0,2589.0,-4072.0,0.0,0.0,0.0
<a href=/player/warwc101>warwc101</a>,Carl Warwick,Los Angeles Dodgers,DOGRS,1,2,1,3,1961,1963,2,No,0,-1.3,1.55,2.85,292,144,-148,701,421,-280,0.0,0.0,0.0,0.0,0.0,0.0
<a href=/player/warwc101>warwc101</a>,Carl Warwick,St. Louis Cardinals,CARDS,2,5,4,9,1962,1965,3,No,0,0.93,8.59,7.66,640,305,-335,1722,489,-1233,727.0,472.0,-255.0,0.0,0.0,0.0
<a href=/player/warwc101>warwc101</a>,Carl Warwick,Houston Astros,ASTROS,9,14,14,28,1964,1978,14,No,0,34.4,13.08,-21.32,1890,2214,324,2333,7061,4728,10035.0,2590.0,-7445.0,0.0,0.0,0.0
<a href=/player/warwc101>warwc101</a>,Carl Warwick,Baltimore Orioles,ORLS,2,2,3,5,1966,1970,4,No,0,-0.16,-0.4,-0.24,29,86,57,36,210,174,0.0,0.0,0.0,0.0,0.0,0.0
<a href=/player/wasdj001>wasdj001</a>,John Wasdin,Oakland Athletics,ATLTCS,1,2,1,3,1997,1997,0,No,0,2.36,0.22,-2.14,184,108,-76,1,446,445,1019.0,0.0,-1019.0,0.0,0.0,0.0
<a href=/player/wasdj001>wasdj001</a>,John Wasdin,Boston Red Sox,RSOX,2,5,5,10,2000,2002,2,No,0,0.87,1.83,0.96,125,248,123,134,537,403,371.0,782.0,411.0,3375000.0,0.0,-3375000.0
<a href=/player/wasdj001>wasdj001</a>,John Wasdin,Baltimore Orioles,ORLS,1,1,1,2,2001,2002,1,No,0,0.0,0.12,0.12,0,24,24,0,2,2,0.0,132.0,132.0,0.0,0.0,0.0
<a href=/player/wasdj001>wasdj001</a>,John Wasdin,Pittsburgh Pirates,PIRATS,1,1,1,2,2003,2003,0,No,0,-0.6,0.0,0.6,3,0,-3,0,0,0,15.0,0.0,-15.0,0.0,0.0,0.0
<a href=/player/wasdj101>wasdj101</a>,Jimmy Wasdell,Minneapolis,Minneapolis,1,1,3,4,1937,1946,9,No,0,-1.14,0.0,1.14,124,0,-124,429,0,-429,0.0,0.0,0.0,0.0,0.0,0.0
<a href=/player/wasdj101>wasdj101</a>,Jimmy Wasdell,Brooklyn Dodgers,DOGRS,1,4,1,5,1941,1948,7,No,0,4.25,10.42,6.17,798,406,-392,2943,1540,-1403,336.0,0.0,-336.0,0.0,0.0,0.0
<a href=/player/washc001>washc001</a>,Claudell Washington,Oakland Athletics,ATLTCS,2,3,4,7,1977,1978,1,No,0,1.93,-0.88,-2.81,219,180,-39,877,417,-460,0.0,629.0,629.0,0.0,0.0,0.0
<a href=/player/washc001>washc001</a>,Claudell Washington,Texas Rangers,RNGRS,5,9,9,18,1978,1982,4,No,0,22.0,5.65,-16.35,909,552,-357,2290,1222,-1068,4197.0,810.0,-3387.0,313000.0,0.0,-313000.0
<a href=/player/washc001>washc001</a>,Claudell Washington,Chicago White Sox,WSOX,2,2,2,4,1980,1983,3,No,0,0.13,0.0,-0.13,79,0,-79,306,0,-306,0.0,0.0,0.0,0.0,0.0,0.0
<a href=/player/washc001>washc001</a>,Claudell Washington,Atlanta Braves,BRAVES,1,2,2,4,1986,1988,2,No,0,2.5,1.46,-1.04,350,271,-79,1144,976,-168,0.0,0.0,0.0,750000.0,0.0,-750000.0
<a href=/player/washc001>washc001</a>,Claudell Washington,California Angels,ANGELS,1,2,1,3,1990,1993,3,No,0,0.54,2.38,1.84,153,560,407,83,2347,2264,698.0,0.0,-698.0,675000.0,0.0,-675000.0
<a href=/player/washg102>washg102</a>,George Washington,Indianapolis,Indianapolis,1,1,3,4,1934,1947,13,No,0,-0.31,0.0,0.31,128,0,-128,405,0,-405,0.0,0.0,0.0,0.0,0.0,0.0
<a href=/player/washj001>washj001</a>,Jarrod Washburn,Seattle Mariners,MARNRS,1,1,2,3,2009,2012,3,No,0,-0.68,-0.44,0.24,8,25,17,0,1,1,129.0,377.0,248.0,9850000.0,0.0,-9850000.0
<a href=/player/washl101>washl101</a>,LaRue Washington,Texas Rangers,RNGRS,2,3,2,5,1980,1980,0,No,1,-0.15,1.32,1.47,9,109,100,9,388,379,0.0,0.0,0.0,0.0,0.0,0.0
<a href=/player/washr001>washr001</a>,Ron Washington,Kansas City Royals,ROYALS,1,1,1,2,1976,1976,0,No,0,-0.03,0.0,0.03,10,0,-10,20,0,-20,0.0,0.0,0.0,0.0,0.0,0.0
<a href=/player/washr001>washr001</a>,Ron Washington,Los Angeles Dodgers,DOGRS,1,1,1,2,1980,1980,0,No,0,1.54,0.0,-1.54,452,0,-452,1340,0,-1340,0.0,0.0,0.0,0.0,0.0,0.0
<a href=/player/washr101>washr101</a>,Ray Washburn,St. Louis Cardinals,CARDS,11,18,17,35,1969,1976,7,No,0,16.37,3.31,-13.06,1906,573,-1333,3074,793,-2281,4746.0,1182.0,-3564.0,35000.0,0.0,-35000.0
<a href=/player/washu001>washu001</a>,U L Washington,Kansas City Royals,ROYALS,1,1,2,3,1985,1985,0,No,0,0.55,0.0,-0.55,68,0,-68,209,0,-209,0.0,0.0,0.0,0.0,0.0,0.0
<a href=/player/wasim001>wasim001</a>,Mark Wasinger,San Diego Padres,PADRS,1,2,2,4,1987,1987,0,No,0,0.35,0.0,-0.35,47,0,-47,92,0,-92,0.0,0.0,0.0,0.0,0.0,0.0
<a href=/player/waslg101>waslg101</a>,Gary Waslewski,Boston Red Sox,RSOX,2,2,2,4,1968,1970,2,No,0,0.74,0.23,-0.51,58,170,112,73,424,351,62.0,0.0,-62.0,48000.0,0.0,-48000.0
<a href=/player/waslg101>waslg101</a>,Gary Waslewski,St. Louis Cardinals,CARDS,1,1,1,2,1969,1969,0,No,0,0.98,0.39,-0.59,72,61,-11,39,21,-18,402.0,190.0,-212.0,0.0,0.0,0.0
<a href=/player/waslg101>waslg101</a>,Gary Waslewski,Montreal Expos,NATEX,2,2,2,4,1970,1974,4,No,0,1.23,12.72,11.49,100,509,409,12,2140,2128,272.0,0.0,-272.0,0.0,0.0,0.0
<a href=/player/watef101>watef101</a>,Fred Waters,Milwaukee Braves,BRAVES,2,10,2,12,1953,1960,7,No,0,8.19,12.74,4.55,794,729,-65,1824,3040,1216,2135.0,0.0,-2135.0,0.0,0.0,0.0
<a href=/player/wates101>wates101</a>,Steve Waterbury,St. Louis Cardinals,CARDS,12,25,23,48,1977,1998,21,No,4,86.36,129.83,43.47,6625,5322,-1303,21245,17737,-3508,7151.0,5142.0,-2009.0,1613333.0,0.0,-1613333.0
<a href=/player/wathd001>wathd001</a>,Dusty Wathan,San Diego Padres,PADRS,1,1,1,2,2002,2002,0,No,0,0.0,-0.11,-0.11,0,7,7,0,20,20,0.0,0.0,0.0,0.0,0.0,0.0
<a href=/player/watkg101>watkg101</a>,George Watkins,St. Louis Cardinals,CARDS,2,2,2,4,1934,1934,0,No,0,1.77,-0.52,-2.29,205,85,-120,753,252,-501,0.0,0.0,0.0,0.0,0.0,0.0
<a href=/player/watkg101>watkg101</a>,George Watkins,New York Giants,GIANTS,3,12,5,17,1934,1949,15,No,0,8.76,66.74,57.98,1268,2382,1114,4502,9585,5083,296.0,0.0,-296.0,0.0,0.0,0.0
<a href=/player/watkp001>watkp001</a>,Pat Watkins,Cincinnati Reds,REDS,1,1,1,2,1999,1999,0,No,0,0.0,0.0,0.0,0,0,0,0,0,0,0.0,0.0,0.0,0.0,0.0,0.0
<a href=/player/watkp001>watkp001</a>,Pat Watkins,Florida Marlins,MARLNS,1,1,1,2,1999,1999,0,No,0,-0.5,0.0,0.5,16,0,-16,22,0,-22,0.0,0.0,0.0,0.0,0.0,0.0
<a href=/player/watsa001>watsa001</a>,Allen Watson,St. Louis Cardinals,CARDS,7,12,13,25,1995,2004,9,No,1,7.92,19.88,11.96,1477,1521,44,4061,3047,-1014,1672.0,2465.0,793.0,14938333.0,0.0,-14938333.0
<a href=/player/watsa001>watsa001</a>,Allen Watson,San Francisco Giants,GIANTS,1,2,1,3,1996,2005,9,No,0,0.96,12.44,11.48,63,1182,1119,0,4497,4497,874.0,0.0,-874.0,240000.0,0.0,-240000.0
<a href=/player/watsa001>watsa001</a>,Allen Watson,New York Mets,METS,1,2,2,4,1999,1999,0,No,0,-0.48,0.0,0.48,3,0,-3,0,0,0,9.0,0.0,-9.0,750000.0,0.0,-750000.0
<a href=/player/watsb001>watsb001</a>,Bob Watson,Houston Astros,ASTROS,3,3,5,8,1979,1983,4,No,0,2.74,-0.68,-3.42,228,58,-170,347,7,-340,612.0,138.0,-474.0,0.0,0.0,0.0
<a href=/player/watsb001>watsb001</a>,Bob Watson,New York Yankees,YANKS,1,1,1,2,1982,1982,0,No,0,0.01,0.0,-0.01,171,0,-171,394,0,-394,0.0,0.0,0.0,570000.0,0.0,-570000.0
<a href=/player/watsm001>watsm001</a>,Mark Watson,Milwaukee Brewers,BREWRS,1,1,1,2,1998,1998,0,No,0,-0.18,0.0,0.18,8,0,-8,0,0,0,19.0,0.0,-19.0,0.0,0.0,0.0
<a href=/player/watsm002>watsm002</a>,Matt Watson,Montreal Expos,NATEX,5,10,12,22,2002,2011,9,No,0,5.61,14.61,9.0,687,585,-102,161,612,451,1873.0,3946.0,2073.0,8655000.0,0.0,-8655000.0
<a href=/player/watsm102>watsm102</a>,Milt Watson,St. Louis Cardinals,CARDS,1,1,2,3,1918,1918,0,No,0,-0.22,-0.43,-0.21,62,22,-40,57,90,33,479.0,0.0,-479.0,0.0,0.0,0.0
<a href=/player/watsm103>watsm103</a>,Mule Watson,Boston Braves,BRAVES,9,18,16,34,1923,1938,15,No,0,22.25,29.52,7.27,1842,2916,1074,4975,10263,5288,4661.0,3399.0,-1262.0,56400.0,0.0,-56400.0
<a href=/player/watst001>watst001</a>,Tony Watson,Pittsburgh Pirates,PIRATS,1,1,2,3,2017,2017,0,Yes,0,0.39,0.0,-0.39,48,0,-48,0,0,0,60.0,0.0,-60.0,5600000.0,0.0,-5600000.0
<a href=/player/watst001>watst001</a>,Tony Watson,Anaheim Angels,ANGELS,1,1,3,4,2021,2021,0,Yes,0,0.65,-0.36,-1.01,52,27,-25,0,0,0,73.0,63.0,-10.0,1000000.0,0.0,-1000000.0
<a href=/player/watwj101>watwj101</a>,Johnny Watwood,Chicago White Sox,WSOX,3,8,5,13,1932,1935,3,No,0,3.4,4.58,1.18,902,283,-619,3430,766,-2664,0.0,735.0,735.0,34500.0,0.0,-34500.0
<a href=/player/watwj101>watwj101</a>,Johnny Watwood,Boston Red Sox,RSOX,1,3,1,4,1933,1937,4,No,0,0.0,5.56,5.56,0,404,404,0,1495,1495,0.0,0.0,0.0,8250.0,0.0,-8250.0
<a href=/player/wayng001>wayng001</a>,Gary Wayne,Minnesota Twins,TWINS,1,2,1,3,1993,1994,1,No,0,0.21,-1.18,-1.39,130,34,-96,1,0,-1,187.0,132.0,-55.0,0.0,0.0,0.0
<a href=/player/waynj001>waynj001</a>,Justin Wayne,Montreal Expos,NATEX,2,6,6,12,2002,2005,3,No,0,7.25,0.27,-6.98,492,319,-173,648,239,-409,1719.0,1333.0,-386.0,4812500.0,0.0,-4812500.0
<a href=/player/weatd001>weatd001</a>,David Weathers,Florida Marlins,MARLNS,3,3,3,6,1996,1999,3,No,0,-0.83,3.9,4.73,87,283,196,125,682,557,117.0,312.0,195.0,675000.0,0.0,-675000.0
<a href=/player/weatd001>weatd001</a>,David Weathers,New York Yankees,YANKS,2,2,3,5,1997,2005,8,No,0,0.34,4.28,3.94,155,341,186,511,1162,651,50.0,4.0,-46.0,2435000.0,0.0,-2435000.0
<a href=/player/weatd001>weatd001</a>,David Weathers,Milwaukee Brewers,BREWRS,1,2,2,4,2001,2003,2,No,0,0.61,-1.88,-2.49,56,108,52,0,117,117,85.0,715.0,630.0,1200000.0,0.0,-1200000.0
<a href=/player/weatd001>weatd001</a>,David Weathers,New York Mets,METS,1,2,1,3,2004,2004,0,No,0,-0.5,0.91,1.41,53,86,33,2,359,357,109.0,0.0,-109.0,3933333.0,0.0,-3933333.0
<a href=/player/weatr101>weatr101</a>,Roy Weatherly,Cleveland Indians,INDINS,5,7,7,14,1942,1948,6,No,0,26.71,21.32,-5.39,1251,1052,-199,4956,4042,-914,0.0,0.0,0.0,29000.0,0.0,-29000.0
<a href=/player/weava101>weava101</a>,Art Weaver,St.Louis Browns,ORLS,3,4,4,8,1905,1907,2,No,0,-1.04,4.18,5.22,52,223,171,153,810,657,0.0,0.0,0.0,0.0,0.0,0.0
<a href=/player/weave001>weave001</a>,Eric Weaver,Los Angeles Dodgers,DOGRS,1,1,1,2,1998,1998,0,No,0,-0.33,0.0,0.33,8,0,-8,0,0,0,28.0,0.0,-28.0,0.0,0.0,0.0
<a href=/player/weavf101>weavf101</a>,Floyd Weaver,Cleveland Indians,INDINS,1,1,2,3,1966,1970,4,No,0,0.0,-0.53,-0.53,0,142,142,0,357,357,0.0,0.0,0.0,0.0,0.0,0.0
<a href=/player/weavf101>weavf101</a>,Floyd Weaver,Milwaukee Brewers,BREWRS,2,3,2,5,1972,1974,2,No,0,0.0,0.87,0.87,0,19,19,0,1,1,0.0,76.0,76.0,0.0,0.0,0.0
<a href=/player/weavj001>weavj001</a>,Jim Weaver,Minnesota Twins,TWINS,4,9,7,16,1985,1995,10,No,0,10.17,8.8,-1.37,960,260,-700,2169,213,-1956,3138.0,2882.0,-256.0,1000000.0,0.0,-1000000.0
<a href=/player/weavj001>weavj001</a>,Jim Weaver,Chicago White Sox,WSOX,1,1,1,2,1989,1989,0,No,0,-0.19,0.0,0.19,12,0,-12,20,0,-20,0.0,0.0,0.0,0.0,0.0,0.0
<a href=/player/weavj002>weavj002</a>,Jeff Weaver,Detroit Tigers,TIGRS,1,2,3,5,2002,2010,8,No,0,1.2,9.65,8.45,49,784,735,0,1705,1705,712.0,3903.0,3191.0,2350000.0,0.0,-2350000.0
<a href=/player/weavj002>weavj002</a>,Jeff Weaver,New York Yankees,YANKS,1,4,1,5,2003,2005,2,No,0,4.25,2.4,-1.85,506,36,-470,179,2,-177,2047.0,616.0,-1431.0,4150000.0,0.0,-4150000.0
<a href=/player/weavj002>weavj002</a>,Jeff Weaver,Anaheim Angels,ANGELS,1,2,1,3,2006,2010,4,No,0,-0.08,0.02,0.1,32,20,-12,35,21,-14,250.0,0.0,-250.0,8325000.0,0.0,-8325000.0
<a href=/player/weavj101>weavj101</a>,Jim Weaver,Washington Senators,TWINS,1,3,1,4,1929,1929,0,No,0,0.0,0.0,0.0,0,0,0,0,0,0,0.0,0.0,0.0,0.0,0.0,0.0
<a href=/player/weavj101>weavj101</a>,Jim Weaver,Baltimore,Baltimore,1,2,3,5,1930,1930,0,No,0,-0.48,0.0,0.48,34,0,-34,24,0,-24,173.0,0.0,-173.0,0.0,0.0,0.0
<a href=/player/weavj101>weavj101</a>,Jim Weaver,Chicago Cubs,CUBS,1,3,2,5,1934,1941,7,No,0,3.72,22.26,18.54,346,634,288,358,941,583,2252.0,4458.0,2206.0,0.0,0.0,0.0
<a href=/player/weavj102>weavj102</a>,Jim Weaver,Cleveland Indians,INDINS,2,4,4,8,1967,1969,2,No,0,1.58,2.6,1.02,217,267,50,702,761,59,0.0,0.0,0.0,0.0,0.0,0.0
<a href=/player/weavj102>weavj102</a>,Jim Weaver,Houston Astros,ASTROS,2,2,2,4,1967,1978,11,No,0,0.44,2.08,1.64,85,1214,1129,71,4740,4669,159.0,0.0,-159.0,0.0,0.0,0.0
<a href=/player/weavl001>weavl001</a>,Luke Weaver,St. Louis Cardinals,CARDS,1,4,1,5,2018,2018,0,Yes,0,4.82,0.0,-4.82,382,0,-382,1034,0,-1034,549.0,0.0,-549.0,550800.0,0.0,-550800.0
<a href=/player/weavm101>weavm101</a>,Monte Weaver,Baltimore,Baltimore,2,2,8,10,1931,1934,3,No,0,18.55,0.0,-18.55,986,0,-986,2913,0,-2913,3095.0,0.0,-3095.0,0.0,0.0,0.0
<a href=/player/weavo101>weavo101</a>,Orlie Weaver,Chicago Cubs,CUBS,3,6,7,13,1911,1916,5,No,0,-3.91,1.45,5.36,376,507,131,960,1665,705,899.0,27.0,-872.0,4500.0,0.0,-4500.0
<a href=/player/weavr101>weavr101</a>,Roger Weaver,Detroit Tigers,TIGRS,2,2,2,4,1982,1983,1,No,0,0.0,-0.76,-0.76,0,14,14,0,33,33,0.0,0.0,0.0,0.0,0.0,0.0
<a href=/player/webbd001>webbd001</a>,Daniel Webb,Toronto Blue Jays,BJAYS,1,2,1,3,2012,2012,0,No,0,-0.18,0.35,0.53,100,54,-46,0,0,0,330.0,131.0,-199.0,0.0,0.0,0.0
<a href=/player/webbe101>webbe101</a>,Earl Webb,Toledo,Toledo,1,1,2,3,1925,1926,1,No,0,0.0,0.0,0.0,4,0,-4,4,0,-4,0.0,0.0,0.0,0.0,0.0,0.0
<a href=/player/webbe101>webbe101</a>,Earl Webb,New York Giants,GIANTS,1,1,1,2,1925,1927,2,No,0,0.0,0.26,0.26,0,140,140,0,531,531,0.0,0.0,0.0,3600.0,0.0,-3600.0
<a href=/player/webbe101>webbe101</a>,Earl Webb,Washington Senators,TWINS,1,1,1,2,1930,1930,0,No,0,8.5,-0.07,-8.57,330,6,-324,1383,5,-1378,0.0,0.0,0.0,0.0,0.0,0.0
<a href=/player/webbe101>webbe101</a>,Earl Webb,Boston Red Sox,RSOX,2,3,3,6,1932,1936,4,No,0,1.18,12.1,10.92,183,698,515,710,2971,2261,0.0,0.0,0.0,23500.0,0.0,-23500.0
<a href=/player/webbe101>webbe101</a>,Earl Webb,Louisville,Louisville,1,1,2,3,1926,1926,0,No,0,3.23,0.0,-3.23,164,0,-164,554,0,-554,0.0,0.0,0.0,0.0,0.0,0.0
<a href=/player/webbh101>webbh101</a>,Hank Webb,New York Mets,METS,2,4,2,6,1977,1979,2,No,0,0.2,5.03,4.83,10,268,258,0,1093,1093,24.0,0.0,-24.0,0.0,0.0,0.0
<a href=/player/webbl102>webbl102</a>,Les Webber,Cleveland Indians,INDINS,1,3,1,4,1948,1948,0,No,0,0.0,0.0,0.0,0,0,0,0,0,0,0.0,0.0,0.0,0.0,0.0,0.0
<a href=/player/webbr001>webbr001</a>,Ryan Webb,Oakland Athletics,ATLTCS,2,5,3,8,2009,2016,7,No,0,1.67,5.28,3.61,416,684,268,588,2314,1726,340.0,0.0,-340.0,410000.0,0.0,-410000.0
<a href=/player/webbr001>webbr001</a>,Ryan Webb,San Diego Padres,PADRS,7,19,13,32,2010,2021,11,Yes,0,21.8,17.69,-4.11,1883,1364,-519,3716,4253,537,2638.0,362.0,-2276.0,9990300.0,0.0,-9990300.0
<a href=/player/webbr001>webbr001</a>,Ryan Webb,Baltimore Orioles,ORLS,1,3,2,5,2015,2015,0,Yes,0,0.0,0.0,0.0,0,0,0,0,0,0,0.0,0.0,0.0,0.0,0.0,0.0
<a href=/player/webbr101>webbr101</a>,Red Webb,New York Giants,GIANTS,14,31,27,58,1949,1968,19,No,0,59.86,70.44,10.58,4286,4168,-118,14522,10114,-4408,1384.0,8678.0,7294.0,127500.0,0.0,-127500.0
<a href=/player/webbs101>webbs101</a>,Skeeter Webb,Cleveland Indians,INDINS,1,1,2,3,1940,1940,0,No,0,-2.42,0.0,2.42,342,0,-342,1323,0,-1323,0.0,0.0,0.0,0.0,0.0,0.0
<a href=/player/webbs101>webbs101</a>,Skeeter Webb,Chicago White Sox,WSOX,1,1,1,2,1944,1946,2,No,0,-0.96,-0.17,0.79,232,17,-215,719,19,-700,0.0,0.0,0.0,6000.0,0.0,-6000.0
<a href=/player/webbt001>webbt001</a>,Tyler Webb,New York Yankees,YANKS,2,3,3,6,2017,2017,0,Yes,0,5.53,0.11,-5.42,317,13,-304,917,45,-872,707.0,0.0,-707.0,0.0,0.0,0.0
<a href=/player/weben001>weben001</a>,Neil Weber,Arizona Diamondbacks,DBACKS,1,1,1,2,1999,1999,0,No,0,0.0,0.0,0.0,0,0,0,0,0,0,0.0,0.0,0.0,0.0,0.0,0.0
<a href=/player/websa001>websa001</a>,Allen Webster,Los Angeles Dodgers,DOGRS,5,22,14,36,2012,2021,9,Yes,0,4.41,31.13,26.72,1016,1541,525,2843,5562,2719,1152.0,835.0,-317.0,78709000.0,0.0,-78709000.0
<a href=/player/websa001>websa001</a>,Allen Webster,Boston Red Sox,RSOX,3,6,4,10,2014,2019,5,Yes,0,1.08,2.41,1.33,219,69,-150,105,2,-103,1466.0,676.0,-790.0,3666000.0,0.0,-3666000.0
<a href=/player/websm001>websm001</a>,Mitch Webster,Toronto Blue Jays,BJAYS,1,1,1,2,1985,1986,1,No,0,9.96,0.0,-9.96,462,0,-462,1862,0,-1862,0.0,0.0,0.0,0.0,0.0,0.0
<a href=/player/websm001>websm001</a>,Mitch Webster,Montreal Expos,NATEX,3,5,5,10,1988,2001,13,No,0,10.34,12.73,2.39,993,989,-4,2591,1867,-724,539.0,722.0,183.0,837500.0,0.0,-837500.0
<a href=/player/websm001>websm001</a>,Mitch Webster,Chicago Cubs,CUBS,1,1,1,2,1989,1991,2,No,0,3.14,-0.41,-3.55,141,84,-57,513,181,-332,0.0,0.0,0.0,550000.0,0.0,-550000.0
<a href=/player/websm001>websm001</a>,Mitch Webster,Cleveland Indians,INDINS,1,1,1,2,1991,1991,0,No,0,-0.92,-0.88,0.04,36,14,-22,106,0,-106,0.0,104.0,104.0,750000.0,0.0,-750000.0
<a href=/player/websm001>websm001</a>,Mitch Webster,Pittsburgh Pirates,PIRATS,1,1,1,2,1991,1991,0,No,0,0.19,-0.17,-0.36,417,16,-401,736,23,-713,0.0,0.0,0.0,0.0,0.0,0.0
<a href=/player/websr101>websr101</a>,Ray Webster,Cleveland Indians,INDINS,2,2,2,4,1960,1960,0,No,0,1.58,-0.36,-1.94,47,6,-41,8,0,-8,62.0,7.0,-55.0,0.0,0.0,0.0
<a href=/player/websr102>websr102</a>,Ramon Webster,Oakland Athletics,ATLTCS,3,3,3,6,1970,1971,1,No,0,-0.66,0.1,0.76,339,68,-271,884,161,-723,0.0,17.0,17.0,17000.0,0.0,-17000.0
<a href=/player/weekj001>weekj001</a>,Jemile Weeks,Oakland Athletics,ATLTCS,1,2,1,3,2013,2014,1,No,0,-0.03,-1.33,-1.3,3,41,38,13,1,-12,0.0,121.0,121.0,0.0,0.0,0.0
<a href=/player/weekj001>weekj001</a>,Jemile Weeks,Baltimore Orioles,ORLS,1,2,2,4,2014,2014,0,Yes,0,0.24,-0.08,-0.32,17,19,2,41,45,4,0.0,0.0,0.0,515000.0,0.0,-515000.0
<a href=/player/weekj101>weekj101</a>,John Weekly,Houston Astros,ASTROS,1,2,1,3,1964,1964,0,No,0,0.0,0.62,0.62,0,89,89,0,342,342,0.0,0.0,0.0,0.0,0.0,0.0
<a href=/player/weekj101>weekj101</a>,John Weekly,Houston Astros,ASTROS,1,2,1,3,1966,1967,1,No,0,0.0,0.2,0.2,0,20,20,0,3,3,0.0,71.0,71.0,0.0,0.0,0.0
<a href=/player/wehmh101>wehmh101</a>,Herm Wehmeier,Philadelphia Phillies,PHILS,4,7,7,14,1956,1968,12,No,0,28.54,33.07,4.53,1270,1974,704,1527,5948,4421,4802.0,2050.0,-2752.0,0.0,0.0,0.0
<a href=/player/wehrd001>wehrd001</a>,Dave Wehrmeister,San Diego Padres,PADRS,2,2,2,4,1979,1979,0,No,1,-0.06,-0.02,0.04,5,75,70,0,225,225,21.0,0.0,-21.0,0.0,0.0,0.0
<a href=/player/wehrd001>wehrd001</a>,Dave Wehrmeister,New York Yankees,YANKS,1,1,2,3,1983,1983,0,No,0,-0.39,0.0,0.39,14,0,-14,2,0,-2,45.0,0.0,-45.0,0.0,0.0,0.0
<a href=/player/weigp001>weigp001</a>,Patrick Weigel,Atlanta Braves,BRAVES,1,2,1,3,2021,2021,0,Yes,0,0.01,-0.18,-0.19,6,32,26,0,78,78,12.0,0.0,-12.0,0.0,0.0,0.0
<a href=/player/weigr101>weigr101</a>,Ralph Weigel,Cleveland Indians,INDINS,1,1,1,2,1948,1948,0,No,0,-0.44,1.16,1.6,66,83,17,179,274,95,0.0,0.0,0.0,0.0,0.0,0.0
<a href=/player/weikd101>weikd101</a>,Dick Weik,Washington Senators,TWINS,8,17,15,32,1950,1963,13,No,0,11.48,15.58,4.1,1173,2463,1290,3483,7409,3926,910.0,1792.0,882.0,17500.0,0.0,-17500.0
<a href=/player/weikd101>weikd101</a>,Dick Weik,Cleveland Indians,INDINS,4,8,7,15,1953,1960,7,No,0,29.6,3.08,-26.52,1527,466,-1061,3515,525,-2990,4632.0,1595.0,-3037.0,15900.0,0.0,-15900.0
<a href=/player/weilb101>weilb101</a>,Bob Weiland,Chicago White Sox,WSOX,3,9,4,13,1930,1936,6,No,0,0.81,-0.65,-1.46,234,127,-107,748,417,-331,0.0,39.0,39.0,19600.0,0.0,-19600.0
<a href=/player/weilb101>weilb101</a>,Bob Weiland,Chicago White Sox,WSOX,1,1,1,2,1931,1934,3,No,0,4.66,1.38,-3.28,186,174,-12,160,194,34,1403.0,1583.0,180.0,3000.0,0.0,-3000.0
<a href=/player/weilb101>weilb101</a>,Bob Weiland,Boston Red Sox,RSOX,4,10,7,17,1934,1940,6,No,0,25.17,35.69,10.52,1726,1087,-639,6233,3303,-2930,2563.0,4057.0,1494.0,43500.0,0.0,-43500.0
<a href=/player/weilb101>weilb101</a>,Bob Weiland,Cleveland Indians,INDINS,2,4,2,6,1934,1940,6,No,0,1.33,10.59,9.26,342,673,331,1172,2639,1467,96.0,0.0,-96.0,5000.0,0.0,-5000.0
<a href=/player/weilk001>weilk001</a>,Kyle Weiland,Boston Red Sox,RSOX,2,6,3,9,2011,2019,8,No,0,10.72,7.46,-3.26,739,668,-71,662,2223,1561,960.0,157.0,-803.0,971000.0,0.0,-971000.0
<a href=/player/weimj101>weimj101</a>,Jake Weimer,Chicago Cubs,CUBS,1,1,2,3,1905,1911,6,No,0,11.75,19.21,7.46,171,733,562,246,2999,2753,1889.0,0.0,-1889.0,0.0,0.0,0.0
<a href=/player/weimj101>weimj101</a>,Jake Weimer,Cincinnati Reds,REDS,1,2,2,4,1908,1910,2,No,0,-0.57,0.79,1.36,13,104,91,18,143,125,9.0,1093.0,1084.0,0.0,0.0,0.0
<a href=/player/weinl101>weinl101</a>,Lefty Weinert,Philadelphia Phillies,PHILS,1,1,1,2,1924,1924,0,No,0,0.0,0.0,0.0,0,0,0,0,0,0,0.0,0.0,0.0,3600.0,0.0,-3600.0
<a href=/player/weinl101>weinl101</a>,Lefty Weinert,Chicago Cubs,CUBS,1,2,1,3,1928,1932,4,No,0,0.0,1.97,1.97,0,170,170,0,586,586,0.0,0.0,0.0,4000.0,0.0,-4000.0
<a href=/player/weinp101>weinp101</a>,Phil Weintraub,New York Giants,GIANTS,1,3,1,4,1935,1947,12,No,0,0.93,6.58,5.65,74,650,576,80,2704,2624,660.0,0.0,-660.0,0.0,0.0,0.0
<a href=/player/weinp101>weinp101</a>,Phil Weintraub,Baltimore,Baltimore,1,1,1,2,1938,1938,0,No,0,2.49,0.0,-2.49,100,0,-100,421,0,-421,0.0,0.0,0.0,0.0,0.0,0.0
<a href=/player/weisa101>weisa101</a>,Al Weis,Chicago White Sox,WSOX,12,24,24,48,1967,1985,18,No,1,42.94,39.29,-3.65,3870,2650,-1220,10120,8109,-2011,6724.0,4885.0,-1839.0,267950.0,0.0,-267950.0
<a href=/player/weisw001>weisw001</a>,Walt Weiss,Oakland Athletics,ATLTCS,1,1,2,3,1992,1992,0,No,0,1.48,0.0,-1.48,158,0,-158,591,0,-591,0.0,0.0,0.0,760000.0,0.0,-760000.0
<a href=/player/welaj101>welaj101</a>,Johnny Welaj,Washington Senators,TWINS,16,29,30,59,1941,1963,22,No,0,24.05,43.96,19.91,2536,4015,1479,7469,11713,4244,2727.0,6408.0,3681.0,56000.0,0.0,-56000.0
<a href=/player/welaj101>welaj101</a>,Johnny Welaj,Philadelphia Athletics,ATLTCS,1,2,2,4,1943,1943,0,No,0,0.0,-0.05,-0.05,0,2,2,0,3,3,0.0,21.0,21.0,9500.0,0.0,-9500.0
<a href=/player/welcb001>welcb001</a>,Bob Welch,Los Angeles Dodgers,DOGRS,2,4,4,8,1987,1992,5,No,1,9.39,9.73,0.34,242,1063,821,1,1797,1796,3926.0,1084.0,-2842.0,1187500.0,0.0,-1187500.0
<a href=/player/welcc101>welcc101</a>,Curt Welch,St.Louis Cardinals,CARDS,1,2,4,6,1887,1897,10,No,0,9.58,4.43,-5.15,488,169,-319,2210,668,-1542,3.0,0.0,-3.0,0.0,0.0,0.0
<a href=/player/welcm001>welcm001</a>,Mike Welch,New York Mets,METS,1,1,1,2,1997,1999,2,No,0,-0.68,0.0,0.68,20,0,-20,3,0,-3,62.0,0.0,-62.0,0.0,0.0,0.0
<a href=/player/weldm101>weldm101</a>,Mike Welday,Chicago White Sox,WSOX,2,8,2,10,1909,1928,19,No,0,0.0,33.7,33.7,0,1837,1837,0,6519,6519,0.0,0.0,0.0,2400.0,0.0,-2400.0
<a href=/player/welkd001>welkd001</a>,Duke Welker,Pittsburgh Pirates,PIRATS,1,2,1,3,2013,2013,0,No,0,-0.24,-0.03,0.21,28,25,-3,122,92,-30,0.0,0.0,0.0,0.0,0.0,0.0
<a href=/player/welkd001>welkd001</a>,Duke Welker,Minnesota Twins,TWINS,1,1,1,2,2013,2014,1,No,0,0.04,0.24,0.2,2,4,2,0,1,1,4.0,40.0,36.0,0.0,0.0,0.0
<a href=/player/wellb001>wellb001</a>,Brad Wellman,Kansas City Royals,ROYALS,3,7,5,12,1982,1990,8,No,0,15.6,24.69,9.09,1105,393,-712,1343,512,-831,5715.0,4650.0,-1065.0,1318000.0,0.0,-1318000.0
<a href=/player/wellc001>wellc001</a>,Casper Wells,Detroit Tigers,TIGRS,7,12,11,23,2011,2021,10,Yes,0,17.56,10.21,-7.35,1262,701,-561,1311,661,-650,4444.0,2831.0,-1613.0,16933000.0,0.0,-16933000.0
<a href=/player/welld001>welld001</a>,David Wells,Detroit Tigers,TIGRS,8,15,19,34,1995,2010,15,No,1,14.27,22.97,8.7,4267,1601,-2666,10453,2795,-7658,4780.0,7012.0,2232.0,14390667.0,0.0,-14390667.0
<a href=/player/welld001>welld001</a>,David Wells,Cincinnati Reds,REDS,2,2,3,5,1995,1998,3,No,0,2.51,-0.84,-3.35,153,154,1,186,454,268,673.0,51.0,-622.0,0.0,0.0,0.0
<a href=/player/welld001>welld001</a>,David Wells,New York Yankees,YANKS,1,3,1,4,1999,2003,4,No,0,11.64,19.58,7.94,456,165,-291,1235,16,-1219,1600.0,3012.0,1412.0,0.0,0.0,0.0
<a href=/player/welld001>welld001</a>,David Wells,Toronto Blue Jays,BJAYS,2,3,5,8,2001,2001,0,No,0,1.34,-0.46,-1.8,17,81,64,2,117,115,302.0,78.0,-224.0,0.0,0.0,0.0
<a href=/player/welld001>welld001</a>,David Wells,Boston Red Sox,RSOX,1,1,1,2,2006,2009,3,No,0,-0.26,-0.21,0.05,54,48,-6,50,112,62,441.0,0.0,-441.0,4075000.0,0.0,-4075000.0
<a href=/player/wellg101>wellg101</a>,Greg Wells,Toronto Blue Jays,BJAYS,1,1,1,2,1982,1983,1,No,0,-0.5,-0.81,-0.31,15,152,137,57,369,312,0.0,0.0,0.0,0.0,0.0,0.0
<a href=/player/wellj001>wellj001</a>,Jared Wells,San Diego Padres,PADRS,1,1,1,2,2008,2009,1,No,0,-0.17,0.31,0.48,6,45,39,0,38,38,16.0,333.0,317.0,0.0,0.0,0.0
<a href=/player/wellk001>wellk001</a>,Kip Wells,Chicago White Sox,WSOX,1,3,2,5,2001,2002,1,No,0,9.76,-1.6,-11.36,587,29,-558,520,5,-515,4516.0,401.0,-4115.0,300000.0,0.0,-300000.0
<a href=/player/wellk001>wellk001</a>,Kip Wells,Pittsburgh Pirates,PIRATS,2,2,2,4,2006,2010,4,No,0,-0.07,-1.84,-1.77,2,228,226,0,194,194,24.0,247.0,223.0,4552000.0,0.0,-4552000.0
<a href=/player/wellt001>wellt001</a>,Terry Wells,Houston Astros,ASTROS,5,8,9,17,1990,2008,18,No,2,-0.57,6.64,7.21,220,1493,1273,632,4484,3852,677.0,482.0,-195.0,4015000.0,0.0,-4015000.0
<a href=/player/wellt002>wellt002</a>,Todd Wellemeyer,Chicago Cubs,CUBS,1,1,2,3,2006,2006,0,No,0,-0.02,0.0,0.02,36,0,-36,0,0,0,64.0,0.0,-64.0,0.0,0.0,0.0
<a href=/player/wellv001>wellv001</a>,Vernon Wells,Toronto Blue Jays,BJAYS,3,3,4,7,2011,2011,0,No,1,7.36,0.87,-6.49,588,128,-460,2216,275,-1941,0.0,152.0,152.0,0.0,0.0,0.0
<a href=/player/wellv001>wellv001</a>,Vernon Wells,Anaheim Angels,ANGELS,1,1,2,3,2013,2013,0,Yes,0,-0.08,0.0,0.08,130,0,-130,458,0,-458,0.0,0.0,0.0,0.0,0.0,0.0
<a href=/player/welsc001>welsc001</a>,Chris Welsh,New York Yankees,YANKS,6,13,11,24,1981,1992,11,No,0,27.03,19.65,-7.38,2401,1053,-1348,5956,3510,-2446,5438.0,699.0,-4739.0,913333.0,0.0,-913333.0
<a href=/player/welsc001>welsc001</a>,Chris Welsh,Montreal Expos,NATEX,1,1,1,2,1984,1985,1,No,0,0.73,0.0,-0.73,25,0,-25,0,0,0,229.0,0.0,-229.0,0.0,0.0,0.0
<a href=/player/welsj101>welsj101</a>,Jimmy Welsh,Seattle,Seattle,1,1,3,4,1924,1939,15,No,0,6.53,0.0,-6.53,553,0,-553,2315,0,-2315,0.0,0.0,0.0,0.0,0.0,0.0
<a href=/player/welsj101>welsj101</a>,Jimmy Welsh,Boston Braves,BRAVES,14,32,26,58,1928,1952,24,No,0,61.82,116.64,54.82,3287,6047,2760,11058,20048,8990,3053.0,10767.0,7714.0,50600.0,0.0,-50600.0
<a href=/player/welsj101>welsj101</a>,Jimmy Welsh,New York Giants,GIANTS,2,3,2,5,1929,1930,1,No,0,2.77,-1.87,-4.64,281,184,-97,1029,649,-380,0.0,0.0,0.0,0.0,0.0,0.0
<a href=/player/welsj101>welsj101</a>,Jimmy Welsh,Boston Braves,BRAVES,5,9,7,16,1930,1938,8,No,0,10.35,19.77,9.42,741,1862,1121,2307,7255,4948,1075.0,89.0,-986.0,16000.0,0.0,-16000.0
<a href=/player/wendj001>wendj001</a>,J.B. Wendelken,Boston Red Sox,RSOX,3,8,6,14,2013,2020,7,Yes,0,1.74,3.1,1.36,152,304,152,96,10,-86,1036.0,1375.0,339.0,5113000.0,0.0,-5113000.0
<a href=/player/wendj001>wendj001</a>,J.B. Wendelken,Chicago White Sox,WSOX,1,2,1,3,2015,2017,2,No,0,1.38,1.19,-0.19,101,94,-7,0,384,384,336.0,0.0,-336.0,0.0,0.0,0.0
<a href=/player/wendj002>wendj002</a>,Joey Wendle,Cleveland Indians,INDINS,2,2,2,4,2014,2019,5,No,0,1.27,-0.45,-1.72,215,94,-121,733,375,-358,0.0,0.0,0.0,6500000.0,0.0,-6500000.0
<a href=/player/wendj002>wendj002</a>,Joey Wendle,Oakland Athletics,ATLTCS,2,4,4,8,2017,2021,4,Yes,0,10.42,0.25,-10.17,504,191,-313,1839,676,-1163,0.0,0.0,0.0,535000.0,0.0,-535000.0
<a href=/player/wendt001>wendt001</a>,Turk Wendell,Atlanta Braves,BRAVES,1,2,2,4,1991,1993,2,No,0,0.81,1.0,0.19,361,259,-102,26,720,694,723.0,247.0,-476.0,0.0,0.0,0.0
<a href=/player/wendt001>wendt001</a>,Turk Wendell,Chicago Cubs,CUBS,2,4,4,8,1997,2001,4,No,0,3.27,3.1,-0.17,1097,717,-380,1379,2198,819,1191.0,830.0,-361.0,9308333.0,0.0,-9308333.0
<a href=/player/wendt001>wendt001</a>,Turk Wendell,New York Mets,METS,2,6,5,11,2001,2005,4,No,0,2.32,0.95,-1.37,695,209,-486,27,48,21,1207.0,444.0,-763.0,5800000.0,0.0,-5800000.0
<a href=/player/wengd001>wengd001</a>,Don Wengert,Oakland Athletics,ATLTCS,3,5,4,9,1997,2006,9,No,0,-1.08,-1.24,-0.16,199,140,-59,175,236,61,192.0,0.0,-192.0,392000.0,0.0,-392000.0
<a href=/player/wengd001>wengd001</a>,Don Wengert,San Diego Padres,PADRS,1,1,1,2,1998,1998,0,No,0,0.13,-0.14,-0.27,44,12,-32,15,0,-15,149.0,8.0,-141.0,240000.0,0.0,-240000.0
<a href=/player/wents101>wents101</a>,Stan Wentzel,Boston Braves,BRAVES,4,7,6,13,1946,1952,6,No,0,-0.23,24.56,24.79,358,848,490,547,3228,2681,596.0,210.0,-386.0,0.0,0.0,0.0
<a href=/player/weraj101>weraj101</a>,Julie Wera,StPaul,StPaul,1,1,1,2,1926,1926,0,No,0,0.01,0.0,-0.01,43,0,-43,58,0,-58,0.0,0.0,0.0,0.0,0.0,0.0
<a href=/player/weraj101>weraj101</a>,Julie Wera,New York Yankees,YANKS,1,2,1,3,1931,1947,16,No,0,0.0,24.32,24.32,0,1666,1666,0,7252,7252,0.0,0.0,0.0,0.0,0.0,0.0
<a href=/player/werbb101>werbb101</a>,Billy Werber,Boston Red Sox,RSOX,2,3,4,7,1936,1940,4,No,0,20.71,2.22,-18.49,1267,394,-873,4856,1328,-3528,671.0,596.0,-75.0,16000.0,0.0,-16000.0
<a href=/player/werhj101>werhj101</a>,Johnny Werhas,Los Angeles Dodgers,DOGRS,1,1,1,2,1967,1967,0,No,0,0.13,0.87,0.74,49,90,41,89,257,168,0.0,0.0,0.0,10000.0,0.0,-10000.0
<a href=/player/werlb101>werlb101</a>,Bill Werle,Pittsburgh Pirates,PIRATS,1,1,1,2,1952,1956,4,No,0,-0.28,0.21,0.49,38,80,42,9,41,32,117.0,400.0,283.0,0.0,0.0,0.0
<a href=/player/werlb101>werlb101</a>,Bill Werle,SanFrancisco,SanFrancisco,1,1,3,4,1948,1949,1,No,0,3.61,0.0,-3.61,294,0,-294,201,0,-201,1770.0,0.0,-1770.0,0.0,0.0,0.0
<a href=/player/werna001>werna001</a>,Andrew Werner,San Diego Padres,PADRS,1,2,2,4,2012,2016,4,No,0,-0.78,7.91,8.69,52,195,143,95,168,73,0.0,1566.0,1566.0,481000.0,0.0,-481000.0
<a href=/player/wernd101>wernd101</a>,Don Werner,Cincinnati Reds,REDS,1,2,2,4,1980,1980,0,No,0,-0.43,0.0,0.43,24,0,-24,73,0,-73,0.0,0.0,0.0,0.0,0.0,0.0
<a href=/player/wernd101>wernd101</a>,Don Werner,Kansas City Royals,ROYALS,1,2,1,3,1984,1986,2,No,0,-0.02,-0.09,-0.07,22,5,-17,15,0,-15,132.0,39.0,-93.0,0.0,0.0,0.0
<a href=/player/wertb001>wertb001</a>,Bill Wertz,Cleveland Indians,INDINS,1,1,1,2,1996,1996,0,No,0,0.0,0.0,0.0,0,0,0,0,0,0,0.0,0.0,0.0,0.0,0.0,0.0
<a href=/player/wertd101>wertd101</a>,Dennis Werth,New York Yankees,YANKS,1,1,1,2,1982,1982,0,No,0,-0.12,0.0,0.12,41,0,-41,19,0,-19,0.0,0.0,0.0,0.0,0.0,0.0
<a href=/player/wertd103>wertd103</a>,Don Wert,Detroit Tigers,TIGRS,3,8,7,15,1970,1979,9,No,0,1.68,25.88,24.2,545,2212,1667,1182,7310,6128,747.0,4256.0,3509.0,232600.0,0.0,-232600.0
<a href=/player/wertj001>wertj001</a>,Jayson Werth,Baltimore Orioles,ORLS,2,2,2,4,2000,2003,3,No,0,0.17,1.98,1.81,41,164,123,104,569,465,0.0,80.0,80.0,0.0,0.0,0.0
<a href=/player/wertj001>wertj001</a>,Jayson Werth,Toronto Blue Jays,BJAYS,3,7,7,14,2004,2014,10,No,0,3.57,12.83,9.26,587,928,341,810,1646,836,842.0,1398.0,556.0,7829600.0,0.0,-7829600.0
<a href=/player/wertj101>wertj101</a>,Johnny Werts,Boston Braves,BRAVES,1,3,1,4,1928,1928,0,No,0,0.0,-0.51,-0.51,0,14,14,0,6,6,0.0,65.0,65.0,10080.0,0.0,-10080.0
<a href=/player/wertv101>wertv101</a>,Vic Wertz,Detroit Tigers,TIGRS,6,16,16,32,1952,1961,9,No,0,19.6,10.08,-9.52,1436,1371,-65,2274,3811,1537,4378.0,2214.0,-2164.0,23200.0,0.0,-23200.0
<a href=/player/wertv101>wertv101</a>,Vic Wertz,Baltimore Orioles,ORLS,5,8,10,18,1954,1960,6,No,0,21.82,11.95,-9.87,1218,957,-261,3526,2530,-996,2291.0,1476.0,-815.0,0.0,0.0,0.0
<a href=/player/wertv101>wertv101</a>,Vic Wertz,Cleveland Indians,INDINS,3,4,5,9,1958,1965,7,No,0,9.07,15.07,6.0,1121,727,-394,4065,1984,-2081,0.0,1913.0,1913.0,0.0,0.0,0.0
<a href=/player/westd001>westd001</a>,David West,New York Mets,METS,2,6,3,9,1989,1991,2,No,2,34.39,9.58,-24.81,807,164,-643,0,204,204,6852.0,1699.0,-5153.0,378000.0,0.0,-378000.0
<a href=/player/westd001>westd001</a>,David West,Minnesota Twins,TWINS,1,1,1,2,1992,1993,1,No,0,3.78,1.22,-2.56,244,53,-191,60,0,-60,755.0,243.0,-512.0,0.0,0.0,0.0
<a href=/player/westd001>westd001</a>,David West,Houston Astros,ASTROS,1,1,1,2,1998,1998,0,No,0,-0.31,0.0,0.31,6,0,-6,0,0,0,6.0,0.0,-6.0,0.0,0.0,0.0
<a href=/player/westj001>westj001</a>,Jake Westbrook,Colorado Rockies,ROCKS,8,16,13,29,1997,2002,5,No,0,6.04,1.53,-4.51,876,711,-165,660,1343,683,2239.0,928.0,-1311.0,9375000.0,0.0,-9375000.0
<a href=/player/westj001>westj001</a>,Jake Westbrook,Montreal Expos,NATEX,1,3,1,4,1999,2001,2,No,0,1.49,-0.32,-1.81,57,27,-30,6,21,15,645.0,214.0,-431.0,0.0,0.0,0.0
<a href=/player/westj001>westj001</a>,Jake Westbrook,New York Yankees,YANKS,6,10,8,18,2000,2013,13,Yes,1,11.39,22.07,10.68,570,1540,970,441,4696,4255,3809.0,682.0,-3127.0,14660923.0,0.0,-14660923.0
<a href=/player/westj001>westj001</a>,Jake Westbrook,Cleveland Indians,INDINS,2,3,3,6,2010,2020,10,Yes,0,1.34,32.12,30.78,188,260,72,187,150,-37,1652.0,4025.0,2373.0,28000000.0,0.0,-28000000.0
<a href=/player/westm001>westm001</a>,Mickey Weston,Baltimore Orioles,ORLS,1,1,1,2,1990,1991,1,No,0,0.08,-0.6,-0.68,2,38,36,0,0,0,6.0,186.0,180.0,104500.0,0.0,-104500.0
<a href=/player/westm102>westm102</a>,Max West,Boston Braves,BRAVES,1,1,2,3,1946,1946,0,No,0,0.38,-0.01,-0.39,72,20,-52,235,3,-232,0.0,46.0,46.0,0.0,0.0,0.0
<a href=/player/westm102>westm102</a>,Max West,Cleveland Indians,INDINS,2,2,2,4,1951,1951,0,No,0,0.0,-0.14,-0.14,0,11,11,0,12,12,0.0,0.0,0.0,0.0,0.0,0.0
<a href=/player/wests101>wests101</a>,Sam West,Washington Senators,TWINS,3,6,5,11,1932,1936,4,No,0,25.58,12.35,-13.23,1434,628,-806,5873,2235,-3638,390.0,1249.0,859.0,38000.0,0.0,-38000.0
<a href=/player/wests101>wests101</a>,Sam West,St.Louis Browns,ORLS,1,1,1,2,1938,1939,1,No,0,4.51,0.82,-3.69,290,144,-146,1024,624,-400,0.0,0.0,0.0,0.0,0.0,0.0
<a href=/player/westw102>westw102</a>,Wally Westlake,Oakland,Oakland,1,1,2,3,1946,1946,0,No,0,11.3,0.0,-11.3,580,0,-580,2223,0,-2223,0.0,0.0,0.0,0.0,0.0,0.0
<a href=/player/westw102>westw102</a>,Wally Westlake,Pittsburgh Pirates,PIRATS,20,37,49,86,1951,1973,22,No,0,26.24,49.68,23.44,3262,4651,1389,9080,13358,4278,3705.0,3970.0,265.0,216500.0,0.0,-216500.0
<a href=/player/westw102>westw102</a>,Wally Westlake,St. Louis Cardinals,CARDS,2,5,3,8,1952,1954,2,No,0,-0.48,0.45,0.93,72,246,174,232,797,565,0.0,0.0,0.0,0.0,0.0,0.0
<a href=/player/westw102>westw102</a>,Wally Westlake,Cincinnati Reds,REDS,1,1,2,3,1952,1952,0,No,0,3.24,0.0,-3.24,212,0,-212,636,0,-636,0.0,0.0,0.0,0.0,0.0,0.0
<a href=/player/westw102>westw102</a>,Wally Westlake,Cleveland Indians,INDINS,9,17,16,33,1955,1968,13,No,0,100.62,38.17,-62.45,4524,2758,-1766,15556,10180,-5376,4502.0,562.0,-3940.0,0.0,0.0,0.0
<a href=/player/wethj001>wethj001</a>,Jeff Wetherby,Atlanta Braves,BRAVES,1,2,2,4,1990,1990,0,No,0,0.0,0.0,0.0,0,0,0,0,0,0,0.0,0.0,0.0,0.0,0.0,0.0
<a href=/player/wettj001>wettj001</a>,John Wetteland,Los Angeles Dodgers,DOGRS,3,4,4,8,1991,1994,3,No,0,3.76,0.59,-3.17,176,242,66,364,733,369,1120.0,132.0,-988.0,2900000.0,0.0,-2900000.0
<a href=/player/wettj001>wettj001</a>,John Wetteland,Cincinnati Reds,REDS,5,7,10,17,1991,2006,15,No,0,8.76,8.38,-0.38,1127,1227,100,1121,3011,1890,1371.0,1423.0,52.0,12068333.0,0.0,-12068333.0
<a href=/player/wettj001>wettj001</a>,John Wetteland,Montreal Expos,NATEX,1,1,2,3,1995,2001,6,No,0,4.06,-0.58,-4.64,123,173,50,0,394,394,375.0,0.0,-375.0,0.0,0.0,0.0
<a href=/player/whalb101>whalb101</a>,Bert Whaling,Boston Braves,BRAVES,1,2,1,3,1915,1917,2,No,0,0.0,0.67,0.67,0,170,170,0,638,638,0.0,0.0,0.0,6800.0,0.0,-6800.0
<a href=/player/whalr001>whalr001</a>,Rob Whalen,New York Mets,METS,1,2,2,4,2015,2015,0,No,0,-0.77,0.79,1.56,50,93,43,21,281,260,224.0,0.0,-224.0,0.0,0.0,0.0
<a href=/player/whalr001>whalr001</a>,Rob Whalen,Atlanta Braves,BRAVES,2,3,3,6,2016,2021,5,Yes,0,-0.2,0.58,0.78,48,74,26,123,266,143,45.0,0.0,-45.0,0.0,0.0,0.0
<a href=/player/wheal101>wheal101</a>,Lee Wheat,Cleveland Indians,INDINS,1,3,1,4,1954,1955,1,No,0,-0.18,-0.05,0.13,26,176,150,8,639,631,106.0,0.0,-106.0,0.0,0.0,0.0
<a href=/player/wheal101>wheal101</a>,Lee Wheat,Kansas City Athletics,ATLTCS,32,65,62,127,1956,1976,20,No,0,95.85,56.13,-39.72,9593,6816,-2777,23097,19555,-3542,12004.0,6179.0,-5825.0,476100.0,0.0,-476100.0
<a href=/player/wheam101>wheam101</a>,Mack Wheat,Newark,Newark,1,1,1,2,1915,1915,0,No,0,-1.75,0.0,1.75,137,0,-137,369,0,-369,0.0,0.0,0.0,0.0,0.0,0.0
<a href=/player/wheaw101>wheaw101</a>,Woody Wheaton,Philadelphia Athletics,ATLTCS,1,5,1,6,1944,1946,2,No,0,0.0,1.19,1.19,0,162,162,0,669,669,0.0,0.0,0.0,3000.0,0.0,-3000.0
<a href=/player/wheed001>wheed001</a>,Dan Wheeler,New York Mets,METS,1,1,1,2,2004,2004,0,No,0,4.64,0.0,-4.64,400,0,-400,0,0,0,626.0,0.0,-626.0,311500.0,0.0,-311500.0
<a href=/player/wheed001>wheed001</a>,Dan Wheeler,Houston Astros,ASTROS,1,1,2,3,2007,2008,1,No,0,2.19,2.71,0.52,246,161,-85,0,616,616,592.0,0.0,-592.0,2100000.0,0.0,-2100000.0
<a href=/player/wheej001>wheej001</a>,Jason Wheeler,Los Angeles Dodgers,DOGRS,1,1,1,2,2017,2017,0,No,0,0.0,0.0,0.0,0,0,0,0,0,0,0.0,0.0,0.0,0.0,0.0,0.0
<a href=/player/wheer001>wheer001</a>,Ryan Wheeler,Arizona Diamondbacks,DBACKS,1,1,1,2,2012,2016,4,No,0,-1.06,0.75,1.81,59,93,34,106,0,-106,0.0,123.0,123.0,0.0,0.0,0.0
<a href=/player/wheez001>wheez001</a>,Zack Wheeler,San Francisco Giants,GIANTS,1,1,2,3,2011,2011,0,No,0,10.76,1.17,-9.59,246,44,-202,250,179,-71,2248.0,0.0,-2248.0,0.0,0.0,0.0
<a href=/player/whelk001>whelk001</a>,Kevin Whelan,Detroit Tigers,TIGRS,1,3,1,4,2006,2009,3,No,0,-0.32,2.79,3.11,6,247,241,0,1075,1075,19.0,0.0,-19.0,0.0,0.0,0.0
<a href=/player/whilj101>whilj101</a>,Jack Whillock,Detroit Tigers,TIGRS,1,1,1,2,1973,1973,0,No,0,0.0,0.0,0.0,0,0,0,0,0,0,0.0,0.0,0.0,0.0,0.0,0.0
<a href=/player/whism001>whism001</a>,Matt Whisenant,Philadelphia Phillies,PHILS,2,3,3,6,1992,2004,12,No,2,-0.36,9.96,10.32,27,711,684,0,2073,2073,41.0,1766.0,1725.0,0.0,0.0,0.0
<a href=/player/whism001>whism001</a>,Matt Whisenant,Florida Marlins,MARLNS,1,1,1,2,1997,2008,11,No,0,0.2,2.01,1.81,152,274,122,0,832,832,358.0,0.0,-358.0,150000.0,0.0,-150000.0
<a href=/player/whisp101>whisp101</a>,Pete Whisenant,Milwaukee Braves,BRAVES,1,1,1,2,1955,1959,4,No,0,-0.74,-0.76,-0.02,58,208,150,122,613,491,0.0,0.0,0.0,0.0,0.0,0.0
<a href=/player/whisp101>whisp101</a>,Pete Whisenant,St. Louis Cardinals,CARDS,1,1,1,2,1956,1956,0,No,0,1.02,0.9,-0.12,103,75,-28,346,181,-165,0.0,0.0,0.0,0.0,0.0,0.0
<a href=/player/whisp101>whisp101</a>,Pete Whisenant,Chicago Cubs,CUBS,2,5,4,9,1956,1958,2,No,0,7.54,-1.1,-8.64,773,105,-668,2296,34,-2262,130.0,197.0,67.0,0.0,0.0,0.0
<a href=/player/whisp101>whisp101</a>,Pete Whisenant,Cleveland Indians,INDINS,1,1,1,2,1960,1960,0,No,0,-0.14,2.56,2.7,68,117,49,140,520,380,0.0,0.0,0.0,0.0,0.0,0.0
<a href=/player/whita001>whita001</a>,Alex White,Cleveland Indians,INDINS,1,4,1,5,2011,2013,2,No,0,-0.32,1.97,2.29,204,79,-125,247,10,-237,813.0,1274.0,461.0,0.0,0.0,0.0
<a href=/player/whita001>whita001</a>,Alex White,Colorado Rockies,ROCKS,1,2,2,4,2012,2014,2,Yes,0,0.0,0.63,0.63,0,153,153,0,1,1,0.0,245.0,245.0,0.0,0.0,0.0
<a href=/player/whita102>whita102</a>,Art Whitney,Pittsburgh Pirates,PIRATS,1,1,1,2,1888,1888,0,No,0,0.62,0.2,-0.42,220,30,-190,868,115,-753,13.0,0.0,-13.0,0.0,0.0,0.0
<a href=/player/whitb101>whitb101</a>,Burgess Whitehead,St. Louis Cardinals,CARDS,2,3,4,7,1935,1942,7,No,0,9.44,16.07,6.63,978,440,-538,3815,541,-3274,437.0,4133.0,3696.0,0.0,0.0,0.0
<a href=/player/whitb105>whitb105</a>,Bill White,San Francisco Giants,GIANTS,1,2,2,4,1959,1961,2,No,0,28.04,6.49,-21.55,1173,252,-921,4711,231,-4480,0.0,1899.0,1899.0,0.0,0.0,0.0
<a href=/player/whitb105>whitb105</a>,Bill White,St. Louis Cardinals,CARDS,11,23,19,42,1965,1972,7,No,0,31.6,1.61,-29.99,3237,670,-2567,8420,1434,-6986,1865.0,703.0,-1162.0,32500.0,0.0,-32500.0
<a href=/player/whitb105>whitb105</a>,Bill White,Philadelphia Phillies,PHILS,5,10,9,19,1969,1984,15,No,0,35.13,12.22,-22.91,1727,1537,-190,5411,1840,-3571,1000.0,2166.0,1166.0,0.0,0.0,0.0
<a href=/player/whitb108>whitb108</a>,Bill Whitby,Minnesota Twins,TWINS,1,1,2,3,1969,1969,0,No,0,0.0,0.0,0.0,0,0,0,0,0,0,0.0,0.0,0.0,0.0,0.0,0.0
<a href=/player/whitc101>whitc101</a>,Charlie White,Baltimore Orioles,ORLS,1,2,1,3,1954,1954,0,No,0,0.12,-0.22,-0.34,62,2,-60,138,1,-137,0.0,12.0,12.0,0.0,0.0,0.0
<a href=/player/whitc102>whitc102</a>,Charlie Whitehouse,Indianapolis,Indianapolis,1,1,3,4,1920,1928,8,No,0,0.0,0.0,0.0,0,0,0,0,0,0,0.0,0.0,0.0,0.0,0.0,0.0
<a href=/player/whitd001>whitd001</a>,Devon White,California Angels,ANGELS,2,4,5,9,1990,1993,3,No,0,21.39,3.93,-17.46,688,442,-246,3033,1668,-1365,79.0,0.0,-79.0,1180000.0,0.0,-1180000.0
<a href=/player/whitd001>whitd001</a>,Devon White,Florida Marlins,MARLNS,2,2,2,4,1997,2002,5,No,0,3.75,0.6,-3.15,146,250,104,627,860,233,0.0,0.0,0.0,3400000.0,0.0,-3400000.0
<a href=/player/whitd001>whitd001</a>,Devon White,Los Angeles Dodgers,DOGRS,2,2,3,5,2001,2003,2,No,0,0.82,0.03,-0.79,126,298,172,432,953,521,0.0,0.0,0.0,0.0,0.0,0.0
<a href=/player/whitd103>whitd103</a>,Dick Whitman,Philadelphia Phillies,PHILS,1,2,1,3,1951,1952,1,No,0,0.0,-0.41,-0.41,0,96,96,0,243,243,0.0,0.0,0.0,10000.0,0.0,-10000.0
<a href=/player/white001>white001</a>,Ed Whitson,Pittsburgh Pirates,PIRATS,3,5,7,12,1979,1990,11,No,1,17.64,30.66,13.02,910,2106,1196,973,7523,6550,3555.0,123.0,-3432.0,975500.0,0.0,-975500.0
<a href=/player/white001>white001</a>,Ed Whitson,San Francisco Giants,GIANTS,1,1,1,2,1981,1985,4,No,0,2.62,-1.37,-3.99,40,271,231,0,606,606,323.0,0.0,-323.0,0.0,0.0,0.0
<a href=/player/white001>white001</a>,Ed Whitson,Cleveland Indians,INDINS,1,1,2,3,1982,1984,2,No,0,15.84,-0.69,-16.53,463,165,-298,481,273,-208,4063.0,402.0,-3661.0,0.0,0.0,0.0
<a href=/player/white001>white001</a>,Ed Whitson,New York Yankees,YANKS,1,1,1,2,1986,1988,2,No,0,13.61,0.95,-12.66,334,109,-225,365,0,-365,3063.0,591.0,-2472.0,800000.0,0.0,-800000.0
<a href=/player/white002>white002</a>,Ernie Whitt,Toronto Blue Jays,BJAYS,1,2,1,3,1989,1993,4,No,0,-1.22,-0.11,1.11,67,2,-65,204,0,-204,0.0,5.0,5.0,800000.0,0.0,-800000.0
<a href=/player/white003>white003</a>,Ed Whited,Houston Astros,ASTROS,1,2,2,4,1987,1992,5,No,0,-0.79,-1.14,-0.35,36,612,576,82,2086,2004,0.0,0.0,0.0,0.0,0.0,0.0
<a href=/player/white006>white006</a>,Eli White,Oakland Athletics,ATLTCS,2,4,3,7,2018,2019,1,Yes,0,0.76,-0.15,-0.91,276,139,-137,886,518,-368,0.0,0.0,0.0,4147500.0,0.0,-4147500.0
<a href=/player/white102>white102</a>,Earl Whitehill,Detroit Tigers,TIGRS,1,1,2,3,1932,1935,3,No,0,12.58,7.81,-4.77,270,276,6,428,268,-160,2990.0,2107.0,-883.0,0.0,0.0,0.0
<a href=/player/white102>white102</a>,Earl Whitehill,Washington Senators,TWINS,1,1,1,2,1936,1937,1,No,0,-1.03,0.0,1.03,118,0,-118,125,0,-125,922.0,0.0,-922.0,0.0,0.0,0.0
<a href=/player/whitf103>whitf103</a>,Fred Whitfield,St. Louis Cardinals,CARDS,11,19,18,37,1962,1976,14,No,0,28.47,15.48,-12.99,2535,1258,-1277,5298,686,-4612,6302.0,3329.0,-2973.0,0.0,0.0,0.0
<a href=/player/whitf103>whitf103</a>,Fred Whitfield,Cleveland Indians,INDINS,1,3,1,4,1967,1968,1,No,0,1.38,0.99,-0.39,316,130,-186,387,265,-122,982.0,0.0,-982.0,27000.0,0.0,-27000.0
<a href=/player/whitg001>whitg001</a>,Gabe White,Montreal Expos,NATEX,1,1,1,2,1995,1995,0,No,0,2.89,0.0,-2.89,525,0,-525,26,0,-26,988.0,0.0,-988.0,109000.0,0.0,-109000.0
<a href=/player/whitg001>whitg001</a>,Gabe White,Cincinnati Reds,REDS,3,5,5,10,2000,2002,2,No,0,4.91,-0.68,-5.59,311,84,-227,13,25,12,534.0,281.0,-253.0,630000.0,0.0,-630000.0
<a href=/player/whitg001>whitg001</a>,Gabe White,Colorado Rockies,ROCKS,4,6,7,13,2001,2003,2,No,0,2.38,1.01,-1.37,515,182,-333,507,247,-260,927.0,121.0,-806.0,4816667.0,0.0,-4816667.0
<a href=/player/whitg001>whitg001</a>,Gabe White,New York Yankees,YANKS,1,1,2,3,2004,2007,3,No,0,-0.62,0.0,0.62,80,0,-80,0,0,0,117.0,0.0,-117.0,1925000.0,0.0,-1925000.0
<a href=/player/whith101>whith101</a>,Hal White,Detroit Tigers,TIGRS,13,25,26,51,1952,1968,16,No,0,25.92,52.07,26.15,2610,3104,494,6934,6097,-837,4331.0,10073.0,5742.0,79500.0,0.0,-79500.0
<a href=/player/whitj001>whitj001</a>,Jerry White,Montreal Expos,NATEX,1,1,1,2,1978,1983,5,No,0,0.22,1.87,1.65,59,450,391,162,72,-90,0.0,1045.0,1045.0,0.0,0.0,0.0
<a href=/player/whitj001>whitj001</a>,Jerry White,Chicago Cubs,CUBS,1,2,1,3,1978,1979,1,No,0,3.97,-0.08,-4.05,798,31,-767,2458,14,-2444,0.0,0.0,0.0,0.0,0.0,0.0
<a href=/player/whitj101>whitj101</a>,John Whitehead,Chicago White Sox,WSOX,1,1,1,2,1939,1939,0,No,0,0.32,0.06,-0.26,90,57,-33,31,62,31,330.0,270.0,-60.0,0.0,0.0,0.0
<a href=/player/whitj102>whitj102</a>,Jim Whitney,Washington Senators,WS8,1,1,1,2,1889,1889,0,No,0,0.0,0.0,0.0,0,0,0,0,0,0,0.0,0.0,0.0,0.0,0.0,0.0
<a href=/player/whitj104>whitj104</a>,Jo-Jo White,Seattle,Seattle,1,1,1,2,1942,1943,1,No,0,1.01,0.0,-1.01,224,0,-224,889,0,-889,0.0,0.0,0.0,0.0,0.0,0.0
<a href=/player/whitj104>whitj104</a>,Jo-Jo White,Detroit Tigers,TIGRS,1,5,1,6,1938,1952,14,No,0,0.0,25.69,25.69,0,589,589,0,728,728,0.0,4363.0,4363.0,11000.0,0.0,-11000.0
<a href=/player/whitk101>whitk101</a>,Kirby White,Boston Braves,BRAVES,1,1,2,3,1910,1911,1,No,0,0.74,-1.88,-2.62,64,213,149,55,568,513,467.0,814.0,347.0,0.0,0.0,0.0
<a href=/player/whitl002>whitl002</a>,Larry White,Cleveland Indians,INDINS,18,31,36,67,1981,2001,20,No,1,116.55,78.96,-37.59,6988,5496,-1492,21431,20127,-1304,7765.0,4126.0,-3639.0,20493332.0,0.0,-20493332.0
<a href=/player/whitl003>whitl003</a>,Len Whitehouse,Texas Rangers,RNGRS,1,1,1,2,1982,1983,1,No,0,0.93,0.0,-0.93,95,0,-95,0,0,0,337.0,0.0,-337.0,0.0,0.0,0.0
<a href=/player/whitm001>whitm001</a>,Mark Whiten,Toronto Blue Jays,BJAYS,8,18,13,31,1991,2013,22,No,3,16.79,37.75,20.96,2901,2301,-600,8386,7682,-704,1653.0,2653.0,1000.0,7815000.0,0.0,-7815000.0
<a href=/player/whitm001>whitm001</a>,Mark Whiten,Cleveland Indians,INDINS,2,2,4,6,1993,1996,3,No,0,4.72,4.68,-0.04,353,76,-277,1130,23,-1107,1063.0,1084.0,21.0,0.0,0.0,0.0
<a href=/player/whitm001>whitm001</a>,Mark Whiten,St. Louis Cardinals,CARDS,2,3,3,6,1995,1996,1,No,0,1.59,0.67,-0.92,214,226,12,117,434,317,740.0,182.0,-558.0,125000.0,0.0,-125000.0
<a href=/player/whitm001>whitm001</a>,Mark Whiten,Boston Red Sox,RSOX,1,1,1,2,1995,1995,0,No,0,3.11,0.03,-3.08,120,5,-115,461,17,-444,0.0,0.0,0.0,1638268.0,0.0,-1638268.0
<a href=/player/whitm001>whitm001</a>,Mark Whiten,Atlanta Braves,BRAVES,1,1,1,2,1996,1996,0,No,0,1.68,0.0,-1.68,40,0,-40,163,0,-163,0.0,0.0,0.0,0.0,0.0,0.0
<a href=/player/whitm003>whitm003</a>,Matt White,Boston Red Sox,RSOX,1,1,1,2,2003,2003,0,No,0,-0.12,0.0,0.12,4,0,-4,0,0,0,6.0,0.0,-6.0,300000.0,0.0,-300000.0
<a href=/player/whitm103>whitm103</a>,Mike White,California Angels,ANGELS,1,2,2,4,1966,1967,1,No,0,0.0,0.0,0.0,0,0,0,0,0,0,0.0,0.0,0.0,0.0,0.0,0.0
<a href=/player/whitp102>whitp102</a>,Possum Whitted,St. Louis Cardinals,CARDS,1,2,1,3,1914,1914,0,No,0,0.65,1.83,1.18,156,44,-112,545,55,-490,0.0,460.0,460.0,2300.0,0.0,-2300.0
<a href=/player/whitp102>whitp102</a>,Possum Whitted,Boston Braves,BRAVES,1,3,1,4,1915,1917,2,No,0,5.22,6.66,1.44,653,350,-303,2277,1416,-861,0.0,0.0,0.0,0.0,0.0,0.0
<a href=/player/whitp102>whitp102</a>,Possum Whitted,Philadelphia Phillies,PHILS,3,5,5,10,1919,1923,4,No,0,11.59,-1.78,-13.37,628,470,-158,2396,1854,-542,0.0,0.0,0.0,10000.0,0.0,-10000.0
<a href=/player/whitp103>whitp103</a>,Pinky Whitney,Boston Braves,BRAVES,2,2,2,4,1936,1938,2,No,0,5.14,0.0,-5.14,446,109,-337,1587,323,-1264,0.0,0.0,0.0,0.0,0.0,0.0
<a href=/player/whitp103>whitp103</a>,Pinky Whitney,Philadelphia Phillies,PHILS,4,10,6,16,1933,1941,8,No,0,6.58,22.7,16.12,1012,1092,80,3802,2883,-919,324.0,2494.0,2170.0,0.0,0.0,0.0
<a href=/player/whitr001>whitr001</a>,Rondell White,Montreal Expos,NATEX,1,1,1,2,2000,2004,4,No,0,2.57,-1.2,-3.77,114,27,-87,431,25,-406,0.0,207.0,207.0,4000000.0,0.0,-4000000.0
<a href=/player/whitr001>whitr001</a>,Rondell White,New York Yankees,YANKS,1,1,3,4,2003,2003,0,No,0,1.96,-0.1,-2.06,115,22,-93,449,61,-388,0.0,0.0,0.0,0.0,0.0,0.0
<a href=/player/whitr001>whitr001</a>,Rondell White,San Diego Padres,PADRS,2,2,3,5,2003,2004,1,No,0,0.31,0.0,-0.31,93,0,-93,86,0,-86,127.0,0.0,-127.0,5500000.0,0.0,-5500000.0
<a href=/player/whitr002>whitr002</a>,Rick White,Tampa Bay Devil Rays,RAYS,1,2,2,4,2000,2003,3,No,0,0.01,4.03,4.02,189,316,127,73,802,729,294.0,1188.0,894.0,863000.0,0.0,-863000.0
<a href=/player/whitr002>whitr002</a>,Rick White,Los Angeles Dodgers,DOGRS,1,1,1,2,2004,2004,0,No,0,-0.61,0.0,0.61,65,0,-65,0,0,0,235.0,0.0,-235.0,0.0,0.0,0.0
<a href=/player/whits101>whits101</a>,Steve Whitaker,Kansas City Royals,ROYALS,2,4,2,6,1969,1977,8,No,0,11.49,4.04,-7.45,1298,779,-519,3743,2778,-965,624.0,554.0,-70.0,65000.0,0.0,-65000.0
<a href=/player/whits101>whits101</a>,Steve Whitaker,Milwaukee Brewers,BREWRS,2,3,2,5,1969,1970,1,No,0,2.45,-0.08,-2.53,213,64,-149,45,45,0,485.0,396.0,-89.0,48000.0,0.0,-48000.0
<a href=/player/whits102>whits102</a>,Steve White,Boston Red Sox,RSOX,10,29,25,54,1911,1935,24,No,0,51.77,27.79,-23.98,3792,3076,-716,15081,11324,-3757,0.0,1203.0,1203.0,45050.0,0.0,-45050.0
<a href=/player/whits103>whits103</a>,Sammy White,Boston Red Sox,RSOX,3,7,4,11,1960,1966,6,No,0,-0.53,-1.25,-0.72,125,550,425,299,1387,1088,0.0,336.0,336.0,18500.0,0.0,-18500.0
<a href=/player/whits103>whits103</a>,Sammy White,Seattle,Seattle,1,1,1,2,1949,1949,0,No,0,1.9,0.0,-1.9,981,0,-981,3621,0,-3621,0.0,0.0,0.0,0.0,0.0,0.0
<a href=/player/whitt001>whitt001</a>,Terry Whitfield,New York Yankees,YANKS,3,5,3,8,1977,1985,8,No,1,1.79,2.44,0.65,858,32,-826,2573,4,-2569,78.0,651.0,573.0,0.0,0.0,0.0
<a href=/player/whitt002>whitt002</a>,Tyler White,Houston Astros,ASTROS,1,1,1,2,2019,2019,0,Yes,0,-0.46,0.0,0.46,12,0,-12,26,0,-26,0.0,0.0,0.0,582900.0,0.0,-582900.0
<a href=/player/whitw001>whitw001</a>,Wally Whitehurst,Oakland Athletics,ATLTCS,1,4,2,6,1987,1994,7,No,0,2.78,10.76,7.98,260,216,-44,78,1,-77,952.0,3814.0,2862.0,1137653.0,0.0,-1137653.0
<a href=/player/whitw001>whitw001</a>,Wally Whitehurst,New York Mets,METS,2,4,2,6,1992,1993,1,No,0,12.22,-0.41,-12.63,490,79,-411,1635,295,-1340,509.0,0.0,-509.0,2535000.0,0.0,-2535000.0
<a href=/player/wicka101>wicka101</a>,Al Wickland,StPaul,StPaul,1,1,1,2,1919,1919,0,No,0,-0.75,0.0,0.75,26,0,-26,49,0,-49,0.0,0.0,0.0,0.0,0.0,0.0
<a href=/player/wickb001>wickb001</a>,Bob Wickman,Chicago White Sox,WSOX,1,3,1,4,1992,1994,2,No,0,12.77,-0.22,-12.99,326,200,-126,0,759,759,3273.0,0.0,-3273.0,0.0,0.0,0.0
<a href=/player/wickb001>wickb001</a>,Bob Wickman,New York Yankees,YANKS,2,5,4,9,1996,2003,7,No,0,18.7,20.21,1.51,1086,282,-804,1937,16,-1921,2545.0,3310.0,765.0,1050000.0,0.0,-1050000.0
<a href=/player/wickb001>wickb001</a>,Bob Wickman,Milwaukee Brewers,BREWRS,10,20,24,44,2000,2012,12,No,2,44.17,39.37,-4.8,3016,3033,17,9285,7113,-2172,2619.0,7597.0,4978.0,13997000.0,0.0,-13997000.0
<a href=/player/wickb001>wickb001</a>,Bob Wickman,Cleveland Indians,INDINS,2,2,2,4,2006,2007,1,No,0,1.23,0.74,-0.49,197,52,-145,140,196,56,209.0,0.0,-209.0,5000000.0,0.0,-5000000.0
<a href=/player/wickb101>wickb101</a>,Bob Wicker,St. Louis Cardinals,CARDS,1,1,1,2,1903,1910,7,No,0,8.69,-0.8,-9.49,211,35,-176,381,52,-329,2177.0,383.0,-1794.0,0.0,0.0,0.0
<a href=/player/wickb101>wickb101</a>,Bob Wicker,Chicago Cubs,CUBS,1,1,2,3,1906,1913,7,No,0,0.58,19.28,18.7,40,329,289,54,440,386,448.0,3405.0,2957.0,0.0,0.0,0.0
<a href=/player/wickd101>wickd101</a>,Dave Wickersham,Kansas City Athletics,ATLTCS,15,33,27,60,1963,1976,13,No,0,55.99,46.74,-9.25,6677,4175,-2502,14870,13661,-1209,10290.0,2197.0,-8093.0,387100.0,0.0,-387100.0
<a href=/player/wickd101>wickd101</a>,Dave Wickersham,Detroit Tigers,TIGRS,3,3,3,6,1967,1972,5,No,0,3.73,-0.74,-4.47,476,328,-148,46,564,518,1071.0,291.0,-780.0,49000.0,0.0,-49000.0
<a href=/player/wickd101>wickd101</a>,Dave Wickersham,Kansas City Royals,ROYALS,1,1,1,2,1969,1970,1,No,0,0.0,0.0,0.0,0,0,0,0,0,0,0.0,0.0,0.0,25000.0,0.0,-25000.0
<a href=/player/wickf101>wickf101</a>,Floyd Wicker,Montreal Expos,NATEX,1,1,1,2,1969,1971,2,No,0,-0.3,-0.32,-0.02,26,110,84,52,391,339,0.0,0.0,0.0,0.0,0.0,0.0
<a href=/player/wickf101>wickf101</a>,Floyd Wicker,Milwaukee Brewers,BREWRS,4,6,4,10,1971,1976,5,No,0,3.35,4.86,1.51,554,421,-133,1839,819,-1020,335.0,641.0,306.0,163000.0,0.0,-163000.0
<a href=/player/wickk001>wickk001</a>,Kevin Wickander,Cleveland Indians,INDINS,1,1,1,2,1993,1993,0,No,0,-0.56,0.0,0.56,66,0,-66,2,0,-2,76.0,0.0,-76.0,145000.0,0.0,-145000.0
<a href=/player/wickk001>wickk001</a>,Kevin Wickander,Detroit Tigers,TIGRS,1,1,1,2,1995,1995,0,No,0,0.45,0.0,-0.45,29,0,-29,0,0,0,94.0,0.0,-94.0,160000.0,0.0,-160000.0
<a href=/player/wickk101>wickk101</a>,Kemp Wicker,Brooklyn Dodgers,DOGRS,1,3,1,4,1941,1946,5,No,0,0.0,-0.17,-0.17,0,19,19,0,34,34,0.0,0.0,0.0,0.0,0.0,0.0
<a href=/player/wickr001>wickr001</a>,Rowan Wick,San Diego Padres,PADRS,1,1,1,2,2018,2020,2,No,0,0.91,0.0,-0.91,124,0,-124,0,0,0,221.0,0.0,-221.0,0.0,0.0,0.0
<a href=/player/widet001>widet001</a>,Taylor Widener,New York Yankees,YANKS,2,4,2,6,2018,2020,2,No,0,-0.27,4.02,4.29,326,71,-255,950,61,-889,271.0,823.0,552.0,621900.0,0.0,-621900.0
<a href=/player/widgc001>widgc001</a>,Chris Widger,Seattle Mariners,MARNRS,2,4,3,7,1996,1999,3,No,0,0.25,7.02,6.77,475,103,-372,1514,15,-1499,341.0,1794.0,1453.0,5016667.0,0.0,-5016667.0
<a href=/player/widgc001>widgc001</a>,Chris Widger,Montreal Expos,NATEX,3,5,5,10,2000,2015,15,No,2,0.49,27.41,26.92,227,674,447,766,1595,829,26.0,3302.0,3276.0,4745000.0,0.0,-4745000.0
<a href=/player/widma101>widma101</a>,Al Widmar,Boston Red Sox,RSOX,2,8,5,13,1947,1955,8,No,0,6.5,21.93,15.43,835,962,127,1487,3127,1640,2844.0,2066.0,-778.0,10000.0,0.0,-10000.0
<a href=/player/widma101>widma101</a>,Al Widmar,St.Louis Browns,ORLS,40,98,101,199,1951,1994,43,No,3,172.85,216.49,43.64,11423,17730,6307,26850,53504,26654,34401.0,21386.0,-13015.0,1044583.0,0.0,-1044583.0
<a href=/player/wieat101>wieat101</a>,Ted Wieand,St. Louis Cardinals,CARDS,31,60,55,115,1957,1998,41,No,7,117.05,218.79,101.74,11329,10308,-1021,30194,36340,6146,12663.0,4453.0,-8210.0,3323333.0,0.0,-3323333.0
<a href=/player/wieat101>wieat101</a>,Ted Wieand,Cincinnati Reds,REDS,1,3,2,5,1960,1960,0,No,0,3.11,0.0,-3.11,276,0,-276,63,0,-63,598.0,0.0,-598.0,0.0,0.0,0.0
<a href=/player/wiecb001>wiecb001</a>,Brad Wieck,New York Mets,METS,1,2,1,3,2015,2015,0,No,0,-1.89,0.09,1.98,94,76,-18,2,1,-1,145.0,103.0,-42.0,0.0,0.0,0.0
<a href=/player/wiecb001>wiecb001</a>,Brad Wieck,San Diego Padres,PADRS,1,1,1,2,2019,2019,0,No,0,0.8,-0.23,-1.03,58,4,-54,0,0,0,84.0,5.0,-79.0,0.0,0.0,0.0
<a href=/player/wiegt001>wiegt001</a>,Tom Wieghaus,Montreal Expos,NATEX,1,1,1,2,1984,1984,0,No,0,-0.34,0.0,0.34,6,0,-6,12,0,-12,0.0,0.0,0.0,0.0,0.0,0.0
<a href=/player/wielj001>wielj001</a>,Joe Wieland,Texas Rangers,RNGRS,1,2,1,3,2011,2012,1,No,0,-0.83,1.99,2.82,224,92,-132,92,0,-92,1056.0,234.0,-822.0,0.0,0.0,0.0
<a href=/player/wielj001>wielj001</a>,Joe Wieland,San Diego Padres,PADRS,2,5,4,9,2014,2016,2,No,0,8.85,0.65,-8.2,684,254,-430,2593,1079,-1514,26.0,0.0,-26.0,1293600.0,0.0,-1293600.0
<a href=/player/wielj001>wielj001</a>,Joe Wieland,Los Angeles Dodgers,DOGRS,2,5,3,8,2016,2021,5,Yes,0,-0.91,0.86,1.77,22,242,220,43,6,-37,56.0,333.0,277.0,0.0,0.0,0.0
<a href=/player/wielj001>wielj001</a>,Joe Wieland,Seattle Mariners,MARNRS,1,1,1,2,2016,2016,0,No,0,0.0,0.0,0.0,0,0,0,0,0,0,0.0,0.0,0.0,590000.0,0.0,-590000.0
<a href=/player/wiesb101>wiesb101</a>,Bob Wiesler,New York Yankees,YANKS,7,20,15,35,1956,1970,14,No,0,3.04,33.17,30.13,2442,2492,50,6615,5619,-996,2999.0,5239.0,2240.0,115500.0,0.0,-115500.0
<a href=/player/wietw101>wietw101</a>,Whitey Wietelmann,Boston Braves,BRAVES,4,7,6,13,1946,1952,6,No,0,-0.23,24.56,24.79,358,848,490,547,3228,2681,596.0,210.0,-386.0,0.0,0.0,0.0
<a href=/player/wigga001>wigga001</a>,Alan Wiggins,San Diego Padres,PADRS,1,1,2,3,1985,1986,1,No,0,-0.72,0.74,1.46,232,44,-188,947,6,-941,0.0,120.0,120.0,512500.0,0.0,-512500.0
<a href=/player/wiggs001>wiggs001</a>,Scott Wiggins,New York Yankees,YANKS,3,4,5,9,2002,2007,5,No,0,0.56,1.31,0.75,51,257,206,183,839,656,17.0,91.0,74.0,13000000.0,0.0,-13000000.0
<a href=/player/wiggt001>wiggt001</a>,Ty Wigginton,New York Mets,METS,4,6,6,12,2004,2010,6,No,0,-0.86,11.14,12.0,655,533,-122,1973,723,-1250,683.0,3210.0,2527.0,2841000.0,0.0,-2841000.0
<a href=/player/wiggt001>wiggt001</a>,Ty Wigginton,Tampa Bay Devil Rays,RAYS,1,2,1,3,2007,2010,3,No,0,2.71,2.19,-0.52,161,246,85,616,0,-616,0.0,592.0,592.0,2700000.0,0.0,-2700000.0
<a href=/player/wighb101>wighb101</a>,Bill Wight,New York Yankees,YANKS,2,4,2,6,1948,1956,8,No,0,8.14,18.41,10.27,334,437,103,647,602,-45,2224.0,4492.0,2268.0,0.0,0.0,0.0
<a href=/player/wighb101>wighb101</a>,Bill Wight,Chicago White Sox,WSOX,5,11,10,21,1950,1963,13,No,0,1.07,31.48,30.41,1321,1905,584,3161,6140,2979,1824.0,1373.0,-451.0,20000.0,0.0,-20000.0
<a href=/player/wighb101>wighb101</a>,Bill Wight,Boston Red Sox,RSOX,2,6,6,12,1952,1956,4,No,0,8.2,10.1,1.9,1335,867,-468,4777,3045,-1732,507.0,401.0,-106.0,80000.0,0.0,-80000.0
<a href=/player/wighb101>wighb101</a>,Bill Wight,Detroit Tigers,TIGRS,3,7,7,14,1953,1959,6,No,0,19.59,21.85,2.26,1560,1406,-154,4177,3381,-796,3244.0,3436.0,192.0,42000.0,0.0,-42000.0
<a href=/player/wighb101>wighb101</a>,Bill Wight,Cleveland Indians,INDINS,3,4,3,7,1955,1960,5,No,0,5.1,-0.07,-5.17,210,79,-131,284,145,-139,1239.0,27.0,-1212.0,0.0,0.0,0.0
<a href=/player/wilbd101>wilbd101</a>,Del Wilber,Boston Red Sox,RSOX,2,2,2,4,1954,1960,6,No,0,1.54,5.91,4.37,150,520,370,430,1970,1540,0.0,0.0,0.0,0.0,0.0,0.0
<a href=/player/wilbt101>wilbt101</a>,Ted Wilborn,Toronto Blue Jays,BJAYS,5,9,9,18,1979,1987,8,No,0,10.29,14.89,4.6,1883,1679,-204,6026,5403,-623,668.0,1848.0,1180.0,0.0,0.0,0.0
<a href=/player/wilbt101>wilbt101</a>,Ted Wilborn,New York Yankees,YANKS,1,2,1,3,1982,1983,1,No,0,0.43,-1.33,-1.76,102,24,-78,34,0,-34,441.0,285.0,-156.0,0.0,0.0,0.0
<a href=/player/wilcm001>wilcm001</a>,Milt Wilcox,Cincinnati Reds,REDS,1,1,1,2,1971,1971,0,No,0,-0.84,0.0,0.84,132,0,-132,51,0,-51,1085.0,0.0,-1085.0,0.0,0.0,0.0
<a href=/player/wilcm001>wilcm001</a>,Milt Wilcox,Cleveland Indians,INDINS,3,4,6,10,1975,1983,8,No,0,3.79,14.66,10.87,393,604,211,16,775,759,1581.0,1813.0,232.0,85000.0,0.0,-85000.0
<a href=/player/wilem101>wilem101</a>,Mark Wiley,San Diego Padres,PADRS,1,1,1,2,1978,1978,0,No,0,-0.02,0.0,0.02,2,0,-2,0,0,0,8.0,0.0,-8.0,0.0,0.0,0.0
<a href=/player/wilem101>wilem101</a>,Mark Wiley,Toronto Blue Jays,BJAYS,1,1,1,2,1980,1980,0,No,0,0.0,0.23,0.23,0,41,41,0,0,0,0.0,165.0,165.0,0.0,0.0,0.0
<a href=/player/wiler101>wiler101</a>,Randy Wiles,St. Louis Cardinals,CARDS,1,1,1,2,1976,1977,1,No,0,-0.22,0.0,0.22,5,0,-5,0,0,0,8.0,0.0,-8.0,0.0,0.0,0.0
<a href=/player/wiler101>wiler101</a>,Randy Wiles,St. Louis Cardinals,CARDS,1,1,1,2,1977,1977,0,No,0,0.0,0.0,0.0,0,0,0,0,0,0,0.0,0.0,0.0,0.0,0.0,0.0
<a href=/player/wilfr001>wilfr001</a>,Rob Wilfong,Minnesota Twins,TWINS,3,6,6,12,1982,1989,7,No,0,9.33,17.94,8.61,1193,1029,-164,3688,4105,417,852.0,435.0,-417.0,1243500.0,0.0,-1243500.0
<a href=/player/wilhh101>wilhh101</a>,Hoyt Wilhelm,New York Giants,GIANTS,1,1,1,2,1957,1959,2,No,0,0.28,-1.14,-1.42,80,225,145,6,643,637,165.0,0.0,-165.0,0.0,0.0,0.0
<a href=/player/wilhh101>wilhh101</a>,Hoyt Wilhelm,Baltimore Orioles,ORLS,4,10,7,17,1963,1973,10,No,0,64.06,37.52,-26.54,3307,1677,-1630,9685,6745,-2940,2176.0,306.0,-1870.0,108500.0,0.0,-108500.0
<a href=/player/wilhh101>wilhh101</a>,Hoyt Wilhelm,Kansas City Royals,ROYALS,3,5,5,10,1968,1978,10,No,0,3.8,11.09,7.29,526,770,244,825,2425,1600,1152.0,645.0,-507.0,49000.0,0.0,-49000.0
<a href=/player/wilhh101>wilhh101</a>,Hoyt Wilhelm,California Angels,ANGELS,3,7,6,13,1969,1990,21,No,0,44.93,60.7,15.77,1370,2449,1079,2746,9851,7105,8249.0,1336.0,-6913.0,212000.0,0.0,-212000.0
<a href=/player/wilhh101>wilhh101</a>,Hoyt Wilhelm,Chicago Cubs,CUBS,2,3,3,6,1970,1972,2,No,0,2.13,-1.94,-4.07,441,108,-333,857,47,-810,244.0,188.0,-56.0,0.0,0.0,0.0
<a href=/player/wilhj101>wilhj101</a>,Joe Wilhoit,Venice,Venice,1,1,2,3,1915,1915,0,No,0,0.67,0.0,-0.67,170,0,-170,638,0,-638,0.0,0.0,0.0,0.0,0.0,0.0
<a href=/player/wilhj101>wilhj101</a>,Joe Wilhoit,New York Giants,GIANTS,2,8,3,11,1919,1923,4,No,0,10.49,7.89,-2.6,305,402,97,539,1094,555,2035.0,323.0,-1712.0,12500.0,0.0,-12500.0
<a href=/player/wilhj102>wilhj102</a>,Jim Wilhelm,San Diego Padres,PADRS,6,12,11,23,1980,1989,9,No,1,32.03,18.95,-13.08,2570,1369,-1201,8500,3065,-5435,2306.0,4252.0,1946.0,0.0,0.0,0.0
<a href=/player/wilht001>wilht001</a>,Tom Wilhelmsen,Seattle Mariners,MARNRS,2,5,3,8,2015,2017,2,No,0,-1.06,0.95,2.01,37,177,140,16,698,682,66.0,0.0,-66.0,6250000.0,0.0,-6250000.0
<a href=/player/wilka003>wilka003</a>,Aaron Wilkerson,Boston Red Sox,RSOX,1,2,2,4,2016,2016,0,No,0,-0.35,-0.44,-0.09,28,47,19,9,137,128,106.0,0.0,-106.0,0.0,0.0,0.0
<a href=/player/wilkb001>wilkb001</a>,Bill Wilkinson,Seattle Mariners,MARNRS,1,2,3,5,1989,1989,0,No,0,-1.21,-0.79,0.42,71,15,-56,253,0,-253,0.0,256.0,256.0,215000.0,0.0,-215000.0
<a href=/player/wilkb002>wilkb002</a>,Brad Wilkerson,Washington Nationals,NATEX,2,4,3,7,2005,2015,10,No,2,0.68,26.37,25.69,217,505,288,754,1103,349,26.0,3282.0,3256.0,3395000.0,0.0,-3395000.0
<a href=/player/wilkc001>wilkc001</a>,Curt Wilkerson,Texas Rangers,RNGRS,2,7,4,11,1988,1994,6,No,0,0.27,27.89,27.62,791,1284,493,491,4575,4084,1767.0,710.0,-1057.0,532500.0,0.0,-532500.0
<a href=/player/wilkd001>wilkd001</a>,Dean Wilkins,New York Yankees,YANKS,6,14,8,22,1987,2001,14,No,1,22.68,17.2,-5.48,1957,1291,-666,5757,3988,-1769,3742.0,1690.0,-2052.0,2485000.0,0.0,-2485000.0
<a href=/player/wilkd001>wilkd001</a>,Dean Wilkins,Chicago Cubs,CUBS,1,1,1,2,1991,1991,0,No,0,-1.78,0.0,1.78,14,0,-14,1,0,-1,24.0,0.0,-24.0,0.0,0.0,0.0
<a href=/player/wilkh101>wilkh101</a>,Harry Wilke,Mobile,Mobile,1,1,1,2,1926,1926,0,No,0,-0.23,0.0,0.23,3,0,-3,9,0,-9,0.0,0.0,0.0,0.0,0.0,0.0
<a href=/player/wilkr001>wilkr001</a>,Rick Wilkins,Chicago Cubs,CUBS,1,1,2,3,1995,1998,3,No,0,0.14,8.11,7.97,99,639,540,357,2349,1992,0.0,0.0,0.0,0.0,0.0,0.0
<a href=/player/wilkr001>wilkr001</a>,Rick Wilkins,Houston Astros,ASTROS,1,2,1,3,1996,1996,0,No,0,1.77,0.4,-1.37,118,37,-81,393,89,-304,0.0,0.0,0.0,1550000.0,0.0,-1550000.0
<a href=/player/wilkr001>wilkr001</a>,Rick Wilkins,Seattle Mariners,MARNRS,1,1,1,2,1998,1998,0,No,0,-0.17,0.0,0.17,5,0,-5,17,0,-17,0.0,0.0,0.0,425000.0,0.0,-425000.0
<a href=/player/wilkt101>wilkt101</a>,Ted Wilks,St. Louis Cardinals,CARDS,3,10,5,15,1951,1954,3,No,0,10.75,2.71,-8.04,1144,382,-762,2713,1234,-1479,1601.0,388.0,-1213.0,41500.0,0.0,-41500.0
<a href=/player/wilkt101>wilkt101</a>,Ted Wilks,Pittsburgh Pirates,PIRATS,1,2,3,5,1952,1952,0,No,0,6.5,-0.35,-6.85,756,19,-737,2451,60,-2391,46.0,0.0,-46.0,0.0,0.0,0.0
<a href=/player/willa101>willa101</a>,Al Williams,Atlanta,Atlanta,1,1,2,3,1935,1946,11,No,0,-2.17,0.0,2.17,92,0,-92,56,0,-56,506.0,0.0,-506.0,0.0,0.0,0.0
<a href=/player/willb001>willb001</a>,Brian Williams,Houston Astros,ASTROS,15,31,38,69,1994,2011,17,No,2,59.26,30.42,-28.84,4671,6149,1478,11202,16044,4842,6620.0,5977.0,-643.0,31714000.0,0.0,-31714000.0
<a href=/player/willb101>willb101</a>,Bump Wills,Texas Rangers,RNGRS,1,1,3,4,1982,1983,1,No,0,0.93,-0.09,-1.02,128,40,-88,477,0,-477,0.0,152.0,152.0,0.0,0.0,0.0
<a href=/player/willb104>willb104</a>,Billy Williams,Chicago Cubs,CUBS,11,19,24,43,1974,1990,16,No,0,23.18,13.21,-9.97,3006,2415,-591,7963,5685,-2278,1223.0,3795.0,2572.0,1040000.0,0.0,-1040000.0
<a href=/player/willb105>willb105</a>,Bernie Williams,San Francisco Giants,GIANTS,4,8,7,15,1973,1979,6,No,1,5.12,0.53,-4.59,507,876,369,1563,1384,-179,25.0,2162.0,2137.0,125000.0,0.0,-125000.0
<a href=/player/willb106>willb106</a>,Bob Will,Chicago Cubs,CUBS,1,2,2,4,1964,1965,1,No,0,0.14,0.31,0.17,26,71,45,14,56,42,133.0,454.0,321.0,0.0,0.0,0.0
<a href=/player/willc001>willc001</a>,Carl Willis,Detroit Tigers,TIGRS,1,2,1,3,1984,1986,2,No,0,-0.97,-0.02,0.95,94,80,-14,7,0,-7,227.0,318.0,91.0,0.0,0.0,0.0
<a href=/player/willc001>willc001</a>,Carl Willis,Cincinnati Reds,REDS,1,1,1,2,1988,1988,0,No,0,-0.64,0.0,0.64,6,0,-6,0,0,0,36.0,0.0,-36.0,0.0,0.0,0.0
<a href=/player/willc101>willc101</a>,Charlie Williams,New York Mets,METS,1,2,1,3,1972,1972,0,No,0,3.76,1.62,-2.14,474,69,-405,81,242,161,1449.0,0.0,-1449.0,0.0,0.0,0.0
<a href=/player/willc102>willc102</a>,Claude Willoughby,Philadelphia Phillies,PHILS,2,3,6,9,1930,1936,6,No,0,25.37,8.0,-17.37,1352,958,-394,5364,4215,-1149,77.0,0.0,-77.0,24000.0,0.0,-24000.0
<a href=/player/willc103>willc103</a>,Cy Williams,Chicago Cubs,CUBS,1,1,1,2,1917,1920,3,No,0,30.63,4.03,-26.6,1463,354,-1109,5786,1419,-4367,0.0,0.0,0.0,4000.0,0.0,-4000.0
<a href=/player/willd001>willd001</a>,Dana Williams,Boston Red Sox,RSOX,1,1,1,2,1989,1989,0,No,0,0.0,0.0,0.0,0,0,0,0,0,0,0.0,0.0,0.0,0.0,0.0,0.0
<a href=/player/willd002>willd002</a>,David Williams,Pittsburgh Pirates,PIRATS,2,2,3,5,2005,2008,3,No,0,-0.67,-0.41,0.26,212,85,-127,705,244,-461,120.0,32.0,-88.0,8830000.0,0.0,-8830000.0
<a href=/player/willd002>willd002</a>,David Williams,Cincinnati Reds,REDS,2,3,2,5,2006,2010,4,No,0,-0.46,0.93,1.39,16,46,30,12,125,113,100.0,13.0,-87.0,1800000.0,0.0,-1800000.0
<a href=/player/willd003>willd003</a>,Dontrelle Willis,Chicago Cubs,CUBS,2,5,3,8,2002,2004,2,No,1,19.76,10.92,-8.84,396,427,31,455,211,-244,3529.0,2185.0,-1344.0,0.0,0.0,0.0
<a href=/player/willd003>willd003</a>,Dontrelle Willis,Florida Marlins,MARLNS,5,6,11,17,2007,2013,6,No,0,60.75,3.64,-57.11,2705,1161,-1544,9389,789,-8600,1298.0,2358.0,1060.0,18420219.0,0.0,-18420219.0
<a href=/player/willd003>willd003</a>,Dontrelle Willis,Detroit Tigers,TIGRS,1,2,1,3,2010,2010,0,No,0,-0.24,0.0,0.24,11,0,-11,6,0,-6,67.0,0.0,-67.0,12000000.0,0.0,-12000000.0
<a href=/player/willd101>willd101</a>,Dallas Williams,Baltimore Orioles,ORLS,1,2,1,3,1982,1985,3,No,0,-0.67,0.87,1.54,18,216,198,41,563,522,0.0,0.0,0.0,0.0,0.0,0.0
<a href=/player/willd101>willd101</a>,Dallas Williams,Cincinnati Reds,REDS,1,1,1,2,1984,1984,0,No,0,0.0,0.0,0.0,0,0,0,0,0,0,0.0,0.0,0.0,0.0,0.0,0.0
<a href=/player/willd102>willd102</a>,Davey Williams,Atlanta,Atlanta,1,1,3,4,1948,1950,2,No,0,5.49,0.0,-5.49,517,0,-517,1993,0,-1993,0.0,0.0,0.0,0.0,0.0,0.0
<a href=/player/willd104>willd104</a>,Dick Williams,Baltimore Orioles,ORLS,2,2,2,4,1957,1960,3,No,0,-0.29,4.68,4.97,129,349,220,330,994,664,0.0,0.0,0.0,18000.0,0.0,-18000.0
<a href=/player/willd104>willd104</a>,Dick Williams,Cleveland Indians,INDINS,8,15,14,29,1958,1968,10,No,0,101.35,32.49,-68.86,4418,2446,-1972,15260,8973,-6287,4502.0,562.0,-3940.0,0.0,0.0,0.0
<a href=/player/willd104>willd104</a>,Dick Williams,Baltimore Orioles,ORLS,1,1,1,2,1958,1959,1,No,0,4.3,-0.22,-4.52,257,114,-143,1004,390,-614,0.0,0.0,0.0,0.0,0.0,0.0
<a href=/player/willd104>willd104</a>,Dick Williams,Kansas City Athletics,ATLTCS,2,3,3,6,1961,1963,2,No,0,10.64,-2.14,-12.78,963,354,-609,748,642,-106,2603.0,934.0,-1669.0,0.0,0.0,0.0
<a href=/player/willd104>willd104</a>,Dick Williams,Houston Astros,ASTROS,2,2,2,4,1962,1965,3,No,0,0.55,-0.97,-1.52,151,61,-90,238,215,-23,0.0,0.0,0.0,0.0,0.0,0.0
<a href=/player/willd109>willd109</a>,Dewey Williams,Atlanta,Atlanta,1,1,1,2,1940,1940,0,No,0,0.0,0.0,0.0,0,0,0,0,0,0,0.0,0.0,0.0,0.0,0.0,0.0
<a href=/player/wille001>wille001</a>,Eddie Williams,New York Mets,METS,1,3,1,4,1984,1987,3,No,0,3.5,-0.12,-3.62,99,72,-27,111,61,-50,956.0,505.0,-451.0,0.0,0.0,0.0
<a href=/player/wille001>wille001</a>,Eddie Williams,Cleveland Indians,INDINS,1,1,2,3,1989,1989,0,No,0,0.81,0.24,-0.57,66,9,-57,229,0,-229,0.0,99.0,99.0,0.0,0.0,0.0
<a href=/player/wille001>wille001</a>,Eddie Williams,Los Angeles Dodgers,DOGRS,1,1,1,2,1997,1997,0,No,0,-0.32,0.0,0.32,30,0,-30,103,0,-103,0.0,0.0,0.0,0.0,0.0,0.0
<a href=/player/wille101>wille101</a>,Earl Williams,Atlanta Braves,BRAVES,11,19,24,43,1972,1986,14,No,0,30.99,9.46,-21.53,1998,2587,589,5259,6910,1651,4220.0,2478.0,-1742.0,95000.0,0.0,-95000.0
<a href=/player/wille101>wille101</a>,Earl Williams,Baltimore Orioles,ORLS,11,23,20,43,1975,1994,19,No,3,46.79,85.06,38.27,2432,4349,1917,5059,10615,5556,10756.0,13691.0,2935.0,713333.0,0.0,-713333.0
<a href=/player/willf001>willf001</a>,Frank Williams,San Francisco Giants,GIANTS,5,9,7,16,1987,2005,18,No,1,10.87,19.52,8.65,824,2100,1276,1559,6786,5227,1721.0,932.0,-789.0,1340000.0,0.0,-1340000.0
<a href=/player/willf002>willf002</a>,Frank Wills,Kansas City Royals,ROYALS,2,3,3,6,1985,1988,3,No,0,0.52,1.39,0.87,85,358,273,227,1074,847,0.0,58.0,58.0,0.0,0.0,0.0
<a href=/player/willf002>willf002</a>,Frank Wills,New York Mets,METS,1,1,1,2,1985,1985,0,No,0,-0.89,0.0,0.89,24,0,-24,0,0,0,369.0,0.0,-369.0,0.0,0.0,0.0
<a href=/player/willg001>willg001</a>,Gerald Williams,New York Yankees,YANKS,2,5,4,9,1996,2003,7,No,0,18.7,20.21,1.51,1086,282,-804,1937,16,-1921,2545.0,3310.0,765.0,1050000.0,0.0,-1050000.0
<a href=/player/willg001>willg001</a>,Gerald Williams,Milwaukee Brewers,BREWRS,1,1,1,2,1997,2002,5,No,0,4.09,2.1,-1.99,272,242,-30,756,8,-748,0.0,405.0,405.0,700000.0,0.0,-700000.0
<a href=/player/willg002>willg002</a>,George Williams,Minnesota Twins,TWINS,1,1,1,2,1999,1999,0,No,0,0.0,0.0,0.0,0,0,0,0,0,0,0.0,0.0,0.0,0.0,0.0,0.0
<a href=/player/willg101>willg101</a>,George Williams,St. Louis Cardinals,CARDS,1,1,1,2,1965,1967,2,No,0,0.0,0.0,0.0,0,0,0,0,0,0,0.0,0.0,0.0,0.0,0.0,0.0
<a href=/player/willg103>willg103</a>,Gus Williams,St.Louis Browns,ORLS,1,3,1,4,1915,1917,2,No,0,0.0,-0.08,-0.08,0,17,17,0,34,34,0.0,0.0,0.0,1800.0,0.0,-1800.0
<a href=/player/willh103>willh103</a>,Harry Williams,New York Yankees,YANKS,1,2,1,3,1914,1914,0,No,0,0.0,0.51,0.51,0,93,93,0,380,380,0.0,0.0,0.0,0.0,0.0,0.0
<a href=/player/willj001>willj001</a>,Jerry Willard,Philadelphia Phillies,PHILS,5,11,8,19,1982,1999,17,No,0,22.81,28.42,5.61,2142,1948,-194,7615,5685,-1930,390.0,1257.0,867.0,2950000.0,0.0,-2950000.0
<a href=/player/willj003>willj003</a>,Jerome Williams,San Francisco Giants,GIANTS,2,3,3,6,2005,2008,3,No,0,2.36,1.11,-1.25,196,369,173,41,1,-40,695.0,405.0,-290.0,336000.0,0.0,-336000.0
<a href=/player/willj004>willj004</a>,Josh Willingham,Florida Marlins,MARLNS,13,35,35,70,2008,2020,12,Yes,0,62.26,28.41,-33.85,4300,3021,-1279,10993,9069,-1924,7970.0,4278.0,-3692.0,67010000.0,0.0,-67010000.0
<a href=/player/willj004>willj004</a>,Josh Willingham,Washington Nationals,NATEX,2,2,3,5,2010,2013,3,Yes,0,2.17,-0.11,-2.28,146,253,107,563,47,-516,12.0,339.0,327.0,5101000.0,0.0,-5101000.0
<a href=/player/willj004>willj004</a>,Josh Willingham,Minnesota Twins,TWINS,1,1,1,2,2014,2016,2,No,0,0.18,0.0,-0.18,24,0,-24,86,0,-86,0.0,0.0,0.0,7000000.0,0.0,-7000000.0
<a href=/player/willj006>willj006</a>,Justin Williams,Arizona Diamondbacks,DBACKS,3,7,4,11,2014,2019,5,Yes,0,3.79,-0.16,-3.95,192,125,-67,130,321,191,1136.0,438.0,-698.0,4275000.0,0.0,-4275000.0
<a href=/player/willj006>willj006</a>,Justin Williams,Tampa Bay Devil Rays,RAYS,2,5,5,10,2018,2020,2,Yes,0,6.49,6.47,-0.02,634,226,-408,1668,967,-701,343.0,0.0,-343.0,4100000.0,0.0,-4100000.0
<a href=/player/willj102>willj102</a>,Jim Willoughby,San Francisco Giants,GIANTS,1,1,1,2,1974,1974,0,No,0,0.0,0.0,0.0,0,0,0,0,0,0,0.0,0.0,0.0,0.0,0.0,0.0
<a href=/player/willj102>willj102</a>,Jim Willoughby,St. Louis Cardinals,CARDS,3,3,5,8,1975,1976,1,No,0,1.63,0.21,-1.42,279,64,-215,541,200,-341,606.0,0.0,-606.0,0.0,0.0,0.0
<a href=/player/willj102>willj102</a>,Jim Willoughby,Chicago White Sox,WSOX,1,1,1,2,1978,1978,0,No,0,0.0,0.0,0.0,0,0,0,0,0,0,0.0,0.0,0.0,0.0,0.0,0.0
<a href=/player/willj104>willj104</a>,Jim Willis,Chicago Cubs,CUBS,3,6,6,12,1954,1961,7,No,0,3.29,2.06,-1.23,406,565,159,221,1460,1239,2057.0,7.0,-2050.0,0.0,0.0,0.0
<a href=/player/willj106>willj106</a>,Jimmy Williams,New York Yankees,YANKS,3,6,6,12,1907,1911,4,No,0,37.76,7.87,-29.89,2601,491,-2110,10473,2011,-8462,0.0,0.0,0.0,0.0,0.0,0.0
<a href=/player/willj107>willj107</a>,Jimy Williams,St. Louis Cardinals,CARDS,4,6,5,11,1968,1971,3,No,0,5.07,0.97,-4.1,849,114,-735,2705,290,-2415,0.0,0.0,0.0,0.0,0.0,0.0
<a href=/player/willj107>willj107</a>,Jimy Williams,Montreal Expos,NATEX,1,1,1,2,1971,1971,0,No,0,0.0,0.0,0.0,0,0,0,0,0,0,0.0,0.0,0.0,0.0,0.0,0.0
<a href=/player/willj108>willj108</a>,Jim Williams,Chicago Cubs,CUBS,3,4,3,7,1967,1973,6,No,0,1.48,-0.34,-1.82,258,333,75,792,861,69,0.0,8.0,8.0,37250.0,0.0,-37250.0
<a href=/player/willk001>willk001</a>,Ken Williams,Chicago White Sox,WSOX,3,4,5,9,1989,1991,2,No,0,-0.18,4.71,4.89,248,106,-142,427,126,-301,701.0,946.0,245.0,1315000.0,0.0,-1315000.0
<a href=/player/willm001>willm001</a>,Matt Williams,Toronto Blue Jays,BJAYS,1,3,1,4,1985,1986,1,No,0,0.93,0.73,-0.2,6,131,125,0,477,477,78.0,0.0,-78.0,0.0,0.0,0.0
<a href=/player/willm002>willm002</a>,Mitch Williams,San Diego Padres,PADRS,1,1,1,2,1985,1985,0,No,0,3.58,0.0,-3.58,232,0,-232,0,0,0,824.0,0.0,-824.0,0.0,0.0,0.0
<a href=/player/willm002>willm002</a>,Mitch Williams,Texas Rangers,RNGRS,2,7,4,11,1988,1994,6,No,0,0.27,27.89,27.62,791,1284,493,491,4575,4084,1767.0,710.0,-1057.0,532500.0,0.0,-532500.0
<a href=/player/willm002>willm002</a>,Mitch Williams,Chicago Cubs,CUBS,3,3,7,10,1991,1995,4,No,0,4.89,1.97,-2.92,667,742,75,18,57,39,1589.0,1518.0,-71.0,557500.0,0.0,-557500.0
<a href=/player/willm002>willm002</a>,Mitch Williams,Philadelphia Phillies,PHILS,2,3,3,6,1993,1996,3,No,0,-1.07,3.02,4.09,122,167,45,3,151,148,185.0,433.0,248.0,3609000.0,0.0,-3609000.0
<a href=/player/willm003>willm003</a>,Matt Williams,San Francisco Giants,GIANTS,4,6,9,15,1996,2008,12,No,2,6.64,34.66,28.02,354,1877,1523,690,4566,3876,695.0,1319.0,624.0,6936000.0,0.0,-6936000.0
<a href=/player/willm003>willm003</a>,Matt Williams,Cleveland Indians,INDINS,2,2,4,6,1997,2001,4,No,0,7.37,-0.84,-8.21,623,54,-569,2465,0,-2465,51.0,172.0,121.0,7150000.0,0.0,-7150000.0
<a href=/player/willm004>willm004</a>,Mark Williamson,San Diego Padres,PADRS,2,3,3,6,1986,1990,4,No,0,10.9,-1.16,-12.06,682,244,-438,834,162,-672,3461.0,484.0,-2977.0,1525000.0,0.0,-1525000.0
<a href=/player/willm005>willm005</a>,Mike Williams,Pittsburgh Pirates,PIRATS,1,1,1,2,2001,2002,1,No,0,0.27,0.08,-0.19,50,24,-26,0,23,23,67.0,208.0,141.0,1200000.0,0.0,-1200000.0
<a href=/player/willm005>willm005</a>,Mike Williams,Pittsburgh Pirates,PIRATS,1,2,1,3,2003,2003,0,No,0,-0.52,0.0,0.52,56,0,-56,0,0,0,77.0,0.0,-77.0,3500000.0,0.0,-3500000.0
<a href=/player/willm006>willm006</a>,Matt Williams,Cleveland Indians,INDINS,1,1,1,2,1995,1995,0,No,0,0.0,-0.14,-0.14,0,17,17,0,27,27,0.0,0.0,0.0,0.0,0.0,0.0
<a href=/player/willm102>willm102</a>,Maury Wills,Los Angeles Dodgers,DOGRS,1,1,2,3,1966,1968,2,No,0,7.77,-0.49,-8.26,302,319,17,1350,982,-368,0.0,0.0,0.0,85000.0,0.0,-85000.0
<a href=/player/willm102>willm102</a>,Maury Wills,Montreal Expos,NATEX,4,5,7,12,1969,1978,9,No,0,18.8,19.12,0.32,1836,868,-968,5544,3116,-2428,0.0,0.0,0.0,0.0,0.0,0.0
<a href=/player/willm105>willm105</a>,Mark Williams,Kansas City Royals,ROYALS,1,1,1,2,1975,1975,0,No,0,0.02,0.0,-0.02,3,0,-3,3,0,-3,0.0,0.0,0.0,0.0,0.0,0.0
<a href=/player/willn001>willn001</a>,Nick Williams,Texas Rangers,RNGRS,5,14,16,30,2015,2021,6,Yes,0,11.03,13.28,2.25,790,293,-497,1664,16,-1648,2536.0,2164.0,-372.0,3762500.0,0.0,-3762500.0
<a href=/player/willn101>willn101</a>,Nick Willhite,Los Angeles Dodgers,DOGRS,1,1,1,2,1966,1967,1,No,0,-0.48,-0.23,0.25,20,8,-12,10,0,-10,118.0,20.0,-98.0,9000.0,0.0,-9000.0
<a href=/player/willn101>willn101</a>,Nick Willhite,California Angels,ANGELS,5,5,6,11,1967,1973,6,No,0,0.62,4.1,3.48,359,646,287,804,471,-333,516.0,1754.0,1238.0,10000.0,0.0,-10000.0
<a href=/player/willr001>willr001</a>,Reggie Williams,Los Angeles Dodgers,DOGRS,1,1,1,2,1988,1988,0,No,0,-0.06,0.0,0.06,11,0,-11,31,0,-31,0.0,0.0,0.0,0.0,0.0,0.0
<a href=/player/willr002>willr002</a>,Reggie Williams,California Angels,ANGELS,1,1,1,2,1993,1999,6,No,0,-0.14,4.43,4.57,15,188,173,13,0,-13,0.0,640.0,640.0,0.0,0.0,0.0
<a href=/player/willr003>willr003</a>,Randy Williams,Seattle Mariners,MARNRS,1,1,1,2,2004,2004,0,No,0,-0.27,0.0,0.27,4,0,-4,1,0,-1,13.0,0.0,-13.0,0.0,0.0,0.0
<a href=/player/willr104>willr104</a>,Rip Williams,New York Yankees,YANKS,1,2,1,3,1912,1912,0,No,0,4.64,-0.55,-5.19,406,29,-377,1061,95,-966,0.0,0.0,0.0,0.0,0.0,0.0
<a href=/player/willr104>willr104</a>,Rip Williams,Buffalo,Buffalo,1,1,2,3,1910,1910,0,No,0,-0.3,0.0,0.3,95,0,-95,329,0,-329,0.0,0.0,0.0,0.0,0.0,0.0
<a href=/player/willr104>willr104</a>,Rip Williams,Washington Senators,TWINS,1,4,1,5,1917,1922,5,No,0,0.0,-0.6,-0.6,0,32,32,0,104,104,0.0,0.0,0.0,0.0,0.0,0.0
<a href=/player/wills002>wills002</a>,Scott Williamson,Cincinnati Reds,REDS,1,1,2,3,2003,2007,4,No,0,0.92,-1.4,-2.32,55,12,-43,0,6,6,147.0,54.0,-93.0,1600000.0,0.0,-1600000.0
<a href=/player/wills002>wills002</a>,Scott Williamson,Chicago Cubs,CUBS,1,1,2,3,2006,2006,0,No,0,-0.26,0.0,0.26,22,0,-22,0,0,0,33.0,0.0,-33.0,2000000.0,0.0,-2000000.0
<a href=/player/wills102>wills102</a>,Stan Williams,Los Angeles Dodgers,DOGRS,1,1,1,2,1962,1963,1,No,0,1.38,-1.13,-2.51,101,89,-12,75,256,181,685.0,0.0,-685.0,0.0,0.0,0.0
<a href=/player/wills102>wills102</a>,Stan Williams,Cleveland Indians,INDINS,15,21,26,47,1969,1984,15,No,0,48.37,39.17,-9.2,3144,4059,915,8529,12020,3491,2855.0,3764.0,909.0,351750.0,0.0,-351750.0
<a href=/player/wills102>wills102</a>,Stan Williams,Minnesota Twins,TWINS,1,1,2,3,1971,1971,0,No,0,0.65,0.0,-0.65,20,0,-20,1,0,-1,38.0,0.0,-38.0,40000.0,0.0,-40000.0
<a href=/player/willt001>willt001</a>,Todd Williams,Los Angeles Dodgers,DOGRS,1,1,1,2,1995,1995,0,No,0,0.0,0.0,0.0,0,0,0,0,0,0,0.0,0.0,0.0,0.0,0.0,0.0
<a href=/player/willt001>willt001</a>,Todd Williams,Cincinnati Reds,REDS,1,1,1,2,1999,2000,1,No,0,0.16,-0.06,-0.22,13,9,-4,0,1,1,29.0,0.0,-29.0,0.0,0.0,0.0
<a href=/player/willt002>willt002</a>,Trevor Williams,Miami Marlins,MARLNS,1,1,1,2,2015,2015,0,Yes,0,4.86,0.0,-4.86,194,0,-194,145,0,-145,1604.0,0.0,-1604.0,0.0,0.0,0.0
<a href=/player/willt002>willt002</a>,Trevor Williams,Chicago Cubs,CUBS,1,3,1,4,2021,2021,0,Yes,0,2.33,0.0,-2.33,66,0,-66,194,0,-194,97.0,0.0,-97.0,14100000.0,0.0,-14100000.0
<a href=/player/willt003>willt003</a>,Taylor Williams,Seattle Mariners,MARNRS,1,1,1,2,2020,2020,0,Yes,0,0.12,0.0,-0.12,10,0,-10,0,0,0,19.0,0.0,-19.0,0.0,0.0,0.0
<a href=/player/willt103>willt103</a>,Ted Williams,SanDiego,SanDiego,2,2,5,7,1937,1939,2,No,0,130.77,0.0,-130.77,2971,0,-2971,11881,0,-11881,6.0,0.0,-6.0,0.0,0.0,0.0
<a href=/player/willv101>willv101</a>,Vic Willis,Syracuse,Syracuse,1,1,2,3,1897,1897,0,No,0,42.08,0.0,-42.08,658,0,-658,1092,0,-1092,7720.0,0.0,-7720.0,0.0,0.0,0.0
<a href=/player/willv101>willv101</a>,Vic Willis,Boston Braves,BRAVES,3,4,6,10,1905,1917,12,No,0,22.76,27.79,5.03,670,2025,1355,1752,7631,5879,3628.0,2702.0,-926.0,0.0,0.0,0.0
<a href=/player/willw001>willw001</a>,Woody Williams,Toronto Blue Jays,BJAYS,1,3,1,4,1998,2001,3,No,0,7.56,0.33,-7.23,451,52,-399,328,5,-323,2800.0,760.0,-2040.0,1787500.0,0.0,-1787500.0
<a href=/player/willw001>willw001</a>,Woody Williams,San Diego Padres,PADRS,1,1,2,3,2001,2002,1,No,0,11.71,0.53,-11.18,185,121,-64,221,385,164,1766.0,0.0,-1766.0,5083333.0,0.0,-5083333.0
<a href=/player/willw103>willw103</a>,Walt Williams,St. Louis Cardinals,CARDS,1,2,2,4,1966,1967,1,No,0,2.36,-0.3,-2.66,603,24,-579,1918,71,-1847,0.0,0.0,0.0,9000.0,0.0,-9000.0
<a href=/player/willw103>willw103</a>,Walt Williams,Chicago White Sox,WSOX,2,2,2,4,1972,1976,4,No,0,1.09,-0.65,-1.74,105,187,82,371,504,133,0.0,142.0,142.0,53000.0,0.0,-53000.0
<a href=/player/willw103>willw103</a>,Walt Williams,Cleveland Indians,INDINS,4,7,5,12,1974,1976,2,No,0,-3.21,4.02,7.23,307,69,-238,459,0,-459,1098.0,1299.0,201.0,68000.0,0.0,-68000.0
<a href=/player/wilsa001>wilsa001</a>,Alex Wilson,Boston Red Sox,RSOX,1,3,1,4,2014,2019,5,No,0,9.45,9.39,-0.06,366,170,-196,427,24,-403,794.0,2892.0,2098.0,10500000.0,0.0,-10500000.0
<a href=/player/wilsa101>wilsa101</a>,Artie Wilson,Oakland,Oakland,1,3,5,8,1950,1951,1,No,0,-0.44,0.0,0.44,186,0,-186,308,0,-308,172.0,0.0,-172.0,0.0,0.0,0.0
<a href=/player/wilsa102>wilsa102</a>,Art Wilson,Pittsburgh Pirates,PIRATS,1,1,2,3,1916,1917,1,No,0,0.51,0.75,0.24,117,127,10,375,438,63,0.0,0.0,0.0,5500.0,0.0,-5500.0
<a href=/player/wilsa102>wilsa102</a>,Art Wilson,Chicago Cubs,CUBS,1,3,1,4,1918,1918,0,No,0,1.89,7.03,5.14,176,71,-105,557,112,-445,0.0,807.0,807.0,0.0,0.0,0.0
<a href=/player/wilsa103>wilsa103</a>,Archie Wilson,New York Yankees,YANKS,7,19,15,34,1952,1970,18,No,0,13.22,40.85,27.63,2406,2911,505,6464,7208,744,3937.0,4978.0,1041.0,115500.0,0.0,-115500.0
<a href=/player/wilsa103>wilsa103</a>,Archie Wilson,Washington Senators,TWINS,2,2,2,4,1952,1953,1,No,0,-0.15,0.45,0.6,18,90,72,41,299,258,0.0,0.0,0.0,0.0,0.0,0.0
<a href=/player/wilsa103>wilsa103</a>,Archie Wilson,Toronto,Toronto,2,3,4,7,1956,1958,2,No,0,-0.02,0.0,0.02,52,0,-52,3,0,-3,128.0,0.0,-128.0,0.0,0.0,0.0
<a href=/player/wilsb002>wilsb002</a>,Bobby Wilson,Texas Rangers,RNGRS,1,2,1,3,2016,2016,0,No,0,-1.41,0.37,1.78,25,30,5,62,94,32,38.0,4.0,-34.0,0.0,0.0,0.0
<a href=/player/wilsb002>wilsb002</a>,Bobby Wilson,Detroit Tigers,TIGRS,1,1,1,2,2016,2018,2,No,0,-0.37,-0.76,-0.39,42,32,-10,141,0,-141,0.0,209.0,209.0,0.0,0.0,0.0
<a href=/player/wilsb002>wilsb002</a>,Bobby Wilson,Minnesota Twins,TWINS,1,1,2,3,2018,2018,0,No,0,0.0,-0.01,-0.01,0,14,14,0,34,34,0.0,3.0,3.0,0.0,0.0,0.0
<a href=/player/wilsb003>wilsb003</a>,Bryse Wilson,Atlanta Braves,BRAVES,1,2,1,3,2021,2021,0,Yes,0,0.25,0.61,0.36,15,53,38,12,0,-12,121.0,78.0,-43.0,0.0,0.0,0.0
<a href=/player/wilsb101>wilsb101</a>,Bill Wilson,Philadelphia Phillies,PHILS,1,1,1,2,1973,1974,1,No,0,0.0,0.14,0.14,0,44,44,0,0,0,0.0,74.0,74.0,0.0,0.0,0.0
<a href=/player/wilsb103>wilsb103</a>,Bill Wilson,Chicago White Sox,WSOX,1,4,2,6,1954,1956,2,No,0,0.81,2.11,1.3,331,206,-125,724,121,-603,571.0,421.0,-150.0,8500.0,0.0,-8500.0
<a href=/player/wilsc001>wilsc001</a>,Craig Wilson,St. Louis Cardinals,CARDS,2,3,4,7,1993,1994,1,No,2,0.21,6.98,6.77,278,245,-33,1031,1059,28,0.0,0.0,0.0,0.0,0.0,0.0
<a href=/player/wilsc003>wilsc003</a>,Craig Wilson,Toronto Blue Jays,BJAYS,2,7,5,12,1996,2001,5,No,0,5.42,8.51,3.09,1726,826,-900,3923,2165,-1758,1392.0,748.0,-644.0,1500000.0,0.0,-1500000.0
<a href=/player/wilsc003>wilsc003</a>,Craig Wilson,Pittsburgh Pirates,PIRATS,1,1,1,2,2006,2007,1,No,0,-0.91,1.4,2.31,40,143,103,109,28,-81,0.0,426.0,426.0,3300000.0,0.0,-3300000.0
<a href=/player/wilsc102>wilsc102</a>,Chief Wilson,Pittsburgh Pirates,PIRATS,1,5,3,8,1913,1915,2,No,0,18.03,3.31,-14.72,1733,233,-1500,6155,938,-5217,795.0,0.0,-795.0,11400.0,0.0,-11400.0
<a href=/player/wilsd001>wilsd001</a>,Dan Wilson,Cincinnati Reds,REDS,9,15,18,33,1993,2013,20,No,0,45.48,40.95,-4.53,3672,3082,-590,10149,8976,-1173,3098.0,6878.0,3780.0,12546000.0,0.0,-12546000.0
<a href=/player/wilsd002>wilsd002</a>,Desi Wilson,Texas Rangers,RNGRS,1,2,1,3,1994,1995,1,No,0,14.18,0.0,-14.18,1333,0,-1333,5009,0,-5009,0.0,0.0,0.0,0.0,0.0,0.0
<a href=/player/wilse001>wilse001</a>,Enrique Wilson,Minnesota Twins,TWINS,1,1,1,2,1994,1994,0,No,0,-0.01,0.0,0.01,190,0,-190,607,0,-607,0.0,0.0,0.0,0.0,0.0,0.0
<a href=/player/wilse001>wilse001</a>,Enrique Wilson,Cleveland Indians,INDINS,1,2,1,3,2000,2002,2,No,0,-2.57,-1.33,1.24,129,133,4,392,475,83,0.0,0.0,0.0,450000.0,0.0,-450000.0
<a href=/player/wilse001>wilse001</a>,Enrique Wilson,Pittsburgh Pirates,PIRATS,2,3,2,5,2001,2003,2,No,0,4.87,0.09,-4.78,558,46,-512,637,4,-633,777.0,109.0,-668.0,635000.0,0.0,-635000.0
<a href=/player/wilse102>wilse102</a>,Earl Wilson,Boston Red Sox,RSOX,3,6,5,11,1966,1968,2,No,0,22.76,3.78,-18.98,955,221,-734,2583,411,-2172,3084.0,1094.0,-1990.0,17000.0,0.0,-17000.0
<a href=/player/wilsf101>wilsf101</a>,Frank Wilson,St.Louis Browns,ORLS,3,6,3,9,1928,1932,4,No,0,0.0,1.32,1.32,0,238,238,0,781,781,0.0,187.0,187.0,15500.0,0.0,-15500.0
<a href=/player/wilsf101>wilsf101</a>,Frank Wilson,Boston Braves,BRAVES,1,3,1,4,1926,1931,5,No,0,0.0,6.6,6.6,0,629,629,0,2661,2661,0.0,0.0,0.0,8700.0,0.0,-8700.0
<a href=/player/wilsg001>wilsg001</a>,Glenn Wilson,Detroit Tigers,TIGRS,1,2,2,4,1984,1992,8,No,0,6.42,12.78,6.36,721,1236,515,2522,2277,-245,3.0,1451.0,1448.0,0.0,0.0,0.0
<a href=/player/wilsg001>wilsg001</a>,Glenn Wilson,Philadelphia Phillies,PHILS,2,4,4,8,1987,1989,2,No,0,8.23,2.23,-6.0,632,164,-468,1265,649,-616,1310.0,12.0,-1298.0,1629900.0,0.0,-1629900.0
<a href=/player/wilsg001>wilsg001</a>,Glenn Wilson,Seattle Mariners,MARNRS,2,2,2,4,1988,1991,3,No,0,2.35,0.72,-1.63,199,342,143,639,1197,558,0.0,0.0,0.0,1540000.0,0.0,-1540000.0
<a href=/player/wilsg001>wilsg001</a>,Glenn Wilson,Pittsburgh Pirates,PIRATS,3,3,4,7,1989,1993,4,No,0,1.22,0.03,-1.19,481,43,-438,1664,92,-1572,0.0,18.0,18.0,750000.0,0.0,-750000.0
<a href=/player/wilsg103>wilsg103</a>,Grady Wilson,Pittsburgh Pirates,PIRATS,1,2,1,3,1949,1949,0,No,0,0.0,0.0,0.0,0,0,0,0,0,0,0.0,0.0,0.0,0.0,0.0,0.0
<a href=/player/wilsh102>wilsh102</a>,Hack Wilson,New York Giants,GIANTS,2,3,2,5,1925,1927,2,No,0,0.0,0.26,0.26,0,144,144,0,535,535,0.0,0.0,0.0,12100.0,0.0,-12100.0
<a href=/player/wilsh102>wilsh102</a>,Hack Wilson,Chicago Cubs,CUBS,1,2,1,3,1931,1933,2,No,0,-0.02,-0.44,-0.42,2,94,92,0,73,73,3.0,633.0,630.0,33000.0,0.0,-33000.0
<a href=/player/wilsh102>wilsh102</a>,Hack Wilson,St. Louis Cardinals,CARDS,1,1,2,3,1932,1932,0,No,0,5.81,0.0,-5.81,319,0,-319,1163,0,-1163,0.0,0.0,0.0,0.0,0.0,0.0
<a href=/player/wilsh102>wilsh102</a>,Hack Wilson,Portsmouth,Portsmouth,1,2,1,3,1923,1923,0,No,0,2.21,0.0,-2.21,334,0,-334,792,0,-792,1269.0,0.0,-1269.0,0.0,0.0,0.0
<a href=/player/wilsj002>wilsj002</a>,Jack Wilson,St. Louis Cardinals,CARDS,3,3,4,7,2000,2003,3,No,0,21.81,-0.28,-22.09,1522,122,-1400,4703,0,-4703,378.0,121.0,-257.0,1600000.0,0.0,-1600000.0
<a href=/player/wilsj002>wilsj002</a>,Jack Wilson,Pittsburgh Pirates,PIRATS,1,2,5,7,2009,2012,3,No,0,2.82,0.94,-1.88,179,390,211,514,1304,790,332.0,0.0,-332.0,10600000.0,0.0,-10600000.0
<a href=/player/wilsj002>wilsj002</a>,Jack Wilson,Seattle Mariners,MARNRS,1,1,1,2,2011,2011,0,No,0,-0.98,0.0,0.98,57,0,-57,122,0,-122,0.0,0.0,0.0,5000000.0,0.0,-5000000.0
<a href=/player/wilsj004>wilsj004</a>,Justin Wilson,Pittsburgh Pirates,PIRATS,1,1,1,2,2014,2019,5,No,0,0.99,8.49,7.5,101,450,349,0,1734,1734,237.0,0.0,-237.0,515000.0,0.0,-515000.0
<a href=/player/wilsj004>wilsj004</a>,Justin Wilson,New York Yankees,YANKS,2,3,3,6,2015,2021,6,Yes,0,4.01,1.99,-2.02,203,135,-68,0,2,2,424.0,876.0,452.0,4456000.0,0.0,-4456000.0
<a href=/player/wilsj004>wilsj004</a>,Justin Wilson,Detroit Tigers,TIGRS,1,2,3,5,2017,2017,0,Yes,0,1.19,0.18,-1.01,218,27,-191,113,106,-7,217.0,0.0,-217.0,4700000.0,0.0,-4700000.0
<a href=/player/wilsj004>wilsj004</a>,Justin Wilson,New York Yankees,YANKS,1,2,1,3,2021,2021,0,Yes,0,1.83,0.0,-1.83,88,0,-88,0,0,0,127.0,0.0,-127.0,3900000.0,0.0,-3900000.0
<a href=/player/wilsj103>wilsj103</a>,Jack Wilson,Portland,Portland,1,1,1,2,1935,1938,3,No,0,12.22,0.0,-12.22,518,0,-518,417,0,-417,3203.0,0.0,-3203.0,0.0,0.0,0.0
<a href=/player/wilsj103>wilsj103</a>,Jack Wilson,Boston Red Sox,RSOX,2,3,3,6,1941,1943,2,No,0,21.33,-1.33,-22.66,818,70,-748,3332,174,-3158,514.0,323.0,-191.0,22500.0,0.0,-22500.0
<a href=/player/wilsj104>wilsj104</a>,Jim Wilson,Boston Red Sox,RSOX,2,8,5,13,1947,1955,8,No,0,6.5,21.93,15.43,835,962,127,1487,3127,1640,2844.0,2066.0,-778.0,10000.0,0.0,-10000.0
<a href=/player/wilsj104>wilsj104</a>,Jim Wilson,Cleveland Indians,INDINS,1,1,3,4,1949,1949,0,No,0,0.0,0.0,0.0,0,0,0,0,0,0,0.0,0.0,0.0,0.0,0.0,0.0
<a href=/player/wilsj104>wilsj104</a>,Jim Wilson,Seattle,Seattle,1,1,3,4,1950,1950,0,No,0,4.71,0.0,-4.71,200,0,-200,221,0,-221,1757.0,0.0,-1757.0,0.0,0.0,0.0
<a href=/player/wilsj104>wilsj104</a>,Jim Wilson,Baltimore Orioles,ORLS,26,48,50,98,1956,1994,38,No,3,80.74,145.05,64.31,5690,7775,2085,11208,18490,7282,20337.0,19836.0,-501.0,923333.0,0.0,-923333.0
<a href=/player/wilsj105>wilsj105</a>,Jimmie Wilson,Philadelphia Phillies,PHILS,5,9,9,18,1928,1940,12,No,0,39.18,41.3,2.12,1904,2696,792,7415,9869,2454,0.0,0.0,0.0,21000.0,0.0,-21000.0
<a href=/player/wilsj105>wilsj105</a>,Jimmie Wilson,St. Louis Cardinals,CARDS,1,1,2,3,1933,1936,3,No,0,0.74,4.53,3.79,311,321,10,949,1140,191,0.0,0.0,0.0,0.0,0.0,0.0
<a href=/player/wilsj105>wilsj105</a>,Jimmie Wilson,NewHaven,NewHaven,1,1,2,3,1923,1923,0,No,0,4.33,0.0,-4.33,838,0,-838,2778,0,-2778,0.0,0.0,0.0,0.0,0.0,0.0
<a href=/player/wilsm001>wilsm001</a>,Mookie Wilson,New York Mets,METS,1,1,2,3,1989,1990,1,No,0,1.54,-0.46,-2.0,287,96,-191,1134,2,-1132,0.0,175.0,175.0,1000000.0,0.0,-1000000.0
<a href=/player/wilsp001>wilsp001</a>,Paul Wilson,New York Mets,METS,2,3,3,6,2000,2001,1,No,0,6.03,0.01,-6.02,591,253,-338,1813,73,-1740,1188.0,422.0,-766.0,0.0,0.0,0.0
<a href=/player/wilsp002>wilsp002</a>,Preston Wilson,New York Mets,METS,1,3,1,4,1998,2005,7,No,0,6.18,24.6,18.42,588,972,384,2350,3941,1591,0.0,0.0,0.0,0.0,0.0,0.0
<a href=/player/wilsp002>wilsp002</a>,Preston Wilson,Florida Marlins,MARLNS,4,9,11,20,2002,2015,13,No,0,11.51,22.72,11.21,893,1533,640,2983,2710,-273,1797.0,5078.0,3281.0,13177000.0,0.0,-13177000.0
<a href=/player/wilsp002>wilsp002</a>,Preston Wilson,Colorado Rockies,ROCKS,1,1,3,4,2005,2006,1,No,0,0.4,-0.93,-1.33,68,16,-52,280,9,-271,0.0,74.0,74.0,12500000.0,0.0,-12500000.0
<a href=/player/wilsr102>wilsr102</a>,Red Wilson,Chicago White Sox,WSOX,30,57,56,113,1954,1971,17,No,0,69.82,122.29,52.47,8118,8309,191,22337,20184,-2153,7158.0,13512.0,6354.0,248750.0,0.0,-248750.0
<a href=/player/wilsr102>wilsr102</a>,Red Wilson,Detroit Tigers,TIGRS,1,2,1,3,1960,1960,0,No,0,-0.21,0.09,0.3,42,26,-16,127,61,-66,0.0,0.0,0.0,0.0,0.0,0.0
<a href=/player/wilss001>wilss001</a>,Steve Wilson,Texas Rangers,RNGRS,2,7,4,11,1988,1994,6,No,0,0.27,27.89,27.62,791,1284,493,491,4575,4084,1767.0,710.0,-1057.0,532500.0,0.0,-532500.0
<a href=/player/wilss001>wilss001</a>,Steve Wilson,Chicago Cubs,CUBS,1,1,1,2,1991,1991,0,No,0,0.95,0.0,-0.95,192,0,-192,6,0,-6,302.0,0.0,-302.0,205000.0,0.0,-205000.0
<a href=/player/wilst001>wilst001</a>,Tack Wilson,Los Angeles Dodgers,DOGRS,1,1,1,2,1983,1983,0,No,0,-0.05,0.0,0.05,5,0,-5,4,0,-4,0.0,0.0,0.0,0.0,0.0,0.0
<a href=/player/wilst001>wilst001</a>,Tack Wilson,Texas Rangers,RNGRS,1,2,2,4,1989,1989,0,No,0,0.0,0.0,0.0,0,0,0,0,0,0,0.0,0.0,0.0,0.0,0.0,0.0
<a href=/player/wilst003>wilst003</a>,Tom Wilson,New York Yankees,YANKS,1,1,2,3,1996,1996,0,No,0,0.0,0.0,0.0,0,0,0,0,0,0,0.0,0.0,0.0,0.0,0.0,0.0
<a href=/player/wilst003>wilst003</a>,Tom Wilson,Oakland Athletics,ATLTCS,1,1,1,2,2002,2002,0,No,0,0.2,0.0,-0.2,192,0,-192,589,0,-589,0.0,0.0,0.0,0.0,0.0,0.0
<a href=/player/wilst003>wilst003</a>,Tom Wilson,New York Mets,METS,1,1,1,2,2004,2004,0,No,0,-0.14,0.0,0.14,9,0,-9,8,0,-8,0.0,0.0,0.0,0.0,0.0,0.0
<a href=/player/wilst102>wilst102</a>,Tex Wilson,Brooklyn Dodgers,DOGRS,2,4,2,6,1925,1931,6,No,0,-1.16,1.81,2.97,36,399,363,37,1222,1185,282.0,591.0,309.0,7500.0,0.0,-7500.0
<a href=/player/wilst104>wilst104</a>,Terry Wilshusen,California Angels,ANGELS,2,3,2,5,1973,1974,1,No,0,-0.74,0.84,1.58,36,140,104,91,478,387,0.0,0.0,0.0,8550.0,0.0,-8550.0
<a href=/player/wilsv001>wilsv001</a>,Vance Wilson,New York Mets,METS,2,2,2,4,2005,2008,3,No,0,2.0,-1.09,-3.09,222,73,-149,687,89,-598,0.0,54.0,54.0,0.0,0.0,0.0
<a href=/player/wilth101>wilth101</a>,Hal Wiltse,Boston Red Sox,RSOX,1,1,1,2,1928,1928,0,No,0,0.17,-0.02,-0.19,52,104,52,23,343,320,216.0,0.0,-216.0,3600.0,0.0,-3600.0
<a href=/player/wilts101>wilts101</a>,Snake Wiltse,Syracuse,Syracuse,1,1,3,4,1901,1911,10,No,0,-0.42,0.0,0.42,14,0,-14,21,0,-21,133.0,0.0,-133.0,0.0,0.0,0.0
<a href=/player/wincs001>wincs001</a>,Scott Winchester,Cleveland Indians,INDINS,1,4,2,6,1997,1998,1,No,0,5.24,-0.51,-5.75,1014,98,-916,190,187,-3,2567.0,112.0,-2455.0,0.0,0.0,0.0
<a href=/player/wincs001>wincs001</a>,Scott Winchester,Arizona Diamondbacks,DBACKS,2,2,3,5,1997,2002,5,No,0,7.08,-0.46,-7.54,838,201,-637,44,1,-43,1558.0,280.0,-1278.0,210000.0,0.0,-210000.0
<a href=/player/windg101>windg101</a>,Gordie Windhorn,Boston Red Sox,RSOX,1,2,1,3,1957,1957,0,No,0,-2.46,0.0,2.46,96,0,-96,53,0,-53,393.0,0.0,-393.0,0.0,0.0,0.0
<a href=/player/windg101>windg101</a>,Gordie Windhorn,New York Yankees,YANKS,1,2,1,3,1960,1960,0,No,0,0.05,-0.09,-0.14,34,8,-26,37,0,-37,0.0,13.0,13.0,0.0,0.0,0.0
<a href=/player/windg101>windg101</a>,Gordie Windhorn,Los Angeles Dodgers,DOGRS,2,3,4,7,1961,1962,1,No,0,-0.42,0.0,0.42,35,0,-35,74,0,-74,0.0,0.0,0.0,0.0,0.0,0.0
<a href=/player/windg101>windg101</a>,Gordie Windhorn,Kansas City Athletics,ATLTCS,1,1,1,2,1962,1962,0,No,0,-0.07,0.19,0.26,40,6,-34,51,16,-35,0.0,0.0,0.0,0.0,0.0,0.0
<a href=/player/winer001>winer001</a>,Robbie Wine,Houston Astros,ASTROS,1,1,1,2,1988,1988,0,No,0,0.0,0.0,0.0,0,0,0,0,0,0,0.0,0.0,0.0,0.0,0.0,0.0
<a href=/player/winfd001>winfd001</a>,Dave Winfield,New York Yankees,YANKS,1,1,1,2,1990,1993,3,No,0,1.69,-0.2,-1.89,262,27,-235,1103,0,-1103,0.0,429.0,429.0,1958652.0,0.0,-1958652.0
<a href=/player/winga101>winga101</a>,Al Wingo,Detroit Tigers,TIGRS,2,4,2,6,1928,1933,5,No,0,12.96,7.86,-5.1,710,567,-143,2975,2526,-449,0.0,0.0,0.0,13000.0,0.0,-13000.0
<a href=/player/wingi101>wingi101</a>,Ivey Wingo,St. Louis Cardinals,CARDS,1,1,1,2,1915,1919,4,No,0,13.97,6.56,-7.41,1010,392,-618,3390,1201,-2189,0.0,0.0,0.0,0.0,0.0,0.0
<a href=/player/winkb801>winkb801</a>,Bobby Winkles,Chicago White Sox,WSOX,1,1,1,2,1958,1960,2,No,0,0.0,0.0,0.0,0,0,0,0,0,0,0.0,0.0,0.0,0.0,0.0,0.0
<a href=/player/winkd001>winkd001</a>,Daniel Winkler,Atlanta Braves,BRAVES,1,2,1,3,2019,2020,1,No,0,0.0,1.32,1.32,0,68,68,0,0,0,0.0,131.0,131.0,1610000.0,0.0,-1610000.0
<a href=/player/winnh001>winnh001</a>,Herm Winningham,New York Mets,METS,1,4,1,5,1984,1989,5,No,0,17.64,11.38,-6.26,1847,600,-1247,5919,2448,-3471,1489.0,0.0,-1489.0,356000.0,0.0,-356000.0
<a href=/player/winnh001>winnh001</a>,Herm Winningham,Montreal Expos,NATEX,3,5,4,9,1988,1992,4,No,0,1.15,0.52,-0.63,739,280,-459,1881,660,-1221,41.0,0.0,-41.0,330000.0,0.0,-330000.0
<a href=/player/winnj001>winnj001</a>,Jim Winn,Pittsburgh Pirates,PIRATS,1,1,1,2,1987,1990,3,No,0,-0.64,3.32,3.96,57,350,293,0,663,663,282.0,6.0,-276.0,0.0,0.0,0.0
<a href=/player/winnr001>winnr001</a>,Randy Winn,Tampa Bay Devil Rays,RAYS,2,2,3,5,2002,2004,2,No,0,10.07,0.43,-9.64,527,52,-475,2100,155,-1945,0.0,0.0,0.0,960000.0,0.0,-960000.0
<a href=/player/winnr001>winnr001</a>,Randy Winn,Seattle Mariners,MARNRS,3,3,4,7,2005,2007,2,No,0,13.21,0.09,-13.12,1039,42,-997,4182,119,-4063,0.0,0.0,0.0,3750000.0,0.0,-3750000.0
<a href=/player/winst101>winst101</a>,Tom Winsett,St. Louis Cardinals,CARDS,2,2,4,6,1936,1938,2,No,0,-1.6,0.05,1.65,216,177,-39,671,491,-180,3.0,0.0,-3.0,0.0,0.0,0.0
<a href=/player/winst101>winst101</a>,Tom Winsett,Boston Red Sox,RSOX,1,2,1,3,1931,1931,0,No,0,0.0,0.0,0.0,0,0,0,0,0,0,0.0,0.0,0.0,2400.0,0.0,-2400.0
<a href=/player/wintc101>wintc101</a>,Clarence Winters,SanAntonio,SanAntonio,1,1,1,2,1924,1924,0,No,0,-0.83,0.0,0.83,8,0,-8,3,0,-3,21.0,0.0,-21.0,0.0,0.0,0.0
<a href=/player/wintj101>wintj101</a>,Jesse Winters,New York Giants,GIANTS,2,7,2,9,1921,1924,3,No,0,-1.56,-0.07,1.49,187,154,-33,261,191,-70,992.0,253.0,-739.0,6000.0,0.0,-6000.0
<a href=/player/wintm001>wintm001</a>,Matt Winters,Chicago White Sox,WSOX,4,8,9,17,1986,1996,10,No,0,8.12,26.46,18.34,1204,1239,35,3582,5184,1602,266.0,488.0,222.0,4896500.0,0.0,-4896500.0
<a href=/player/wirta101>wirta101</a>,Alan Wirth,San Francisco Giants,GIANTS,4,14,8,22,1978,1992,14,No,0,8.18,23.62,15.44,767,1277,510,1656,1600,-56,2714.0,7759.0,5045.0,0.0,0.0,0.0
<a href=/player/wirtk101>wirtk101</a>,Kettle Wirts,Chicago White Sox,WSOX,6,16,8,24,1924,1936,12,No,0,0.32,2.24,1.92,474,816,342,1478,2777,1299,0.0,222.0,222.0,28700.0,0.0,-28700.0
<a href=/player/wisdp001>wisdp001</a>,Patrick Wisdom,St. Louis Cardinals,CARDS,1,1,1,2,2018,2019,1,No,0,-0.25,-0.09,0.16,9,5,-4,28,7,-21,0.0,0.0,0.0,0.0,0.0,0.0
<a href=/player/wisec101>wisec101</a>,Casey Wise,Chicago Cubs,CUBS,2,2,5,7,1957,1962,5,No,0,-1.01,1.27,2.28,58,134,76,170,208,38,0.0,138.0,138.0,0.0,0.0,0.0
<a href=/player/wisec101>wisec101</a>,Casey Wise,Milwaukee Braves,BRAVES,1,3,2,5,1959,1961,2,No,0,-0.44,0.34,0.78,224,49,-175,615,163,-452,0.0,0.0,0.0,0.0,0.0,0.0
<a href=/player/wiser101>wiser101</a>,Rick Wise,Philadelphia Phillies,PHILS,1,1,1,2,1972,1986,14,No,0,8.78,69.39,60.61,140,1000,860,202,1413,1211,1584.0,11092.0,9508.0,0.0,0.0,0.0
<a href=/player/wiser101>wiser101</a>,Rick Wise,St. Louis Cardinals,CARDS,10,15,16,31,1973,1978,5,No,0,43.88,7.39,-36.49,1933,556,-1377,5993,1737,-4256,2099.0,259.0,-1840.0,96000.0,0.0,-96000.0
<a href=/player/wiser101>wiser101</a>,Rick Wise,Boston Red Sox,RSOX,2,6,3,9,1978,1987,9,No,0,14.86,20.93,6.07,699,715,16,1362,2220,858,3997.0,3996.0,-1.0,0.0,0.0,0.0
<a href=/player/wislm001>wislm001</a>,Matt Wisler,San Diego Padres,PADRS,6,17,12,29,2015,2021,6,Yes,0,17.57,11.2,-6.37,1317,971,-346,3711,2795,-916,1719.0,362.0,-1357.0,9570500.0,0.0,-9570500.0
<a href=/player/wislm001>wislm001</a>,Matt Wisler,Atlanta Braves,BRAVES,1,3,1,4,2018,2020,2,No,0,1.47,1.06,-0.41,203,131,-72,53,396,343,403.0,0.0,-403.0,565000.0,0.0,-565000.0
<a href=/player/wislm001>wislm001</a>,Matt Wisler,Cincinnati Reds,REDS,1,1,1,2,2019,2019,0,Yes,0,-0.09,0.0,0.09,39,0,-39,1,0,-1,87.0,0.0,-87.0,0.0,0.0,0.0
<a href=/player/wislm001>wislm001</a>,Matt Wisler,San Francisco Giants,GIANTS,1,2,1,3,2021,2021,0,Yes,0,0.28,0.0,-0.28,28,0,-28,0,0,0,88.0,0.0,-88.0,1150000.0,0.0,-1150000.0
<a href=/player/wisnj101>wisnj101</a>,Jack Wisner,New York Giants,GIANTS,3,6,3,9,1926,1940,14,No,0,11.39,25.05,13.66,220,939,719,272,1487,1215,2128.0,7418.0,5290.0,4500.0,0.0,-4500.0
<a href=/player/witaj001>witaj001</a>,Jay Witasick,St. Louis Cardinals,CARDS,7,13,12,25,1996,2004,8,No,1,8.44,23.16,14.72,1305,1318,13,4128,1707,-2421,1089.0,4162.0,3073.0,14483333.0,0.0,-14483333.0
<a href=/player/witaj001>witaj001</a>,Jay Witasick,Oakland Athletics,ATLTCS,1,1,2,3,1999,2000,1,No,0,0.38,0.0,-0.38,59,0,-59,9,0,-9,743.0,0.0,-743.0,0.0,0.0,0.0
<a href=/player/witaj001>witaj001</a>,Jay Witasick,Kansas City Royals,ROYALS,1,1,1,2,2000,2001,1,No,0,0.25,0.3,0.05,256,21,-235,31,0,-31,620.0,366.0,-254.0,250000.0,0.0,-250000.0
<a href=/player/witaj001>witaj001</a>,Jay Witasick,San Diego Padres,PADRS,4,6,6,12,2001,2005,4,No,0,0.88,0.22,-0.66,482,271,-211,1468,818,-650,145.0,188.0,43.0,5015000.0,0.0,-5015000.0
<a href=/player/witaj001>witaj001</a>,Jay Witasick,New York Yankees,YANKS,1,1,1,2,2001,2002,1,No,0,1.38,0.36,-1.02,86,84,-2,5,245,240,205.0,0.0,-205.0,0.0,0.0,0.0
<a href=/player/witaj001>witaj001</a>,Jay Witasick,Colorado Rockies,ROCKS,3,5,4,9,2005,2010,5,No,0,4.0,-0.14,-4.14,707,385,-322,1691,690,-1001,801.0,134.0,-667.0,2526000.0,0.0,-2526000.0
<a href=/player/witem101>witem101</a>,Mickey Witek,New York Yankees,YANKS,1,1,3,4,1939,1943,4,No,0,7.53,0.0,-7.53,579,0,-579,2323,0,-2323,0.0,0.0,0.0,0.0,0.0,0.0
<a href=/player/witem101>witem101</a>,Mickey Witek,Boston Red Sox,RSOX,1,2,2,4,1948,1948,0,No,0,0.0,0.0,0.0,2,0,-2,1,0,-1,0.0,0.0,0.0,0.0,0.0,0.0
<a href=/player/witem101>witem101</a>,Mickey Witek,New York Giants,GIANTS,2,7,5,12,1948,1954,6,No,0,0.0,-0.44,-0.44,0,186,186,0,308,308,0.0,172.0,172.0,0.0,0.0,0.0
<a href=/player/withc001>withc001</a>,Chris Withrow,Los Angeles Dodgers,DOGRS,1,2,4,6,2015,2016,1,Yes,0,1.24,-0.01,-1.25,134,78,-56,167,142,-25,113.0,54.0,-59.0,0.0,0.0,0.0
<a href=/player/withc101>withc101</a>,Corky Withrow,St. Louis Cardinals,CARDS,2,4,3,7,1964,1965,1,No,0,0.31,0.14,-0.17,71,26,-45,56,14,-42,454.0,133.0,-321.0,0.0,0.0,0.0
<a href=/player/withf101>withf101</a>,Frank Withrow,Philadelphia Phillies,PHILS,6,11,10,21,1923,1940,17,No,0,39.18,45.63,6.45,1904,3534,1630,7415,12647,5232,0.0,0.0,0.0,21000.0,0.0,-21000.0
<a href=/player/wittb001>wittb001</a>,Bobby Witt,Texas Rangers,RNGRS,2,5,3,8,1992,1996,4,No,0,8.49,4.09,-4.4,638,377,-261,2442,1627,-815,1191.0,3.0,-1188.0,15083333.0,0.0,-15083333.0
<a href=/player/wittb001>wittb001</a>,Bobby Witt,Florida Marlins,MARLNS,1,1,2,3,1995,1997,2,No,0,3.86,0.0,-3.86,95,0,-95,7,0,-7,1618.0,0.0,-1618.0,1800000.0,0.0,-1800000.0
<a href=/player/wittm001>wittm001</a>,Mike Witt,California Angels,ANGELS,1,1,1,2,1990,1991,1,No,0,-0.2,1.69,1.89,27,262,235,0,1103,1103,429.0,0.0,-429.0,1300000.0,0.0,-1300000.0
<a href=/player/wittn001>wittn001</a>,Nick Wittgren,Miami Marlins,MARLNS,1,1,1,2,2019,2019,0,Yes,0,1.31,0.0,-1.31,147,0,-147,0,0,0,431.0,0.0,-431.0,0.0,0.0,0.0
<a href=/player/wockj001>wockj001</a>,John Wockenfuss,Texas Rangers,RNGRS,3,7,4,11,1973,1978,5,No,0,27.61,17.12,-10.49,555,168,-387,197,0,-197,7626.0,3555.0,-4071.0,60000.0,0.0,-60000.0
<a href=/player/wockj001>wockj001</a>,John Wockenfuss,St. Louis Cardinals,CARDS,1,1,1,2,1973,1973,0,No,0,6.8,0.0,-6.8,677,0,-677,2117,0,-2117,0.0,0.0,0.0,0.0,0.0,0.0
<a href=/player/wockj001>wockj001</a>,John Wockenfuss,Detroit Tigers,TIGRS,1,2,2,4,1984,1992,8,No,0,6.42,12.78,6.36,721,1236,515,2522,2277,-245,3.0,1451.0,1448.0,0.0,0.0,0.0
<a href=/player/woeha101>woeha101</a>,Andy Woehr,Philadelphia Phillies,PHILS,1,2,1,3,1924,1924,0,No,0,0.0,0.0,0.0,0,0,0,0,0,0,0.0,0.0,0.0,4800.0,0.0,-4800.0
<a href=/player/wohlj001>wohlj001</a>,Jim Wohlford,Kansas City Royals,ROYALS,4,7,5,12,1976,1997,21,No,1,3.48,61.02,57.54,709,1258,549,973,3160,2187,2893.0,7458.0,4565.0,1600000.0,0.0,-1600000.0
<a href=/player/wohlj001>wohlj001</a>,Jim Wohlford,San Francisco Giants,GIANTS,1,1,1,2,1983,1983,0,No,0,1.35,0.33,-1.02,318,22,-296,626,77,-549,0.0,0.0,0.0,0.0,0.0,0.0
<a href=/player/wohlm001>wohlm001</a>,Mark Wohlers,Atlanta Braves,BRAVES,1,2,1,3,1999,1999,0,No,0,0.18,-0.27,-0.45,99,27,-72,0,1,1,180.0,50.0,-130.0,5200000.0,0.0,-5200000.0
<a href=/player/wohlm001>wohlm001</a>,Mark Wohlers,Cincinnati Reds,REDS,1,1,1,2,2001,2001,0,No,0,0.22,0.0,-0.22,36,0,-36,0,0,0,107.0,0.0,-107.0,500000.0,0.0,-500000.0
<a href=/player/wojca001>wojca001</a>,Asher Wojciechowski,Toronto Blue Jays,BJAYS,4,12,6,18,2012,2016,4,No,0,10.83,2.99,-7.84,1068,309,-759,3494,605,-2889,904.0,1431.0,527.0,11237500.0,0.0,-11237500.0
<a href=/player/wojep101>wojep101</a>,Pete Wojey,Brooklyn Dodgers,DOGRS,1,1,2,3,1955,1955,0,No,0,0.17,0.0,-0.17,8,0,-8,0,0,0,16.0,0.0,-16.0,0.0,0.0,0.0
<a href=/player/wojep101>wojep101</a>,Pete Wojey,Detroit Tigers,TIGRS,3,5,6,11,1958,1964,6,No,0,0.54,14.8,14.26,185,388,203,295,399,104,451.0,2975.0,2524.0,0.0,0.0,0.0
<a href=/player/wojne001>wojne001</a>,Ed Wojna,Philadelphia Phillies,PHILS,4,7,5,12,1983,1992,9,No,1,3.32,3.9,0.58,591,613,22,223,793,570,1674.0,2750.0,1076.0,375000.0,0.0,-375000.0
<a href=/player/wojne001>wojne001</a>,Ed Wojna,San Diego Padres,PADRS,1,1,1,2,1987,1988,1,No,0,0.0,0.0,0.0,0,0,0,0,0,0,0.0,0.0,0.0,0.0,0.0,0.0
<a href=/player/wojne001>wojne001</a>,Ed Wojna,Chicago White Sox,WSOX,1,2,1,3,1989,1989,0,No,0,0.24,0.81,0.57,9,66,57,0,229,229,99.0,0.0,-99.0,0.0,0.0,0.0
<a href=/player/wolcb001>wolcb001</a>,Bob Wolcott,Arizona Diamondbacks,DBACKS,1,1,1,2,1998,2000,2,No,0,-0.14,0.0,0.14,4,0,-4,0,0,0,20.0,0.0,-20.0,0.0,0.0,0.0
<a href=/player/wolfb001>wolfb001</a>,Brian Wolfe,Milwaukee Brewers,BREWRS,1,1,1,2,2006,2007,1,No,0,0.72,1.11,0.39,75,76,1,0,289,289,248.0,0.0,-248.0,0.0,0.0,0.0
<a href=/player/wolfb102>wolfb102</a>,Barney Wolfe,New York Yankees,YANKS,1,2,1,3,1904,1904,0,No,0,10.23,2.28,-7.95,672,44,-628,792,66,-726,6259.0,413.0,-5846.0,0.0,0.0,0.0
<a href=/player/wolfl101>wolfl101</a>,Larry Wolfe,Minnesota Twins,TWINS,1,1,1,2,1979,1979,0,No,0,0.18,0.0,-0.18,65,0,-65,124,0,-124,0.0,0.0,0.0,0.0,0.0,0.0
<a href=/player/wolfr001>wolfr001</a>,Randy Wolf,San Diego Padres,PADRS,2,2,2,4,2008,2009,1,No,0,1.12,-0.01,-1.13,25,8,-17,26,6,-20,227.0,54.0,-173.0,4750000.0,0.0,-4750000.0
<a href=/player/wolfr002>wolfr002</a>,Ross Wolf,Baltimore Orioles,ORLS,1,1,1,2,2010,2011,1,No,0,0.02,-0.09,-0.11,11,65,54,0,172,172,38.0,0.0,-38.0,0.0,0.0,0.0
<a href=/player/wolfr102>wolfr102</a>,Roger Wolff,Philadelphia Athletics,ATLTCS,1,1,1,2,1943,1946,3,No,0,5.14,6.62,1.48,174,166,-8,200,214,14,1581.0,1742.0,161.0,5000.0,0.0,-5000.0
<a href=/player/wolfr102>wolfr102</a>,Roger Wolff,Washington Senators,TWINS,1,1,1,2,1947,1947,0,No,0,0.01,-0.8,-0.81,14,36,22,5,89,84,48.0,0.0,-48.0,0.0,0.0,0.0
<a href=/player/wolfr102>wolfr102</a>,Roger Wolff,Pittsburgh Pirates,PIRATS,1,2,1,3,1947,1953,6,No,0,0.0,-0.99,-0.99,0,295,295,0,686,686,0.0,0.0,0.0,0.0,0.0,0.0
<a href=/player/wolfw101>wolfw101</a>,Wally Wolf,Houston Astros,ASTROS,2,4,2,6,1964,1966,2,No,0,0.87,1.76,0.89,66,278,212,152,894,742,15.0,0.0,-15.0,0.0,0.0,0.0
<a href=/player/wolvh101>wolvh101</a>,Harry Wolverton,Philadelphia Phillies,PHILS,1,2,1,3,1904,1904,0,No,0,3.87,0.0,-3.87,209,0,-209,665,0,-665,1001.0,0.0,-1001.0,0.0,0.0,0.0
<a href=/player/womad101>womad101</a>,Dooley Womack,New York Yankees,YANKS,2,2,2,4,1968,1969,1,No,0,0.39,0.08,-0.31,86,6,-80,63,14,-49,154.0,0.0,-154.0,38500.0,0.0,-38500.0
<a href=/player/womad101>womad101</a>,Dooley Womack,Houston Astros,ASTROS,1,2,1,3,1969,1970,1,No,0,0.39,-0.47,-0.86,18,90,72,1,24,23,43.0,312.0,269.0,23500.0,0.0,-23500.0
<a href=/player/womad101>womad101</a>,Dooley Womack,Houston Astros,ASTROS,2,4,2,6,1969,1973,4,No,0,-0.36,3.98,4.34,121,303,182,243,70,-173,0.0,713.0,713.0,23500.0,0.0,-23500.0
<a href=/player/womat001>womat001</a>,Tony Womack,Pittsburgh Pirates,PIRATS,1,1,2,3,1999,2000,1,No,0,1.43,0.08,-1.35,629,8,-621,2744,1,-2743,0.0,16.0,16.0,0.0,0.0,0.0
<a href=/player/womat001>womat001</a>,Tony Womack,Arizona Diamondbacks,DBACKS,1,1,1,2,2003,2003,0,No,0,-0.63,0.0,0.63,21,0,-21,81,0,-81,0.0,0.0,0.0,6000000.0,0.0,-6000000.0
<a href=/player/womat001>womat001</a>,Tony Womack,Colorado Rockies,ROCKS,1,1,1,2,2003,2003,0,No,0,0.24,0.0,-0.24,40,0,-40,109,0,-109,0.0,0.0,0.0,0.0,0.0,0.0
<a href=/player/womat001>womat001</a>,Tony Womack,Boston Red Sox,RSOX,1,1,1,2,2004,2004,0,No,0,3.28,0.0,-3.28,145,0,-145,606,0,-606,0.0,0.0,0.0,0.0,0.0,0.0
<a href=/player/womat001>womat001</a>,Tony Womack,New York Yankees,YANKS,1,2,2,4,2005,2005,0,No,0,0.1,0.0,-0.1,9,0,-9,23,0,-23,0.0,0.0,0.0,2000000.0,0.0,-2000000.0
<a href=/player/wongc001>wongc001</a>,Connor Wong,Los Angeles Dodgers,DOGRS,1,3,3,6,2020,2020,0,Yes,0,4.62,3.6,-1.02,205,55,-150,839,246,-593,0.0,0.0,0.0,0.0,0.0,0.0
<a href=/player/wooda001>wooda001</a>,Al Woods,Toronto Blue Jays,BJAYS,1,1,1,2,1982,1984,2,No,0,0.0,4.73,4.73,0,269,269,0,899,899,0.0,0.0,0.0,0.0,0.0,0.0
<a href=/player/wooda002>wooda002</a>,Alex Wood,Atlanta Braves,BRAVES,3,7,11,18,2015,2020,5,Yes,0,4.88,-1.29,-6.17,588,465,-123,687,1320,633,1642.0,246.0,-1396.0,24400000.0,0.0,-24400000.0
<a href=/player/wooda002>wooda002</a>,Alex Wood,Los Angeles Dodgers,DOGRS,3,12,8,20,2018,2021,3,Yes,0,5.8,8.33,2.53,663,133,-530,2223,501,-1722,299.0,229.0,-70.0,36964000.0,0.0,-36964000.0
<a href=/player/woodd102>woodd102</a>,Dick Woodson,Minnesota Twins,TWINS,1,1,2,3,1974,1977,3,No,0,-0.46,-0.48,-0.02,8,13,5,0,0,0,84.0,140.0,56.0,29000.0,0.0,-29000.0
<a href=/player/woodd102>woodd102</a>,Dick Woodson,New York Yankees,YANKS,1,1,1,2,1975,1975,0,No,0,0.0,0.0,0.0,0,0,0,0,0,0,0.0,0.0,0.0,0.0,0.0,0.0
<a href=/player/woodf102>woodf102</a>,Frank Woodward,Philadelphia Phillies,PHILS,3,6,7,13,1919,1925,6,No,0,15.32,16.37,1.05,851,640,-211,1993,1730,-263,4451.0,3043.0,-1408.0,8500.0,0.0,-8500.0
<a href=/player/woodg001>woodg001</a>,Gary Woods,Toronto Blue Jays,BJAYS,3,3,3,6,1978,1986,8,No,0,0.25,3.51,3.26,73,454,381,181,1261,1080,0.0,0.0,0.0,0.0,0.0,0.0
<a href=/player/woodg001>woodg001</a>,Gary Woods,Houston Astros,ASTROS,1,1,1,2,1981,1981,0,No,0,0.76,0.0,-0.76,378,0,-378,690,0,-690,0.0,0.0,0.0,0.0,0.0,0.0
<a href=/player/woodg101>woodg101</a>,Gene Woodling,Cleveland Indians,INDINS,1,1,1,2,1946,1947,1,No,0,0.08,0.35,0.27,22,61,39,87,135,48,0.0,0.0,0.0,0.0,0.0,0.0
<a href=/player/woodg101>woodg101</a>,Gene Woodling,Pittsburgh Pirates,PIRATS,1,5,1,6,1947,1947,0,No,0,0.0,0.0,0.0,0,0,0,0,0,0,0.0,0.0,0.0,5000.0,0.0,-5000.0
<a href=/player/woodg101>woodg101</a>,Gene Woodling,New York Yankees,YANKS,12,33,27,60,1954,1970,16,No,0,40.55,76.98,36.43,5201,4368,-833,16466,10777,-5689,3212.0,10751.0,7539.0,302500.0,0.0,-302500.0
<a href=/player/woodg101>woodg101</a>,Gene Woodling,Baltimore Orioles,ORLS,2,3,3,6,1955,1956,1,No,0,5.21,-0.32,-5.53,337,154,-183,1279,434,-845,0.0,0.0,0.0,0.0,0.0,0.0
<a href=/player/woodg101>woodg101</a>,Gene Woodling,Cleveland Indians,INDINS,8,15,14,29,1958,1968,10,No,0,101.35,32.49,-68.86,4418,2446,-1972,15260,8973,-6287,4502.0,562.0,-3940.0,0.0,0.0,0.0
<a href=/player/woodh001>woodh001</a>,Hunter Wood,Tampa Bay Devil Rays,RAYS,1,2,2,4,2019,2019,0,Yes,0,0.02,0.0,-0.02,21,0,-21,0,0,0,49.0,0.0,-49.0,0.0,0.0,0.0
<a href=/player/woodh101>woodh101</a>,Hal Woodeshick,Detroit Tigers,TIGRS,3,4,5,9,1958,1968,10,No,0,1.32,14.68,13.36,168,713,545,243,528,285,332.0,3536.0,3204.0,0.0,0.0,0.0
<a href=/player/woodh101>woodh101</a>,Hal Woodeshick,Cleveland Indians,INDINS,1,2,1,3,1959,1960,1,No,0,-2.61,0.95,3.56,330,49,-281,541,143,-398,528.0,0.0,-528.0,0.0,0.0,0.0
<a href=/player/woodh101>woodh101</a>,Hal Woodeshick,Washington Senators,RNGRS,1,1,1,2,1961,1967,6,No,0,-0.79,0.48,1.27,24,430,406,5,1410,1405,55.0,0.0,-55.0,0.0,0.0,0.0
<a href=/player/woodh101>woodh101</a>,Hal Woodeshick,Houston Astros,ASTROS,3,6,5,11,1965,1970,5,No,0,24.19,12.71,-11.48,1107,622,-485,906,1206,300,7567.0,2468.0,-5099.0,0.0,0.0,0.0
<a href=/player/woodj001>woodj001</a>,Jason Wood,Oakland Athletics,ATLTCS,1,1,1,2,1998,1998,0,No,0,-0.21,1.23,1.44,37,61,24,73,201,128,0.0,0.0,0.0,170000.0,0.0,-170000.0
<a href=/player/woodj103>woodj103</a>,Jim Woods,Chicago Cubs,CUBS,1,3,1,4,1960,1961,1,No,0,4.05,4.05,0.0,233,260,27,447,1040,593,1208.0,0.0,-1208.0,0.0,0.0,0.0
<a href=/player/woodk002>woodk002</a>,Kerry Wood,Cleveland Indians,INDINS,1,2,2,4,2010,2010,0,No,0,1.48,0.0,-1.48,24,0,-24,0,0,0,78.0,0.0,-78.0,10500000.0,0.0,-10500000.0
<a href=/player/woodk101>woodk101</a>,Ken Wood,St.Louis Browns,ORLS,3,5,5,10,1951,1956,5,No,0,0.5,2.1,1.6,348,405,57,823,914,91,0.0,256.0,256.0,0.0,0.0,0.0
<a href=/player/woodk101>woodk101</a>,Ken Wood,Boston Red Sox,RSOX,1,1,1,2,1952,1953,1,No,0,0.53,-0.15,-0.68,73,18,-55,275,41,-234,0.0,0.0,0.0,0.0,0.0,0.0
<a href=/player/woodk101>woodk101</a>,Ken Wood,Washington Senators,TWINS,1,1,1,2,1953,1953,0,No,0,0.0,-0.08,-0.08,0,17,17,0,24,24,0.0,0.0,0.0,0.0,0.0,0.0
<a href=/player/woodl101>woodl101</a>,Larry Woodall,Chicago Cubs,CUBS,2,8,3,11,1933,1946,13,No,0,22.35,18.34,-4.01,627,903,276,2568,3781,1213,0.0,0.0,0.0,0.0,0.0,0.0
<a href=/player/woodm002>woodm002</a>,Mike Wood,Oakland Athletics,ATLTCS,1,2,1,3,2004,2005,1,No,0,4.64,1.22,-3.42,770,62,-708,2737,0,-2737,839.0,198.0,-641.0,0.0,0.0,0.0
<a href=/player/woodr102>woodr102</a>,Ron Woods,Detroit Tigers,TIGRS,1,1,1,2,1969,1970,1,No,0,1.05,0.61,-0.44,192,94,-98,500,377,-123,0.0,0.0,0.0,7500.0,0.0,-7500.0
<a href=/player/woodr102>woodr102</a>,Ron Woods,New York Yankees,YANKS,1,1,1,2,1971,1973,2,No,0,2.67,0.28,-2.39,373,152,-221,944,350,-594,0.0,0.0,0.0,16000.0,0.0,-16000.0
<a href=/player/woods001>woods001</a>,Steve Woodard,Milwaukee Brewers,BREWRS,10,20,24,44,2000,2012,12,No,2,44.17,39.37,-4.8,3016,3033,17,9285,7113,-2172,2619.0,7597.0,4978.0,13997000.0,0.0,-13997000.0
<a href=/player/woods102>woods102</a>,Sam Woodruff,Cincinnati Reds,REDS,1,2,1,3,1905,1905,0,No,0,0.0,0.0,0.0,0,0,0,0,0,0,0.0,0.0,0.0,0.0,0.0,0.0
<a href=/player/woods102>woods102</a>,Sam Woodruff,Louisville,Louisville,1,1,2,3,1910,1910,0,No,0,-0.59,0.0,0.59,21,0,-21,69,0,-69,0.0,0.0,0.0,0.0,0.0,0.0
<a href=/player/woodt001>woodt001</a>,Tracy Woodson,Los Angeles Dodgers,DOGRS,1,1,1,2,1989,1989,0,No,0,0.0,0.0,0.0,0,0,0,0,0,0,0.0,0.0,0.0,0.0,0.0,0.0
<a href=/player/woodt004>woodt004</a>,Travis Wood,Cincinnati Reds,REDS,1,3,1,4,2011,2015,4,No,0,7.63,1.09,-6.54,509,203,-306,388,0,-388,2074.0,256.0,-1818.0,422500.0,0.0,-422500.0
<a href=/player/woodt004>woodt004</a>,Travis Wood,Kansas City Royals,ROYALS,2,7,5,12,2017,2021,4,No,0,3.49,-0.89,-4.38,348,169,-179,52,6,-46,1021.0,694.0,-327.0,538900.0,0.0,-538900.0
<a href=/player/woodw101>woodw101</a>,Woody Woodward,Atlanta Braves,BRAVES,3,5,5,10,1968,1970,2,No,0,13.88,3.02,-10.86,1605,185,-1420,1388,304,-1084,4147.0,923.0,-3224.0,0.0,0.0,0.0
<a href=/player/woodw102>woodw102</a>,Walt Woods,Pittsburgh Pirates,PIRATS,1,3,1,4,1901,1901,0,No,0,0.0,-0.42,-0.42,0,14,14,0,21,21,0.0,133.0,133.0,0.0,0.0,0.0
<a href=/player/woodw103>woodw103</a>,Wilbur Wood,Pittsburgh Pirates,PIRATS,1,1,1,2,1966,1968,2,No,0,50.06,-1.24,-51.3,965,125,-840,349,30,-319,7574.0,354.0,-7220.0,0.0,0.0,0.0
<a href=/player/workb001>workb001</a>,Brandon Workman,Boston Red Sox,RSOX,1,2,2,4,2020,2020,0,Yes,0,-0.87,0.58,1.45,25,2,-23,0,0,0,67.0,30.0,-37.0,5113000.0,0.0,-5113000.0
<a href=/player/workc101>workc101</a>,Chuck Workman,Boston Braves,BRAVES,1,1,1,2,1946,1946,0,No,0,0.37,-0.14,-0.51,58,24,-34,162,55,-107,0.0,0.0,0.0,0.0,0.0,0.0
<a href=/player/worlv001>worlv001</a>,Vance Worley,Philadelphia Phillies,PHILS,3,4,4,8,2012,2016,4,Yes,0,1.59,4.92,3.33,336,335,-1,250,1350,1100,1151.0,0.0,-1151.0,4595000.0,0.0,-4595000.0
<a href=/player/worrm001>worrm001</a>,Mark Worrell,St. Louis Cardinals,CARDS,1,2,1,3,2008,2009,1,No,0,4.04,-0.85,-4.89,717,77,-640,3,193,190,1041.0,0.0,-1041.0,0.0,0.0,0.0
<a href=/player/worrt002>worrt002</a>,Tim Worrell,San Diego Padres,PADRS,11,16,16,32,1997,2005,8,No,0,0.63,9.5,8.87,874,1331,457,1663,2360,697,1171.0,1867.0,696.0,13510000.0,0.0,-13510000.0
<a href=/player/worrt002>worrt002</a>,Tim Worrell,Detroit Tigers,TIGRS,1,2,1,3,1998,1998,0,No,0,0.14,-0.51,-0.65,78,52,-26,182,145,-37,16.0,0.0,-16.0,1000000.0,0.0,-1000000.0
<a href=/player/worrt002>worrt002</a>,Tim Worrell,Cleveland Indians,INDINS,1,1,1,2,1998,1998,0,No,0,1.32,0.0,-1.32,82,0,-82,0,0,0,316.0,0.0,-316.0,0.0,0.0,0.0
<a href=/player/worrt002>worrt002</a>,Tim Worrell,Chicago Cubs,CUBS,2,3,2,5,2000,2002,2,No,0,1.7,3.59,1.89,504,173,-331,24,670,646,747.0,0.0,-747.0,3450000.0,0.0,-3450000.0
<a href=/player/worrt002>worrt002</a>,Tim Worrell,Philadelphia Phillies,PHILS,1,2,1,3,2005,2006,1,No,0,0.45,-0.09,-0.54,64,10,-54,1,6,5,95.0,0.0,-95.0,3050000.0,0.0,-3050000.0
<a href=/player/worta101>worta101</a>,Al Worthington,San Francisco Giants,GIANTS,1,1,1,2,1960,1961,1,No,0,-0.51,0.2,0.71,12,119,107,1,176,175,35.0,0.0,-35.0,0.0,0.0,0.0
<a href=/player/wortc001>wortc001</a>,Craig Worthington,Baltimore Orioles,ORLS,1,2,2,4,1992,1992,0,No,0,0.0,0.0,0.0,0,0,0,0,0,0,0.0,0.0,0.0,0.0,0.0,0.0
<a href=/player/wortc001>wortc001</a>,Craig Worthington,Cincinnati Reds,REDS,1,1,2,3,1995,1995,0,No,0,0.43,0.0,-0.43,39,0,-39,104,0,-104,0.0,0.0,0.0,0.0,0.0,0.0
<a href=/player/wortc101>wortc101</a>,Chuck Wortman,KansasCity,KansasCity,1,2,1,3,1916,1916,0,No,0,-2.05,0.0,2.05,161,0,-161,494,0,-494,0.0,0.0,0.0,0.0,0.0,0.0
<a href=/player/wortr101>wortr101</a>,Rich Wortham,Chicago White Sox,WSOX,2,2,2,4,1980,1987,7,No,0,0.85,11.85,11.0,80,716,636,347,2709,2362,0.0,0.0,0.0,252000.0,0.0,-252000.0
<a href=/player/wothm001>wothm001</a>,Matt Wotherspoon,New York Yankees,YANKS,1,1,1,2,2017,2017,0,No,0,-0.4,0.0,0.4,2,0,-2,0,0,0,14.0,0.0,-14.0,0.0,0.0,0.0
<a href=/player/wriga102>wriga102</a>,Al Wright,Mission,Mission,1,2,2,4,1932,1933,1,No,0,-0.29,0.0,0.29,86,0,-86,205,0,-205,0.0,0.0,0.0,0.0,0.0,0.0
<a href=/player/wrigc001>wrigc001</a>,Chase Wright,New York Yankees,YANKS,2,3,3,6,2009,2009,0,No,0,-0.08,0.01,0.09,52,39,-13,126,98,-28,0.0,0.0,0.0,0.0,0.0,0.0
<a href=/player/wrigc102>wrigc102</a>,Clyde Wright,California Angels,ANGELS,3,7,8,15,1973,1976,3,No,0,0.2,6.55,6.35,187,557,370,417,1633,1216,696.0,244.0,-452.0,35000.0,0.0,-35000.0
<a href=/player/wrigc102>wrigc102</a>,Clyde Wright,Milwaukee Brewers,BREWRS,1,1,1,2,1974,1976,2,No,0,-0.25,1.7,1.95,25,58,33,0,0,0,280.0,938.0,658.0,67001.0,0.0,-67001.0
<a href=/player/wrige101>wrige101</a>,Ed Wright,Indianapolis,Indianapolis,1,1,2,3,1945,1945,0,No,0,3.35,0.0,-3.35,154,0,-154,133,0,-133,1068.0,0.0,-1068.0,0.0,0.0,0.0
<a href=/player/wrige101>wrige101</a>,Ed Wright,Philadelphia Phillies,PHILS,1,1,1,2,1950,1950,0,No,0,0.0,0.0,0.0,0,0,0,0,0,0,0.0,0.0,0.0,0.0,0.0,0.0
<a href=/player/wrigg001>wrigg001</a>,George Wright,San Francisco Giants,GIANTS,1,1,1,2,1989,1989,0,No,0,0.0,-0.19,-0.19,0,12,12,0,20,20,0.0,0.0,0.0,0.0,0.0,0.0
<a href=/player/wrigg102>wrigg102</a>,Glenn Wright,Pittsburgh Pirates,PIRATS,1,1,2,3,1928,1930,2,No,0,8.54,0.53,-8.01,434,100,-334,1570,99,-1471,0.0,677.0,677.0,12000.0,0.0,-12000.0
<a href=/player/wrigg103>wrigg103</a>,Gene Wright,Cleveland Indians,INDINS,2,2,2,4,1903,1905,2,No,0,3.81,4.62,0.81,75,142,67,117,222,105,918.0,1669.0,751.0,0.0,0.0,0.0
<a href=/player/wrigj001>wrigj001</a>,Jamey Wright,Colorado Rockies,ROCKS,5,7,10,17,1999,2015,16,Yes,2,2.29,20.39,18.1,742,1883,1141,1686,1378,-308,1715.0,2932.0,1217.0,6840000.0,0.0,-6840000.0
<a href=/player/wrigj001>wrigj001</a>,Jamey Wright,Milwaukee Brewers,BREWRS,1,2,2,4,2002,2003,1,No,0,0.01,0.04,0.03,8,8,0,6,1,-5,45.0,12.0,-33.0,4250000.0,0.0,-4250000.0
<a href=/player/wrigj002>wrigj002</a>,Jaret Wright,New York Yankees,YANKS,1,2,1,3,2006,2008,2,No,0,-0.34,0.34,0.68,3,28,25,0,0,0,31.0,107.0,76.0,7666667.0,0.0,-7666667.0
<a href=/player/wrigj101>wrigj101</a>,Jim Wright,Kansas City Royals,ROYALS,1,1,1,2,1982,1982,0,No,0,0.0,0.0,0.0,0,0,0,0,0,0,0.0,0.0,0.0,0.0,0.0,0.0
<a href=/player/wrigj102>wrigj102</a>,Joe Wright,Louisville Colonels,LS3,1,2,1,3,1896,1899,3,No,0,-0.17,5.69,5.86,17,500,483,58,1976,1918,0.0,0.0,0.0,0.0,0.0,0.0
<a href=/player/wrigk101>wrigk101</a>,Ken Wright,Kansas City Royals,ROYALS,1,2,1,3,1973,1977,4,No,0,9.36,0.87,-8.49,1040,79,-961,3577,0,-3577,17.0,554.0,537.0,65000.0,0.0,-65000.0
<a href=/player/wrigk101>wrigk101</a>,Ken Wright,New York Yankees,YANKS,1,1,1,2,1974,1975,1,No,0,0.0,0.48,0.48,0,26,26,0,0,0,0.0,170.0,170.0,20000.0,0.0,-20000.0
<a href=/player/wrigm001>wrigm001</a>,Mike Wright,Baltimore Orioles,ORLS,1,1,1,2,2019,2019,0,Yes,0,-0.21,0.0,0.21,9,0,-9,0,0,0,48.0,0.0,-48.0,567500.0,0.0,-567500.0
<a href=/player/wrigm101>wrigm101</a>,Mel Wright,New York Yankees,YANKS,2,5,3,8,1954,1955,1,No,0,3.52,0.32,-3.2,493,79,-414,1250,164,-1086,274.0,0.0,-274.0,20000.0,0.0,-20000.0
<a href=/player/wrigr001>wrigr001</a>,Ricky Wright,Los Angeles Dodgers,DOGRS,5,8,6,14,1983,1994,11,No,0,11.39,19.01,7.62,690,775,85,366,1238,872,3528.0,4504.0,976.0,3861000.0,0.0,-3861000.0
<a href=/player/wrigr002>wrigr002</a>,Ron Wright,Atlanta Braves,BRAVES,10,23,19,42,1996,2015,19,No,3,94.1,26.32,-67.78,4716,2211,-2505,15043,5115,-9928,7498.0,3071.0,-4427.0,29276500.0,0.0,-29276500.0
<a href=/player/wrigr104>wrigr104</a>,Rasty Wright,St.Louis Browns,ORLS,1,2,1,3,1920,1920,0,No,0,0.0,5.97,5.97,0,76,76,0,110,110,0.0,806.0,806.0,0.0,0.0,0.0
<a href=/player/wrigs001>wrigs001</a>,Steven Wright,Cleveland Indians,INDINS,5,9,12,21,2012,2019,7,Yes,0,7.61,23.51,15.9,415,937,522,560,910,350,1555.0,4479.0,2924.0,22963900.0,0.0,-22963900.0
<a href=/player/wrigt101>wrigt101</a>,Tom Wright,Boston Red Sox,RSOX,2,3,3,6,1951,1954,3,No,0,0.76,-1.3,-2.06,327,78,-249,1005,178,-827,0.0,0.0,0.0,0.0,0.0,0.0
<a href=/player/wrigt101>wrigt101</a>,Tom Wright,St.Louis Browns,ORLS,1,2,2,4,1952,1952,0,No,0,0.64,0.34,-0.3,156,55,-101,332,173,-159,0.0,0.0,0.0,0.0,0.0,0.0
<a href=/player/wrigt101>wrigt101</a>,Tom Wright,Chicago White Sox,WSOX,1,1,1,2,1954,1954,0,No,0,0.35,0.0,-0.35,85,0,-85,200,0,-200,0.0,0.0,0.0,0.0,0.0,0.0
<a href=/player/wrigt102>wrigt102</a>,Taffy Wright,Washington Senators,TWINS,5,8,6,14,1939,1946,7,No,0,15.27,0.38,-14.89,1887,491,-1396,7336,1848,-5488,270.0,315.0,45.0,42250.0,0.0,-42250.0
<a href=/player/wuerm001>wuerm001</a>,Michael Wuertz,Chicago Cubs,CUBS,1,1,2,3,2009,2009,0,No,0,1.6,0.0,-1.6,173,0,-173,0,0,0,456.0,0.0,-456.0,0.0,0.0,0.0
<a href=/player/wuesy101>wuesy101</a>,Yats Wuestling,Detroit Tigers,TIGRS,1,3,2,5,1930,1932,2,No,0,0.55,-1.14,-1.69,146,271,125,467,761,294,97.0,731.0,634.0,18000.0,0.0,-18000.0
<a href=/player/wyatj102>wyatj102</a>,John Wyatt,New York Yankees,YANKS,1,1,1,2,1968,1968,0,No,0,0.35,0.0,-0.35,44,0,-44,2,0,-2,91.0,0.0,-91.0,0.0,0.0,0.0
<a href=/player/wyatj102>wyatj102</a>,John Wyatt,Kansas City Athletics,ATLTCS,10,23,15,38,1966,1976,10,No,0,27.1,17.67,-9.43,4296,1831,-2465,8999,4813,-4186,5181.0,1373.0,-3808.0,355600.0,0.0,-355600.0
<a href=/player/wyatw101>wyatw101</a>,Whit Wyatt,Detroit Tigers,TIGRS,1,1,1,2,1933,1934,1,No,0,-0.72,-1.98,-1.26,164,56,-108,74,52,-22,631.0,381.0,-250.0,3900.0,0.0,-3900.0
<a href=/player/wyneb001>wyneb001</a>,Butch Wynegar,Minnesota Twins,TWINS,4,5,7,12,1982,1986,4,No,0,11.35,2.12,-9.23,555,275,-280,2031,106,-1925,297.0,1461.0,1164.0,620000.0,0.0,-620000.0
<a href=/player/wyneb001>wyneb001</a>,Butch Wynegar,New York Yankees,YANKS,2,2,4,6,1986,1992,6,No,0,6.03,0.09,-5.94,415,42,-373,167,0,-167,1440.0,174.0,-1266.0,733333.0,0.0,-733333.0
<a href=/player/wynnb102>wynnb102</a>,Billy Wynne,New York Mets,METS,2,5,4,9,1967,1974,7,No,0,2.47,11.88,9.41,357,948,591,832,3426,2594,1066.0,0.0,-1066.0,89000.0,0.0,-89000.0
<a href=/player/wynnb102>wynnb102</a>,Billy Wynne,Chicago White Sox,WSOX,8,16,13,29,1970,1985,15,No,1,24.79,26.84,2.05,2093,1635,-458,4791,5459,668,4811.0,2182.0,-2629.0,87700.0,0.0,-87700.0
<a href=/player/wynne101>wynne101</a>,Early Wynn,Washington Senators,TWINS,13,25,27,52,1948,1963,15,No,0,65.65,20.21,-45.44,3128,2926,-202,8413,6562,-1851,9264.0,7302.0,-1962.0,32000.0,0.0,-32000.0
<a href=/player/wynne101>wynne101</a>,Early Wynn,Cleveland Indians,INDINS,8,14,14,28,1957,1968,11,No,0,114.78,28.23,-86.55,4690,1762,-2928,15896,6646,-9250,7534.0,133.0,-7401.0,15000.0,0.0,-15000.0
<a href=/player/wynnj101>wynnj101</a>,Jim Wynn,Houston Astros,ASTROS,4,4,6,10,1973,1979,6,No,0,12.44,0.12,-12.32,338,148,-190,1224,113,-1111,349.0,1017.0,668.0,100000.0,0.0,-100000.0
<a href=/player/wynnj101>wynnj101</a>,Jim Wynn,Los Angeles Dodgers,DOGRS,1,4,2,6,1975,1984,9,No,0,-0.88,19.14,20.02,1504,1261,-243,5163,4749,-414,0.0,0.0,0.0,0.0,0.0,0.0
<a href=/player/wynnm001>wynnm001</a>,Marvell Wynne,Kansas City Royals,ROYALS,1,2,1,3,1981,1981,0,No,0,0.0,-1.23,-1.23,0,8,8,0,0,0,0.0,59.0,59.0,0.0,0.0,0.0
<a href=/player/wynnm001>wynnm001</a>,Marvell Wynne,New York Mets,METS,1,2,2,4,1983,1984,1,No,0,-1.75,-1.63,0.12,360,108,-252,1480,288,-1192,0.0,0.0,0.0,0.0,0.0,0.0
<a href=/player/wynnm001>wynnm001</a>,Marvell Wynne,Pittsburgh Pirates,PIRATS,1,1,1,2,1986,1992,6,No,0,0.09,1.19,1.1,468,414,-54,1204,60,-1144,0.0,993.0,993.0,0.0,0.0,0.0
<a href=/player/wynnm001>wynnm001</a>,Marvell Wynne,San Diego Padres,PADRS,18,35,37,72,1989,2010,21,No,6,17.39,61.98,44.59,4199,5322,1123,14254,17973,3719,1244.0,2171.0,927.0,26139800.0,0.0,-26139800.0
<a href=/player/wyroj101>wyroj101</a>,Johnny Wyrostek,Pittsburgh Pirates,PIRATS,2,6,4,10,1943,1950,7,No,0,26.56,10.14,-16.42,1156,549,-607,3340,925,-2415,3832.0,2198.0,-1634.0,0.0,0.0,0.0
<a href=/player/wyroj101>wyroj101</a>,Johnny Wyrostek,Philadelphia Phillies,PHILS,1,2,1,3,1948,1950,2,No,0,7.24,0.5,-6.74,573,215,-358,2394,797,-1597,0.0,0.0,0.0,0.0,0.0,0.0
<a href=/player/wyroj101>wyroj101</a>,Johnny Wyrostek,Cincinnati Reds,REDS,3,4,4,8,1952,1958,6,No,0,0.93,3.9,2.97,451,195,-256,1172,136,-1036,552.0,1210.0,658.0,0.0,0.0,0.0
<a href=/player/yajum001>yajum001</a>,Miguel Yajure,New York Yankees,YANKS,1,4,1,5,2021,2021,0,Yes,0,-0.2,2.23,2.43,9,31,22,3,2,-1,54.0,433.0,379.0,0.0,0.0,0.0
<a href=/player/yamaj001>yamaj001</a>,Jordan Yamamoto,Milwaukee Brewers,BREWRS,1,4,1,5,2018,2018,0,Yes,0,-6.06,7.26,13.32,541,147,-394,1645,651,-994,270.0,0.0,-270.0,0.0,0.0,0.0
<a href=/player/yamaj001>yamaj001</a>,Jordan Yamamoto,Miami Marlins,MARLNS,1,1,1,2,2021,2021,0,Yes,0,-0.17,0.0,0.17,4,0,-4,2,0,-2,20.0,0.0,-20.0,0.0,0.0,0.0
<a href=/player/yan-e001>yan-e001</a>,Esteban Yan,Atlanta Braves,BRAVES,6,12,9,21,1995,2005,10,No,2,61.82,22.45,-39.37,2272,974,-1298,4447,2820,-1627,9346.0,423.0,-8923.0,4543000.0,0.0,-4543000.0
<a href=/player/yan-e001>yan-e001</a>,Esteban Yan,Texas Rangers,RNGRS,1,1,1,2,2003,2003,0,No,0,-0.49,0.0,0.49,74,0,-74,1,0,-1,130.0,0.0,-130.0,1500000.0,0.0,-1500000.0
<a href=/player/yan-e001>yan-e001</a>,Esteban Yan,Anaheim Angels,ANGELS,1,2,1,3,2006,2006,0,No,0,0.23,0.0,-0.23,28,0,-28,0,0,0,45.0,0.0,-45.0,1250000.0,0.0,-1250000.0
<a href=/player/yanch101>yanch101</a>,Hugh Yancy,Chicago White Sox,WSOX,1,1,1,2,1976,1978,2,No,0,0.0,-0.61,-0.61,0,29,29,0,67,67,0.0,0.0,0.0,0.0,0.0,0.0
<a href=/player/yantg101>yantg101</a>,George Yantz,Cleveland Indians,INDINS,1,6,1,7,1913,1914,1,No,0,0.0,-0.98,-0.98,0,48,48,0,37,37,0.0,303.0,303.0,0.0,0.0,0.0
<a href=/player/yarbr001>yarbr001</a>,Ryan Yarbrough,Seattle Mariners,MARNRS,1,3,1,4,2017,2017,0,No,0,6.86,0.0,-6.86,335,0,-335,833,0,-833,1499.0,0.0,-1499.0,0.0,0.0,0.0
<a href=/player/yarne001>yarne001</a>,Ed Yarnall,New York Mets,METS,1,3,1,4,1998,2005,7,No,0,6.18,24.6,18.42,588,972,384,2350,3941,1591,0.0,0.0,0.0,0.0,0.0,0.0
<a href=/player/yarne001>yarne001</a>,Ed Yarnall,Florida Marlins,MARLNS,8,17,20,37,1999,2019,20,Yes,0,61.77,64.47,2.7,1848,3278,1430,4569,10868,6299,8696.0,5082.0,-3614.0,29867000.0,0.0,-29867000.0
<a href=/player/yarne001>yarne001</a>,Ed Yarnall,New York Yankees,YANKS,4,12,6,18,2000,2007,7,No,2,5.36,3.85,-1.51,689,111,-578,203,14,-189,3035.0,1602.0,-1433.0,4387150.0,0.0,-4387150.0
<a href=/player/yarrr101>yarrr101</a>,Rube Yarrison,Brooklyn Dodgers,DOGRS,1,1,1,2,1924,1924,0,No,0,0.0,0.0,0.0,0,0,0,0,0,0,0.0,0.0,0.0,4500.0,0.0,-4500.0
<a href=/player/yastm001>yastm001</a>,Mike Yastrzemski,Baltimore Orioles,ORLS,1,1,1,2,2019,2019,0,Yes,0,7.67,0.0,-7.67,300,0,-300,1168,0,-1168,0.0,0.0,0.0,0.0,0.0,0.0
<a href=/player/yatea101>yatea101</a>,Al Yates,New York Mets,METS,1,2,1,3,1967,1968,1,No,0,0.0,-0.1,-0.1,0,16,16,0,8,8,0.0,79.0,79.0,0.0,0.0,0.0
<a href=/player/yatea101>yatea101</a>,Al Yates,Boston Red Sox,RSOX,1,1,1,2,1970,1974,4,No,0,0.09,2.98,2.89,24,197,173,52,15,-37,0.0,485.0,485.0,0.0,0.0,0.0
<a href=/player/yatet001>yatet001</a>,Tyler Yates,Oakland Athletics,ATLTCS,1,2,1,3,2001,2001,0,No,0,0.66,0.0,-0.66,175,0,-175,14,0,-14,284.0,0.0,-284.0,1800000.0,0.0,-1800000.0
<a href=/player/yatet001>yatet001</a>,Tyler Yates,Atlanta Braves,BRAVES,2,2,2,4,2008,2013,5,No,0,-0.69,-0.57,0.12,174,107,-67,1,231,230,266.0,0.0,-266.0,0.0,0.0,0.0
<a href=/player/yde-e101>yde-e101</a>,Emil Yde,OklahomaCity,OklahomaCity,1,1,1,2,1923,1924,1,No,0,3.69,0.0,-3.69,275,0,-275,284,0,-284,1850.0,0.0,-1850.0,0.0,0.0,0.0
<a href=/player/yde-e101>yde-e101</a>,Emil Yde,Pittsburgh Pirates,PIRATS,1,2,1,3,1927,1927,0,No,0,0.0,0.0,0.0,0,0,0,0,0,0,0.0,0.0,0.0,11200.0,0.0,-11200.0
<a href=/player/yeagj101>yeagj101</a>,Joe Yeager,New York Yankees,YANKS,1,1,1,2,1907,1907,0,No,0,2.92,-1.04,-3.96,133,52,-81,497,153,-344,0.0,0.0,0.0,0.0,0.0,0.0
<a href=/player/yeags001>yeags001</a>,Steve Yeager,Los Angeles Dodgers,DOGRS,1,1,1,2,1985,1986,1,No,0,-0.02,0.6,0.62,50,120,70,146,1,-145,0.0,214.0,214.0,500000.0,0.0,-500000.0
<a href=/player/yeara101>yeara101</a>,Al Yeargin,Boston Braves,BRAVES,15,35,27,62,1924,1952,28,No,0,61.82,121.75,59.93,3287,6434,3147,11058,21686,10628,3053.0,10767.0,7714.0,56700.0,0.0,-56700.0
<a href=/player/yelde001>yelde001</a>,Eric Yelding,Houston Astros,ASTROS,1,1,1,2,1992,1993,1,No,0,0.0,-0.18,-0.18,0,14,14,0,1,1,0.0,36.0,36.0,0.0,0.0,0.0
<a href=/player/yelic001>yelic001</a>,Christian Yelich,Miami Marlins,MARLNS,2,2,5,7,2018,2021,3,Yes,0,15.72,-1.3,-17.02,456,144,-312,1955,432,-1523,20.0,270.0,250.0,0.0,0.0,0.0
<a href=/player/yellc101>yellc101</a>,Chief Yellow Horse,Pittsburgh Pirates,PIRATS,1,5,1,6,1922,1922,0,No,0,0.0,0.0,0.0,0,0,0,0,0,0,0.0,0.0,0.0,2700.0,0.0,-2700.0
<a href=/player/yerkc101>yerkc101</a>,Carroll Yerkes,Philadelphia Athletics,ATLTCS,1,4,2,6,1929,1936,7,No,0,0.0,5.27,5.27,0,394,394,0,395,395,0.0,2946.0,2946.0,7500.0,0.0,-7500.0
<a href=/player/yettr001>yettr001</a>,Rich Yett,Minnesota Twins,TWINS,4,9,7,16,1985,1995,10,No,0,10.17,8.8,-1.37,960,260,-700,2169,213,-1956,3138.0,2882.0,-256.0,1000000.0,0.0,-1000000.0
<a href=/player/ynoah001>ynoah001</a>,Huascar Ynoa,Minnesota Twins,TWINS,2,2,5,7,2017,2020,3,No,0,1.55,0.11,-1.44,58,49,-9,34,2,-32,459.0,223.0,-236.0,0.0,0.0,0.0
<a href=/player/ynoam001>ynoam001</a>,Michael Ynoa,Oakland Athletics,ATLTCS,1,2,4,6,2014,2020,6,Yes,0,0.52,22.61,22.09,80,1074,994,2,4228,4226,819.0,2.0,-817.0,5345000.0,0.0,-5345000.0
<a href=/player/yorkj101>yorkj101</a>,Jim York,Kansas City Royals,ROYALS,1,2,2,4,1971,1978,7,No,0,-0.79,21.38,22.17,228,897,669,24,3753,3729,523.0,0.0,-523.0,25250.0,0.0,-25250.0
<a href=/player/yorkl101>yorkl101</a>,Lefty York,Chicago Cubs,CUBS,2,4,2,6,1922,1935,13,No,0,1.8,38.34,36.54,269,1621,1352,1048,7164,6116,0.0,0.0,0.0,15500.0,0.0,-15500.0
<a href=/player/yorkm001>yorkm001</a>,Mike York,Pittsburgh Pirates,PIRATS,2,2,2,4,1991,1991,0,No,0,-0.69,-1.09,-0.4,431,52,-379,736,129,-607,104.0,0.0,-104.0,0.0,0.0,0.0
<a href=/player/yorkr101>yorkr101</a>,Rudy York,Detroit Tigers,TIGRS,1,1,1,2,1946,1951,5,No,0,1.88,4.16,2.28,202,491,289,875,2016,1141,0.0,0.0,0.0,0.0,0.0,0.0
<a href=/player/yorkr101>yorkr101</a>,Rudy York,Boston Red Sox,RSOX,1,1,1,2,1947,1947,0,No,0,0.58,0.13,-0.45,102,109,7,438,451,13,0.0,0.0,0.0,0.0,0.0,0.0
<a href=/player/yorkt102>yorkt102</a>,Tony York,Boston Braves,BRAVES,6,10,11,21,1946,1966,20,No,0,4.65,47.8,43.15,447,2538,2091,1596,8887,7291,15.0,0.0,-15.0,0.0,0.0,0.0
<a href=/player/yoshm001>yoshm001</a>,Masato Yoshii,New York Mets,METS,2,4,4,8,2000,2003,3,No,0,1.23,0.94,-0.29,67,107,40,77,11,-66,531.0,263.0,-268.0,0.0,0.0,0.0
<a href=/player/yoste001>yoste001</a>,Ned Yost,Milwaukee Brewers,BREWRS,4,6,7,13,1983,1991,8,No,0,21.39,21.5,0.11,1530,927,-603,1542,2353,811,4939.0,4297.0,-642.0,700000.0,0.0,-700000.0
<a href=/player/yoste101>yoste101</a>,Eddie Yost,Washington Senators,TWINS,5,10,8,18,1958,1963,5,No,0,7.52,-2.19,-9.71,769,798,29,2600,2634,34,5.0,80.0,75.0,9500.0,0.0,-9500.0
<a href=/player/yotee101>yotee101</a>,Elmer Yoter,Indianapolis,Indianapolis,1,1,2,3,1927,1928,1,No,0,0.14,0.0,-0.14,14,0,-14,31,0,-31,0.0,0.0,0.0,0.0,0.0,0.0
<a href=/player/youkk001>youkk001</a>,Kevin Youkilis,Boston Red Sox,RSOX,3,4,4,8,2012,2013,1,No,0,1.33,-1.09,-2.42,123,19,-104,467,16,-451,0.0,51.0,51.0,981500.0,0.0,-981500.0
<a href=/player/youmf001>youmf001</a>,Floyd Youmans,New York Mets,METS,1,4,1,5,1984,1989,5,No,0,17.64,11.38,-6.26,1847,600,-1247,5919,2448,-3471,1489.0,0.0,-1489.0,356000.0,0.0,-356000.0
<a href=/player/youmf001>youmf001</a>,Floyd Youmans,Montreal Expos,NATEX,3,5,3,8,1988,1994,6,No,1,-0.06,0.65,0.71,294,172,-122,31,225,194,762.0,1094.0,332.0,250000.0,0.0,-250000.0
<a href=/player/youna001>youna001</a>,Anthony Young,New York Mets,METS,2,4,3,7,1994,1998,4,No,0,2.23,3.48,1.25,191,688,497,349,2703,2354,468.0,0.0,-468.0,4160000.0,0.0,-4160000.0
<a href=/player/youna003>youna003</a>,Andy Young,St. Louis Cardinals,CARDS,1,4,1,5,2018,2018,0,Yes,0,4.82,0.0,-4.82,382,0,-382,1034,0,-1034,549.0,0.0,-549.0,550800.0,0.0,-550800.0
<a href=/player/younb101>younb101</a>,Bobby Young,St. Louis Cardinals,CARDS,1,1,1,2,1949,1949,0,No,0,-1.88,0.0,1.88,633,0,-633,2603,0,-2603,0.0,0.0,0.0,0.0,0.0,0.0
<a href=/player/younb101>younb101</a>,Bobby Young,Baltimore Orioles,ORLS,1,1,1,2,1955,1955,0,No,0,0.18,-0.41,-0.59,19,16,-3,47,43,-4,0.0,0.0,0.0,0.0,0.0,0.0
<a href=/player/younb102>younb102</a>,Babe Young,New York Giants,GIANTS,1,1,1,2,1947,1948,1,No,0,1.92,-0.03,-1.95,144,66,-78,554,15,-539,0.0,199.0,199.0,0.0,0.0,0.0
<a href=/player/younb102>younb102</a>,Babe Young,Cincinnati Reds,REDS,1,1,1,2,1948,1948,0,No,0,-0.22,-0.47,-0.25,41,32,-9,127,11,-116,0.0,122.0,122.0,0.0,0.0,0.0
<a href=/player/younc002>younc002</a>,Cliff Young,Montreal Expos,NATEX,4,6,6,12,1985,2001,16,No,0,10.34,22.69,12.35,993,1451,458,2591,3729,1138,539.0,722.0,183.0,837500.0,0.0,-837500.0
<a href=/player/younc002>younc002</a>,Cliff Young,Toronto Blue Jays,BJAYS,1,1,1,2,1989,1989,0,No,0,0.42,-0.3,-0.72,28,7,-21,0,0,0,130.0,51.0,-79.0,0.0,0.0,0.0
<a href=/player/younc003>younc003</a>,Chris Young,Pittsburgh Pirates,PIRATS,1,2,1,3,2002,2003,1,No,0,0.0,0.0,0.0,0,0,0,0,0,0,0.0,0.0,0.0,0.0,0.0,0.0
<a href=/player/younc003>younc003</a>,Chris Young,Montreal Expos,NATEX,1,2,2,4,2004,2004,0,No,0,3.6,-0.83,-4.43,40,55,15,5,159,154,603.0,0.0,-603.0,0.0,0.0,0.0
<a href=/player/younc003>younc003</a>,Chris Young,Texas Rangers,RNGRS,1,3,3,6,2006,2007,1,No,0,28.55,3.75,-24.8,1126,114,-1012,3924,0,-3924,1652.0,471.0,-1181.0,0.0,0.0,0.0
<a href=/player/younc004>younc004</a>,Chris Young,Chicago White Sox,WSOX,3,7,7,14,2005,2015,10,No,0,21.04,18.91,-2.13,1161,870,-291,3709,2249,-1460,1060.0,1883.0,823.0,16705000.0,0.0,-16705000.0
<a href=/player/younc004>younc004</a>,Chris Young,Arizona Diamondbacks,DBACKS,4,10,7,17,2012,2017,5,Yes,0,-2.7,5.27,7.97,277,431,154,890,914,24,52.0,197.0,145.0,19275000.0,0.0,-19275000.0
<a href=/player/younc102>younc102</a>,Cy Young,Boston Red Sox,RSOX,3,7,7,14,1909,1913,4,No,0,5.53,13.46,7.93,126,735,609,191,757,566,1513.0,5050.0,3537.0,0.0,0.0,0.0
<a href=/player/yound001>yound001</a>,Dmitri Young,St. Louis Cardinals,CARDS,2,4,3,7,1997,1999,2,No,0,9.56,-0.59,-10.15,1040,227,-813,3190,4,-3186,549.0,372.0,-177.0,8625000.0,0.0,-8625000.0
<a href=/player/yound001>yound001</a>,Dmitri Young,Tampa Bay Devil Rays,RAYS,1,1,1,2,1997,1999,2,No,0,5.59,-0.19,-5.78,565,106,-459,2178,303,-1875,0.0,0.0,0.0,0.0,0.0,0.0
<a href=/player/yound001>yound001</a>,Dmitri Young,Cincinnati Reds,REDS,2,4,3,7,2001,2003,2,No,0,8.28,-1.1,-9.38,902,211,-691,3664,427,-3237,0.0,710.0,710.0,5900000.0,0.0,-5900000.0
<a href=/player/yound003>yound003</a>,Delmon Young,Tampa Bay Devil Rays,RAYS,6,10,18,28,2007,2018,11,Yes,0,7.31,39.77,32.46,1554,1744,190,4454,3404,-1050,1936.0,6404.0,4468.0,6476100.0,0.0,-6476100.0
<a href=/player/yound003>yound003</a>,Delmon Young,Minnesota Twins,TWINS,1,1,2,3,2011,2015,4,No,0,-0.57,0.02,0.59,191,18,-173,786,0,-786,0.0,64.0,64.0,5375000.0,0.0,-5375000.0
<a href=/player/yound004>yound004</a>,Delwyn Young,Los Angeles Dodgers,DOGRS,1,1,2,3,2009,2010,1,No,0,-0.88,0.0,0.88,234,0,-234,595,0,-595,0.0,0.0,0.0,0.0,0.0,0.0
<a href=/player/yound101>yound101</a>,Dick Young,Philadelphia Phillies,PHILS,8,13,12,25,1954,1984,30,No,0,31.81,64.58,32.77,1931,3925,1994,6995,10274,3279,0.0,2963.0,2963.0,0.0,0.0,0.0
<a href=/player/yound103>yound103</a>,Don Young,Chicago Cubs,CUBS,1,1,1,2,1970,1970,0,No,0,0.0,-0.82,-0.82,0,52,52,0,9,9,0.0,130.0,130.0,0.0,0.0,0.0
<a href=/player/youne001>youne001</a>,Eric Young,Colorado Rockies,ROCKS,2,3,2,5,1997,2004,7,No,0,5.33,7.43,2.1,281,303,22,1234,358,-876,86.0,2830.0,2744.0,10050000.0,0.0,-10050000.0
<a href=/player/youne001>youne001</a>,Eric Young,Los Angeles Dodgers,DOGRS,6,10,12,22,1999,2013,14,No,2,3.76,16.28,12.52,757,1664,907,2628,3589,961,416.0,2617.0,2201.0,12585000.0,0.0,-12585000.0
<a href=/player/youne001>youne001</a>,Eric Young,Milwaukee Brewers,BREWRS,1,1,1,2,2003,2003,0,No,0,-0.78,0.0,0.78,26,0,-26,82,0,-82,0.0,0.0,0.0,2000000.0,0.0,-2000000.0
<a href=/player/youne003>youne003</a>,Eric Young,Colorado Rockies,ROCKS,1,1,1,2,2013,2013,0,No,0,2.06,-0.62,-2.68,209,8,-201,743,4,-739,0.0,57.0,57.0,492000.0,0.0,-492000.0
<a href=/player/young001>young001</a>,Gerald Young,New York Mets,METS,8,19,15,34,1984,2019,35,No,3,34.57,79.41,44.84,2275,4652,2377,5360,12176,6816,3537.0,3405.0,-132.0,15948000.0,0.0,-15948000.0
<a href=/player/younh103>younh103</a>,Harley Young,Pittsburgh Pirates,PIRATS,1,2,1,3,1908,1909,1,No,0,1.07,0.43,-0.64,57,32,-25,69,31,-38,500.0,269.0,-231.0,1500.0,0.0,-1500.0
<a href=/player/youni101>youni101</a>,Irv Young,Boston Braves,BRAVES,2,2,3,5,1908,1909,1,No,0,0.43,0.35,-0.08,32,65,33,31,78,47,269.0,565.0,296.0,0.0,0.0,0.0
<a href=/player/younj001>younj001</a>,Joel Youngblood,Cincinnati Reds,REDS,2,3,2,5,1977,1981,4,No,0,2.35,3.66,1.31,313,112,-201,98,126,28,1033.0,1005.0,-28.0,85000.0,0.0,-85000.0
<a href=/player/younj001>younj001</a>,Joel Youngblood,St. Louis Cardinals,CARDS,13,30,24,54,1977,1998,21,No,5,92.92,122.2,29.28,7343,5225,-2118,22954,17678,-5276,6532.0,3025.0,-3507.0,1533333.0,0.0,-1533333.0
<a href=/player/younj001>younj001</a>,Joel Youngblood,New York Mets,METS,1,1,1,2,1982,1986,4,No,0,-0.73,0.26,0.99,40,196,156,104,16,-88,0.0,507.0,507.0,366667.0,0.0,-366667.0
<a href=/player/younj101>younj101</a>,John Young,Detroit Tigers,TIGRS,1,1,1,2,1974,1974,0,No,0,0.0,0.0,0.0,0,0,0,0,0,0,0.0,0.0,0.0,0.0,0.0,0.0
<a href=/player/younl101>younl101</a>,Larry Yount,Houston Astros,ASTROS,1,2,1,3,1974,1974,0,No,0,0.0,-0.58,-0.58,0,64,64,0,116,116,0.0,0.0,0.0,0.0,0.0,0.0
<a href=/player/younm001>younm001</a>,Matt Young,Seattle Mariners,MARNRS,1,1,2,3,1986,1990,4,No,0,-0.02,0.16,0.18,94,73,-21,3,0,-3,163.0,303.0,140.0,205000.0,0.0,-205000.0
<a href=/player/younm001>younm001</a>,Matt Young,Los Angeles Dodgers,DOGRS,2,4,4,8,1987,1992,5,No,1,9.39,9.73,0.34,242,1063,821,1,1797,1796,3926.0,1084.0,-2842.0,1187500.0,0.0,-1187500.0
<a href=/player/younm002>younm002</a>,Mike Young,Baltimore Orioles,ORLS,2,4,5,9,1988,1989,1,No,0,0.13,-2.08,-2.21,83,157,74,184,486,302,0.0,0.0,0.0,0.0,0.0,0.0
<a href=/player/younm002>younm002</a>,Mike Young,Philadelphia Phillies,PHILS,1,1,1,2,1988,1988,0,No,0,-0.38,0.43,0.81,8,10,2,18,3,-15,0.0,49.0,49.0,395000.0,0.0,-395000.0
<a href=/player/younm003>younm003</a>,Michael Young,Toronto Blue Jays,BJAYS,1,2,1,3,2000,2002,2,No,0,25.41,3.65,-21.76,1836,80,-1756,8047,8,-8039,53.0,1300.0,1247.0,0.0,0.0,0.0
<a href=/player/younm003>younm003</a>,Michael Young,Texas Rangers,RNGRS,3,6,5,11,2012,2015,3,No,0,0.34,-2.78,-3.12,251,118,-133,826,281,-545,19.0,285.0,266.0,17001100.0,0.0,-17001100.0
<a href=/player/younm003>younm003</a>,Michael Young,Philadelphia Phillies,PHILS,2,4,2,6,2013,2014,1,No,0,0.28,-0.1,-0.38,67,4,-63,137,0,-137,37.0,7.0,-30.0,496000.0,0.0,-496000.0
<a href=/player/younp101>younp101</a>,Pep Young,Pittsburgh Pirates,PIRATS,1,1,1,2,1940,1940,0,No,0,0.0,0.0,0.0,0,0,0,0,0,0,0.0,0.0,0.0,0.0,0.0,0.0
<a href=/player/younp101>younp101</a>,Pep Young,Brooklyn Dodgers,DOGRS,1,1,1,2,1940,1946,6,No,0,-0.08,2.1,2.18,4,148,144,13,423,410,0.0,0.0,0.0,0.0,0.0,0.0
<a href=/player/younr102>younr102</a>,Russ Young,Milwaukee,Milwaukee,1,1,4,5,1930,1931,1,No,0,-0.31,0.0,0.31,16,0,-16,36,0,-36,0.0,0.0,0.0,0.0,0.0,0.0
<a href=/player/younr103>younr103</a>,Ralph Young,Sacramento,Sacramento,1,1,1,2,1914,1914,0,No,0,3.49,0.0,-3.49,890,0,-890,3786,0,-3786,0.0,0.0,0.0,0.0,0.0,0.0
<a href=/player/yvars101>yvars101</a>,Sal Yvars,St. Louis Cardinals,CARDS,1,1,1,2,1954,1954,0,No,0,0.0,0.0,0.0,0,0,0,0,0,0,0.0,0.0,0.0,0.0,0.0,0.0
<a href=/player/zabaa101>zabaa101</a>,Adrian Zabala,New York Giants,GIANTS,1,4,1,5,1953,1957,4,No,0,0.0,2.61,2.61,0,252,252,0,49,49,0.0,709.0,709.0,0.0,0.0,0.0
<a href=/player/zabez101>zabez101</a>,Zip Zabel,Brooklyn Dodgers,DOGRS,1,2,1,3,1913,1913,0,No,0,1.78,0.0,-1.78,159,0,-159,149,0,-149,886.0,0.0,-886.0,0.0,0.0,0.0
<a href=/player/zachc101>zachc101</a>,Chris Zachary,Kansas City Royals,ROYALS,1,1,1,2,1970,1973,3,No,0,-1.11,3.97,5.08,47,288,241,33,37,4,269.0,585.0,316.0,0.0,0.0,0.0
<a href=/player/zachc101>zachc101</a>,Chris Zachary,St. Louis Cardinals,CARDS,1,1,1,2,1971,1971,0,No,0,1.46,0.0,-1.46,50,0,-50,3,0,-3,115.0,0.0,-115.0,0.0,0.0,0.0
<a href=/player/zachc101>zachc101</a>,Chris Zachary,Detroit Tigers,TIGRS,3,3,3,6,1973,1973,0,No,0,0.39,0.46,0.07,72,22,-50,148,0,-148,36.0,241.0,205.0,0.0,0.0,0.0
<a href=/player/zachc101>zachc101</a>,Chris Zachary,Pittsburgh Pirates,PIRATS,1,1,1,2,1973,1973,0,No,0,0.0,0.0,0.0,0,0,0,0,0,0,0.0,0.0,0.0,17500.0,0.0,-17500.0
<a href=/player/zachp001>zachp001</a>,Pat Zachry,Cincinnati Reds,REDS,3,6,5,11,1977,1990,13,No,0,13.19,18.54,5.35,1751,636,-1115,5361,1105,-4256,2918.0,3754.0,836.0,450000.0,0.0,-450000.0
<a href=/player/zachp001>zachp001</a>,Pat Zachry,New York Mets,METS,3,4,4,8,1982,1984,2,No,0,-0.9,-1.63,-0.73,659,108,-551,1758,288,-1470,432.0,0.0,-432.0,0.0,0.0,0.0
<a href=/player/zachp001>zachp001</a>,Pat Zachry,Los Angeles Dodgers,DOGRS,2,2,2,4,1985,1985,0,No,0,-0.66,0.15,0.81,81,78,-3,196,161,-35,38.0,0.0,-38.0,750000.0,0.0,-750000.0
<a href=/player/zacht101>zacht101</a>,Tom Zachary,Washington Senators,TWINS,1,2,2,4,1926,1926,0,No,0,4.68,-1.0,-5.68,222,56,-166,205,69,-136,1704.0,214.0,-1490.0,0.0,0.0,0.0
<a href=/player/zacht101>zacht101</a>,Tom Zachary,St.Louis Browns,ORLS,22,41,50,91,1927,1952,25,No,0,133.07,120.47,-12.6,6485,9318,2833,21218,29687,8469,12714.0,17495.0,4781.0,217500.0,0.0,-217500.0
<a href=/player/zagum001>zagum001</a>,Mike Zagurski,Philadelphia Phillies,PHILS,1,1,1,2,2011,2011,0,No,0,-0.41,0.0,0.41,88,0,-88,0,0,0,112.0,0.0,-112.0,0.0,0.0,0.0
<a href=/player/zahng001>zahng001</a>,Geoff Zahn,Los Angeles Dodgers,DOGRS,5,9,7,16,1975,1992,17,No,2,9.7,35.66,25.96,449,1802,1353,26,2476,2450,4776.0,6831.0,2055.0,1249500.0,0.0,-1249500.0
<a href=/player/zahnp101>zahnp101</a>,Paul Zahniser,Washington Senators,TWINS,1,2,1,3,1925,1927,2,No,0,1.68,5.81,4.13,272,192,-80,587,672,85,1044.0,0.0,-1044.0,3600.0,0.0,-3600.0
<a href=/player/zahnp101>zahnp101</a>,Paul Zahniser,StPaul,StPaul,2,2,4,6,1928,1930,2,No,0,-0.07,0.0,0.07,47,0,-47,121,0,-121,3.0,0.0,-3.0,0.0,0.0,0.0
<a href=/player/zahnp101>zahnp101</a>,Paul Zahniser,Boston Red Sox,RSOX,1,4,2,6,1926,1926,0,No,0,0.0,0.0,0.0,0,0,0,0,0,0,0.0,0.0,0.0,15750.0,0.0,-15750.0
<a href=/player/zaluj101>zaluj101</a>,Jack Zalusky,New York Yankees,YANKS,1,2,1,3,1904,1910,6,No,0,0.0,5.04,5.04,0,522,522,0,1684,1684,0.0,0.0,0.0,0.0,0.0,0.0
<a href=/player/zambc001>zambc001</a>,Carlos Zambrano,Chicago Cubs,CUBS,1,2,1,3,2012,2012,0,No,0,0.72,-1.46,-2.18,67,42,-25,36,34,-2,397.0,334.0,-63.0,0.0,0.0,0.0
<a href=/player/zambv001>zambv001</a>,Victor Zambrano,Tampa Bay Devil Rays,RAYS,9,12,17,29,2004,2020,16,Yes,0,1.53,40.6,39.07,1161,1574,413,1626,3513,1887,2118.0,4281.0,2163.0,9958000.0,0.0,-9958000.0
<a href=/player/zamod001>zamod001</a>,Daniel Zamora,Pittsburgh Pirates,PIRATS,1,2,1,3,2018,2018,0,No,0,0.3,-0.37,-0.67,65,13,-52,0,0,0,53.0,17.0,-36.0,0.0,0.0,0.0
<a href=/player/zannd101>zannd101</a>,Dom Zanni,San Francisco Giants,GIANTS,1,4,2,6,1961,1964,3,No,0,7.93,4.13,-3.8,685,341,-344,242,140,-102,2569.0,1260.0,-1309.0,0.0,0.0,0.0
<a href=/player/zannd101>zannd101</a>,Dom Zanni,Chicago White Sox,WSOX,1,1,1,2,1963,1964,1,No,0,0.85,1.23,0.38,88,90,2,5,13,8,191.0,219.0,28.0,0.0,0.0,0.0
<a href=/player/zapuj101>zapuj101</a>,Joe Zapustas,Philadelphia Athletics,ATLTCS,2,4,2,6,1933,1934,1,No,0,0.0,0.0,0.0,0,0,0,0,0,0,0.0,0.0,0.0,0.0,0.0,0.0
<a href=/player/zaria101>zaria101</a>,Al Zarilla,St.Louis Browns,ORLS,1,1,2,3,1949,1949,0,No,0,2.81,0.33,-2.48,332,104,-228,1231,376,-855,0.0,0.0,0.0,14500.0,0.0,-14500.0
<a href=/player/zaria101>zaria101</a>,Al Zarilla,Boston Red Sox,RSOX,3,9,8,17,1950,1956,6,No,0,14.02,9.79,-4.23,1662,1085,-577,5506,3192,-2314,1880.0,1611.0,-269.0,111000.0,0.0,-111000.0
<a href=/player/zaria101>zaria101</a>,Al Zarilla,Chicago White Sox,WSOX,2,3,3,6,1952,1954,2,No,0,-0.05,0.64,0.69,740,156,-584,2104,332,-1772,0.0,0.0,0.0,20000.0,0.0,-20000.0
<a href=/player/zaskj001>zaskj001</a>,Jeff Zaske,Pittsburgh Pirates,PIRATS,2,2,2,4,1986,1990,4,No,0,0.14,-0.49,-0.63,20,106,86,2,42,40,61.0,441.0,380.0,150000.0,0.0,-150000.0
<a href=/player/zaucn101>zaucn101</a>,Norm Zauchin,Boston Red Sox,RSOX,2,3,2,5,1958,1962,4,No,0,0.48,20.28,19.8,432,732,300,1643,3004,1361,0.0,0.0,0.0,0.0,0.0,0.0
<a href=/player/zaung001>zaung001</a>,Gregg Zaun,Baltimore Orioles,ORLS,1,1,1,2,1996,1998,2,No,0,0.01,0.38,0.37,174,95,-79,545,0,-545,0.0,307.0,307.0,140000.0,0.0,-140000.0
<a href=/player/zaung001>zaung001</a>,Gregg Zaun,Texas Rangers,RNGRS,6,16,16,32,1999,2013,14,No,4,10.07,37.12,27.05,1336,2425,1089,3189,7223,4034,1798.0,1911.0,113.0,18360260.0,0.0,-18360260.0
<a href=/player/zaung001>zaung001</a>,Gregg Zaun,Baltimore Orioles,ORLS,1,1,1,2,2009,2011,2,No,0,0.33,-0.13,-0.46,34,14,-20,99,51,-48,0.0,0.0,0.0,1500000.0,0.0,-1500000.0
<a href=/player/zdebj101>zdebj101</a>,Joe Zdeb,Kansas City Royals,ROYALS,1,1,1,2,1980,1980,0,No,0,0.0,0.0,0.0,0,0,0,0,0,0,0.0,0.0,0.0,0.0,0.0,0.0
<a href=/player/zeidj001>zeidj001</a>,Josh Zeid,Philadelphia Phillies,PHILS,2,5,5,10,2011,2018,7,No,0,10.84,2.57,-8.27,1005,441,-564,3635,1629,-2006,674.0,0.0,-674.0,10400000.0,0.0,-10400000.0
<a href=/player/zeidr101>zeidr101</a>,Rollie Zeider,Chicago White Sox,WSOX,1,2,1,3,1913,1914,1,No,0,-0.81,2.78,3.59,83,160,77,319,648,329,0.0,0.0,0.0,0.0,0.0,0.0
<a href=/player/zeilt001>zeilt001</a>,Todd Zeile,St. Louis Cardinals,CARDS,1,2,3,5,1995,1996,1,No,0,-1.32,0.22,1.54,79,70,-9,325,79,-246,0.0,629.0,629.0,3700000.0,0.0,-3700000.0
<a href=/player/zeilt001>zeilt001</a>,Todd Zeile,Philadelphia Phillies,PHILS,4,6,7,13,1996,2002,6,No,0,5.3,4.73,-0.57,557,658,101,602,1100,498,2055.0,1429.0,-626.0,10946667.0,0.0,-10946667.0
<a href=/player/zeilt001>zeilt001</a>,Todd Zeile,Los Angeles Dodgers,DOGRS,9,17,19,36,1998,2017,19,No,0,17.97,55.2,37.23,1483,3217,1734,4788,11288,6500,1883.0,2450.0,567.0,29893334.0,0.0,-29893334.0
<a href=/player/zeilt001>zeilt001</a>,Todd Zeile,Florida Marlins,MARLNS,1,1,2,3,1998,1998,0,No,0,3.05,0.0,-3.05,208,0,-208,869,0,-869,0.0,0.0,0.0,0.0,0.0,0.0
<a href=/player/zeilt001>zeilt001</a>,Todd Zeile,New York Mets,METS,11,24,26,50,2002,2021,19,Yes,0,23.06,23.68,0.62,980,1702,722,2021,4506,2485,5255.0,3554.0,-1701.0,30731467.0,0.0,-30731467.0
<a href=/player/zellb101>zellb101</a>,Bart Zeller,Milwaukee Brewers,BREWRS,3,4,4,8,1971,1973,2,No,0,-0.12,-0.77,-0.65,3,126,123,9,406,397,0.0,22.0,22.0,18000.0,0.0,-18000.0
<a href=/player/zeppb101>zeppb101</a>,Bill Zepp,Minnesota Twins,TWINS,2,2,3,5,1971,1974,3,No,0,-0.75,0.24,0.99,59,58,-1,44,90,46,95.0,0.0,-95.0,0.0,0.0,0.0
<a href=/player/zerng101>zerng101</a>,Gus Zernial,Chicago White Sox,WSOX,37,70,65,135,1951,1971,20,No,0,135.72,175.24,39.52,11342,10596,-746,33371,28350,-5021,13927.0,15729.0,1802.0,374250.0,0.0,-374250.0
<a href=/player/zerng101>zerng101</a>,Gus Zernial,Kansas City Athletics,ATLTCS,31,62,61,123,1957,1976,19,No,0,95.85,56.38,-39.47,9593,6643,-2950,23097,19018,-4079,12004.0,6179.0,-5825.0,476100.0,0.0,-476100.0
<a href=/player/ziegb001>ziegb001</a>,Brad Ziegler,Oakland Athletics,ATLTCS,1,1,2,3,2011,2013,2,No,0,7.21,0.64,-6.57,736,91,-645,7,165,158,1072.0,176.0,-896.0,1250000.0,0.0,-1250000.0
<a href=/player/ziegb001>ziegb001</a>,Brad Ziegler,Arizona Diamondbacks,DBACKS,1,1,2,3,2016,2016,0,Yes,0,0.93,0.0,-0.93,34,0,-34,0,0,0,89.0,0.0,-89.0,0.0,0.0,0.0
<a href=/player/ziegb001>ziegb001</a>,Brad Ziegler,Miami Marlins,MARLNS,1,1,1,2,2018,2018,0,Yes,0,0.01,0.0,-0.01,56,0,-56,0,0,0,65.0,0.0,-65.0,9000000.0,0.0,-9000000.0
<a href=/player/zimmb002>zimmb002</a>,Bruce Zimmermann,Atlanta Braves,BRAVES,1,5,2,7,2018,2020,2,No,0,0.09,0.72,0.63,63,86,23,4,50,46,357.0,484.0,127.0,0.0,0.0,0.0
<a href=/player/zimmb101>zimmb101</a>,Bill Zimmerman,Newark,Newark,1,1,1,2,1915,1915,0,No,0,-0.17,0.0,0.17,22,0,-22,62,0,-62,0.0,0.0,0.0,0.0,0.0,0.0
<a href=/player/zimmb101>zimmb101</a>,Bill Zimmerman,Brooklyn Dodgers,DOGRS,3,8,5,13,1916,1927,11,No,0,6.65,18.0,11.35,787,1605,818,3022,6599,3577,0.0,0.0,0.0,27500.0,0.0,-27500.0
<a href=/player/zimmc101>zimmc101</a>,Chief Zimmer,Louisville Colonels,LS3,1,12,5,17,1899,1900,1,No,0,267.1,0.0,-267.1,7388,0,-7388,29004,0,-29004,7568.0,0.0,-7568.0,4350.0,0.0,-4350.0
<a href=/player/zimmd101>zimmd101</a>,Don Zimmer,Los Angeles Dodgers,DOGRS,2,4,6,10,1960,1968,8,No,0,9.89,15.02,5.13,1184,1098,-86,1862,588,-1274,1656.0,2535.0,879.0,122000.0,0.0,-122000.0
<a href=/player/zimmd101>zimmd101</a>,Don Zimmer,New York Mets,METS,1,1,2,3,1962,1962,0,No,0,0.31,-0.97,-1.28,63,74,11,207,120,-87,0.0,61.0,61.0,0.0,0.0,0.0
<a href=/player/zimmd101>zimmd101</a>,Don Zimmer,Cincinnati Reds,REDS,1,1,1,2,1963,1963,0,No,0,0.25,0.0,-0.25,22,0,-22,26,0,-26,0.0,0.0,0.0,0.0,0.0,0.0
<a href=/player/zimmh101>zimmh101</a>,Heinie Zimmerman,Chicago Cubs,CUBS,3,6,5,11,1916,1923,7,No,0,11.54,10.57,-0.97,610,657,47,2316,2253,-63,0.0,807.0,807.0,6500.0,0.0,-6500.0
<a href=/player/zimmj101>zimmj101</a>,Jerry Zimmerman,Cincinnati Reds,REDS,1,1,1,2,1962,1962,0,No,0,-1.16,0.0,1.16,407,0,-407,897,0,-897,0.0,0.0,0.0,0.0,0.0,0.0
<a href=/player/zimmr101>zimmr101</a>,Roy Zimmerman,New York Giants,GIANTS,1,2,2,4,1950,1957,7,No,0,0.0,-0.62,-0.62,0,132,132,0,152,152,0.0,0.0,0.0,0.0,0.0,0.0
<a href=/player/zinng101>zinng101</a>,Guy Zinn,New York Yankees,YANKS,6,15,9,24,1912,1946,34,No,0,28.8,114.46,85.66,1052,3746,2694,1402,10175,8773,7730.0,15194.0,7464.0,42500.0,0.0,-42500.0
<a href=/player/zinta001>zinta001</a>,Alan Zinter,New York Mets,METS,3,3,4,7,1994,1997,3,No,0,-3.03,2.58,5.61,499,315,-184,2022,891,-1131,10.0,148.0,138.0,587500.0,0.0,-587500.0
<a href=/player/zipfb101>zipfb101</a>,Bud Zipfel,Los Angeles Angels,ANGELS,6,9,8,17,1960,1968,8,No,0,-1.84,8.4,10.24,437,851,414,827,2608,1781,443.0,1270.0,827.0,44000.0,0.0,-44000.0
<a href=/player/ziskr101>ziskr101</a>,Richie Zisk,Pittsburgh Pirates,PIRATS,3,7,4,11,1976,1986,10,No,1,2.54,8.92,6.38,174,586,412,599,933,334,146.0,661.0,515.0,0.0,0.0,0.0
<a href=/player/ziskr101>ziskr101</a>,Richie Zisk,Texas Rangers,RNGRS,4,10,10,20,1980,1987,7,No,0,9.35,8.94,-0.41,686,425,-261,1581,631,-950,2721.0,2684.0,-37.0,817500.0,0.0,-817500.0
<a href=/player/zobrb001>zobrb001</a>,Ben Zobrist,Houston Astros,ASTROS,1,2,2,4,2006,2006,0,No,0,34.91,0.23,-34.68,1067,68,-999,4478,261,-4217,29.0,0.0,-29.0,0.0,0.0,0.0
<a href=/player/zobrb001>zobrb001</a>,Ben Zobrist,Tampa Bay Devil Rays,RAYS,3,7,8,15,2015,2020,5,Yes,0,1.14,10.45,9.31,141,997,856,395,3417,3022,283.0,217.0,-66.0,508800.0,0.0,-508800.0
<a href=/player/zobrb001>zobrb001</a>,Ben Zobrist,Oakland Athletics,ATLTCS,3,4,4,8,2015,2016,1,Yes,0,1.77,-2.5,-4.27,107,79,-28,392,193,-199,0.0,153.0,153.0,0.0,0.0,0.0
<a href=/player/zoccp001>zoccp001</a>,Peter Zoccolillo,Chicago Cubs,CUBS,2,3,4,7,2001,2001,0,No,2,-1.88,0.61,2.49,108,56,-52,117,0,-117,715.0,85.0,-630.0,0.0,0.0,0.0
<a href=/player/zolds101>zolds101</a>,Sam Zoldak,Philadelphia Athletics,ATLTCS,4,5,4,9,1944,1953,9,No,0,7.79,8.9,1.11,528,937,409,1124,3595,2471,1511.0,0.0,-1511.0,24000.0,0.0,-24000.0
<a href=/player/zolds101>zolds101</a>,Sam Zoldak,St.Louis Browns,ORLS,1,1,2,3,1948,1952,4,No,0,2.07,2.27,0.2,166,188,22,66,111,45,667.0,1031.0,364.0,10500.0,0.0,-10500.0
<a href=/player/zolds101>zolds101</a>,Sam Zoldak,Cleveland Indians,INDINS,1,3,1,4,1951,1951,0,No,0,2.32,1.96,-0.36,252,108,-144,644,24,-620,610.0,338.0,-272.0,0.0,0.0,0.0
<a href=/player/zoske001>zoske001</a>,Eddie Zosky,Toronto Blue Jays,BJAYS,1,1,1,2,1994,1998,4,No,0,-0.1,0.0,0.1,6,0,-6,5,0,-5,0.0,0.0,0.0,0.0,0.0,0.0
<a href=/player/zubeb101>zubeb101</a>,Bill Zuber,Washington Senators,TWINS,3,4,4,8,1943,1952,9,No,0,6.27,10.3,4.03,428,788,360,1420,1973,553,1073.0,1761.0,688.0,9000.0,0.0,-9000.0
<a href=/player/zunim001>zunim001</a>,Mike Zunino,Seattle Mariners,MARNRS,1,3,2,5,2018,2020,2,Yes,0,3.75,-0.48,-4.23,316,148,-168,979,613,-366,0.0,0.0,0.0,2975000.0,0.0,-2975000.0
<a href=/player/zuvep001>zuvep001</a>,Paul Zuvella,Atlanta Braves,BRAVES,1,2,2,4,1986,1988,2,No,0,2.5,1.46,-1.04,350,271,-79,1144,976,-168,0.0,0.0,0.0,750000.0,0.0,-750000.0
