Player ID,Name,Traded From- Team Name,Traded From- Franchise,Total Transactions,Amount Players Traded Away,Amount Players Traded For,Amount Players Total,Earliest Year,Latest Year,Year Span,total_WAR_out,total_WAR_in,WAR_total,total_G_out,total_G_in,G_total,total_PA_out,total_PA_in,PA_total,total_IP_out,total_IP_in,IP_total,total_salary_out,total_salary_in,salary_total
A.J. Kirby-Jones,A.J. Kirby-Jones,Oakland Athletics,ATLTCS,1,2,2,4,2012,2014,2,8.33,-0.72,-9.05,240,35,-205,210,87,-123,1936.0,0.0,-1936.0,0.0,481000.0,481000.0
A.J. Puckett,A.J. Puckett,Kansas City Royals,ROYALS,1,2,2,4,2017,2017,0,0.0,-1.04,-1.04,0,58,58,0,238,238,0.0,0.0,0.0,0.0,15000000.0,15000000.0
A.J. Wideman,A.J. Wideman,Washington Nationals,NATEX,1,1,1,2,2005,2005,0,0.0,0.0,0.0,0,3,3,0,3,3,0.0,0.0,0.0,0.0,0.0,0.0
AJ Graffanino,AJ Graffanino,Atlanta Braves,BRAVES,1,2,1,3,2020,2021,1,0.0,-0.65,-0.65,0,3,3,0,0,0,0.0,29.0,29.0,0.0,100000.0,100000.0
Aaron Baker,Aaron Baker,Pittsburgh Pirates,PIRATS,1,1,1,2,2011,2011,0,0.0,0.86,0.86,0,28,28,0,113,113,0.0,0.0,0.0,0.0,7250000.0,7250000.0
Aaron Dorlarque,Aaron Dorlarque,Kansas City Royals,ROYALS,2,3,3,6,1995,1997,2,9.23,2.06,-7.17,520,188,-332,2004,744,-1260,0.0,6.0,6.0,6750000.0,2300000.0,-4450000.0
Aaron Kurcz,Aaron Kurcz,Chicago Cubs,CUBS,1,2,1,3,2012,2012,0,-0.21,0.0,0.21,8,0,-8,0,0,0,18.0,0.0,-18.0,0.0,0.0,0.0
Aaron Kurcz,Aaron Kurcz,Boston Red Sox,RSOX,1,2,1,3,2014,2015,1,0.0,0.13,0.13,0,9,9,0,0,0,0.0,33.0,33.0,0.0,515000.0,515000.0
Aaron Pribanic,Aaron Pribanic,Seattle Mariners,MARNRS,2,6,3,9,2009,2011,2,-0.04,2.82,2.86,447,179,-268,1426,514,-912,0.0,332.0,332.0,5822500.0,10600000.0,4777500.0
Abdiel Mendoza,Abdiel Mendoza,Oakland Athletics,ATLTCS,1,2,1,3,2018,2018,0,0.0,-0.06,-0.06,0,6,6,0,0,0,0.0,18.0,18.0,0.0,0.0,0.0
Abe Woody,Abe Woody,Cincinnati Reds,REDS,1,1,1,2,2006,2011,5,0.0,0.0,0.0,0,1,1,0,0,0,0.0,0.0,0.0,0.0,0.0,0.0
Abner Abreu,Abner Abreu,Cleveland Indians,INDINS,1,2,2,4,2011,2011,0,0.0,-0.5,-0.5,0,59,59,0,258,258,0.0,0.0,0.0,0.0,14500000.0,14500000.0
Abrahan Gutierrez,Abrahan Gutierrez,Philadelphia Phillies,PHILS,1,1,1,2,2021,2021,0,0.0,0.0,0.0,0,0,0,0,0,0,0.0,0.0,0.0,0.0,0.0,0.0
Adam Bostick,Adam Bostick,Florida Marlins,MARLNS,2,3,5,8,2006,2009,3,0.88,2.31,1.43,194,420,226,65,1,-64,750.0,584.0,-166.0,737000.0,0.0,-737000.0
Adam Donachie,Adam Donachie,Philadelphia Phillies,PHILS,1,2,1,3,2006,2007,1,0.0,0.0,0.0,0,0,0,0,0,0,0.0,0.0,0.0,0.0,0.0,0.0
Adam Ging,Adam Ging,San Diego Padres,PADRS,7,15,16,31,1986,1992,6,36.08,17.42,-18.66,2233,2005,-228,6347,3857,-2490,2335.0,2895.0,560.0,4783333.0,3737500.0,-1045833.0
Adam Harben,Adam Harben,Minnesota Twins,TWINS,1,1,2,3,2006,2006,0,0.0,-0.1,-0.1,0,16,16,0,54,54,0.0,0.0,0.0,0.0,0.0,0.0
Adam Hill,Adam Hill,New York Mets,METS,2,4,2,6,2019,2019,0,-0.03,-0.49,-0.46,40,34,-6,112,53,-59,7.0,0.0,-7.0,571765.0,0.0,-571765.0
Adam Hill,Adam Hill,Milwaukee Brewers,BREWRS,1,2,1,3,2019,2019,0,0.0,0.0,0.0,0,0,0,0,0,0,0.0,0.0,0.0,0.0,581200.0,581200.0
Adam Morrissey,Adam Morrissey,Chicago Cubs,CUBS,3,5,5,10,2001,2011,10,-0.12,29.15,29.27,358,1400,1042,855,5715,4860,0.0,0.0,0.0,465000.0,5025000.0,4560000.0
Adam Olbrychowski,Adam Olbrychowski,New York Yankees,YANKS,1,1,1,2,2011,2012,1,0.0,0.0,0.0,0,0,0,0,0,0,0.0,0.0,0.0,0.0,0.0,0.0
Adam Robinson,Adam Robinson,Oakland Athletics,ATLTCS,1,1,1,2,1998,1999,1,0.0,1.32,1.32,0,82,82,0,0,0,0.0,316.0,316.0,0.0,0.0,0.0
Adam Seuss,Adam Seuss,Houston Astros,ASTROS,2,2,3,5,2004,2008,4,2.19,7.35,5.16,246,561,315,0,616,616,592.0,626.0,34.0,2100000.0,3011500.0,911500.0
Adam Walker,Adam Walker,Philadelphia Phillies,PHILS,1,2,2,4,2001,2003,2,-0.17,0.2,0.37,24,190,166,21,2,-19,181.0,268.0,87.0,300000.0,5500000.0,5200000.0
Adam Worthington,Adam Worthington,Arizona Diamondbacks,DBACKS,1,1,1,2,2011,2012,1,0.0,-0.41,-0.41,0,88,88,0,0,0,0.0,112.0,112.0,0.0,0.0,0.0
Addison Russ,Addison Russ,Philadelphia Phillies,PHILS,1,1,1,2,2020,2021,1,0.0,0.07,0.07,0,39,39,0,0,0,0.0,113.0,113.0,0.0,0.0,0.0
Adenys Bautista,Adenys Bautista,Cleveland Indians,INDINS,1,1,1,2,2019,2020,1,0.0,-0.16,-0.16,0,25,25,0,81,81,0.0,0.0,0.0,0.0,2475000.0,2475000.0
Admiral Martin,Admiral Martin,Chicago White Sox,WSOX,1,4,1,5,1924,1924,0,0.0,-0.04,-0.04,0,6,6,0,5,5,0.0,0.0,0.0,0.0,0.0,0.0
Adrian Burnside,Adrian Burnside,Los Angeles Dodgers,DOGRS,2,5,2,7,2001,2004,3,0.21,-0.68,-0.89,194,255,61,4,12,8,974.0,483.0,-491.0,4975000.0,6000000.0,1025000.0
Adrian Burnside,Adrian Burnside,Pittsburgh Pirates,PIRATS,2,3,2,5,2002,2006,4,0.18,-0.22,-0.4,49,94,45,110,329,219,63.0,0.0,-63.0,1475000.0,290000.0,-1185000.0
Adrian Myers,Adrian Myers,Texas Rangers,RNGRS,1,1,1,2,1999,1999,0,0.0,0.0,0.0,0,7,7,0,0,0,0.0,52.0,52.0,0.0,5016667.0,5016667.0
Adrian Rivero,Adrian Rivero,Atlanta Braves,BRAVES,1,1,1,2,2014,2014,0,0.0,0.0,0.0,0,0,0,0,0,0,0.0,0.0,0.0,0.0,0.0,0.0
Adrian Rosario,Adrian Rosario,Milwaukee Brewers,BREWRS,2,3,3,6,2011,2015,4,0.39,1.82,1.43,61,261,200,0,1,1,90.0,377.0,287.0,0.0,12166666.0,12166666.0
Aguedo Vasquez,Aguedo Vasquez,Kansas City Royals,ROYALS,1,1,1,2,1989,1990,1,0.0,-0.38,-0.38,0,30,30,0,0,0,0.0,221.0,221.0,0.0,425000.0,425000.0
Al Cardwood,Al Cardwood,Minnesota Twins,TWINS,2,7,4,11,1987,1989,2,2.19,3.46,1.27,550,289,-261,1650,183,-1467,872.0,1114.0,242.0,103500.0,900000.0,796500.0
Al Cardwood,Al Cardwood,Montreal Expos,NATEX,4,6,7,13,1988,1996,8,-0.35,1.55,1.9,76,567,491,0,268,268,1095.0,805.0,-290.0,625000.0,705000.0,80000.0
Al Curtis,Al Curtis,Boston Red Sox,RSOX,2,7,5,12,1955,1963,8,0.69,2.88,2.19,731,424,-307,812,1170,358,1712.0,707.0,-1005.0,7000.0,0.0,-7000.0
Al Pehanick,Al Pehanick,Detroit Tigers,TIGRS,1,1,1,2,1962,1962,0,0.0,0.0,0.0,0,0,0,0,0,0,0.0,0.0,0.0,0.0,0.0,0.0
Al Shirley,Al Shirley,New York Mets,METS,1,1,1,2,1995,1996,1,0.0,-0.13,-0.13,0,70,70,0,113,113,0.0,0.0,0.0,0.0,675000.0,675000.0
Alan Griffin,Alan Griffin,Seattle Mariners,MARNRS,1,2,1,3,1977,1978,1,0.0,-0.35,-0.35,0,42,42,0,118,118,0.0,0.0,0.0,0.0,0.0,0.0
Alan Moye,Alan Moye,Cincinnati Reds,REDS,2,4,5,9,2003,2007,4,0.0,-0.29,-0.29,0,166,166,0,79,79,0.0,223.0,223.0,0.0,0.0,0.0
Alan Walden,Alan Walden,Cleveland Indians,INDINS,1,1,1,2,1992,1993,1,0.0,0.0,0.0,0,0,0,0,0,0,0.0,0.0,0.0,0.0,0.0,0.0
Alan Webb,Alan Webb,Detroit Tigers,TIGRS,1,6,3,9,1999,2004,5,20.76,4.31,-16.45,1380,309,-1071,3548,496,-3052,1196.0,551.0,-645.0,1937500.0,9240000.0,7302500.0
Albert Cartwright,Albert Cartwright,Houston Astros,ASTROS,1,1,1,2,2011,2013,2,0.0,0.45,0.45,0,95,95,0,0,0,0.0,83.0,83.0,0.0,0.0,0.0
Albert Harvin,Albert Harvin,New York Yankees,YANKS,1,5,2,7,1932,1947,15,0.0,15.3,15.3,0,992,992,0,1098,1098,0.0,2971.0,2971.0,0.0,0.0,0.0
Alberto Ciprian,Alberto Ciprian,Milwaukee Brewers,BREWRS,1,2,1,3,2021,2021,0,0.0,0.3,0.3,0,48,48,0,199,199,0.0,0.0,0.0,0.0,7666667.0,7666667.0
Alberto Rodriguez,Alberto Rodriguez,Toronto Blue Jays,BJAYS,1,1,1,2,2020,2020,0,0.0,0.95,0.95,0,6,6,0,0,0,0.0,79.0,79.0,0.0,2000000.0,2000000.0
Alberto Tirado,Alberto Tirado,Toronto Blue Jays,BJAYS,3,6,4,10,2015,2016,1,-0.69,1.54,2.23,124,124,0,375,246,-129,55.0,171.0,116.0,0.0,4100000.0,4100000.0
Aldenis Sanchez,Aldenis Sanchez,Tampa Bay Devil Rays,RAYS,1,2,1,3,2021,2021,0,0.0,0.0,0.0,0,0,0,0,0,0,0.0,0.0,0.0,0.0,0.0,0.0
Aldo Pecorilli,Aldo Pecorilli,St. Louis Cardinals,CARDS,1,1,1,2,1994,1995,1,0.0,-0.54,-0.54,0,34,34,0,110,110,0.0,0.0,0.0,0.0,0.0,0.0
Aldo Ramirez,Aldo Ramirez,Boston Red Sox,RSOX,1,1,1,2,2021,2021,0,0.0,1.33,1.33,0,41,41,0,168,168,0.0,0.0,0.0,0.0,7000000.0,7000000.0
Alec Grosser,Alec Grosser,Atlanta Braves,BRAVES,1,4,2,6,2016,2016,0,-0.57,0.0,0.57,26,0,-26,16,0,-16,128.0,0.0,-128.0,0.0,0.0,0.0
Alec Zumwalt,Alec Zumwalt,Atlanta Braves,BRAVES,2,3,2,5,2004,2006,2,0.58,-1.28,-1.86,271,128,-143,2,1,-1,443.0,173.0,-270.0,3400000.0,1842000.0,-1558000.0
Alejandro Requena,Alejandro Requena,Colorado Rockies,ROCKS,1,3,1,4,2017,2017,0,0.33,0.69,0.36,79,53,-26,2,0,-2,117.0,66.0,-51.0,0.0,6500000.0,6500000.0
Alejandro Solarte,Alejandro Solarte,Toronto Blue Jays,BJAYS,1,2,1,3,2014,2014,0,0.0,0.0,0.0,0,0,0,0,0,0,0.0,0.0,0.0,0.0,0.0,0.0
Alex Call,Alex Call,Chicago White Sox,WSOX,1,1,1,2,2018,2019,1,0.0,-1.03,-1.03,0,67,67,0,251,251,0.0,0.0,0.0,0.0,7000000.0,7000000.0
Alex Cosmidis,Alex Cosmidis,Detroit Tigers,TIGRS,5,9,7,16,1959,1967,8,4.29,0.05,-4.24,724,813,89,2270,1691,-579,122.0,890.0,768.0,38000.0,37000.0,-1000.0
Alex Fernandez,Alex Fernandez,Chicago White Sox,WSOX,3,6,4,10,2002,2004,2,5.66,1.21,-4.45,316,141,-175,1204,435,-769,90.0,416.0,326.0,675000.0,1665000.0,990000.0
Alex Garcia,Alex Garcia,San Diego Padres,PADRS,1,1,1,2,2003,2004,1,0.0,0.04,0.04,0,9,9,0,8,8,0.0,0.0,0.0,0.0,0.0,0.0
Alex Gillingham,Alex Gillingham,Colorado Rockies,ROCKS,1,2,2,4,2012,2014,2,0.0,0.63,0.63,0,153,153,0,1,1,0.0,245.0,245.0,0.0,515500.0,515500.0
Alex McClure,Alex McClure,Kansas City Royals,ROYALS,1,1,1,2,2013,2014,1,0.0,0.0,0.0,0,0,0,0,0,0,0.0,0.0,0.0,0.0,0.0,0.0
Alex Requena,Alex Requena,Cleveland Indians,INDINS,1,1,1,2,2003,2004,1,0.0,-0.13,-0.13,0,12,12,0,0,0,0.0,36.0,36.0,0.0,0.0,0.0
Alex Scherff,Alex Scherff,Boston Red Sox,RSOX,1,1,1,2,2021,2021,0,0.0,0.49,0.49,0,29,29,0,0,0,0.0,75.0,75.0,0.0,2000000.0,2000000.0
Alexander Campos,Alexander Campos,Seattle Mariners,MARNRS,1,2,1,3,2017,2019,2,0.24,-0.47,-0.71,59,180,121,0,711,711,186.0,0.0,-186.0,0.0,537500.0,537500.0
Alexander Canario,Alexander Canario,San Francisco Giants,GIANTS,1,2,1,3,2021,2021,0,0.0,1.09,1.09,0,51,51,0,212,212,0.0,0.0,0.0,0.0,19500000.0,19500000.0
Alexander Ovalles,Alexander Ovalles,Chicago Cubs,CUBS,1,3,2,5,2018,2019,1,-0.39,5.6,5.99,25,74,49,0,71,71,96.0,654.0,558.0,570750.0,0.0,-570750.0
Alexander Ovalles,Alexander Ovalles,Texas Rangers,RNGRS,1,3,3,6,2020,2021,1,0.0,0.0,0.0,0,0,0,0,0,0,0.0,0.0,0.0,0.0,0.0,0.0
Alexander Vizcaino,Alexander Vizcaino,New York Yankees,YANKS,1,2,2,4,2021,2021,0,0.0,0.5,0.5,0,49,49,0,200,200,0.0,0.0,0.0,0.0,16500000.0,16500000.0
Alexis Tapia,Alexis Tapia,Minnesota Twins,TWINS,1,2,1,3,2015,2016,1,0.22,0.73,0.51,11,63,52,0,0,0,69.0,176.0,107.0,0.0,3025000.0,3025000.0
Alfred Paschal,Alfred Paschal,Detroit Tigers,TIGRS,1,2,2,4,1959,1959,0,0.34,0.0,-0.34,101,0,-101,212,0,-212,0.0,0.0,0.0,0.0,0.0,0.0
Alfredo Garcia,Alfredo Garcia,Colorado Rockies,ROCKS,1,1,1,2,2019,2021,2,0.0,0.17,0.17,0,22,22,0,0,0,0.0,34.0,34.0,0.0,555000.0,555000.0
Alfredo Mariscal,Alfredo Mariscal,Chicago White Sox,WSOX,1,1,1,2,1971,1975,4,0.0,-0.56,-0.56,0,6,6,0,1,1,0.0,45.0,45.0,0.0,0.0,0.0
Allen Butler,Allen Butler,New York Yankees,YANKS,2,2,2,4,1998,1999,1,0.0,0.58,0.58,0,36,36,0,0,0,0.0,148.0,148.0,300000.0,185000.0,-115000.0
Allen Edwards,Allen Edwards,Baltimore Orioles,ORLS,2,2,2,4,1982,1983,1,0.0,0.0,0.0,0,0,0,0,0,0,0.0,0.0,0.0,0.0,0.0,0.0
Allen Halley,Allen Halley,Chicago White Sox,WSOX,1,2,2,4,1996,1998,2,-0.91,-1.48,-0.57,26,123,97,0,23,23,210.0,336.0,126.0,0.0,890000.0,890000.0
Allen Herring,Allen Herring,St. Louis Cardinals,CARDS,4,5,4,9,1962,1964,2,0.95,1.57,0.62,172,78,-94,34,5,-29,466.0,176.0,-290.0,0.0,0.0,0.0
Allen Plaster,Allen Plaster,Baltimore Orioles,ORLS,1,2,1,3,1993,1995,2,0.46,5.28,4.82,13,339,326,0,1296,1296,177.0,0.0,-177.0,0.0,0.0,0.0
Alvin McGrew,Alvin McGrew,Cleveland Indians,INDINS,3,4,5,9,1975,1983,8,1.76,7.83,6.07,284,560,276,867,1386,519,202.0,1484.0,1282.0,0.0,0.0,0.0
Alvin Morrow,Alvin Morrow,Milwaukee Brewers,BREWRS,1,1,1,2,2000,2001,1,0.0,0.07,0.07,0,22,22,0,64,64,0.0,0.0,0.0,0.0,0.0,0.0
Amos Lewis,Amos Lewis,Texas Rangers,RNGRS,1,4,4,8,1979,1985,6,12.8,8.35,-4.45,488,521,33,1323,2076,753,918.0,0.0,-918.0,475000.0,133333.0,-341667.0
Amos Lewis,Amos Lewis,New York Yankees,YANKS,1,3,1,4,1979,1981,2,0.0,1.82,1.82,0,95,95,0,304,304,0.0,0.0,0.0,0.0,0.0,0.0
Anderson Espinoza,Anderson Espinoza,Boston Red Sox,RSOX,1,1,1,2,2016,2018,2,0.0,3.84,3.84,0,77,77,0,3,3,0.0,949.0,949.0,0.0,0.0,0.0
Anderson Espinoza,Anderson Espinoza,San Diego Padres,PADRS,1,1,1,2,2021,2021,0,0.0,-0.19,-0.19,0,34,34,0,54,54,0.0,0.0,0.0,0.0,1000000.0,1000000.0
Andre Davis,Andre Davis,Kansas City Royals,ROYALS,1,2,2,4,2017,2017,0,0.0,-1.04,-1.04,0,58,58,0,238,238,0.0,0.0,0.0,0.0,15000000.0,15000000.0
Andre King,Andre King,Atlanta Braves,BRAVES,1,1,1,2,1995,1995,0,0.0,0.4,0.4,0,29,29,0,57,57,0.0,0.0,0.0,0.0,1350000.0,1350000.0
Andre King,Andre King,St. Louis Cardinals,CARDS,2,2,3,5,1995,2000,5,0.0,-0.85,-0.85,0,79,79,0,203,203,0.0,0.0,0.0,210000.0,200000.0,-10000.0
Andre Simpson,Andre Simpson,Chicago White Sox,WSOX,3,9,5,14,2001,2003,2,-3.34,5.16,8.5,321,102,-219,107,7,-100,601.0,942.0,341.0,0.0,0.0,0.0
Andrea Pizziconi,Andrea Pizziconi,Arizona Diamondbacks,DBACKS,1,1,1,2,2011,2011,0,0.0,0.0,0.0,0,0,0,0,0,0,0.0,0.0,0.0,0.0,0.0,0.0
Andreaus Lewis,Andreaus Lewis,Texas Rangers,RNGRS,1,2,1,3,1994,1994,0,0.0,0.29,0.29,0,29,29,0,86,86,0.0,0.0,0.0,0.0,0.0,0.0
Andres Duncan,Andres Duncan,San Francisco Giants,GIANTS,1,3,1,4,1993,1993,0,0.3,-0.08,-0.38,64,10,-54,0,6,6,230.0,51.0,-179.0,109000.0,700000.0,591000.0
Andres Melendez,Andres Melendez,Milwaukee Brewers,BREWRS,1,1,1,2,2019,2019,0,0.0,0.0,0.0,0,0,0,0,0,0,0.0,0.0,0.0,0.0,0.0,0.0
Andres Mesa,Andres Mesa,Seattle Mariners,MARNRS,2,4,3,7,2021,2021,0,0.78,-0.11,-0.89,33,124,91,0,253,253,87.0,184.0,97.0,3500000.0,4000000.0,500000.0
Andrew Baldwin,Andrew Baldwin,Philadelphia Phillies,PHILS,1,2,1,3,2006,2010,4,0.0,4.31,4.31,0,239,239,0,269,269,0.0,2162.0,2162.0,0.0,5500000.0,5500000.0
Andrew Dyes,Andrew Dyes,Toronto Blue Jays,BJAYS,2,2,2,4,1978,1980,2,0.0,0.21,0.21,0,43,43,0,0,0,0.0,173.0,173.0,0.0,0.0,0.0
Andrew Istler,Andrew Istler,Los Angeles Dodgers,DOGRS,1,1,1,2,2018,2018,0,0.0,-0.19,-0.19,0,18,18,0,0,0,0.0,25.0,25.0,0.0,7666666.0,7666666.0
Andrew Lefave,Andrew Lefave,Milwaukee Brewers,BREWRS,1,1,1,2,2007,2007,0,0.0,-0.02,-0.02,0,24,24,0,0,0,0.0,18.0,18.0,0.0,850000.0,850000.0
Andrew Lopez,Andrew Lopez,Tampa Bay Devil Rays,RAYS,1,2,1,3,2007,2009,2,0.0,-0.22,-0.22,0,18,18,0,0,0,0.0,74.0,74.0,0.0,0.0,0.0
Andrew McInvale,Andrew McInvale,Toronto Blue Jays,BJAYS,1,2,3,5,2021,2021,0,-1.03,1.51,2.54,53,88,35,134,140,6,0.0,112.0,112.0,100000.0,9675000.0,9575000.0
Andrew Muhlstock,Andrew Muhlstock,San Francisco Giants,GIANTS,13,28,29,57,1977,1998,21,51.57,71.65,20.08,3606,5145,1539,8805,7807,-998,5201.0,15628.0,10427.0,10487778.0,6966667.0,-3521111.0
Andrew Salvo,Andrew Salvo,Chicago White Sox,WSOX,1,3,2,5,2003,2003,0,-0.24,0.07,0.31,72,67,-5,1,296,295,104.0,0.0,-104.0,0.0,8000000.0,8000000.0
Andrew Shive,Andrew Shive,New York Yankees,YANKS,1,2,2,4,2010,2010,0,0.0,1.48,1.48,0,24,24,0,0,0,0.0,78.0,78.0,0.0,10500000.0,10500000.0
Andrew Slight,Andrew Slight,Chicago White Sox,WSOX,1,2,1,3,1914,1915,1,0.0,0.0,0.0,0,0,0,0,0,0,0.0,0.0,0.0,0.0,0.0,0.0
Andrew Sopko,Andrew Sopko,Los Angeles Dodgers,DOGRS,1,2,2,4,2019,2019,0,0.0,0.72,0.72,0,87,87,0,249,249,0.0,12.0,12.0,0.0,0.0,0.0
Andrew Thurman,Andrew Thurman,Houston Astros,ASTROS,2,4,3,7,2015,2018,3,4.87,5.33,0.46,316,563,247,420,1880,1460,2027.0,215.0,-1812.0,0.0,0.0,0.0
Andruw Monasterio,Andruw Monasterio,Chicago Cubs,CUBS,1,2,1,3,2018,2018,0,0.0,0.51,0.51,0,35,35,0,146,146,0.0,0.0,0.0,0.0,17500000.0,17500000.0
Andruw Monasterio,Andruw Monasterio,Washington Nationals,NATEX,2,6,4,10,2018,2021,3,-0.4,4.3,4.7,134,190,56,433,712,279,140.0,0.0,-140.0,7000000.0,6033333.0,-966667.0
Andy Barb,Andy Barb,Philadelphia Phillies,PHILS,1,2,1,3,2006,2010,4,0.0,4.31,4.31,0,239,239,0,269,269,0.0,2162.0,2162.0,0.0,5500000.0,5500000.0
Andy Bausher,Andy Bausher,Pittsburgh Pirates,PIRATS,1,1,1,2,2000,2001,1,0.0,0.75,0.75,0,22,22,0,27,27,0.0,187.0,187.0,0.0,230000.0,230000.0
Andy Beckerman,Andy Beckerman,New York Mets,METS,2,3,2,5,1994,1997,3,0.02,-0.19,-0.21,4,111,107,0,113,113,42.0,991.0,949.0,3213400.0,3205000.0,-8400.0
Andy Finlay,Andy Finlay,Atlanta Braves,BRAVES,1,3,1,4,1969,1970,1,-0.8,2.26,3.06,142,212,70,403,844,441,0.0,0.0,0.0,0.0,0.0,0.0
Andy Shibilo,Andy Shibilo,San Diego Padres,PADRS,1,2,2,4,2002,2006,4,1.41,0.0,-1.41,227,0,-227,0,0,0,535.0,0.0,-535.0,500000.0,0.0,-500000.0
Andy Shipman,Andy Shipman,Boston Red Sox,RSOX,1,1,1,2,2004,2004,0,0.0,0.01,0.01,0,6,6,0,0,0,0.0,18.0,18.0,0.0,0.0,0.0
Andy Zwirchitz,Andy Zwirchitz,New York Mets,METS,2,4,3,7,1997,1999,2,1.53,1.68,0.15,165,283,118,98,37,-61,946.0,702.0,-244.0,3150000.0,2800000.0,-350000.0
Aneurys Zabala,Aneurys Zabala,Seattle Mariners,MARNRS,2,4,3,7,2017,2018,1,0.01,-0.36,-0.37,6,35,29,0,0,0,56.0,129.0,73.0,0.0,2150000.0,2150000.0
Aneurys Zabala,Aneurys Zabala,Los Angeles Dodgers,DOGRS,2,3,5,8,2018,2021,3,1.46,1.7,0.24,133,258,125,0,6,6,192.0,419.0,227.0,0.0,0.0,0.0
Anfernee Seymour,Anfernee Seymour,Miami Marlins,MARLNS,1,2,1,3,2016,2018,2,0.0,-0.38,-0.38,0,45,45,0,0,0,0.0,42.0,42.0,0.0,0.0,0.0
Angel German,Angel German,Los Angeles Dodgers,DOGRS,1,2,1,3,2017,2017,0,0.11,0.39,0.28,2,48,46,9,0,-9,0.0,60.0,60.0,0.0,5600000.0,5600000.0
Angel Ramirez,Angel Ramirez,Toronto Blue Jays,BJAYS,1,1,2,3,1997,1997,0,0.0,-0.08,-0.08,0,39,39,0,176,176,0.0,0.0,0.0,0.0,870000.0,870000.0
Angelo Burrows,Angelo Burrows,Atlanta Braves,BRAVES,1,2,1,3,2005,2005,0,0.0,-0.14,-0.14,0,24,24,0,40,40,0.0,0.0,0.0,0.0,900000.0,900000.0
Angeudis Santos,Angeudis Santos,Boston Red Sox,RSOX,1,1,1,2,2020,2021,1,0.0,-0.06,-0.06,0,34,34,0,0,0,0.0,100.0,100.0,0.0,0.0,0.0
Anthony Briggs,Anthony Briggs,Atlanta Braves,BRAVES,1,1,1,2,1998,2002,4,0.0,-0.03,-0.03,0,8,8,0,0,0,0.0,11.0,11.0,0.0,0.0,0.0
Anthony Giresi,Anthony Giresi,Philadelphia Phillies,PHILS,1,2,1,3,1969,1969,0,0.0,-0.07,-0.07,0,13,13,0,14,14,0.0,0.0,0.0,0.0,0.0,0.0
Anthony Jackson,Anthony Jackson,Colorado Rockies,ROCKS,1,1,1,2,2010,2013,3,0.0,-0.1,-0.1,0,16,16,0,0,0,0.0,16.0,16.0,0.0,0.0,0.0
Anthony Webster,Anthony Webster,Chicago White Sox,WSOX,1,3,1,4,2003,2003,0,5.54,2.04,-3.5,375,73,-302,0,289,289,1248.0,0.0,-1248.0,0.0,9150000.0,9150000.0
Anton French,Anton French,St. Louis Cardinals,CARDS,1,1,1,2,1995,1995,0,0.0,-0.86,-0.86,0,22,22,0,82,82,0.0,0.0,0.0,0.0,111500.0,111500.0
Anton French,Anton French,Atlanta Braves,BRAVES,1,1,1,2,1996,1999,3,0.0,0.37,0.37,0,163,163,0,291,291,0.0,0.0,0.0,0.0,185000.0,185000.0
Anton French,Anton French,Detroit Tigers,TIGRS,1,1,1,2,1996,1999,3,0.0,-0.1,-0.1,0,32,32,0,0,0,0.0,78.0,78.0,0.0,0.0,0.0
Antonio Cabello,Antonio Cabello,New York Yankees,YANKS,1,2,2,4,2021,2021,0,0.0,0.33,0.33,0,102,102,0,361,361,0.0,0.0,0.0,0.0,0.0,0.0
Antonio Cruz,Antonio Cruz,Detroit Tigers,TIGRS,1,2,1,3,2011,2011,0,0.0,0.46,0.46,0,40,40,0,133,133,0.0,0.0,0.0,0.0,1000000.0,1000000.0
Antonio Fernandez,Antonio Fernandez,San Diego Padres,PADRS,1,1,1,2,1997,2002,5,0.0,2.68,2.68,0,99,99,0,107,107,0.0,891.0,891.0,0.0,0.0,0.0
Antonio Sucre,Antonio Sucre,Washington Nationals,NATEX,2,4,2,6,2004,2005,1,-0.93,0.01,0.94,16,82,66,9,308,299,74.0,0.0,-74.0,674000.0,12800000.0,12126000.0
Apolinar Garcia,Apolinar Garcia,Oakland Athletics,ATLTCS,1,2,1,3,1991,1991,0,0.0,-0.69,-0.69,0,56,56,0,204,204,0.0,0.0,0.0,0.0,0.0,0.0
Apostol Garcia,Apostol Garcia,Detroit Tigers,TIGRS,2,4,3,7,1999,2002,3,-0.56,-0.4,0.16,98,120,22,61,10,-51,565.0,1738.0,1173.0,5300000.0,13083334.0,7783334.0
Ara Petrosian,Ara Petrosian,Colorado Rockies,ROCKS,1,2,1,3,1998,1999,1,0.0,-0.8,-0.8,0,138,138,0,381,381,0.0,0.0,0.0,0.0,1000000.0,1000000.0
Aric LeClair,Aric LeClair,Kansas City Royals,ROYALS,1,1,1,2,2003,2003,0,0.0,0.4,0.4,0,10,10,0,0,0,0.0,143.0,143.0,0.0,0.0,0.0
Arnie Gooch,Arnie Gooch,Colorado Rockies,ROCKS,1,2,2,4,1995,1996,1,-0.04,0.08,0.12,47,18,-29,7,15,8,143.0,129.0,-14.0,109000.0,5562990.0,5453990.0
Arnie Gooch,Arnie Gooch,New York Mets,METS,4,7,8,15,1998,2006,8,19.49,18.13,-1.36,1116,1028,-88,1998,1238,-760,1375.0,1729.0,354.0,12550000.0,10305000.0,-2245000.0
Arsenio Diaz,Arsenio Diaz,New York Mets,METS,1,4,1,5,1971,1974,3,-0.13,-1.66,-1.53,1,64,63,4,139,135,0.0,0.0,0.0,0.0,0.0,0.0
Art Charles,Art Charles,Toronto Blue Jays,BJAYS,1,1,1,2,2013,2013,0,0.0,0.0,0.0,0,0,0,0,0,0,0.0,0.0,0.0,0.0,0.0,0.0
Art DeFilippis,Art DeFilippis,Texas Rangers,RNGRS,1,1,1,2,1976,1976,0,0.0,0.0,0.0,0,0,0,0,0,0,0.0,0.0,0.0,0.0,0.0,0.0
Art DelDuca,Art DelDuca,Seattle,Seattle,1,2,1,3,1954,1954,0,0.0,0.0,0.0,0,0,0,0,0,0,0.0,0.0,0.0,0.0,0.0,0.0
Arthur Clifford,Arthur Clifford,Detroit Tigers,TIGRS,1,2,1,3,1971,1971,0,0.24,-0.53,-0.77,58,32,-26,90,4,-86,0.0,95.0,95.0,0.0,0.0,0.0
Arthur Duchesnil,Arthur Duchesnil,New York Giants,GIANTS,2,4,2,6,1913,1915,2,8.83,4.27,-4.56,856,228,-628,2811,864,-1947,1477.0,0.0,-1477.0,0.0,0.0,0.0
Arthur Luce,Arthur Luce,Cincinnati Reds,REDS,1,2,1,3,1940,1946,6,0.0,-0.07,-0.07,0,12,12,0,19,19,0.0,0.0,0.0,0.0,0.0,0.0
Arthur Ray,Arthur Ray,Pittsburgh Pirates,PIRATS,2,3,3,6,1983,1992,9,-1.54,-0.56,0.98,576,774,198,1492,1540,48,0.0,993.0,993.0,0.0,0.0,0.0
Arthur Visconti,Arthur Visconti,New York Yankees,YANKS,1,4,1,5,1947,1947,0,0.0,0.0,0.0,0,0,0,0,0,0,0.0,0.0,0.0,0.0,0.0,0.0
Artie Kay,Artie Kay,Baltimore Orioles,ORLS,1,3,1,4,1961,1962,1,-0.1,0.84,0.94,11,78,67,8,316,308,0.0,0.0,0.0,0.0,0.0,0.0
Arturo Miranda,Arturo Miranda,Oakland Athletics,ATLTCS,1,1,1,2,1968,1968,0,0.0,0.0,0.0,0,0,0,0,0,0,0.0,0.0,0.0,0.0,0.0,0.0
Augie Schmidt,Augie Schmidt,Toronto Blue Jays,BJAYS,1,3,1,4,1985,1987,2,0.9,0.56,-0.34,130,92,-38,70,0,-70,652.0,301.0,-351.0,0.0,0.0,0.0
Austin Bossart,Austin Bossart,Philadelphia Phillies,PHILS,1,1,1,2,2019,2019,0,0.0,-0.5,-0.5,0,21,21,0,14,14,0.0,166.0,166.0,0.0,8000000.0,8000000.0
Austin House,Austin House,Oakland Athletics,ATLTCS,1,2,1,3,2014,2021,7,0.0,9.92,9.92,0,645,645,0,2492,2492,0.0,0.0,0.0,0.0,0.0,0.0
Austin Manahan,Austin Manahan,Montreal Expos,NATEX,1,2,1,3,1993,1995,2,0.0,0.67,0.67,0,30,30,0,12,12,0.0,141.0,141.0,0.0,0.0,0.0
Austin Martin,Austin Martin,Toronto Blue Jays,BJAYS,1,2,1,3,2021,2021,0,0.0,1.38,1.38,0,13,13,0,2,2,0.0,211.0,211.0,0.0,6100000.0,6100000.0
Austin Shenton,Austin Shenton,Seattle Mariners,MARNRS,1,2,1,3,2021,2021,0,0.82,0.4,-0.42,27,25,-2,0,0,0,71.0,66.0,-5.0,100000.0,0.0,-100000.0
Austin Wates,Austin Wates,Houston Astros,ASTROS,3,8,7,15,2014,2019,5,5.86,22.81,16.95,902,718,-184,1801,1734,-67,1776.0,1238.0,-538.0,2712000.0,500000.0,-2212000.0
Avery Weems,Avery Weems,Chicago White Sox,WSOX,1,2,1,3,2020,2020,0,0.72,0.0,-0.72,29,0,-29,4,0,-4,353.0,0.0,-353.0,0.0,11333334.0,11333334.0
B.J. Garbe,B.J. Garbe,Minnesota Twins,TWINS,1,1,1,2,2004,2004,0,0.0,0.24,0.24,0,19,19,0,44,44,0.0,0.0,0.0,0.0,0.0,0.0
B.J. LaMura,B.J. LaMura,Chicago White Sox,WSOX,1,1,1,2,2006,2006,0,0.0,0.01,0.01,0,19,19,0,51,51,0.0,0.0,0.0,0.0,650000.0,650000.0
Bailey Horn,Bailey Horn,Chicago White Sox,WSOX,1,1,1,2,2021,2021,0,0.0,0.63,0.63,0,25,25,0,0,0,0.0,54.0,54.0,0.0,800000.0,800000.0
Bambi Mesa,Bambi Mesa,Chicago White Sox,WSOX,2,5,2,7,1981,1985,4,2.62,4.41,1.79,199,140,-59,397,1,-396,970.0,1329.0,359.0,0.0,0.0,0.0
Bambi Mesa,Bambi Mesa,Minnesota Twins,TWINS,1,1,1,2,1983,1984,1,0.0,-0.05,-0.05,0,5,5,0,4,4,0.0,0.0,0.0,0.0,0.0,0.0
Barney Cleveland,Barney Cleveland,Pittsburgh Pirates,PIRATS,3,8,4,12,1916,1922,6,39.97,14.79,-25.18,1164,990,-174,2135,3762,1627,8893.0,711.0,-8182.0,9650.0,5000.0,-4650.0
Barney Lutz,Barney Lutz,Philadelphia Athletics,ATLTCS,4,5,4,9,1944,1953,9,7.79,8.9,1.11,528,937,409,1124,3595,2471,1511.0,0.0,-1511.0,24000.0,0.0,-24000.0
Barret Loux,Barret Loux,Texas Rangers,RNGRS,1,1,1,2,2012,2013,1,0.0,0.0,0.0,0,0,0,0,0,0,0.0,0.0,0.0,0.0,0.0,0.0
Bear Bay,Bear Bay,Chicago Cubs,CUBS,1,1,1,2,2005,2005,0,0.0,-0.01,-0.01,0,37,37,0,1,1,0.0,59.0,59.0,0.0,0.0,0.0
Beau Jones,Beau Jones,Atlanta Braves,BRAVES,3,7,5,12,2007,2009,2,51.72,9.48,-42.24,2314,404,-1910,8153,1445,-6708,2789.0,84.0,-2705.0,15385000.0,11700000.0,-3685000.0
Beau Vaughan,Beau Vaughan,Boston Red Sox,RSOX,1,2,1,3,2008,2009,1,0.0,0.0,0.0,0,0,0,0,0,0,0.0,0.0,0.0,0.0,0.0,0.0
Belvani Martinez,Belvani Martinez,Arizona Diamondbacks,DBACKS,2,2,2,4,1999,2000,1,-0.02,-0.85,-0.83,186,55,-131,300,121,-179,0.0,0.0,0.0,1100000.0,1125000.0,25000.0
Ben Abner,Ben Abner,Montreal Expos,NATEX,1,2,1,3,1986,1986,0,0.0,-0.23,-0.23,0,30,30,0,69,69,0.0,0.0,0.0,0.0,0.0,0.0
Ben Bailey,Ben Bailey,Cincinnati Reds,REDS,1,2,1,3,1996,1997,1,0.0,0.04,0.04,0,25,25,0,96,96,0.0,0.0,0.0,0.0,0.0,0.0
Ben Bianchi,Ben Bianchi,Baltimore Orioles,ORLS,1,3,1,4,1986,1987,1,0.0,-0.57,-0.57,0,34,34,0,85,85,0.0,0.0,0.0,0.0,0.0,0.0
Ben Cox,Ben Cox,Washington Nationals,NATEX,1,1,1,2,2005,2005,0,0.0,-0.11,-0.11,0,20,20,0,54,54,0.0,0.0,0.0,0.0,800000.0,800000.0
Ben Himes,Ben Himes,Cincinnati Reds,REDS,1,2,2,4,2005,2006,1,0.0,0.1,0.1,0,9,9,0,23,23,0.0,0.0,0.0,0.0,2000000.0,2000000.0
Ben Jukich,Ben Jukich,Oakland Athletics,ATLTCS,1,2,1,3,2007,2009,2,-0.06,0.33,0.39,44,33,-11,0,73,73,59.0,0.0,-59.0,0.0,0.0,0.0
Ben Julianel,Ben Julianel,St. Louis Cardinals,CARDS,1,2,1,3,2003,2003,0,0.0,0.34,0.34,0,16,16,0,14,14,0.0,114.0,114.0,0.0,6000000.0,6000000.0
Ben Julianel,Ben Julianel,New York Yankees,YANKS,1,1,1,2,2005,2007,2,0.0,0.68,0.68,0,117,117,0,0,0,0.0,368.0,368.0,0.0,0.0,0.0
Ben Margalski,Ben Margalski,Philadelphia Phillies,PHILS,1,1,1,2,2002,2002,0,0.0,0.0,0.0,0,0,0,0,0,0,0.0,0.0,0.0,0.0,0.0,0.0
Ben Mateosky,Ben Mateosky,Detroit Tigers,TIGRS,1,1,1,2,1958,1960,2,0.0,-0.06,-0.06,0,26,26,0,2,2,0.0,55.0,55.0,0.0,0.0,0.0
Ben Mateosky,Ben Mateosky,St. Louis Cardinals,CARDS,1,1,1,2,1961,1962,1,0.0,0.0,0.0,0,0,0,0,0,0,0.0,0.0,0.0,0.0,0.0,0.0
Ben Paullus,Ben Paullus,New York Yankees,YANKS,1,1,1,2,2013,2014,1,0.0,0.12,0.12,0,13,13,0,25,25,0.0,3.0,3.0,0.0,0.0,0.0
Ben Shaffar,Ben Shaffar,Chicago Cubs,CUBS,2,3,2,5,2001,2002,1,-0.07,1.18,1.25,254,63,-191,981,235,-746,6.0,0.0,-6.0,0.0,1800000.0,1800000.0
Ben Shaffar,Ben Shaffar,Cincinnati Reds,REDS,1,1,1,2,2001,2002,1,0.0,0.22,0.22,0,22,22,0,1,1,0.0,70.0,70.0,0.0,795000.0,795000.0
Ben Snyder,Ben Snyder,Baltimore Orioles,ORLS,1,2,2,4,2009,2010,1,0.65,0.2,-0.45,41,33,-8,0,5,5,95.0,572.0,477.0,850000.0,12868892.0,12018892.0
Ben Washburn,Ben Washburn,Montreal Expos,NATEX,1,1,1,2,2003,2004,1,0.0,0.84,0.84,0,38,38,0,86,86,0.0,0.0,0.0,0.0,0.0,0.0
Benji DeQuin,Benji DeQuin,Montreal Expos,NATEX,1,1,1,2,2004,2005,1,0.0,-0.23,-0.23,0,108,108,0,4,4,0.0,138.0,138.0,0.0,0.0,0.0
Bernard Cobb,Bernard Cobb,Pittsburgh Pirates,PIRATS,4,7,4,11,1937,1946,9,3.24,18.29,15.05,164,1051,887,641,3703,3062,0.0,666.0,666.0,0.0,0.0,0.0
Bernie Beckman,Bernie Beckman,Detroit Tigers,TIGRS,1,2,1,3,1972,1972,0,0.0,0.18,0.18,0,59,59,0,139,139,0.0,0.0,0.0,0.0,0.0,0.0
Bert Geiger,Bert Geiger,Chicago White Sox,WSOX,1,2,1,3,1982,1986,4,0.16,7.02,6.86,20,523,503,12,1875,1863,0.0,0.0,0.0,0.0,0.0,0.0
Bill Cutshall,Bill Cutshall,Montreal Expos,NATEX,2,2,2,4,1986,1988,2,0.0,0.06,0.06,0,10,10,0,2,2,0.0,26.0,26.0,0.0,0.0,0.0
Bill Flowers,Bill Flowers,Cleveland Indians,INDINS,1,1,1,2,1973,1974,1,0.0,-0.35,-0.35,0,14,14,0,0,0,0.0,216.0,216.0,0.0,38000.0,38000.0
Bill Hance,Bill Hance,Texas Rangers,RNGRS,2,3,2,5,1985,1991,6,9.16,3.49,-5.67,280,372,92,750,977,227,1044.0,361.0,-683.0,431500.0,68000.0,-363500.0
Bill Haslerig,Bill Haslerig,Atlanta Braves,BRAVES,1,1,1,2,1980,1985,5,0.0,2.64,2.64,0,204,204,0,547,547,0.0,0.0,0.0,0.0,0.0,0.0
Bill Henderson,Bill Henderson,Detroit Tigers,TIGRS,1,3,2,5,1989,1990,1,0.0,-0.12,-0.12,0,13,13,0,34,34,0.0,5.0,5.0,0.0,0.0,0.0
Bill Kelly,Bill Kelly,New York Giants,GIANTS,2,8,3,11,1919,1923,4,10.49,7.89,-2.6,305,402,97,539,1094,555,2035.0,323.0,-1712.0,12500.0,9600.0,-2900.0
Bill Kirkpatrick,Bill Kirkpatrick,Baltimore Orioles,ORLS,6,18,17,35,1974,1988,14,24.52,108.22,83.7,1282,4856,3574,1868,13359,11491,8105.0,12121.0,4016.0,705333.0,98500.0,-606833.0
Bill Lajoie,Bill Lajoie,Baltimore Orioles,ORLS,9,23,20,43,1960,1988,28,27.92,121.63,93.71,1879,5109,3230,2628,13546,10918,8511.0,12795.0,4284.0,787833.0,104900.0,-682933.0
Bill Lajoie,Bill Lajoie,Los Angeles Dodgers,DOGRS,2,3,4,7,1961,1962,1,-0.42,0.0,0.42,35,0,-35,74,0,-74,0.0,0.0,0.0,0.0,0.0,0.0
Bill McCarthy,Bill McCarthy,Atlanta Braves,BRAVES,1,1,1,2,2007,2007,0,0.0,0.0,0.0,0,0,0,0,0,0,0.0,0.0,0.0,0.0,0.0,0.0
Bill Merrifield,Bill Merrifield,California Angels,ANGELS,1,2,1,3,1987,1990,3,-0.7,4.86,5.56,26,422,396,1,1802,1801,56.0,0.0,-56.0,0.0,807000.0,807000.0
Bill Merrifield,Bill Merrifield,Pittsburgh Pirates,PIRATS,1,1,1,2,1988,1988,0,0.0,0.0,0.0,0,0,0,0,0,0,0.0,0.0,0.0,0.0,0.0,0.0
Bill Oplinger,Bill Oplinger,Baltimore Orioles,ORLS,2,3,3,6,1962,1966,4,0.15,0.64,0.49,200,82,-118,614,176,-438,0.0,0.0,0.0,8500.0,0.0,-8500.0
Bill Rhinehart,Bill Rhinehart,Washington Nationals,NATEX,1,2,2,4,2011,2011,0,0.0,-0.17,-0.17,0,43,43,0,107,107,0.0,0.0,0.0,0.0,1750000.0,1750000.0
Bill Sinton,Bill Sinton,Boston Red Sox,RSOX,1,2,2,4,1948,1948,0,0.0,0.0,0.0,2,0,-2,1,0,-1,0.0,0.0,0.0,0.0,0.0,0.0
Bill Stevenson,Bill Stevenson,San Diego Padres,PADRS,3,5,5,10,1989,2008,19,13.46,29.47,16.01,630,2260,1630,2360,66,-2294,138.0,3878.0,3740.0,3375000.0,109000.0,-3266000.0
Bill VanBommel,Bill VanBommel,Oakland Athletics,ATLTCS,2,4,6,10,1976,1978,2,9.34,5.62,-3.72,178,460,282,558,1294,736,944.0,1423.0,479.0,100000.0,0.0,-100000.0
Bill Wrona,Bill Wrona,Seattle Mariners,MARNRS,1,1,1,2,1984,1985,1,0.0,0.0,0.0,0,0,0,0,0,0,0.0,0.0,0.0,0.0,0.0,0.0
Billy Bartels,Billy Bartels,Los Angeles Dodgers,DOGRS,1,1,1,2,1987,1987,0,0.0,-0.25,-0.25,0,40,40,0,146,146,0.0,0.0,0.0,0.0,300000.0,300000.0
Billy Carthel,Billy Carthel,New York Mets,METS,1,4,1,5,1971,1974,3,-0.13,-1.66,-1.53,1,64,63,4,139,135,0.0,0.0,0.0,0.0,0.0,0.0
Billy Farmer,Billy Farmer,Boston Red Sox,RSOX,6,12,12,24,1969,1977,8,34.7,14.03,-20.67,1690,1006,-684,5095,2431,-2664,3846.0,3907.0,61.0,155000.0,163750.0,8750.0
Billy Hogan,Billy Hogan,San Diego Padres,PADRS,1,1,1,2,2004,2005,1,0.0,-0.27,-0.27,0,4,4,0,1,1,0.0,13.0,13.0,0.0,0.0,0.0
Billy Kerr,Billy Kerr,SanDiego,SanDiego,1,1,1,2,1947,1947,0,0.0,0.0,0.0,0,0,0,0,0,0,0.0,0.0,0.0,0.0,0.0,0.0
Billy Killian,Billy Killian,San Diego Padres,PADRS,9,21,20,41,2006,2021,15,51.12,29.32,-21.8,2292,1830,-462,7839,5012,-2827,1512.0,4191.0,2679.0,15535200.0,5157500.0,-10377700.0
Billy Max,Billy Max,Milwaukee Brewers,BREWRS,1,1,1,2,1984,1984,0,0.0,0.0,0.0,0,0,0,0,0,0,0.0,0.0,0.0,0.0,0.0,0.0
Billy Presley,Billy Presley,Baltimore Orioles,ORLS,1,3,2,5,1980,1980,0,0.0,0.0,0.0,0,0,0,0,0,0,0.0,0.0,0.0,0.0,0.0,0.0
Blaine Mull,Blaine Mull,Kansas City Royals,ROYALS,2,2,2,4,1997,2002,5,6.89,-1.26,-8.15,751,131,-620,3005,345,-2660,0.0,378.0,378.0,0.0,2800000.0,2800000.0
Blair Walters,Blair Walters,Chicago White Sox,WSOX,1,3,2,5,2012,2012,0,4.38,0.83,-3.55,242,35,-207,1,0,-1,927.0,104.0,-823.0,0.0,0.0,0.0
Blaise Kozeniewski,Blaise Kozeniewski,New York Yankees,YANKS,1,1,1,2,1996,1998,2,0.0,3.29,3.29,0,242,242,0,940,940,0.0,0.0,0.0,0.0,0.0,0.0
Blake Cooper,Blake Cooper,Arizona Diamondbacks,DBACKS,1,1,1,2,2014,2014,0,0.0,-0.07,-0.07,0,7,7,0,5,5,0.0,0.0,0.0,0.0,0.0,0.0
Blake Hunt,Blake Hunt,San Diego Padres,PADRS,1,4,1,5,2020,2020,0,1.51,0.0,-1.51,105,0,-105,277,0,-277,238.0,0.0,-238.0,0.0,7600000.0,7600000.0
Blake Johnson,Blake Johnson,Los Angeles Dodgers,DOGRS,2,5,3,8,2006,2007,1,-0.56,-0.24,0.32,64,85,21,5,67,62,658.0,69.0,-589.0,8750000.0,1700000.0,-7050000.0
Blake Mayo,Blake Mayo,Los Angeles Dodgers,DOGRS,1,1,1,2,1999,1999,0,0.0,0.0,0.0,0,0,0,0,0,0,0.0,0.0,0.0,0.0,0.0,0.0
Blake Perkins,Blake Perkins,Washington Nationals,NATEX,1,3,1,4,2018,2018,0,-0.73,0.15,0.88,62,41,-21,233,0,-233,0.0,56.0,56.0,0.0,0.0,0.0
Blake Rutherford,Blake Rutherford,New York Yankees,YANKS,1,4,3,7,2017,2020,3,0.5,4.41,3.91,12,310,298,0,241,241,30.0,651.0,621.0,6150000.0,12535000.0,6385000.0
Bo Dodson,Bo Dodson,Boston Red Sox,RSOX,1,1,1,2,1998,1998,0,0.0,0.01,0.01,0,2,2,0,1,1,0.0,0.0,0.0,0.0,0.0,0.0
Bo Flowers,Bo Flowers,Detroit Tigers,TIGRS,3,5,4,9,2005,2010,5,1.05,4.48,3.43,399,254,-145,54,7,-47,685.0,1390.0,705.0,1975000.0,318500.0,-1656500.0
Bo Ortiz,Bo Ortiz,Baltimore Orioles,ORLS,1,1,1,2,1994,1994,0,0.0,0.18,0.18,0,28,28,0,80,80,0.0,0.0,0.0,0.0,755718.0,755718.0
Bob Baldrick,Bob Baldrick,Montreal Expos,NATEX,2,2,2,4,1983,1984,1,0.0,-0.26,-0.26,0,13,13,0,5,5,0.0,11.0,11.0,0.0,0.0,0.0
Bob Bathe,Bob Bathe,Oakland Athletics,ATLTCS,1,2,2,4,1986,1986,0,-0.31,0.0,0.31,17,0,-17,23,0,-23,0.0,0.0,0.0,0.0,0.0,0.0
Bob Helsom,Bob Helsom,New York Yankees,YANKS,5,11,11,22,1982,1993,11,53.43,40.75,-12.68,2484,1599,-885,8455,4687,-3768,3002.0,2795.0,-207.0,2627500.0,2285766.0,-341734.0
Bob Landeck,Bob Landeck,New York Yankees,YANKS,1,3,1,4,1951,1955,4,0.0,0.28,0.28,0,56,56,0,29,29,0.0,270.0,270.0,0.0,0.0,0.0
Bob Maneely,Bob Maneely,Chicago Cubs,CUBS,2,5,2,7,1972,1976,4,12.2,0.19,-12.01,299,239,-60,0,36,36,2874.0,554.0,-2320.0,72500.0,25000.0,-47500.0
Bob Parham,Bob Parham,Brooklyn Dodgers,DOGRS,1,2,1,3,1932,1934,2,0.0,5.81,5.81,0,319,319,0,1163,1163,0.0,0.0,0.0,0.0,0.0,0.0
Bob Polinsky,Bob Polinsky,New York Yankees,YANKS,4,7,7,14,1977,1983,6,29.7,12.76,-16.94,1788,732,-1056,2195,2573,378,4627.0,0.0,-4627.0,0.0,400000.0,400000.0
Bob Polinsky,Bob Polinsky,Chicago White Sox,WSOX,1,3,3,6,1977,1978,1,1.55,0.0,-1.55,299,0,-299,869,0,-869,0.0,0.0,0.0,70000.0,0.0,-70000.0
Bob Polinsky,Bob Polinsky,New York Yankees,YANKS,16,36,34,70,1979,1995,16,29.43,51.07,21.64,3022,3837,815,7138,10506,3368,6440.0,4403.0,-2037.0,3694706.0,5935000.0,2240294.0
Bob Scott,Bob Scott,Baltimore Orioles,ORLS,5,11,8,19,1967,1973,6,0.02,-1.5,-1.52,551,253,-298,598,477,-121,1557.0,66.0,-1491.0,38500.0,36600.0,-1900.0
Bob Sharpnack,Bob Sharpnack,California Angels,ANGELS,1,2,1,3,1985,1987,2,0.0,4.61,4.61,0,74,74,0,0,0,0.0,1291.0,1291.0,0.0,0.0,0.0
Bob Siegel,Bob Siegel,Seattle Mariners,MARNRS,1,1,1,2,1986,1990,4,0.0,-0.79,-0.79,0,43,43,0,102,102,0.0,0.0,0.0,0.0,0.0,0.0
Bob Sudo,Bob Sudo,Montreal Expos,NATEX,1,1,1,2,1988,1988,0,0.0,0.0,0.0,0,0,0,0,0,0,0.0,0.0,0.0,0.0,0.0,0.0
Bob Wishnevski,Bob Wishnevski,Toronto Blue Jays,BJAYS,1,2,1,3,1991,1992,1,-0.04,3.8,3.84,33,189,156,34,768,734,0.0,0.0,0.0,0.0,875000.0,875000.0
Bob Wissler,Bob Wissler,Minnesota Twins,TWINS,1,2,2,4,1970,1970,0,0.0,0.0,0.0,0,0,0,0,0,0,0.0,0.0,0.0,8000.0,12000.0,4000.0
Bobby Basham,Bobby Basham,Cincinnati Reds,REDS,1,1,1,2,2006,2008,2,0.0,2.33,2.33,0,254,254,0,817,817,0.0,0.0,0.0,0.0,0.0,0.0
Bobby Borchering,Bobby Borchering,Arizona Diamondbacks,DBACKS,6,11,12,23,2012,2019,7,8.73,6.22,-2.51,828,1204,376,3152,2716,-436,0.0,1347.0,1347.0,0.0,495000.0,495000.0
Bobby Catton,Bobby Catton,New York Mets,METS,4,8,5,13,1964,1970,6,3.02,7.06,4.04,629,598,-31,1532,2197,665,1019.0,0.0,-1019.0,88000.0,95000.0,7000.0
Bobby Cripps,Bobby Cripps,Los Angeles Dodgers,DOGRS,1,1,1,2,1997,1997,0,0.0,0.16,0.16,0,42,42,0,191,191,0.0,0.0,0.0,0.0,2500000.0,2500000.0
Bobby Gamez,Bobby Gamez,California Angels,ANGELS,1,1,1,2,1994,1994,0,0.0,0.0,0.0,0,0,0,0,0,0,0.0,0.0,0.0,0.0,0.0,0.0
Bobby Hrapmann,Bobby Hrapmann,St. Louis Cardinals,CARDS,2,3,2,5,1976,1977,1,-2.23,0.7,2.93,320,204,-116,745,727,-18,229.0,0.0,-229.0,0.0,0.0,0.0
Bobby Mitchell,Bobby Mitchell,San Diego Padres,PADRS,5,9,9,18,1981,1991,10,23.07,22.84,-0.23,1220,1476,256,3009,1558,-1451,1633.0,5326.0,3693.0,3883333.0,1525000.0,-2358333.0
Bobby Rector,Bobby Rector,San Francisco Giants,GIANTS,1,2,1,3,1997,1997,0,0.0,-0.56,-0.56,0,16,16,0,12,12,0.0,99.0,99.0,0.0,1125000.0,1125000.0
Bobby Rodgers,Bobby Rodgers,Boston Red Sox,RSOX,1,1,1,2,1996,1997,1,0.0,-0.28,-0.28,0,42,42,0,74,74,0.0,0.0,0.0,0.0,134000.0,134000.0
Bobby Sismondo,Bobby Sismondo,Detroit Tigers,TIGRS,1,1,1,2,2000,2002,2,0.0,1.58,1.58,0,278,278,0,795,795,0.0,0.0,0.0,0.0,0.0,0.0
Bobby Sismondo,Bobby Sismondo,Philadelphia Phillies,PHILS,1,1,1,2,2001,2001,0,0.0,0.0,0.0,0,0,0,0,0,0,0.0,0.0,0.0,0.0,0.0,0.0
Bobby Wilson,Bobby Wilson,Cleveland Indians,INDINS,1,2,1,3,1952,1955,3,0.19,-0.65,-0.84,8,120,112,3,17,14,36.0,312.0,276.0,0.0,10000.0,10000.0
Bobby Wilson,Bobby Wilson,Philadelphia Athletics,ATLTCS,51,119,130,249,1953,1976,23,220.72,117.73,-102.99,17901,16276,-1625,45475,48056,2581,21193.0,17462.0,-3731.0,561100.0,842400.0,281300.0
Boi Rodriguez,Boi Rodriguez,Montreal Expos,NATEX,1,2,2,4,1991,1993,2,8.18,0.0,-8.18,462,0,-462,1670,0,-1670,0.0,0.0,0.0,0.0,0.0,0.0
Bolivar Volquez,Bolivar Volquez,Baltimore Orioles,ORLS,1,2,1,3,1999,2003,4,-0.26,4.13,4.39,28,143,115,89,20,-69,0.0,2220.0,2220.0,0.0,0.0,0.0
Bowden Francis,Bowden Francis,Milwaukee Brewers,BREWRS,1,2,1,3,2021,2021,0,0.58,0.23,-0.35,34,56,22,0,174,174,98.0,0.0,-98.0,0.0,0.0,0.0
Brad Baker,Brad Baker,Boston Red Sox,RSOX,1,2,2,4,2002,2005,3,0.0,1.41,1.41,0,227,227,0,0,0,0.0,535.0,535.0,0.0,500000.0,500000.0
Brad Baker,Brad Baker,Atlanta Braves,BRAVES,1,1,1,2,2006,2006,0,0.0,0.0,0.0,0,0,0,0,0,0,0.0,0.0,0.0,0.0,0.0,0.0
Brad Correll,Brad Correll,Cincinnati Reds,REDS,1,2,2,4,2004,2006,2,-0.03,0.46,0.49,53,65,12,1,87,86,76.0,206.0,130.0,500000.0,0.0,-500000.0
Brad Hassinger,Brad Hassinger,Philadelphia Phillies,PHILS,1,1,1,2,1993,1993,0,0.0,-0.41,-0.41,0,50,50,0,3,3,0.0,94.0,94.0,0.0,0.0,0.0
Brad Hoyer,Brad Hoyer,San Diego Padres,PADRS,1,2,1,3,1990,1991,1,0.0,-0.74,-0.74,0,28,28,0,2,2,0.0,61.0,61.0,0.0,360000.0,360000.0
Brad Kaufman,Brad Kaufman,San Diego Padres,PADRS,1,2,2,4,1998,1998,0,0.16,0.0,-0.16,3,0,-3,0,0,0,27.0,0.0,-27.0,0.0,0.0,0.0
Brad Key,Brad Key,Cincinnati Reds,REDS,2,3,3,6,2006,2007,1,-0.79,-0.18,0.61,21,80,59,50,242,192,0.0,0.0,0.0,2000000.0,0.0,-2000000.0
Brad Murray,Brad Murray,Chicago White Sox,WSOX,1,1,1,2,2005,2005,0,0.0,0.0,0.0,0,0,0,0,0,0,0.0,0.0,0.0,0.0,0.0,0.0
Brad Pounders,Brad Pounders,San Diego Padres,PADRS,3,5,5,10,1989,2008,19,13.46,29.47,16.01,630,2260,1630,2360,66,-2294,138.0,3878.0,3740.0,3375000.0,109000.0,-3266000.0
Brad Tweedlie,Brad Tweedlie,Cincinnati Reds,REDS,1,2,1,3,1996,1996,0,0.0,1.33,1.33,0,37,37,0,141,141,0.0,0.0,0.0,0.0,1135000.0,1135000.0
Brady Feigl,Brady Feigl,Atlanta Braves,BRAVES,1,2,1,3,2016,2018,2,0.0,0.11,0.11,0,152,152,0,6,6,0.0,274.0,274.0,0.0,0.0,0.0
Braeden Ogle,Braeden Ogle,Pittsburgh Pirates,PIRATS,1,1,1,2,2021,2021,0,0.0,0.0,0.0,0,0,0,0,0,0,0.0,0.0,0.0,0.0,0.0,0.0
Brandon Barker,Brandon Barker,Atlanta Braves,BRAVES,1,2,2,4,2016,2016,0,0.0,0.0,0.0,0,0,0,0,0,0,0.0,0.0,0.0,0.0,0.0,0.0
Brandon Cromer,Brandon Cromer,Toronto Blue Jays,BJAYS,2,7,5,12,1996,2001,5,5.42,8.51,3.09,1726,826,-900,3923,2165,-1758,1392.0,748.0,-644.0,1500000.0,5870000.0,4370000.0
Brandon Hynick,Brandon Hynick,Colorado Rockies,ROCKS,1,1,2,3,2009,2009,0,0.0,0.9,0.9,0,14,14,0,4,4,0.0,51.0,51.0,0.0,10000000.0,10000000.0
Brandon Jacobs,Brandon Jacobs,Boston Red Sox,RSOX,1,1,2,3,2013,2013,0,0.0,0.19,0.19,0,20,20,0,0,0,0.0,46.0,46.0,0.0,0.0,0.0
Brandon Jacobs,Brandon Jacobs,Chicago White Sox,WSOX,3,5,5,10,2013,2020,7,3.36,16.12,12.76,339,440,101,1313,1933,620,353.0,102.0,-251.0,3255000.0,11824334.0,8569334.0
Brandon Kloess,Brandon Kloess,Chicago White Sox,WSOX,1,1,1,2,2012,2014,2,0.0,-0.19,-0.19,0,20,20,0,36,36,0.0,0.0,0.0,0.0,0.0,0.0
Brandon Leese,Brandon Leese,San Francisco Giants,GIANTS,1,2,1,3,1997,1997,0,0.0,-0.56,-0.56,0,16,16,0,12,12,0.0,99.0,99.0,0.0,1125000.0,1125000.0
Brandon Miller,Brandon Miller,Seattle Mariners,MARNRS,1,4,1,5,2017,2018,1,5.31,0.23,-5.08,114,11,-103,89,0,-89,990.0,26.0,-964.0,0.0,4600000.0,4600000.0
Brandon Pernell,Brandon Pernell,San Diego Padres,PADRS,2,2,2,4,1999,2000,1,0.75,-0.23,-0.98,22,6,-16,27,0,-27,187.0,9.0,-178.0,230000.0,200000.0,-30000.0
Brandon Ramey,Brandon Ramey,Philadelphia Phillies,PHILS,1,3,1,4,2020,2020,0,0.0,-0.6,-0.6,0,10,10,0,0,0,0.0,23.0,23.0,0.0,1250000.0,1250000.0
Brandon Roberts,Brandon Roberts,Cincinnati Reds,REDS,1,1,1,2,2006,2008,2,0.0,-0.18,-0.18,0,115,115,0,209,209,0.0,0.0,0.0,0.0,1000000.0,1000000.0
Brandon Sisk,Brandon Sisk,Kansas City Royals,ROYALS,1,1,2,3,2012,2013,1,0.0,3.22,3.22,0,33,33,0,4,4,0.0,633.0,633.0,0.0,11200000.0,11200000.0
Brandon Waring,Brandon Waring,Cincinnati Reds,REDS,1,3,2,5,2008,2011,3,-0.23,1.51,1.74,26,269,243,51,1011,960,0.0,0.0,0.0,3000000.0,7500000.0,4500000.0
Brandon Weeden,Brandon Weeden,New York Yankees,YANKS,1,4,1,5,2003,2005,2,4.25,2.4,-1.85,506,36,-470,179,2,-177,2047.0,616.0,-1431.0,4150000.0,15714286.0,11564286.0
Brayan Hernandez,Brayan Hernandez,Seattle Mariners,MARNRS,1,4,1,5,2017,2018,1,5.31,0.23,-5.08,114,11,-103,89,0,-89,990.0,26.0,-964.0,0.0,4600000.0,4600000.0
Breen Newcomer,Breen Newcomer,Boston Red Sox,RSOX,1,2,1,3,1977,1977,0,0.0,0.0,0.0,0,2,2,0,2,2,0.0,0.0,0.0,0.0,0.0,0.0
Brendan McCurry,Brendan McCurry,Oakland Athletics,ATLTCS,1,1,1,2,2015,2018,3,0.0,7.12,7.12,0,397,397,0,1694,1694,0.0,0.0,0.0,0.0,8000000.0,8000000.0
Brendon Davis,Brendon Davis,Los Angeles Dodgers,DOGRS,1,3,1,4,2017,2017,0,-1.3,0.52,1.82,240,18,-222,874,20,-854,69.0,149.0,80.0,0.0,11000000.0,11000000.0
Brennan Malone,Brennan Malone,Arizona Diamondbacks,DBACKS,2,4,5,9,2020,2020,0,3.3,1.36,-1.94,92,37,-55,387,138,-249,0.0,33.0,33.0,0.0,0.0,0.0
Brent Stentz,Brent Stentz,Detroit Tigers,TIGRS,2,3,2,5,1996,1997,1,-0.94,0.09,1.03,337,47,-290,1117,151,-966,0.0,0.0,0.0,728000.0,225000.0,-503000.0
Bret Wagner,Bret Wagner,St. Louis Cardinals,CARDS,6,12,11,23,1996,2004,8,8.44,23.16,14.72,1305,1318,13,4128,1707,-2421,1089.0,4162.0,3073.0,14483333.0,16620281.0,2136948.0
Brett Cumberland,Brett Cumberland,Atlanta Braves,BRAVES,1,5,2,7,2018,2020,2,0.09,0.72,0.63,63,86,23,4,50,46,357.0,484.0,127.0,0.0,5600000.0,5600000.0
Brett Jacobson,Brett Jacobson,Detroit Tigers,TIGRS,1,1,1,2,2009,2009,0,0.0,-0.76,-0.76,0,40,40,0,117,117,0.0,0.0,0.0,0.0,8000000.0,8000000.0
Brett Jacobson,Brett Jacobson,Baltimore Orioles,ORLS,1,2,2,4,2010,2017,7,-0.62,15.73,16.35,27,889,862,0,3636,3636,74.0,0.0,-74.0,0.0,6550000.0,6550000.0
Brett Jenkins,Brett Jenkins,Montreal Expos,NATEX,1,1,1,2,1992,1995,3,0.0,3.14,3.14,0,212,212,0,75,75,0.0,799.0,799.0,0.0,115000.0,115000.0
Brett King,Brett King,Chicago Cubs,CUBS,1,3,2,5,2000,2000,0,0.0,0.0,0.0,0,0,0,0,0,0,0.0,0.0,0.0,0.0,0.0,0.0
Brett Lorin,Brett Lorin,Seattle Mariners,MARNRS,2,6,3,9,2009,2011,2,-0.04,2.82,2.86,447,179,-268,1426,514,-912,0.0,332.0,332.0,5822500.0,10600000.0,4777500.0
Brett Price,Brett Price,Oakland Athletics,ATLTCS,1,1,1,2,2003,2010,7,0.0,0.0,0.0,0,0,0,0,0,0,0.0,0.0,0.0,0.0,2600000.0,2600000.0
Brett Wallach,Brett Wallach,Los Angeles Dodgers,DOGRS,2,4,4,8,2010,2013,3,0.08,2.91,2.83,324,264,-60,960,343,-617,0.0,1182.0,1182.0,410000.0,16002000.0,15592000.0
Brett Wise,Brett Wise,Los Angeles Dodgers,DOGRS,1,2,1,3,1983,1984,1,12.91,-0.97,-13.88,786,117,-669,22,124,102,1584.0,0.0,-1584.0,0.0,0.0,0.0
Brian Brooks,Brian Brooks,San Diego Padres,PADRS,1,1,1,2,1989,1991,2,0.0,-0.39,-0.39,0,17,17,0,41,41,0.0,0.0,0.0,0.0,0.0,0.0
Brian Conroy,Brian Conroy,Boston Red Sox,RSOX,1,1,1,2,1994,1995,1,0.0,-0.3,-0.3,0,2,2,0,0,0,0.0,3.0,3.0,0.0,0.0,0.0
Brian Griffiths,Brian Griffiths,Houston Astros,ASTROS,2,3,2,5,1992,1995,3,0.14,0.64,0.5,6,255,249,0,176,176,12.0,297.0,285.0,475000.0,1375000.0,900000.0
Brian Griffiths,Brian Griffiths,Florida Marlins,MARLNS,1,1,1,2,1993,1993,0,0.0,0.0,0.0,0,0,0,0,0,0,0.0,0.0,0.0,0.0,0.0,0.0
Brian Guinn,Brian Guinn,Oakland Athletics,ATLTCS,2,4,3,7,1987,1997,10,0.59,15.32,14.73,237,554,317,1,0,-1,339.0,1971.0,1632.0,0.0,0.0,0.0
Brian Harrison,Brian Harrison,San Diego Padres,PADRS,1,1,1,2,1990,1991,1,0.0,0.08,0.08,0,54,54,0,2,2,0.0,105.0,105.0,0.0,0.0,0.0
Brian Jenkins,Brian Jenkins,New York Mets,METS,1,1,1,2,2001,2001,0,0.0,0.0,0.0,0,0,0,0,0,0,0.0,0.0,0.0,0.0,243000.0,243000.0
Brian Jeroloman,Brian Jeroloman,Pittsburgh Pirates,PIRATS,1,1,1,2,2013,2013,0,0.0,0.0,0.0,0,0,0,0,0,0,0.0,0.0,0.0,0.0,0.0,0.0
Brian Loyd,Brian Loyd,San Diego Padres,PADRS,1,1,1,2,1998,1998,0,0.0,-0.33,-0.33,0,42,42,0,0,0,0.0,43.0,43.0,0.0,4416667.0,4416667.0
Brian Manning,Brian Manning,San Francisco Giants,GIANTS,1,6,3,9,1997,1999,2,21.4,-0.07,-21.47,1008,161,-847,1122,94,-1028,2523.0,875.0,-1648.0,0.0,9757500.0,9757500.0
Brian Morrison,Brian Morrison,Toronto Blue Jays,BJAYS,1,1,1,2,1990,1990,0,0.0,0.0,0.0,0,0,0,0,0,0,0.0,0.0,0.0,0.0,0.0,0.0
Brian Murphy,Brian Murphy,Atlanta Braves,BRAVES,1,2,2,4,1967,1969,2,-3.37,0.31,3.68,234,194,-40,135,17,-118,1228.0,428.0,-800.0,0.0,0.0,0.0
Brian Partenheimer,Brian Partenheimer,Boston Red Sox,RSOX,1,1,1,2,1999,2000,1,0.0,-0.55,-0.55,0,11,11,0,0,0,0.0,39.0,39.0,0.0,0.0,0.0
Brian Ryder,Brian Ryder,New York Yankees,YANKS,2,4,3,7,1981,1988,7,1.81,9.6,7.79,277,868,591,978,3230,2252,30.0,0.0,-30.0,1050000.0,1450000.0,400000.0
Brian Schales,Brian Schales,Miami Marlins,MARLNS,2,3,3,6,2018,2020,2,1.9,0.09,-1.81,73,139,66,0,0,0,333.0,225.0,-108.0,1125000.0,564200.0,-560800.0
Brian Shaffer,Brian Shaffer,Arizona Diamondbacks,DBACKS,2,3,2,5,2018,2021,3,1.28,-0.96,-2.24,100,134,34,228,7,-221,96.0,270.0,174.0,0.0,0.0,0.0
Brian Stephenson,Brian Stephenson,Chicago Cubs,CUBS,2,4,5,9,1999,2002,3,1.82,4.66,2.84,231,348,117,64,1392,1328,872.0,299.0,-573.0,6473500.0,8775000.0,2301500.0
Brian Tokarse,Brian Tokarse,Anaheim Angels,ANGELS,1,2,1,3,1998,1999,1,0.0,-0.83,-0.83,0,32,32,0,79,79,0.0,0.0,0.0,0.0,700000.0,700000.0
Brian Ward,Brian Ward,Baltimore Orioles,ORLS,1,3,2,5,2015,2015,0,0.0,0.0,0.0,0,0,0,0,0,0,0.0,0.0,0.0,0.0,0.0,0.0
Brooks Carey,Brooks Carey,Baltimore Orioles,ORLS,1,2,1,3,1982,1985,3,-0.67,0.87,1.54,18,216,198,41,563,522,0.0,0.0,0.0,0.0,0.0,0.0
Bruce Compton,Bruce Compton,Cleveland Indians,INDINS,1,2,1,3,1977,1982,5,0.0,-0.15,-0.15,0,173,173,0,361,361,0.0,0.0,0.0,0.0,0.0,0.0
Bryan Connell,Bryan Connell,Milwaukee Brewers,BREWRS,1,2,1,3,2018,2018,0,0.0,0.32,0.32,0,30,30,0,0,0,0.0,24.0,24.0,0.0,0.0,0.0
Bryan Dial,Bryan Dial,Texas Rangers,RNGRS,1,2,1,3,1986,1987,1,0.0,-0.29,-0.29,0,16,16,0,0,0,0.0,71.0,71.0,0.0,0.0,0.0
Bryan Gaal,Bryan Gaal,San Diego Padres,PADRS,1,1,1,2,2004,2005,1,0.0,-0.18,-0.18,0,6,6,0,0,0,0.0,11.0,11.0,0.0,0.0,0.0
Bryan House,Bryan House,Chicago Cubs,CUBS,2,2,2,4,1990,1997,7,0.3,6.03,5.73,61,594,533,198,1995,1797,0.0,0.0,0.0,1287500.0,0.0,-1287500.0
Bryan Jones,Bryan Jones,Kansas City Royals,ROYALS,1,2,1,3,1976,1977,1,0.0,-0.55,-0.55,0,39,39,0,0,0,0.0,114.0,114.0,0.0,0.0,0.0
Bryan Wolff,Bryan Wolff,San Diego Padres,PADRS,2,5,5,10,1995,2006,11,5.59,24.83,19.24,564,1458,894,2040,5766,3726,0.0,4.0,4.0,10951680.0,12450000.0,1498320.0
Bryant Flete,Bryant Flete,Chicago Cubs,CUBS,1,4,1,5,2017,2020,3,6.48,3.51,-2.97,293,156,-137,969,150,-819,891.0,1319.0,428.0,0.0,0.0,0.0
Bryce Ball,Bryce Ball,Atlanta Braves,BRAVES,1,1,1,2,2021,2021,0,0.0,0.24,0.24,0,64,64,0,194,194,0.0,0.0,0.0,0.0,4500000.0,4500000.0
Bryce Hulstrom,Bryce Hulstrom,Chicago White Sox,WSOX,4,5,6,11,1987,1996,9,8.04,25.3,17.26,594,791,197,1682,2873,1191,422.0,1123.0,701.0,5255000.0,2145555.0,-3109445.0
Bryson Brigman,Bryson Brigman,Seattle Mariners,MARNRS,1,2,1,3,2018,2018,0,0.0,-0.16,-0.16,0,30,30,0,97,97,0.0,0.0,0.0,0.0,3250000.0,3250000.0
Bubba Derby,Bubba Derby,Oakland Athletics,ATLTCS,2,5,4,9,2016,2021,5,0.49,7.5,7.01,147,815,668,445,3236,2791,0.0,0.0,0.0,0.0,0.0,0.0
Bubba Holland,Bubba Holland,Pittsburgh Pirates,PIRATS,1,4,1,5,1982,1986,4,0.06,2.65,2.59,23,373,350,0,881,881,83.0,0.0,-83.0,0.0,0.0,0.0
Bubba Nelson,Bubba Nelson,Atlanta Braves,BRAVES,1,2,1,3,2004,2006,2,-0.35,-0.6,-0.25,5,368,363,4,1,-3,46.0,543.0,497.0,0.0,0.0,0.0
Bubba Smith,Bubba Smith,Seattle Mariners,MARNRS,1,1,1,2,1993,1993,0,0.0,0.0,0.0,0,0,0,0,0,0,0.0,0.0,0.0,0.0,0.0,0.0
Bubbie Buzachero,Bubbie Buzachero,Toronto Blue Jays,BJAYS,1,1,1,2,2006,2010,4,0.0,0.98,0.98,0,227,227,0,3,3,0.0,1233.0,1233.0,0.0,0.0,0.0
Buck Autry,Buck Autry,New York Mets,METS,1,2,1,3,1985,1986,1,0.0,0.33,0.33,0,70,70,0,7,7,0.0,121.0,121.0,0.0,0.0,0.0
Buck McNabb,Buck McNabb,Houston Astros,ASTROS,3,6,6,12,1995,2008,13,0.51,3.85,3.34,210,1347,1137,625,3983,3358,615.0,482.0,-133.0,4015000.0,5550000.0,1535000.0
Bud Watkins,Bud Watkins,San Francisco Giants,GIANTS,1,1,1,2,1960,1963,3,0.0,-0.1,-0.1,0,5,5,0,4,4,0.0,0.0,0.0,0.0,0.0,0.0
Buddy Borden,Buddy Borden,Pittsburgh Pirates,PIRATS,1,1,1,2,2014,2016,2,0.0,1.71,1.71,0,279,279,0,582,582,0.0,0.0,0.0,0.0,1475000.0,1475000.0
Buddy Copeland,Buddy Copeland,Oakland Athletics,ATLTCS,1,1,1,2,1975,1978,3,0.0,-1.9,-1.9,0,214,214,0,88,88,0.0,0.0,0.0,0.0,0.0,0.0
Buddy Hernandez,Buddy Hernandez,San Diego Padres,PADRS,1,1,1,2,2002,2003,1,0.0,0.0,0.0,0,0,0,0,0,0,0.0,0.0,0.0,0.0,0.0,0.0
Buddy Reed,Buddy Reed,San Diego Padres,PADRS,1,2,1,3,2019,2021,2,-0.02,1.34,1.36,18,193,175,40,614,574,0.0,0.0,0.0,0.0,3600000.0,3600000.0
Byeong-Hak An,Byeong-Hak An,Boston Red Sox,RSOX,1,2,1,3,2002,2003,1,-0.26,-0.75,-0.49,4,24,20,0,0,0,11.0,67.0,56.0,0.0,1200000.0,1200000.0
Byron Ballard,Byron Ballard,New York Yankees,YANKS,1,1,1,2,1981,1982,1,0.0,-0.03,-0.03,0,2,2,0,0,0,0.0,0.0,0.0,0.0,0.0,0.0
C.J. Chatham,C.J. Chatham,Boston Red Sox,RSOX,1,1,1,2,2021,2021,0,0.0,0.0,0.0,0,0,0,0,0,0,0.0,0.0,0.0,0.0,0.0,0.0
C.J. Henry,C.J. Henry,New York Yankees,YANKS,1,4,2,6,2006,2008,2,0.06,7.5,7.44,46,382,336,0,1631,1631,38.0,136.0,98.0,0.0,16900000.0,16900000.0
C.J. Hinojosa,C.J. Hinojosa,San Francisco Giants,GIANTS,2,3,2,5,2019,2019,0,-0.31,-0.21,0.1,6,15,9,17,36,19,0.0,0.0,0.0,0.0,0.0,0.0
C.L. Penigar,C.L. Penigar,Philadelphia Phillies,PHILS,2,5,3,8,1982,1988,6,12.97,14.82,1.85,911,983,72,587,531,-56,5303.0,1684.0,-3619.0,0.0,1330000.0,1330000.0
Cade Gaspar,Cade Gaspar,Detroit Tigers,TIGRS,7,19,14,33,1996,2002,6,8.66,7.11,-1.55,2368,1295,-1073,4185,3631,-554,2521.0,1620.0,-901.0,8560000.0,6675000.0,-1885000.0
Cal Stevenson,Cal Stevenson,Toronto Blue Jays,BJAYS,2,4,3,7,2019,2021,2,-0.75,-0.48,0.27,26,56,30,8,146,138,113.0,0.0,-113.0,4800000.0,0.0,-4800000.0
Cal Stevenson,Cal Stevenson,Houston Astros,ASTROS,2,4,2,6,2020,2021,1,1.08,-0.38,-1.46,66,28,-38,219,0,-219,14.0,72.0,58.0,0.0,1900000.0,1900000.0
Caleb Dirks,Caleb Dirks,Los Angeles Dodgers,DOGRS,1,2,4,6,2016,2016,0,0.0,-0.57,-0.57,0,26,26,0,16,16,0.0,128.0,128.0,0.0,0.0,0.0
Caleb Kilian,Caleb Kilian,San Francisco Giants,GIANTS,1,2,1,3,2021,2021,0,0.0,1.09,1.09,0,51,51,0,212,212,0.0,0.0,0.0,0.0,19500000.0,19500000.0
Caleb Sampen,Caleb Sampen,Los Angeles Dodgers,DOGRS,1,1,1,2,2019,2019,0,0.0,-0.06,-0.06,0,8,8,0,0,0,0.0,15.0,15.0,0.0,0.0,0.0
Calvin Faucher,Calvin Faucher,Minnesota Twins,TWINS,1,2,2,4,2021,2021,0,0.48,0.33,-0.15,55,6,-49,238,2,-236,0.0,80.0,80.0,13000000.0,0.0,-13000000.0
Calvin Medlock,Calvin Medlock,Cincinnati Reds,REDS,1,2,3,5,2007,2007,0,0.0,0.07,0.07,0,27,27,0,68,68,0.0,0.0,0.0,0.0,0.0,0.0
Calvin Meier,Calvin Meier,Kansas City Royals,ROYALS,1,2,1,3,1974,1975,1,0.0,-1.04,-1.04,0,39,39,0,100,100,0.0,0.0,0.0,0.0,26000.0,26000.0
Cam Smith,Cam Smith,Detroit Tigers,TIGRS,2,3,3,6,1996,1998,2,2.15,3.3,1.15,155,83,-72,547,163,-384,0.0,525.0,525.0,600000.0,1071500.0,471500.0
Canaan Smith-Njigba,Canaan Smith-Njigba,New York Yankees,YANKS,1,4,1,5,2021,2021,0,-0.2,2.23,2.43,9,31,22,3,2,-1,54.0,433.0,379.0,0.0,0.0,0.0
Carl Cavanaugh,Carl Cavanaugh,Detroit Tigers,TIGRS,1,2,1,3,1971,1973,2,0.0,3.07,3.07,0,217,217,0,745,745,0.0,0.0,0.0,0.0,60000.0,60000.0
Carl Chester,Carl Chester,Tampa Bay Devil Rays,RAYS,1,3,3,6,2020,2021,1,2.36,0.0,-2.36,157,0,-157,642,0,-642,0.0,0.0,0.0,0.0,0.0,0.0
Carl Frey,Carl Frey,Wichita,Wichita,1,2,2,4,1928,1928,0,-0.01,0.0,0.01,6,0,-6,9,0,-9,0.0,0.0,0.0,0.0,0.0,0.0
Carl Grovom,Carl Grovom,Houston Astros,ASTROS,1,1,1,2,1988,1988,0,0.0,0.38,0.38,0,74,74,0,289,289,0.0,0.0,0.0,0.0,790909.0,790909.0
Carl South,Carl South,Los Angeles Dodgers,DOGRS,1,1,1,2,1996,1996,0,0.0,-0.05,-0.05,0,15,15,0,18,18,0.0,0.0,0.0,0.0,800000.0,800000.0
Carlos Alfonso,Carlos Alfonso,Houston Astros,ASTROS,2,3,2,5,1975,1984,9,11.67,4.55,-7.12,325,651,326,410,1211,801,3231.0,2344.0,-887.0,0.0,225000.0,225000.0
Carlos De La Cruz,Carlos De La Cruz,Boston Red Sox,RSOX,1,2,1,3,2005,2005,0,0.0,1.03,1.03,0,68,68,0,0,0,0.0,112.0,112.0,0.0,0.0,0.0
Carlos Herrera,Carlos Herrera,Seattle Mariners,MARNRS,1,3,1,4,2015,2016,1,3.41,-0.26,-3.67,178,126,-52,88,430,342,1011.0,0.0,-1011.0,0.0,7500000.0,7500000.0
Carlos Hines,Carlos Hines,Tampa Bay Devil Rays,RAYS,1,1,1,2,2006,2006,0,0.0,0.12,0.12,0,20,20,0,0,0,0.0,60.0,60.0,0.0,387000.0,387000.0
Carlos Melo,Carlos Melo,Detroit Tigers,TIGRS,1,2,1,3,2008,2010,2,0.07,0.88,0.81,11,224,213,0,776,776,44.0,0.0,-44.0,0.0,1600000.0,1600000.0
Carlos Ortega,Carlos Ortega,Los Angeles Dodgers,DOGRS,2,5,5,10,2001,2001,0,0.16,0.96,0.8,66,24,-42,0,27,27,216.0,238.0,22.0,0.0,5950000.0,5950000.0
Carlos Perez,Carlos Perez,Baltimore Orioles,ORLS,1,2,1,3,2006,2007,1,0.0,5.92,5.92,0,267,267,0,1002,1002,0.0,0.0,0.0,0.0,0.0,0.0
Carlos Piste,Carlos Piste,Cincinnati Reds,REDS,1,1,1,2,2006,2007,1,0.0,0.06,0.06,0,4,4,0,15,15,0.0,0.0,0.0,0.0,0.0,0.0
Carlos Portuondo,Carlos Portuondo,Atlanta Braves,BRAVES,2,3,3,6,2017,2017,0,-0.1,1.0,1.1,24,121,97,105,500,395,0.0,0.0,0.0,0.0,0.0,0.0
Carlos Rincon,Carlos Rincon,Los Angeles Dodgers,DOGRS,1,1,1,2,2021,2021,0,0.0,-0.22,-0.22,0,37,37,0,98,98,0.0,0.0,0.0,0.0,0.0,0.0
Carlos Rios,Carlos Rios,Pittsburgh Pirates,PIRATS,1,2,1,3,1982,1987,5,6.94,8.17,1.23,204,340,136,222,296,74,1805.0,2507.0,702.0,0.0,90000.0,90000.0
Carlos Rojas,Carlos Rojas,Baltimore Orioles,ORLS,1,1,1,2,2012,2012,0,0.0,-0.12,-0.12,0,5,5,0,0,0,0.0,12.0,12.0,0.0,0.0,0.0
Carlos Torres,Carlos Torres,Boston Red Sox,RSOX,1,1,1,2,2005,2006,1,0.0,0.23,0.23,0,10,10,0,6,6,0.0,0.0,0.0,0.0,0.0,0.0
Carlos Vargas,Carlos Vargas,Seattle Mariners,MARNRS,1,3,1,4,2017,2017,0,6.86,0.0,-6.86,335,0,-335,833,0,-833,1499.0,0.0,-1499.0,0.0,0.0,0.0
Carlos Vasquez,Carlos Vasquez,Chicago Cubs,CUBS,1,2,1,3,2006,2009,3,-0.4,0.17,0.57,27,164,137,0,1,1,97.0,190.0,93.0,0.0,400000.0,400000.0
Carlos Villalobos,Carlos Villalobos,Seattle Mariners,MARNRS,1,3,2,5,1997,1998,1,0.42,-0.64,-1.06,53,29,-24,0,2,2,389.0,290.0,-99.0,1300000.0,1410000.0,110000.0
Carlos Villalobos,Carlos Villalobos,Detroit Tigers,TIGRS,3,10,6,16,1999,2002,3,3.62,7.62,4.0,1493,652,-841,3797,1742,-2055,861.0,1164.0,303.0,6750000.0,3640000.0,-3110000.0
Carlton Smith,Carlton Smith,Cleveland Indians,INDINS,1,2,2,4,2011,2011,0,0.0,-0.5,-0.5,0,59,59,0,258,258,0.0,0.0,0.0,0.0,14500000.0,14500000.0
Carson Carroll,Carson Carroll,Minnesota Twins,TWINS,1,1,1,2,1984,1984,0,0.0,-0.7,-0.7,0,14,14,0,43,43,0.0,0.0,0.0,0.0,280000.0,280000.0
Carson Ragsdale,Carson Ragsdale,Philadelphia Phillies,PHILS,1,1,1,2,2021,2021,0,0.0,0.39,0.39,0,82,82,0,1,1,0.0,127.0,127.0,0.0,0.0,0.0
Carter Bins,Carter Bins,Seattle Mariners,MARNRS,1,2,1,3,2021,2021,0,0.0,0.27,0.27,0,14,14,0,3,3,0.0,191.0,191.0,0.0,2500000.0,2500000.0
Cary Ammons,Cary Ammons,Kansas City Royals,ROYALS,1,1,1,2,2001,2002,1,0.0,-0.37,-0.37,0,89,89,0,189,189,0.0,0.0,0.0,0.0,225000.0,225000.0
Case Williams,Case Williams,Colorado Rockies,ROCKS,1,2,2,4,2020,2020,0,1.03,0.0,-1.03,61,0,-61,16,0,-16,219.0,0.0,-219.0,0.0,0.0,0.0
Case Williams,Case Williams,Cincinnati Reds,REDS,1,2,1,3,2021,2021,0,0.0,0.31,0.31,0,46,46,0,0,0,0.0,64.0,64.0,0.0,4050000.0,4050000.0
Casey Erickson,Casey Erickson,New York Yankees,YANKS,1,2,2,4,2009,2009,0,-0.08,0.01,0.09,52,39,-13,126,98,-28,0.0,0.0,0.0,0.0,1500000.0,1500000.0
Casey Gillaspie,Casey Gillaspie,Tampa Bay Devil Rays,RAYS,1,1,1,2,2017,2018,1,0.0,0.28,0.28,0,32,32,0,0,0,0.0,55.0,55.0,0.0,1400000.0,1400000.0
Casey Meisner,Casey Meisner,New York Mets,METS,1,1,2,3,2015,2015,0,0.0,0.29,0.29,0,61,61,0,1,1,0.0,97.0,97.0,0.0,8300001.0,8300001.0
Casey Meisner,Casey Meisner,Oakland Athletics,ATLTCS,1,1,1,2,2018,2018,0,0.0,-0.21,-0.21,0,9,9,0,0,0,0.0,43.0,43.0,0.0,0.0,0.0
Casey Weathers,Casey Weathers,Colorado Rockies,ROCKS,1,2,2,4,2011,2018,7,0.03,17.66,17.63,55,1081,1026,202,4267,4065,0.0,0.0,0.0,2287500.0,440000.0,-1847500.0
Cesar Mejia,Cesar Mejia,Detroit Tigers,TIGRS,1,3,1,4,1988,1989,1,23.49,1.15,-22.34,894,144,-750,3339,504,-2835,0.0,0.0,0.0,0.0,1540000.0,1540000.0
Cesar Mejia,Cesar Mejia,Baltimore Orioles,ORLS,1,2,2,4,1989,1989,0,-0.15,0.0,0.15,8,0,-8,9,0,-9,0.0,0.0,0.0,0.0,0.0,0.0
Cesar Rojas,Cesar Rojas,San Diego Padres,PADRS,1,2,2,4,2006,2006,0,0.07,0.0,-0.07,17,0,-17,15,0,-15,0.0,0.0,0.0,0.0,0.0,0.0
Cesar Saba,Cesar Saba,Boston Red Sox,RSOX,1,2,1,3,2000,2000,0,-1.48,-0.14,1.34,52,33,-19,23,123,100,259.0,0.0,-259.0,0.0,800000.0,800000.0
Chaad Stewart,Chaad Stewart,Baltimore Orioles,ORLS,2,3,2,5,1995,1996,1,0.29,-0.9,-1.19,94,78,-16,3,263,260,185.0,174.0,-11.0,2934000.0,4250000.0,1316000.0
Chad Blackwell,Chad Blackwell,Kansas City Royals,ROYALS,1,2,1,3,2005,2006,1,-1.27,0.11,1.38,95,30,-65,0,3,3,157.0,501.0,344.0,0.0,4500000.0,4500000.0
Chad Green,Chad Green,Milwaukee Brewers,BREWRS,1,2,2,4,2000,2001,1,-0.17,-1.16,-0.99,43,82,39,97,8,-89,0.0,184.0,184.0,0.0,230000.0,230000.0
Chad Hartvigson,Chad Hartvigson,San Francisco Giants,GIANTS,1,1,1,2,1997,1999,2,0.0,-0.19,-0.19,0,23,23,0,1,1,0.0,39.0,39.0,0.0,0.0,0.0
Chad Petty,Chad Petty,Detroit Tigers,TIGRS,1,2,1,3,2003,2005,2,0.0,0.33,0.33,0,180,180,0,775,775,0.0,0.0,0.0,0.0,340000.0,340000.0
Chad Ricketts,Chad Ricketts,Chicago Cubs,CUBS,2,4,5,9,1999,2002,3,1.82,4.66,2.84,231,348,117,64,1392,1328,872.0,299.0,-573.0,6473500.0,8775000.0,2301500.0
Chad Ricketts,Chad Ricketts,Los Angeles Dodgers,DOGRS,2,3,3,6,2001,2006,5,-1.54,8.97,10.51,109,957,848,286,2429,2143,215.0,683.0,468.0,3400000.0,10800000.0,7400000.0
Chad Smith,Chad Smith,Miami Marlins,MARLNS,1,1,1,2,2020,2020,0,0.0,0.2,0.2,0,3,3,0,0,0,0.0,15.0,15.0,0.0,0.0,0.0
Chad Spanberger,Chad Spanberger,Colorado Rockies,ROCKS,1,3,1,4,2018,2019,1,0.04,0.16,0.12,1,90,89,0,0,0,3.0,119.0,116.0,0.0,0.0,0.0
Chad Spanberger,Chad Spanberger,Toronto Blue Jays,BJAYS,1,1,1,2,2019,2020,1,0.0,-0.44,-0.44,0,10,10,0,0,0,0.0,101.0,101.0,0.0,6500000.0,6500000.0
Chad Tracy,Chad Tracy,Texas Rangers,RNGRS,1,1,1,2,2012,2012,0,0.0,0.0,0.0,0,0,0,0,0,0,0.0,0.0,0.0,0.0,0.0,0.0
Charles Basford,Charles Basford,New York Yankees,YANKS,1,1,1,2,2013,2013,0,0.0,0.0,0.0,0,0,0,0,0,0,0.0,0.0,0.0,0.0,493000.0,493000.0
Charles Glock,Charles Glock,Cincinnati Reds,REDS,1,3,1,4,1939,1939,0,0.0,-0.1,-0.1,0,6,6,0,14,14,0.0,0.0,0.0,0.0,0.0,0.0
Charles Glock,Charles Glock,Atlanta,Atlanta,1,1,1,2,1948,1950,2,0.0,0.0,0.0,0,0,0,0,0,0,0.0,0.0,0.0,0.0,0.0,0.0
Charles Miller,Charles Miller,Chicago Cubs,CUBS,1,2,1,3,1906,1906,0,0.0,0.0,0.0,0,1,1,0,1,1,0.0,0.0,0.0,0.0,0.0,0.0
Charles Poe,Charles Poe,Chicago White Sox,WSOX,1,2,1,3,1996,1996,0,-0.05,0.57,0.62,12,132,120,0,541,541,89.0,0.0,-89.0,0.0,0.0,0.0
Charles Sipple,Charles Sipple,Cleveland Indians,INDINS,1,3,2,5,1952,1960,8,-0.35,6.71,7.06,19,748,729,60,2451,2391,0.0,35.0,35.0,10000.0,0.0,-10000.0
Charlie Corbell,Charlie Corbell,San Francisco Giants,GIANTS,1,1,1,2,1988,1997,9,0.0,7.12,7.12,0,827,827,0,18,18,0.0,1389.0,1389.0,0.0,0.0,0.0
Charlie Nail,Charlie Nail,Detroit Tigers,TIGRS,1,1,1,2,1984,1984,0,0.0,0.0,0.0,0,0,0,0,0,0,0.0,0.0,0.0,0.0,0.0,0.0
Charlie Scott,Charlie Scott,Cleveland Indians,INDINS,1,1,1,2,1990,1991,1,0.0,0.0,0.0,0,0,0,0,0,0,0.0,0.0,0.0,0.0,0.0,0.0
Chase Fontaine,Chase Fontaine,Atlanta Braves,BRAVES,1,2,1,3,2008,2009,1,1.25,0.21,-1.04,300,18,-282,1007,0,-1007,0.0,29.0,29.0,0.0,0.0,0.0
Chase Weems,Chase Weems,New York Yankees,YANKS,1,1,1,2,2009,2009,0,0.0,0.6,0.6,0,45,45,0,93,93,0.0,0.0,0.0,0.0,2000000.0,2000000.0
Chester Trail,Chester Trail,New York Yankees,YANKS,1,4,1,5,1967,1968,1,0.0,-0.05,-0.05,0,74,74,0,79,79,0.0,678.0,678.0,0.0,0.0,0.0
Chico Vaughns,Chico Vaughns,Milwaukee Brewers,BREWRS,1,1,1,2,1972,1972,0,0.0,0.0,0.0,0,0,0,0,0,0,0.0,0.0,0.0,0.0,0.0,0.0
Chih Hsien Chiang,Chih Hsien Chiang,Boston Red Sox,RSOX,1,4,2,6,2011,2012,1,0.0,0.23,0.23,0,8,8,0,0,0,0.0,114.0,114.0,0.0,1000000.0,1000000.0
Chris Alvarez,Chris Alvarez,Chicago White Sox,WSOX,4,8,9,17,1986,1996,10,8.12,26.46,18.34,1204,1239,35,3582,5184,1602,266.0,488.0,222.0,4896500.0,2055555.0,-2840945.0
Chris Balcom-Miller,Chris Balcom-Miller,Colorado Rockies,ROCKS,1,1,2,3,2010,2010,0,0.0,-0.13,-0.13,0,18,18,0,1,1,0.0,25.0,25.0,0.0,905000.0,905000.0
Chris Bayer,Chris Bayer,Boston Red Sox,RSOX,7,15,13,28,1985,1993,8,20.97,19.79,-1.18,2048,1909,-139,3771,4732,961,4874.0,3574.0,-1300.0,3550000.0,2472500.0,-1077500.0
Chris Buglovsky,Chris Buglovsky,Colorado Rockies,ROCKS,2,2,2,4,2003,2006,3,-0.07,-1.16,-1.09,18,139,121,0,12,12,20.0,311.0,291.0,318000.0,0.0,-318000.0
Chris Calvert,Chris Calvert,Minnesota Twins,TWINS,2,2,2,4,1988,1989,1,-0.42,0.47,0.89,18,36,18,0,0,0,42.0,457.0,415.0,0.0,0.0,0.0
Chris Clark,Chris Clark,San Diego Padres,PADRS,1,1,1,2,1997,1999,2,0.0,-0.72,-0.72,0,30,30,0,0,0,0.0,25.0,25.0,0.0,0.0,0.0
Chris Cody,Chris Cody,Detroit Tigers,TIGRS,3,3,3,6,2007,2008,1,-0.6,0.0,0.6,100,26,-74,6,0,-6,171.0,99.0,-72.0,395000.0,0.0,-395000.0
Chris Corn,Chris Corn,New York Yankees,YANKS,3,4,4,8,1996,1999,3,8.82,0.9,-7.92,626,120,-506,2195,467,-1728,0.0,0.0,0.0,1700000.0,1750000.0,50000.0
Chris DeWitt,Chris DeWitt,New York Mets,METS,1,1,1,2,1996,2001,5,0.0,-0.56,-0.56,0,454,454,0,715,715,0.0,4.0,4.0,0.0,0.0,0.0
Chris Fallon,Chris Fallon,Kansas City Royals,ROYALS,1,3,1,4,2004,2006,2,-0.1,-0.25,-0.15,24,15,-9,1,0,-1,42.0,75.0,33.0,0.0,0.0,0.0
Chris Jensen,Chris Jensen,Colorado Rockies,ROCKS,1,2,2,4,2013,2014,1,1.75,1.05,-0.7,79,16,-63,0,15,15,465.0,130.0,-335.0,0.0,5750000.0,5750000.0
Chris Jones,Chris Jones,Cleveland Indians,INDINS,1,1,2,3,2011,2012,1,0.0,-0.36,-0.36,0,23,23,0,4,4,0.0,357.0,357.0,0.0,15000000.0,15000000.0
Chris Jones,Chris Jones,Atlanta Braves,BRAVES,1,1,1,2,2013,2013,0,0.0,0.43,0.43,0,73,73,0,0,0,0.0,93.0,93.0,0.0,0.0,0.0
Chris Maffett,Chris Maffett,Cleveland Indians,INDINS,4,5,4,9,1992,1994,2,0.28,1.85,1.57,412,216,-196,1134,642,-492,15.0,40.0,25.0,325000.0,975500.0,650500.0
Chris Malone,Chris Malone,Colorado Rockies,ROCKS,1,2,1,3,2011,2012,1,0.0,0.0,0.0,0,0,0,0,0,0,0.0,0.0,0.0,0.0,0.0,0.0
Chris Manno,Chris Manno,Washington Nationals,NATEX,1,2,2,4,2011,2011,0,0.0,-0.17,-0.17,0,43,43,0,107,107,0.0,0.0,0.0,0.0,1750000.0,1750000.0
Chris Morris,Chris Morris,St. Louis Cardinals,CARDS,1,2,2,4,2002,2002,0,0.04,0.01,-0.03,8,8,0,1,6,5,12.0,45.0,33.0,300000.0,4250000.0,3950000.0
Chris Mowday,Chris Mowday,Toronto Blue Jays,BJAYS,1,2,1,3,2002,2003,1,0.04,0.58,0.54,8,33,25,26,6,-20,0.0,578.0,578.0,0.0,2550000.0,2550000.0
Chris Myers,Chris Myers,Baltimore Orioles,ORLS,1,1,1,2,1991,1992,1,0.0,-0.34,-0.34,0,2,2,0,0,0,0.0,20.0,20.0,0.0,0.0,0.0
Chris O'Brien,Chris O'Brien,Los Angeles Dodgers,DOGRS,1,2,3,5,2015,2015,0,0.0,0.0,0.0,0,0,0,0,0,0,0.0,0.0,0.0,0.0,0.0,0.0
Chris O'Dowd,Chris O'Dowd,Colorado Rockies,ROCKS,1,2,2,4,2015,2016,1,0.0,-0.37,-0.37,0,36,36,0,27,27,0.0,241.0,241.0,0.0,0.0,0.0
Chris Oliver,Chris Oliver,Philadelphia Phillies,PHILS,1,3,1,4,2015,2015,0,0.0,0.0,0.0,0,0,0,0,0,0,0.0,0.0,0.0,0.0,0.0,0.0
Chris Province,Chris Province,Boston Red Sox,RSOX,1,1,1,2,2009,2010,1,0.0,-0.12,-0.12,0,2,2,0,0,0,0.0,6.0,6.0,0.0,0.0,0.0
Chris Tierney,Chris Tierney,Kansas City Royals,ROYALS,1,2,1,3,2003,2003,0,0.0,0.89,0.89,0,22,22,0,85,85,0.0,0.0,0.0,0.0,5500000.0,5500000.0
Chris Torres,Chris Torres,Seattle Mariners,MARNRS,1,3,2,5,2017,2020,3,-0.89,1.81,2.7,38,291,253,23,1091,1068,267.0,0.0,-267.0,0.0,7800000.0,7800000.0
Chris Vallimont,Chris Vallimont,Miami Marlins,MARLNS,1,3,1,4,2019,2019,0,0.34,0.0,-0.34,55,0,-55,0,0,0,128.0,0.0,-128.0,2500000.0,0.0,-2500000.0
Chris Van Rossum,Chris Van Rossum,San Francisco Giants,GIANTS,2,3,3,6,1998,2006,8,0.78,7.92,7.14,162,796,634,1,75,74,211.0,1209.0,998.0,3050000.0,1435000.0,-1615000.0
Chris White,Chris White,Cleveland Indians,INDINS,2,3,4,7,2003,2004,1,0.71,-0.61,-1.32,50,65,15,2,0,-2,739.0,235.0,-504.0,1500000.0,0.0,-1500000.0
Chris Wimmer,Chris Wimmer,San Francisco Giants,GIANTS,3,5,5,10,1996,2005,9,8.05,10.51,2.46,534,1493,959,1552,4581,3029,1216.0,932.0,-284.0,865000.0,725000.0,-140000.0
Christian Bridenbaugh,Christian Bridenbaugh,Los Angeles Dodgers,DOGRS,2,3,2,5,2001,2004,3,0.31,4.7,4.39,45,302,257,101,1189,1088,0.0,0.0,0.0,975000.0,212000.0,-763000.0
Christian Lara,Christian Lara,Boston Red Sox,RSOX,1,2,1,3,2008,2008,0,0.0,0.0,0.0,0,0,0,0,0,0,0.0,0.0,0.0,0.0,0.0,0.0
Christian Rojas,Christian Rojas,Cincinnati Reds,REDS,1,2,1,3,1998,1998,0,0.0,-1.7,-1.7,0,31,31,0,4,4,0.0,79.0,79.0,0.0,205000.0,205000.0
Chuck Baldwin,Chuck Baldwin,Cleveland Indians,INDINS,1,1,1,2,1989,1989,0,0.0,-0.55,-0.55,0,12,12,0,29,29,0.0,0.0,0.0,0.0,0.0,0.0
Chuck Dougherty,Chuck Dougherty,Oakland Athletics,ATLTCS,1,3,2,5,1981,1983,2,-0.62,1.11,1.73,74,210,136,201,288,87,0.0,1046.0,1046.0,0.0,0.0,0.0
Chuck Erickson,Chuck Erickson,Boston Red Sox,RSOX,1,2,1,3,1975,1976,1,0.0,-0.13,-0.13,0,18,18,0,55,55,0.0,0.0,0.0,0.0,0.0,0.0
Chuck Everson,Chuck Everson,Detroit Tigers,TIGRS,1,1,1,2,1990,1991,1,0.0,2.28,2.28,0,104,104,0,0,0,0.0,474.0,474.0,0.0,0.0,0.0
Chuck Loseth,Chuck Loseth,Milwaukee Brewers,BREWRS,10,16,19,35,1971,1986,15,43.81,45.76,1.95,2829,2561,-268,7569,6589,-980,5854.0,7527.0,1673.0,612800.0,15000.0,-597800.0
Chuck Mount,Chuck Mount,Kansas City Royals,ROYALS,2,5,3,8,1987,1989,2,6.71,1.86,-4.85,503,45,-458,494,0,-494,4503.0,794.0,-3709.0,62500.0,930000.0,867500.0
Chuck Mount,Chuck Mount,Chicago White Sox,WSOX,2,2,2,4,1989,1992,3,-0.18,0.0,0.18,14,0,-14,1,0,-1,36.0,0.0,-36.0,0.0,0.0,0.0
Chuck Ross,Chuck Ross,Boston Red Sox,RSOX,1,2,1,3,1976,1978,2,0.0,-0.1,-0.1,0,254,254,0,961,961,0.0,0.0,0.0,0.0,0.0,0.0
Chuck Rowland,Chuck Rowland,Philadelphia Athletics,ATLTCS,3,9,5,14,1924,1935,11,15.67,38.22,22.55,391,1328,937,1453,5363,3910,735.0,0.0,-735.0,39667.0,10400.0,-29267.0
Chuck Staniland,Chuck Staniland,St. Louis Cardinals,CARDS,2,3,4,7,1959,1962,3,0.6,1.14,0.54,42,87,45,78,232,154,0.0,0.0,0.0,0.0,0.0,0.0
Chuck Tiffany,Chuck Tiffany,Los Angeles Dodgers,DOGRS,3,6,4,10,2006,2008,2,2.19,-0.23,-2.42,275,388,113,424,385,-39,1172.0,396.0,-776.0,4405000.0,800923.0,-3604077.0
Claude Rohwer,Claude Rohwer,Pittsburgh Pirates,PIRATS,1,5,1,6,1922,1922,0,0.0,0.0,0.0,0,0,0,0,0,0,0.0,0.0,0.0,2700.0,0.0,-2700.0
Clayton Daniel,Clayton Daniel,Chicago Cubs,CUBS,1,1,1,2,2020,2020,0,0.0,-0.14,-0.14,0,10,10,0,0,0,0.0,28.0,28.0,0.0,0.0,0.0
Clayton Hamilton,Clayton Hamilton,San Diego Padres,PADRS,1,1,1,2,2005,2006,1,0.0,0.0,0.0,0,0,0,0,0,0,0.0,0.0,0.0,0.0,326000.0,326000.0
Cleuluis Rondon,Cleuluis Rondon,Boston Red Sox,RSOX,3,8,6,14,2013,2020,7,1.74,3.1,1.36,152,304,152,96,10,-86,1036.0,1375.0,339.0,5113000.0,0.0,-5113000.0
Clint Brannon,Clint Brannon,Texas Rangers,RNGRS,1,1,1,2,2005,2006,1,0.0,0.0,0.0,0,0,0,0,0,0,0.0,0.0,0.0,0.0,300000.0,300000.0
Clint Everts,Clint Everts,New York Mets,METS,1,1,1,2,2010,2010,0,0.0,0.0,0.0,0,0,0,0,0,0,0.0,0.0,0.0,0.0,0.0,0.0
Clyde Keller,Clyde Keller,St. Louis Cardinals,CARDS,1,1,1,2,1991,1992,1,0.0,0.08,0.08,0,22,22,0,76,76,0.0,0.0,0.0,0.0,0.0,0.0
Clyde Parris,Clyde Parris,Los Angeles Dodgers,DOGRS,2,3,3,6,1960,1961,1,-0.97,0.0,0.97,59,0,-59,114,0,-114,63.0,0.0,-63.0,0.0,0.0,0.0
Cobi Cradle,Cobi Cradle,Cincinnati Reds,REDS,2,3,2,5,1995,1995,0,-1.55,-0.06,1.49,126,4,-122,291,0,-291,0.0,3.0,3.0,0.0,118500.0,118500.0
Cody Bohanek,Cody Bohanek,Houston Astros,ASTROS,1,2,3,5,2019,2019,0,2.03,0.0,-2.03,269,0,-269,893,0,-893,0.0,0.0,0.0,0.0,0.0,0.0
Cody Thomas,Cody Thomas,Los Angeles Dodgers,DOGRS,1,2,2,4,2021,2021,0,-0.38,-0.48,-0.1,13,33,20,0,66,66,27.0,0.0,-27.0,0.0,0.0,0.0
Cole Nelson,Cole Nelson,Detroit Tigers,TIGRS,1,2,1,3,2011,2012,1,0.02,-0.57,-0.59,18,191,173,0,786,786,64.0,0.0,-64.0,0.0,5375000.0,5375000.0
Cole Wilcox,Cole Wilcox,San Diego Padres,PADRS,1,4,1,5,2020,2020,0,1.51,0.0,-1.51,105,0,-105,277,0,-277,238.0,0.0,-238.0,0.0,7600000.0,7600000.0
Colin Charland,Colin Charland,California Angels,ANGELS,1,2,1,3,1990,1992,2,-0.04,-1.98,-1.94,120,101,-19,352,0,-352,0.0,377.0,377.0,0.0,0.0,0.0
Colton Cain,Colton Cain,Pittsburgh Pirates,PIRATS,1,3,1,4,2012,2014,2,1.62,0.18,-1.44,191,63,-128,764,59,-705,17.0,493.0,476.0,0.0,0.0,0.0
Colton Turner,Colton Turner,Toronto Blue Jays,BJAYS,1,1,1,2,2016,2016,0,0.0,-0.17,-0.17,0,16,16,0,36,36,0.0,0.0,0.0,0.0,0.0,0.0
Conner Capel,Conner Capel,Cleveland Indians,INDINS,1,2,1,3,2018,2018,0,0.0,0.0,0.0,0,0,0,0,0,0,0.0,0.0,0.0,0.0,0.0,0.0
Connor Cannon,Connor Cannon,San Francisco Giants,GIANTS,1,2,1,3,2021,2021,0,0.95,0.0,-0.95,52,65,13,0,175,175,128.0,3.0,-125.0,925000.0,0.0,-925000.0
Connor Graham,Connor Graham,Colorado Rockies,ROCKS,1,1,1,2,2009,2015,6,0.0,6.3,6.3,0,606,606,0,0,0,0.0,827.0,827.0,0.0,3350000.0,3350000.0
Connor Panas,Connor Panas,Toronto Blue Jays,BJAYS,1,1,2,3,2018,2019,1,0.0,-0.17,-0.17,0,10,10,0,0,0,0.0,136.0,136.0,0.0,3000000.0,3000000.0
Conor Lillis-White,Conor Lillis-White,Anaheim Angels,ANGELS,2,2,2,4,2018,2021,3,0.42,1.93,1.51,27,114,87,111,456,345,0.0,0.0,0.0,3250000.0,950000.0,-2300000.0
Cooper Hummel,Cooper Hummel,Milwaukee Brewers,BREWRS,1,2,1,3,2021,2021,0,0.0,0.3,0.3,0,48,48,0,199,199,0.0,0.0,0.0,0.0,7666667.0,7666667.0
Corey Black,Corey Black,New York Yankees,YANKS,1,1,2,3,2013,2014,1,0.0,0.9,0.9,0,125,125,0,481,481,0.0,0.0,0.0,0.0,0.0,0.0
Corey Brittan,Corey Brittan,New York Mets,METS,1,1,1,2,2002,2002,0,0.0,-0.32,-0.32,0,32,32,0,0,0,0.0,42.0,42.0,0.0,0.0,0.0
Corey Coles,Corey Coles,New York Mets,METS,2,3,3,6,2008,2012,4,6.46,12.32,5.86,583,640,57,2471,2080,-391,0.0,191.0,191.0,3500000.0,3850000.0,350000.0
Corey Copping,Corey Copping,Los Angeles Dodgers,DOGRS,1,1,1,2,2018,2018,0,0.0,-0.4,-0.4,0,10,10,0,0,0,0.0,11.0,11.0,0.0,1500000.0,1500000.0
Corey Jenkins,Corey Jenkins,Boston Red Sox,RSOX,1,1,1,2,1998,1998,0,0.0,-0.08,-0.08,0,8,8,0,14,14,0.0,0.0,0.0,0.0,190000.0,190000.0
Corey Littrell,Corey Littrell,Boston Red Sox,RSOX,1,3,2,5,2014,2018,4,5.3,1.43,-3.87,83,264,181,89,204,115,836.0,1078.0,242.0,0.0,0.0,0.0
Corey Pointer,Corey Pointer,Atlanta Braves,BRAVES,3,9,6,15,1996,2002,6,32.33,18.19,-14.14,1723,1238,-485,5218,2155,-3063,3645.0,2345.0,-1300.0,12631500.0,14051680.0,1420180.0
Corey Wimberly,Corey Wimberly,Colorado Rockies,ROCKS,1,1,1,2,2009,2009,0,0.0,-0.05,-0.05,0,29,29,0,56,56,0.0,0.0,0.0,0.0,0.0,0.0
Corey Wimberly,Corey Wimberly,Oakland Athletics,ATLTCS,4,5,4,9,2010,2014,4,3.45,5.86,2.41,352,341,-11,551,854,303,434.0,601.0,167.0,3675000.0,3200000.0,-475000.0
Cory Keylor,Cory Keylor,Baltimore Orioles,ORLS,1,1,1,2,2007,2007,0,0.0,-0.12,-0.12,0,11,11,0,36,36,0.0,0.0,0.0,0.0,0.0,0.0
Cory Stewart,Cory Stewart,San Diego Padres,PADRS,1,3,1,4,2003,2009,6,19.18,17.35,-1.83,859,833,-26,3184,3689,505,1194.0,0.0,-1194.0,305000.0,8833333.0,8528333.0
Craig Bullock,Craig Bullock,San Diego Padres,PADRS,2,2,2,4,1992,1993,1,0.0,0.01,0.01,0,55,55,0,5,5,0.0,95.0,95.0,0.0,0.0,0.0
Craig Hendrickson,Craig Hendrickson,California Angels,ANGELS,1,1,1,2,1977,1978,1,0.0,-0.62,-0.62,0,6,6,0,0,0,0.0,55.0,55.0,0.0,52000.0,52000.0
Craig Italiano,Craig Italiano,Oakland Athletics,ATLTCS,2,5,3,8,2009,2016,7,1.67,5.28,3.61,416,684,268,588,2314,1726,340.0,0.0,-340.0,410000.0,1250000.0,840000.0
Craig Landis,Craig Landis,San Francisco Giants,GIANTS,2,3,3,6,1980,1984,4,-0.65,4.3,4.95,76,142,66,15,92,77,517.0,884.0,367.0,0.0,150000.0,150000.0
Craig Pueschner,Craig Pueschner,San Diego Padres,PADRS,1,2,1,3,1991,1992,1,4.78,-0.97,-5.75,230,132,-98,937,8,-929,0.0,239.0,239.0,675000.0,2000000.0,1325000.0
Craig Repoz,Craig Repoz,New York Mets,METS,2,3,2,5,1990,1991,1,0.0,-0.36,-0.36,0,97,97,0,306,306,0.0,0.0,0.0,0.0,825000.0,825000.0
Craig Stem,Craig Stem,Los Angeles Dodgers,DOGRS,1,1,1,2,2014,2015,1,0.0,0.0,0.0,0,0,0,0,0,0,0.0,0.0,0.0,0.0,0.0,0.0
Craig Weissmann,Craig Weissmann,Chicago Cubs,CUBS,1,2,1,3,1983,1985,2,0.0,-1.38,-1.38,0,103,103,0,175,175,0.0,0.0,0.0,0.0,0.0,0.0
Cristian Perez,Cristian Perez,Kansas City Royals,ROYALS,1,1,1,2,2019,2021,2,0.0,-0.19,-0.19,0,6,6,0,0,0,0.0,26.0,26.0,0.0,556725.0,556725.0
Curtis Mead,Curtis Mead,Philadelphia Phillies,PHILS,1,1,1,2,2019,2019,0,0.0,0.0,0.0,0,0,0,0,0,0,0.0,0.0,0.0,0.0,0.0,0.0
Curtis Taylor,Curtis Taylor,Arizona Diamondbacks,DBACKS,1,1,1,2,2017,2018,1,0.0,-0.93,-0.93,0,118,118,0,0,0,0.0,160.0,160.0,0.0,1600000.0,1600000.0
Curtis Taylor,Curtis Taylor,Tampa Bay Devil Rays,RAYS,1,2,1,3,2019,2019,0,0.0,0.71,0.71,0,37,37,0,119,119,0.0,0.0,0.0,0.0,100000.0,100000.0
Cutter Dykstra,Cutter Dykstra,Milwaukee Brewers,BREWRS,1,2,1,3,2011,2012,1,0.0,2.79,2.79,0,241,241,0,751,751,0.0,0.0,0.0,0.0,0.0,0.0
D'Andre Toney,D'Andre Toney,Kansas City Royals,ROYALS,1,2,2,4,2012,2012,0,0.42,-0.3,-0.72,60,73,13,0,210,210,165.0,0.0,-165.0,0.0,0.0,0.0
D.J. Boston,D.J. Boston,Toronto Blue Jays,BJAYS,1,1,1,2,1996,1998,2,0.0,0.4,0.4,0,148,148,0,531,531,0.0,0.0,0.0,0.0,350000.0,350000.0
D.L. Smith,D.L. Smith,Baltimore Orioles,ORLS,1,2,1,3,1988,1988,0,0.0,0.0,0.0,0,0,0,0,0,0,0.0,0.0,0.0,0.0,0.0,0.0
Dairon Blanco,Dairon Blanco,Oakland Athletics,ATLTCS,1,2,1,3,2019,2021,2,0.0,1.78,1.78,0,121,121,0,1,1,0.0,307.0,307.0,0.0,2250000.0,2250000.0
Dakota Chalmers,Dakota Chalmers,Oakland Athletics,ATLTCS,1,1,1,2,2018,2019,1,0.0,-0.42,-0.42,0,41,41,0,0,0,0.0,105.0,105.0,0.0,0.0,0.0
Dale Spier,Dale Spier,New York Yankees,YANKS,17,30,29,59,1972,1997,25,45.9,39.67,-6.23,3504,3041,-463,6462,7164,702,12175.0,8022.0,-4153.0,4780000.0,3079500.0,-1700500.0
Dallas Buck,Dallas Buck,Arizona Diamondbacks,DBACKS,1,3,2,5,2008,2008,0,-0.17,-0.36,-0.19,138,44,-94,113,187,74,459.0,0.0,-459.0,402000.0,13000000.0,12598000.0
Dallas Trahern,Dallas Trahern,Detroit Tigers,TIGRS,2,8,3,11,2007,2010,3,-0.1,-1.19,-1.09,705,27,-678,1077,3,-1074,1506.0,303.0,-1203.0,12380000.0,13850000.0,1470000.0
Dalton Kelly,Dalton Kelly,Seattle Mariners,MARNRS,1,3,2,5,2016,2018,2,1.91,-0.63,-2.54,161,100,-61,1,297,296,549.0,3.0,-546.0,0.0,0.0,0.0
Dalton Von Schamann,Dalton Von Schamann,Los Angeles Dodgers,DOGRS,1,1,1,2,2014,2014,0,0.0,0.0,0.0,0,0,0,0,0,0,0.0,0.0,0.0,0.0,0.0,0.0
Damaso Espino,Damaso Espino,Cincinnati Reds,REDS,2,4,5,9,2003,2007,4,0.0,-0.29,-0.29,0,166,166,0,79,79,0.0,223.0,223.0,0.0,0.0,0.0
Damon Casetta-Stubbs,Damon Casetta-Stubbs,Seattle Mariners,MARNRS,1,1,1,2,2021,2021,0,0.0,-0.04,-0.04,0,72,72,0,202,202,0.0,0.0,0.0,0.0,0.0,0.0
Damon Farmar,Damon Farmar,Chicago Cubs,CUBS,2,3,2,5,1985,1988,3,0.84,4.57,3.73,84,482,398,169,531,362,0.0,631.0,631.0,490000.0,280000.0,-210000.0
Dan Cataline,Dan Cataline,Chicago Cubs,CUBS,3,4,3,7,1983,1988,5,1.79,5.67,3.88,345,610,265,964,2221,1257,0.0,37.0,37.0,0.0,0.0,0.0
Dan DeYoung,Dan DeYoung,Texas Rangers,RNGRS,1,2,1,3,1998,1999,1,0.0,3.05,3.05,0,208,208,0,869,869,0.0,0.0,0.0,0.0,0.0,0.0
Dan Denham,Dan Denham,Oakland Athletics,ATLTCS,1,1,1,2,2007,2007,0,0.0,0.0,0.0,0,0,0,0,0,0,0.0,0.0,0.0,0.0,0.0,0.0
Dan Ford,Dan Ford,St. Louis Cardinals,CARDS,1,2,1,3,1971,1972,1,0.0,0.65,0.65,0,20,20,0,1,1,0.0,38.0,38.0,0.0,40000.0,40000.0
Dan Grunhard,Dan Grunhard,California Angels,ANGELS,1,1,1,2,1992,1992,0,0.0,0.0,0.0,0,0,0,0,0,0,0.0,0.0,0.0,0.0,0.0,0.0
Dan McKinley,Dan McKinley,San Francisco Giants,GIANTS,2,3,2,5,1999,2000,1,-0.22,0.45,0.67,53,114,61,0,1,1,225.0,174.0,-51.0,0.0,687500.0,687500.0
Dan Winters,Dan Winters,Oakland Athletics,ATLTCS,1,2,1,3,1985,1986,1,0.0,2.32,2.32,0,194,194,0,667,667,0.0,0.0,0.0,0.0,0.0,0.0
Dana Ridenour,Dana Ridenour,New York Yankees,YANKS,1,1,1,2,1989,1991,2,0.0,-0.57,-0.57,0,226,226,0,641,641,0.0,0.0,0.0,0.0,0.0,0.0
Dane Acker,Dane Acker,Oakland Athletics,ATLTCS,1,3,3,6,2021,2021,0,-0.26,0.18,0.44,104,178,74,346,635,289,0.0,0.0,0.0,0.0,0.0,0.0
Daniel Brady,Daniel Brady,New York Yankees,YANKS,1,4,1,5,1967,1968,1,0.0,-0.05,-0.05,0,74,74,0,79,79,0.0,678.0,678.0,0.0,0.0,0.0
Daniel Haigwood,Daniel Haigwood,Chicago White Sox,WSOX,2,5,3,8,2005,2009,4,5.6,12.08,6.48,287,529,242,1146,2165,1019,0.0,0.0,0.0,15000000.0,13166667.0,-1833333.0
Daniel Haigwood,Daniel Haigwood,Philadelphia Phillies,PHILS,2,3,2,5,2006,2009,3,0.0,1.44,1.44,0,166,166,0,151,151,0.0,106.0,106.0,0.0,1952000.0,1952000.0
Daniel Loomer,Daniel Loomer,California Angels,ANGELS,1,2,1,3,1970,1970,0,0.0,0.0,0.0,0,0,0,0,0,0,0.0,0.0,0.0,0.0,0.0,0.0
Daniel Missaki,Daniel Missaki,Seattle Mariners,MARNRS,1,3,1,4,2015,2016,1,3.41,-0.26,-3.67,178,126,-52,88,430,342,1011.0,0.0,-1011.0,0.0,7500000.0,7500000.0
Daniel Ozoria,Daniel Ozoria,Anaheim Angels,ANGELS,1,1,1,2,2019,2019,0,0.0,0.04,0.04,0,1,1,0,0,0,0.0,7.0,7.0,0.0,0.0,0.0
Daniel Palencia,Daniel Palencia,Oakland Athletics,ATLTCS,1,2,1,3,2021,2021,0,-0.36,1.44,1.8,14,29,15,31,0,-31,0.0,88.0,88.0,0.0,2250000.0,2250000.0
Daniel Rosenbaum,Daniel Rosenbaum,Washington Nationals,NATEX,1,1,1,2,2015,2015,0,0.0,0.0,0.0,0,0,0,0,0,0,0.0,0.0,0.0,0.0,0.0,0.0
Daniel Scarpetta,Daniel Scarpetta,Milwaukee Brewers,BREWRS,4,6,7,13,1983,1991,8,21.39,21.5,0.11,1530,927,-603,1542,2353,811,4939.0,4297.0,-642.0,700000.0,325000.0,-375000.0
Daniel Smith,Daniel Smith,Los Angeles Dodgers,DOGRS,1,2,1,3,1977,1978,1,0.0,-0.13,-0.13,0,59,59,0,113,113,0.0,0.0,0.0,0.0,0.0,0.0
Daniel Turpen,Daniel Turpen,San Francisco Giants,GIANTS,2,3,2,5,2010,2016,6,1.51,8.03,6.52,247,764,517,434,2472,2038,191.0,287.0,96.0,3850000.0,4655000.0,805000.0
Daniel Turpen,Daniel Turpen,Boston Red Sox,RSOX,1,1,1,2,2011,2011,0,0.0,0.0,0.0,0,0,0,0,0,0,0.0,0.0,0.0,0.0,0.0,0.0
Daniel Turpen,Daniel Turpen,Colorado Rockies,ROCKS,2,3,2,5,2011,2012,1,0.0,0.09,0.09,0,4,4,0,0,0,0.0,6.0,6.0,0.0,2700000.0,2700000.0
Danilo Rivas,Danilo Rivas,Pittsburgh Pirates,PIRATS,1,1,1,2,1971,1976,5,0.0,8.0,8.0,0,526,526,0,42,42,0.0,1043.0,1043.0,0.0,0.0,0.0
Danny Christensen,Danny Christensen,Kansas City Royals,ROYALS,1,1,1,2,2007,2010,3,0.0,0.36,0.36,0,51,51,0,0,0,0.0,157.0,157.0,0.0,0.0,0.0
Danny Gutierrez,Danny Gutierrez,Kansas City Royals,ROYALS,1,1,2,3,2009,2013,4,0.0,-0.11,-0.11,0,5,5,0,17,17,0.0,0.0,0.0,0.0,0.0,0.0
Danny Lynch,Danny Lynch,St. Louis Cardinals,CARDS,1,3,1,4,1953,1953,0,0.0,0.0,0.0,0,0,0,0,0,0,0.0,0.0,0.0,0.0,0.0,0.0
Danny Muegge,Danny Muegge,Arizona Diamondbacks,DBACKS,2,6,2,8,2005,2009,4,0.95,0.24,-0.71,303,273,-30,1104,1118,14,0.0,0.0,0.0,10213898.0,0.0,-10213898.0
Danny Peoples,Danny Peoples,Cleveland Indians,INDINS,3,5,7,12,2001,2008,7,0.76,6.93,6.17,461,824,363,1426,2856,1430,357.0,576.0,219.0,15000000.0,0.0,-15000000.0
Danny Perales,Danny Perales,Arizona Diamondbacks,DBACKS,1,1,1,2,2008,2009,1,0.0,0.0,0.0,0,0,0,0,0,0,0.0,0.0,0.0,0.0,0.0,0.0
Danry Vasquez,Danry Vasquez,Detroit Tigers,TIGRS,1,2,1,3,2013,2013,0,-0.35,0.29,0.64,9,28,19,0,0,0,108.0,59.0,-49.0,0.0,0.0,0.0
Dante Brinkley,Dante Brinkley,New York Mets,METS,1,2,1,3,2005,2007,2,0.0,2.55,2.55,0,243,243,0,1039,1039,0.0,0.0,0.0,0.0,4666667.0,4666667.0
Dante Mendoza,Dante Mendoza,Cleveland Indians,INDINS,2,5,3,8,2018,2021,3,0.47,1.8,1.33,203,170,-33,650,509,-141,11.0,0.0,-11.0,547800.0,0.0,-547800.0
Darin Blood,Darin Blood,San Francisco Giants,GIANTS,1,1,1,2,1998,1998,0,0.0,-0.25,-0.25,0,41,41,0,115,115,0.0,0.0,0.0,0.0,3151380.0,3151380.0
Darin Cloninger,Darin Cloninger,San Diego Padres,PADRS,1,2,1,3,1984,1986,2,5.62,5.89,0.27,103,387,284,0,1380,1380,1792.0,0.0,-1792.0,0.0,0.0,0.0
Dario Guzman,Dario Guzman,Detroit Tigers,TIGRS,3,3,3,6,1987,1988,1,0.2,-0.3,-0.5,7,16,9,6,30,24,0.0,0.0,0.0,0.0,0.0,0.0
Dario Rubinstein,Dario Rubinstein,Washington Senators,TWINS,1,4,4,8,1956,1956,0,0.0,0.0,0.0,0,0,0,0,0,0,0.0,0.0,0.0,0.0,0.0,0.0
Darlin Guzman,Darlin Guzman,Cincinnati Reds,REDS,1,1,1,2,2021,2021,0,0.0,0.0,0.0,0,0,0,0,0,0,0.0,0.0,0.0,0.0,0.0,0.0
Darrell Nicholas,Darrell Nicholas,Milwaukee Brewers,BREWRS,4,9,9,18,1998,2004,6,4.53,4.88,0.35,522,716,194,1583,1430,-153,437.0,1049.0,612.0,2750000.0,682500.0,-2067500.0
Darrell Pruitt,Darrell Pruitt,Chicago White Sox,WSOX,1,1,1,2,1988,1988,0,0.0,-0.64,-0.64,0,6,6,0,0,0,0.0,36.0,36.0,0.0,0.0,0.0
Darren Blakely,Darren Blakely,Anaheim Angels,ANGELS,1,1,1,2,2001,2001,0,0.0,-1.08,-1.08,0,16,16,0,66,66,0.0,0.0,0.0,0.0,0.0,0.0
Darren Blakely,Darren Blakely,New York Yankees,YANKS,3,4,4,8,2001,2007,6,0.42,0.27,-0.15,30,179,149,18,0,-18,184.0,789.0,605.0,6000000.0,6000000.0,0.0
Darren Burroughs,Darren Burroughs,Philadelphia Phillies,PHILS,1,4,2,6,1983,1984,1,4.33,2.1,-2.23,526,139,-387,92,339,247,1500.0,17.0,-1483.0,0.0,0.0,0.0
Darren Burroughs,Darren Burroughs,San Diego Padres,PADRS,1,1,1,2,1984,1984,0,0.0,0.0,0.0,0,0,0,0,0,0,0.0,0.0,0.0,0.0,0.0,0.0
Darryl Banks,Darryl Banks,Chicago Cubs,CUBS,4,14,9,23,1984,1991,7,18.76,21.66,2.9,1968,1112,-856,6227,902,-5325,1933.0,5322.0,3389.0,1746666.0,2928000.0,1181334.0
Darryl Landrum,Darryl Landrum,Toronto Blue Jays,BJAYS,1,2,1,3,1987,1987,0,-0.44,-0.32,0.12,59,3,-56,0,0,0,297.0,36.0,-261.0,71500.0,0.0,-71500.0
Daryl Green,Daryl Green,Oakland Athletics,ATLTCS,1,3,1,4,1990,1990,0,4.87,0.81,-4.06,395,29,-366,1429,123,-1306,0.0,0.0,0.0,102500.0,1500000.0,1397500.0
Dauris Valdez,Dauris Valdez,San Diego Padres,PADRS,1,1,1,2,2021,2021,0,0.0,0.22,0.22,0,10,10,0,0,0,0.0,15.0,15.0,0.0,0.0,0.0
Dave Benham,Dave Benham,Boston Red Sox,RSOX,1,2,1,3,1999,1999,0,1.49,0.53,-0.96,212,5,-207,24,0,-24,420.0,77.0,-343.0,0.0,2500000.0,2500000.0
Dave Blakley,Dave Blakley,San Francisco Giants,GIANTS,1,2,3,5,1987,1994,7,5.69,0.91,-4.78,646,306,-340,2698,81,-2617,6.0,1068.0,1062.0,0.0,0.0,0.0
Dave Blakley,Dave Blakley,Minnesota Twins,TWINS,1,1,1,2,1987,1987,0,0.0,0.0,0.0,0,0,0,0,0,0,0.0,0.0,0.0,0.0,0.0,0.0
Dave Brundage,Dave Brundage,Philadelphia Phillies,PHILS,2,4,4,8,1987,1989,2,8.23,2.23,-6.0,632,164,-468,1265,649,-616,1310.0,12.0,-1298.0,1629900.0,750000.0,-879900.0
Dave Clay,Dave Clay,Atlanta Braves,BRAVES,1,3,1,4,1986,1986,0,1.33,-0.29,-1.62,68,76,8,242,144,-98,0.0,0.0,0.0,0.0,0.0,0.0
Dave Crouthers,Dave Crouthers,Baltimore Orioles,ORLS,1,3,2,5,2005,2005,0,4.2,-1.01,-5.21,574,102,-472,1675,424,-1251,0.0,0.0,0.0,0.0,0.0,0.0
Dave Duplessis,Dave Duplessis,Cleveland Indians,INDINS,2,4,2,6,1994,1994,0,-0.31,-0.66,-0.35,27,19,-8,0,0,0,177.0,71.0,-106.0,1850000.0,2975000.0,1125000.0
Dave Gandolph,Dave Gandolph,Texas Rangers,RNGRS,1,1,1,2,1993,1994,1,0.0,1.89,1.89,0,60,60,0,193,193,0.0,0.0,0.0,0.0,500000.0,500000.0
Dave Hartnett,Dave Hartnett,Seattle Mariners,MARNRS,1,1,1,2,1987,1987,0,0.0,-0.82,-0.82,0,45,45,0,135,135,0.0,0.0,0.0,0.0,880000.0,880000.0
Dave Jefferson,Dave Jefferson,Chicago Cubs,CUBS,1,2,1,3,1997,1997,0,0.0,0.0,0.0,0,0,0,0,0,0,0.0,0.0,0.0,0.0,0.0,0.0
Dave Kent,Dave Kent,New York Yankees,YANKS,1,3,3,6,1970,1970,0,0.24,0.0,-0.24,29,0,-29,33,0,-33,0.0,0.0,0.0,0.0,0.0,0.0
Dave Lenderman,Dave Lenderman,Chicago Cubs,CUBS,1,2,1,3,1986,1987,1,0.08,1.13,1.05,1,162,161,1,51,50,0.0,630.0,630.0,0.0,530000.0,530000.0
Dave Lynch,Dave Lynch,Texas Rangers,RNGRS,1,2,2,4,1990,1991,1,0.0,-0.03,-0.03,0,6,6,0,0,0,0.0,18.0,18.0,0.0,0.0,0.0
Dave Martinez,Dave Martinez,California Angels,ANGELS,2,3,2,5,1990,1992,2,0.89,0.39,-0.5,197,172,-25,434,626,192,0.0,0.0,0.0,357500.0,2316666.0,1959166.0
Dave Miller,Dave Miller,Atlanta Braves,BRAVES,1,2,1,3,1989,1990,1,0.0,-0.48,-0.48,0,92,92,0,0,0,0.0,153.0,153.0,0.0,0.0,0.0
Dave Noyce,Dave Noyce,Florida Marlins,MARLNS,1,2,1,3,2000,2000,0,-0.32,-0.12,0.2,18,36,18,35,123,88,0.0,0.0,0.0,0.0,4600000.0,4600000.0
Dave Noyce,Dave Noyce,Chicago Cubs,CUBS,4,8,6,14,2002,2007,5,3.71,5.35,1.64,539,612,73,838,2270,1432,801.0,0.0,-801.0,7233333.0,15890494.0,8657161.0
Dave Pike,Dave Pike,Milwaukee Brewers,BREWRS,1,1,1,2,1994,1995,1,0.0,0.5,0.5,0,24,24,0,0,0,0.0,99.0,99.0,0.0,0.0,0.0
Dave Richards,Dave Richards,Detroit Tigers,TIGRS,1,1,1,2,1991,1991,0,0.0,0.0,0.0,0,0,0,0,0,0,0.0,0.0,0.0,0.0,0.0,0.0
Dave Rivera,Dave Rivera,Texas Rangers,RNGRS,2,3,2,5,1978,1984,6,4.64,3.01,-1.63,361,454,93,939,1279,340,0.0,259.0,259.0,0.0,0.0,0.0
Dave Sinnes,Dave Sinnes,Toronto Blue Jays,BJAYS,2,4,4,8,1995,1997,2,19.63,3.81,-15.82,207,44,-163,147,0,-147,2766.0,687.0,-2079.0,8000000.0,0.0,-8000000.0
Dave Sommer,Dave Sommer,Montreal Expos,NATEX,3,4,4,8,1991,1992,1,-1.13,-1.26,-0.13,147,60,-87,321,92,-229,0.0,52.0,52.0,119000.0,920000.0,801000.0
Dave Swanson,Dave Swanson,New York Mets,METS,9,15,15,30,1995,2006,11,21.84,19.97,-1.87,1441,1812,371,2084,2876,792,2476.0,2029.0,-447.0,21862990.0,15877333.0,-5985657.0
Dave Tuttle,Dave Tuttle,Cincinnati Reds,REDS,3,5,4,9,1995,1998,3,1.13,-0.21,-1.34,524,176,-348,786,483,-303,1638.0,269.0,-1369.0,299000.0,2300667.0,2001667.0
Dave Wilder,Dave Wilder,Oakland Athletics,ATLTCS,2,4,3,7,1987,1997,10,0.59,15.32,14.73,237,554,317,1,0,-1,339.0,1971.0,1632.0,0.0,0.0,0.0
Daven Bond,Daven Bond,Houston Astros,ASTROS,7,14,19,33,1990,2004,14,26.09,8.2,-17.89,2264,1789,-475,4026,3854,-172,4263.0,3434.0,-829.0,7155000.0,5554000.0,-1601000.0
David Burge,David Burge,Kansas City Athletics,ATLTCS,1,3,2,5,1966,1966,0,0.6,0.0,-0.6,100,0,-100,283,0,-283,0.0,0.0,0.0,0.0,0.0,0.0
David Chavarria,David Chavarria,Texas Rangers,RNGRS,2,2,2,4,1996,1997,1,-0.19,0.0,0.19,23,0,-23,1,0,-1,39.0,0.0,-39.0,0.0,125000.0,125000.0
David Colon,David Colon,New York Mets,METS,1,5,1,6,1969,1971,2,11.34,3.37,-7.97,538,281,-257,615,957,342,4078.0,0.0,-4078.0,0.0,50000.0,50000.0
David Culpepper,David Culpepper,Los Angeles Dodgers,DOGRS,2,6,3,9,1973,1984,11,-0.05,31.52,31.57,1550,1541,-9,5211,5934,723,415.0,0.0,-415.0,100000.0,0.0,-100000.0
David Espinosa,David Espinosa,Cincinnati Reds,REDS,1,3,3,6,2002,2002,0,0.0,-0.66,-0.66,0,20,20,0,16,16,0.0,130.0,130.0,0.0,2400000.0,2400000.0
David Grangaard,David Grangaard,Houston Astros,ASTROS,9,16,13,29,1971,1989,18,44.32,17.37,-26.95,2726,2302,-424,7585,5583,-2002,6887.0,3796.0,-3091.0,35500.0,41750.0,6250.0
David Heintz,David Heintz,Pittsburgh Pirates,PIRATS,5,8,9,17,1968,1973,5,-0.64,0.41,1.05,22,41,19,70,35,-35,0.0,36.0,36.0,17500.0,0.0,-17500.0
David Paisano,David Paisano,Chicago White Sox,WSOX,2,4,5,9,2006,2016,10,4.75,20.31,15.56,542,364,-178,56,181,125,1384.0,4762.0,3378.0,728000.0,8282695.0,7554695.0
David Rosario,David Rosario,Chicago Cubs,CUBS,1,1,1,2,1991,1991,0,0.0,0.0,0.0,0,0,0,0,0,0,0.0,0.0,0.0,0.0,0.0,0.0
David Shafer,David Shafer,Cincinnati Reds,REDS,1,2,2,4,2007,2007,0,0.0,-0.82,-0.82,0,68,68,0,6,6,0.0,128.0,128.0,0.0,0.0,0.0
David Whitehead,David Whitehead,Philadelphia Phillies,PHILS,1,1,1,2,2015,2016,1,0.0,0.26,0.26,0,8,8,0,7,7,0.0,52.0,52.0,0.0,8000000.0,8000000.0
Dawrin Frias,Dawrin Frias,New York Mets,METS,1,1,2,3,2015,2015,0,0.0,-0.66,-0.66,0,30,30,0,0,0,0.0,26.0,26.0,0.0,5500000.0,5500000.0
Dax Winslett,Dax Winslett,Los Angeles Dodgers,DOGRS,1,1,1,2,1995,1995,0,0.0,-0.3,-0.3,0,12,12,0,11,11,0.0,87.0,87.0,0.0,240000.0,240000.0
Daylan Holt,Daylan Holt,Oakland Athletics,ATLTCS,2,6,5,11,2002,2003,1,15.18,3.47,-11.71,801,134,-667,480,219,-261,4974.0,260.0,-4714.0,2433333.0,4320000.0,1886667.0
Dean Freeland,Dean Freeland,Milwaukee Brewers,BREWRS,1,2,1,3,1985,1990,5,0.0,6.86,6.86,0,667,667,0,2711,2711,0.0,0.0,0.0,0.0,0.0,0.0
Decomba Conner,Decomba Conner,Cincinnati Reds,REDS,1,2,1,3,1996,1997,1,0.0,0.04,0.04,0,25,25,0,96,96,0.0,0.0,0.0,0.0,0.0,0.0
Deion Tansel,Deion Tansel,Tampa Bay Devil Rays,RAYS,2,2,2,4,2017,2018,1,0.0,0.0,0.0,0,0,0,0,0,0,0.0,0.0,0.0,0.0,546200.0,546200.0
Deivi Estrada,Deivi Estrada,Atlanta Braves,BRAVES,1,1,1,2,2021,2021,0,0.0,0.0,0.0,0,0,0,0,0,0,0.0,0.0,0.0,0.0,0.0,0.0
Demi Orimoloye,Demi Orimoloye,Milwaukee Brewers,BREWRS,1,1,1,2,2018,2018,0,0.0,0.28,0.28,0,19,19,0,54,54,0.0,0.0,0.0,0.0,5000000.0,5000000.0
Demond Smith,Demond Smith,California Angels,ANGELS,2,2,2,4,1995,1996,1,0.02,-0.57,-0.59,33,61,28,77,71,-6,3.0,46.0,43.0,250000.0,430000.0,180000.0
Dennis Hood,Dennis Hood,Atlanta Braves,BRAVES,1,1,1,2,1990,1992,2,0.0,0.0,0.0,0,0,0,0,0,0,0.0,0.0,0.0,0.0,0.0,0.0
Dennis Myers,Dennis Myers,Oakland Athletics,ATLTCS,1,2,1,3,1974,1974,0,6.81,0.02,-6.79,570,73,-497,2213,113,-2100,0.0,0.0,0.0,0.0,0.0,0.0
Dennis Russo,Dennis Russo,Cincinnati Reds,REDS,1,1,1,2,2000,2000,0,0.0,0.0,0.0,0,0,0,0,0,0,0.0,0.0,0.0,0.0,0.0,0.0
Dennis Webb,Dennis Webb,Kansas City Royals,ROYALS,1,1,1,2,1981,1981,0,0.0,0.0,0.0,0,2,2,0,0,0,0.0,0.0,0.0,0.0,0.0,0.0
Derek Hacopian,Derek Hacopian,Milwaukee Brewers,BREWRS,1,1,1,2,1995,1996,1,0.0,0.45,0.45,0,29,29,0,0,0,0.0,94.0,94.0,0.0,160000.0,160000.0
Derek Hasselhoff,Derek Hasselhoff,Chicago White Sox,WSOX,1,1,2,3,2001,2001,0,0.0,-0.03,-0.03,0,39,39,0,0,0,0.0,102.0,102.0,0.0,2400000.0,2400000.0
Derek Vinyard,Derek Vinyard,Boston Red Sox,RSOX,3,5,6,11,1994,2011,17,0.04,46.15,46.11,391,2084,1693,170,5862,5692,732.0,3501.0,2769.0,2300000.0,0.0,-2300000.0
Derrick Saito,Derrick Saito,Kansas City Royals,ROYALS,5,11,10,21,2009,2021,12,13.34,47.45,34.11,880,2988,2108,2084,10524,8440,3202.0,2429.0,-773.0,26600000.0,15358267.0,-11241733.0
Derrick Van Dusen,Derrick Van Dusen,Seattle Mariners,MARNRS,1,2,1,3,2002,2002,0,-0.48,0.16,0.64,24,8,-16,54,0,-54,0.0,148.0,148.0,0.0,2500000.0,2500000.0
Derwin McNealy,Derwin McNealy,New York Yankees,YANKS,1,1,1,2,1984,1985,1,0.0,-0.06,-0.06,0,7,7,0,0,0,0.0,30.0,30.0,0.0,0.0,0.0
Desmond Henry,Desmond Henry,Texas Rangers,RNGRS,1,1,1,2,2013,2014,1,0.0,0.0,0.0,0,0,0,0,0,0,0.0,0.0,0.0,0.0,0.0,0.0
Devin Jones,Devin Jones,Baltimore Orioles,ORLS,2,2,2,4,2013,2018,5,0.39,5.96,5.57,54,314,260,0,2,2,71.0,983.0,912.0,5165000.0,498200.0,-4666800.0
Dewayne Coleman,Dewayne Coleman,Minnesota Twins,TWINS,2,3,4,7,1986,1990,4,-0.88,-0.16,0.72,76,144,68,2,101,99,157.0,373.0,216.0,725000.0,873333.0,148333.0
Dewey Marshall,Dewey Marshall,SanAntonio,SanAntonio,1,5,1,6,1923,1923,0,9.54,0.0,-9.54,1176,0,-1176,4721,0,-4721,0.0,0.0,0.0,0.0,0.0,0.0
Dexter Carter,Dexter Carter,Chicago White Sox,WSOX,6,14,12,26,2009,2018,9,7.16,22.73,15.57,991,1029,38,935,3763,2828,4825.0,1688.0,-3137.0,13340000.0,19075000.0,5735000.0
Deybis Benitez,Deybis Benitez,Seattle Mariners,MARNRS,1,1,1,2,2009,2010,1,0.0,0.0,0.0,0,0,0,0,0,0,0.0,0.0,0.0,0.0,0.0,0.0
Dian Toscano,Dian Toscano,Atlanta Braves,BRAVES,1,4,2,6,2016,2016,0,-0.57,0.0,0.57,26,0,-26,16,0,-16,128.0,0.0,-128.0,0.0,0.0,0.0
Dick Hanlon,Dick Hanlon,Los Angeles Dodgers,DOGRS,1,1,1,2,1959,1959,0,0.0,0.16,0.16,0,28,28,0,6,6,0.0,92.0,92.0,0.0,0.0,0.0
Dick Hearn,Dick Hearn,New York Yankees,YANKS,1,2,1,3,1944,1950,6,0.0,-1.41,-1.41,0,90,90,0,41,41,0.0,394.0,394.0,0.0,0.0,0.0
Dick Kinaman,Dick Kinaman,Cleveland Indians,INDINS,10,19,17,36,1952,1968,16,100.62,41.41,-59.21,4524,2970,-1554,15556,10816,-4740,4502.0,562.0,-3940.0,0.0,32000.0,32000.0
Dick Oder,Dick Oder,Cincinnati Reds,REDS,1,2,2,4,1945,1947,2,0.0,0.0,0.0,0,0,0,0,0,0,0.0,0.0,0.0,0.0,0.0,0.0
Dick Sanders,Dick Sanders,New York Yankees,YANKS,1,2,1,3,1960,1960,0,0.05,-0.09,-0.14,34,8,-26,37,0,-37,0.0,13.0,13.0,0.0,0.0,0.0
Diego Castillo,Diego Castillo,New York Yankees,YANKS,1,2,1,3,2021,2021,0,-0.22,1.27,1.49,44,30,-14,149,0,-149,0.0,84.0,84.0,0.0,0.0,0.0
Diego Goris,Diego Goris,Pittsburgh Pirates,PIRATS,2,3,2,5,2011,2012,1,-0.43,-0.15,0.28,21,29,8,31,56,25,38.0,0.0,-38.0,483000.0,0.0,-483000.0
Dillon Paulson,Dillon Paulson,Los Angeles Dodgers,DOGRS,1,2,1,3,2020,2020,0,0.0,0.0,0.0,0,0,0,0,0,0,0.0,0.0,0.0,0.0,0.0,0.0
Diomar Lopez,Diomar Lopez,San Diego Padres,PADRS,1,1,1,2,2019,2019,0,0.0,-0.09,-0.09,0,39,39,0,1,1,0.0,87.0,87.0,0.0,0.0,0.0
Diowill Burgos,Diowill Burgos,St. Louis Cardinals,CARDS,1,1,1,2,2020,2021,1,0.0,0.03,0.03,0,25,25,0,45,45,0.0,0.0,0.0,0.0,0.0,0.0
Dody Rather,Dody Rather,New York Yankees,YANKS,4,8,5,13,1986,1989,3,16.29,-1.42,-17.71,1165,146,-1019,2749,144,-2605,4215.0,1258.0,-2957.0,1022000.0,1140000.0,118000.0
Dom Thompson-Williams,Dom Thompson-Williams,New York Yankees,YANKS,1,3,1,4,2018,2020,2,-1.57,1.84,3.41,118,37,-81,6,8,2,818.0,513.0,-305.0,0.0,4900000.0,4900000.0
Domingo Michel,Domingo Michel,Los Angeles Dodgers,DOGRS,1,2,1,3,1989,1991,2,0.0,-0.42,-0.42,0,51,51,0,76,76,0.0,0.0,0.0,0.0,70400.0,70400.0
Domingo Mota,Domingo Mota,Los Angeles Dodgers,DOGRS,1,2,1,3,1991,1992,1,0.26,-0.93,-1.19,137,121,-16,406,313,-93,0.0,0.0,0.0,260000.0,0.0,-260000.0
Don Bolte,Don Bolte,Chicago White Sox,WSOX,2,3,2,5,1971,1972,1,0.08,0.0,-0.08,33,0,-33,5,0,-5,104.0,0.0,-104.0,0.0,0.0,0.0
Don Brown,Don Brown,Cincinnati Reds,REDS,9,13,18,31,1989,2006,17,19.53,23.14,3.61,2921,2149,-772,1877,4164,2287,4092.0,3999.0,-93.0,22668833.0,10745833.0,-11923000.0
Don Brown,Don Brown,Chicago Cubs,CUBS,1,1,1,2,1922,1922,0,0.0,2.93,2.93,0,122,122,0,500,500,0.0,0.0,0.0,0.0,0.0,0.0
Don Carter,Don Carter,Montreal Expos,NATEX,1,2,1,3,1983,1983,0,0.0,0.28,0.28,0,31,31,0,136,136,0.0,0.0,0.0,0.0,375000.0,375000.0
Don Koonce,Don Koonce,New York Mets,METS,1,4,1,5,1971,1974,3,-0.13,-1.66,-1.53,1,64,63,4,139,135,0.0,0.0,0.0,0.0,0.0,0.0
Don Koonce,Don Koonce,Montreal Expos,NATEX,1,1,1,2,1973,1973,0,0.0,0.0,0.0,0,0,0,0,0,0,0.0,0.0,0.0,0.0,0.0,0.0
Don Levinski,Don Levinski,Montreal Expos,NATEX,1,5,4,9,2002,2009,7,5.7,-0.5,-6.2,445,197,-248,458,190,-268,1719.0,735.0,-984.0,4812500.0,6500000.0,1687500.0
Don Levinski,Don Levinski,Florida Marlins,MARLNS,1,2,1,3,2003,2005,2,-0.35,2.59,2.94,2,296,294,0,1062,1062,6.0,0.0,-6.0,0.0,4250000.0,4250000.0
Don Lovell,Don Lovell,Cleveland Indians,INDINS,1,2,2,4,1988,1988,0,0.0,0.0,0.0,0,0,0,0,0,0,0.0,0.0,0.0,0.0,0.0,0.0
Don Pisker,Don Pisker,Houston Astros,ASTROS,2,2,2,4,1978,1981,3,0.76,0.25,-0.51,378,73,-305,690,181,-509,0.0,0.0,0.0,0.0,0.0,0.0
Don Pisker,Don Pisker,Toronto Blue Jays,BJAYS,2,2,2,4,1981,1986,5,0.0,3.51,3.51,0,454,454,0,1261,1261,0.0,0.0,0.0,0.0,0.0,0.0
Don Stratton,Don Stratton,Houston Astros,ASTROS,1,2,1,3,1974,1974,0,0.0,-0.58,-0.58,0,64,64,0,116,116,0.0,0.0,0.0,0.0,0.0,0.0
Donald Furnald,Donald Furnald,California Angels,ANGELS,1,2,2,4,1966,1967,1,0.0,0.0,0.0,0,0,0,0,0,0,0.0,0.0,0.0,0.0,0.0,0.0
Donald Griffin,Donald Griffin,Toronto,Toronto,2,3,4,7,1956,1958,2,-0.02,0.0,0.02,52,0,-52,3,0,-3,128.0,0.0,-128.0,0.0,0.0,0.0
Donald Johnson,Donald Johnson,Atlanta Braves,BRAVES,1,2,1,3,1969,1969,0,-1.08,0.0,1.08,32,0,-32,10,0,-10,137.0,0.0,-137.0,0.0,0.0,0.0
Donald Prohovich,Donald Prohovich,Chicago White Sox,WSOX,1,2,1,3,1960,1960,0,0.0,0.03,0.03,0,10,10,0,18,18,0.0,0.0,0.0,0.0,0.0,0.0
Donald Robertson,Donald Robertson,New York Giants,GIANTS,1,1,1,2,1950,1952,2,0.0,0.0,0.0,0,0,0,0,0,0,0.0,0.0,0.0,0.0,0.0,0.0
Donnie Dewees,Donnie Dewees,Chicago Cubs,CUBS,1,1,1,2,2017,2017,0,0.0,0.0,0.0,0,0,0,0,0,0,0.0,0.0,0.0,0.0,0.0,0.0
Donnie Dewees,Donnie Dewees,Kansas City Royals,ROYALS,1,1,1,2,2019,2020,1,0.0,0.0,0.0,0,0,0,0,0,0,0.0,0.0,0.0,0.0,0.0,0.0
Donnie Iasparro,Donnie Iasparro,Minnesota Twins,TWINS,1,1,1,2,1986,1987,1,0.0,0.0,0.0,0,0,0,0,0,0,0.0,0.0,0.0,0.0,0.0,0.0
Donnie Moore,Donnie Moore,Milwaukee Brewers,BREWRS,1,1,1,2,1997,1997,0,0.0,0.02,0.02,0,4,4,0,0,0,0.0,42.0,42.0,0.0,3213400.0,3213400.0
Donnie Schmidt,Donnie Schmidt,Colorado Rockies,ROCKS,1,1,1,2,1997,1997,0,0.0,0.04,0.04,0,2,2,0,4,4,0.0,0.0,0.0,0.0,160000.0,160000.0
Donny Sands,Donny Sands,New York Yankees,YANKS,1,2,2,4,2021,2021,0,0.0,0.0,0.0,0,0,0,0,0,0,0.0,0.0,0.0,0.0,0.0,0.0
Donovan Casey,Donovan Casey,Los Angeles Dodgers,DOGRS,1,4,2,6,2021,2021,0,0.24,4.89,4.65,47,74,27,110,252,142,188.0,205.0,17.0,0.0,47503480.0,47503480.0
Doug Cinnella,Doug Cinnella,Baltimore Orioles,ORLS,2,4,3,7,1988,1990,2,0.11,0.05,-0.06,10,54,44,0,0,0,21.0,802.0,781.0,335000.0,0.0,-335000.0
Doug Dent,Doug Dent,Atlanta Braves,BRAVES,1,1,1,2,1999,1999,0,0.0,0.21,0.21,0,34,34,0,86,86,0.0,0.0,0.0,0.0,850000.0,850000.0
Doug Givler,Doug Givler,Seattle Mariners,MARNRS,1,1,1,2,1987,1989,2,0.0,-0.22,-0.22,0,24,24,0,0,0,0.0,95.0,95.0,0.0,0.0,0.0
Doug Johns,Doug Johns,Milwaukee Brewers,BREWRS,2,2,3,5,2000,2005,5,0.13,3.2,3.07,157,749,592,0,1032,1032,177.0,509.0,332.0,300000.0,250000.0,-50000.0
Doug Kline,Doug Kline,Minnesota Twins,TWINS,2,2,2,4,1988,1990,2,0.0,1.29,1.29,13,108,95,11,310,299,0.0,0.0,0.0,200000.0,300000.0,100000.0
Doug Kline,Doug Kline,Baltimore Orioles,ORLS,2,2,2,4,1988,1989,1,-0.2,0.0,0.2,32,0,-32,3,0,-3,72.0,0.0,-72.0,0.0,0.0,0.0
Douglas Lulay,Douglas Lulay,San Diego Padres,PADRS,1,1,1,2,1982,1982,0,0.0,0.0,0.0,0,0,0,0,0,0,0.0,0.0,0.0,0.0,0.0,0.0
Drake Fellows,Drake Fellows,San Diego Padres,PADRS,1,5,1,6,2021,2021,0,2.1,3.49,1.39,119,68,-51,1,57,56,182.0,544.0,362.0,0.0,0.0,0.0
Drew Finley,Drew Finley,New York Yankees,YANKS,2,3,2,5,2018,2019,1,0.36,0.0,-0.36,179,0,-179,465,0,-465,0.0,0.0,0.0,0.0,0.0,0.0
Drew Millas,Drew Millas,Oakland Athletics,ATLTCS,1,3,3,6,2021,2021,0,0.0,-0.1,-0.1,0,88,88,0,339,339,0.0,0.0,0.0,0.0,7000000.0,7000000.0
Drew Strotman,Drew Strotman,Tampa Bay Devil Rays,RAYS,1,2,2,4,2021,2021,0,0.33,0.48,0.15,6,55,49,2,238,236,80.0,0.0,-80.0,0.0,13000000.0,13000000.0
Drew Vettleson,Drew Vettleson,Tampa Bay Devil Rays,RAYS,3,8,5,13,2014,2018,4,0.49,9.21,8.72,459,720,261,782,2375,1593,577.0,688.0,111.0,508800.0,3779600.0,3270800.0
Duane Dewey,Duane Dewey,Kansas City Royals,ROYALS,1,2,2,4,1983,1986,3,0.96,2.85,1.89,53,424,371,0,1712,1712,233.0,0.0,-233.0,0.0,180000.0,180000.0
Duane James,Duane James,Detroit Tigers,TIGRS,1,1,1,2,1985,1992,7,0.0,13.09,13.09,0,252,252,0,1,1,0.0,4654.0,4654.0,0.0,590000.0,590000.0
Dustin Brisson,Dustin Brisson,Boston Red Sox,RSOX,1,3,1,4,2001,2002,1,0.0,-0.56,-0.56,0,12,12,0,0,0,0.0,66.0,66.0,0.0,5333333.0,5333333.0
Dustin Harris,Dustin Harris,Oakland Athletics,ATLTCS,1,3,2,5,2020,2020,0,0.0,0.01,0.01,0,5,5,0,0,0,0.0,64.0,64.0,0.0,9833333.0,9833333.0
Dustin Majewski,Dustin Majewski,Oakland Athletics,ATLTCS,13,18,21,39,2005,2021,16,30.54,35.42,4.88,1528,2159,631,3830,6158,2328,1492.0,3539.0,2047.0,13440000.0,8216100.0,-5223900.0
Dustin Martin,Dustin Martin,New York Mets,METS,1,2,1,3,2007,2011,4,-1.44,2.94,4.38,187,365,178,534,1469,935,3.0,0.0,-3.0,0.0,5750000.0,5750000.0
Dwayne Pollok,Dwayne Pollok,Chicago White Sox,WSOX,1,1,1,2,2007,2007,0,0.0,0.0,0.0,0,0,0,0,0,0,0.0,0.0,0.0,0.0,0.0,0.0
Dwight Maness,Dwight Maness,Los Angeles Dodgers,DOGRS,1,2,1,3,1995,1997,2,0.0,-0.18,-0.18,0,178,178,0,724,724,0.0,0.0,0.0,0.0,2000000.0,2000000.0
Dylan Thompson,Dylan Thompson,Seattle Mariners,MARNRS,1,3,2,5,2016,2018,2,1.91,-0.63,-2.54,161,100,-61,1,297,296,549.0,3.0,-546.0,0.0,0.0,0.0
Earl Johnson,Earl Johnson,San Diego Padres,PADRS,1,1,1,2,1997,1997,0,0.0,0.0,0.0,0,0,0,0,0,0,0.0,0.0,0.0,0.0,0.0,0.0
Earl Sanders,Earl Sanders,Toronto Blue Jays,BJAYS,1,1,1,2,1990,1990,0,0.0,0.0,0.0,0,0,0,0,0,0,0.0,0.0,0.0,0.0,0.0,0.0
Earl Sanders,Earl Sanders,Atlanta Braves,BRAVES,1,2,1,3,1991,1992,1,0.0,-0.43,-0.43,0,48,48,0,3,3,0.0,104.0,104.0,0.0,0.0,0.0
Easton Lucas,Easton Lucas,Miami Marlins,MARLNS,2,2,2,4,2019,2020,1,-0.1,-0.04,0.06,22,30,8,79,128,49,0.0,0.0,0.0,8200000.0,4825000.0,-3375000.0
Ed Collins,Ed Collins,Milwaukee Brewers,BREWRS,1,1,1,2,1996,1997,1,0.0,0.84,0.84,0,34,34,0,3,3,0.0,229.0,229.0,0.0,0.0,0.0
Ed Cuervo,Ed Cuervo,Philadelphia Phillies,PHILS,1,1,1,2,1978,1979,1,0.0,0.0,0.0,0,0,0,0,0,0,0.0,0.0,0.0,0.0,0.0,0.0
Ed Gerald,Ed Gerald,Kansas City Royals,ROYALS,1,2,2,4,1993,1995,2,6.98,0.21,-6.77,245,278,33,1059,1031,-28,0.0,0.0,0.0,0.0,0.0,0.0
Ed Gustafson,Ed Gustafson,San Francisco Giants,GIANTS,1,1,1,2,1990,1992,2,0.0,0.88,0.88,0,208,208,0,23,23,0.0,538.0,538.0,0.0,0.0,0.0
Ed Kurpiel,Ed Kurpiel,St. Louis Cardinals,CARDS,1,2,1,3,1974,1976,2,0.0,1.8,1.8,0,180,180,0,415,415,0.0,0.0,0.0,0.0,0.0,0.0
Ed Kurpiel,Ed Kurpiel,California Angels,ANGELS,1,2,1,3,1976,1977,1,0.0,0.18,0.18,0,169,169,0,540,540,0.0,0.0,0.0,0.0,0.0,0.0
Ed Kurpiel,Ed Kurpiel,St. Louis Cardinals,CARDS,1,1,2,3,1976,1976,0,0.0,0.0,0.0,0,0,0,0,0,0,0.0,0.0,0.0,0.0,0.0,0.0
Ed Myers,Ed Myers,Oakland Athletics,ATLTCS,2,4,3,7,1985,1985,0,5.99,2.63,-3.36,113,29,-84,0,0,0,1871.0,583.0,-1288.0,0.0,0.0,0.0
Ed Pacheco,Ed Pacheco,Houston Astros,ASTROS,1,2,1,3,1965,1967,2,0.0,1.4,1.4,0,140,140,0,40,40,0.0,542.0,542.0,0.0,20000.0,20000.0
Ed Pacheco,Ed Pacheco,Houston Astros,ASTROS,1,3,3,6,1966,1968,2,0.0,-0.84,-0.84,0,120,120,0,7,7,0.0,229.0,229.0,0.0,0.0,0.0
Ed Pacheco,Ed Pacheco,Baltimore Orioles,ORLS,1,2,2,4,1968,1968,0,0.0,0.0,0.0,0,0,0,0,0,0,0.0,0.0,0.0,0.0,0.0,0.0
Ed Pacheco,Ed Pacheco,Pittsburgh Pirates,PIRATS,3,5,5,10,1970,1973,3,0.0,0.41,0.41,0,41,41,0,35,35,0.0,36.0,36.0,17500.0,0.0,-17500.0
Ed Perozo,Ed Perozo,Boston Red Sox,RSOX,1,3,1,4,1990,1991,1,0.0,0.54,0.54,0,52,52,0,179,179,0.0,0.0,0.0,0.0,1100000.0,1100000.0
Ed Puikunas,Ed Puikunas,Oakland Athletics,ATLTCS,1,2,1,3,1985,1986,1,0.0,2.32,2.32,0,194,194,0,667,667,0.0,0.0,0.0,0.0,0.0,0.0
Ed Ricks,Ed Ricks,New York Yankees,YANKS,19,44,41,85,1977,1995,18,29.75,51.78,22.03,3287,4268,981,7585,11807,4222,7486.0,4403.0,-3083.0,3944706.0,6805000.0,2860294.0
Ed Selway,Ed Selway,Detroit Tigers,TIGRS,1,5,1,6,1938,1952,14,0.0,25.69,25.69,0,589,589,0,728,728,0.0,4363.0,4363.0,11000.0,0.0,-11000.0
Eddi Candelario,Eddi Candelario,Chicago White Sox,WSOX,2,6,3,9,2003,2003,0,-3.34,5.0,8.34,321,36,-285,107,7,-100,601.0,726.0,125.0,0.0,0.0,0.0
Eddie Bogart,Eddie Bogart,St. Louis Cardinals,CARDS,1,3,1,4,1921,1921,0,0.0,0.87,0.87,0,76,76,0,77,77,0.0,625.0,625.0,0.0,0.0,0.0
Eddie Lantigua,Eddie Lantigua,Los Angeles Dodgers,DOGRS,1,1,1,2,1994,1994,0,0.0,-0.11,-0.11,0,10,10,0,0,0,0.0,15.0,15.0,0.0,0.0,0.0
Eddie Lora,Eddie Lora,Boston Red Sox,RSOX,1,2,1,3,2009,2009,0,-0.21,0.34,0.55,100,15,-85,180,0,-180,0.0,41.0,41.0,400000.0,10500000.0,10100000.0
Eddie Morlan,Eddie Morlan,Minnesota Twins,TWINS,3,6,7,13,2007,2015,8,34.0,-0.38,-34.38,1580,849,-731,6027,3046,-2981,1777.0,138.0,-1639.0,12330000.0,1726100.0,-10603900.0
Eddie Tanner,Eddie Tanner,Kansas City Royals,ROYALS,1,2,1,3,1987,1987,0,0.0,0.0,0.0,0,0,0,0,0,0,0.0,0.0,0.0,0.0,0.0,0.0
Eddy Yean,Eddy Yean,Washington Nationals,NATEX,1,2,1,3,2020,2020,0,-0.15,0.0,0.15,53,0,-53,41,0,-41,350.0,0.0,-350.0,0.0,4800000.0,4800000.0
Edgardo Rodriguez,Edgardo Rodriguez,Tampa Bay Devil Rays,RAYS,2,4,5,9,2020,2020,0,-0.6,1.04,1.64,10,47,37,22,152,130,0.0,0.0,0.0,0.0,0.0,0.0
Edisson Gonzalez,Edisson Gonzalez,Tampa Bay Devil Rays,RAYS,1,2,1,3,2019,2019,0,0.0,0.71,0.71,0,37,37,0,119,119,0.0,0.0,0.0,0.0,100000.0,100000.0
Eduar Lopez,Eduar Lopez,Anaheim Angels,ANGELS,1,1,1,2,2015,2015,0,0.0,-0.65,-0.65,0,30,30,0,60,60,0.0,0.0,0.0,0.0,0.0,0.0
Eduard Pinto,Eduard Pinto,Texas Rangers,RNGRS,1,1,2,3,2017,2017,0,0.0,-0.02,-0.02,0,22,22,0,0,0,0.0,58.0,58.0,0.0,0.0,0.0
Eduardo Herrera,Eduardo Herrera,Arizona Diamondbacks,DBACKS,1,1,1,2,2021,2021,0,0.0,-0.35,-0.35,0,20,20,0,39,39,0.0,0.0,0.0,0.0,0.0,0.0
Eduardo Perez,Eduardo Perez,Los Angeles Dodgers,DOGRS,1,2,1,3,2008,2008,0,0.0,-0.25,-0.25,0,14,14,0,13,13,0.0,122.0,122.0,0.0,10000000.0,10000000.0
Eduardo Sierra,Eduardo Sierra,Oakland Athletics,ATLTCS,1,2,2,4,2003,2004,1,0.0,1.02,1.02,0,41,41,0,0,0,0.0,161.0,161.0,0.0,2200000.0,2200000.0
Eduardo Sierra,Eduardo Sierra,New York Yankees,YANKS,2,3,2,5,2005,2006,1,2.28,1.29,-0.99,307,72,-235,33,112,79,681.0,426.0,-255.0,3600000.0,5650000.0,2050000.0
Edward Jordan,Edward Jordan,California Angels,ANGELS,1,2,1,3,1976,1977,1,0.0,0.18,0.18,0,169,169,0,540,540,0.0,0.0,0.0,0.0,0.0,0.0
Edward Knoblauch,Edward Knoblauch,Dallas,Dallas,1,4,2,6,1954,1954,0,0.0,0.0,0.0,0,0,0,0,0,0,0.0,0.0,0.0,0.0,0.0,0.0
Edward Konick,Edward Konick,Chicago Cubs,CUBS,2,3,5,8,1954,1955,1,0.0,0.0,0.0,0,0,0,0,0,0,0.0,0.0,0.0,0.0,0.0,0.0
Edward Watts,Edward Watts,Baltimore Orioles,ORLS,1,1,1,2,1974,1974,0,0.0,0.0,0.0,0,0,0,0,0,0,0.0,0.0,0.0,0.0,0.0,0.0
Elehuris Montero,Elehuris Montero,St. Louis Cardinals,CARDS,1,5,1,6,2021,2021,0,0.69,4.14,3.45,45,157,112,42,653,611,346.0,0.0,-346.0,0.0,0.0,0.0
Eliecer Cardenas,Eliecer Cardenas,Atlanta Braves,BRAVES,1,1,1,2,2011,2012,1,0.0,-1.08,-1.08,0,67,67,0,155,155,0.0,0.0,0.0,0.0,2125000.0,2125000.0
Eliezer Alvarez,Eliezer Alvarez,St. Louis Cardinals,CARDS,1,1,1,2,2017,2017,0,0.0,0.44,0.44,0,18,18,0,1,1,0.0,33.0,33.0,0.0,0.0,0.0
Eliezer Mesa,Eliezer Mesa,Colorado Rockies,ROCKS,1,2,1,3,2011,2011,0,-0.29,1.57,1.86,3,70,67,0,286,286,15.0,0.0,-15.0,0.0,6000000.0,6000000.0
Elio Prado,Elio Prado,Boston Red Sox,RSOX,1,2,2,4,2019,2019,0,0.0,-0.16,-0.16,0,27,27,0,0,0,0.0,161.0,161.0,0.0,9500000.0,9500000.0
Elisaul Pimentel,Elisaul Pimentel,Los Angeles Dodgers,DOGRS,1,2,1,3,2010,2010,0,-0.45,-0.69,-0.24,12,39,27,39,160,121,0.0,0.0,0.0,0.0,1650000.0,1650000.0
Elliot Morris,Elliot Morris,Anaheim Angels,ANGELS,2,6,4,10,2014,2017,3,-0.93,3.94,4.87,94,402,308,26,948,922,108.0,488.0,380.0,0.0,12000000.0,12000000.0
Elmer Gardner,Elmer Gardner,Pittsburgh Pirates,PIRATS,1,3,1,4,1910,1910,0,0.0,0.0,0.0,0,0,0,0,0,0,0.0,0.0,0.0,0.0,0.0,0.0
Elvin Beltre,Elvin Beltre,Cincinnati Reds,REDS,1,4,2,6,2002,2002,0,6.19,-0.7,-6.89,1101,12,-1089,365,10,-355,1151.0,84.0,-1067.0,233000.0,6200000.0,5967000.0
Elvin Nina,Elvin Nina,Oakland Athletics,ATLTCS,3,7,5,12,1999,2003,4,20.51,6.2,-14.31,1029,288,-741,2006,1023,-983,4166.0,874.0,-3292.0,3050000.0,3425000.0,375000.0
Elvin Nina,Elvin Nina,Los Angeles Dodgers,DOGRS,1,1,1,2,2004,2004,0,0.0,0.03,0.03,0,34,34,0,0,0,0.0,27.0,27.0,0.0,0.0,0.0
Elvin Rodriguez,Elvin Rodriguez,Anaheim Angels,ANGELS,1,2,1,3,2017,2017,0,0.0,0.47,0.47,0,27,27,0,115,115,0.0,0.0,0.0,0.0,0.0,0.0
Elvis Alvarado,Elvis Alvarado,Washington Nationals,NATEX,1,3,2,5,2019,2020,1,0.05,-0.26,-0.31,39,55,16,0,1,1,84.0,72.0,-12.0,0.0,2210000.0,2210000.0
Elvis Perez,Elvis Perez,Atlanta Braves,BRAVES,2,2,2,4,2002,2005,3,-0.94,1.23,2.17,11,430,419,0,1,1,29.0,504.0,475.0,877500.0,0.0,-877500.0
Ely Churchich,Ely Churchich,Cleveland Indians,INDINS,3,4,4,8,1961,1966,5,-1.42,-0.53,0.89,65,52,-13,111,71,-40,0.0,0.0,0.0,0.0,0.0,0.0
Emil Panko,Emil Panko,Pittsburgh Pirates,PIRATS,1,1,1,2,1959,1961,2,0.0,-0.2,-0.2,0,38,38,0,10,10,0.0,153.0,153.0,0.0,0.0,0.0
Emil Tellinger,Emil Tellinger,New York Yankees,YANKS,2,5,3,8,1954,1955,1,3.52,0.32,-3.2,493,79,-414,1250,164,-1086,274.0,0.0,-274.0,20000.0,0.0,-20000.0
Emmanuel Ramirez,Emmanuel Ramirez,Chicago Cubs,CUBS,1,1,1,2,2003,2003,0,0.0,0.08,0.08,0,21,21,0,52,52,0.0,0.0,0.0,0.0,0.0,0.0
Ender Chavez,Ender Chavez,Colorado Rockies,ROCKS,1,1,1,2,2001,2002,1,0.0,-1.08,-1.08,0,109,109,0,375,375,0.0,0.0,0.0,0.0,0.0,0.0
Endy Rodriguez,Endy Rodriguez,New York Mets,METS,1,1,1,2,2021,2021,0,0.0,0.12,0.12,0,21,21,0,11,11,0.0,115.0,115.0,0.0,0.0,0.0
Enemencio Pacheco,Enemencio Pacheco,Colorado Rockies,ROCKS,1,1,1,2,2002,2002,0,0.0,-0.19,-0.19,0,38,38,0,120,120,0.0,0.0,0.0,0.0,2500000.0,2500000.0
Enrique Rios,Enrique Rios,Minnesota Twins,TWINS,1,1,1,2,1987,1987,0,0.0,-0.07,-0.07,0,20,20,0,58,58,0.0,0.0,0.0,0.0,0.0,0.0
Eric Barry,Eric Barry,Oakland Athletics,ATLTCS,2,4,3,7,1984,1985,1,5.99,2.63,-3.36,113,29,-84,0,0,0,1871.0,583.0,-1288.0,600000.0,625000.0,25000.0
Eric Basurto,Eric Basurto,Florida Marlins,MARLNS,1,1,2,3,2009,2009,0,0.0,0.5,0.5,0,126,126,0,259,259,0.0,3.0,3.0,0.0,0.0,0.0
Eric Broersma,Eric Broersma,Minnesota Twins,TWINS,2,3,2,5,1986,1991,5,-0.06,0.0,0.06,32,326,294,0,395,395,117.0,705.0,588.0,0.0,183700.0,183700.0
Eric Broersma,Eric Broersma,Oakland Athletics,ATLTCS,1,1,1,2,1987,1987,0,0.0,0.0,0.0,0,0,0,0,0,0,0.0,0.0,0.0,0.0,0.0,0.0
Eric Dersin,Eric Dersin,Texas Rangers,RNGRS,1,2,1,3,1985,1986,1,0.32,4.12,3.8,59,221,162,154,862,708,0.0,0.0,0.0,0.0,0.0,0.0
Eric Estes,Eric Estes,Baltimore Orioles,ORLS,1,1,1,2,1998,1998,0,0.0,-0.26,-0.26,0,28,28,0,2,2,0.0,135.0,135.0,0.0,975000.0,975000.0
Eric Filia,Eric Filia,Seattle Mariners,MARNRS,2,3,4,7,2018,2020,2,-0.26,1.51,1.77,55,98,43,1,2,1,72.0,354.0,282.0,2210000.0,0.0,-2210000.0
Eric Ireland,Eric Ireland,Chicago Cubs,CUBS,1,1,1,2,2000,2001,1,0.0,1.47,1.47,0,128,128,0,403,403,0.0,0.0,0.0,0.0,3050000.0,3050000.0
Eric Jagielo,Eric Jagielo,New York Yankees,YANKS,4,8,7,15,2015,2020,5,-1.49,8.03,9.52,440,197,-243,1007,8,-999,290.0,1270.0,980.0,3936900.0,21050000.0,17113100.0
Eric Krebs,Eric Krebs,Pittsburgh Pirates,PIRATS,1,2,1,3,2009,2010,1,0.0,-0.88,-0.88,0,234,234,0,595,595,0.0,0.0,0.0,0.0,0.0,0.0
Eric Mustad,Eric Mustad,San Diego Padres,PADRS,2,4,3,7,1981,1984,3,15.21,2.85,-12.36,959,296,-663,3500,1221,-2279,64.0,0.0,-64.0,0.0,0.0,0.0
Eric Parent,Eric Parent,Seattle Mariners,MARNRS,1,2,1,3,1984,1985,1,0.07,-0.68,-0.75,20,79,59,0,235,235,229.0,0.0,-229.0,0.0,0.0,0.0
Eric Pilkington,Eric Pilkington,Milwaukee Brewers,BREWRS,1,2,1,3,1985,1990,5,0.0,6.86,6.86,0,667,667,0,2711,2711,0.0,0.0,0.0,0.0,0.0,0.0
Eric Schmidt,Eric Schmidt,Chicago White Sox,WSOX,4,8,9,17,1986,1996,10,8.12,26.46,18.34,1204,1239,35,3582,5184,1602,266.0,488.0,222.0,4896500.0,2055555.0,-2840945.0
Eric Schmidt,Eric Schmidt,New York Yankees,YANKS,1,1,1,2,1988,1990,2,0.0,-0.19,-0.19,0,22,22,0,60,60,0.0,0.0,0.0,0.0,0.0,0.0
Eric Stone,Eric Stone,Detroit Tigers,TIGRS,1,1,1,2,1991,1991,0,0.0,0.0,0.0,0,0,0,0,0,0,0.0,0.0,0.0,0.0,0.0,0.0
Erick Leal,Erick Leal,Arizona Diamondbacks,DBACKS,2,4,3,7,2013,2019,6,-0.49,-0.24,0.25,34,59,25,15,115,100,19.0,9.0,-10.0,2884500.0,0.0,-2884500.0
Erick Ojeda,Erick Ojeda,New York Mets,METS,1,2,2,4,1997,1997,0,0.0,0.0,0.0,0,0,0,0,0,0,0.0,0.0,0.0,0.0,0.0,0.0
Erik Manoah,Erik Manoah,New York Mets,METS,1,1,1,2,2016,2017,1,0.0,-0.39,-0.39,0,128,128,0,2,2,0.0,187.0,187.0,0.0,0.0,0.0
Ernie De La Trinidad,Ernie De La Trinidad,Arizona Diamondbacks,DBACKS,2,4,3,7,2018,2021,3,0.3,5.55,5.25,48,364,316,199,1544,1345,0.0,0.0,0.0,7666667.0,4850000.0,-2816667.0
Ernie Delgado,Ernie Delgado,Florida Marlins,MARLNS,1,1,1,2,1995,1996,1,0.0,0.14,0.14,0,14,14,0,0,0,0.0,19.0,19.0,0.0,0.0,0.0
Esteban Quiroz,Esteban Quiroz,Boston Red Sox,RSOX,1,1,1,2,2018,2021,3,0.0,0.88,0.88,0,71,71,0,0,0,0.0,244.0,244.0,0.0,545000.0,545000.0
Esteban Quiroz,Esteban Quiroz,San Diego Padres,PADRS,1,3,2,5,2019,2021,2,-0.02,1.32,1.34,42,186,144,139,686,547,0.0,0.0,0.0,0.0,0.0,0.0
Esteury Ruiz,Esteury Ruiz,Kansas City Royals,ROYALS,2,7,5,12,2017,2021,4,3.49,-0.89,-4.38,348,169,-179,52,6,-46,1021.0,694.0,-327.0,538900.0,4194700.0,3655800.0
Ethan Clark,Ethan Clark,Tampa Bay Devil Rays,RAYS,2,4,2,6,2017,2018,1,0.0,0.91,0.91,23,138,115,65,518,453,0.0,0.0,0.0,5900000.0,0.0,-5900000.0
Ethan Faggett,Ethan Faggett,Boston Red Sox,RSOX,2,3,4,7,1998,1999,1,0.18,0.39,0.21,112,44,-68,326,16,-310,0.0,139.0,139.0,2000000.0,0.0,-2000000.0
Ethan Hollingsworth,Ethan Hollingsworth,Colorado Rockies,ROCKS,3,4,3,7,2011,2015,4,4.38,-1.57,-5.95,246,268,22,830,767,-63,217.0,175.0,-42.0,6000000.0,0.0,-6000000.0
Ethan Hollingsworth,Ethan Hollingsworth,Oakland Athletics,ATLTCS,1,1,1,2,2011,2012,1,0.0,-0.16,-0.16,0,39,39,0,139,139,0.0,0.0,0.0,0.0,419000.0,419000.0
Evan Crawford,Evan Crawford,San Francisco Giants,GIANTS,1,1,1,2,2010,2012,2,0.0,0.38,0.38,0,113,113,0,328,328,0.0,0.0,0.0,0.0,1000000.0,1000000.0
Evan Edwards,Evan Edwards,Miami Marlins,MARLNS,2,2,2,4,2021,2021,0,-0.78,0.87,1.65,12,75,63,0,21,21,13.0,120.0,107.0,0.0,0.0,0.0
Evan Reifert,Evan Reifert,Milwaukee Brewers,BREWRS,1,1,1,2,2021,2021,0,0.0,0.0,0.0,0,0,0,0,0,0,0.0,0.0,0.0,0.0,0.0,0.0
Evan Rust,Evan Rust,Tampa Bay Devil Rays,RAYS,1,2,1,3,2003,2004,1,0.0,2.35,2.35,0,138,138,0,538,538,0.0,0.0,0.0,0.0,7500000.0,7500000.0
Evan Sisk,Evan Sisk,St. Louis Cardinals,CARDS,1,2,2,4,2021,2021,0,-0.36,0.27,0.63,16,21,5,0,15,15,101.0,162.0,61.0,2100000.0,8000000.0,5900000.0
Everett Spikes,Everett Spikes,Detroit Tigers,TIGRS,2,6,2,8,1925,1928,3,0.0,1.07,1.07,0,324,324,0,1271,1271,0.0,0.0,0.0,0.0,30000.0,30000.0
Exicardo Cayones,Exicardo Cayones,Pittsburgh Pirates,PIRATS,1,2,2,4,2012,2013,1,0.0,3.95,3.95,4,119,115,0,138,138,31.0,1180.0,1149.0,0.0,0.0,0.0
Exicardo Cayones,Exicardo Cayones,New York Yankees,YANKS,1,2,1,3,2013,2014,1,0.0,-0.08,-0.08,0,130,130,0,458,458,0.0,0.0,0.0,0.0,0.0,0.0
Ezequiel Duran,Ezequiel Duran,New York Yankees,YANKS,1,4,3,7,2021,2021,0,-0.87,0.78,1.65,6,82,76,0,228,228,70.0,57.0,-13.0,0.0,8700000.0,8700000.0
Fabian Jimenez Angulo,Fabian Jimenez Angulo,San Diego Padres,PADRS,1,2,1,3,2006,2006,0,0.0,-0.26,-0.26,0,22,22,0,0,0,0.0,33.0,33.0,0.0,2000000.0,2000000.0
Fabian Williamson,Fabian Williamson,Seattle Mariners,MARNRS,1,1,1,2,2009,2011,2,0.0,2.37,2.37,0,133,133,0,0,0,0.0,363.0,363.0,0.0,0.0,0.0
Fabian Williamson,Fabian Williamson,Boston Red Sox,RSOX,9,27,16,43,2010,2019,9,35.43,29.55,-5.88,2876,1766,-1110,5076,5901,825,4841.0,1908.0,-2933.0,4708000.0,21865000.0,17157000.0
Fausto Macey,Fausto Macey,San Francisco Giants,GIANTS,1,2,1,3,1996,2005,9,0.96,12.44,11.48,63,1182,1119,0,4497,4497,874.0,0.0,-874.0,240000.0,725000.0,485000.0
Federico Polanco,Federico Polanco,New York Mets,METS,1,1,1,2,2021,2021,0,0.0,-0.17,-0.17,0,4,4,0,2,2,0.0,20.0,20.0,0.0,0.0,0.0
Felix Paulino,Felix Paulino,Philadelphia Phillies,PHILS,1,1,1,2,2018,2018,0,0.0,0.21,0.21,0,23,23,0,0,0,0.0,17.0,17.0,0.0,2450000.0,2450000.0
Felix Perdomo,Felix Perdomo,New York Mets,METS,15,24,25,49,1983,1999,16,42.44,11.67,-30.77,2771,1788,-983,6235,1810,-4425,4175.0,4754.0,579.0,13614666.0,12979167.0,-635499.0
Felix Valerio,Felix Valerio,New York Mets,METS,2,4,2,6,2019,2019,0,-0.03,-0.49,-0.46,40,34,-6,112,53,-59,7.0,0.0,-7.0,571765.0,0.0,-571765.0
Flavio Alfaro,Flavio Alfaro,Atlanta Braves,BRAVES,1,3,1,4,1986,1986,0,1.33,-0.29,-1.62,68,76,8,242,144,-98,0.0,0.0,0.0,0.0,0.0,0.0
Fletcher Bates,Fletcher Bates,New York Mets,METS,3,8,6,14,1997,2005,8,2.32,3.69,1.37,695,703,8,27,54,27,1207.0,1122.0,-85.0,5800000.0,1505000.0,-4295000.0
Floyd Melliere,Floyd Melliere,Charleston,Charleston,1,2,1,3,1955,1955,0,0.0,0.0,0.0,0,0,0,0,0,0,0.0,0.0,0.0,0.0,0.0,0.0
Forrest Wall,Forrest Wall,Colorado Rockies,ROCKS,1,3,1,4,2018,2019,1,0.04,0.16,0.12,1,90,89,0,0,0,3.0,119.0,116.0,0.0,0.0,0.0
Francis Kasheta,Francis Kasheta,San Francisco Giants,GIANTS,3,4,4,8,1968,1971,3,22.81,9.1,-13.71,984,429,-555,3778,1737,-2041,0.0,0.0,0.0,16000.0,23000.0,7000.0
Francisco Alvarez,Francisco Alvarez,Minnesota Twins,TWINS,1,1,1,2,2000,2000,0,0.0,0.0,0.0,0,0,0,0,0,0,0.0,0.0,0.0,0.0,0.0,0.0
Francisco Martinez,Francisco Martinez,Detroit Tigers,TIGRS,7,12,11,23,2011,2021,10,17.56,10.21,-7.35,1262,701,-561,1311,661,-650,4444.0,2831.0,-1613.0,16933000.0,8359750.0,-8573250.0
Francisco Morales,Francisco Morales,Chicago Cubs,CUBS,1,3,2,5,1995,1995,0,0.22,-1.32,-1.54,70,79,9,79,325,246,629.0,0.0,-629.0,0.0,3700000.0,3700000.0
Frandy De La Rosa,Frandy De La Rosa,Chicago Cubs,CUBS,1,1,1,2,2015,2016,1,0.0,-0.48,-0.48,0,32,32,0,2,2,0.0,64.0,64.0,0.0,0.0,0.0
Frank Bellino,Frank Bellino,Baltimore Orioles,ORLS,2,4,5,9,1988,1989,1,0.13,-2.08,-2.21,83,157,74,184,486,302,0.0,0.0,0.0,0.0,0.0,0.0
Frank Campos,Frank Campos,Chicago Cubs,CUBS,1,1,1,2,1990,1990,0,0.0,0.28,0.28,0,84,84,0,6,6,0.0,167.0,167.0,0.0,257500.0,257500.0
Frank Dodson,Frank Dodson,St. Louis Cardinals,CARDS,1,3,1,4,1921,1921,0,0.0,-0.04,-0.04,0,22,22,0,57,57,0.0,0.0,0.0,0.0,0.0,0.0
Frank Duncan,Frank Duncan,Pittsburgh Pirates,PIRATS,1,1,1,2,2017,2017,0,0.0,-0.58,-0.58,0,28,28,0,42,42,0.0,0.0,0.0,0.0,0.0,0.0
Frank Egan,Frank Egan,Cincinnati Reds,REDS,1,2,1,3,1909,1909,0,0.0,-0.01,-0.01,0,2,2,0,6,6,0.0,0.0,0.0,0.0,0.0,0.0
Frank Gailey,Frank Gailey,Toronto Blue Jays,BJAYS,5,13,7,20,2011,2016,5,10.83,2.86,-7.97,1068,336,-732,3494,659,-2835,904.0,1431.0,527.0,11237500.0,13491000.0,2253500.0
Frank German,Frank German,New York Yankees,YANKS,1,2,1,3,2021,2021,0,0.83,0.0,-0.83,75,0,-75,0,0,0,186.0,0.0,-186.0,0.0,0.0,0.0
Frank Graham,Frank Graham,New York Mets,METS,1,1,1,2,2001,2001,0,0.0,0.0,0.0,0,0,0,0,0,0,0.0,0.0,0.0,0.0,0.0,0.0
Frank Harris,Frank Harris,Detroit Tigers,TIGRS,3,6,5,11,1978,1980,2,0.12,-0.82,-0.94,242,77,-165,584,186,-398,0.0,0.0,0.0,0.0,0.0,0.0
Frank Johnson,Frank Johnson,St. Louis Cardinals,CARDS,1,1,1,2,1914,1919,5,0.0,4.18,4.18,0,330,330,0,1185,1185,0.0,0.0,0.0,0.0,0.0,0.0
Frank Tobin,Frank Tobin,Philadelphia Athletics,ATLTCS,1,1,1,2,1926,1930,4,0.0,-0.21,-0.21,0,20,20,0,74,74,0.0,0.0,0.0,0.0,0.0,0.0
Frank Vanzin,Frank Vanzin,Pittsburgh Pirates,PIRATS,6,12,13,25,1969,1988,19,54.34,40.3,-14.04,3033,2509,-524,9949,6676,-3273,5429.0,2003.0,-3426.0,819000.0,0.0,-819000.0
Frank Zoeller,Frank Zoeller,New York Yankees,YANKS,1,4,1,5,1926,1937,11,0.0,46.39,46.39,0,1659,1659,0,7068,7068,0.0,0.0,0.0,0.0,0.0,0.0
Frankie Griffin,Frankie Griffin,Philadelphia Phillies,PHILS,1,2,1,3,1985,1988,3,1.2,7.16,5.96,76,582,506,7,14,7,176.0,1102.0,926.0,0.0,830000.0,830000.0
Franklin Johnson,Franklin Johnson,St. Louis Cardinals,CARDS,1,2,1,3,1913,1913,0,0.0,0.0,0.0,0,0,0,0,0,0,0.0,0.0,0.0,0.0,0.0,0.0
Franklin Perez,Franklin Perez,Houston Astros,ASTROS,1,3,3,6,2017,2021,4,-0.1,16.16,16.26,126,77,-49,429,7,-422,3.0,1431.0,1428.0,0.0,0.0,0.0
Franklin Van Gurp,Franklin Van Gurp,San Francisco Giants,GIANTS,1,1,1,2,2019,2019,0,0.0,0.72,0.72,0,56,56,0,171,171,0.0,0.0,0.0,0.0,0.0,0.0
Frazier Hall,Frazier Hall,Anaheim Angels,ANGELS,1,1,1,2,2012,2013,1,0.0,-0.92,-0.92,0,7,7,0,0,0,0.0,36.0,36.0,0.0,0.0,0.0
Fred Anyzeski,Fred Anyzeski,New York Yankees,YANKS,1,5,1,6,1975,1976,1,0.0,0.33,0.33,0,80,80,0,217,217,0.0,0.0,0.0,0.0,0.0,0.0
Fred Harrington,Fred Harrington,St. Louis Cardinals,CARDS,1,1,1,2,1949,1949,0,0.0,0.0,0.0,0,0,0,0,0,0,0.0,0.0,0.0,0.0,0.0,0.0
Fred Hopke,Fred Hopke,Philadelphia Phillies,PHILS,1,3,2,5,1960,1968,8,5.52,24.2,18.68,336,1274,938,998,4678,3680,0.0,0.0,0.0,0.0,0.0,0.0
Fred McNair,Fred McNair,Seattle Mariners,MARNRS,1,1,1,2,1994,1994,0,0.0,-0.08,-0.08,0,2,2,0,0,0,0.0,8.0,8.0,0.0,0.0,0.0
Fred Reahm,Fred Reahm,St. Louis Cardinals,CARDS,3,4,3,7,1971,1972,1,-0.78,0.08,0.86,52,82,30,91,96,5,0.0,0.0,0.0,24000.0,0.0,-24000.0
Freddie Tisdale,Freddie Tisdale,Los Angeles Dodgers,DOGRS,1,3,1,4,1976,1981,5,0.46,19.38,18.92,71,542,471,226,2055,1829,0.0,0.0,0.0,0.0,0.0,0.0
Freddy Tiburcio,Freddy Tiburcio,Atlanta Braves,BRAVES,3,4,4,8,1987,1993,6,1.55,1.95,0.4,257,575,318,99,38,-61,607.0,1203.0,596.0,215000.0,0.0,-215000.0
Freddy Valdez,Freddy Valdez,New York Mets,METS,1,2,1,3,2021,2021,0,0.0,-0.36,-0.36,0,11,11,0,18,18,0.0,0.0,0.0,0.0,0.0,0.0
Frederick Holmes,Frederick Holmes,Boston Red Sox,RSOX,7,14,15,29,1966,1977,11,34.3,14.63,-19.67,1704,1106,-598,5095,2714,-2381,3875.0,3907.0,32.0,155000.0,163750.0,8750.0
Frederick Moulder,Frederick Moulder,Los Angeles Dodgers,DOGRS,1,1,1,2,1968,1968,0,0.0,0.95,0.95,0,50,50,0,3,3,0.0,117.0,117.0,0.0,0.0,0.0
Fredy Medina,Fredy Medina,Houston Astros,ASTROS,1,1,1,2,2020,2021,1,0.0,-0.16,-0.16,0,79,79,0,0,0,0.0,195.0,195.0,0.0,0.0,0.0
Frisco Parotte,Frisco Parotte,New York Yankees,YANKS,1,1,1,2,1997,1997,0,0.0,0.74,0.74,0,38,38,0,150,150,0.0,0.0,0.0,0.0,1287500.0,1287500.0
G.J. Raymundo,G.J. Raymundo,Toronto Blue Jays,BJAYS,1,1,1,2,2004,2005,1,0.0,0.0,0.0,0,0,0,0,0,0,0.0,0.0,0.0,0.0,0.0,0.0
Gabriel Arias,Gabriel Arias,San Diego Padres,PADRS,2,7,4,11,2020,2021,1,3.34,0.62,-2.72,311,5,-306,892,4,-888,493.0,57.0,-436.0,3000000.0,4100000.0,1100000.0
Gabriel Lino,Gabriel Lino,Baltimore Orioles,ORLS,1,2,1,3,2012,2012,0,0.0,0.0,0.0,0,28,28,0,115,115,0.0,0.0,0.0,0.0,1250000.0,1250000.0
Gabriel Maciel,Gabriel Maciel,Arizona Diamondbacks,DBACKS,2,4,3,7,2018,2021,3,0.3,5.55,5.25,48,364,316,199,1544,1345,0.0,0.0,0.0,7666667.0,4850000.0,-2816667.0
Gaby Hernandez,Gaby Hernandez,New York Mets,METS,1,2,1,3,2005,2007,2,0.0,2.55,2.55,0,243,243,0,1039,1039,0.0,0.0,0.0,0.0,4666667.0,4666667.0
Gaby Hernandez,Gaby Hernandez,Florida Marlins,MARLNS,1,1,1,2,2008,2008,0,0.0,0.89,0.89,0,50,50,0,0,0,0.0,40.0,40.0,0.0,0.0,0.0
Garrett Stallings,Garrett Stallings,Anaheim Angels,ANGELS,1,2,1,3,2020,2021,1,0.0,-1.09,-1.09,0,114,114,0,447,447,0.0,0.0,0.0,0.0,2500000.0,2500000.0
Garrett Williams,Garrett Williams,San Francisco Giants,GIANTS,1,2,2,4,2019,2020,1,0.0,0.0,0.0,0,0,0,0,0,0,0.0,0.0,0.0,0.0,12666667.0,12666667.0
Garry Pyka,Garry Pyka,Milwaukee Brewers,BREWRS,1,2,1,3,1977,1985,8,0.0,17.3,17.3,0,239,239,0,0,0,0.0,4814.0,4814.0,0.0,0.0,0.0
Gary Johnson,Gary Johnson,Chicago Cubs,CUBS,4,8,6,14,2002,2007,5,3.71,5.35,1.64,539,612,73,838,2270,1432,801.0,0.0,-801.0,7233333.0,15890494.0,8657161.0
Gary Jones,Gary Jones,Chicago Cubs,CUBS,2,5,4,9,1986,1992,6,9.01,-0.64,-9.65,632,471,-161,1598,1418,-180,382.0,0.0,-382.0,400000.0,750000.0,350000.0
Gary Melson,Gary Melson,Cleveland Indians,INDINS,1,1,1,2,1980,1980,0,0.0,-0.05,-0.05,0,4,4,0,0,0,0.0,18.0,18.0,0.0,0.0,0.0
Gary Upton,Gary Upton,Milwaukee Brewers,BREWRS,1,1,1,2,1969,1969,0,0.0,0.0,0.0,0,0,0,0,0,0,0.0,0.0,0.0,0.0,0.0,0.0
Gary Washington,Gary Washington,New York Yankees,YANKS,1,3,3,6,1970,1970,0,0.24,0.0,-0.24,29,0,-29,33,0,-33,0.0,0.0,0.0,0.0,0.0,0.0
Gene Altman,Gene Altman,Cincinnati Reds,REDS,3,4,5,9,2000,2004,4,0.58,5.78,5.2,321,456,135,1051,1700,649,0.0,0.0,0.0,3650000.0,1050000.0,-2600000.0
Gene Dusan,Gene Dusan,Oakland Athletics,ATLTCS,1,2,1,3,1972,1973,1,0.0,-0.1,-0.1,0,56,56,0,60,60,0.0,0.0,0.0,0.0,0.0,0.0
Gene Dusan,Gene Dusan,St. Louis Cardinals,CARDS,1,2,2,4,1973,1974,1,0.19,0.24,0.05,36,16,-20,60,0,-60,0.0,24.0,24.0,0.0,16000.0,16000.0
Gene Martin,Gene Martin,Philadelphia Phillies,PHILS,1,1,1,2,1973,1977,4,0.0,0.0,0.0,0,1,1,0,1,1,0.0,0.0,0.0,0.0,0.0,0.0
Geno Morones,Geno Morones,Chicago Cubs,CUBS,3,6,5,11,1995,2001,6,3.42,12.38,8.96,1105,1119,14,1379,4029,2650,1216.0,830.0,-386.0,9308333.0,6555000.0,-2753333.0
Geno Morones,Geno Morones,Kansas City Royals,ROYALS,1,3,2,5,1995,1999,4,-0.09,-0.06,0.03,38,81,43,0,0,0,74.0,445.0,371.0,0.0,125000.0,125000.0
Geoff Goetz,Geoff Goetz,New York Mets,METS,1,3,1,4,1998,2005,7,6.18,24.6,18.42,588,972,384,2350,3941,1591,0.0,0.0,0.0,0.0,0.0,0.0
Geoff Kellogg,Geoff Kellogg,Milwaukee Brewers,BREWRS,13,27,30,57,1992,2012,20,73.34,65.99,-7.35,4315,5311,996,13697,11972,-1725,3271.0,12033.0,8762.0,18537000.0,21422667.0,2885667.0
Geoff Meadows,Geoff Meadows,Houston Astros,ASTROS,2,2,2,4,1983,1984,1,0.0,-0.08,-0.08,0,35,35,0,105,105,0.0,0.0,0.0,0.0,0.0,0.0
George Byam,George Byam,Detroit Tigers,TIGRS,1,3,1,4,1949,1950,1,0.0,0.0,0.0,0,0,0,0,0,0,0.0,0.0,0.0,0.0,0.0,0.0
George Gottleber,George Gottleber,Pittsburgh Pirates,PIRATS,1,2,2,4,1928,1928,0,0.0,0.0,0.0,0,0,0,0,0,0,0.0,0.0,0.0,0.0,0.0,0.0
George Hill,George Hill,Pittsburgh Pirates,PIRATS,5,12,10,22,1979,1992,13,33.21,31.68,-1.53,1132,2093,961,2374,3444,1070,5314.0,7695.0,2381.0,1030000.0,405000.0,-625000.0
George Lacy,George Lacy,Minneapolis,Minneapolis,1,3,2,5,1939,1940,1,2.73,0.0,-2.73,141,0,-141,95,0,-95,836.0,0.0,-836.0,0.0,0.0,0.0
George Makin,George Makin,St. Louis Cardinals,CARDS,1,5,1,6,1924,1925,1,0.0,0.0,0.0,0,0,0,0,0,0,0.0,0.0,0.0,0.0,0.0,0.0
George McPhail,George McPhail,Philadelphia Phillies,PHILS,1,2,1,3,1952,1952,0,0.0,0.0,0.0,0,0,0,0,0,0,0.0,0.0,0.0,0.0,0.0,0.0
George Miner,George Miner,New York Yankees,YANKS,3,7,3,10,1933,1948,15,-3.37,1.52,4.89,613,291,-322,2436,971,-1465,0.0,0.0,0.0,9000.0,3000.0,-6000.0
George Pena,George Pena,New York Yankees,YANKS,3,6,4,10,1972,1985,13,23.27,4.1,-19.17,1007,613,-394,3692,1157,-2535,136.0,811.0,675.0,650000.0,0.0,-650000.0
George Savino,George Savino,Boston Red Sox,RSOX,2,4,3,7,1935,1946,11,-0.22,39.77,39.99,98,1215,1117,100,4433,4333,792.0,1354.0,562.0,15500.0,5500.0,-10000.0
George Snider,George Snider,Portland,Portland,1,2,4,6,1929,1933,4,5.27,0.0,-5.27,394,0,-394,395,0,-395,2946.0,0.0,-2946.0,0.0,7500.0,7500.0
George Toolson,George Toolson,New York Yankees,YANKS,1,3,1,4,1949,1949,0,0.0,0.1,0.1,0,28,28,0,3,3,0.0,80.0,80.0,0.0,0.0,0.0
George Walsh,George Walsh,Boston Braves,BRAVES,2,4,2,6,1911,1911,0,0.0,-0.64,-0.64,0,46,46,0,147,147,0.0,0.0,0.0,0.0,0.0,0.0
Gerald Ako,Gerald Ako,Kansas City Royals,ROYALS,1,2,1,3,1978,1982,4,0.0,0.56,0.56,0,212,212,0,485,485,0.0,0.0,0.0,0.0,0.0,0.0
Geraldo Padua,Geraldo Padua,New York Yankees,YANKS,2,2,3,5,1999,2000,1,-0.61,-0.1,0.51,41,128,87,68,333,265,0.0,0.0,0.0,1000000.0,5400000.0,4400000.0
Geraldo Padua,Geraldo Padua,San Diego Padres,PADRS,2,4,4,8,2000,2002,2,4.18,0.64,-3.54,373,277,-96,1290,508,-782,0.0,215.0,215.0,1750000.0,1850000.0,100000.0
Gerardo Carrillo,Gerardo Carrillo,Los Angeles Dodgers,DOGRS,1,4,2,6,2021,2021,0,0.24,4.89,4.65,47,74,27,110,252,142,188.0,205.0,17.0,0.0,47503480.0,47503480.0
Gerardo Rodriguez,Gerardo Rodriguez,Philadelphia Phillies,PHILS,2,2,2,4,1971,1976,5,7.46,2.83,-4.63,805,320,-485,2649,996,-1653,0.0,92.0,92.0,0.0,0.0,0.0
Gil Downs,Gil Downs,New York Yankees,YANKS,1,2,1,3,1966,1966,0,0.0,0.0,0.0,0,0,0,0,0,0,0.0,0.0,0.0,0.0,16500.0,16500.0
Gilbert Lara,Gilbert Lara,Milwaukee Brewers,BREWRS,1,2,2,4,2018,2018,0,0.0,0.67,0.67,0,10,10,0,8,8,0.0,76.0,76.0,0.0,12000000.0,12000000.0
Gionti Turner,Gionti Turner,Cleveland Indians,INDINS,1,1,1,2,2018,2019,1,0.0,0.0,0.0,0,0,0,0,0,0,0.0,0.0,0.0,0.0,0.0,0.0
Glenn Bott,Glenn Bott,Seattle Mariners,MARNRS,1,1,1,2,2004,2005,1,0.0,0.0,0.0,0,0,0,0,0,0,0.0,0.0,0.0,0.0,0.0,0.0
Glenn Braxton,Glenn Braxton,Chicago White Sox,WSOX,7,14,13,27,1985,1996,11,11.29,32.32,21.03,1612,1563,-49,4746,6374,1628,301.0,975.0,674.0,6084000.0,2773055.0,-3310945.0
Glenn Braxton,Glenn Braxton,New York Yankees,YANKS,4,10,9,19,1986,1992,6,2.03,5.24,3.21,652,1255,603,1902,3999,2097,488.0,0.0,-488.0,400873.0,475000.0,74127.0
Glenn Carter,Glenn Carter,California Angels,ANGELS,1,2,1,3,1991,1993,2,7.27,-1.33,-8.6,302,68,-234,0,0,0,1003.0,307.0,-696.0,120000.0,2833333.0,2713333.0
Glenn Ezell,Glenn Ezell,Minnesota Twins,TWINS,1,2,2,4,1973,1973,0,0.0,0.0,0.0,19,0,-19,19,0,-19,0.0,0.0,0.0,0.0,0.0,0.0
Glenn Gibson,Glenn Gibson,Washington Nationals,NATEX,1,1,1,2,2007,2010,3,0.0,1.99,1.99,0,188,188,0,750,750,0.0,0.0,0.0,0.0,380000.0,380000.0
Glenn Woolard,Glenn Woolard,San Francisco Giants,GIANTS,1,2,2,4,2004,2005,1,2.11,-0.79,-2.9,447,88,-359,72,5,-67,1275.0,156.0,-1119.0,0.0,0.0,0.0
Gordie Amerson,Gordie Amerson,San Diego Padres,PADRS,2,7,4,11,1997,2001,4,12.93,12.25,-0.68,1051,464,-587,3386,1273,-2113,1459.0,771.0,-688.0,0.0,4510000.0,4510000.0
Gordon Farmer,Gordon Farmer,Houston Astros,ASTROS,1,2,1,3,1989,1990,1,0.0,0.35,0.35,0,23,23,0,43,43,0.0,0.0,0.0,0.0,0.0,0.0
Grady Hall,Grady Hall,Chicago White Sox,WSOX,1,1,1,2,1991,1992,1,0.0,0.0,0.0,0,0,0,0,0,0,0.0,0.0,0.0,0.0,0.0,0.0
Graeme Snow,Graeme Snow,Brooklyn Dodgers,DOGRS,1,1,1,2,1915,1920,5,0.0,-1.75,-1.75,0,137,137,0,369,369,0.0,0.0,0.0,0.0,0.0,0.0
Graham Hicks,Graham Hicks,Washington Nationals,NATEX,1,3,1,4,2011,2012,1,0.0,1.64,1.64,0,148,148,0,40,40,0.0,531.0,531.0,0.0,0.0,0.0
Grant Anderson,Grant Anderson,Seattle Mariners,MARNRS,1,1,1,2,2019,2019,0,0.0,0.43,0.43,0,20,20,0,0,0,0.0,71.0,71.0,0.0,0.0,0.0
Grant Gambrell,Grant Gambrell,Kansas City Royals,ROYALS,1,4,2,6,2021,2021,0,-0.67,2.43,3.1,48,134,86,136,538,402,0.0,0.0,0.0,0.0,0.0,0.0
Grant Holmes,Grant Holmes,Los Angeles Dodgers,DOGRS,1,3,2,5,2016,2019,3,5.79,5.89,0.1,131,179,48,13,293,280,1774.0,1084.0,-690.0,0.0,0.0,0.0
Grant Psomas,Grant Psomas,New York Mets,METS,1,3,2,5,2005,2009,4,-3.72,4.84,8.56,420,468,48,1504,2023,519,79.0,0.0,-79.0,0.0,4000000.0,4000000.0
Grayson Long,Grayson Long,Anaheim Angels,ANGELS,1,2,1,3,2017,2017,0,0.0,0.47,0.47,0,27,27,0,115,115,0.0,0.0,0.0,0.0,0.0,0.0
Greg Bruso,Greg Bruso,San Francisco Giants,GIANTS,1,1,1,2,2003,2003,0,0.0,-0.78,-0.78,0,26,26,0,82,82,0.0,0.0,0.0,0.0,2000000.0,2000000.0
Greg Cullen,Greg Cullen,Atlanta Braves,BRAVES,1,2,1,3,2020,2021,1,0.0,-0.65,-0.65,0,3,3,0,0,0,0.0,29.0,29.0,0.0,100000.0,100000.0
Greg Dukeman,Greg Dukeman,Atlanta Braves,BRAVES,2,2,2,4,1999,2000,1,0.0,0.11,0.11,0,2,2,0,3,3,0.0,0.0,0.0,0.0,265000.0,265000.0
Greg Edge,Greg Edge,Milwaukee Brewers,BREWRS,1,1,1,2,1990,1992,2,0.0,0.0,0.0,0,0,0,0,0,0,0.0,0.0,0.0,0.0,0.0,0.0
Greg Ferlenda,Greg Ferlenda,Toronto Blue Jays,BJAYS,1,3,1,4,1985,1986,1,0.93,0.73,-0.2,6,131,125,0,477,477,78.0,0.0,-78.0,0.0,683333.0,683333.0
Greg Ferlenda,Greg Ferlenda,Texas Rangers,RNGRS,1,1,1,2,1987,1987,0,0.0,0.0,0.0,0,0,0,0,0,0,0.0,0.0,0.0,0.0,0.0,0.0
Greg Field,Greg Field,Minnesota Twins,TWINS,4,6,7,13,1978,1985,7,15.63,11.86,-3.77,831,317,-514,71,727,656,2897.0,1804.0,-1093.0,0.0,150000.0,150000.0
Greg Field,Greg Field,New York Mets,METS,2,3,3,6,1979,1981,2,2.69,-0.73,-3.42,413,378,-35,1617,1583,-34,0.0,0.0,0.0,195000.0,0.0,-195000.0
Greg Field,Greg Field,Pittsburgh Pirates,PIRATS,7,7,9,16,1980,1993,13,0.98,14.02,13.04,783,993,210,2768,2915,147,22.0,899.0,877.0,1442500.0,1020000.0,-422500.0
Greg Granger,Greg Granger,Detroit Tigers,TIGRS,1,1,1,2,1996,2012,16,0.0,-0.37,-0.37,0,2,2,0,0,0,0.0,19.0,19.0,0.0,0.0,0.0
Greg Harris,Greg Harris,Los Angeles Dodgers,DOGRS,1,2,2,4,2014,2018,4,0.23,0.98,0.75,5,298,293,0,4,4,17.0,353.0,336.0,501000.0,3000000.0,2499000.0
Greg Hillman,Greg Hillman,Chicago Cubs,CUBS,1,1,1,2,1995,1995,0,0.0,0.0,0.0,0,0,0,0,0,0,0.0,0.0,0.0,0.0,0.0,0.0
Greg Hughes,Greg Hughes,Cincinnati Reds,REDS,1,2,2,4,1980,1980,0,-0.43,0.0,0.43,24,0,-24,73,0,-73,0.0,0.0,0.0,0.0,0.0,0.0
Greg Jemison,Greg Jemison,Texas Rangers,RNGRS,8,18,14,32,1978,1986,8,37.88,13.97,-23.91,1966,931,-1035,3128,2213,-915,8593.0,2102.0,-6491.0,0.0,250000.0,250000.0
Greg Johnson,Greg Johnson,Houston Astros,ASTROS,1,1,1,2,1989,1991,2,0.0,-0.51,-0.51,0,175,175,0,371,371,0.0,0.0,0.0,0.0,0.0,0.0
Greg Kallevig,Greg Kallevig,Chicago Cubs,CUBS,1,1,1,2,1990,1990,0,0.0,0.14,0.14,0,20,20,0,2,2,0.0,61.0,61.0,0.0,150000.0,150000.0
Greg LaFever,Greg LaFever,Cleveland Indians,INDINS,1,1,1,2,1988,1988,0,0.0,-0.06,-0.06,0,11,11,0,31,31,0.0,0.0,0.0,0.0,0.0,0.0
Greg Miclat,Greg Miclat,Baltimore Orioles,ORLS,1,2,1,3,2011,2013,2,0.0,-0.52,-0.52,0,45,45,0,126,126,0.0,0.0,0.0,0.0,0.0,0.0
Greg Miller,Greg Miller,Boston Red Sox,RSOX,2,3,2,5,1999,2002,3,14.08,6.19,-7.89,828,255,-573,3105,1011,-2094,0.0,174.0,174.0,7333333.0,9500000.0,2166667.0
Greg Millikan,Greg Millikan,St. Louis Cardinals,CARDS,5,7,6,13,1972,1977,5,20.99,-1.61,-22.6,875,118,-757,2900,9,-2891,1249.0,251.0,-998.0,47500.0,42500.0,-5000.0
Greg Reinhard,Greg Reinhard,Tampa Bay Devil Rays,RAYS,1,2,1,3,2007,2009,2,0.0,-0.22,-0.22,0,18,18,0,0,0,0.0,74.0,74.0,0.0,0.0,0.0
Greg Ross,Greg Ross,Atlanta Braves,BRAVES,1,1,1,2,2012,2012,0,0.0,-0.38,-0.38,0,14,14,0,20,20,0.0,0.0,0.0,0.0,0.0,0.0
Greg Schubert,Greg Schubert,Oakland Athletics,ATLTCS,1,3,1,4,1972,1977,5,-0.03,-0.15,-0.12,84,20,-64,122,60,-62,13.0,0.0,-13.0,20500.0,36000.0,15500.0
Greg Shockey,Greg Shockey,Seattle Mariners,MARNRS,1,1,1,2,1993,1993,0,0.0,0.82,0.82,0,14,14,0,0,0,0.0,54.0,54.0,0.0,0.0,0.0
Greg Simpson,Greg Simpson,Philadelphia Phillies,PHILS,4,7,8,15,1985,1988,3,7.67,0.31,-7.36,1238,246,-992,3588,287,-3301,737.0,444.0,-293.0,1255000.0,532500.0,-722500.0
Greg Sims,Greg Sims,Pittsburgh Pirates,PIRATS,1,1,1,2,1991,1991,0,0.0,0.0,0.0,0,0,0,0,0,0,0.0,0.0,0.0,0.0,0.0,0.0
Greg Talamantez,Greg Talamantez,Baltimore Orioles,ORLS,1,2,1,3,1987,1988,1,0.54,1.0,0.46,14,52,38,2,0,-2,47.0,283.0,236.0,0.0,330000.0,330000.0
Greg Veloz,Greg Veloz,New York Mets,METS,1,1,1,2,2009,2010,1,0.0,-0.09,-0.09,0,46,46,0,149,149,0.0,0.0,0.0,0.0,400000.0,400000.0
Gregorio Rosario,Gregorio Rosario,Seattle Mariners,MARNRS,1,1,1,2,2007,2007,0,0.0,-0.42,-0.42,0,21,21,0,0,0,0.0,77.0,77.0,0.0,670000.0,670000.0
Griffin Conine,Griffin Conine,Toronto Blue Jays,BJAYS,1,1,1,2,2020,2020,0,0.0,-0.1,-0.1,0,22,22,0,79,79,0.0,0.0,0.0,0.0,8200000.0,8200000.0
Guilford Dickens,Guilford Dickens,New York Giants,GIANTS,2,2,3,5,1955,1955,0,0.73,-0.19,-0.92,107,9,-98,116,13,-103,0.0,0.0,0.0,0.0,0.0,0.0
Guillermo Mercedes,Guillermo Mercedes,Texas Rangers,RNGRS,1,1,1,2,1995,1996,1,0.0,1.82,1.82,0,95,95,0,0,0,0.0,346.0,346.0,0.0,0.0,0.0
Gus Kennedy,Gus Kennedy,San Diego Padres,PADRS,2,3,4,7,1999,2006,7,-1.99,17.0,18.99,162,874,712,576,3363,2787,0.0,547.0,547.0,9625000.0,15000000.0,5375000.0
Gus Varland,Gus Varland,Oakland Athletics,ATLTCS,1,2,2,4,2021,2021,0,-0.48,-0.38,0.1,33,13,-20,66,0,-66,0.0,27.0,27.0,0.0,0.0,0.0
Gustavo Pierre,Gustavo Pierre,Toronto Blue Jays,BJAYS,1,1,1,2,2014,2014,0,0.0,-0.02,-0.02,0,15,15,0,30,30,0.0,0.0,0.0,0.0,1587500.0,1587500.0
Guy Elston,Guy Elston,New York Yankees,YANKS,3,5,5,10,1984,1985,1,4.69,0.8,-3.89,612,147,-465,1490,453,-1037,133.0,0.0,-133.0,435000.0,0.0,-435000.0
Hak-Ju Lee,Hak-Ju Lee,Chicago Cubs,CUBS,4,8,9,17,2011,2019,8,18.8,9.35,-9.45,836,1392,556,1720,408,-1312,3536.0,2716.0,-820.0,1500000.0,0.0,-1500000.0
Hal Garrett,Hal Garrett,San Diego Padres,PADRS,13,19,19,38,1997,2005,8,0.7,9.11,8.41,1015,1374,359,2046,2428,382,1171.0,1867.0,696.0,13510000.0,3990000.0,-9520000.0
Hal Garrett,Hal Garrett,Pittsburgh Pirates,PIRATS,1,1,1,2,1997,1997,0,0.0,-0.32,-0.32,0,30,30,0,103,103,0.0,0.0,0.0,0.0,0.0,0.0
Hal Sieling,Hal Sieling,Boston Red Sox,RSOX,1,2,1,3,1940,1945,5,0.0,4.64,4.64,0,497,497,0,1845,1845,0.0,0.0,0.0,0.0,0.0,0.0
Hansel Rodriguez,Hansel Rodriguez,Toronto Blue Jays,BJAYS,1,1,2,3,2016,2017,1,0.0,-0.4,-0.4,0,57,57,0,165,165,0.0,0.0,0.0,0.0,0.0,0.0
Harold Arauz,Harold Arauz,Houston Astros,ASTROS,2,8,3,11,2015,2020,5,7.89,4.62,-3.27,397,276,-121,183,0,-183,2153.0,753.0,-1400.0,5115800.0,5819000.0,703200.0
Harold Clem,Harold Clem,Pittsburgh Pirates,PIRATS,2,5,4,9,1967,1973,6,15.42,-1.44,-16.86,860,110,-750,2406,119,-2287,2691.0,948.0,-1743.0,75000.0,45000.0,-30000.0
Harold Riggins,Harold Riggins,Colorado Rockies,ROCKS,1,1,1,2,2014,2015,1,0.0,-0.36,-0.36,0,4,4,0,2,2,0.0,28.0,28.0,0.0,0.0,0.0
Harry Brown,Harry Brown,Pittsburgh Pirates,PIRATS,1,5,1,6,1922,1922,0,0.0,0.0,0.0,0,0,0,0,0,0,0.0,0.0,0.0,2700.0,0.0,-2700.0
Harry Rhoades,Harry Rhoades,Milwaukee,Milwaukee,1,1,1,2,1916,1916,0,0.0,0.0,0.0,0,0,0,0,0,0,0.0,0.0,0.0,0.0,0.0,0.0
Harry Schwegman,Harry Schwegman,Baltimore Orioles,ORLS,3,6,5,11,1954,1956,2,5.21,0.22,-4.99,337,207,-130,1279,647,-632,0.0,0.0,0.0,0.0,19000.0,19000.0
Harry Siebert,Harry Siebert,Pittsburgh Pirates,PIRATS,1,3,1,4,1910,1910,0,0.0,0.0,0.0,0,0,0,0,0,0,0.0,0.0,0.0,0.0,0.0,0.0
Hector Correa,Hector Correa,Florida Marlins,MARLNS,1,1,1,2,2009,2010,1,0.0,2.09,2.09,0,171,171,0,610,610,0.0,0.0,0.0,0.0,0.0,0.0
Hector De Los Santos,Hector De Los Santos,Boston Red Sox,RSOX,1,1,1,2,2000,2000,0,0.0,0.06,0.06,0,21,21,0,31,31,0.0,0.0,0.0,0.0,300000.0,300000.0
Hector Made,Hector Made,New York Yankees,YANKS,1,1,1,2,2006,2006,0,0.0,-0.27,-0.27,0,28,28,0,57,57,0.0,0.0,0.0,0.0,425000.0,425000.0
Hector Quinones,Hector Quinones,Milwaukee Brewers,BREWRS,1,1,1,2,1985,1986,1,0.0,0.0,0.0,0,0,0,0,0,0,0.0,0.0,0.0,0.0,275000.0,275000.0
Hendrik Clementina,Hendrik Clementina,Los Angeles Dodgers,DOGRS,2,4,3,7,2017,2019,2,0.0,-0.41,-0.41,0,127,127,0,39,39,0.0,126.0,126.0,1325000.0,14825000.0,13500000.0
Henri Stanley,Henri Stanley,Boston Red Sox,RSOX,5,6,8,14,2004,2010,6,7.49,1.96,-5.53,501,468,-33,2029,1102,-927,0.0,155.0,155.0,4200000.0,4117500.0,-82500.0
Henry Arias,Henry Arias,Kansas City Royals,ROYALS,1,1,1,2,2008,2008,0,0.0,0.0,0.0,0,0,0,0,0,0,0.0,0.0,0.0,0.0,0.0,0.0
Henry Lavallie,Henry Lavallie,New York Yankees,YANKS,2,4,2,6,1924,1926,2,10.55,0.57,-9.98,311,20,-291,225,26,-199,1748.0,108.0,-1640.0,3000.0,10000.0,7000.0
Henry Mack,Henry Mack,Philadelphia Phillies,PHILS,7,17,13,30,1979,1999,20,25.6,38.01,12.41,2807,3562,755,9986,9588,-398,522.0,1259.0,737.0,2950000.0,165000.0,-2785000.0
Henry Santos,Henry Santos,Detroit Tigers,TIGRS,1,1,1,2,1996,1996,0,0.0,-0.5,-0.5,0,18,18,0,61,61,0.0,0.0,0.0,0.0,0.0,0.0
Henry Williamson,Henry Williamson,Baltimore Orioles,ORLS,1,2,1,3,2009,2011,2,0.0,-1.12,-1.12,0,268,268,0,764,764,0.0,0.0,0.0,0.0,0.0,0.0
Herb Lahti,Herb Lahti,Portland,Portland,1,1,2,3,1930,1930,0,0.0,0.0,0.0,0,0,0,0,0,0,0.0,0.0,0.0,0.0,0.0,0.0
Heriberto Hernandez,Heriberto Hernandez,Texas Rangers,RNGRS,1,3,3,6,2020,2021,1,0.0,0.0,0.0,0,0,0,0,0,0,0.0,0.0,0.0,0.0,0.0,0.0
Hormidas Aube,Hormidas Aube,Albany,Albany,1,1,2,3,1931,1931,0,0.0,0.0,0.0,0,0,0,0,0,0,0.0,0.0,0.0,0.0,0.0,0.0
Howard Anderson,Howard Anderson,Dallas,Dallas,1,4,2,6,1954,1954,0,0.0,0.0,0.0,0,0,0,0,0,0,0.0,0.0,0.0,0.0,0.0,0.0
Hudson Head,Hudson Head,San Diego Padres,PADRS,1,5,1,6,2021,2021,0,2.1,3.49,1.39,119,68,-51,1,57,56,182.0,544.0,362.0,0.0,0.0,0.0
Hudson Potts,Hudson Potts,San Diego Padres,PADRS,1,2,1,3,2020,2020,0,0.0,0.02,0.02,0,20,20,0,73,73,0.0,0.0,0.0,0.0,2500000.0,2500000.0
Hunter Cole,Hunter Cole,San Francisco Giants,GIANTS,2,2,5,7,2017,2019,2,-0.29,2.36,2.65,15,330,315,0,47,47,34.0,478.0,444.0,5000000.0,0.0,-5000000.0
Hunter McMahon,Hunter McMahon,Washington Nationals,NATEX,1,1,1,2,2020,2020,0,0.0,-0.32,-0.32,0,23,23,0,0,0,0.0,71.0,71.0,0.0,0.0,0.0
Hunter Stovall,Hunter Stovall,Colorado Rockies,ROCKS,1,1,1,2,2019,2020,1,0.0,0.18,0.18,0,30,30,0,0,0,0.0,47.0,47.0,0.0,0.0,0.0
Ian Bladergroen,Ian Bladergroen,New York Mets,METS,1,1,2,3,2005,2005,0,0.0,1.08,1.08,0,87,87,0,313,313,0.0,0.0,0.0,0.0,0.0,0.0
Ian Clarkin,Ian Clarkin,New York Yankees,YANKS,1,4,3,7,2017,2020,3,0.5,4.41,3.91,12,310,298,0,241,241,30.0,651.0,621.0,6150000.0,12535000.0,6385000.0
Ian Dickson,Ian Dickson,Chicago Cubs,CUBS,1,1,1,2,2013,2013,0,0.0,-0.1,-0.1,0,10,10,0,0,0,0.0,12.0,12.0,0.0,501000.0,501000.0
Ibandel Isabel,Ibandel Isabel,Los Angeles Dodgers,DOGRS,1,2,1,3,2018,2018,0,0.0,0.0,0.0,0,0,0,0,0,0,0.0,0.0,0.0,0.0,0.0,0.0
Ignacio Feliz,Ignacio Feliz,Cleveland Indians,INDINS,2,3,2,5,2018,2019,1,-0.48,-0.04,0.44,31,61,30,11,174,163,92.0,6.0,-86.0,0.0,0.0,0.0
Igor Oropeza,Igor Oropeza,Texas Rangers,RNGRS,1,2,1,3,1994,1994,0,0.0,0.29,0.29,0,29,29,0,86,86,0.0,0.0,0.0,0.0,0.0,0.0
Isaac De León,Isaac De León,Miami Marlins,MARLNS,1,1,1,2,2020,2020,0,0.0,0.23,0.23,0,19,19,0,0,0,0.0,41.0,41.0,0.0,915000.0,915000.0
Isabel Giron,Isabel Giron,Toronto Blue Jays,BJAYS,2,2,2,4,1999,1999,0,0.0,0.0,0.0,0,0,0,0,0,0,0.0,0.0,0.0,0.0,0.0,0.0
Isaiah Greene,Isaiah Greene,New York Mets,METS,1,4,2,6,2021,2021,0,2.78,2.19,-0.59,209,149,-60,798,543,-255,0.0,161.0,161.0,0.0,0.0,0.0
Isaias Velasquez,Isaias Velasquez,Cleveland Indians,INDINS,1,1,1,2,2009,2009,0,0.0,0.0,0.0,0,0,0,0,0,0,0.0,0.0,0.0,0.0,0.0,0.0
Ismael Aquino,Ismael Aquino,Oakland Athletics,ATLTCS,1,2,1,3,2019,2021,2,0.0,1.78,1.78,0,121,121,0,1,1,0.0,307.0,307.0,0.0,2250000.0,2250000.0
Ismael Mena,Ismael Mena,San Diego Padres,PADRS,1,5,2,7,2020,2020,0,-0.94,0.0,0.94,63,0,-63,44,0,-44,444.0,0.0,-444.0,5250000.0,22000000.0,16750000.0
Israel Cruz,Israel Cruz,Texas Rangers,RNGRS,1,2,2,4,2017,2018,1,0.0,-1.31,-1.31,0,42,42,0,0,0,0.0,306.0,306.0,0.0,7000000.0,7000000.0
Israel Puello,Israel Puello,Philadelphia Phillies,PHILS,1,3,1,4,2020,2020,0,0.0,-0.6,-0.6,0,10,10,0,0,0,0.0,23.0,23.0,0.0,1250000.0,1250000.0
Ivan Armstrong,Ivan Armstrong,San Francisco Giants,GIANTS,1,3,1,4,2021,2021,0,-0.36,0.65,1.01,27,52,25,0,0,0,63.0,73.0,10.0,0.0,1000000.0,1000000.0
Ivan Arteaga,Ivan Arteaga,Montreal Expos,NATEX,1,2,1,3,1994,1994,0,0.0,-1.1,-1.1,0,47,47,0,90,90,0.0,0.0,0.0,0.0,0.0,0.0
Ivan Pineyro,Ivan Pineyro,Washington Nationals,NATEX,1,2,2,4,2013,2014,1,0.0,-0.95,-0.95,0,94,94,0,149,149,0.0,0.0,0.0,0.0,0.0,0.0
Ivan Pineyro,Ivan Pineyro,Chicago Cubs,CUBS,1,2,2,4,2015,2015,0,0.0,0.17,0.17,0,21,21,0,23,23,0.0,175.0,175.0,0.0,10000000.0,10000000.0
J.B. Woodman,J.B. Woodman,Toronto Blue Jays,BJAYS,2,2,2,4,2017,2018,1,2.79,2.14,-0.65,170,130,-40,625,452,-173,0.0,0.0,0.0,2000000.0,2500000.0,500000.0
J.J. D'Orazio,J.J. D'Orazio,Toronto Blue Jays,BJAYS,1,2,1,3,2021,2021,0,0.0,-0.26,-0.26,0,10,10,0,0,0,0.0,24.0,24.0,0.0,3500000.0,3500000.0
J.J. Johnson,J.J. Johnson,Boston Red Sox,RSOX,1,2,1,3,1995,1995,0,2.15,1.05,-1.1,120,30,-90,1,0,-1,1528.0,91.0,-1437.0,109000.0,4350000.0,4241000.0
J.T. Stotts,J.T. Stotts,Oakland Athletics,ATLTCS,1,2,2,4,2003,2004,1,0.0,1.02,1.02,0,41,41,0,0,0,0.0,161.0,161.0,0.0,2200000.0,2200000.0
J.T. Thomas,J.T. Thomas,San Francisco Giants,GIANTS,1,1,1,2,2003,2004,1,0.0,0.3,0.3,0,117,117,0,324,324,0.0,0.0,0.0,0.0,315000.0,315000.0
JC Encarnación,JC Encarnación,Atlanta Braves,BRAVES,1,5,2,7,2018,2020,2,0.09,0.72,0.63,63,86,23,4,50,46,357.0,484.0,127.0,0.0,5600000.0,5600000.0
JP Sears,JP Sears,Seattle Mariners,MARNRS,1,2,1,3,2017,2019,2,0.0,-0.4,-0.4,0,16,16,0,0,0,0.0,57.0,57.0,0.0,0.0,0.0
Jack Bastable,Jack Bastable,Oakland Athletics,ATLTCS,2,2,3,5,1973,1974,1,-0.96,0.73,1.69,49,185,136,174,718,544,0.0,6.0,6.0,75000.0,0.0,-75000.0
Jack Burman,Jack Burman,Brooklyn Dodgers,DOGRS,1,3,1,4,1941,1946,5,0.0,-0.17,-0.17,0,19,19,0,34,34,0.0,0.0,0.0,0.0,8000.0,8000.0
Jack Burt,Jack Burt,Bridgeport,Bridgeport,1,1,4,5,1947,1948,1,0.0,0.0,0.0,0,0,0,0,0,0,0.0,0.0,0.0,0.0,0.0,0.0
Jack Cardey,Jack Cardey,St. Louis Cardinals,CARDS,1,3,1,4,1953,1953,0,0.0,0.0,0.0,0,0,0,0,0,0,0.0,0.0,0.0,0.0,0.0,0.0
Jack Kotzelnick,Jack Kotzelnick,St. Louis Cardinals,CARDS,1,2,2,4,1918,1918,0,0.0,-0.15,-0.15,0,31,31,0,60,60,0.0,69.0,69.0,0.0,0.0,0.0
Jack McKnight,Jack McKnight,Toronto Blue Jays,BJAYS,1,3,1,4,1985,1987,2,0.9,0.56,-0.34,130,92,-38,70,0,-70,652.0,301.0,-351.0,0.0,0.0,0.0
Jack Murphy,Jack Murphy,Toronto Blue Jays,BJAYS,1,1,1,2,2015,2017,2,0.0,1.65,1.65,0,249,249,0,694,694,0.0,3.0,3.0,0.0,2525000.0,2525000.0
Jack Smith,Jack Smith,Detroit Tigers,TIGRS,1,3,2,5,1982,1982,0,-0.02,0.0,0.02,8,0,-8,20,0,-20,0.0,0.0,0.0,0.0,0.0,0.0
Jack Suwinski,Jack Suwinski,San Diego Padres,PADRS,1,3,2,5,2021,2021,0,0.0,0.98,0.98,0,57,57,0,211,211,0.0,0.0,0.0,0.0,4300000.0,4300000.0
Jackson Melian,Jackson Melian,New York Yankees,YANKS,1,4,2,6,2000,2000,0,-1.35,0.26,1.61,143,16,-127,19,0,-19,383.0,274.0,-109.0,0.0,4750000.0,4750000.0
Jackson Melian,Jackson Melian,Milwaukee Brewers,BREWRS,1,1,1,2,2002,2003,1,0.0,0.1,0.1,0,51,51,0,169,169,0.0,0.0,0.0,0.0,277500.0,277500.0
Jacob Condra-Bogan,Jacob Condra-Bogan,Kansas City Royals,ROYALS,1,1,1,2,2018,2019,1,0.0,0.13,0.13,0,27,27,0,101,101,0.0,0.0,0.0,0.0,553900.0,553900.0
Jacob Lopez,Jacob Lopez,San Francisco Giants,GIANTS,1,1,1,2,2019,2021,2,0.0,-0.37,-0.37,0,4,4,0,10,10,0.0,0.0,0.0,0.0,0.0,0.0
Jacob Wallace,Jacob Wallace,Colorado Rockies,ROCKS,1,1,1,2,2020,2020,0,0.0,0.19,0.19,0,24,24,0,97,97,0.0,0.0,0.0,0.0,4250000.0,4250000.0
Jacobo Sequea,Jacobo Sequea,Cincinnati Reds,REDS,1,2,2,4,1999,1999,0,7.79,0.88,-6.91,427,24,-403,2,30,28,1138.0,232.0,-906.0,0.0,5250000.0,5250000.0
Jaime Goudie,Jaime Goudie,Cincinnati Reds,REDS,1,1,1,2,1999,1999,0,0.0,0.0,0.0,0,0,0,0,0,0,0.0,0.0,0.0,0.0,0.0,0.0
Jair Bogaerts,Jair Bogaerts,Boston Red Sox,RSOX,2,3,3,6,2012,2015,3,0.0,-0.08,-0.08,0,17,17,0,0,0,0.0,51.0,51.0,0.0,515000.0,515000.0
Jair Camargo,Jair Camargo,Los Angeles Dodgers,DOGRS,1,3,3,6,2020,2020,0,1.94,0.24,-1.7,36,23,-13,4,0,-4,519.0,70.0,-449.0,0.0,0.0,0.0
Jair Fernandez,Jair Fernandez,Seattle Mariners,MARNRS,1,1,1,2,2008,2008,0,0.0,0.19,0.19,0,34,34,0,4,4,0.0,337.0,337.0,0.0,0.0,0.0
Jake Blalock,Jake Blalock,Philadelphia Phillies,PHILS,1,2,1,3,2006,2006,0,-0.83,0.74,1.57,42,132,90,7,301,294,525.0,0.0,-525.0,0.0,0.0,0.0
Jake Bray,Jake Bray,Baltimore Orioles,ORLS,1,1,1,2,2017,2019,2,0.0,0.0,0.0,0,0,0,0,0,0,0.0,0.0,0.0,0.0,0.0,0.0
Jake Guenther,Jake Guenther,Tampa Bay Devil Rays,RAYS,1,3,3,6,2020,2020,0,2.36,0.0,-2.36,157,0,-157,642,0,-642,0.0,0.0,0.0,0.0,0.0,0.0
Jake Jefferies,Jake Jefferies,Tampa Bay Devil Rays,RAYS,2,2,2,4,2011,2012,1,-0.36,0.74,1.1,124,71,-53,1,1,0,187.0,187.0,0.0,1075000.0,750000.0,-325000.0
Jake Lemmerman,Jake Lemmerman,Los Angeles Dodgers,DOGRS,1,1,1,2,2012,2013,1,0.0,-1.21,-1.21,0,127,127,0,356,356,0.0,6.0,6.0,0.0,1500000.0,1500000.0
Jake Meyer,Jake Meyer,Chicago White Sox,WSOX,2,5,3,8,1999,2001,2,0.13,3.24,3.11,312,245,-67,1036,818,-218,0.0,0.0,0.0,675000.0,6600000.0,5925000.0
Jake Meyer,Jake Meyer,Cincinnati Reds,REDS,2,6,3,9,2000,2013,13,18.66,15.9,-2.76,696,1440,744,2678,3953,1275,381.0,721.0,340.0,8282695.0,396000.0,-7886695.0
Jake Peter,Jake Peter,Chicago White Sox,WSOX,3,4,6,10,2018,2018,0,0.04,1.42,1.38,75,104,29,0,1,1,83.0,235.0,152.0,2450000.0,0.0,-2450000.0
Jake Rasner,Jake Rasner,Texas Rangers,RNGRS,1,3,2,5,2006,2010,4,19.87,1.7,-18.17,323,47,-276,31,7,-24,4762.0,663.0,-4099.0,0.0,332000.0,332000.0
Jake Sanchez,Jake Sanchez,Chicago White Sox,WSOX,1,1,1,2,2014,2014,0,0.0,0.15,0.15,0,11,11,0,33,33,0.0,0.0,0.0,0.0,0.0,0.0
Jake Scheiner,Jake Scheiner,Philadelphia Phillies,PHILS,1,1,2,3,2019,2020,1,0.0,0.59,0.59,0,83,83,0,252,252,0.0,0.0,0.0,0.0,14000000.0,14000000.0
Jake Schmitt,Jake Schmitt,Philadelphia Phillies,PHILS,6,11,9,20,1951,1968,17,28.54,39.21,10.67,1270,2169,899,1527,6174,4647,4802.0,3446.0,-1356.0,0.0,12000.0,12000.0
Jake Sommers,Jake Sommers,St. Louis Cardinals,CARDS,1,5,1,6,2021,2021,0,0.69,4.14,3.45,45,157,112,42,653,611,346.0,0.0,-346.0,0.0,0.0,0.0
James Armstrong,James Armstrong,Chicago Cubs,CUBS,1,2,1,3,1969,1969,0,0.0,-0.25,-0.25,0,32,32,0,2,2,0.0,54.0,54.0,0.0,0.0,0.0
James Farris,James Farris,Chicago Cubs,CUBS,2,5,4,9,2017,2019,2,-0.39,6.25,6.64,25,115,90,0,93,93,96.0,871.0,775.0,570750.0,0.0,-570750.0
James Marinan,James Marinan,Los Angeles Dodgers,DOGRS,2,3,5,8,2018,2021,3,1.46,1.7,0.24,133,258,125,0,6,6,192.0,419.0,227.0,0.0,0.0,0.0
James Miner,James Miner,Kansas City Royals,ROYALS,1,1,1,2,1984,1984,0,0.0,-0.04,-0.04,0,4,4,0,5,5,0.0,0.0,0.0,0.0,0.0,0.0
James Nelson,James Nelson,Miami Marlins,MARLNS,1,2,1,3,2020,2021,1,0.0,-0.48,-0.48,0,12,12,0,0,0,0.0,33.0,33.0,0.0,0.0,0.0
James Ramsey,James Ramsey,St. Louis Cardinals,CARDS,1,1,1,2,2014,2014,0,0.0,-0.77,-0.77,0,17,17,0,9,9,0.0,92.0,92.0,0.0,0.0,0.0
James Reeves,James Reeves,New York Yankees,YANKS,1,1,1,2,2021,2021,0,0.0,0.42,0.42,0,15,15,0,48,48,0.0,0.0,0.0,0.0,0.0,0.0
James Skelton,James Skelton,Detroit Tigers,TIGRS,1,1,1,2,2009,2012,3,0.0,0.0,0.0,0,0,0,0,0,0,0.0,0.0,0.0,0.0,0.0,0.0
James Ward,James Ward,Philadelphia Phillies,PHILS,1,2,1,3,1912,1912,0,-0.17,-0.4,-0.23,26,24,-2,61,67,6,0.0,0.0,0.0,0.0,0.0,0.0
Jameson Hannah,Jameson Hannah,Oakland Athletics,ATLTCS,1,1,2,3,2019,2019,0,0.0,0.44,0.44,0,10,10,0,0,0,0.0,165.0,165.0,0.0,10000000.0,10000000.0
Jameson Hannah,Jameson Hannah,Cincinnati Reds,REDS,2,4,3,7,2020,2021,1,0.84,0.31,-0.53,95,46,-49,0,0,0,138.0,64.0,-74.0,0.0,4050000.0,4050000.0
Jamie Richmond,Jamie Richmond,Atlanta Braves,BRAVES,2,3,2,5,2008,2008,0,1.55,1.01,-0.54,122,88,-34,170,345,175,206.0,0.0,-206.0,7000000.0,0.0,-7000000.0
Janigson Villalobos,Janigson Villalobos,San Diego Padres,PADRS,1,1,2,3,2018,2018,0,0.0,-0.2,-0.2,0,32,32,0,1,1,0.0,62.0,62.0,0.0,0.0,0.0
Jared Blasdell,Jared Blasdell,St. Louis Cardinals,CARDS,1,2,1,3,2002,2003,1,0.0,-0.52,-0.52,0,153,153,0,10,10,0.0,287.0,287.0,0.0,2800000.0,2800000.0
Jared Camp,Jared Camp,Milwaukee Brewers,BREWRS,1,2,1,3,1996,1998,2,0.0,1.8,1.8,0,225,225,0,554,554,0.0,0.0,0.0,0.0,0.0,0.0
Jared Camp,Jared Camp,Minnesota Twins,TWINS,5,6,10,16,1999,2014,15,49.88,41.01,-8.87,1812,778,-1034,6466,1371,-5095,2229.0,4286.0,2057.0,6987500.0,7175000.0,187500.0
Jared Carkuff,Jared Carkuff,Toronto Blue Jays,BJAYS,1,2,1,3,2018,2018,0,-0.5,-0.25,0.25,13,122,109,36,506,470,0.0,0.0,0.0,0.0,0.0,0.0
Jared Ruxer,Jared Ruxer,Anaheim Angels,ANGELS,1,1,1,2,2016,2017,1,0.0,-0.4,-0.4,0,11,11,0,0,0,0.0,31.0,31.0,0.0,0.0,0.0
Jarod Plummer,Jarod Plummer,Los Angeles Dodgers,DOGRS,1,1,1,2,2006,2008,2,0.0,0.41,0.41,0,41,41,0,80,80,0.0,0.0,0.0,0.0,0.0,0.0
Jarret Martin,Jarret Martin,Baltimore Orioles,ORLS,1,2,1,3,2011,2012,1,0.0,0.14,0.14,0,16,16,0,0,0,0.0,97.0,97.0,0.0,0.0,0.0
Jason Arnold,Jason Arnold,New York Yankees,YANKS,2,7,2,9,2002,2005,3,6.71,3.6,-3.11,546,85,-461,184,2,-182,2652.0,1328.0,-1324.0,4387150.0,15714286.0,11327136.0
Jason Arnold,Jason Arnold,Oakland Athletics,ATLTCS,1,1,1,2,2002,2005,3,0.0,4.84,4.84,0,337,337,0,1390,1390,0.0,0.0,0.0,0.0,0.0,0.0
Jason Bahr,Jason Bahr,San Francisco Giants,GIANTS,1,3,1,4,2018,2018,0,0.75,0.0,-0.75,24,0,-24,0,0,0,64.0,0.0,-64.0,1675000.0,0.0,-1675000.0
Jason Belcher,Jason Belcher,Milwaukee Brewers,BREWRS,1,2,2,4,2004,2004,0,0.0,0.0,0.0,0,0,0,0,0,0,0.0,0.0,0.0,0.0,300000.0,300000.0
Jason Brester,Jason Brester,San Francisco Giants,GIANTS,1,3,1,4,1998,2000,2,0.87,8.82,7.95,148,284,136,604,1104,500,12.0,0.0,-12.0,2750000.0,4900000.0,2150000.0
Jason Burch,Jason Burch,St. Louis Cardinals,CARDS,1,3,1,4,2004,2005,1,0.0,3.28,3.28,0,144,144,0,545,545,0.0,0.0,0.0,0.0,12666667.0,12666667.0
Jason Burch,Jason Burch,Colorado Rockies,ROCKS,1,2,1,3,2007,2007,0,0.16,0.74,0.58,8,27,19,0,24,24,23.0,238.0,215.0,0.0,0.0,0.0
Jason Dewey,Jason Dewey,Anaheim Angels,ANGELS,1,2,1,3,2000,2000,0,0.0,-0.95,-0.95,0,46,46,0,80,80,0.0,0.0,0.0,0.0,0.0,0.0
Jason Felice,Jason Felice,New York Mets,METS,1,3,1,4,1982,1984,2,-1.57,2.55,4.12,181,68,-113,297,77,-220,497.0,693.0,196.0,0.0,375000.0,375000.0
Jason Felice,Jason Felice,New York Mets,METS,1,1,1,2,1987,1987,0,0.0,0.0,0.0,0,0,0,0,0,0,0.0,0.0,0.0,0.0,0.0,0.0
Jason Fitzgerald,Jason Fitzgerald,Cleveland Indians,INDINS,1,1,1,2,2002,2002,0,0.0,-0.36,-0.36,0,42,42,0,125,125,0.0,0.0,0.0,0.0,0.0,0.0
Jason Fransz,Jason Fransz,Chicago Cubs,CUBS,1,2,1,3,2003,2003,0,0.0,-0.37,-0.37,0,28,28,0,55,55,0.0,0.0,0.0,0.0,1000000.0,1000000.0
Jason Goldstein,Jason Goldstein,Seattle Mariners,MARNRS,1,1,1,2,2017,2017,0,0.0,-0.27,-0.27,0,10,10,0,0,0,0.0,55.0,55.0,0.0,0.0,0.0
Jason Heinrich,Jason Heinrich,Baltimore Orioles,ORLS,1,1,1,2,2016,2017,1,0.0,0.13,0.13,0,24,24,0,55,55,0.0,0.0,0.0,0.0,0.0,0.0
Jason Jarvis,Jason Jarvis,New York Yankees,YANKS,1,3,1,4,1995,2000,5,-0.54,20.23,20.77,27,149,122,0,13,13,296.0,2766.0,2470.0,0.0,8000000.0,8000000.0
Jason Knapp,Jason Knapp,Philadelphia Phillies,PHILS,3,6,6,12,2009,2015,6,27.43,-0.46,-27.89,716,374,-342,1539,630,-909,4038.0,442.0,-3596.0,1175000.0,6421400.0,5246400.0
Jason Lakman,Jason Lakman,Chicago White Sox,WSOX,1,4,2,6,2000,2001,1,0.13,0.48,0.35,312,100,-212,1036,320,-716,0.0,0.0,0.0,675000.0,6600000.0,5925000.0
Jason Moore,Jason Moore,San Diego Padres,PADRS,1,1,1,2,2002,2002,0,0.0,-0.14,-0.14,0,8,8,0,0,0,0.0,18.0,18.0,0.0,0.0,0.0
Jason Parker,Jason Parker,Cincinnati Reds,REDS,1,1,2,3,2021,2021,0,0.0,1.83,1.83,0,88,88,0,0,0,0.0,127.0,127.0,0.0,3900000.0,3900000.0
Jason Rice,Jason Rice,Boston Red Sox,RSOX,1,1,2,3,2011,2011,0,0.0,-0.39,-0.39,0,12,12,0,22,22,0.0,0.0,0.0,0.0,3200000.0,3200000.0
Jason Satre,Jason Satre,Cincinnati Reds,REDS,1,2,1,3,1992,1992,0,0.0,0.0,0.0,0,0,0,0,0,0,0.0,0.0,0.0,0.0,0.0,0.0
Jason Stevenson,Jason Stevenson,Chicago Cubs,CUBS,1,1,1,2,1996,1997,1,0.0,0.12,0.12,0,16,16,0,32,32,0.0,0.0,0.0,0.0,0.0,0.0
Jason Stockstill,Jason Stockstill,Anaheim Angels,ANGELS,1,2,1,3,1998,1999,1,0.0,-0.83,-0.83,0,32,32,0,79,79,0.0,0.0,0.0,0.0,700000.0,700000.0
Jason Stoffel,Jason Stoffel,San Francisco Giants,GIANTS,1,2,1,3,2011,2011,0,-0.35,-0.74,-0.39,20,56,36,18,230,212,160.0,0.0,-160.0,0.0,2300000.0,2300000.0
Jason Stokes,Jason Stokes,Florida Marlins,MARLNS,2,2,2,4,2007,2013,6,0.2,2.72,2.52,79,287,208,260,789,529,0.0,352.0,352.0,417000.0,0.0,-417000.0
Jason Turman,Jason Turman,Montreal Expos,NATEX,1,1,1,2,1999,1999,0,0.0,0.43,0.43,0,101,101,0,1,1,0.0,198.0,198.0,0.0,0.0,0.0
Javier Betancourt,Javier Betancourt,Detroit Tigers,TIGRS,1,2,1,3,2015,2017,2,6.56,0.31,-6.25,404,95,-309,1209,0,-1209,0.0,251.0,251.0,0.0,3500000.0,3500000.0
Javier Gonzalez,Javier Gonzalez,New York Mets,METS,1,2,1,3,1994,1996,2,5.97,0.34,-5.63,528,218,-310,2187,7,-2180,0.0,427.0,427.0,120000.0,180000.0,60000.0
Javier Ochoa,Javier Ochoa,New York Mets,METS,1,1,1,2,2001,2001,0,0.0,-0.92,-0.92,0,28,28,0,3,3,0.0,51.0,51.0,0.0,0.0,0.0
Javon Moran,Javon Moran,Philadelphia Phillies,PHILS,2,5,5,10,2004,2009,5,6.82,2.03,-4.79,443,166,-277,1673,131,-1542,564.0,1155.0,591.0,16900000.0,2750000.0,-14150000.0
Javon Moran,Javon Moran,Cincinnati Reds,REDS,2,3,3,6,2006,2007,1,-0.79,-0.18,0.61,21,80,59,50,242,192,0.0,0.0,0.0,2000000.0,0.0,-2000000.0
Jay Carden,Jay Carden,New York Mets,METS,1,5,1,6,1969,1971,2,11.34,3.37,-7.97,538,281,-257,615,957,342,4078.0,0.0,-4078.0,0.0,50000.0,50000.0
Jay Peterson,Jay Peterson,Chicago Cubs,CUBS,1,2,1,3,1997,1997,0,0.02,0.0,-0.02,6,0,-6,9,0,-9,0.0,0.0,0.0,0.0,0.0,0.0
Jay Yennaco,Jay Yennaco,Boston Red Sox,RSOX,1,2,1,3,1998,2000,2,-0.36,2.97,3.33,41,241,200,1,918,917,243.0,0.0,-243.0,0.0,1800000.0,1800000.0
Jean Carmona,Jean Carmona,Milwaukee Brewers,BREWRS,1,3,1,4,2018,2018,0,5.49,-0.04,-5.53,219,46,-173,950,134,-816,17.0,0.0,-17.0,2550000.0,8500000.0,5950000.0
Jean Cosme,Jean Cosme,Baltimore Orioles,ORLS,1,1,1,2,2016,2016,0,0.0,-0.22,-0.22,0,19,19,0,0,0,0.0,82.0,82.0,0.0,0.0,0.0
Jean Pinto,Jean Pinto,Anaheim Angels,ANGELS,1,2,1,3,2020,2021,1,0.0,-1.09,-1.09,0,114,114,0,447,447,0.0,0.0,0.0,0.0,2500000.0,2500000.0
Jeferson Mejia,Jeferson Mejia,Chicago Cubs,CUBS,2,4,2,6,2014,2017,3,0.75,1.66,0.91,266,245,-21,270,799,529,1562.0,7.0,-1555.0,14000000.0,10000000.0,-4000000.0
Jeferson Mejia,Jeferson Mejia,Arizona Diamondbacks,DBACKS,1,1,1,2,2017,2017,0,0.0,-0.56,-0.56,0,34,34,0,89,89,0.0,0.0,0.0,0.0,1250000.0,1250000.0
Jeff Albert,Jeff Albert,Los Angeles Dodgers,DOGRS,2,4,4,8,1977,1984,7,15.47,7.3,-8.17,1806,765,-1041,7323,1796,-5527,184.0,243.0,59.0,0.0,0.0,0.0
Jeff Bruksch,Jeff Bruksch,Oakland Athletics,ATLTCS,1,3,1,4,2003,2003,0,14.51,0.2,-14.31,509,45,-464,479,186,-293,4166.0,0.0,-4166.0,0.0,0.0,0.0
Jeff Bumgarner,Jeff Bumgarner,Minnesota Twins,TWINS,1,3,2,5,1988,1989,1,0.0,-0.66,-0.66,0,87,87,0,337,337,0.0,0.0,0.0,0.0,650000.0,650000.0
Jeff Clarke,Jeff Clarke,SiouxCity,SiouxCity,1,1,3,4,1911,1917,6,0.0,0.0,0.0,0,0,0,0,0,0,0.0,0.0,0.0,0.0,0.0,0.0
Jeff Edwards,Jeff Edwards,Los Angeles Dodgers,DOGRS,1,1,1,2,1987,1987,0,0.0,-0.39,-0.39,0,70,70,0,151,151,0.0,0.0,0.0,0.0,450000.0,450000.0
Jeff Hubbard,Jeff Hubbard,Baltimore Orioles,ORLS,1,3,1,4,1986,1987,1,0.0,-0.57,-0.57,0,34,34,0,85,85,0.0,0.0,0.0,0.0,0.0,0.0
Jeff Hulse,Jeff Hulse,Kansas City Royals,ROYALS,1,1,1,2,1989,1990,1,0.0,0.1,0.1,0,21,21,0,0,0,0.0,123.0,123.0,0.0,68000.0,68000.0
Jeff Kennard,Jeff Kennard,New York Yankees,YANKS,1,1,1,2,2007,2009,2,0.0,1.07,1.07,0,181,181,0,523,523,0.0,0.0,0.0,0.0,1350000.0,1350000.0
Jeff Knox,Jeff Knox,Philadelphia Phillies,PHILS,5,8,8,16,1986,1990,4,1.67,-0.06,-1.73,297,223,-74,689,513,-176,783.0,49.0,-734.0,1372500.0,720833.0,-651667.0
Jeff Lorick,Jeff Lorick,Atlanta Braves,BRAVES,1,3,1,4,2010,2010,0,0.0,0.92,0.92,0,39,39,0,151,151,0.0,0.0,0.0,0.0,13250000.0,13250000.0
Jeff Martin,Jeff Martin,Kansas City Royals,ROYALS,1,4,2,6,1996,1997,1,2.49,5.44,2.95,410,153,-257,728,660,-68,275.0,0.0,-275.0,120000.0,7200000.0,7080000.0
Jeff Mays,Jeff Mays,Toronto Blue Jays,BJAYS,1,3,1,4,1985,1986,1,0.93,0.73,-0.2,6,131,125,0,477,477,78.0,0.0,-78.0,0.0,683333.0,683333.0
Jeff Perry,Jeff Perry,Minnesota Twins,TWINS,1,1,1,2,1987,1987,0,0.0,-0.5,-0.5,0,9,9,0,0,0,0.0,129.0,129.0,0.0,0.0,0.0
Jeff Pries,Jeff Pries,New York Yankees,YANKS,1,2,2,4,1987,1988,1,1.62,0.02,-1.6,145,18,-127,0,47,47,649.0,0.0,-649.0,0.0,260000.0,260000.0
Jeff Reynolds,Jeff Reynolds,New York Yankees,YANKS,1,3,1,4,1982,1983,1,-0.79,-0.41,0.38,55,69,14,159,249,90,0.0,0.0,0.0,250000.0,800000.0,550000.0
Jeff Satzinger,Jeff Satzinger,Minnesota Twins,TWINS,1,2,1,3,1990,1990,0,0.0,-0.23,-0.23,0,69,69,0,237,237,0.0,0.0,0.0,0.0,0.0,0.0
Jeff Soptic,Jeff Soptic,Chicago White Sox,WSOX,1,1,1,2,2013,2015,2,0.0,2.35,2.35,0,322,322,0,1143,1143,0.0,0.0,0.0,0.0,0.0,0.0
Jeff Sovern,Jeff Sovern,Chicago White Sox,WSOX,2,3,2,5,1975,1979,4,1.12,4.35,3.23,126,167,41,15,0,-15,323.0,879.0,556.0,0.0,0.0,0.0
Jeff Taglienti,Jeff Taglienti,Boston Red Sox,RSOX,2,5,5,10,2000,2002,2,0.87,1.83,0.96,125,248,123,134,537,403,371.0,782.0,411.0,3375000.0,6575000.0,3200000.0
Jeff Taglienti,Jeff Taglienti,Colorado Rockies,ROCKS,2,3,2,5,2000,2001,1,0.55,0.19,-0.36,98,119,21,59,11,-48,524.0,256.0,-268.0,2800000.0,3200000.0,400000.0
Jeff Tuss,Jeff Tuss,Montreal Expos,NATEX,1,1,1,2,1993,1993,0,0.0,0.0,0.0,0,0,0,0,0,0,0.0,0.0,0.0,0.0,0.0,0.0
Jeff Verplancke,Jeff Verplancke,San Francisco Giants,GIANTS,1,1,2,3,2002,2002,0,0.0,-0.13,-0.13,0,8,8,0,14,14,0.0,0.0,0.0,0.0,3450000.0,3450000.0
Jeffrey Mason,Jeffrey Mason,St. Louis Cardinals,CARDS,5,6,6,12,1972,1977,5,20.99,-2.42,-23.41,875,146,-729,2900,15,-2885,1249.0,316.0,-933.0,47500.0,42500.0,-5000.0
Jeffrey Rosa,Jeffrey Rosa,Washington Nationals,NATEX,1,1,1,2,2017,2018,1,0.0,0.48,0.48,0,107,107,0,1,1,0.0,173.0,173.0,0.0,0.0,0.0
Jeffry Abreu,Jeffry Abreu,Los Angeles Dodgers,DOGRS,1,2,2,4,2019,2019,0,0.0,-0.4,-0.4,0,24,24,0,39,39,0.0,0.0,0.0,0.0,13000000.0,13000000.0
Jeisson Rosario,Jeisson Rosario,San Diego Padres,PADRS,1,2,1,3,2020,2020,0,0.0,0.02,0.02,0,20,20,0,73,73,0.0,0.0,0.0,0.0,2500000.0,2500000.0
Jereme Milons,Jereme Milons,Los Angeles Dodgers,DOGRS,1,1,1,2,2004,2005,1,0.0,0.75,0.75,0,79,79,0,14,14,0.0,256.0,256.0,0.0,4000000.0,4000000.0
Jeremias Pineda,Jeremias Pineda,Boston Red Sox,RSOX,1,1,1,2,2012,2012,0,0.0,-0.13,-0.13,0,10,10,0,29,29,0.0,0.0,0.0,0.0,515000.0,515000.0
Jeremy Blevins,Jeremy Blevins,Anaheim Angels,ANGELS,2,4,2,6,1996,2000,4,0.66,6.28,5.62,38,162,124,115,353,238,0.0,1167.0,1167.0,1916972.0,6320000.0,4403028.0
Jeremy Jackson,Jeremy Jackson,Kansas City Royals,ROYALS,1,1,1,2,1999,1999,0,0.0,0.15,0.15,0,8,8,0,0,0,0.0,25.0,25.0,0.0,0.0,0.0
Jermaine Palacios,Jermaine Palacios,Minnesota Twins,TWINS,1,1,1,2,2018,2020,2,0.0,4.28,4.28,0,73,73,0,11,11,0.0,1011.0,1011.0,0.0,0.0,0.0
Jerome Nelson,Jerome Nelson,California Angels,ANGELS,1,2,1,3,1985,1987,2,0.0,4.61,4.61,0,74,74,0,0,0,0.0,1291.0,1291.0,0.0,0.0,0.0
Jerome Yarter,Jerome Yarter,Philadelphia Athletics,ATLTCS,1,1,1,2,1936,1941,5,0.0,1.07,1.07,0,282,282,0,328,328,0.0,2600.0,2600.0,0.0,0.0,0.0
Jeromy Palki,Jeromy Palki,Seattle Mariners,MARNRS,1,2,1,3,1997,1997,0,10.83,1.1,-9.73,203,30,-173,21,129,108,2839.0,0.0,-2839.0,0.0,750000.0,750000.0
Jerrod Fuell,Jerrod Fuell,Detroit Tigers,TIGRS,1,2,3,5,2003,2010,7,2.96,5.55,2.59,57,267,210,66,23,-43,572.0,3820.0,3248.0,0.0,0.0,0.0
Jerry Amador,Jerry Amador,Seattle Mariners,MARNRS,1,2,1,3,1999,2000,1,0.81,-1.0,-1.81,5,121,116,0,527,527,90.0,0.0,-90.0,0.0,1750000.0,1750000.0
Jerry Aubin,Jerry Aubin,Pittsburgh Pirates,PIRATS,1,4,1,5,1982,1986,4,0.06,2.65,2.59,23,373,350,0,881,881,83.0,0.0,-83.0,0.0,0.0,0.0
Jerry Branch,Jerry Branch,Pittsburgh Pirates,PIRATS,3,5,5,10,1970,1973,3,0.0,0.41,0.41,0,41,41,0,35,35,0.0,36.0,36.0,17500.0,0.0,-17500.0
Jerry Holtz,Jerry Holtz,Baltimore Orioles,ORLS,1,2,2,4,1988,1988,0,-0.33,0.0,0.33,9,0,-9,10,0,-10,0.0,0.0,0.0,0.0,0.0,0.0
Jerry King,Jerry King,Boston Red Sox,RSOX,1,3,2,5,1982,1986,4,26.9,1.92,-24.98,1356,609,-747,5373,2373,-3000,4.0,0.0,-4.0,440000.0,0.0,-440000.0
Jerry King,Jerry King,Oakland Athletics,ATLTCS,1,1,1,2,1983,1983,0,0.0,-0.27,-0.27,0,8,8,0,0,0,0.0,44.0,44.0,0.0,0.0,0.0
Jerry McDonald,Jerry McDonald,Pittsburgh Pirates,PIRATS,1,1,1,2,1980,1980,0,0.0,0.0,0.0,0,3,3,0,3,3,0.0,0.0,0.0,0.0,0.0,0.0
Jerry Oakes,Jerry Oakes,Milwaukee Brewers,BREWRS,2,3,3,6,2002,2004,2,-0.18,-0.5,-0.32,49,158,109,142,124,-18,0.0,759.0,759.0,0.0,0.0,0.0
Jerry Parent,Jerry Parent,Milwaukee Brewers,BREWRS,8,13,15,28,1996,2006,10,13.14,4.75,-8.39,1056,1863,807,2193,3091,898,1015.0,2798.0,1783.0,17862000.0,10210000.0,-7652000.0
Jerry Schlegelmilch,Jerry Schlegelmilch,Minnesota Twins,TWINS,1,1,2,3,1971,1971,0,0.0,0.0,0.0,0,0,0,0,0,0,0.0,0.0,0.0,0.0,0.0,0.0
Jerson Perez,Jerson Perez,New York Mets,METS,1,1,1,2,2000,2000,0,0.0,-0.07,-0.07,0,4,4,0,0,0,0.0,8.0,8.0,0.0,0.0,0.0
Jesse Anderson,Jesse Anderson,New York Mets,METS,1,1,1,2,1980,1980,0,0.0,0.13,0.13,0,79,79,0,306,306,0.0,0.0,0.0,0.0,0.0,0.0
Jesse Anderson,Jesse Anderson,Chicago White Sox,WSOX,1,1,1,2,1982,1983,1,0.0,0.0,0.0,0,0,0,0,0,0,0.0,0.0,0.0,0.0,0.0,0.0
Jesse Ibarra,Jesse Ibarra,San Francisco Giants,GIANTS,1,1,1,2,1996,1997,1,0.0,-0.25,-0.25,0,118,118,0,372,372,0.0,0.0,0.0,0.0,670000.0,670000.0
Jessie Huggins,Jessie Huggins,Milwaukee Brewers,BREWRS,5,11,10,21,1970,1978,8,8.62,9.79,1.17,793,534,-259,2099,1479,-620,524.0,1634.0,1110.0,180301.0,32500.0,-147801.0
Jesus Azuaje,Jesus Azuaje,Cleveland Indians,INDINS,5,11,9,20,1994,2001,7,59.36,5.4,-53.96,3537,380,-3157,10591,1129,-9462,3110.0,195.0,-2915.0,7871666.0,7925000.0,53334.0
Jesus Brito,Jesus Brito,Cleveland Indians,INDINS,1,1,1,2,2010,2010,0,0.0,0.0,0.0,0,0,0,0,0,0,0.0,0.0,0.0,0.0,0.0,0.0
Jesus Castillo,Jesus Castillo,Arizona Diamondbacks,DBACKS,2,4,3,7,2013,2019,6,-0.49,-0.24,0.25,34,59,25,15,115,100,19.0,9.0,-10.0,2884500.0,0.0,-2884500.0
Jesus Castillo,Jesus Castillo,Chicago Cubs,CUBS,1,1,1,2,2016,2016,0,0.0,0.27,0.27,0,31,31,0,0,0,0.0,43.0,43.0,0.0,0.0,0.0
Jesus Cordero,Jesus Cordero,Los Angeles Dodgers,DOGRS,1,2,1,3,2001,2002,1,0.34,1.59,1.25,20,77,57,3,48,45,61.0,484.0,423.0,0.0,2750000.0,2750000.0
Jesus Lopez,Jesus Lopez,Oakland Athletics,ATLTCS,2,3,3,6,2019,2019,0,-0.39,-0.53,-0.14,19,35,16,75,126,51,0.0,3.0,3.0,12000000.0,0.0,-12000000.0
Jesus Martinez,Jesus Martinez,Arizona Diamondbacks,DBACKS,1,1,1,2,1997,1998,1,0.0,3.75,3.75,0,146,146,0,627,627,0.0,0.0,0.0,0.0,3400000.0,3400000.0
Jesus Martinez,Jesus Martinez,Florida Marlins,MARLNS,1,1,1,2,1998,2002,4,0.0,0.6,0.6,0,250,250,0,860,860,0.0,0.0,0.0,0.0,0.0,0.0
Jesus Merchan,Jesus Merchan,Philadelphia Phillies,PHILS,1,1,1,2,2007,2007,0,0.0,0.0,0.0,0,0,0,0,0,0,0.0,0.0,0.0,0.0,1075000.0,1075000.0
Jesus Merchan,Jesus Merchan,Florida Marlins,MARLNS,1,1,1,2,2011,2011,0,0.0,-0.56,-0.56,0,20,20,0,49,49,0.0,0.0,0.0,0.0,0.0,0.0
Jesus Ozoria,Jesus Ozoria,Seattle Mariners,MARNRS,1,1,1,2,2019,2019,0,0.0,2.63,2.63,0,78,78,0,281,281,0.0,9.0,9.0,0.0,0.0,0.0
Jesus Sanchez,Jesus Sanchez,New York Yankees,YANKS,1,4,2,6,2006,2008,2,0.06,7.5,7.44,46,382,336,0,1631,1631,38.0,136.0,98.0,0.0,16900000.0,16900000.0
Jesus Valdez,Jesus Valdez,Los Angeles Dodgers,DOGRS,1,1,1,2,2018,2019,1,0.0,2.07,2.07,0,98,98,0,233,233,0.0,0.0,0.0,0.0,4250000.0,4250000.0
Jeter Downs,Jeter Downs,Cincinnati Reds,REDS,2,6,6,12,2018,2020,2,0.33,2.24,1.91,53,294,241,210,761,551,24.0,499.0,475.0,30700000.0,49964000.0,19264000.0
Jeter Downs,Jeter Downs,Los Angeles Dodgers,DOGRS,1,3,3,6,2020,2020,0,4.62,3.6,-1.02,205,55,-150,839,246,-593,0.0,0.0,0.0,0.0,0.0,0.0
Jhan Zambrano,Jhan Zambrano,Texas Rangers,RNGRS,1,1,1,2,2021,2021,0,0.0,0.3,0.3,0,68,68,0,1,1,0.0,177.0,177.0,0.0,0.0,0.0
Jhoan Duran,Jhoan Duran,Arizona Diamondbacks,DBACKS,2,4,3,7,2018,2021,3,0.3,5.55,5.25,48,364,316,199,1544,1345,0.0,0.0,0.0,7666667.0,4850000.0,-2816667.0
Jhon Nunez,Jhon Nunez,Boston Red Sox,RSOX,1,1,1,2,2020,2021,1,0.0,-0.9,-0.9,0,4,4,0,0,0,0.0,26.0,26.0,0.0,0.0,0.0
Jhon Torres,Jhon Torres,Cleveland Indians,INDINS,1,2,1,3,2018,2018,0,0.0,0.0,0.0,0,0,0,0,0,0,0.0,0.0,0.0,0.0,0.0,0.0
Jhondaniel Medina,Jhondaniel Medina,Baltimore Orioles,ORLS,1,1,1,2,2012,2013,1,0.0,0.15,0.15,0,8,8,0,31,31,0.0,0.0,0.0,0.0,483000.0,483000.0
Jhonleider Salinas,Jhonleider Salinas,Cleveland Indians,INDINS,1,2,1,3,2016,2018,2,0.0,0.9,0.9,0,212,212,0,509,509,0.0,3.0,3.0,0.0,0.0,0.0
Jhonny Carvajal,Jhonny Carvajal,Cincinnati Reds,REDS,4,6,6,12,1995,2002,7,4.91,1.2,-3.71,311,343,32,13,46,33,534.0,886.0,352.0,630000.0,2779000.0,2149000.0
Jhonny Pereda,Jhonny Pereda,Chicago Cubs,CUBS,1,1,1,2,2020,2020,0,0.0,0.0,0.0,0,0,0,0,0,0,0.0,0.0,0.0,0.0,0.0,0.0
Jim Adamczak,Jim Adamczak,Chicago Cubs,CUBS,3,4,4,8,1983,1986,3,-0.29,0.14,0.43,16,70,54,0,5,5,71.0,155.0,84.0,0.0,0.0,0.0
Jim Baxter,Jim Baxter,Detroit Tigers,TIGRS,1,1,1,2,1991,1991,0,0.0,0.24,0.24,0,60,60,0,160,160,0.0,0.0,0.0,0.0,0.0,0.0
Jim Blueberg,Jim Blueberg,Seattle Mariners,MARNRS,4,6,6,12,1991,1997,6,0.63,4.76,4.13,191,388,197,402,1307,905,434.0,126.0,-308.0,829445.0,348000.0,-481445.0
Jim Davins,Jim Davins,Minnesota Twins,TWINS,1,1,1,2,1990,1990,0,0.0,-0.44,-0.44,0,37,37,0,75,75,0.0,0.0,0.0,0.0,0.0,0.0
Jim Deschaine,Jim Deschaine,Chicago Cubs,CUBS,3,10,5,15,2001,2009,8,12.08,11.04,-1.04,698,868,170,2292,2781,489,413.0,718.0,305.0,6900000.0,10775000.0,3875000.0
Jim Frey,Jim Frey,Milwaukee Braves,BRAVES,1,1,1,2,1956,1956,0,0.0,0.0,0.0,0,0,0,0,0,0,0.0,0.0,0.0,0.0,0.0,0.0
Jim Jefferson,Jim Jefferson,Montreal Expos,NATEX,5,6,7,13,1984,1990,6,0.99,-0.06,-1.05,232,245,13,372,641,269,776.0,129.0,-647.0,0.0,752000.0,752000.0
Jim Koontz,Jim Koontz,Milwaukee Brewers,BREWRS,1,3,2,5,1984,1987,3,0.0,0.59,0.59,0,124,124,0,432,432,0.0,0.0,0.0,0.0,0.0,0.0
Jim Koranda,Jim Koranda,Los Angeles Dodgers,DOGRS,1,2,1,3,1962,1962,0,-0.44,0.03,0.47,14,53,39,19,130,111,0.0,0.0,0.0,0.0,0.0,0.0
Jim Lemasters,Jim Lemasters,Atlanta Braves,BRAVES,4,6,5,11,1989,1999,10,0.53,8.7,8.17,181,486,305,594,687,93,451.0,1914.0,1463.0,3957333.0,1503000.0,-2454333.0
Jim Lewis,Jim Lewis,Houston Astros,ASTROS,3,6,6,12,1995,2008,13,0.51,3.85,3.34,210,1347,1137,625,3983,3358,615.0,482.0,-133.0,4015000.0,5550000.0,1535000.0
Jim Post,Jim Post,Baltimore Orioles,ORLS,5,10,10,20,1954,1960,6,15.05,10.79,-4.26,745,954,209,1673,2729,1056,2291.0,1208.0,-1083.0,10000.0,0.0,-10000.0
Jim Rasmussen,Jim Rasmussen,Philadelphia Phillies,PHILS,1,2,1,3,1983,1984,1,0.0,-0.39,-0.39,0,14,14,0,2,2,0.0,45.0,45.0,0.0,0.0,0.0
Jim Richardson,Jim Richardson,Brooklyn Dodgers,DOGRS,1,2,1,3,1930,1933,3,0.0,0.99,0.99,0,185,185,0,141,141,0.0,1021.0,1021.0,0.0,0.0,0.0
Jim Sak,Jim Sak,San Diego Padres,PADRS,2,4,4,8,2000,2002,2,4.18,0.64,-3.54,373,277,-96,1290,508,-782,0.0,215.0,215.0,1750000.0,1850000.0,100000.0
Jim Saul,Jim Saul,St. Louis Cardinals,CARDS,1,2,1,3,1964,1966,2,0.0,0.73,0.73,0,184,184,0,341,341,0.0,0.0,0.0,0.0,26500.0,26500.0
Jim Strichek,Jim Strichek,Cincinnati Reds,REDS,1,1,1,2,1983,1983,0,0.0,-0.28,-0.28,0,56,56,0,138,138,0.0,0.0,0.0,0.0,0.0,0.0
Jim Strichek,Jim Strichek,St. Louis Cardinals,CARDS,1,2,1,3,1983,1985,2,-0.15,0.1,0.25,4,16,12,0,0,0,19.0,30.0,11.0,0.0,0.0,0.0
Jimmy Daniel,Jimmy Daniel,Kansas City Royals,ROYALS,2,3,2,5,1986,1993,7,0.16,6.43,6.27,66,171,105,156,190,34,0.0,1390.0,1390.0,0.0,450000.0,450000.0
Jimmy Daspit,Jimmy Daspit,Los Angeles Dodgers,DOGRS,1,1,1,2,1994,1995,1,0.0,-0.08,-0.08,0,30,30,0,0,0,0.0,26.0,26.0,0.0,0.0,0.0
Jimmy Densmore,Jimmy Densmore,New York Yankees,YANKS,1,5,1,6,1934,1934,0,0.0,0.0,0.0,0,0,0,0,0,0,0.0,0.0,0.0,2000.0,0.0,-2000.0
Jimmy Hamilton,Jimmy Hamilton,Cleveland Indians,INDINS,1,2,1,3,1999,1999,0,0.0,-0.27,-0.27,0,28,28,0,96,96,0.0,0.0,0.0,0.0,1730000.0,1730000.0
Jimmy Williams,Jimmy Williams,Minnesota Twins,TWINS,1,2,1,3,1990,1991,1,0.0,-0.05,-0.05,0,56,56,0,0,0,0.0,232.0,232.0,0.0,1450000.0,1450000.0
Jimmy Williams,Jimmy Williams,New York Mets,METS,3,4,4,8,1995,1998,3,1.06,2.23,1.17,526,299,-227,1782,890,-892,0.0,0.0,0.0,5452000.0,260000.0,-5192000.0
Jio Orozco,Jio Orozco,Seattle Mariners,MARNRS,2,4,2,6,2016,2019,3,0.26,1.79,1.53,174,383,209,483,1397,914,0.0,0.0,0.0,0.0,572400.0,572400.0
Joaquin Contreras,Joaquin Contreras,New York Mets,METS,1,2,2,4,1989,1990,1,0.07,-0.15,-0.22,24,8,-16,0,9,9,343.0,0.0,-343.0,0.0,0.0,0.0
Joaquin Tejada,Joaquin Tejada,Seattle Mariners,MARNRS,1,2,1,3,2021,2021,0,0.0,0.27,0.27,0,14,14,0,3,3,0.0,191.0,191.0,0.0,2500000.0,2500000.0
Jobduan Morales,Jobduan Morales,Miami Marlins,MARLNS,2,2,2,4,2012,2014,2,-0.37,2.67,3.04,81,219,138,250,792,542,0.0,0.0,0.0,494500.0,0.0,-494500.0
Jody Johnston,Jody Johnston,New York Mets,METS,1,3,1,4,1983,1984,1,0.0,-0.14,-0.14,0,73,73,0,115,115,0.0,0.0,0.0,0.0,0.0,0.0
Joe Carroll,Joe Carroll,San Diego Padres,PADRS,4,8,6,14,1980,1984,4,16.75,2.24,-14.51,1038,424,-614,3623,1747,-1876,529.0,0.0,-529.0,0.0,0.0,0.0
Joe Chabek,Joe Chabek,Brooklyn Dodgers,DOGRS,3,8,5,13,1916,1927,11,6.65,18.0,11.35,787,1605,818,3022,6599,3577,0.0,0.0,0.0,27500.0,4800.0,-22700.0
Joe De Berry,Joe De Berry,Cincinnati Reds,REDS,7,15,9,24,1992,2010,18,38.5,29.57,-8.93,1755,1640,-115,6377,5925,-452,2595.0,2089.0,-506.0,19233333.0,12345291.0,-6888042.0
Joe Dellicarri,Joe Dellicarri,New York Mets,METS,1,1,1,2,1994,1994,0,0.0,0.0,0.0,0,0,0,0,0,0,0.0,0.0,0.0,0.0,0.0,0.0
Joe Espada,Joe Espada,Florida Marlins,MARLNS,1,1,1,2,2001,2001,0,0.0,0.5,0.5,0,40,40,0,4,4,0.0,85.0,85.0,0.0,0.0,0.0
Joe Foley,Joe Foley,Boston Red Sox,RSOX,1,2,1,3,1910,1912,2,0.0,-0.3,-0.3,0,95,95,0,329,329,0.0,0.0,0.0,0.0,0.0,0.0
Joe Gardner,Joe Gardner,Cleveland Indians,INDINS,1,4,1,5,2011,2013,2,-0.32,1.97,2.29,204,79,-125,247,10,-237,813.0,1274.0,461.0,0.0,2800000.0,2800000.0
Joe Graves,Joe Graves,New York Mets,METS,1,2,1,3,1986,1986,0,0.0,0.0,0.0,0,0,0,0,0,0,0.0,0.0,0.0,0.0,0.0,0.0
Joe Gunkel,Joe Gunkel,Boston Red Sox,RSOX,2,2,3,5,2015,2015,0,-0.25,1.11,1.36,24,60,36,75,178,103,0.0,0.0,0.0,5000000.0,0.0,-5000000.0
Joe Hicks,Joe Hicks,Chicago Cubs,CUBS,1,1,1,2,1986,1988,2,0.0,0.0,0.0,0,0,0,0,0,0,0.0,0.0,0.0,0.0,0.0,0.0
Joe Jarrell,Joe Jarrell,Kansas City Royals,ROYALS,2,3,2,5,1986,1993,7,0.16,6.43,6.27,66,171,105,156,190,34,0.0,1390.0,1390.0,0.0,450000.0,450000.0
Joe Kesselmark,Joe Kesselmark,Los Angeles Dodgers,DOGRS,1,2,1,3,1989,1989,0,0.0,0.0,0.0,0,0,0,0,0,0,0.0,0.0,0.0,0.0,0.0,0.0
Joe Lindsey,Joe Lindsey,Oakland Athletics,ATLTCS,1,2,1,3,1972,1973,1,0.0,-0.1,-0.1,0,56,56,0,60,60,0.0,0.0,0.0,0.0,0.0,0.0
Joe Lis,Joe Lis,Toronto Blue Jays,BJAYS,1,1,1,2,1996,1996,0,0.0,0.0,0.0,0,0,0,0,0,0,0.0,0.0,0.0,0.0,0.0,0.0
Joe Lisio,Joe Lisio,New York Mets,METS,1,1,1,2,1998,1999,1,0.0,0.0,0.0,0,0,0,0,0,0,0.0,0.0,0.0,0.0,0.0,0.0
Joe Lisio,Joe Lisio,Arizona Diamondbacks,DBACKS,1,2,1,3,1998,1998,0,0.0,0.27,0.27,0,64,64,0,1,1,0.0,131.0,131.0,225000.0,342500.0,117500.0
Joe McCann,Joe McCann,New York Mets,METS,1,1,1,2,1992,1992,0,0.0,0.0,0.0,0,0,0,0,0,0,0.0,0.0,0.0,0.0,0.0,0.0
Joe Messman,Joe Messman,Houston Astros,ASTROS,1,1,1,2,1999,1999,0,0.0,0.71,0.71,0,20,20,0,75,75,0.0,0.0,0.0,0.0,1750000.0,1750000.0
Joe Montalvo,Joe Montalvo,Seattle,Seattle,1,1,1,2,1951,1951,0,0.0,0.0,0.0,0,0,0,0,0,0,0.0,0.0,0.0,0.0,0.0,0.0
Joe Norris,Joe Norris,Montreal Expos,NATEX,1,1,1,2,1994,1994,0,0.0,0.0,0.0,0,0,0,0,0,0,0.0,0.0,0.0,0.0,0.0,0.0
Joe Smith,Joe Smith,San Francisco Giants,GIANTS,1,2,1,3,2001,2001,0,-0.01,-0.14,-0.13,3,54,51,6,3,-3,0.0,103.0,103.0,310000.0,350000.0,40000.0
Joe Sutton,Joe Sutton,Chicago White Sox,WSOX,1,1,1,2,1999,1999,0,0.0,0.0,0.0,0,0,0,0,0,0,0.0,0.0,0.0,0.0,0.0,0.0
Joe Szekely,Joe Szekely,Kansas City Royals,ROYALS,1,3,1,4,1983,1986,3,0.0,2.06,2.06,0,98,98,0,0,0,0.0,587.0,587.0,0.0,0.0,0.0
Joe Szekely,Joe Szekely,Pittsburgh Pirates,PIRATS,1,1,1,2,1990,1990,0,0.0,0.0,0.0,0,0,0,0,0,0,0.0,0.0,0.0,0.0,0.0,0.0
Joe Testa,Joe Testa,Minnesota Twins,TWINS,1,2,1,3,2010,2012,2,10.47,1.92,-8.55,578,130,-448,2276,0,-2276,0.0,366.0,366.0,0.0,3500000.0,3500000.0
Joe Thomas,Joe Thomas,Boston Red Sox,RSOX,1,3,2,5,1998,1998,0,0.81,-0.07,-0.88,43,39,-4,66,12,-54,325.0,72.0,-253.0,0.0,2100000.0,2100000.0
Joe Turek,Joe Turek,Cincinnati Reds,REDS,1,3,1,4,1991,1992,1,-2.2,4.96,7.16,60,62,2,0,87,87,839.0,641.0,-198.0,215000.0,2025000.0,1810000.0
Joe Vitter,Joe Vitter,Chicago Cubs,CUBS,2,7,2,9,1936,1947,11,6.07,33.87,27.8,546,772,226,1567,1415,-152,1708.0,5741.0,4033.0,9500.0,8000.0,-1500.0
Joe Wilson,Joe Wilson,Philadelphia Phillies,PHILS,2,5,5,10,2004,2009,5,6.82,2.03,-4.79,443,166,-277,1673,131,-1542,564.0,1155.0,591.0,16900000.0,2750000.0,-14150000.0
Joel Cesar,Joel Cesar,Pittsburgh Pirates,PIRATS,2,2,2,4,2020,2021,1,-0.01,-0.01,-0.0,20,37,17,1,42,41,50.0,40.0,-10.0,0.0,0.0,0.0
Joel Gibson,Joel Gibson,Philadelphia Phillies,PHILS,2,4,2,6,1964,1966,2,4.55,-0.7,-5.25,451,79,-372,428,37,-391,3416.0,375.0,-3041.0,5400.0,15000.0,9600.0
Joel Santo,Joel Santo,San Diego Padres,PADRS,1,2,1,3,2006,2006,0,0.0,-0.26,-0.26,0,22,22,0,0,0,0.0,33.0,33.0,0.0,2000000.0,2000000.0
Joel Valdez,Joel Valdez,Philadelphia Phillies,PHILS,1,2,2,4,2021,2021,0,0.0,0.0,0.0,0,0,0,0,0,0,0.0,0.0,0.0,0.0,0.0,0.0
Joey Cantillo,Joey Cantillo,San Diego Padres,PADRS,2,7,4,11,2020,2021,1,3.34,0.62,-2.72,311,5,-306,892,4,-888,493.0,57.0,-436.0,3000000.0,4100000.0,1100000.0
Joey Curletta,Joey Curletta,Los Angeles Dodgers,DOGRS,3,5,4,9,2016,2017,1,0.14,0.23,0.09,78,14,-64,181,40,-141,47.0,0.0,-47.0,8500000.0,532900.0,-7967100.0
Joey Curletta,Joey Curletta,Philadelphia Phillies,PHILS,1,1,1,2,2017,2017,0,0.0,0.0,0.0,0,0,0,0,0,0,0.0,0.0,0.0,0.0,0.0,0.0
Joey McLaughlin,Joey McLaughlin,Toronto Blue Jays,BJAYS,1,1,1,2,2006,2006,0,0.0,0.0,0.0,0,0,0,0,0,0,0.0,0.0,0.0,0.0,0.0,0.0
Joey Wentz,Joey Wentz,Atlanta Braves,BRAVES,1,2,1,3,2019,2021,2,-1.28,0.82,2.1,67,117,50,219,0,-219,3.0,208.0,205.0,0.0,4000000.0,4000000.0
Johan Dominguez,Johan Dominguez,Milwaukee Brewers,BREWRS,1,2,1,3,2018,2018,0,0.0,0.32,0.32,0,30,30,0,0,0,0.0,24.0,24.0,0.0,0.0,0.0
Johan Mieses,Johan Mieses,Los Angeles Dodgers,DOGRS,2,6,2,8,2018,2018,0,-0.21,2.29,2.5,29,86,57,41,330,289,217.0,0.0,-217.0,0.0,16000000.0,16000000.0
Johermyn Chavez,Johermyn Chavez,Toronto Blue Jays,BJAYS,1,2,1,3,2009,2014,5,0.98,5.22,4.24,193,105,-88,0,11,11,555.0,1614.0,1059.0,640000.0,425000.0,-215000.0
John Ambrose,John Ambrose,Chicago White Sox,WSOX,2,4,3,7,1999,2002,3,9.76,3.5,-6.26,587,200,-387,520,8,-512,4516.0,1281.0,-3235.0,300000.0,1933333.0,1633333.0
John Buffamoyer,John Buffamoyer,Baltimore Orioles,ORLS,1,2,2,4,1981,1981,0,0.0,0.0,0.0,0,0,0,0,0,0,0.0,0.0,0.0,0.0,0.0,0.0
John Burden,John Burden,Pittsburgh Pirates,PIRATS,2,4,2,6,1979,1982,3,-0.15,0.88,1.03,107,26,-81,27,13,-14,442.0,163.0,-279.0,0.0,0.0,0.0
John Burns,John Burns,Atlanta Braves,BRAVES,6,8,14,22,1970,1983,13,20.68,3.5,-17.18,1646,1604,-42,6239,4561,-1678,541.0,2701.0,2160.0,480000.0,157200.0,-322800.0
John Butler,John Butler,California Angels,ANGELS,1,2,1,3,1966,1969,3,-0.75,0.75,1.5,40,38,-2,1,6,5,95.0,129.0,34.0,8500.0,17000.0,8500.0
John Carter,John Carter,Kansas City Royals,ROYALS,1,3,2,5,1995,1999,4,-0.09,-0.06,0.03,38,81,43,0,0,0,74.0,445.0,371.0,0.0,125000.0,125000.0
John Carter,John Carter,New York Mets,METS,1,2,2,4,1997,1997,0,0.0,0.0,0.0,0,0,0,0,0,0,0.0,0.0,0.0,0.0,0.0,0.0
John Cotton,John Cotton,Chicago Cubs,CUBS,1,2,1,3,1999,2000,1,0.0,-0.11,-0.11,0,13,13,0,16,16,0.0,0.0,0.0,0.0,0.0,0.0
John Cox,John Cox,Chicago Cubs,CUBS,2,5,4,9,1986,1992,6,9.01,-0.64,-9.65,632,471,-161,1598,1418,-180,382.0,0.0,-382.0,400000.0,750000.0,350000.0
John Csefalvay,John Csefalvay,New York Mets,METS,1,1,1,2,1981,1984,3,0.0,0.0,0.0,0,91,91,0,222,222,0.0,0.0,0.0,0.0,0.0,0.0
John Curtice,John Curtice,Boston Red Sox,RSOX,1,2,1,3,2000,2001,1,1.86,0.82,-1.04,246,137,-109,104,537,433,1213.0,0.0,-1213.0,0.0,7000000.0,7000000.0
John Dolinsek,John Dolinsek,Houston Astros,ASTROS,2,4,3,7,1972,1975,3,0.24,-1.05,-1.29,348,159,-189,1336,70,-1266,157.0,233.0,76.0,66000.0,32000.0,-34000.0
John Githens,John Githens,Cleveland Indians,INDINS,1,2,2,4,1988,1988,0,0.0,0.0,0.0,0,0,0,0,0,0,0.0,0.0,0.0,0.0,0.0,0.0
John Hoffman,John Hoffman,Boston Red Sox,RSOX,1,2,2,4,1949,1950,1,0.0,-0.68,-0.68,0,28,28,0,12,12,0.0,68.0,68.0,0.0,0.0,0.0
John Hopkins,John Hopkins,New York Yankees,YANKS,1,3,2,5,1930,1943,13,0.0,-0.48,-0.48,0,34,34,0,24,24,0.0,173.0,173.0,6500.0,0.0,-6500.0
John Hrusovsky,John Hrusovsky,Cincinnati Reds,REDS,1,1,1,2,1994,1994,0,0.0,0.0,0.0,0,0,0,0,0,0,0.0,0.0,0.0,0.0,0.0,0.0
John Hudgins,John Hudgins,Texas Rangers,RNGRS,2,3,3,6,2006,2008,2,0.0,0.45,0.45,0,58,58,0,132,132,0.0,0.0,0.0,0.0,0.0,0.0
John Jancse,John Jancse,Baltimore Orioles,ORLS,3,6,5,11,1954,1956,2,5.21,0.22,-4.99,337,207,-130,1279,647,-632,0.0,0.0,0.0,0.0,19000.0,19000.0
John Lujan,John Lujan,Texas Rangers,RNGRS,1,1,1,2,2007,2008,1,0.0,-0.29,-0.29,0,17,17,0,43,43,0.0,0.0,0.0,0.0,0.0,0.0
John Malkin,John Malkin,Cleveland Indians,INDINS,1,1,1,2,1983,1985,2,0.0,1.18,1.18,0,31,31,0,0,0,0.0,348.0,348.0,0.0,0.0,0.0
John Mason,John Mason,Baltimore Orioles,ORLS,11,31,27,58,1968,1999,31,24.66,144.75,120.09,2993,6557,3564,6819,13225,6406,10078.0,28899.0,18821.0,759833.0,72500.0,-687333.0
John Murphy,John Murphy,Detroit Tigers,TIGRS,2,4,3,7,1978,1985,7,-2.68,10.4,13.08,239,743,504,342,1333,991,691.0,2139.0,1448.0,0.0,200000.0,200000.0
John Narron,John Narron,New York Yankees,YANKS,1,5,1,6,1975,1976,1,0.0,0.33,0.33,0,80,80,0,217,217,0.0,0.0,0.0,0.0,0.0,0.0
John Nicholson,John Nicholson,Colorado Rockies,ROCKS,8,16,13,29,1997,2002,5,6.04,1.53,-4.51,876,711,-165,660,1343,683,2239.0,928.0,-1311.0,9375000.0,9275000.0,-100000.0
John Novinsky,John Novinsky,St. Louis Cardinals,CARDS,1,2,1,3,2003,2003,0,0.23,0.18,-0.05,18,36,18,0,0,0,28.0,54.0,26.0,0.0,1700000.0,1700000.0
John Pachot,John Pachot,Montreal Expos,NATEX,1,1,1,2,1999,2004,5,0.0,-1.27,-1.27,0,172,172,0,460,460,0.0,0.0,0.0,0.0,0.0,0.0
John Pintar,John Pintar,Brooklyn Dodgers,DOGRS,1,3,1,4,1940,1949,9,0.16,3.28,3.12,111,521,410,388,1916,1528,0.0,0.0,0.0,0.0,0.0,0.0
John Posey,John Posey,Baltimore Orioles,ORLS,1,1,1,2,1989,1991,2,0.0,-0.02,-0.02,0,4,4,0,1,1,0.0,0.0,0.0,0.0,0.0,0.0
John Richy,John Richy,Los Angeles Dodgers,DOGRS,1,2,2,4,2015,2018,3,-0.34,2.52,2.86,37,386,349,98,1246,1148,0.0,0.0,0.0,0.0,0.0,0.0
John Riddle,John Riddle,Baltimore Orioles,ORLS,6,13,9,22,1966,1973,7,1.41,-0.48,-1.89,684,433,-251,1106,498,-608,1557.0,550.0,-1007.0,66000.0,36600.0,-29400.0
John Ryan,John Ryan,Milwaukee Brewers,BREWRS,1,3,1,4,1970,1971,1,0.0,0.0,0.0,0,0,0,0,0,0,0.0,0.0,0.0,0.0,0.0,0.0
John Semprini,John Semprini,New York Mets,METS,1,1,1,2,1984,1984,0,0.0,0.0,0.0,0,0,0,0,0,0,0.0,0.0,0.0,0.0,0.0,0.0
John Serritella,John Serritella,Kansas City Royals,ROYALS,1,3,1,4,1983,1986,3,0.0,2.06,2.06,0,98,98,0,0,0,0.0,587.0,587.0,0.0,0.0,0.0
John Skinner,John Skinner,Kansas City Royals,ROYALS,1,2,1,3,1981,1981,0,0.0,-1.23,-1.23,0,8,8,0,0,0,0.0,59.0,59.0,0.0,0.0,0.0
John Sneed,John Sneed,Toronto Blue Jays,BJAYS,2,2,2,4,2000,2000,0,-0.11,-0.38,-0.27,142,40,-102,217,131,-86,0.0,0.0,0.0,0.0,1250000.0,1250000.0
John Trisler,John Trisler,Milwaukee Brewers,BREWRS,12,24,26,50,1992,2012,20,48.89,52.13,3.24,3405,4089,684,10041,7823,-2218,2917.0,9528.0,6611.0,18537000.0,21422667.0,2885667.0
John Turk,John Turk,Philadelphia Phillies,PHILS,1,2,1,3,1958,1959,1,0.0,-0.11,-0.11,0,50,50,0,120,120,0.0,0.0,0.0,0.0,0.0,0.0
John Valle,John Valle,Detroit Tigers,TIGRS,1,2,1,3,1978,1980,2,0.0,4.64,4.64,0,73,73,0,0,0,0.0,1101.0,1101.0,0.0,0.0,0.0
John Wooten,John Wooten,Oakland Athletics,ATLTCS,1,1,1,2,2013,2015,2,0.0,1.97,1.97,0,142,142,0,0,0,0.0,315.0,315.0,0.0,0.0,0.0
John Young,John Young,St. Louis Cardinals,CARDS,1,2,2,4,1985,1995,10,0.0,14.6,14.6,0,992,992,0,3173,3173,0.0,18.0,18.0,0.0,0.0,0.0
John-Paul Davis,John-Paul Davis,Tampa Bay Devil Rays,RAYS,1,2,1,3,2003,2004,1,0.0,2.35,2.35,0,138,138,0,538,538,0.0,0.0,0.0,0.0,7500000.0,7500000.0
Johnny Ard,Johnny Ard,Minnesota Twins,TWINS,1,2,1,3,1990,1991,1,0.0,-0.05,-0.05,0,56,56,0,0,0,0.0,232.0,232.0,0.0,1450000.0,1450000.0
Johnny Evans,Johnny Evans,Milwaukee Brewers,BREWRS,1,2,1,3,1982,1983,1,-0.85,-0.28,0.57,52,36,-16,0,52,52,614.0,0.0,-614.0,0.0,0.0,0.0
Johnny Jones,Johnny Jones,Kansas City Royals,ROYALS,2,3,4,7,1968,1979,11,2.3,2.62,0.32,386,477,91,35,1073,1038,783.0,420.0,-363.0,50000.0,0.0,-50000.0
Johnny Raburn,Johnny Raburn,Anaheim Angels,ANGELS,1,3,2,5,2002,2002,0,-0.5,0.27,0.77,52,39,-13,74,76,2,47.0,0.0,-47.0,500000.0,2750000.0,2250000.0
Johnny Scruggs,Johnny Scruggs,Baltimore Orioles,ORLS,5,11,8,19,1967,1973,6,0.02,-1.5,-1.52,551,253,-298,598,477,-121,1557.0,66.0,-1491.0,38500.0,36600.0,-1900.0
Jon Connolly,Jon Connolly,Detroit Tigers,TIGRS,1,2,1,3,2004,2004,0,0.0,0.0,0.0,0,0,0,0,0,0,0.0,0.0,0.0,0.0,0.0,0.0
Jon Gilmore,Jon Gilmore,Atlanta Braves,BRAVES,5,12,14,26,2008,2014,6,17.06,9.0,-8.06,2364,1258,-1106,2896,3420,524,3035.0,1593.0,-1442.0,26080000.0,24455000.0,-1625000.0
Jon Keller,Jon Keller,Baltimore Orioles,ORLS,2,2,3,5,2017,2020,3,0.7,3.43,2.73,144,193,49,0,0,0,238.0,725.0,487.0,1050000.0,0.0,-1050000.0
Jon Searles,Jon Searles,Pittsburgh Pirates,PIRATS,1,2,1,3,2002,2003,1,0.0,0.0,0.0,0,0,0,0,0,0,0.0,0.0,0.0,0.0,370000.0,370000.0
Jon-Mark Sprowl,Jon-Mark Sprowl,Arizona Diamondbacks,DBACKS,1,3,2,5,2003,2003,0,-0.2,0.48,0.68,53,45,-8,58,183,125,91.0,0.0,-91.0,1200000.0,13000000.0,11800000.0
Jonah McReynolds,Jonah McReynolds,Texas Rangers,RNGRS,1,1,2,3,2019,2019,0,0.0,0.0,0.0,0,0,0,0,0,0,0.0,0.0,0.0,0.0,7250000.0,7250000.0
Jonathan Guzman,Jonathan Guzman,New York Mets,METS,1,1,1,2,1999,2000,1,0.0,0.0,0.0,0,7,7,0,0,0,0.0,0.0,0.0,0.0,0.0,0.0
Jonathan Martinez,Jonathan Martinez,Los Angeles Dodgers,DOGRS,2,2,3,5,2014,2015,1,1.65,0.76,-0.89,249,24,-225,694,49,-645,3.0,0.0,-3.0,2525000.0,0.0,-2525000.0
Jonathon Crawford,Jonathon Crawford,Detroit Tigers,TIGRS,1,2,1,3,2014,2015,1,13.23,-0.51,-13.74,916,33,-883,3730,5,-3725,0.0,561.0,561.0,0.0,1500000.0,1500000.0
Jonnathan Aristil,Jonnathan Aristil,Colorado Rockies,ROCKS,3,5,3,8,2010,2012,2,6.7,0.04,-6.66,199,171,-28,28,33,5,2842.0,468.0,-2374.0,8200000.0,7225000.0,-975000.0
Jonny Tucker,Jonny Tucker,Los Angeles Dodgers,DOGRS,4,8,8,16,1998,2006,8,3.75,12.46,8.71,1576,982,-594,3524,3610,86,1585.0,233.0,-1352.0,12365000.0,8350000.0,-4015000.0
Jordan Humphreys,Jordan Humphreys,New York Mets,METS,1,1,1,2,2020,2020,0,0.0,-0.14,-0.14,0,17,17,0,25,25,0.0,0.0,0.0,0.0,0.0,0.0
Jordan Johnson,Jordan Johnson,San Francisco Giants,GIANTS,1,2,1,3,2019,2019,0,0.0,-0.11,-0.11,0,8,8,0,16,16,0.0,0.0,0.0,0.0,0.0,0.0
Jordan Kipper,Jordan Kipper,Anaheim Angels,ANGELS,1,1,1,2,2017,2017,0,0.0,0.01,0.01,0,1,1,0,0,0,0.0,1.0,1.0,0.0,0.0,0.0
Jordan Milbrath,Jordan Milbrath,Cleveland Indians,INDINS,1,1,1,2,2019,2021,2,0.0,1.31,1.31,0,147,147,0,0,0,0.0,431.0,431.0,0.0,0.0,0.0
Jordan Paroubeck,Jordan Paroubeck,San Diego Padres,PADRS,6,17,12,29,2015,2021,6,17.57,11.2,-6.37,1317,971,-346,3711,2795,-916,1719.0,362.0,-1357.0,9570500.0,0.0,-9570500.0
Jordan Pries,Jordan Pries,Seattle Mariners,MARNRS,2,3,3,6,2016,2020,4,3.31,0.75,-2.56,262,353,91,86,1268,1182,1374.0,0.0,-1374.0,0.0,3150000.0,3150000.0
Jordan Tarsovich,Jordan Tarsovich,Los Angeles Dodgers,DOGRS,1,1,1,2,2017,2017,0,0.0,-0.35,-0.35,0,17,17,0,36,36,0.0,0.0,0.0,0.0,0.0,0.0
Jordy Barley,Jordy Barley,San Diego Padres,PADRS,1,2,1,3,2021,2021,0,-0.22,-0.24,-0.02,54,45,-9,0,0,0,65.0,57.0,-8.0,0.0,6000000.0,6000000.0
Jorge Cordova,Jorge Cordova,Florida Marlins,MARLNS,2,2,2,4,2000,2003,3,-0.19,0.38,0.57,34,100,66,4,0,-4,68.0,183.0,115.0,0.0,0.0,0.0
Jorge Cordova,Jorge Cordova,Cincinnati Reds,REDS,1,3,3,6,2002,2002,0,0.0,-0.66,-0.66,0,20,20,0,16,16,0.0,130.0,130.0,0.0,2400000.0,2400000.0
Jorge Gomez,Jorge Gomez,Texas Rangers,RNGRS,1,2,1,3,1984,1985,1,0.0,0.08,0.08,0,46,46,0,0,0,0.0,504.0,504.0,0.0,0.0,0.0
Jorge Jimenez,Jorge Jimenez,Houston Astros,ASTROS,2,4,3,7,2009,2010,1,1.04,0.25,-0.79,124,114,-10,0,0,0,162.0,160.0,-2.0,1625000.0,410000.0,-1215000.0
Jorge Nunez,Jorge Nunez,Toronto Blue Jays,BJAYS,2,3,3,6,1999,2003,4,23.05,6.03,-17.02,967,477,-490,4167,1414,-2753,0.0,331.0,331.0,14125000.0,9375000.0,-4750000.0
Jorge Nunez,Jorge Nunez,Los Angeles Dodgers,DOGRS,3,8,7,15,2002,2008,6,2.91,17.96,15.05,743,864,121,1634,1120,-514,515.0,2722.0,2207.0,9106667.0,11835000.0,2728333.0
Jorge Nunez,Jorge Nunez,Montreal Expos,NATEX,1,2,4,6,2003,2004,1,5.15,-4.18,-9.33,48,270,222,7,107,100,913.0,449.0,-464.0,0.0,0.0,0.0
Jose Acosta,Jose Acosta,Cincinnati Reds,REDS,1,1,1,2,2020,2021,1,0.0,-0.23,-0.23,0,19,19,0,34,34,0.0,0.0,0.0,0.0,0.0,0.0
Jose Almonte,Jose Almonte,Boston Red Sox,RSOX,1,2,1,3,2016,2016,0,0.0,0.93,0.93,0,34,34,0,0,0,0.0,89.0,89.0,0.0,0.0,0.0
Jose Amado,Jose Amado,Seattle Mariners,MARNRS,1,1,1,2,1996,1997,1,0.0,-0.15,-0.15,0,15,15,0,0,0,0.0,127.0,127.0,0.0,0.0,0.0
Jose Arias,Jose Arias,Chicago Cubs,CUBS,1,2,1,3,2014,2015,1,0.0,-0.66,-0.66,0,15,15,0,10,10,0.0,104.0,104.0,0.0,0.0,0.0
Jose Berroa,Jose Berroa,Pittsburgh Pirates,PIRATS,1,1,1,2,2021,2021,0,0.0,0.08,0.08,0,2,2,0,6,6,0.0,0.0,0.0,0.0,0.0,0.0
Jose Caballero,Jose Caballero,Arizona Diamondbacks,DBACKS,1,1,2,3,2019,2020,1,0.0,-0.62,-0.62,0,20,20,0,22,22,0.0,180.0,180.0,0.0,16000000.0,16000000.0
Jose Calero,Jose Calero,Minnesota Twins,TWINS,1,2,2,4,1966,1968,2,-1.3,-0.53,0.77,68,125,57,19,299,280,243.0,0.0,-243.0,0.0,0.0,0.0
Jose Castro,Jose Castro,Philadelphia Phillies,PHILS,1,1,2,3,1981,1981,0,0.0,0.0,0.0,0,0,0,0,0,0,0.0,0.0,0.0,0.0,0.0,0.0
Jose Castro,Jose Castro,New York Mets,METS,1,2,1,3,2007,2007,0,0.0,-0.79,-0.79,0,21,21,0,50,50,0.0,0.0,0.0,0.0,2000000.0,2000000.0
Jose Cepeda,Jose Cepeda,Kansas City Royals,ROYALS,1,1,1,2,1999,1999,0,0.0,-0.15,-0.15,0,8,8,0,0,0,0.0,25.0,25.0,0.0,0.0,0.0
Jose Corniell,Jose Corniell,Seattle Mariners,MARNRS,2,4,3,7,2020,2021,1,0.78,-0.11,-0.89,33,124,91,0,253,253,87.0,184.0,97.0,3500000.0,4785000.0,1285000.0
Jose Cueto,Jose Cueto,Chicago Cubs,CUBS,1,4,2,6,2002,2004,2,19.76,10.92,-8.84,396,427,31,455,211,-244,3529.0,2185.0,-1344.0,0.0,0.0,0.0
Jose De La Cruz,Jose De La Cruz,Tampa Bay Devil Rays,RAYS,1,1,1,2,2006,2007,1,0.0,0.0,0.0,0,0,0,0,0,0,0.0,0.0,0.0,0.0,0.0,0.0
Jose Delgado,Jose Delgado,Pittsburgh Pirates,PIRATS,2,2,2,4,1994,1995,1,0.64,-0.86,-1.5,49,76,27,119,252,133,0.0,0.0,0.0,250000.0,0.0,-250000.0
Jose Dominguez,Jose Dominguez,Minnesota Twins,TWINS,2,4,3,7,1987,1991,4,0.91,5.69,4.78,306,646,340,81,2698,2617,1068.0,6.0,-1062.0,0.0,0.0,0.0
Jose Estrada,Jose Estrada,Anaheim Angels,ANGELS,1,1,1,2,2020,2021,1,0.0,-0.03,-0.03,0,2,2,0,0,0,0.0,7.0,7.0,0.0,0.0,0.0
Jose Garcia,Jose Garcia,New York Yankees,YANKS,2,2,2,4,2004,2004,0,4.32,0.0,-4.32,487,0,-487,1436,0,-1436,0.0,0.0,0.0,0.0,0.0,0.0
Jose Gomez,Jose Gomez,Colorado Rockies,ROCKS,1,3,1,4,2017,2017,0,0.33,0.69,0.36,79,53,-26,2,0,-2,117.0,66.0,-51.0,0.0,6500000.0,6500000.0
Jose King,Jose King,Arizona Diamondbacks,DBACKS,1,3,1,4,2017,2017,0,-1.37,2.41,3.78,123,62,-61,423,257,-166,0.0,0.0,0.0,0.0,0.0,0.0
Jose Marte,Jose Marte,Texas Rangers,RNGRS,1,1,1,2,2008,2010,2,0.0,1.4,1.4,0,80,80,0,1,1,0.0,594.0,594.0,0.0,0.0,0.0
Jose Martinez,Jose Martinez,Kansas City Royals,ROYALS,1,1,1,2,2015,2016,1,0.0,-0.12,-0.12,0,4,4,0,5,5,0.0,0.0,0.0,0.0,775000.0,775000.0
Jose Monzon,Jose Monzon,Houston Astros,ASTROS,1,2,2,4,2012,2015,3,0.63,0.0,-0.63,153,0,-153,1,0,-1,245.0,0.0,-245.0,0.0,0.0,0.0
Jose Musset,Jose Musset,California Angels,ANGELS,1,1,2,3,1993,1995,2,0.0,1.15,1.15,0,164,164,0,558,558,0.0,0.0,0.0,0.0,2250000.0,2250000.0
Jose Olmeda,Jose Olmeda,Boston Red Sox,RSOX,2,3,2,5,1999,1999,0,1.49,0.53,-0.96,212,5,-207,24,0,-24,420.0,77.0,-343.0,0.0,2500000.0,2500000.0
Jose Pett,Jose Pett,Toronto Blue Jays,BJAYS,2,7,5,12,1996,2001,5,5.42,8.51,3.09,1726,826,-900,3923,2165,-1758,1392.0,748.0,-644.0,1500000.0,5870000.0,4370000.0
Jose Pimentel,Jose Pimentel,Los Angeles Dodgers,DOGRS,1,1,1,2,1998,1998,0,0.0,-0.14,-0.14,0,5,5,0,9,9,0.0,0.0,0.0,0.0,0.0,0.0
Jose Rafael De Paula,Jose Rafael De Paula,New York Yankees,YANKS,3,6,4,10,2014,2018,4,4.88,7.78,2.9,526,501,-25,1896,1981,85,219.0,0.0,-219.0,13550625.0,0.0,-13550625.0
Jose Rivera,Jose Rivera,Pittsburgh Pirates,PIRATS,1,4,1,5,1982,1986,4,0.06,2.65,2.59,23,373,350,0,881,881,83.0,0.0,-83.0,0.0,0.0,0.0
Jose Salvador,Jose Salvador,Cincinnati Reds,REDS,1,2,1,3,2020,2020,0,-0.21,-0.49,-0.28,9,20,11,1,55,54,68.0,0.0,-68.0,0.0,2200000.0,2200000.0
Jose Santos,Jose Santos,Texas Rangers,RNGRS,1,2,1,3,1998,1999,1,0.0,3.05,3.05,0,208,208,0,869,869,0.0,0.0,0.0,0.0,0.0,0.0
Jose Torres,Jose Torres,Kansas City Royals,ROYALS,1,3,1,4,1983,1986,3,0.0,2.06,2.06,0,98,98,0,0,0,0.0,587.0,587.0,0.0,0.0,0.0
Jose Vallejo,Jose Vallejo,Texas Rangers,RNGRS,1,2,1,3,2009,2009,0,0.0,-0.43,-0.43,0,28,28,0,104,104,0.0,0.0,0.0,0.0,1500000.0,1500000.0
Jose Ventura,Jose Ventura,Chicago White Sox,WSOX,1,1,1,2,1992,1992,0,0.0,0.0,0.0,0,0,0,0,0,0,0.0,0.0,0.0,0.0,0.0,0.0
Joseph Christian,Joseph Christian,Minnesota Twins,TWINS,1,1,1,2,1965,1965,0,0.0,0.0,0.0,0,0,0,0,0,0,0.0,0.0,0.0,0.0,0.0,0.0
Joseph Faraci,Joseph Faraci,New York Yankees,YANKS,1,2,1,3,1967,1968,1,0.0,0.0,0.0,0,0,0,0,0,0,0.0,0.0,0.0,0.0,0.0,0.0
Joseph Jarneski,Joseph Jarneski,Texas Rangers,RNGRS,1,2,2,4,2019,2019,0,0.0,0.0,0.0,0,0,0,0,0,0,0.0,0.0,0.0,0.0,4650000.0,4650000.0
Joseph Turczak,Joseph Turczak,Cincinnati Reds,REDS,1,2,2,4,1945,1947,2,0.0,0.0,0.0,0,0,0,0,0,0,0.0,0.0,0.0,0.0,0.0,0.0
Josh Dimmick,Josh Dimmick,Houston Astros,ASTROS,1,1,1,2,1999,1999,0,0.0,0.0,0.0,0,0,0,0,0,0,0.0,0.0,0.0,0.0,0.0,0.0
Josh Elander,Josh Elander,Atlanta Braves,BRAVES,1,1,2,3,2015,2015,0,0.0,-0.68,-0.68,0,30,30,0,5,5,0.0,79.0,79.0,0.0,0.0,0.0
Josh Gessner,Josh Gessner,Philadelphia Phillies,PHILS,1,3,4,7,2021,2021,0,-1.21,0.8,2.01,9,74,65,0,29,29,64.0,300.0,236.0,0.0,9766666.0,9766666.0
Josh Habel,Josh Habel,San Francisco Giants,GIANTS,1,1,1,2,2004,2004,0,0.0,0.01,0.01,0,12,12,0,1,1,0.0,19.0,19.0,0.0,440000.0,440000.0
Josh Harris,Josh Harris,Cincinnati Reds,REDS,4,7,7,14,1999,2004,5,10.74,9.45,-1.29,965,646,-319,3397,2378,-1019,0.0,0.0,0.0,3650000.0,1050000.0,-2600000.0
Josh Hoffpauir,Josh Hoffpauir,Texas Rangers,RNGRS,1,1,1,2,2004,2004,0,0.0,0.2,0.2,0,4,4,0,0,0,0.0,57.0,57.0,0.0,700000.0,700000.0
Josh McAffee,Josh McAffee,Arizona Diamondbacks,DBACKS,1,1,1,2,2000,2002,2,0.0,0.0,0.0,0,0,0,0,0,0,0.0,0.0,0.0,0.0,0.0,0.0
Josh McKinley,Josh McKinley,Montreal Expos,NATEX,1,2,2,4,2004,2004,0,3.6,-0.83,-4.43,40,55,15,5,159,154,603.0,0.0,-603.0,0.0,0.0,0.0
Josh Pennington,Josh Pennington,Boston Red Sox,RSOX,1,4,1,5,2016,2019,3,5.97,-0.24,-6.21,440,43,-397,1667,0,-1667,0.0,128.0,128.0,515000.0,513900.0,-1100.0
Josh Pressley,Josh Pressley,Tampa Bay Devil Rays,RAYS,1,2,1,3,2002,2003,1,0.0,0.68,0.68,0,34,34,0,124,124,0.0,0.0,0.0,575000.0,6250000.0,5675000.0
Josh Reynolds,Josh Reynolds,New York Mets,METS,1,3,2,5,2002,2003,1,0.08,0.83,0.75,11,64,53,13,7,-6,29.0,147.0,118.0,0.0,500000.0,500000.0
Josh Santos,Josh Santos,San Francisco Giants,GIANTS,2,3,2,5,1999,2000,1,-0.22,0.45,0.67,53,114,61,0,1,1,225.0,174.0,-51.0,0.0,687500.0,687500.0
Josh Smith,Josh Smith,New York Yankees,YANKS,1,4,3,7,2021,2021,0,-0.87,0.78,1.65,6,82,76,0,228,228,70.0,57.0,-13.0,0.0,8700000.0,8700000.0
Josh Stowers,Josh Stowers,Seattle Mariners,MARNRS,1,1,1,2,2019,2019,0,0.0,0.0,0.0,0,0,0,0,0,0,0.0,0.0,0.0,0.0,0.0,0.0
Josh Stowers,Josh Stowers,Seattle Mariners,MARNRS,1,1,1,2,2019,2021,2,0.0,-0.42,-0.42,0,110,110,0,417,417,0.0,0.0,0.0,0.0,0.0,0.0
Josh Stowers,Josh Stowers,New York Yankees,YANKS,1,2,2,4,2021,2021,0,0.0,0.33,0.33,0,102,102,0,361,361,0.0,0.0,0.0,0.0,0.0,0.0
Josh Thigpen,Josh Thigpen,Boston Red Sox,RSOX,1,2,1,3,2002,2003,1,0.0,1.1,1.1,0,144,144,0,647,647,0.0,0.0,0.0,0.0,2050000.0,2050000.0
Josh Tobias,Josh Tobias,Philadelphia Phillies,PHILS,1,1,1,2,2016,2017,1,0.0,-0.41,-0.41,0,4,4,0,2,2,0.0,22.0,22.0,0.0,13000000.0,13000000.0
Josh Winckowski,Josh Winckowski,Toronto Blue Jays,BJAYS,1,3,1,4,2021,2021,0,-0.51,2.02,2.53,63,30,-33,3,2,-1,137.0,452.0,315.0,0.0,0.0,0.0
Josh Winckowski,Josh Winckowski,New York Mets,METS,1,2,1,3,2021,2021,0,0.0,-0.36,-0.36,0,11,11,0,18,18,0.0,0.0,0.0,0.0,0.0,0.0
Josh Wolf,Josh Wolf,New York Mets,METS,1,4,2,6,2021,2021,0,2.78,2.19,-0.59,209,149,-60,798,543,-255,0.0,161.0,161.0,0.0,0.0,0.0
Joshua Javier,Joshua Javier,Arizona Diamondbacks,DBACKS,1,2,1,3,2018,2018,0,-0.06,-0.87,-0.81,4,48,44,0,0,0,17.0,43.0,26.0,0.0,2712500.0,2712500.0
Josue Peley,Josue Peley,Pittsburgh Pirates,PIRATS,1,1,1,2,2010,2010,0,0.0,0.0,0.0,0,0,0,0,0,0,0.0,0.0,0.0,0.0,0.0,0.0
Juan Andujar,Juan Andujar,St. Louis Cardinals,CARDS,3,5,4,9,1993,1996,3,6.18,4.27,-1.91,282,470,188,117,1434,1317,1824.0,182.0,-1642.0,125000.0,0.0,-125000.0
Juan Aracena,Juan Aracena,Cleveland Indians,INDINS,1,2,1,3,1999,1999,0,0.0,-0.27,-0.27,0,28,28,0,96,96,0.0,0.0,0.0,0.0,1730000.0,1730000.0
Juan Aracena,Juan Aracena,Baltimore Orioles,ORLS,1,1,1,2,2000,2001,1,0.0,0.0,0.0,0,0,0,0,0,0,0.0,0.0,0.0,0.0,0.0,0.0
Juan Bautista,Juan Bautista,Baltimore Orioles,ORLS,3,3,4,7,1997,2001,4,-0.27,4.21,4.48,28,255,227,96,867,771,0.0,0.0,0.0,1730000.0,1925000.0,195000.0
Juan Carlos Sulbaran,Juan Carlos Sulbaran,Cincinnati Reds,REDS,2,3,3,6,2012,2018,6,-0.39,1.45,1.84,105,280,175,0,4,4,160.0,420.0,260.0,0.0,4000000.0,4000000.0
Juan Cedeno,Juan Cedeno,Boston Red Sox,RSOX,1,2,1,3,2005,2006,1,-0.16,1.26,1.42,53,51,-2,167,200,33,0.0,0.0,0.0,0.0,1100000.0,1100000.0
Juan De Leon,Juan De Leon,Houston Astros,ASTROS,1,1,1,2,2004,2007,3,0.0,4.32,4.32,0,487,487,0,1436,1436,0.0,0.0,0.0,0.0,0.0,0.0
Juan De Paula,Juan De Paula,Seattle Mariners,MARNRS,2,4,2,6,2016,2019,3,0.26,1.79,1.53,174,383,209,483,1397,914,0.0,0.0,0.0,0.0,572400.0,572400.0
Juan De Paula,Juan De Paula,New York Yankees,YANKS,1,2,2,4,2018,2018,0,-0.04,0.93,0.97,10,25,15,19,114,95,0.0,0.0,0.0,0.0,14750000.0,14750000.0
Juan De Paula,Juan De Paula,San Francisco Giants,GIANTS,1,3,1,4,2019,2019,0,-0.38,0.77,1.15,80,156,76,48,628,580,182.0,0.0,-182.0,0.0,0.0,0.0
Juan Figueroa,Juan Figueroa,Chicago White Sox,WSOX,1,4,2,6,2000,2001,1,0.13,0.48,0.35,312,100,-212,1036,320,-716,0.0,0.0,0.0,675000.0,6600000.0,5925000.0
Juan Geraldo,Juan Geraldo,Philadelphia Phillies,PHILS,1,3,1,4,2020,2020,0,0.0,-0.6,-0.6,0,10,10,0,0,0,0.0,23.0,23.0,0.0,1250000.0,1250000.0
Juan Gonzalez,Juan Gonzalez,Milwaukee Brewers,BREWRS,1,1,2,3,1995,1997,2,0.0,0.38,0.38,0,53,53,0,163,163,0.0,0.0,0.0,0.0,255000.0,255000.0
Juan Gonzalez,Juan Gonzalez,Detroit Tigers,TIGRS,1,2,1,3,2004,2011,7,-0.28,18.63,18.91,27,817,790,58,3384,3326,0.0,0.0,0.0,0.0,0.0,0.0
Juan Hernaiz,Juan Hernaiz,Los Angeles Dodgers,DOGRS,1,2,1,3,1996,1997,1,5.99,0.0,-5.99,703,0,-703,2550,0,-2550,0.0,0.0,0.0,0.0,0.0,0.0
Juan Herrera,Juan Herrera,Cleveland Indians,INDINS,2,2,2,4,2013,2018,5,-0.8,2.78,3.58,54,343,289,0,585,585,44.0,260.0,216.0,2400000.0,0.0,-2400000.0
Juan Jimenez,Juan Jimenez,San Diego Padres,PADRS,1,1,1,2,2005,2005,0,0.0,-0.22,-0.22,0,10,10,0,21,21,0.0,0.0,0.0,0.0,0.0,0.0
Juan LeBron,Juan LeBron,Kansas City Royals,ROYALS,1,1,1,2,1998,2004,6,0.0,14.18,14.18,0,875,875,0,3712,3712,0.0,0.0,0.0,0.0,0.0,0.0
Juan Ramirez,Juan Ramirez,Detroit Tigers,TIGRS,1,3,3,6,2017,2017,0,16.16,0.0,-16.16,77,0,-77,7,0,-7,1431.0,0.0,-1431.0,0.0,0.0,0.0
Juan Rivera,Juan Rivera,Los Angeles Dodgers,DOGRS,1,2,1,3,2008,2008,0,0.0,-0.21,-0.21,0,84,84,0,256,256,0.0,0.0,0.0,0.0,0.0,0.0
Juan Rodriguez,Juan Rodriguez,Boston Red Sox,RSOX,1,4,2,6,2011,2012,1,0.34,0.23,-0.11,124,8,-116,300,0,-300,273.0,114.0,-159.0,0.0,0.0,0.0
Juan Then,Juan Then,Seattle Mariners,MARNRS,1,2,1,3,2017,2019,2,0.0,-0.4,-0.4,0,16,16,0,0,0,0.0,57.0,57.0,0.0,0.0,0.0
Juan Then,Juan Then,New York Yankees,YANKS,1,1,2,3,2019,2019,0,0.0,0.67,0.67,0,44,44,0,197,197,0.0,0.0,0.0,0.0,0.0,0.0
Juan Yepez,Juan Yepez,Atlanta Braves,BRAVES,1,1,2,3,2017,2017,0,0.0,0.42,0.42,0,100,100,0,314,314,0.0,0.0,0.0,0.0,0.0,0.0
Julian Cordero,Julian Cordero,Texas Rangers,RNGRS,1,4,2,6,2006,2013,7,2.6,12.97,10.37,354,855,501,502,3435,2933,270.0,0.0,-270.0,7270260.0,8500000.0,1229740.0
Julian Tubb,Julian Tubb,Chicago Cubs,CUBS,1,2,1,3,1940,1944,4,0.0,-0.62,-0.62,0,35,35,0,67,67,0.0,0.0,0.0,0.0,0.0,0.0
Julian Vasquez,Julian Vasquez,California Angels,ANGELS,1,2,1,3,1992,1996,4,2.15,2.22,0.07,142,49,-93,498,0,-498,0.0,723.0,723.0,1600000.0,0.0,-1600000.0
Julien Tucker,Julien Tucker,Houston Astros,ASTROS,1,1,1,2,1997,1997,0,0.0,-0.12,-0.12,0,9,9,0,22,22,0.0,0.0,0.0,0.0,425000.0,425000.0
Julio Frias,Julio Frias,Miami Marlins,MARLNS,2,4,2,6,2020,2021,1,2.61,2.79,0.18,160,115,-45,284,406,122,441.0,172.0,-269.0,0.0,0.0,0.0
Julio Pimentel,Julio Pimentel,Los Angeles Dodgers,DOGRS,2,5,3,8,2006,2007,1,-0.56,-0.24,0.32,64,85,21,5,67,62,658.0,69.0,-589.0,8750000.0,1700000.0,-7050000.0
Julio Rodriguez,Julio Rodriguez,Detroit Tigers,TIGRS,1,2,1,3,2011,2011,0,0.0,0.46,0.46,0,40,40,0,133,133,0.0,0.0,0.0,0.0,1000000.0,1000000.0
Julius McDougal,Julius McDougal,Chicago Cubs,CUBS,1,3,2,5,1986,1987,1,-0.8,-0.88,-0.08,87,76,-11,1,2,1,373.0,157.0,-216.0,873333.0,725000.0,-148333.0
Julius McDougal,Julius McDougal,Minnesota Twins,TWINS,1,1,1,2,1988,1990,2,0.0,0.64,0.64,0,57,57,0,100,100,0.0,0.0,0.0,0.0,0.0,0.0
Junior Caminero,Junior Caminero,Cleveland Indians,INDINS,1,1,1,2,2021,2021,0,0.0,0.0,0.0,0,0,0,0,0,0,0.0,0.0,0.0,0.0,0.0,0.0
Junior Caminero,Junior Caminero,Cleveland Indians,INDINS,1,1,1,2,2021,2021,0,0.0,0.0,0.0,0,0,0,0,0,0,0.0,0.0,0.0,0.0,0.0,0.0
Junior Garcia,Junior Garcia,Houston Astros,ASTROS,1,1,1,2,2015,2015,0,0.0,-0.72,-0.72,0,25,25,0,0,0,0.0,36.0,36.0,0.0,2500000.0,2500000.0
Junior Perez,Junior Perez,San Diego Padres,PADRS,1,1,1,2,2020,2021,1,0.0,-0.18,-0.18,0,79,79,0,121,121,0.0,0.0,0.0,0.0,0.0,0.0
Justin Barnes,Justin Barnes,Milwaukee Brewers,BREWRS,1,1,1,2,2005,2005,0,0.0,0.0,0.0,0,0,0,0,0,0,0.0,0.0,0.0,0.0,0.0,0.0
Justin Carter,Justin Carter,Colorado Rockies,ROCKS,2,3,2,5,2000,2001,1,0.55,0.19,-0.36,98,119,21,59,11,-48,524.0,256.0,-268.0,2800000.0,3200000.0,400000.0
Justin Choate,Justin Choate,Tampa Bay Devil Rays,RAYS,5,10,15,25,2013,2020,7,10.52,4.89,-5.63,1388,715,-673,4818,2481,-2337,195.0,188.0,-7.0,3254200.0,9506400.0,6252200.0
Justin Dunning,Justin Dunning,Seattle Mariners,MARNRS,1,2,2,4,1999,1999,0,0.0,-0.48,-0.48,0,3,3,0,0,0,0.0,9.0,9.0,212000.0,750000.0,538000.0
Justin Echols,Justin Echols,Texas Rangers,RNGRS,2,5,5,10,2004,2007,3,27.72,7.35,-20.37,1181,154,-1027,4083,5,-4078,1652.0,1074.0,-578.0,0.0,0.0,0.0
Justin Fuller,Justin Fuller,Los Angeles Dodgers,DOGRS,1,1,2,3,2009,2009,0,0.0,0.0,0.0,0,17,17,0,17,17,0.0,0.0,0.0,0.0,13000000.0,13000000.0
Justin Henry,Justin Henry,Detroit Tigers,TIGRS,1,1,1,2,2012,2013,1,0.0,0.0,0.0,0,0,0,0,0,0,0.0,0.0,0.0,0.0,0.0,0.0
Justin Jones,Justin Jones,Chicago Cubs,CUBS,2,8,4,12,2004,2009,5,12.48,9.74,-2.74,841,537,-304,3110,1477,-1633,213.0,718.0,505.0,5750000.0,6525000.0,775000.0
Justin Kelly,Justin Kelly,Anaheim Angels,ANGELS,1,1,2,3,2017,2018,1,0.0,-0.5,-0.5,0,64,64,0,0,0,0.0,190.0,190.0,0.0,5000000.0,5000000.0
Justin Pope,Justin Pope,St. Louis Cardinals,CARDS,1,2,1,3,2003,2003,0,0.0,0.34,0.34,0,16,16,0,14,14,0.0,114.0,114.0,0.0,6000000.0,6000000.0
Justin Souza,Justin Souza,Seattle Mariners,MARNRS,1,1,1,2,2009,2010,1,0.0,0.6,0.6,0,51,51,0,167,167,0.0,0.0,0.0,0.0,410000.0,410000.0
Justin Sterner,Justin Sterner,Miami Marlins,MARLNS,1,2,1,3,2021,2021,0,0.0,-0.91,-0.91,0,27,27,0,4,4,0.0,54.0,54.0,0.0,0.0,0.0
Justin Yurchak,Justin Yurchak,Chicago White Sox,WSOX,1,1,1,2,2018,2019,1,0.0,-0.34,-0.34,0,17,17,0,0,0,0.0,152.0,152.0,0.0,0.0,0.0
K.J. Harrison,K.J. Harrison,Milwaukee Brewers,BREWRS,1,2,2,4,2018,2018,0,0.0,0.67,0.67,0,10,10,0,8,8,0.0,76.0,76.0,0.0,12000000.0,12000000.0
Kade Scivicque,Kade Scivicque,Detroit Tigers,TIGRS,1,2,1,3,2016,2016,0,0.0,0.21,0.21,0,29,29,0,91,91,0.0,0.0,0.0,0.0,0.0,0.0
Kai-Wei Teng,Kai-Wei Teng,Minnesota Twins,TWINS,1,3,1,4,2019,2019,0,-0.71,-0.29,0.42,26,15,-11,68,0,-68,0.0,34.0,34.0,0.0,5000000.0,5000000.0
Kasey Kalich,Kasey Kalich,Atlanta Braves,BRAVES,1,1,1,2,2021,2021,0,0.0,1.05,1.05,0,55,55,0,242,242,0.0,0.0,0.0,0.0,8050000.0,8050000.0
Keegan Curtis,Keegan Curtis,New York Yankees,YANKS,1,1,1,2,2021,2021,0,0.0,-0.05,-0.05,0,9,9,0,23,23,0.0,0.0,0.0,0.0,0.0,0.0
Keith Bodie,Keith Bodie,New York Mets,METS,1,1,1,2,1980,1980,0,0.0,0.0,0.0,0,0,0,0,0,0,0.0,0.0,0.0,0.0,0.0,0.0
Keith Eaddy,Keith Eaddy,Baltimore Orioles,ORLS,1,1,1,2,1996,1996,0,0.0,0.0,0.0,0,0,0,0,0,0,0.0,0.0,0.0,0.0,0.0,0.0
Keith Heberling,Keith Heberling,New York Yankees,YANKS,1,2,1,3,1994,1995,1,1.86,4.02,2.16,233,30,-203,702,0,-702,0.0,653.0,653.0,0.0,5300000.0,5300000.0
Keith Kaiser,Keith Kaiser,Cincinnati Reds,REDS,1,3,1,4,1990,1993,3,-0.24,2.7,2.94,60,260,200,65,933,868,497.0,0.0,-497.0,104000.0,934000.0,830000.0
Keith Morrison,Keith Morrison,Atlanta Braves,BRAVES,1,2,2,4,1991,1993,2,0.0,8.32,8.32,0,378,378,0,1494,1494,0.0,0.0,0.0,0.0,0.0,0.0
Keith Volkman,Keith Volkman,Anaheim Angels,ANGELS,1,2,2,4,1999,1999,0,17.78,-1.12,-18.9,806,87,-719,3297,269,-3028,0.0,0.0,0.0,0.0,0.0,0.0
Kelly Faulk,Kelly Faulk,Philadelphia Phillies,PHILS,1,2,1,3,1983,1984,1,0.0,-0.39,-0.39,0,14,14,0,2,2,0.0,45.0,45.0,0.0,0.0,0.0
Kelly Ramos,Kelly Ramos,New York Mets,METS,1,1,1,2,1999,2003,4,0.0,0.0,0.0,0,0,0,0,0,0,0.0,0.0,0.0,0.0,0.0,0.0
Kelly Snider,Kelly Snider,Los Angeles Dodgers,DOGRS,1,3,1,4,1981,1987,6,3.72,8.48,4.76,672,868,196,2514,2981,467,0.0,0.0,0.0,0.0,0.0,0.0
Kelvin Bautista,Kelvin Bautista,Texas Rangers,RNGRS,1,1,1,2,2021,2021,0,0.0,0.15,0.15,0,40,40,0,0,0,0.0,119.0,119.0,0.0,0.0,0.0
Kelvin Pichardo,Kelvin Pichardo,Philadelphia Phillies,PHILS,1,1,1,2,2005,2005,0,0.0,-0.05,-0.05,0,22,22,0,21,21,0.0,0.0,0.0,0.0,2000000.0,2000000.0
Ken Gill,Ken Gill,Minnesota Twins,TWINS,1,1,1,2,1973,1977,4,0.0,3.45,3.45,0,221,221,0,0,0,0.0,1140.0,1140.0,0.0,0.0,0.0
Ken Kinnard,Ken Kinnard,Toronto Blue Jays,BJAYS,2,4,2,6,1985,1985,0,1.41,-1.31,-2.72,202,123,-79,317,361,44,109.0,0.0,-109.0,185000.0,750000.0,565000.0
Ken Pennington,Ken Pennington,Atlanta Braves,BRAVES,1,2,1,3,1990,1990,0,0.04,-1.77,-1.81,8,140,132,0,577,577,90.0,0.0,-90.0,0.0,0.0,0.0
Ken Reed,Ken Reed,New York Mets,METS,1,2,1,3,1985,1986,1,0.0,0.33,0.33,0,70,70,0,7,7,0.0,121.0,121.0,0.0,0.0,0.0
Ken Rivers,Ken Rivers,Toronto Blue Jays,BJAYS,1,3,3,6,1990,1995,5,3.61,21.84,18.23,424,669,245,1598,2979,1381,0.0,79.0,79.0,255000.0,990000.0,735000.0
Ken Spratke,Ken Spratke,Seattle Mariners,MARNRS,1,1,1,2,1988,1992,4,0.0,-1.02,-1.02,0,199,199,0,494,494,0.0,0.0,0.0,0.0,0.0,0.0
Kendal Volz,Kendal Volz,Boston Red Sox,RSOX,2,3,3,6,2011,2012,1,0.07,2.71,2.64,6,174,168,26,653,627,0.0,0.0,0.0,1200000.0,640000.0,-560000.0
Kendall Williams,Kendall Williams,Toronto Blue Jays,BJAYS,1,2,1,3,2020,2020,0,0.0,0.1,0.1,0,5,5,0,0,0,0.0,47.0,47.0,0.0,2100000.0,2100000.0
Kenedy Corona,Kenedy Corona,New York Mets,METS,1,2,1,3,2019,2020,1,1.02,0.19,-0.83,78,16,-62,0,34,34,190.0,0.0,-190.0,0.0,2212000.0,2212000.0
Kenneth Bennett,Kenneth Bennett,New York Yankees,YANKS,1,5,1,6,1975,1976,1,0.0,0.33,0.33,0,80,80,0,217,217,0.0,0.0,0.0,0.0,0.0,0.0
Kenneth Braden,Kenneth Braden,Middletown,Middletown,1,2,2,4,1945,1945,0,0.0,0.0,0.0,0,0,0,0,0,0,0.0,0.0,0.0,0.0,0.0,0.0
Kenneth Myette,Kenneth Myette,Chicago Cubs,CUBS,3,5,3,8,1969,1974,5,-2.15,0.81,2.96,445,387,-58,1077,715,-362,55.0,283.0,228.0,0.0,25000.0,25000.0
Kenny Baker,Kenny Baker,Montreal Expos,NATEX,1,2,1,3,1985,1985,0,0.0,0.55,0.55,0,68,68,0,209,209,0.0,0.0,0.0,0.0,0.0,0.0
Kenny Lutz,Kenny Lutz,Cincinnati Reds,REDS,1,1,1,2,2000,2004,4,0.0,-0.85,-0.85,0,456,456,0,1260,1260,0.0,0.0,0.0,0.0,0.0,0.0
Kenny Perez,Kenny Perez,Boston Red Sox,RSOX,1,2,2,4,2005,2005,0,0.0,-0.2,-0.2,0,4,4,0,13,13,0.0,0.0,0.0,0.0,4000000.0,4000000.0
Kent Bachman,Kent Bachman,Montreal Expos,NATEX,1,1,1,2,1986,1988,2,0.0,0.9,0.9,0,246,246,0,8,8,0.0,402.0,402.0,0.0,487500.0,487500.0
Kenzie Davis,Kenzie Davis,Kansas City Royals,ROYALS,1,1,1,2,1975,1975,0,0.0,0.0,0.0,0,0,0,0,0,0,0.0,0.0,0.0,0.0,16000.0,16000.0
Keto Anderson,Keto Anderson,Chicago Cubs,CUBS,1,1,1,2,2002,2002,0,0.0,0.0,0.0,0,0,0,0,0,0,0.0,0.0,0.0,0.0,0.0,0.0
Kevin Alcantara,Kevin Alcantara,New York Yankees,YANKS,1,2,2,4,2021,2021,0,0.0,0.5,0.5,0,49,49,0,200,200,0.0,0.0,0.0,0.0,16500000.0,16500000.0
Kevin Armstrong,Kevin Armstrong,New York Mets,METS,12,24,21,45,1986,2006,20,25.44,47.58,22.14,2466,2918,452,5573,6399,826,2555.0,3756.0,1201.0,24986257.0,19799833.0,-5186424.0
Kevin Brown,Kevin Brown,New York Mets,METS,12,24,21,45,1986,2006,20,25.44,47.58,22.14,2466,2918,452,5573,6399,826,2555.0,3756.0,1201.0,24986257.0,19799833.0,-5186424.0
Kevin Burford,Kevin Burford,San Diego Padres,PADRS,3,5,5,10,1998,2002,4,4.18,1.58,-2.6,373,429,56,1290,827,-463,0.0,215.0,215.0,1750000.0,2410000.0,660000.0
Kevin Carmody,Kevin Carmody,Milwaukee Brewers,BREWRS,1,2,2,4,1990,1992,2,2.24,1.3,-0.94,232,30,-202,659,0,-659,0.0,293.0,293.0,150000.0,200000.0,50000.0
Kevin Castleberry,Kevin Castleberry,Atlanta Braves,BRAVES,1,1,1,2,1991,1991,0,0.0,0.14,0.14,0,14,14,0,13,13,0.0,0.0,0.0,0.0,0.0,0.0
Kevin Comer,Kevin Comer,Toronto Blue Jays,BJAYS,4,12,6,18,2012,2016,4,10.83,2.99,-7.84,1068,309,-759,3494,605,-2889,904.0,1431.0,527.0,11237500.0,12316000.0,1078500.0
Kevin Davis,Kevin Davis,California Angels,ANGELS,1,1,1,2,1986,1987,1,0.0,0.0,0.0,0,0,0,0,0,0,0.0,0.0,0.0,0.0,0.0,0.0
Kevin Dean,Kevin Dean,Montreal Expos,NATEX,5,11,10,21,1989,2001,12,21.4,30.38,8.98,1830,1831,1,4276,2869,-1407,3122.0,2278.0,-844.0,1435000.0,850000.0,-585000.0
Kevin Dean,Kevin Dean,Atlanta Braves,BRAVES,1,2,1,3,1990,1990,0,0.0,-0.56,-0.56,0,50,50,0,0,0,0.0,92.0,92.0,0.0,122000.0,122000.0
Kevin Eichhorn,Kevin Eichhorn,Arizona Diamondbacks,DBACKS,1,2,1,3,2011,2011,0,0.0,-1.5,-1.5,0,16,16,0,16,16,0.0,128.0,128.0,0.0,0.0,0.0
Kevin Franklin,Kevin Franklin,Cincinnati Reds,REDS,1,2,2,4,2017,2017,0,1.0,0.0,-1.0,120,0,-120,499,0,-499,0.0,0.0,0.0,0.0,0.0,0.0
Kevin Gallaher,Kevin Gallaher,Houston Astros,ASTROS,1,2,1,3,1996,1996,0,0.0,-0.01,-0.01,1,18,17,0,0,0,0.0,28.0,28.0,0.0,400000.0,400000.0
Kevin Garner,Kevin Garner,San Diego Padres,PADRS,2,4,3,7,1991,1994,3,4.76,-1.77,-6.53,685,201,-484,2072,489,-1583,0.0,199.0,199.0,130000.0,0.0,-130000.0
Kevin Gibbs,Kevin Gibbs,Los Angeles Dodgers,DOGRS,1,3,2,5,2000,2002,2,3.81,0.2,-3.61,184,161,-23,631,541,-90,0.0,0.0,0.0,1450000.0,3416667.0,1966667.0
Kevin Gillen,Kevin Gillen,Kansas City Royals,ROYALS,1,1,1,2,1979,1979,0,0.0,0.0,0.0,0,0,0,0,0,0,0.0,0.0,0.0,0.0,0.0,0.0
Kevin Gordon,Kevin Gordon,Colorado Rockies,ROCKS,1,1,1,2,1999,1999,0,0.0,-0.5,-0.5,0,16,16,0,22,22,0.0,0.0,0.0,0.0,0.0,0.0
Kevin Gowdy,Kevin Gowdy,Philadelphia Phillies,PHILS,1,3,4,7,2021,2021,0,-1.21,0.8,2.01,9,74,65,0,29,29,64.0,300.0,236.0,0.0,9766666.0,9766666.0
Kevin Guzman,Kevin Guzman,Los Angeles Dodgers,DOGRS,9,31,24,55,2015,2021,6,13.68,18.97,5.29,1948,1113,-835,5665,1311,-4354,2367.0,3323.0,956.0,37486500.0,81903480.0,44416980.0
Kevin Houston,Kevin Houston,Houston Astros,ASTROS,2,4,2,6,1981,1987,6,18.26,12.31,-5.95,1057,753,-304,4016,2821,-1195,147.0,0.0,-147.0,450000.0,0.0,-450000.0
Kevin Howard,Kevin Howard,Cincinnati Reds,REDS,1,2,2,4,2005,2006,1,0.0,0.1,0.1,0,9,9,0,23,23,0.0,0.0,0.0,0.0,2000000.0,2000000.0
Kevin Kristan,Kevin Kristan,Chicago White Sox,WSOX,3,5,6,11,1984,1997,13,0.78,21.51,20.73,266,2126,1860,135,7098,6963,1605.0,1633.0,28.0,720500.0,260000.0,-460500.0
Kevin Merrell,Kevin Merrell,Oakland Athletics,ATLTCS,1,1,1,2,2019,2019,0,0.0,0.92,0.92,0,15,15,0,4,4,0.0,220.0,220.0,0.0,100000.0,100000.0
Kevin Mobley,Kevin Mobley,Detroit Tigers,TIGRS,1,2,1,3,2000,2002,2,-0.26,-0.7,-0.44,6,35,29,0,0,0,17.0,149.0,132.0,0.0,220000.0,220000.0
Kevin Northrup,Kevin Northrup,Montreal Expos,NATEX,1,1,1,2,1995,1995,0,0.0,0.55,0.55,0,52,52,0,1,1,0.0,66.0,66.0,0.0,195000.0,195000.0
Kevin Ool,Kevin Ool,Boston Red Sox,RSOX,1,2,1,3,2005,2005,0,0.0,1.03,1.03,0,68,68,0,0,0,0.0,112.0,112.0,0.0,0.0,0.0
Kevin Price,Kevin Price,Baltimore Orioles,ORLS,1,2,1,3,1988,1988,0,0.0,0.0,0.0,0,0,0,0,0,0,0.0,0.0,0.0,0.0,0.0,0.0
Kevin Pucetas,Kevin Pucetas,San Francisco Giants,GIANTS,1,2,1,3,2010,2010,0,0.0,-0.57,-0.57,0,42,42,0,139,139,0.0,0.0,0.0,0.0,12000000.0,12000000.0
Kevin Rawitzer,Kevin Rawitzer,Chicago Cubs,CUBS,1,2,1,3,1999,2000,1,0.0,-0.11,-0.11,0,13,13,0,16,16,0.0,0.0,0.0,0.0,0.0,0.0
Kevin Roberts,Kevin Roberts,Milwaukee Brewers,BREWRS,1,2,1,3,2007,2007,0,-0.41,0.0,0.41,24,0,-24,0,0,0,51.0,0.0,-51.0,0.0,2733333.0,2733333.0
Kevin Russ,Kevin Russ,Oakland Athletics,ATLTCS,1,2,1,3,1986,1987,1,0.5,0.04,-0.46,36,22,-14,1,42,41,70.0,0.0,-70.0,0.0,0.0,0.0
Kevin Smith,Kevin Smith,New York Mets,METS,1,2,1,3,2020,2020,0,0.0,0.15,0.15,0,10,10,0,0,0,0.0,27.0,27.0,0.0,1050000.0,1050000.0
Kevin Trudeau,Kevin Trudeau,New York Yankees,YANKS,1,1,1,2,1986,1986,0,0.0,-0.63,-0.63,0,71,71,0,116,116,0.0,0.0,0.0,0.0,0.0,0.0
Kevin Trudeau,Kevin Trudeau,Minnesota Twins,TWINS,3,5,6,11,1988,1995,7,10.18,-1.81,-11.99,698,140,-558,1780,213,-1567,1711.0,302.0,-1409.0,1000000.0,0.0,-1000000.0
Kieran Mattison,Kieran Mattison,Kansas City Royals,ROYALS,1,3,2,5,2003,2005,2,0.0,0.71,0.71,0,50,50,0,2,2,0.0,739.0,739.0,0.0,1500000.0,1500000.0
Kirk Killingsworth,Kirk Killingsworth,Texas Rangers,RNGRS,1,2,1,3,1987,1988,1,0.0,0.0,0.0,0,0,0,0,0,0,0.0,0.0,0.0,0.0,0.0,0.0
Klondike Smith,Klondike Smith,New York Yankees,YANKS,6,15,9,24,1912,1946,34,28.8,114.46,85.66,1052,3746,2694,1402,10175,8773,7730.0,15194.0,7464.0,42500.0,38450.0,-4050.0
Kodi Medeiros,Kodi Medeiros,Milwaukee Brewers,BREWRS,1,2,2,4,2018,2018,0,0.0,-0.17,-0.17,0,52,52,0,0,0,0.0,66.0,66.0,0.0,0.0,0.0
Kody Eaves,Kody Eaves,Anaheim Angels,ANGELS,1,1,1,2,2016,2018,2,0.0,0.25,0.25,0,223,223,0,638,638,0.0,0.0,0.0,0.0,0.0,0.0
Kole Strayhorn,Kole Strayhorn,Los Angeles Dodgers,DOGRS,1,3,2,5,2003,2003,0,0.4,0.21,-0.19,110,61,-49,377,246,-131,0.0,0.0,0.0,0.0,12166667.0,12166667.0
Konnor Pilkington,Konnor Pilkington,Chicago White Sox,WSOX,1,1,1,2,2021,2021,0,0.0,-0.67,-0.67,0,53,53,0,217,217,0.0,0.0,0.0,0.0,5000000.0,5000000.0
Kramer Sneed,Kramer Sneed,New York Yankees,YANKS,1,2,1,3,2013,2014,1,0.0,-0.08,-0.08,0,130,130,0,458,458,0.0,0.0,0.0,0.0,0.0,0.0
Kristian Bell,Kristian Bell,Toronto Blue Jays,BJAYS,1,2,1,3,2007,2009,2,-0.44,9.81,10.25,11,289,278,2,1272,1270,138.0,0.0,-138.0,0.0,1550000.0,1550000.0
Kurt Beamesderfer,Kurt Beamesderfer,Baltimore Orioles,ORLS,1,1,1,2,1987,1987,0,0.0,0.0,0.0,0,0,0,0,0,0,0.0,0.0,0.0,0.0,0.0,0.0
Kurt Walker,Kurt Walker,Chicago White Sox,WSOX,7,12,13,25,1986,1997,11,68.61,10.59,-58.02,2705,1929,-776,10284,5529,-4755,1119.0,1610.0,491.0,1600000.0,247000.0,-1353000.0
Kyle Bartsch,Kyle Bartsch,Kansas City Royals,ROYALS,1,1,1,2,2014,2016,2,0.0,-0.23,-0.23,0,13,13,0,44,44,0.0,0.0,0.0,0.0,0.0,0.0
Kyle Bono,Kyle Bono,Boston Red Sox,RSOX,1,2,2,4,2005,2005,0,0.0,-0.2,-0.2,0,4,4,0,13,13,0.0,0.0,0.0,0.0,4000000.0,4000000.0
Kyle Bradish,Kyle Bradish,Anaheim Angels,ANGELS,1,4,1,5,2019,2021,2,0.0,1.39,1.39,4,37,33,0,4,4,13.0,469.0,456.0,0.0,2800000.0,2800000.0
Kyle Brnovich,Kyle Brnovich,Anaheim Angels,ANGELS,1,4,1,5,2019,2021,2,0.0,1.39,1.39,4,37,33,0,4,4,13.0,469.0,456.0,0.0,2800000.0,2800000.0
Kyle Cofield,Kyle Cofield,Atlanta Braves,BRAVES,1,1,2,3,2010,2011,1,0.0,0.42,0.42,0,126,126,0,0,0,0.0,163.0,163.0,0.0,5000000.0,5000000.0
Kyle Edens,Kyle Edens,Cincinnati Reds,REDS,1,1,2,3,2006,2006,0,0.0,0.23,0.23,0,28,28,0,0,0,0.0,45.0,45.0,0.0,1250000.0,1250000.0
Kyle Gunderson,Kyle Gunderson,Washington Nationals,NATEX,1,1,1,2,2009,2010,1,0.0,-0.93,-0.93,0,52,52,0,2,2,0.0,84.0,84.0,0.0,660000.0,660000.0
Kyle Haynes,Kyle Haynes,Pittsburgh Pirates,PIRATS,1,1,1,2,2013,2017,4,0.0,-0.19,-0.19,0,192,192,0,583,583,0.0,0.0,0.0,0.0,515100.0,515100.0
Kyle Hurt,Kyle Hurt,Miami Marlins,MARLNS,1,2,1,3,2021,2021,0,0.61,1.46,0.85,82,133,51,4,0,-4,120.0,192.0,72.0,0.0,0.0,0.0
Kyle Johnson,Kyle Johnson,Anaheim Angels,ANGELS,1,1,1,2,2013,2015,2,0.0,2.7,2.7,0,211,211,0,466,466,0.0,0.0,0.0,0.0,493520.0,493520.0
Kyle Johnston,Kyle Johnston,Washington Nationals,NATEX,2,2,3,5,2019,2021,2,-0.24,1.48,1.72,45,179,134,0,0,0,57.0,300.0,243.0,6000000.0,1500000.0,-4500000.0
Kyle Kaminska,Kyle Kaminska,Miami Marlins,MARLNS,2,3,2,5,2012,2013,1,0.79,-0.75,-1.54,309,45,-264,740,147,-593,0.0,0.0,0.0,483000.0,0.0,-483000.0
Kyle Kaminska,Kyle Kaminska,Pittsburgh Pirates,PIRATS,1,1,1,2,2012,2013,1,0.0,0.0,0.0,0,0,0,0,0,0,0.0,0.0,0.0,0.0,481500.0,481500.0
Kyle Kessel,Kyle Kessel,New York Mets,METS,1,3,2,5,1999,2000,1,10.81,6.86,-3.95,663,212,-451,364,706,342,1347.0,656.0,-691.0,687500.0,8625000.0,7937500.0
Kyle Kessel,Kyle Kessel,New York Mets,METS,1,1,2,3,2001,2012,11,0.0,0.22,0.22,0,10,10,0,0,0,0.0,17.0,17.0,0.0,1200000.0,1200000.0
Kyle Pearson,Kyle Pearson,Pittsburgh Pirates,PIRATS,1,1,1,2,2008,2009,1,0.0,-0.59,-0.59,0,98,98,0,5,5,0.0,165.0,165.0,0.0,395000.0,395000.0
Kyle Simon,Kyle Simon,Baltimore Orioles,ORLS,1,2,1,3,2012,2012,0,0.0,0.0,0.0,0,28,28,0,115,115,0.0,0.0,0.0,0.0,1250000.0,1250000.0
Kyle Smit,Kyle Smit,Los Angeles Dodgers,DOGRS,2,4,4,8,2010,2013,3,0.08,2.91,2.83,324,264,-60,960,343,-617,0.0,1182.0,1182.0,410000.0,16002000.0,15592000.0
Kyle Smith,Kyle Smith,Kansas City Royals,ROYALS,1,1,1,2,2013,2014,1,0.0,-0.56,-0.56,0,55,55,0,156,156,0.0,0.0,0.0,0.0,0.0,0.0
Kyle Washington,Kyle Washington,Cleveland Indians,INDINS,8,13,15,28,1992,2011,19,4.4,22.94,18.54,1064,1793,729,2423,3925,1502,442.0,3419.0,2977.0,9756200.0,3392500.0,-6363700.0
Kyle Winkler,Kyle Winkler,Tampa Bay Devil Rays,RAYS,1,1,1,2,2015,2015,0,0.0,-0.26,-0.26,0,4,4,0,10,10,0.0,0.0,0.0,0.0,0.0,0.0
Kyler Burke,Kyler Burke,San Diego Padres,PADRS,1,2,2,4,2007,2008,1,-0.62,-1.21,-0.59,10,74,64,36,243,207,0.0,0.0,0.0,382300.0,4533333.0,4151033.0
Kyung-Min Na,Kyung-Min Na,Chicago Cubs,CUBS,2,4,4,8,2012,2021,9,4.49,36.69,32.2,319,1310,991,393,5639,5246,1826.0,3.0,-1823.0,16500000.0,0.0,-16500000.0
Lance Caraccioli,Lance Caraccioli,Los Angeles Dodgers,DOGRS,3,3,4,7,2002,2004,2,0.37,0.55,0.18,113,138,25,391,395,4,0.0,0.0,0.0,0.0,266000.0,266000.0
Lance Hudson,Lance Hudson,Oakland Athletics,ATLTCS,2,2,3,5,1982,1985,3,3.96,4.07,0.11,174,363,189,539,1324,785,0.0,92.0,92.0,450000.0,0.0,-450000.0
Larry Lassalle,Larry Lassalle,Milwaukee Braves,BRAVES,2,10,2,12,1953,1960,7,8.19,12.74,4.55,794,729,-65,1824,3040,1216,2135.0,0.0,-2135.0,0.0,42000.0,42000.0
Larry Whitford,Larry Whitford,Chicago Cubs,CUBS,1,2,1,3,1986,1987,1,0.0,-0.31,-0.31,0,8,8,0,15,15,0.0,0.0,0.0,0.0,0.0,0.0
Larry Wimberly,Larry Wimberly,Philadelphia Phillies,PHILS,2,4,4,8,1996,1999,3,1.93,-0.39,-2.32,220,301,81,209,170,-39,390.0,444.0,54.0,225000.0,0.0,-225000.0
Lars Huijer,Lars Huijer,Seattle Mariners,MARNRS,1,1,1,2,2015,2015,0,0.0,0.0,0.0,0,0,0,0,0,0,0.0,0.0,0.0,0.0,0.0,0.0
Lawrence Elliott,Lawrence Elliott,Detroit Tigers,TIGRS,2,3,3,6,1973,1992,19,6.42,19.58,13.16,721,1913,1192,2522,4394,1872,3.0,1451.0,1448.0,0.0,0.0,0.0
Lee Brown,Lee Brown,Houston Astros,ASTROS,1,2,1,3,1968,1968,0,0.0,-1.85,-1.85,0,90,90,0,221,221,0.0,0.0,0.0,0.0,0.0,0.0
Lee Chandler,Lee Chandler,Chicago White Sox,WSOX,4,9,4,13,1936,1950,14,-0.26,3.15,3.41,394,894,500,1460,3508,2048,0.0,0.0,0.0,20900.0,0.0,-20900.0
Lee Evans,Lee Evans,Pittsburgh Pirates,PIRATS,3,4,5,9,2001,2010,9,-1.67,7.92,9.59,31,815,784,5,714,709,425.0,4763.0,4338.0,6485333.0,3550000.0,-2935333.0
Lee Handley,Lee Handley,Chicago Cubs,CUBS,1,4,1,5,1960,1961,1,14.78,2.04,-12.74,914,260,-654,121,914,793,2300.0,0.0,-2300.0,0.0,0.0,0.0
Lee Johnson,Lee Johnson,Atlanta Braves,BRAVES,1,2,1,3,1990,1990,0,0.0,-0.56,-0.56,0,50,50,0,0,0,0.0,92.0,92.0,0.0,122000.0,122000.0
Lee Strait,Lee Strait,Philadelphia Athletics,ATLTCS,1,2,1,3,1918,1918,0,0.0,7.48,7.48,0,88,88,0,123,123,0.0,995.0,995.0,0.0,0.0,0.0
Lefty Mossor,Lefty Mossor,Portland,Portland,1,1,2,3,1945,1945,0,0.0,0.0,0.0,0,0,0,0,0,0,0.0,0.0,0.0,0.0,17200.0,17200.0
Leland White,Leland White,Chicago White Sox,WSOX,3,4,4,8,1966,1976,10,0.79,1.71,0.92,129,790,661,442,2422,1980,0.0,142.0,142.0,83000.0,31500.0,-51500.0
Lenny Wentz,Lenny Wentz,Cincinnati Reds,REDS,1,1,1,2,1992,1992,0,0.0,0.0,0.0,0,0,0,0,0,0,0.0,0.0,0.0,0.0,0.0,0.0
Leo Angermeier,Leo Angermeier,Cleveland Indians,INDINS,1,3,1,4,1912,1915,3,0.0,1.09,1.09,0,280,280,0,1151,1151,0.0,0.0,0.0,0.0,0.0,0.0
Leo Crawford,Leo Crawford,Los Angeles Dodgers,DOGRS,1,1,1,2,2020,2021,1,0.0,0.7,0.7,0,53,53,0,2,2,0.0,77.0,77.0,0.0,5125000.0,5125000.0
Leo Crawford,Leo Crawford,Los Angeles Dodgers,DOGRS,1,1,0,1,2020,2020,0,0.0,0.0,0.0,0,0,0,0,0,0,0.0,0.0,0.0,0.0,0.0,0.0
Leo Vasquez,Leo Vasquez,New York Mets,METS,1,2,1,3,1999,1999,0,4.65,1.12,-3.53,602,24,-578,2480,30,-2450,0.0,228.0,228.0,200000.0,5000000.0,4800000.0
Leon Landry,Leon Landry,Los Angeles Dodgers,DOGRS,1,2,1,3,2012,2015,3,0.0,0.25,0.25,0,290,290,0,3,3,0.0,434.0,434.0,0.0,5000000.0,5000000.0
Leonard Williams,Leonard Williams,Milwaukee Braves,BRAVES,2,7,3,10,1957,1961,4,-1.07,-0.69,0.38,281,102,-179,637,325,-312,138.0,0.0,-138.0,0.0,0.0,0.0
Leonardo Rivas,Leonardo Rivas,Anaheim Angels,ANGELS,1,2,1,3,2020,2021,1,0.0,2.81,2.81,0,81,81,0,0,0,0.0,210.0,210.0,900000.0,5714285.0,4814285.0
Leroy Jones,Leroy Jones,Mobile,Mobile,1,1,1,2,1926,1926,0,0.0,0.0,0.0,0,0,0,0,0,0,0.0,0.0,0.0,0.0,0.0,0.0
Leroy McKinnis,Leroy McKinnis,San Diego Padres,PADRS,14,20,20,40,1997,2005,8,0.7,9.11,8.41,1015,1374,359,2046,2428,382,1171.0,1867.0,696.0,13510000.0,3990000.0,-9520000.0
Lincoln Holdzkom,Lincoln Holdzkom,Florida Marlins,MARLNS,1,2,1,3,2006,2006,0,0.0,-0.02,-0.02,0,36,36,0,0,0,0.0,64.0,64.0,0.0,0.0,0.0
Lindsay Foster,Lindsay Foster,Cleveland Indians,INDINS,1,2,2,4,1990,1992,2,-0.52,2.03,2.55,50,76,26,126,0,-126,0.0,701.0,701.0,700000.0,515000.0,-185000.0
Lindsay Gulin,Lindsay Gulin,New York Mets,METS,1,1,1,2,1998,1998,0,0.0,-0.17,-0.17,0,5,5,0,17,17,0.0,0.0,0.0,0.0,425000.0,425000.0
Liover Peguero,Liover Peguero,Arizona Diamondbacks,DBACKS,2,4,5,9,2020,2020,0,3.3,1.36,-1.94,92,37,-55,387,138,-249,0.0,33.0,33.0,0.0,0.0,0.0
Lloyd Fourroux,Lloyd Fourroux,Baltimore Orioles,ORLS,3,6,5,11,1969,1973,4,0.65,-0.01,-0.66,284,47,-237,424,80,-344,279.0,0.0,-279.0,0.0,18000.0,18000.0
Loek van Mil,Loek van Mil,Minnesota Twins,TWINS,1,1,1,2,2010,2010,0,0.0,0.64,0.64,0,9,9,0,0,0,0.0,29.0,29.0,0.0,9000000.0,9000000.0
Logan Bawcom,Logan Bawcom,Los Angeles Dodgers,DOGRS,1,2,1,3,2012,2015,3,0.0,0.25,0.25,0,290,290,0,3,3,0.0,434.0,434.0,0.0,5000000.0,5000000.0
Logan Cerny,Logan Cerny,Philadelphia Phillies,PHILS,1,1,1,2,2021,2021,0,0.0,0.0,0.0,0,0,0,0,0,0,0.0,0.0,0.0,0.0,0.0,0.0
Logan Driscoll,Logan Driscoll,San Diego Padres,PADRS,1,2,1,3,2020,2020,0,3.8,0.04,-3.76,172,23,-149,623,0,-623,0.0,66.0,66.0,0.0,0.0,0.0
Logan Salow,Logan Salow,Oakland Athletics,ATLTCS,2,2,2,4,2018,2018,0,0.96,-0.3,-1.26,21,4,-17,0,0,0,123.0,20.0,-103.0,0.0,0.0,0.0
Logan Shore,Logan Shore,Oakland Athletics,ATLTCS,1,2,1,3,2018,2021,3,0.0,4.25,4.25,0,56,56,0,0,0,0.0,918.0,918.0,0.0,6000000.0,6000000.0
Lonny Backer,Lonny Backer,Chicago Cubs,CUBS,2,8,3,11,1933,1946,13,22.35,18.34,-4.01,627,903,276,2568,3781,1213,0.0,0.0,0.0,0.0,0.0,0.0
Louis Heyman,Louis Heyman,Philadelphia Phillies,PHILS,1,2,1,3,1956,1956,0,0.0,-0.48,-0.48,0,40,40,0,1,1,0.0,70.0,70.0,0.0,0.0,0.0
Louis Holdener,Louis Holdener,Cleveland Indians,INDINS,3,4,4,8,1961,1966,5,-1.42,-0.53,0.89,65,52,-13,111,71,-40,0.0,0.0,0.0,0.0,0.0,0.0
Louis Schaub,Louis Schaub,Chicago Cubs,CUBS,1,2,1,3,1906,1906,0,0.0,0.0,0.0,0,1,1,0,1,1,0.0,0.0,0.0,0.0,0.0,0.0
Lucius Fox,Lucius Fox,San Francisco Giants,GIANTS,2,5,3,8,2016,2017,1,1.48,0.39,-1.09,241,87,-154,809,81,-728,306.0,728.0,422.0,7000000.0,0.0,-7000000.0
Lucius Fox,Lucius Fox,Tampa Bay Devil Rays,RAYS,1,1,1,2,2020,2020,0,0.0,0.34,0.34,0,17,17,0,25,25,0.0,0.0,0.0,0.0,0.0,0.0
Luis Alejandro Basabe,Luis Alejandro Basabe,Boston Red Sox,RSOX,1,2,1,3,2016,2016,0,0.0,0.93,0.93,0,34,34,0,0,0,0.0,89.0,89.0,0.0,0.0,0.0
Luis Arroyo,Luis Arroyo,San Diego Padres,PADRS,1,2,2,4,1996,1996,0,-0.29,0.02,0.31,62,2,-60,131,0,-131,0.0,2.0,2.0,0.0,0.0,0.0
Luis Benitez,Luis Benitez,Texas Rangers,RNGRS,2,7,4,11,1988,1994,6,0.27,27.89,27.62,791,1284,493,491,4575,4084,1767.0,710.0,-1057.0,532500.0,300500.0,-232000.0
Luis Bryan,Luis Bryan,Houston Astros,ASTROS,2,4,3,7,2009,2010,1,1.04,0.25,-0.79,124,114,-10,0,0,0,162.0,160.0,-2.0,1625000.0,410000.0,-1215000.0
Luis Caballero,Luis Caballero,Atlanta Braves,BRAVES,1,1,1,2,2011,2012,1,0.0,-0.98,-0.98,0,57,57,0,122,122,0.0,0.0,0.0,0.0,5000000.0,5000000.0
Luis Cotto,Luis Cotto,Kansas City Royals,ROYALS,1,1,1,2,2003,2003,0,0.0,0.0,0.0,0,0,0,0,0,0,0.0,0.0,0.0,0.0,0.0,0.0
Luis De La Rosa,Luis De La Rosa,Kansas City Royals,ROYALS,1,4,2,6,2021,2021,0,-0.67,2.43,3.1,48,134,86,136,538,402,0.0,0.0,0.0,0.0,0.0,0.0
Luis Garcia,Luis Garcia,Boston Red Sox,RSOX,1,3,1,4,2001,2002,1,0.0,-0.56,-0.56,0,12,12,0,0,0,0.0,66.0,66.0,0.0,5333333.0,5333333.0
Luis Garcia,Luis Garcia,St. Louis Cardinals,CARDS,1,2,1,3,2002,2002,0,9.03,0.46,-8.57,435,28,-407,1848,33,-1815,0.0,256.0,256.0,0.0,7911948.0,7911948.0
Luis Ortega,Luis Ortega,Boston Red Sox,RSOX,1,1,1,2,2013,2014,1,0.0,1.52,1.52,0,76,76,0,0,0,0.0,212.0,212.0,0.0,1550000.0,1550000.0
Luis Rico,Luis Rico,Pittsburgh Pirates,PIRATS,1,2,2,4,2012,2014,2,0.0,1.15,1.15,0,120,120,0,7,7,0.0,252.0,252.0,0.0,0.0,0.0
Luis Rijo,Luis Rijo,New York Yankees,YANKS,1,2,2,4,2018,2018,0,0.29,0.32,0.03,37,12,-25,141,2,-139,0.0,163.0,163.0,0.0,12000000.0,12000000.0
Luis Rosado,Luis Rosado,Baltimore Orioles,ORLS,1,1,1,2,1985,1986,1,0.0,0.22,0.22,0,64,64,0,214,214,0.0,0.0,0.0,0.0,0.0,0.0
Luis Santana,Luis Santana,New York Mets,METS,1,3,2,5,2019,2019,0,0.0,1.17,1.17,0,140,140,0,453,453,0.0,0.0,0.0,0.0,0.0,0.0
Luis Sumoza,Luis Sumoza,Boston Red Sox,RSOX,2,2,2,4,2008,2009,1,-0.65,-0.89,-0.24,147,70,-77,486,191,-295,0.0,0.0,0.0,1500000.0,7440000.0,5940000.0
Luis Valenzuela,Luis Valenzuela,Kansas City Royals,ROYALS,1,1,2,3,2015,2015,0,0.0,-0.44,-0.44,0,12,12,0,34,34,0.0,0.0,0.0,0.0,4000000.0,4000000.0
Luis Vasquez,Luis Vasquez,Boston Red Sox,RSOX,3,6,4,10,1989,1993,4,-2.7,4.47,7.17,436,419,-17,1235,872,-363,258.0,1268.0,1010.0,177000.0,2600000.0,2423000.0
Luis Ysla,Luis Ysla,San Francisco Giants,GIANTS,1,1,1,2,2015,2015,0,0.0,-0.25,-0.25,0,24,24,0,75,75,0.0,0.0,0.0,0.0,5000000.0,5000000.0
Lukas Schiraldi,Lukas Schiraldi,Seattle Mariners,MARNRS,1,4,1,5,2017,2018,1,5.31,0.23,-5.08,114,11,-103,89,0,-89,990.0,26.0,-964.0,0.0,4600000.0,4600000.0
Luke Berryhill,Luke Berryhill,Cincinnati Reds,REDS,1,1,1,2,2021,2021,0,0.0,-0.48,-0.48,0,48,48,0,2,2,0.0,72.0,72.0,0.0,0.0,0.0
Luke Dykstra,Luke Dykstra,Atlanta Braves,BRAVES,2,6,2,8,2016,2017,1,2.2,1.46,-0.74,256,33,-223,58,35,-23,887.0,339.0,-548.0,13307500.0,11500000.0,-1807500.0
Lupe Chavez,Lupe Chavez,Toronto Blue Jays,BJAYS,1,1,1,2,2016,2016,0,0.0,-0.56,-0.56,0,14,14,0,0,0,0.0,45.0,45.0,0.0,0.0,0.0
Lynn Carlson,Lynn Carlson,Pittsburgh Pirates,PIRATS,1,1,1,2,1991,1992,1,0.0,0.0,0.0,0,0,0,0,0,0,0.0,0.0,0.0,0.0,0.0,0.0
Lynn McKinney,Lynn McKinney,Kansas City Royals,ROYALS,1,1,1,2,1978,1979,1,0.0,0.04,0.04,0,9,9,0,15,15,0.0,0.0,0.0,0.0,0.0,0.0
Maikol Escotto,Maikol Escotto,New York Yankees,YANKS,1,4,1,5,2021,2021,0,-0.2,2.23,2.43,9,31,22,3,2,-1,54.0,433.0,379.0,0.0,0.0,0.0
Malik Collymore,Malik Collymore,St. Louis Cardinals,CARDS,1,1,2,3,2015,2017,2,0.0,0.24,0.24,0,219,219,0,0,0,0.0,300.0,300.0,0.0,0.0,0.0
Malique Ziegler,Malique Ziegler,San Francisco Giants,GIANTS,1,1,1,2,2019,2019,0,0.0,0.33,0.33,0,70,70,0,147,147,0.0,0.0,0.0,0.0,0.0,0.0
Manny Francois,Manny Francois,Los Angeles Dodgers,DOGRS,1,2,1,3,1989,1989,0,0.0,0.0,0.0,0,0,0,0,0,0,0.0,0.0,0.0,0.0,0.0,0.0
Manny Lantigua,Manny Lantigua,Houston Astros,ASTROS,1,1,1,2,1975,1979,4,0.0,-0.52,-0.52,0,7,7,0,21,21,0.0,0.0,0.0,0.0,0.0,0.0
Manny Pérez,Manny Pérez,Pittsburgh Pirates,PIRATS,1,5,1,6,1947,1947,0,0.0,0.0,0.0,0,0,0,0,0,0,0.0,0.0,0.0,5000.0,0.0,-5000.0
Manuel Bernal,Manuel Bernal,Kansas City Royals,ROYALS,2,2,2,4,1998,1998,0,-0.35,0.02,0.37,74,30,-44,143,91,-52,0.0,0.0,0.0,0.0,260000.0,260000.0
Manuel Lugo,Manuel Lugo,Jalisco,Jalisco,1,2,1,3,1973,1973,0,8.38,0.0,-8.38,129,0,-129,0,0,0,2154.0,0.0,-2154.0,0.0,0.0,0.0
Manuel Rondon,Manuel Rondon,Anaheim Angels,ANGELS,1,2,1,3,2015,2015,0,0.0,0.0,0.0,0,0,0,0,0,0,0.0,0.0,0.0,0.0,0.0,0.0
Marc Griffin,Marc Griffin,Los Angeles Dodgers,DOGRS,2,2,2,4,1991,1998,7,0.0,-0.13,-0.13,0,3,3,0,0,0,0.0,7.0,7.0,0.0,0.0,0.0
Marc Lewis,Marc Lewis,Boston Red Sox,RSOX,6,11,11,22,1995,2000,5,9.7,4.71,-4.99,608,530,-78,1634,946,-688,1320.0,621.0,-699.0,7038500.0,2323500.0,-4715000.0
Marc Lewis,Marc Lewis,Atlanta Braves,BRAVES,1,1,1,2,1997,1997,0,0.0,0.0,0.0,0,28,28,0,58,58,0.0,0.0,0.0,0.0,750000.0,750000.0
Marc Marini,Marc Marini,Cleveland Indians,INDINS,1,2,1,3,1996,1996,0,0.0,0.0,0.0,0,0,0,0,0,0,0.0,0.0,0.0,0.0,0.0,0.0
Marcelo Carreno,Marcelo Carreno,Detroit Tigers,TIGRS,1,2,1,3,2012,2015,3,0.0,-0.35,-0.35,0,15,15,0,37,37,0.0,0.0,0.0,0.0,1375000.0,1375000.0
Marco Duarte,Marco Duarte,Houston Astros,ASTROS,1,1,1,2,2011,2018,7,0.0,12.15,12.15,0,795,795,0,2706,2706,0.0,0.0,0.0,0.0,0.0,0.0
Marcos Betances,Marcos Betances,Detroit Tigers,TIGRS,1,3,2,5,1989,1990,1,0.0,-0.12,-0.12,0,13,13,0,34,34,0.0,5.0,5.0,0.0,0.0,0.0
Marcus Greene,Marcus Greene,Texas Rangers,RNGRS,1,2,1,3,2015,2015,0,0.11,-0.05,-0.16,22,37,15,0,82,82,32.0,0.0,-32.0,508500.0,4250000.0,3741500.0
Marcus Smith,Marcus Smith,Oakland Athletics,ATLTCS,1,3,2,5,2020,2020,0,0.0,0.01,0.01,0,5,5,0,0,0,0.0,64.0,64.0,0.0,9833333.0,9833333.0
Marcus Wilson,Marcus Wilson,Arizona Diamondbacks,DBACKS,1,1,2,3,2019,2019,0,0.0,-0.94,-0.94,0,31,31,0,70,70,0.0,0.0,0.0,0.0,910000.0,910000.0
Mario Brito,Mario Brito,Montreal Expos,NATEX,3,5,6,11,1991,1997,6,15.54,6.93,-8.61,814,1027,213,3114,2899,-215,199.0,380.0,181.0,3475000.0,177000.0,-3298000.0
Mario Iglesias,Mario Iglesias,Chicago White Sox,WSOX,1,1,1,2,1999,1999,0,0.0,0.0,0.0,0,0,0,0,0,0,0.0,0.0,0.0,0.0,0.0,0.0
Mario Sanchez,Mario Sanchez,Washington Nationals,NATEX,1,1,1,2,2016,2019,3,0.0,-0.14,-0.14,0,44,44,0,0,0,0.0,57.0,57.0,0.0,0.0,0.0
Marion Jackson,Marion Jackson,Milwaukee Brewers,BREWRS,1,2,1,3,1971,1972,1,2.12,-1.77,-3.89,78,65,-13,19,18,-1,282.0,203.0,-79.0,0.0,0.0,0.0
Mark Appel,Mark Appel,Houston Astros,ASTROS,2,8,3,11,2015,2020,5,7.89,4.62,-3.27,397,276,-121,183,0,-183,2153.0,753.0,-1400.0,5115800.0,5819000.0,703200.0
Mark Blackmar,Mark Blackmar,Baltimore Orioles,ORLS,2,4,2,6,2014,2015,1,1.11,0.28,-0.83,60,50,-10,178,201,23,0.0,0.0,0.0,0.0,4250000.0,4250000.0
Mark Carper,Mark Carper,Baltimore Orioles,ORLS,1,2,1,3,1992,1998,6,0.0,6.46,6.46,0,315,315,0,0,0,0.0,1327.0,1327.0,0.0,0.0,0.0
Mark Covert,Mark Covert,St. Louis Cardinals,CARDS,1,1,1,2,1977,1977,0,0.0,1.89,1.89,0,81,81,0,16,16,0.0,256.0,256.0,0.0,0.0,0.0
Mark Davis,Mark Davis,New York Mets,METS,2,3,3,6,1985,1986,1,15.41,0.0,-15.41,1225,0,-1225,3818,0,-3818,18.0,0.0,-18.0,0.0,0.0,0.0
Mark Doran,Mark Doran,California Angels,ANGELS,1,2,1,3,1989,1989,0,10.8,0.0,-10.8,349,0,-349,0,0,0,1214.0,0.0,-1214.0,0.0,0.0,0.0
Mark Fellows,Mark Fellows,Detroit Tigers,TIGRS,1,3,2,5,1982,1982,0,-0.02,0.0,0.02,8,0,-8,20,0,-20,0.0,0.0,0.0,0.0,0.0,0.0
Mark Hamlin,Mark Hamlin,Colorado Rockies,ROCKS,8,16,13,29,1997,2002,5,6.04,1.53,-4.51,876,711,-165,660,1343,683,2239.0,928.0,-1311.0,9375000.0,9275000.0,-100000.0
Mark Hamlin,Mark Hamlin,Montreal Expos,NATEX,1,2,2,4,1997,1999,2,4.68,1.62,-3.06,267,77,-190,4,314,310,460.0,0.0,-460.0,725000.0,0.0,-725000.0
Mark Hampton,Mark Hampton,Texas Rangers,RNGRS,1,1,1,2,1992,1992,0,0.0,-0.49,-0.49,0,39,39,0,0,0,0.0,137.0,137.0,0.0,1075000.0,1075000.0
Mark Jackson,Mark Jackson,St. Louis Cardinals,CARDS,1,1,1,2,1985,1985,0,0.0,1.15,1.15,0,28,28,0,82,82,0.0,0.0,0.0,0.0,0.0,0.0
Mark Leonette,Mark Leonette,Oakland Athletics,ATLTCS,2,4,3,7,1987,1997,10,0.59,15.32,14.73,237,554,317,1,0,-1,339.0,1971.0,1632.0,0.0,0.0,0.0
Mark Mangum,Mark Mangum,Colorado Rockies,ROCKS,14,25,26,51,1997,2003,6,21.69,15.75,-5.94,2403,1893,-510,1976,1038,-938,5980.0,2902.0,-3078.0,24071314.0,14545000.0,-9526314.0
Mark Merchant,Mark Merchant,Pittsburgh Pirates,PIRATS,1,3,2,5,1989,1989,0,-1.22,-1.21,0.01,20,71,51,0,253,253,300.0,0.0,-300.0,222500.0,215000.0,-7500.0
Mark Nussbeck,Mark Nussbeck,St. Louis Cardinals,CARDS,3,6,6,12,2000,2009,9,25.91,31.82,5.91,1193,1089,-104,4738,3413,-1325,107.0,490.0,383.0,7200000.0,12850000.0,5650000.0
Mark Persails,Mark Persails,Detroit Tigers,TIGRS,3,10,6,16,1999,2002,3,3.62,7.62,4.0,1493,652,-841,3797,1742,-2055,861.0,1164.0,303.0,6750000.0,3640000.0,-3110000.0
Mark Phillips,Mark Phillips,San Diego Padres,PADRS,3,5,4,9,2003,2004,1,0.21,1.96,1.75,115,115,0,147,449,302,127.0,0.0,-127.0,5500000.0,0.0,-5500000.0
Mark Roberts,Mark Roberts,Chicago White Sox,WSOX,1,1,1,2,2000,2000,0,0.0,0.0,0.0,0,0,0,0,0,0,0.0,0.0,0.0,0.0,0.0,0.0
Mark Sappington,Mark Sappington,Anaheim Angels,ANGELS,1,1,1,2,2014,2015,1,0.0,0.96,0.96,0,71,71,0,0,0,0.0,157.0,157.0,0.0,750000.0,750000.0
Mark Seaver,Mark Seaver,Baltimore Orioles,ORLS,1,2,1,3,1997,1997,0,2.08,0.05,-2.03,82,83,1,11,349,338,1229.0,0.0,-1229.0,0.0,3300000.0,3300000.0
Mark Softy,Mark Softy,New York Yankees,YANKS,16,36,34,70,1979,1995,16,29.43,51.07,21.64,3022,3837,815,7138,10506,3368,6440.0,4403.0,-2037.0,3694706.0,5935000.0,2240294.0
Martin Rivas,Martin Rivas,Pittsburgh Pirates,PIRATS,5,12,10,22,1979,1992,13,33.21,31.68,-1.53,1132,2093,961,2374,3444,1070,5314.0,7695.0,2381.0,1030000.0,405000.0,-625000.0
Martin Sanchez,Martin Sanchez,Atlanta Braves,BRAVES,1,1,1,2,1996,1997,1,0.0,0.0,0.0,0,0,0,0,0,0,0.0,0.0,0.0,0.0,187500.0,187500.0
Marty Barnett,Marty Barnett,Philadelphia Phillies,PHILS,1,1,1,2,1999,2000,1,0.0,0.33,0.33,0,104,104,0,1,1,0.0,158.0,158.0,0.0,545000.0,545000.0
Marty Lister,Marty Lister,Cincinnati Reds,REDS,3,4,4,8,1994,2003,9,-0.82,7.3,8.12,166,906,740,133,2361,2228,172.0,625.0,453.0,1650000.0,275000.0,-1375000.0
Marty Mason,Marty Mason,New York Yankees,YANKS,5,11,11,22,1982,1993,11,53.43,40.75,-12.68,2484,1599,-885,8455,4687,-3768,3002.0,2795.0,-207.0,2627500.0,2285766.0,-341734.0
Marty Weymouth,Marty Weymouth,Seattle Mariners,MARNRS,1,1,1,2,1998,1998,0,0.0,-0.34,-0.34,0,2,2,0,0,0,0.0,17.0,17.0,0.0,0.0,0.0
Marv Thompson,Marv Thompson,New York Yankees,YANKS,1,2,1,3,1980,1980,0,0.52,-0.3,-0.82,8,10,2,0,0,0,129.0,152.0,23.0,0.0,200000.0,200000.0
Marvin Duke,Marvin Duke,New York Yankees,YANKS,1,2,1,3,1936,1938,2,0.0,0.31,0.31,0,13,13,0,47,47,0.0,0.0,0.0,0.0,0.0,0.0
Mason Berne,Mason Berne,Atlanta Braves,BRAVES,1,1,1,2,2021,2021,0,0.0,-0.32,-0.32,0,26,26,0,87,87,0.0,0.0,0.0,0.0,3500000.0,3500000.0
Mateo Gil,Mateo Gil,St. Louis Cardinals,CARDS,1,5,1,6,2021,2021,0,0.69,4.14,3.45,45,157,112,42,653,611,346.0,0.0,-346.0,0.0,0.0,0.0
Mathew Reeves,Mathew Reeves,Los Angeles Dodgers,DOGRS,1,3,1,4,1981,1987,6,3.72,8.48,4.76,672,868,196,2514,2981,467,0.0,0.0,0.0,0.0,0.0,0.0
Matt Avery,Matt Avery,Chicago Cubs,CUBS,2,2,2,4,2008,2012,4,0.09,-0.51,-0.6,2,59,57,0,33,33,3.0,312.0,309.0,0.0,0.0,0.0
Matt Ball,Matt Ball,Chicago White Sox,WSOX,1,1,1,2,2016,2016,0,0.0,-0.57,-0.57,0,9,9,0,3,3,0.0,83.0,83.0,0.0,0.0,0.0
Matt Boone,Matt Boone,Detroit Tigers,TIGRS,2,5,4,9,2002,2005,3,-0.66,0.33,0.99,20,180,160,16,775,759,130.0,0.0,-130.0,2400000.0,340000.0,-2060000.0
Matt Brash,Matt Brash,San Diego Padres,PADRS,1,1,1,2,2020,2021,1,0.0,0.12,0.12,0,10,10,0,0,0,0.0,19.0,19.0,0.0,0.0,0.0
Matt Brazis,Matt Brazis,Seattle Mariners,MARNRS,2,3,2,5,2014,2015,1,0.64,-0.53,-1.17,21,36,15,60,81,21,0.0,0.0,0.0,2505000.0,2000000.0,-505000.0
Matt Bruback,Matt Bruback,Chicago Cubs,CUBS,1,3,3,6,2003,2011,8,0.04,25.85,25.81,310,1180,870,721,4941,4220,0.0,0.0,0.0,0.0,4025000.0,4025000.0
Matt Brunson,Matt Brunson,Detroit Tigers,TIGRS,1,1,1,2,1996,1996,0,0.0,-0.7,-0.7,0,25,25,0,0,0,0.0,91.0,91.0,0.0,0.0,0.0
Matt Bullinger,Matt Bullinger,Cleveland Indians,INDINS,1,1,1,2,1981,1984,3,0.0,-0.04,-0.04,0,62,62,0,0,0,0.0,209.0,209.0,0.0,0.0,0.0
Matt Bullinger,Matt Bullinger,New York Mets,METS,1,3,1,4,1984,1987,3,3.5,-0.12,-3.62,99,72,-27,111,61,-50,956.0,505.0,-451.0,0.0,0.0,0.0
Matt Coenen,Matt Coenen,Detroit Tigers,TIGRS,1,1,1,2,2003,2006,3,0.0,1.26,1.26,0,141,141,0,0,0,0.0,477.0,477.0,0.0,0.0,0.0
Matt Connolly,Matt Connolly,Colorado Rockies,ROCKS,1,1,1,2,1992,1993,1,0.0,0.0,0.0,0,0,0,0,0,0,0.0,0.0,0.0,0.0,0.0,0.0
Matt Cusick,Matt Cusick,Houston Astros,ASTROS,1,1,1,2,2008,2009,1,0.0,2.94,2.94,0,175,175,0,0,0,0.0,253.0,253.0,0.0,3750000.0,3750000.0
Matt Cusick,Matt Cusick,New York Yankees,YANKS,1,2,2,4,2010,2010,0,0.0,1.48,1.48,0,24,24,0,0,0,0.0,78.0,78.0,0.0,10500000.0,10500000.0
Matt Drews,Matt Drews,New York Yankees,YANKS,1,2,1,3,1996,1997,1,-0.38,0.96,1.34,46,151,105,180,653,473,0.0,0.0,0.0,6200000.0,9237500.0,3037500.0
Matt Drews,Matt Drews,Arizona Diamondbacks,DBACKS,2,6,2,8,1997,2003,6,6.66,8.29,1.63,875,595,-280,3219,2462,-757,172.0,0.0,-172.0,0.0,13550000.0,13550000.0
Matt Foley,Matt Foley,Miami Marlins,MARLNS,1,2,1,3,2016,2016,0,0.0,-0.25,-0.25,0,26,26,0,55,55,0.0,0.0,0.0,0.0,0.0,0.0
Matt Frawley,Matt Frawley,Pittsburgh Pirates,PIRATS,1,1,1,2,2017,2018,1,0.0,0.24,0.24,0,47,47,0,1,1,0.0,86.0,86.0,0.0,0.0,0.0
Matt Garrick,Matt Garrick,Anaheim Angels,ANGELS,1,1,1,2,1998,2000,2,0.0,2.17,2.17,0,139,139,0,0,0,0.0,492.0,492.0,0.0,475000.0,475000.0
Matt Gorgen,Matt Gorgen,Tampa Bay Devil Rays,RAYS,1,1,1,2,2010,2010,0,0.0,-0.67,-0.67,0,27,27,0,0,0,0.0,63.0,63.0,0.0,4185000.0,4185000.0
Matt Heidenreich,Matt Heidenreich,Chicago White Sox,WSOX,1,3,2,5,2012,2012,0,4.38,0.83,-3.55,242,35,-207,1,0,-1,927.0,104.0,-823.0,0.0,0.0,0.0
Matt Krook,Matt Krook,San Francisco Giants,GIANTS,1,4,2,6,2017,2017,0,1.25,0.0,-1.25,79,0,-79,289,0,-289,0.0,0.0,0.0,11000000.0,13000000.0,2000000.0
Matt Lawson,Matt Lawson,Texas Rangers,RNGRS,1,4,2,6,2010,2012,2,2.66,1.99,-0.67,576,111,-465,1946,0,-1946,977.0,588.0,-389.0,0.0,10150000.0,10150000.0
Matt Lawson,Matt Lawson,Seattle Mariners,MARNRS,1,2,1,3,2011,2011,0,0.0,0.19,0.19,0,37,37,0,0,0,0.0,128.0,128.0,0.0,0.0,0.0
Matt Lollis,Matt Lollis,San Diego Padres,PADRS,5,10,9,19,2014,2019,5,13.64,2.43,-11.21,896,526,-370,1526,1044,-482,2446.0,524.0,-1922.0,2925000.0,2005000.0,-920000.0
Matt Long,Matt Long,Anaheim Angels,ANGELS,2,2,2,4,2014,2015,1,-1.21,-0.45,0.76,229,32,-197,575,35,-540,5.0,0.0,-5.0,987500.0,700000.0,-287500.0
Matt Lorenzo,Matt Lorenzo,Texas Rangers,RNGRS,1,1,1,2,2005,2005,0,0.0,-0.94,-0.94,0,11,11,0,0,0,0.0,29.0,29.0,0.0,877500.0,877500.0
Matt McDonald,Matt McDonald,Oakland Athletics,ATLTCS,1,1,1,2,1995,1997,2,0.0,0.0,0.0,0,0,0,0,0,0,0.0,0.0,0.0,0.0,0.0,0.0
Matt Merricks,Matt Merricks,Atlanta Braves,BRAVES,1,1,1,2,2004,2005,1,0.0,-0.11,-0.11,0,66,66,0,0,0,0.0,58.0,58.0,0.0,1400000.0,1400000.0
Matt Nevarez,Matt Nevarez,Texas Rangers,RNGRS,1,2,1,3,2009,2009,0,0.0,-0.43,-0.43,0,28,28,0,104,104,0.0,0.0,0.0,0.0,1500000.0,1500000.0
Matt Parker,Matt Parker,St. Louis Cardinals,CARDS,1,3,1,4,2000,2003,3,0.9,5.69,4.79,122,488,366,2,2221,2219,248.0,0.0,-248.0,0.0,0.0,0.0
Matt Peterson,Matt Peterson,New York Mets,METS,4,6,6,12,2004,2010,6,-0.86,11.14,12.0,655,533,-122,1973,723,-1250,683.0,3210.0,2527.0,2841000.0,10775000.0,7934000.0
Matt Pool,Matt Pool,Colorado Rockies,ROCKS,1,1,1,2,1997,1997,0,0.0,0.51,0.51,0,28,28,0,33,33,0.0,259.0,259.0,0.0,1740000.0,1740000.0
Matt Rose,Matt Rose,Chicago Cubs,CUBS,1,4,1,5,2017,2020,3,6.48,3.51,-2.97,293,156,-137,969,150,-819,891.0,1319.0,428.0,0.0,0.0,0.0
Matt Seelinger,Matt Seelinger,Pittsburgh Pirates,PIRATS,1,1,2,3,2018,2018,0,0.0,0.0,0.0,0,15,15,0,47,47,0.0,0.0,0.0,0.0,5900000.0,5900000.0
Matt Targac,Matt Targac,Atlanta Braves,BRAVES,1,1,1,2,1999,1999,0,0.0,-0.06,-0.06,0,37,37,0,3,3,0.0,86.0,86.0,0.0,0.0,0.0
Matt Thayer,Matt Thayer,San Diego Padres,PADRS,1,2,1,3,2006,2006,0,0.0,0.0,0.0,0,0,0,0,0,0,0.0,0.0,0.0,0.0,0.0,0.0
Matt Waldron,Matt Waldron,Cleveland Indians,INDINS,1,3,6,9,2020,2020,0,0.62,-0.12,-0.74,5,36,31,4,78,74,57.0,44.0,-13.0,4100000.0,3000000.0,-1100000.0
Matt Yeatman,Matt Yeatman,Milwaukee Brewers,BREWRS,2,3,3,6,2002,2004,2,-0.18,-0.5,-0.32,49,158,109,142,124,-18,0.0,759.0,759.0,0.0,0.0,0.0
Matthew Dyer,Matthew Dyer,New York Mets,METS,1,2,1,3,2021,2021,0,0.0,0.56,0.56,0,26,26,0,22,22,0.0,190.0,190.0,100000.0,2500000.0,2400000.0
Matthew Liberatore,Matthew Liberatore,Tampa Bay Devil Rays,RAYS,2,4,5,9,2020,2020,0,-0.6,1.04,1.64,10,47,37,22,152,130,0.0,0.0,0.0,0.0,0.0,0.0
Matthew Spann,Matthew Spann,Tampa Bay Devil Rays,RAYS,2,2,2,4,2013,2015,2,-0.65,1.66,2.31,30,200,170,60,647,587,0.0,0.0,0.0,0.0,0.0,0.0
Matthew Spencer,Matthew Spencer,Philadelphia Phillies,PHILS,2,4,2,6,2008,2012,4,4.22,2.37,-1.85,203,206,3,28,216,188,867.0,1849.0,982.0,8500000.0,3700000.0,-4800000.0
Matthew Spencer,Matthew Spencer,Oakland Athletics,ATLTCS,3,6,5,11,2009,2013,4,-0.36,1.6,1.96,79,247,168,172,718,546,28.0,38.0,10.0,805000.0,2601500.0,1796500.0
Matthew Sweeney,Matthew Sweeney,Anaheim Angels,ANGELS,1,3,1,4,2009,2011,2,9.82,-0.01,-9.83,598,38,-560,1637,7,-1630,198.0,564.0,366.0,405000.0,6000000.0,5595000.0
Mauber Lopez,Mauber Lopez,Philadelphia Phillies,PHILS,1,1,1,2,2004,2007,3,0.0,-0.24,-0.24,0,59,59,0,0,0,0.0,108.0,108.0,0.0,0.0,0.0
Max Rachac,Max Rachac,New York Giants,GIANTS,1,2,1,3,1922,1923,1,0.0,0.03,0.03,0,4,4,0,1,1,0.0,15.0,15.0,0.0,0.0,0.0
Max Wotell,Max Wotell,New York Mets,METS,3,4,3,7,2016,2021,5,0.07,2.8,2.73,96,168,72,266,686,420,0.0,3.0,3.0,13000000.0,3500000.0,-9500000.0
Maxx Tissenbaum,Maxx Tissenbaum,San Diego Padres,PADRS,5,10,9,19,2014,2019,5,13.64,2.43,-11.21,896,526,-370,1526,1044,-482,2446.0,524.0,-1922.0,2925000.0,2005000.0,-920000.0
McKenzie Mills,McKenzie Mills,Washington Nationals,NATEX,1,2,2,4,2017,2020,3,0.0,3.05,3.05,0,238,238,0,808,808,0.0,0.0,0.0,0.0,10000000.0,10000000.0
McKenzie Mills,McKenzie Mills,Philadelphia Phillies,PHILS,1,1,2,3,2018,2018,0,0.0,-0.18,-0.18,0,29,29,0,54,54,0.0,0.0,0.0,0.0,3400000.0,3400000.0
Melvin Geho,Melvin Geho,Philadelphia Phillies,PHILS,2,8,4,12,1957,1962,5,1.07,-3.22,-4.29,707,621,-86,1985,2063,78,115.0,0.0,-115.0,9000.0,0.0,-9000.0
Miah Bradbury,Miah Bradbury,Seattle Mariners,MARNRS,2,3,3,6,1992,1994,2,-1.19,-0.25,0.94,99,17,-82,244,0,-244,20.0,66.0,46.0,0.0,125000.0,125000.0
Mica Lewis,Mica Lewis,Minnesota Twins,TWINS,1,1,1,2,1993,1993,0,0.0,0.0,0.0,0,0,0,0,0,0,0.0,0.0,0.0,0.0,0.0,0.0
Michael Almanzar,Michael Almanzar,Boston Red Sox,RSOX,1,2,2,4,2014,2015,1,-0.08,0.24,0.32,19,17,-2,45,41,-4,0.0,0.0,0.0,0.0,515000.0,515000.0
Michael Burgess,Michael Burgess,Washington Nationals,NATEX,1,3,1,4,2011,2012,1,0.0,1.64,1.64,0,148,148,0,40,40,0.0,531.0,531.0,0.0,0.0,0.0
Michael Dubee,Michael Dubee,Philadelphia Phillies,PHILS,1,1,1,2,2007,2007,0,0.0,0.99,0.99,0,45,45,0,156,156,0.0,0.0,0.0,0.0,3250000.0,3250000.0
Michael Dubee,Michael Dubee,Chicago White Sox,WSOX,1,1,1,2,2009,2009,0,0.0,0.0,0.0,0,0,0,0,0,0,0.0,0.0,0.0,0.0,0.0,0.0
Michael Everett,Michael Everett,Philadelphia Phillies,PHILS,1,2,1,3,1970,1970,0,0.0,-0.64,-0.64,0,22,22,0,70,70,0.0,0.0,0.0,0.0,0.0,0.0
Michael Fremuth,Michael Fremuth,Detroit Tigers,TIGRS,1,2,1,3,1971,1973,2,0.0,3.07,3.07,0,217,217,0,745,745,0.0,0.0,0.0,0.0,60000.0,60000.0
Michael Herson,Michael Herson,Baltimore Orioles,ORLS,2,3,3,6,1971,1973,2,-0.61,-0.01,0.6,124,47,-77,406,80,-326,0.0,0.0,0.0,0.0,18000.0,18000.0
Michael Mader,Michael Mader,Miami Marlins,MARLNS,1,2,1,3,2016,2018,2,0.0,-0.38,-0.38,0,45,45,0,0,0,0.0,42.0,42.0,0.0,0.0,0.0
Michael Main,Michael Main,Texas Rangers,RNGRS,1,2,1,3,2010,2010,0,0.12,-0.8,-0.92,56,57,1,0,195,195,72.0,0.0,-72.0,975000.0,4500000.0,3525000.0
Michael Plassmeyer,Michael Plassmeyer,Seattle Mariners,MARNRS,1,3,2,5,2018,2020,2,3.75,-0.48,-4.23,316,148,-168,979,613,-366,0.0,0.0,0.0,2975000.0,0.0,-2975000.0
Michael Plassmeyer,Michael Plassmeyer,Tampa Bay Devil Rays,RAYS,1,1,2,3,2021,2021,0,0.0,0.28,0.28,0,28,28,0,0,0,0.0,88.0,88.0,0.0,1150000.0,1150000.0
Michael Poindexter,Michael Poindexter,Cleveland Indians,INDINS,1,2,1,3,1984,1984,0,0.0,0.34,0.34,0,25,25,0,0,0,0.0,151.0,151.0,0.0,0.0,0.0
Michael Santos,Michael Santos,San Francisco Giants,GIANTS,2,5,3,8,2016,2017,1,1.48,0.39,-1.09,241,87,-154,809,81,-728,306.0,728.0,422.0,7000000.0,0.0,-7000000.0
Michael Thomas,Michael Thomas,Boston Red Sox,RSOX,1,4,1,5,2010,2013,3,0.81,5.19,4.38,55,355,300,34,1329,1295,134.0,0.0,-134.0,0.0,418580.0,418580.0
Michell Miliano,Michell Miliano,San Diego Padres,PADRS,1,3,2,5,2021,2021,0,0.0,0.98,0.98,0,57,57,0,211,211,0.0,0.0,0.0,0.0,4300000.0,4300000.0
Mick Fieldbinder,Mick Fieldbinder,Milwaukee Brewers,BREWRS,1,1,1,2,1997,1998,1,0.0,0.18,0.18,0,140,140,0,299,299,0.0,0.0,0.0,0.0,0.0,0.0
Mick Pageler,Mick Pageler,San Francisco Giants,GIANTS,1,3,1,4,1997,2004,7,-0.78,10.35,11.13,14,712,698,11,6,-5,128.0,1135.0,1007.0,0.0,3080000.0,3080000.0
Mickey Hall,Mickey Hall,Boston Red Sox,RSOX,1,1,1,2,2009,2009,0,0.0,0.21,0.21,0,7,7,0,0,0,0.0,102.0,102.0,0.0,0.0,0.0
Mickey Pina,Mickey Pina,Boston Red Sox,RSOX,1,1,1,2,1991,1991,0,0.0,-0.64,-0.64,0,13,13,0,0,0,0.0,67.0,67.0,0.0,0.0,0.0
Miguel Celestino,Miguel Celestino,Seattle Mariners,MARNRS,1,2,1,3,2010,2010,0,1.78,-0.77,-2.55,120,125,5,382,457,75,3.0,0.0,-3.0,0.0,0.0,0.0
Miguel Chalas,Miguel Chalas,Baltimore Orioles,ORLS,2,4,2,6,2014,2015,1,1.11,0.28,-0.83,60,50,-10,178,201,23,0.0,0.0,0.0,0.0,4250000.0,4250000.0
Miguel Felix,Miguel Felix,Chicago White Sox,WSOX,1,4,2,6,2000,2001,1,0.13,0.48,0.35,312,100,-212,1036,320,-716,0.0,0.0,0.0,675000.0,6600000.0,5925000.0
Miguel Inzunza,Miguel Inzunza,St. Louis Cardinals,CARDS,1,2,2,4,1996,1997,1,-0.3,0.33,0.63,16,17,1,0,37,37,71.0,0.0,-71.0,180000.0,0.0,-180000.0
Miguel Padilla,Miguel Padilla,Houston Astros,ASTROS,1,1,1,2,2020,2021,1,0.0,0.0,0.0,0,0,0,0,0,0,0.0,0.0,0.0,0.0,0.0,0.0
Miguel Sabino,Miguel Sabino,Atlanta Braves,BRAVES,1,2,2,4,1990,1990,0,0.0,0.0,0.0,0,0,0,0,0,0,0.0,0.0,0.0,0.0,0.0,0.0
Miguel Sosa,Miguel Sosa,Atlanta Braves,BRAVES,1,1,1,2,1985,1986,1,0.0,0.62,0.62,0,92,92,0,221,221,0.0,0.0,0.0,0.0,435000.0,435000.0
Miguel Sulbaran,Miguel Sulbaran,Los Angeles Dodgers,DOGRS,2,2,2,4,2013,2014,1,-0.54,-0.4,0.14,22,67,45,57,199,142,0.0,5.0,5.0,700000.0,0.0,-700000.0
Miguel Sulbaran,Miguel Sulbaran,Minnesota Twins,TWINS,2,2,2,4,2014,2019,5,1.23,3.09,1.86,126,279,153,517,814,297,0.0,414.0,414.0,0.0,0.0,0.0
Mike Allen,Mike Allen,San Diego Padres,PADRS,2,3,2,5,1977,1977,0,-0.17,0.14,0.31,215,64,-151,280,187,-93,168.0,11.0,-157.0,0.0,95000.0,95000.0
Mike Antonini,Mike Antonini,New York Mets,METS,1,1,1,2,2010,2011,1,0.0,-0.43,-0.43,0,22,22,0,23,23,0.0,0.0,0.0,0.0,0.0,0.0
Mike Baldwin,Mike Baldwin,Montreal Expos,NATEX,1,1,1,2,1975,1977,2,0.0,-0.14,-0.14,0,7,7,0,18,18,0.0,0.0,0.0,0.0,0.0,0.0
Mike Berger,Mike Berger,Montreal Expos,NATEX,1,1,1,2,1988,1990,2,0.0,0.3,0.3,0,8,8,0,5,5,0.0,54.0,54.0,0.0,0.0,0.0
Mike Blais,Mike Blais,Boston Red Sox,RSOX,1,1,1,2,1998,1998,0,0.0,-0.31,-0.31,0,6,6,0,0,0,0.0,6.0,6.0,0.0,0.0,0.0
Mike Brady,Mike Brady,Toronto Blue Jays,BJAYS,1,2,1,3,1989,1991,2,-0.46,1.54,2.0,96,287,191,2,1134,1132,175.0,0.0,-175.0,200000.0,1000000.0,800000.0
Mike Brooks,Mike Brooks,Minnesota Twins,TWINS,2,3,3,6,1973,1977,4,0.26,-0.78,-1.04,4,55,51,0,0,0,14.0,604.0,590.0,11000.0,0.0,-11000.0
Mike Browning,Mike Browning,New York Yankees,YANKS,1,1,1,2,1983,1985,2,0.0,0.53,0.53,0,13,13,0,0,0,0.0,50.0,50.0,0.0,0.0,0.0
Mike Bucci,Mike Bucci,Texas Rangers,RNGRS,1,3,2,5,1980,1980,0,-0.55,-1.43,-0.88,28,119,91,57,205,148,0.0,0.0,0.0,0.0,0.0,0.0
Mike Bumstead,Mike Bumstead,San Diego Padres,PADRS,1,2,1,3,2005,2005,0,0.0,0.14,0.14,0,9,9,0,15,15,0.0,0.0,0.0,0.0,316000.0,316000.0
Mike Burns,Mike Burns,Detroit Tigers,TIGRS,3,6,5,11,1978,1980,2,0.12,-0.82,-0.94,242,77,-165,584,186,-398,0.0,0.0,0.0,0.0,0.0,0.0
Mike Carruthers,Mike Carruthers,Cleveland Indians,INDINS,1,1,1,2,1972,1972,0,0.0,0.0,0.0,0,0,0,0,0,0,0.0,0.0,0.0,0.0,0.0,0.0
Mike Carter,Mike Carter,Milwaukee Brewers,BREWRS,1,2,1,3,1993,1995,2,0.0,1.19,1.19,0,47,47,0,0,0,0.0,559.0,559.0,0.0,245000.0,245000.0
Mike Curry,Mike Curry,Kansas City Royals,ROYALS,1,1,1,2,2001,2001,0,0.0,-0.82,-0.82,0,29,29,0,80,80,0.0,0.0,0.0,0.0,0.0,0.0
Mike Curtis,Mike Curtis,Chicago Cubs,CUBS,4,7,7,14,1988,2001,13,5.81,8.61,2.8,1572,1332,-240,2118,2424,306,1917.0,3355.0,1438.0,10348333.0,6555000.0,-3793333.0
Mike Davis,Mike Davis,New York Mets,METS,1,1,1,2,1983,1984,1,0.0,-0.77,-0.77,0,96,96,0,85,85,0.0,780.0,780.0,0.0,0.0,0.0
Mike Drumright,Mike Drumright,Detroit Tigers,TIGRS,2,3,2,5,1999,2002,3,-0.26,-0.81,-0.55,6,38,32,0,0,0,17.0,162.0,145.0,0.0,220000.0,220000.0
Mike Flannery,Mike Flannery,Florida Marlins,MARLNS,2,3,2,5,2005,2005,0,0.68,-0.67,-1.35,117,54,-63,0,1,1,368.0,71.0,-297.0,0.0,1950000.0,1950000.0
Mike Floyd,Mike Floyd,Los Angeles Dodgers,DOGRS,1,2,2,4,1973,1973,0,0.0,0.0,0.0,0,0,0,0,0,0,0.0,0.0,0.0,0.0,0.0,0.0
Mike Freitas,Mike Freitas,New York Mets,METS,1,2,1,3,1992,1994,2,1.1,0.52,-0.58,68,170,102,3,6,3,150.0,357.0,207.0,0.0,510000.0,510000.0
Mike Fulmer,Mike Fulmer,Oakland Athletics,ATLTCS,1,4,1,5,1986,1987,1,2.24,1.63,-0.61,195,21,-174,688,0,-688,0.0,339.0,339.0,0.0,0.0,0.0
Mike Gordon,Mike Gordon,New York Yankees,YANKS,1,3,1,4,1995,2000,5,-0.54,20.23,20.77,27,149,122,0,13,13,296.0,2766.0,2470.0,0.0,8000000.0,8000000.0
Mike Goss,Mike Goss,Boston Red Sox,RSOX,1,4,1,5,2003,2008,5,0.73,17.72,16.99,728,123,-605,51,11,-40,1381.0,2025.0,644.0,634000.0,10000000.0,9366000.0
Mike Guerrero,Mike Guerrero,Milwaukee Brewers,BREWRS,1,1,1,2,1992,1993,1,0.0,0.08,0.08,0,30,30,0,0,0,0.0,112.0,112.0,0.0,0.0,0.0
Mike Halperin,Mike Halperin,Toronto Blue Jays,BJAYS,2,7,5,12,1996,2001,5,5.42,8.51,3.09,1726,826,-900,3923,2165,-1758,1392.0,748.0,-644.0,1500000.0,5870000.0,4370000.0
Mike Hernandez,Mike Hernandez,Detroit Tigers,TIGRS,2,2,3,5,2008,2011,3,-1.5,4.58,6.08,16,89,73,16,12,-4,128.0,1400.0,1272.0,0.0,0.0,0.0
Mike Hook,Mike Hook,Houston Astros,ASTROS,1,3,1,4,1989,1989,0,0.0,-0.25,-0.25,0,40,40,0,31,31,0.0,290.0,290.0,0.0,0.0,0.0
Mike Hook,Mike Hook,California Angels,ANGELS,2,3,2,5,1990,1992,2,0.89,0.39,-0.5,197,172,-25,434,626,192,0.0,0.0,0.0,357500.0,2316666.0,1959166.0
Mike Jacobs,Mike Jacobs,Boston Red Sox,RSOX,6,11,11,22,1995,2000,5,9.7,4.71,-4.99,608,530,-78,1634,946,-688,1320.0,621.0,-699.0,7038500.0,2323500.0,-4715000.0
Mike King,Mike King,Oakland Athletics,ATLTCS,2,2,3,5,1980,1983,3,5.46,1.47,-3.99,400,157,-243,1376,554,-822,0.0,0.0,0.0,0.0,0.0,0.0
Mike King,Mike King,Chicago Cubs,CUBS,1,1,1,2,1982,1982,0,0.0,0.0,0.0,0,0,0,0,0,0,0.0,0.0,0.0,0.0,0.0,0.0
Mike Kremblas,Mike Kremblas,Toronto Blue Jays,BJAYS,1,1,1,2,2002,2004,2,0.0,0.2,0.2,0,192,192,0,589,589,0.0,0.0,0.0,0.0,0.0,0.0
Mike Lebo,Mike Lebo,Toronto Blue Jays,BJAYS,4,4,4,8,1981,1982,1,-0.11,-2.44,-2.33,179,147,-32,384,402,18,0.0,0.0,0.0,0.0,160000.0,160000.0
Mike Maitland,Mike Maitland,Chicago White Sox,WSOX,2,3,3,6,1983,1985,2,0.33,0.15,-0.18,77,5,-72,7,0,-7,121.0,16.0,-105.0,0.0,0.0,0.0
Mike Nannini,Mike Nannini,Houston Astros,ASTROS,1,3,1,4,2002,2002,0,0.0,0.4,0.4,0,30,30,0,1,1,0.0,57.0,57.0,0.0,2800000.0,2800000.0
Mike Nannini,Mike Nannini,Chicago Cubs,CUBS,2,3,4,7,2003,2010,7,2.37,22.6,20.23,134,924,790,491,4021,3530,0.0,0.0,0.0,13555000.0,4250000.0,-9305000.0
Mike Ondina,Mike Ondina,Chicago White Sox,WSOX,1,1,1,2,1978,1978,0,0.0,0.33,0.33,0,8,8,0,30,30,0.0,0.0,0.0,0.0,0.0,0.0
Mike Pomeranz,Mike Pomeranz,Minnesota Twins,TWINS,1,1,2,3,1990,1991,1,0.0,1.68,1.68,0,132,132,0,338,338,0.0,0.0,0.0,0.0,0.0,0.0
Mike Pomeranz,Mike Pomeranz,Pittsburgh Pirates,PIRATS,1,1,1,2,1990,1994,4,0.0,0.42,0.42,0,312,312,0,714,714,0.0,0.0,0.0,0.0,210000.0,210000.0
Mike Rupp,Mike Rupp,Boston Red Sox,RSOX,1,1,1,2,2001,2001,0,0.0,0.0,0.0,0,0,0,0,0,0,0.0,0.0,0.0,0.0,0.0,0.0
Mike Santiago,Mike Santiago,Atlanta Braves,BRAVES,1,1,1,2,1986,1988,2,0.0,0.08,0.08,0,160,160,0,5,5,0.0,269.0,269.0,0.0,0.0,0.0
Mike Santiago,Mike Santiago,New York Mets,METS,1,2,3,5,1988,1988,0,-0.66,0.0,0.66,87,0,-87,337,0,-337,0.0,0.0,0.0,650000.0,0.0,-650000.0
Mike Shade,Mike Shade,Minnesota Twins,TWINS,1,1,1,2,1987,1991,4,0.0,2.06,2.06,0,618,618,0,1876,1876,0.0,0.0,0.0,0.0,0.0,0.0
Mike Sinnerud,Mike Sinnerud,Milwaukee Braves,BRAVES,1,1,1,2,1965,1966,1,0.0,-0.19,-0.19,0,15,15,0,36,36,0.0,0.0,0.0,0.0,0.0,0.0
Mike Sinnerud,Mike Sinnerud,Houston Astros,ASTROS,1,3,1,4,1968,1968,0,0.37,0.0,-0.37,361,0,-361,1073,0,-1073,0.0,0.0,0.0,0.0,0.0,0.0
Mike Sodders,Mike Sodders,Minnesota Twins,TWINS,2,2,2,4,1983,1983,0,-0.24,-0.65,-0.41,89,31,-58,175,113,-62,0.0,0.0,0.0,0.0,0.0,0.0
Mike Sodders,Mike Sodders,Chicago Cubs,CUBS,1,1,1,2,1992,1992,0,0.0,-0.61,-0.61,0,48,48,0,122,122,0.0,0.0,0.0,0.0,2500000.0,2500000.0
Mike Soper,Mike Soper,Chicago White Sox,WSOX,7,14,13,27,1985,1996,11,11.29,32.32,21.03,1612,1563,-49,4746,6374,1628,301.0,975.0,674.0,6084000.0,2773055.0,-3310945.0
Mike Soper,Mike Soper,New York Yankees,YANKS,1,2,2,4,1987,1995,8,-0.86,11.75,12.61,19,665,646,0,2177,2177,199.0,66.0,-133.0,0.0,0.0,0.0
Mike Soper,Mike Soper,Chicago White Sox,WSOX,2,4,3,7,1987,1993,6,58.18,-1.05,-59.23,1893,402,-1491,7947,1106,-6841,125.0,649.0,524.0,260000.0,0.0,-260000.0
Mike Stefanski,Mike Stefanski,Milwaukee Brewers,BREWRS,1,1,1,2,1995,1995,0,0.0,0.0,0.0,0,0,0,0,0,0,0.0,0.0,0.0,0.0,0.0,0.0
Mike Stoker,Mike Stoker,Houston Astros,ASTROS,1,2,2,4,1987,1992,5,-0.79,-1.14,-0.35,36,612,576,82,2086,2004,0.0,0.0,0.0,0.0,875000.0,875000.0
Mike Sullivan,Mike Sullivan,Philadelphia Phillies,PHILS,3,5,5,10,1994,2000,6,9.86,-2.15,-12.01,543,698,155,225,2244,2019,1674.0,703.0,-971.0,876500.0,1319000.0,442500.0
Mike Turgeon,Mike Turgeon,Chicago Cubs,CUBS,1,3,2,5,1980,1981,1,-0.93,0.0,0.93,72,0,-72,267,0,-267,0.0,0.0,0.0,0.0,0.0,0.0
Mike Villa,Mike Villa,San Francisco Giants,GIANTS,1,3,1,4,1987,1987,0,2.82,0.95,-1.87,290,101,-189,7,239,232,505.0,0.0,-505.0,0.0,0.0,0.0
Mike Villano,Mike Villano,San Francisco Giants,GIANTS,1,3,1,4,1997,2004,7,-0.78,10.35,11.13,14,712,698,11,6,-5,128.0,1135.0,1007.0,0.0,3080000.0,3080000.0
Mike Watson,Mike Watson,Colorado Rockies,ROCKS,2,2,2,4,2003,2003,0,0.24,-0.63,-0.87,40,21,-19,109,81,-28,0.0,0.0,0.0,0.0,6000000.0,6000000.0
Mike Watt,Mike Watt,Los Angeles Dodgers,DOGRS,1,2,1,3,2008,2008,0,0.0,-0.25,-0.25,0,14,14,0,13,13,0.0,122.0,122.0,0.0,10000000.0,10000000.0
Mike Watters,Mike Watters,Los Angeles Dodgers,DOGRS,2,5,4,9,1986,1992,6,10.4,9.71,-0.69,399,1157,758,1,1800,1799,4543.0,1247.0,-3296.0,1249500.0,1342653.0,93153.0
Mike Weathers,Mike Weathers,Toronto Blue Jays,BJAYS,2,3,3,6,1977,1977,0,-0.31,2.36,2.67,91,132,41,268,528,260,0.0,0.0,0.0,0.0,0.0,0.0
Mike Wenner,Mike Wenner,Oakland Athletics,ATLTCS,1,1,1,2,2001,2002,1,0.0,0.75,0.75,0,20,20,0,0,0,0.0,161.0,161.0,0.0,240000.0,240000.0
Mike Westbrook,Mike Westbrook,New York Mets,METS,1,1,1,2,1987,1987,0,0.0,0.0,0.0,0,0,0,0,0,0,0.0,0.0,0.0,0.0,0.0,0.0
Mike Wilkins,Mike Wilkins,Detroit Tigers,TIGRS,1,1,1,2,1990,1993,3,0.0,0.81,0.81,0,80,80,0,0,0,0.0,181.0,181.0,0.0,0.0,0.0
Mike Williams,Mike Williams,Chicago White Sox,WSOX,2,5,3,8,2001,2001,0,-0.46,1.34,1.8,81,17,-64,117,2,-115,78.0,302.0,224.0,0.0,0.0,0.0
Mike Williams,Mike Williams,Toronto Blue Jays,BJAYS,1,1,1,2,2001,2001,0,0.0,0.28,0.28,0,16,16,0,0,0,0.0,57.0,57.0,0.0,0.0,0.0
Mike Wodnicki,Mike Wodnicki,St. Louis Cardinals,CARDS,1,2,1,3,2002,2003,1,-1.26,0.08,1.34,128,65,-63,2,78,76,230.0,608.0,378.0,245000.0,1100000.0,855000.0
Mike Ziegler,Mike Ziegler,Oakland Athletics,ATLTCS,1,1,1,2,2005,2005,0,0.0,0.0,0.0,0,0,0,0,0,0,0.0,0.0,0.0,0.0,0.0,0.0
Miles Head,Miles Head,Boston Red Sox,RSOX,1,3,2,5,2011,2013,2,15.82,0.39,-15.43,609,113,-496,2364,219,-2145,139.0,132.0,-7.0,0.0,1865000.0,1865000.0
Miller Diaz,Miller Diaz,New York Mets,METS,3,8,7,15,2015,2018,3,0.7,4.78,4.08,291,310,19,600,0,-600,833.0,459.0,-374.0,24250000.0,17133065.0,-7116935.0
Mishael Deson,Mishael Deson,Colorado Rockies,ROCKS,2,4,3,7,2020,2021,1,0.45,0.91,0.46,52,72,20,18,0,-18,64.0,117.0,53.0,4050000.0,3225000.0,-825000.0
Mitch Cook,Mitch Cook,Chicago Cubs,CUBS,3,4,4,8,1983,1986,3,-0.29,0.14,0.43,16,70,54,0,5,5,71.0,155.0,84.0,0.0,0.0,0.0
Mitch Cook,Mitch Cook,New York Mets,METS,1,3,1,4,1984,1986,2,6.19,2.33,-3.86,605,254,-351,2016,932,-1084,0.0,0.0,0.0,0.0,0.0,0.0
Mitch Hilligoss,Mitch Hilligoss,New York Yankees,YANKS,1,2,1,3,2010,2011,1,0.0,-0.32,-0.32,0,33,33,0,35,35,0.0,0.0,0.0,0.0,0.0,0.0
Moose Johnson,Moose Johnson,Philadelphia Phillies,PHILS,1,4,4,8,1956,1956,0,0.0,0.0,0.0,0,0,0,0,0,0,0.0,0.0,0.0,0.0,0.0,0.0
Myles Smith,Myles Smith,Boston Red Sox,RSOX,1,1,1,2,2014,2015,1,0.0,0.0,0.0,0,0,0,0,0,0,0.0,0.0,0.0,0.0,0.0,0.0
Natanael Mateo,Natanael Mateo,San Diego Padres,PADRS,1,2,1,3,2005,2005,0,0.04,0.91,0.87,16,37,21,37,124,87,0.0,0.0,0.0,325000.0,400000.0,75000.0
Nate Cromwell,Nate Cromwell,Atlanta Braves,BRAVES,2,3,2,5,1990,1992,2,0.0,-0.43,-0.43,0,48,48,0,3,3,0.0,104.0,104.0,0.0,0.0,0.0
Nate Hyatt,Nate Hyatt,Anaheim Angels,ANGELS,1,2,1,3,2015,2016,1,0.0,-0.31,-0.31,0,19,19,0,39,39,0.0,0.0,0.0,0.0,0.0,0.0
Nate Spears,Nate Spears,Baltimore Orioles,ORLS,1,2,1,3,2006,2007,1,0.0,5.92,5.92,0,267,267,0,1002,1002,0.0,0.0,0.0,0.0,0.0,0.0
Nate Tebbs,Nate Tebbs,San Diego Padres,PADRS,3,5,6,11,2000,2011,11,-1.09,8.64,9.73,131,924,793,88,239,151,85.0,1430.0,1345.0,2077500.0,1600000.0,-477500.0
Nathan Kirby,Nathan Kirby,Milwaukee Brewers,BREWRS,1,1,1,2,2021,2021,0,0.0,0.0,0.0,0,0,0,0,0,0,0.0,0.0,0.0,0.0,0.0,0.0
Nathan Lukes,Nathan Lukes,Cleveland Indians,INDINS,1,2,1,3,2016,2018,2,0.0,0.9,0.9,0,212,212,0,509,509,0.0,3.0,3.0,0.0,0.0,0.0
Nathan Witt,Nathan Witt,Los Angeles Dodgers,DOGRS,2,2,2,4,2019,2020,1,-0.14,0.27,0.41,10,47,37,0,3,3,28.0,81.0,53.0,0.0,0.0,0.0
Neal Mersch,Neal Mersch,New York Yankees,YANKS,16,36,34,70,1979,1995,16,29.43,51.07,21.64,3022,3837,815,7138,10506,3368,6440.0,4403.0,-2037.0,3694706.0,5935000.0,2240294.0
Neder Horta,Neder Horta,New York Yankees,YANKS,4,8,5,13,1985,1989,4,16.4,-1.53,-17.93,1169,149,-1020,2749,144,-2605,4224.0,1295.0,-2929.0,1022000.0,1965000.0,943000.0
Neil Simoneaux,Neil Simoneaux,St. Louis Cardinals,CARDS,1,1,1,2,2002,2003,1,0.0,-0.05,-0.05,0,4,4,0,1,1,0.0,13.0,13.0,0.0,0.0,0.0
Nelson Garcia,Nelson Garcia,Philadelphia Phillies,PHILS,1,1,1,2,1975,1976,1,0.0,1.73,1.73,0,106,106,0,15,15,0.0,290.0,290.0,0.0,0.0,0.0
Nelson Garcia,Nelson Garcia,Cleveland Indians,INDINS,2,2,2,4,1976,1984,8,0.0,1.63,1.63,0,204,204,0,722,722,0.0,28.0,28.0,0.0,0.0,0.0
Nelson Lara,Nelson Lara,Florida Marlins,MARLNS,1,1,1,2,2001,2006,5,0.0,0.0,0.0,0,0,0,0,0,0,0.0,0.0,0.0,0.0,0.0,0.0
Nelson Payano,Nelson Payano,Atlanta Braves,BRAVES,1,1,1,2,2008,2009,1,0.0,-0.37,-0.37,0,206,206,0,299,299,0.0,0.0,0.0,0.0,0.0,0.0
Nelson Ward,Nelson Ward,Seattle Mariners,MARNRS,2,3,3,6,2015,2016,1,1.44,-0.13,-1.57,26,49,23,0,0,0,71.0,128.0,57.0,0.0,8000000.0,8000000.0
Neraldo Catalina,Neraldo Catalina,New York Mets,METS,1,1,1,2,2019,2019,0,0.0,0.31,0.31,0,29,29,0,4,4,0.0,93.0,93.0,0.0,560400.0,560400.0
Nestor Molina,Nestor Molina,Toronto Blue Jays,BJAYS,1,1,1,2,2011,2014,3,0.0,-0.71,-0.71,0,67,67,0,1,1,0.0,155.0,155.0,0.0,435000.0,435000.0
Nial Hughes,Nial Hughes,Los Angeles Dodgers,DOGRS,2,3,2,5,2001,2004,3,0.31,4.7,4.39,45,302,257,101,1189,1088,0.0,0.0,0.0,975000.0,212000.0,-763000.0
Nick Davis,Nick Davis,New York Mets,METS,1,2,1,3,1990,1990,0,0.0,0.27,0.27,0,12,12,0,0,0,0.0,17.0,17.0,0.0,450000.0,450000.0
Nick Green,Nick Green,Texas Rangers,RNGRS,1,3,1,4,2016,2016,0,0.0,0.27,0.27,0,52,52,0,206,206,0.0,0.0,0.0,0.0,0.0,0.0
Nick Leach,Nick Leach,Los Angeles Dodgers,DOGRS,1,1,1,2,1999,1999,0,0.0,0.0,0.0,0,0,0,0,0,0,0.0,0.0,0.0,0.0,300000.0,300000.0
Nick Ortiz,Nick Ortiz,Kansas City Royals,ROYALS,1,1,1,2,2000,2001,1,0.0,0.59,0.59,0,47,47,0,118,118,0.0,0.0,0.0,0.0,213000.0,213000.0
Nick Quintana,Nick Quintana,Detroit Tigers,TIGRS,1,1,1,2,2021,2021,0,0.0,0.0,0.0,0,0,0,0,0,0,0.0,0.0,0.0,0.0,4187500.0,4187500.0
Nick Ramirez,Nick Ramirez,Baltimore Orioles,ORLS,1,2,1,3,1988,1988,0,0.0,-0.57,-0.57,0,20,20,0,30,30,0.0,0.0,0.0,0.0,0.0,0.0
Nick Schmidt,Nick Schmidt,San Diego Padres,PADRS,4,6,10,16,2011,2019,8,2.1,6.35,4.25,243,555,312,4,1043,1039,1186.0,426.0,-760.0,9925000.0,7805000.0,-2120000.0
Nick Skuse,Nick Skuse,Anaheim Angels,ANGELS,2,3,4,7,1997,2000,3,17.78,-2.06,-19.84,806,424,-382,3297,1386,-1911,0.0,0.0,0.0,0.0,728000.0,728000.0
Nick Sogard,Nick Sogard,Tampa Bay Devil Rays,RAYS,1,2,3,5,2021,2021,0,0.0,0.11,0.11,0,61,61,0,0,0,0.0,216.0,216.0,0.0,0.0,0.0
Nick Wells,Nick Wells,Toronto Blue Jays,BJAYS,1,3,1,4,2015,2015,0,-1.1,0.06,1.16,24,25,1,0,0,0,43.0,57.0,14.0,0.0,0.0,0.0
Nick Wells,Nick Wells,Seattle Mariners,MARNRS,2,5,5,10,2019,2020,1,1.48,1.08,-0.4,218,73,-145,269,160,-109,200.0,93.0,-107.0,0.0,0.0,0.0
Niko Hulsizer,Niko Hulsizer,Los Angeles Dodgers,DOGRS,2,3,3,6,2019,2021,2,-0.38,0.57,0.95,13,105,92,0,66,66,27.0,92.0,65.0,0.0,560800.0,560800.0
Noah Davis,Noah Davis,Cincinnati Reds,REDS,1,2,1,3,2021,2021,0,0.0,0.31,0.31,0,46,46,0,0,0,0.0,64.0,64.0,0.0,4050000.0,4050000.0
Noah Zavolas,Noah Zavolas,Seattle Mariners,MARNRS,1,2,1,3,2018,2019,1,0.26,0.49,0.23,174,121,-53,483,507,24,0.0,0.0,0.0,0.0,572400.0,572400.0
Noelberth Romero,Noelberth Romero,Boston Red Sox,RSOX,1,2,2,4,2019,2019,0,0.0,-0.16,-0.16,0,27,27,0,0,0,0.0,161.0,161.0,0.0,9500000.0,9500000.0
Nolan Blackwood,Nolan Blackwood,Oakland Athletics,ATLTCS,1,2,1,3,2018,2021,3,0.0,4.25,4.25,0,56,56,0,0,0,0.0,918.0,918.0,0.0,6000000.0,6000000.0
Nolan Sanburn,Nolan Sanburn,Oakland Athletics,ATLTCS,1,1,2,3,2014,2014,0,0.0,-0.03,-0.03,0,25,25,0,76,76,0.0,0.0,0.0,0.0,15000000.0,15000000.0
Noochie Varner,Noochie Varner,Cincinnati Reds,REDS,1,3,3,6,2002,2002,0,0.0,-0.66,-0.66,0,20,20,0,16,16,0.0,130.0,130.0,0.0,2400000.0,2400000.0
Noochie Varner,Noochie Varner,Detroit Tigers,TIGRS,1,2,1,3,2003,2005,2,0.0,0.33,0.33,0,180,180,0,775,775,0.0,0.0,0.0,0.0,340000.0,340000.0
Noochie Varner,Noochie Varner,Milwaukee Brewers,BREWRS,6,12,13,25,2003,2012,9,37.27,23.81,-13.46,2463,1970,-493,9279,4716,-4563,883.0,6330.0,5447.0,8747000.0,19975667.0,11228667.0
Norm Churchill,Norm Churchill,Cleveland Indians,INDINS,1,2,1,3,1977,1982,5,0.0,-0.15,-0.15,0,173,173,0,361,361,0.0,0.0,0.0,0.0,0.0,0.0
Norm Hutchins,Norm Hutchins,Anaheim Angels,ANGELS,1,2,1,3,2000,2000,0,0.0,-0.95,-0.95,0,46,46,0,80,80,0.0,0.0,0.0,0.0,0.0,0.0
Norm Kies,Norm Kies,New York Yankees,YANKS,1,2,1,3,1936,1938,2,0.0,0.31,0.31,0,13,13,0,47,47,0.0,0.0,0.0,0.0,0.0,0.0
Norman Fox,Norman Fox,New York Giants,GIANTS,1,1,1,2,1953,1956,3,0.0,0.0,0.0,0,0,0,0,0,0,0.0,0.0,0.0,0.0,0.0,0.0
Odannys Ayala,Odannys Ayala,Kansas City Royals,ROYALS,1,1,1,2,2003,2003,0,0.0,0.0,0.0,0,0,0,0,0,0,0.0,0.0,0.0,0.0,0.0,0.0
Odis McCowan,Odis McCowan,Milwaukee Brewers,BREWRS,2,3,2,5,1972,1974,2,0.0,0.87,0.87,0,19,19,0,1,1,0.0,76.0,76.0,0.0,0.0,0.0
Oliver Blakeney,Oliver Blakeney,Philadelphia Athletics,ATLTCS,1,4,1,5,1937,1940,3,0.0,6.28,6.28,0,278,278,0,321,321,0.0,1514.0,1514.0,0.0,0.0,0.0
Olivo Astacio,Olivo Astacio,Boston Red Sox,RSOX,1,1,2,3,2005,2005,0,0.0,-0.55,-0.55,0,8,8,0,0,0,0.0,20.0,20.0,0.0,4233333.0,4233333.0
Omar Cruz,Omar Cruz,San Diego Padres,PADRS,1,5,1,6,2021,2021,0,2.1,3.49,1.39,119,68,-51,1,57,56,182.0,544.0,362.0,0.0,0.0,0.0
Omar Ortiz,Omar Ortiz,San Diego Padres,PADRS,5,11,8,19,2001,2007,6,6.69,14.89,8.2,976,910,-66,3576,3007,-569,532.0,273.0,-259.0,12000000.0,8812500.0,-3187500.0
Omar Poveda,Omar Poveda,Texas Rangers,RNGRS,1,2,1,3,2010,2010,0,0.0,-0.56,-0.56,0,30,30,0,105,105,0.0,0.0,0.0,0.0,6000000.0,6000000.0
Orlando Lind,Orlando Lind,Pittsburgh Pirates,PIRATS,2,3,2,5,1990,1994,4,1.68,0.42,-1.26,132,312,180,338,714,376,0.0,0.0,0.0,0.0,210000.0,210000.0
Orlando Rodriguez,Orlando Rodriguez,Chicago White Sox,WSOX,3,9,5,14,2001,2003,2,-3.34,5.16,8.5,321,102,-219,107,7,-100,601.0,942.0,341.0,0.0,0.0,0.0
Oscar Brito,Oscar Brito,Cincinnati Reds,REDS,1,2,1,3,1982,1982,0,2.67,1.5,-1.17,410,82,-328,39,48,9,858.0,458.0,-400.0,0.0,0.0,0.0
Oscar Brito,Oscar Brito,St. Louis Cardinals,CARDS,1,1,1,2,1984,1987,3,0.0,1.04,1.04,0,316,316,0,655,655,0.0,0.0,0.0,0.0,0.0,0.0
Osleivis Basabe,Osleivis Basabe,Texas Rangers,RNGRS,1,3,3,6,2020,2021,1,0.0,0.0,0.0,0,0,0,0,0,0,0.0,0.0,0.0,0.0,0.0,0.0
Osman Gutierrez,Osman Gutierrez,Toronto Blue Jays,BJAYS,1,1,2,3,2017,2017,0,0.0,0.48,0.48,0,15,15,0,0,0,0.0,51.0,51.0,0.0,5750000.0,5750000.0
Osmy Gregorio,Osmy Gregorio,Seattle Mariners,MARNRS,1,3,2,5,2017,2019,2,0.0,0.36,0.36,0,30,30,0,38,38,0.0,44.0,44.0,0.0,0.0,0.0
Ottis Smith,Ottis Smith,New York Mets,METS,2,4,3,7,1994,1998,4,2.23,3.48,1.25,191,688,497,349,2703,2354,468.0,0.0,-468.0,4160000.0,5150000.0,990000.0
Owen Caissie,Owen Caissie,San Diego Padres,PADRS,1,5,2,7,2020,2020,0,-0.94,0.0,0.94,63,0,-63,44,0,-44,444.0,0.0,-444.0,5250000.0,22000000.0,16750000.0
P.J. Bevis,P.J. Bevis,Arizona Diamondbacks,DBACKS,1,1,1,2,2002,2003,1,0.0,0.02,0.02,0,15,15,0,28,28,0.0,0.0,0.0,0.0,0.0,0.0
P.J. Campbell,P.J. Campbell,Baltimore Orioles,ORLS,1,1,1,2,1969,1970,1,0.0,0.67,0.67,0,6,6,0,2,2,0.0,18.0,18.0,0.0,0.0,0.0
P.J. Dean,P.J. Dean,Washington Nationals,NATEX,3,5,5,10,2008,2013,5,5.63,4.16,-1.47,562,556,-6,2188,1050,-1138,12.0,770.0,758.0,5101000.0,810000.0,-4291000.0
Pablo Delgado,Pablo Delgado,Texas Rangers,RNGRS,2,7,4,11,1988,1994,6,0.27,27.89,27.62,791,1284,493,491,4575,4084,1767.0,710.0,-1057.0,532500.0,300500.0,-232000.0
Pablo Minaya,Pablo Minaya,Florida Marlins,MARLNS,2,2,2,4,1999,1999,0,-0.5,0.0,0.5,16,0,-16,22,0,-22,0.0,0.0,0.0,0.0,0.0,0.0
Parker Frazier,Parker Frazier,Colorado Rockies,ROCKS,1,1,1,2,2013,2013,0,0.0,0.0,0.0,0,0,0,0,0,0,0.0,0.0,0.0,0.0,0.0,0.0
Pat Adams,Pat Adams,Chicago White Sox,WSOX,1,2,1,3,1984,1985,1,0.0,-0.28,-0.28,0,12,12,0,16,16,0.0,0.0,0.0,0.0,0.0,0.0
Pat Austin,Pat Austin,Detroit Tigers,TIGRS,1,3,2,5,1989,1990,1,0.0,-0.12,-0.12,0,13,13,0,34,34,0.0,5.0,5.0,0.0,0.0,0.0
Pat Collins,Pat Collins,Montreal Expos,NATEX,1,1,1,2,2003,2003,0,0.0,0.0,0.0,0,0,0,0,0,0,0.0,0.0,0.0,0.0,0.0,0.0
Pat Crosby,Pat Crosby,Minnesota Twins,TWINS,5,6,7,13,1986,1989,3,8.22,-2.13,-10.35,574,122,-452,1466,209,-1257,305.0,169.0,-136.0,0.0,0.0,0.0
Pat Flury,Pat Flury,Boston Red Sox,RSOX,2,2,2,4,1999,1999,0,-0.02,-0.13,-0.11,48,10,-38,92,14,-78,0.0,0.0,0.0,0.0,284000.0,284000.0
Pat Gorman,Pat Gorman,New York Mets,METS,1,4,1,5,2000,2000,0,28.33,0.16,-28.17,1330,56,-1274,5573,211,-5362,33.0,0.0,-33.0,210000.0,3000000.0,2790000.0
Pat Lynch,Pat Lynch,Toronto Blue Jays,BJAYS,1,1,1,2,1999,1999,0,0.0,-0.31,-0.31,0,31,31,0,101,101,0.0,0.0,0.0,0.0,0.0,0.0
Pat Skrable,Pat Skrable,Philadelphia Phillies,PHILS,13,29,22,51,1971,1999,28,39.49,60.21,20.72,5043,5092,49,14497,10525,-3972,7936.0,6058.0,-1878.0,2950000.0,1495000.0,-1455000.0
Pat Skrable,Pat Skrable,Milwaukee Brewers,BREWRS,9,23,22,45,1971,1984,13,35.91,84.88,48.97,2475,4171,1696,6161,14852,8691,10247.0,5331.0,-4916.0,466901.0,45000.0,-421901.0
Patrick Dorrian,Patrick Dorrian,Pittsburgh Pirates,PIRATS,1,1,1,2,2019,2019,0,0.0,-0.36,-0.36,0,18,18,0,2,2,0.0,42.0,42.0,0.0,0.0,0.0
Patrick Leonard,Patrick Leonard,Kansas City Royals,ROYALS,3,6,5,11,2012,2021,9,12.05,17.51,5.46,480,779,299,994,1767,773,2270.0,2321.0,51.0,16050000.0,12652767.0,-3397233.0
Paul Bargas,Paul Bargas,Colorado Rockies,ROCKS,1,1,1,2,2010,2011,1,0.0,-0.17,-0.17,0,22,22,0,71,71,0.0,0.0,0.0,0.0,412500.0,412500.0
Paul Click,Paul Click,Milwaukee Brewers,BREWRS,1,3,1,4,1970,1971,1,0.0,0.0,0.0,0,0,0,0,0,0,0.0,0.0,0.0,0.0,0.0,0.0
Paul Hollins,Paul Hollins,New York Mets,METS,1,1,1,2,1985,1985,0,0.0,0.0,0.0,0,0,0,0,0,0,0.0,0.0,0.0,0.0,0.0,0.0
Paul O'Neill,Paul O'Neill,San Diego Padres,PADRS,1,1,1,2,1979,1982,3,0.0,-0.76,-0.76,0,42,42,0,3,3,0.0,79.0,79.0,0.0,0.0,0.0
Paul Perry,Paul Perry,Cleveland Indians,INDINS,1,2,1,3,1984,1984,0,0.0,0.34,0.34,0,25,25,0,0,0,0.0,151.0,151.0,0.0,0.0,0.0
Paul Richan,Paul Richan,Chicago Cubs,CUBS,1,2,2,4,2019,2019,0,0.3,1.75,1.45,39,51,12,0,225,225,107.0,0.0,-107.0,0.0,9950000.0,9950000.0
Paul Semall,Paul Semall,New York Yankees,YANKS,1,1,1,2,1979,1983,4,0.0,0.28,0.28,0,298,298,0,948,948,0.0,0.0,0.0,0.0,320000.0,320000.0
Paul Semall,Paul Semall,Chicago Cubs,CUBS,1,3,1,4,1982,1982,0,-0.09,0.93,1.02,40,128,88,0,477,477,152.0,0.0,-152.0,0.0,0.0,0.0
Paul Torres,Paul Torres,Chicago Cubs,CUBS,1,3,2,5,1995,1995,0,0.22,-1.32,-1.54,70,79,9,79,325,246,629.0,0.0,-629.0,0.0,3700000.0,3700000.0
Paul Voigt,Paul Voigt,Minnesota Twins,TWINS,1,2,2,4,1982,1984,2,0.0,5.34,5.34,0,201,201,0,513,513,0.0,1207.0,1207.0,0.0,0.0,0.0
Paul Weichard,Paul Weichard,Arizona Diamondbacks,DBACKS,2,3,2,5,1999,2003,4,-0.64,1.43,2.07,53,629,576,82,2744,2662,55.0,0.0,-55.0,6000000.0,0.0,-6000000.0
Paul Williams,Paul Williams,Boston Red Sox,RSOX,1,3,1,4,1990,1991,1,0.0,0.54,0.54,0,52,52,0,179,179,0.0,0.0,0.0,0.0,1100000.0,1100000.0
Paxton Schultz,Paxton Schultz,Milwaukee Brewers,BREWRS,1,2,1,3,2021,2021,0,0.0,0.02,0.02,0,4,4,0,8,8,0.0,0.0,0.0,0.0,0.0,0.0
Pedro DeLeon,Pedro DeLeon,Houston Astros,ASTROS,1,3,1,4,1989,1989,0,0.0,-0.25,-0.25,0,40,40,0,31,31,0.0,290.0,290.0,0.0,0.0,0.0
Pedro Gonzalez,Pedro Gonzalez,Colorado Rockies,ROCKS,1,1,1,2,2017,2017,0,0.0,0.82,0.82,0,46,46,0,175,175,0.0,0.0,0.0,0.0,5250000.0,5250000.0
Pedro Martinez,Pedro Martinez,Chicago Cubs,CUBS,1,2,1,3,2020,2020,0,0.0,-0.6,-0.6,0,10,10,0,22,22,0.0,0.0,0.0,0.0,0.0,0.0
Pedro Pena,Pedro Pena,Oakland Athletics,ATLTCS,1,2,1,3,1990,1991,1,4.57,0.41,-4.16,496,108,-388,2054,321,-1733,0.0,0.0,0.0,100000.0,675000.0,575000.0
Pedro Perez,Pedro Perez,Boston Red Sox,RSOX,1,1,1,2,2011,2011,0,0.0,0.0,0.0,0,0,0,0,0,0,0.0,0.0,0.0,0.0,0.0,0.0
Pedro Quintana,Pedro Quintana,New York Mets,METS,2,2,2,4,2021,2021,0,-0.22,0.31,0.53,37,39,2,98,102,4,0.0,0.0,0.0,0.0,0.0,0.0
Pedro Vasquez,Pedro Vasquez,Seattle Mariners,MARNRS,1,2,1,3,2016,2016,0,0.0,-0.38,-0.38,0,18,18,0,0,0,0.0,59.0,59.0,0.0,532500.0,532500.0
Pep Ripperton,Pep Ripperton,Boston Braves,BRAVES,1,2,1,3,1921,1924,3,0.0,-0.51,-0.51,0,229,229,0,841,841,0.0,0.0,0.0,0.0,0.0,0.0
Pepe McNeal,Pepe McNeal,Cleveland Indians,INDINS,1,3,1,4,1995,1995,0,-1.28,1.44,2.72,177,12,-165,474,0,-474,13.0,224.0,211.0,0.0,4525000.0,4525000.0
Pete Blohm,Pete Blohm,Baltimore Orioles,ORLS,1,1,1,2,1988,1992,4,0.0,11.1,11.1,0,511,511,0,2048,2048,0.0,0.0,0.0,0.0,62500.0,62500.0
Pete Carey,Pete Carey,Kansas City Royals,ROYALS,1,2,1,3,1987,1987,0,0.0,0.0,0.0,0,0,0,0,0,0,0.0,0.0,0.0,0.0,0.0,0.0
Pete Crow-Armstrong,Pete Crow-Armstrong,New York Mets,METS,1,1,3,4,2021,2021,0,0.0,2.33,2.33,0,66,66,0,194,194,0.0,97.0,97.0,0.0,14100000.0,14100000.0
Pete Kendrick,Pete Kendrick,Oakland Athletics,ATLTCS,1,4,1,5,1986,1987,1,2.24,1.63,-0.61,195,21,-174,688,0,-688,0.0,339.0,339.0,0.0,0.0,0.0
Pete Maestrales,Pete Maestrales,Baltimore Orioles,ORLS,1,1,2,3,2005,2005,0,0.0,0.23,0.23,0,22,22,0,56,56,0.0,0.0,0.0,0.0,3200000.0,3200000.0
Pete Mesa,Pete Mesa,Cleveland Indians,INDINS,2,3,3,6,1958,1958,0,0.0,0.0,0.0,54,0,-54,37,0,-37,56.0,0.0,-56.0,0.0,0.0,0.0
Pete Rice,Pete Rice,Pittsburgh Pirates,PIRATS,1,2,1,3,1987,1987,0,0.26,-0.14,-0.4,5,36,31,0,73,73,30.0,0.0,-30.0,0.0,425000.0,425000.0
Pete Tucci,Pete Tucci,Toronto Blue Jays,BJAYS,1,3,1,4,1998,2001,3,7.56,0.33,-7.23,451,52,-399,328,5,-323,2800.0,760.0,-2040.0,1787500.0,3250000.0,1462500.0
Peter Bayer,Peter Bayer,Tampa Bay Devil Rays,RAYS,2,2,2,4,2018,2019,1,0.31,0.96,0.65,29,21,-8,4,0,-4,93.0,123.0,30.0,560400.0,0.0,-560400.0
Peter Kuld,Peter Kuld,Cleveland Indians,INDINS,1,1,1,2,1989,1989,0,0.0,0.0,0.0,0,0,0,0,0,0,0.0,0.0,0.0,0.0,0.0,0.0
Peyton Battenfield,Peyton Battenfield,Houston Astros,ASTROS,2,4,2,6,2020,2021,1,1.08,-0.38,-1.46,66,28,-38,219,0,-219,14.0,72.0,58.0,0.0,1900000.0,1900000.0
Peyton Battenfield,Peyton Battenfield,Tampa Bay Devil Rays,RAYS,1,1,2,3,2021,2021,0,0.0,0.29,0.29,0,29,29,0,72,72,0.0,11.0,11.0,0.0,0.0,0.0
Phil Geisler,Phil Geisler,Philadelphia Phillies,PHILS,1,1,1,2,1995,1995,0,0.0,0.0,0.0,0,0,0,0,0,0,0.0,0.0,0.0,0.0,109000.0,109000.0
Phil Lansford,Phil Lansford,Cleveland Indians,INDINS,6,12,11,23,1978,2004,26,33.86,55.28,21.42,2512,2636,124,9309,9198,-111,2682.0,4270.0,1588.0,1767500.0,1412500.0,-355000.0
Phil Pfeifer,Phil Pfeifer,Los Angeles Dodgers,DOGRS,1,2,4,6,2016,2016,0,0.0,-0.57,-0.57,0,26,26,0,16,16,0.0,128.0,128.0,0.0,0.0,0.0
Philip Knuckles,Philip Knuckles,St. Louis Cardinals,CARDS,3,8,6,14,1968,1972,4,11.85,2.24,-9.61,1182,243,-939,1248,521,-727,1854.0,299.0,-1555.0,17500.0,24000.0,6500.0
Philip Mategrano,Philip Mategrano,New York Yankees,YANKS,1,4,1,5,1947,1947,0,0.0,0.0,0.0,0,0,0,0,0,0,0.0,0.0,0.0,0.0,0.0,0.0
Pierre-Luc Marceau,Pierre-Luc Marceau,Montreal Expos,NATEX,1,1,1,2,2004,2004,0,0.0,0.0,0.0,0,0,0,0,0,0,0.0,0.0,0.0,0.0,0.0,0.0
Prelander Berroa,Prelander Berroa,Minnesota Twins,TWINS,1,3,1,4,2019,2019,0,-0.71,-0.29,0.42,26,15,-11,68,0,-68,0.0,34.0,34.0,0.0,5000000.0,5000000.0
Quency Hill,Quency Hill,Philadelphia Phillies,PHILS,8,19,14,33,1977,1999,22,25.71,38.98,13.27,2933,3822,889,10288,10555,267,522.0,1259.0,737.0,2950000.0,165000.0,-2785000.0
Quincy Latimore,Quincy Latimore,Pittsburgh Pirates,PIRATS,1,1,1,2,2013,2014,1,0.0,0.72,0.72,0,150,150,0,15,15,0.0,428.0,428.0,0.0,0.0,0.0
R.D. Spiehs,R.D. Spiehs,San Diego Padres,PADRS,1,2,1,3,2005,2005,0,0.0,0.14,0.14,0,9,9,0,15,15,0.0,0.0,0.0,0.0,316000.0,316000.0
Rafael Rincones,Rafael Rincones,Boston Red Sox,RSOX,1,1,1,2,2017,2017,0,0.0,-0.05,-0.05,0,17,17,0,38,38,0.0,0.0,0.0,0.0,6000000.0,6000000.0
Raider Uceta,Raider Uceta,Anaheim Angels,ANGELS,1,2,1,3,2019,2019,0,0.0,-0.77,-0.77,0,20,20,0,49,49,0.0,0.0,0.0,0.0,590100.0,590100.0
Rainier Rivas,Rainier Rivas,Anaheim Angels,ANGELS,1,2,1,3,2019,2019,0,0.0,-0.77,-0.77,0,20,20,0,49,49,0.0,0.0,0.0,0.0,590100.0,590100.0
Ramon Alvarado,Ramon Alvarado,Oakland Athletics,ATLTCS,1,1,1,2,2006,2007,1,0.0,0.0,0.0,0,0,0,0,0,0,0.0,0.0,0.0,0.0,0.0,0.0
Ramon Cedeno,Ramon Cedeno,Houston Astros,ASTROS,1,2,1,3,1989,1990,1,0.0,0.35,0.35,0,23,23,0,43,43,0.0,0.0,0.0,0.0,0.0,0.0
Ramon Espinosa,Ramon Espinosa,Pittsburgh Pirates,PIRATS,1,2,2,4,1997,1997,0,0.0,0.0,0.0,0,0,0,0,0,0,0.0,0.0,0.0,0.0,0.0,0.0
Randall Schafer,Randall Schafer,Montreal Expos,NATEX,3,4,4,8,1979,1986,7,1.65,1.23,-0.42,131,365,234,465,736,271,0.0,0.0,0.0,0.0,0.0,0.0
Randey Dorame,Randey Dorame,Los Angeles Dodgers,DOGRS,1,3,2,5,2000,2002,2,3.81,0.2,-3.61,184,161,-23,631,541,-90,0.0,0.0,0.0,1450000.0,3416667.0,1966667.0
Randy Brown,Randy Brown,Boston Red Sox,RSOX,2,4,3,7,1997,2004,7,10.08,53.51,43.43,478,211,-267,533,21,-512,3819.0,4151.0,332.0,2100000.0,3615000.0,1515000.0
Randy Curtis,Randy Curtis,New York Mets,METS,1,2,3,5,1993,1994,1,-0.15,-0.19,-0.04,32,20,-12,0,3,3,46.0,51.0,5.0,0.0,150000.0,150000.0
Randy Fierbaugh,Randy Fierbaugh,San Diego Padres,PADRS,1,1,1,2,1979,1979,0,0.0,0.0,0.0,0,0,0,0,0,0,0.0,0.0,0.0,0.0,0.0,0.0
Randy Hammon,Randy Hammon,Kansas City Royals,ROYALS,1,1,1,2,1976,1976,0,0.0,-0.04,-0.04,0,4,4,0,0,0,0.0,13.0,13.0,0.0,0.0,0.0
Randy Henry,Randy Henry,Baltimore Orioles,ORLS,1,2,1,3,2011,2013,2,0.0,-0.52,-0.52,0,45,45,0,126,126,0.0,0.0,0.0,0.0,0.0,0.0
Randy Marshall,Randy Marshall,Detroit Tigers,TIGRS,1,2,2,4,1992,1992,0,-0.71,-1.21,-0.5,102,101,-1,8,364,356,212.0,0.0,-212.0,0.0,0.0,0.0
Randy Newsom,Randy Newsom,Boston Red Sox,RSOX,4,8,6,14,2006,2011,5,8.94,7.24,-1.7,858,505,-353,2103,1474,-629,420.0,365.0,-55.0,6238333.0,397000.0,-5841333.0
Randy Randle,Randy Randle,Houston Astros,ASTROS,1,1,1,2,1987,1987,0,0.0,0.0,0.0,0,0,0,0,0,0,0.0,0.0,0.0,0.0,150000.0,150000.0
Randy Rogers,Randy Rogers,Los Angeles Dodgers,DOGRS,1,2,1,3,1977,1978,1,0.0,-0.13,-0.13,0,59,59,0,113,113,0.0,0.0,0.0,0.0,0.0,0.0
Randy Rogers,Randy Rogers,New York Mets,METS,1,2,1,3,1981,1983,2,0.0,0.72,0.72,0,17,17,0,53,53,0.0,0.0,0.0,0.0,0.0,0.0
Randy Sealy,Randy Sealy,Pittsburgh Pirates,PIRATS,1,1,1,2,1977,1978,1,0.0,0.3,0.3,0,10,10,0,19,19,0.0,0.0,0.0,0.0,0.0,0.0
Randy Vickers,Randy Vickers,Seattle Mariners,MARNRS,1,1,1,2,1996,1996,0,0.0,0.05,0.05,0,11,11,0,0,0,0.0,76.0,76.0,0.0,198000.0,198000.0
Rashad Crawford,Rashad Crawford,Chicago Cubs,CUBS,1,4,1,5,2016,2016,0,9.71,1.2,-8.51,545,54,-491,1768,0,-1768,353.0,80.0,-273.0,0.0,0.0,0.0
Rashad Eldridge,Rashad Eldridge,Cleveland Indians,INDINS,1,1,1,2,2002,2003,1,0.0,-0.08,-0.08,0,96,96,0,308,308,0.0,0.0,0.0,0.0,0.0,0.0
Raul Mondesi,Raul Mondesi,Milwaukee Brewers,BREWRS,2,2,2,4,2012,2013,1,1.52,-0.36,-1.88,76,124,48,0,1,1,212.0,187.0,-25.0,1550000.0,1075000.0,-475000.0
Ray Brown,Ray Brown,Cincinnati Reds,REDS,1,1,1,2,1997,1997,0,0.0,-0.06,-0.06,0,2,2,0,1,1,0.0,4.0,4.0,0.0,0.0,0.0
Ray Castro,Ray Castro,Texas Rangers,RNGRS,1,2,2,4,2019,2019,0,0.0,0.0,0.0,0,0,0,0,0,0,0.0,0.0,0.0,0.0,4650000.0,4650000.0
Ray Ricken,Ray Ricken,New York Yankees,YANKS,1,2,2,4,1998,1999,1,0.0,0.16,0.16,0,3,3,0,0,0,0.0,27.0,27.0,0.0,0.0,0.0
Ray Roche,Ray Roche,Brooklyn Dodgers,DOGRS,2,9,3,12,1941,1947,6,3.3,-0.19,-3.49,337,37,-300,419,81,-338,1285.0,0.0,-1285.0,17500.0,0.0,-17500.0
Ray Velasquez,Ray Velasquez,Minnesota Twins,TWINS,2,4,3,7,1987,1991,4,0.91,5.69,4.78,306,646,340,81,2698,2617,1068.0,6.0,-1062.0,0.0,0.0,0.0
Rayder Ascanio,Rayder Ascanio,Seattle Mariners,MARNRS,2,3,3,6,2017,2019,2,-0.62,4.73,5.35,20,61,41,22,6,-16,180.0,1064.0,884.0,16000000.0,0.0,-16000000.0
Raymel Flores,Raymel Flores,Boston Red Sox,RSOX,3,6,4,10,2014,2019,5,1.08,2.41,1.33,219,69,-150,105,2,-103,1466.0,676.0,-790.0,3666000.0,523500.0,-3142500.0
Raymond Borucki,Raymond Borucki,Philadelphia Phillies,PHILS,1,1,1,2,1983,1984,1,0.0,0.0,0.0,0,0,0,0,0,0,0.0,0.0,0.0,0.0,0.0,0.0
Raymond Cordeiro,Raymond Cordeiro,Houston Astros,ASTROS,5,9,10,19,1965,1973,8,-0.32,0.69,1.01,384,965,581,306,1025,719,923.0,2019.0,1096.0,57500.0,88500.0,31000.0
Raywilly Gomez,Raywilly Gomez,Arizona Diamondbacks,DBACKS,1,1,1,2,2014,2014,0,0.0,0.0,0.0,0,0,0,0,0,0,0.0,0.0,0.0,0.0,0.0,0.0
Reese Olson,Reese Olson,Milwaukee Brewers,BREWRS,1,1,1,2,2021,2021,0,0.0,-0.35,-0.35,0,34,34,0,2,2,0.0,61.0,61.0,0.0,3475000.0,3475000.0
Reggie Abercrombie,Reggie Abercrombie,Los Angeles Dodgers,DOGRS,1,3,2,5,2004,2004,0,-0.45,1.02,1.47,67,105,38,129,363,234,19.0,0.0,-19.0,0.0,7800000.0,7800000.0
Reggie Dobie,Reggie Dobie,New York Mets,METS,2,2,2,4,1988,1991,3,0.08,-0.3,-0.38,22,16,-6,76,13,-63,0.0,0.0,0.0,0.0,0.0,0.0
Reggie Leslie,Reggie Leslie,Cincinnati Reds,REDS,1,2,1,3,1992,1992,0,0.0,0.0,0.0,0,0,0,0,0,0,0.0,0.0,0.0,0.0,0.0,0.0
Reginald Preciado,Reginald Preciado,San Diego Padres,PADRS,1,5,2,7,2020,2020,0,-0.94,0.0,0.94,63,0,-63,44,0,-44,444.0,0.0,-444.0,5250000.0,22000000.0,16750000.0
Reid Redman,Reid Redman,Miami Marlins,MARLNS,1,2,1,3,2014,2015,1,1.69,0.0,-1.69,103,0,-103,1,0,-1,488.0,0.0,-488.0,0.0,1475000.0,1475000.0
Rene Miniel,Rene Miniel,Boston Red Sox,RSOX,1,1,1,2,2003,2003,0,0.0,0.05,0.05,0,15,15,0,34,34,0.0,0.0,0.0,0.0,560000.0,560000.0
Rhys Taylor,Rhys Taylor,Boston Red Sox,RSOX,1,2,1,3,2005,2005,0,0.0,0.05,0.05,0,1,1,0,0,0,0.0,3.0,3.0,0.0,0.0,0.0
Ricardo Andres,Ricardo Andres,Chicago White Sox,WSOX,1,2,2,4,2011,2013,2,0.0,0.17,0.17,0,2,2,0,0,0,0.0,8.0,8.0,0.0,0.0,0.0
Ricardo Aramboles,Ricardo Aramboles,New York Yankees,YANKS,1,1,1,2,2001,2001,0,0.0,0.22,0.22,0,36,36,0,0,0,0.0,107.0,107.0,0.0,500000.0,500000.0
Ricardo Cespedes,Ricardo Cespedes,New York Mets,METS,1,2,1,3,2017,2018,1,-0.15,-0.36,-0.21,15,96,81,4,0,-4,66.0,116.0,50.0,0.0,6550000.0,6550000.0
Ricardo Rodriguez,Ricardo Rodriguez,Atlanta Braves,BRAVES,1,1,1,2,2005,2010,5,0.0,5.78,5.78,0,511,511,0,1516,1516,0.0,0.0,0.0,0.0,0.0,0.0
Ricardo Rodríguez,Ricardo Rodríguez,San Diego Padres,PADRS,1,2,1,3,2015,2017,2,-0.36,-0.48,-0.12,20,87,67,3,211,208,65.0,16.0,-49.0,0.0,507500.0,507500.0
Rich Buonantony,Rich Buonantony,Chicago Cubs,CUBS,1,2,1,3,1983,1986,3,0.0,0.85,0.85,0,131,131,0,294,294,0.0,0.0,0.0,0.0,0.0,0.0
Rich Buonantony,Rich Buonantony,Milwaukee Brewers,BREWRS,1,3,2,5,1984,1987,3,0.0,0.59,0.59,0,124,124,0,432,432,0.0,0.0,0.0,0.0,0.0,0.0
Rich Caldwell,Rich Caldwell,Baltimore Orioles,ORLS,1,2,1,3,1985,1987,2,0.74,-0.72,-1.46,44,232,188,6,947,941,120.0,0.0,-120.0,0.0,512500.0,512500.0
Rich Gomez,Rich Gomez,Detroit Tigers,TIGRS,1,2,2,4,2002,2002,0,-0.46,0.97,1.43,15,108,93,42,363,321,0.0,0.0,0.0,0.0,0.0,0.0
Rich Pratt,Rich Pratt,Chicago White Sox,WSOX,2,2,2,4,1999,2005,6,1.84,9.77,7.93,136,733,597,502,2466,1964,0.0,0.0,0.0,0.0,0.0,0.0
Rich Scalamandre,Rich Scalamandre,St. Louis Cardinals,CARDS,1,1,1,2,2006,2006,0,0.0,-0.17,-0.17,0,38,38,0,4,4,0.0,92.0,92.0,0.0,2200000.0,2200000.0
Richard Duffy,Richard Duffy,Chicago White Sox,WSOX,3,10,4,14,1951,1953,2,2.36,0.32,-2.04,404,226,-178,236,372,136,2232.0,741.0,-1491.0,0.0,0.0,0.0
Richard Guasch,Richard Guasch,Oakland Athletics,ATLTCS,1,3,3,6,2021,2021,0,0.0,-0.1,-0.1,0,88,88,0,339,339,0.0,0.0,0.0,0.0,7000000.0,7000000.0
Richard Ingalls,Richard Ingalls,Oakland Athletics,ATLTCS,1,1,1,2,1975,1978,3,0.0,0.02,0.02,0,3,3,0,3,3,0.0,0.0,0.0,0.0,0.0,0.0
Richard Lewis,Richard Lewis,Atlanta Braves,BRAVES,2,5,3,8,2004,2013,9,-3.3,26.82,30.12,86,573,487,55,584,529,235.0,4935.0,4700.0,370000.0,5000000.0,4630000.0
Richard Mitchell,Richard Mitchell,Pittsburgh Pirates,PIRATS,1,1,1,2,2015,2020,5,0.0,4.86,4.86,0,194,194,0,145,145,0.0,1604.0,1604.0,0.0,0.0,0.0
Richard Negrette,Richard Negrette,Cleveland Indians,INDINS,1,1,1,2,1999,1999,0,0.0,-0.08,-0.08,0,13,13,0,30,30,0.0,0.0,0.0,0.0,715000.0,715000.0
Richard Negrette,Richard Negrette,Chicago Cubs,CUBS,1,1,1,2,1999,2003,4,0.0,-0.39,-0.39,0,148,148,0,359,359,0.0,0.0,0.0,0.0,0.0,0.0
Richard Roberts,Richard Roberts,Detroit Tigers,TIGRS,2,4,3,7,1999,2002,3,-0.56,-0.4,0.16,98,120,22,61,10,-51,565.0,1738.0,1173.0,5300000.0,13083334.0,7783334.0
Richard Rodriguez,Richard Rodriguez,San Francisco Giants,GIANTS,1,1,1,2,2016,2017,1,0.0,-0.23,-0.23,0,3,3,0,6,6,0.0,0.0,0.0,0.0,1250000.0,1250000.0
Richard Sander,Richard Sander,New York Mets,METS,2,4,2,6,1977,1979,2,0.2,5.03,4.83,10,268,258,0,1093,1093,24.0,0.0,-24.0,0.0,0.0,0.0
Richard Stonum,Richard Stonum,Milwaukee Brewers,BREWRS,2,2,2,4,1972,1974,2,0.14,-0.57,-0.71,44,137,93,0,10,10,74.0,421.0,347.0,0.0,0.0,0.0
Richard Wieters,Richard Wieters,Atlanta Braves,BRAVES,1,1,1,2,1979,1981,2,0.0,-0.03,-0.03,0,73,73,0,181,181,0.0,0.0,0.0,0.0,0.0,0.0
Richard Wilson,Richard Wilson,Atlanta Braves,BRAVES,1,1,1,2,1971,1971,0,0.0,0.0,0.0,0,0,0,0,0,0,0.0,0.0,0.0,0.0,0.0,0.0
Richard Yencha,Richard Yencha,Baltimore Orioles,ORLS,1,2,1,3,1963,1965,2,0.0,0.5,0.5,0,146,146,0,23,23,0.0,370.0,370.0,0.0,0.0,0.0
Richie Robnett,Richie Robnett,Oakland Athletics,ATLTCS,1,2,1,3,2009,2011,2,0.0,1.6,1.6,0,173,173,0,0,0,0.0,456.0,456.0,0.0,0.0,0.0
Rick Asadoorian,Rick Asadoorian,Boston Red Sox,RSOX,1,3,1,4,2001,2002,1,0.0,-0.56,-0.56,0,12,12,0,0,0,0.0,66.0,66.0,0.0,5333333.0,5333333.0
Rick Asadoorian,Rick Asadoorian,St. Louis Cardinals,CARDS,1,1,1,2,2003,2003,0,0.0,-0.49,-0.49,0,74,74,0,1,1,0.0,130.0,130.0,0.0,1500000.0,1500000.0
Rick Balabon,Rick Balabon,New York Yankees,YANKS,2,4,2,6,1988,1989,1,22.92,1.01,-21.91,1483,131,-1352,5913,342,-5571,0.0,0.0,0.0,722000.0,670000.0,-52000.0
Rick Browne,Rick Browne,Cleveland Indians,INDINS,14,25,32,57,1984,2001,17,110.22,66.9,-43.32,6314,5064,-1250,18977,18204,-773,7708.0,2374.0,-5334.0,19613332.0,19125000.0,-488332.0
Rick Carriger,Rick Carriger,Baltimore Orioles,ORLS,2,4,3,7,1988,1990,2,0.11,0.05,-0.06,10,54,44,0,0,0,21.0,802.0,781.0,335000.0,0.0,-335000.0
Rick Carriger,Rick Carriger,Montreal Expos,NATEX,3,4,4,8,1989,1996,7,-0.47,1.55,2.02,26,567,541,0,268,268,304.0,805.0,501.0,625000.0,705000.0,80000.0
Rick Clelland,Rick Clelland,Montreal Expos,NATEX,1,1,1,2,1995,1997,2,0.0,-1.33,-1.33,0,193,193,0,16,16,0.0,353.0,353.0,0.0,156000.0,156000.0
Rick Lockwood,Rick Lockwood,Baltimore Orioles,ORLS,1,1,1,2,1986,1986,0,0.0,0.0,0.0,0,0,0,0,0,0,0.0,0.0,0.0,0.0,0.0,0.0
Rick O'Keeffe,Rick O'Keeffe,Milwaukee Brewers,BREWRS,1,2,1,3,1977,1985,8,0.0,17.3,17.3,0,239,239,0,0,0,0.0,4814.0,4814.0,0.0,0.0,0.0
Rick Rembielak,Rick Rembielak,Chicago Cubs,CUBS,1,2,1,3,1986,1987,1,0.0,-0.31,-0.31,0,8,8,0,15,15,0.0,0.0,0.0,0.0,0.0,0.0
Rickey Holifield,Rickey Holifield,Philadelphia Phillies,PHILS,2,4,4,8,1996,1999,3,1.93,-0.39,-2.32,220,301,81,209,170,-39,390.0,444.0,54.0,225000.0,0.0,-225000.0
Ricky Burdette,Ricky Burdette,New York Yankees,YANKS,1,3,1,4,1979,1981,2,0.0,1.82,1.82,0,95,95,0,304,304,0.0,0.0,0.0,0.0,0.0,0.0
Ricky DeVito,Ricky DeVito,Atlanta Braves,BRAVES,1,2,1,3,2021,2021,0,0.25,0.61,0.36,15,53,38,12,0,-12,121.0,78.0,-43.0,0.0,1700000.0,1700000.0
Ricky Jones,Ricky Jones,Baltimore Orioles,ORLS,1,1,1,2,1987,1987,0,0.0,0.0,0.0,0,0,0,0,0,0,0.0,0.0,0.0,0.0,0.0,0.0
Ricky Rojas,Ricky Rojas,Kansas City Royals,ROYALS,1,1,1,2,1987,1987,0,0.0,0.06,0.06,0,39,39,0,124,124,0.0,0.0,0.0,0.0,0.0,0.0
Rob Blumberg,Rob Blumberg,Toronto Blue Jays,BJAYS,1,1,1,2,1991,1991,0,0.0,0.1,0.1,0,71,71,0,141,141,0.0,0.0,0.0,0.0,0.0,0.0
Rob Bryson,Rob Bryson,Milwaukee Brewers,BREWRS,1,4,1,5,2008,2008,0,22.37,5.2,-17.17,1354,34,-1320,5551,50,-5501,190.0,392.0,202.0,0.0,11000000.0,11000000.0
Rob Dewolf,Rob Dewolf,Milwaukee Brewers,BREWRS,1,1,1,2,1986,1988,2,0.0,0.06,0.06,0,4,4,0,7,7,0.0,0.0,0.0,0.0,0.0,0.0
Rob Henkel,Rob Henkel,Florida Marlins,MARLNS,12,23,29,52,2003,2019,16,83.08,57.28,-25.8,2779,2940,161,6322,8392,2070,15065.0,6008.0,-9057.0,40718667.0,23598092.0,-17120575.0
Rob Katzaroff,Rob Katzaroff,Montreal Expos,NATEX,1,1,1,2,1992,1992,0,0.0,-0.78,-0.78,0,14,14,0,0,0,0.0,16.0,16.0,0.0,0.0,0.0
Rob Katzaroff,Rob Katzaroff,New York Mets,METS,1,1,1,2,1992,1992,0,0.0,0.11,0.11,0,46,46,0,145,145,0.0,0.0,0.0,0.0,2000000.0,2000000.0
Rob Pietroburgo,Rob Pietroburgo,Seattle Mariners,MARNRS,1,3,1,4,1979,1981,2,2.1,-0.37,-2.47,64,83,19,0,269,269,447.0,0.0,-447.0,0.0,0.0,0.0
Rob Pugmire,Rob Pugmire,Cleveland Indians,INDINS,1,2,1,3,2000,2002,2,2.43,-0.3,-2.73,134,52,-82,33,128,95,506.0,0.0,-506.0,0.0,1400000.0,1400000.0
Rob Schilling,Rob Schilling,Chicago Cubs,CUBS,1,2,1,3,1983,1985,2,0.0,-1.38,-1.38,0,103,103,0,175,175,0.0,0.0,0.0,0.0,0.0,0.0
Rob Snow,Rob Snow,Boston Red Sox,RSOX,1,2,1,3,1967,1968,1,3.8,1.35,-2.45,154,163,9,14,561,547,413.0,0.0,-413.0,0.0,31250.0,31250.0
Rob Stratton,Rob Stratton,New York Mets,METS,4,8,6,14,1998,2004,6,16.46,25.48,9.02,820,471,-349,1355,484,-871,4079.0,4278.0,199.0,362500.0,1350000.0,987500.0
Rob Stratton,Rob Stratton,Florida Marlins,MARLNS,10,13,22,35,1998,2013,15,78.11,23.68,-54.43,3805,1869,-1936,11801,2165,-9636,3496.0,6395.0,2899.0,18420219.0,799800.0,-17620419.0
Rob Stratton,Rob Stratton,New York Mets,METS,2,4,3,7,2002,2002,0,4.04,-0.58,-4.62,267,21,-246,904,25,-879,36.0,163.0,127.0,362500.0,1350000.0,987500.0
Rob Wassenaar,Rob Wassenaar,California Angels,ANGELS,1,3,2,5,1988,1992,4,-0.32,6.07,6.39,96,81,-15,213,0,-213,64.0,1524.0,1460.0,0.0,1000000.0,1000000.0
Rob Wassenaar,Rob Wassenaar,Minnesota Twins,TWINS,1,2,1,3,1993,1994,1,0.21,-1.18,-1.39,130,34,-96,1,0,-1,187.0,132.0,-55.0,0.0,0.0,0.0
Robert Averette,Robert Averette,Cincinnati Reds,REDS,1,1,1,2,2000,2000,0,0.0,0.31,0.31,0,32,32,0,48,48,0.0,0.0,0.0,0.0,300000.0,300000.0
Robert Baillargeon,Robert Baillargeon,Philadelphia Phillies,PHILS,1,1,1,2,1964,1964,0,0.0,-0.18,-0.18,0,8,8,0,0,0,0.0,8.0,8.0,0.0,0.0,0.0
Robert Bono,Robert Bono,Houston Astros,ASTROS,2,4,3,7,2009,2010,1,1.04,0.25,-0.79,124,114,-10,0,0,0,162.0,160.0,-2.0,1625000.0,410000.0,-1215000.0
Robert Fletcher,Robert Fletcher,Chicago White Sox,WSOX,1,1,1,2,1990,1990,0,0.0,0.0,0.0,0,0,0,0,0,0,0.0,0.0,0.0,0.0,0.0,0.0
Robert Gilliam,Robert Gilliam,Oakland Athletics,ATLTCS,13,26,22,48,2011,2019,8,41.81,19.43,-22.38,2657,1492,-1165,5603,3820,-1783,7622.0,2917.0,-4705.0,9735001.0,4800000.0,-4935001.0
Robert Marcano,Robert Marcano,Cleveland Indians,INDINS,3,6,3,9,1973,1974,1,2.93,-1.31,-4.24,422,87,-335,1042,273,-769,0.0,0.0,0.0,19750.0,160000.0,140250.0
Robert Sagers,Robert Sagers,Chicago White Sox,WSOX,1,2,1,3,1959,1960,1,0.08,0.59,0.51,9,112,103,15,318,303,0.0,0.0,0.0,12500.0,0.0,-12500.0
Robert Stewart,Robert Stewart,St. Louis Cardinals,CARDS,9,13,13,26,1976,1992,16,18.06,16.92,-1.14,1525,1431,-94,2979,3196,217,3633.0,4989.0,1356.0,1943333.0,497500.0,-1445833.0
Roberto Manzueta,Roberto Manzueta,Arizona Diamondbacks,DBACKS,1,1,1,2,1999,2000,1,0.0,0.0,0.0,0,0,0,0,0,0,0.0,0.0,0.0,0.0,350000.0,350000.0
Roberto Miniel,Roberto Miniel,Milwaukee Brewers,BREWRS,1,2,2,4,2001,2003,2,0.61,-1.88,-2.49,56,108,52,0,117,117,85.0,715.0,630.0,1200000.0,0.0,-1200000.0
Robinson Fabian,Robinson Fabian,Colorado Rockies,ROCKS,1,2,1,3,2009,2010,1,1.26,1.09,-0.17,282,192,-90,1,1,0,427.0,182.0,-245.0,0.0,2000000.0,2000000.0
Robinson Garces,Robinson Garces,Detroit Tigers,TIGRS,1,3,1,4,1988,1989,1,23.49,1.15,-22.34,894,144,-750,3339,504,-2835,0.0,0.0,0.0,0.0,1540000.0,1540000.0
Robinson Lopez,Robinson Lopez,Atlanta Braves,BRAVES,1,3,1,4,2010,2010,0,0.0,0.92,0.92,0,39,39,0,151,151,0.0,0.0,0.0,0.0,13250000.0,13250000.0
Rocco Ippolito,Rocco Ippolito,Philadelphia Athletics,ATLTCS,36,79,78,157,1949,1976,27,93.22,74.94,-18.28,10595,9460,-1135,25786,29262,3476,12563.0,7417.0,-5146.0,500300.0,639500.0,139200.0
Rocky Elli,Rocky Elli,New York Mets,METS,1,2,1,3,1990,1991,1,0.0,-0.36,-0.36,0,97,97,0,306,306,0.0,0.0,0.0,0.0,825000.0,825000.0
Rod Imes,Rod Imes,New York Yankees,YANKS,2,4,3,7,1989,1992,3,13.18,0.48,-12.7,1091,78,-1013,3762,0,-3762,640.0,1277.0,637.0,2175000.0,0.0,-2175000.0
Rod Lofton,Rod Lofton,Baltimore Orioles,ORLS,1,1,2,3,1992,1992,0,0.0,0.0,0.0,0,0,0,0,0,0,0.0,0.0,0.0,0.0,0.0,0.0
Rod Pedraza,Rod Pedraza,Montreal Expos,NATEX,1,2,1,3,1994,1994,0,0.0,-1.1,-1.1,0,47,47,0,90,90,0.0,0.0,0.0,0.0,0.0,0.0
Rodger Cole,Rodger Cole,Philadelphia Phillies,PHILS,2,3,3,6,1986,1988,2,-0.99,0.97,1.96,38,139,101,107,137,30,0.0,179.0,179.0,0.0,0.0,0.0
Rodger Cole,Rodger Cole,New York Mets,METS,1,2,1,3,1986,1986,0,0.0,0.0,0.0,0,0,0,0,0,0,0.0,0.0,0.0,0.0,0.0,0.0
Rodolfo Sanchez,Rodolfo Sanchez,Tampa Bay Devil Rays,RAYS,1,1,1,2,2020,2020,0,0.0,-0.28,-0.28,0,4,4,0,0,0,0.0,10.0,10.0,0.0,0.0,0.0
Rodrigo Orozco,Rodrigo Orozco,Toronto Blue Jays,BJAYS,1,1,1,2,2019,2019,0,0.0,-0.82,-0.82,0,17,17,0,43,43,0.0,0.0,0.0,0.0,0.0,0.0
Roger Alexander,Roger Alexander,Milwaukee Brewers,BREWRS,1,2,1,3,1974,1974,0,1.37,0.0,-1.37,187,0,-187,473,0,-473,0.0,0.0,0.0,0.0,220000.0,220000.0
Roger Blanco,Roger Blanco,Seattle Mariners,MARNRS,1,1,1,2,1996,1996,0,0.0,1.68,1.68,0,40,40,0,163,163,0.0,0.0,0.0,0.0,0.0,0.0
Roger Etheridge,Roger Etheridge,Cincinnati Reds,REDS,6,13,8,21,1994,2010,16,11.82,27.11,15.29,501,1515,1014,1009,5387,4378,2595.0,2089.0,-506.0,16400000.0,10195291.0,-6204709.0
Roger Luce,Roger Luce,Texas Rangers,RNGRS,1,1,1,2,1995,1995,0,0.0,0.0,0.0,0,0,0,0,0,0,0.0,0.0,0.0,0.0,0.0,0.0
Rollie Lacy,Rollie Lacy,Chicago Cubs,CUBS,1,3,2,5,2018,2019,1,-0.39,5.6,5.99,25,74,49,0,71,71,96.0,654.0,558.0,570750.0,0.0,-570750.0
Rollie Lacy,Rollie Lacy,Texas Rangers,RNGRS,1,2,5,7,2018,2020,2,0.0,-0.13,-0.13,0,13,13,0,0,0,0.0,38.0,38.0,1050000.0,0.0,-1050000.0
Ron Cox,Ron Cox,St. Louis Cardinals,CARDS,1,2,2,4,1964,1967,3,0.0,-0.48,-0.48,0,55,55,0,111,111,0.0,0.0,0.0,0.0,0.0,0.0
Ron Gerstein,Ron Gerstein,Montreal Expos,NATEX,1,2,2,4,1993,1994,1,0.0,-0.51,-0.51,0,36,36,0,100,100,0.0,0.0,0.0,0.0,0.0,0.0
Ron Gideon,Ron Gideon,Philadelphia Phillies,PHILS,2,3,3,6,1986,1988,2,-0.99,0.97,1.96,38,139,101,107,137,30,0.0,179.0,179.0,0.0,0.0,0.0
Ron Kabbes,Ron Kabbes,St. Louis Cardinals,CARDS,1,1,1,2,1961,1961,0,0.0,0.0,0.0,0,0,0,0,0,0,0.0,0.0,0.0,0.0,0.0,0.0
Ron Koenigsfeld,Ron Koenigsfeld,Milwaukee Brewers,BREWRS,1,3,2,5,1984,1987,3,0.0,0.59,0.59,0,124,124,0,432,432,0.0,0.0,0.0,0.0,0.0,0.0
Ron Mitchell,Ron Mitchell,Los Angeles Dodgers,DOGRS,1,3,1,4,1969,1969,0,0.16,0.15,-0.01,6,18,12,9,21,12,0.0,169.0,169.0,0.0,75000.0,75000.0
Ron Perry,Ron Perry,Chicago White Sox,WSOX,2,5,2,7,1981,1985,4,2.62,4.41,1.79,199,140,-59,397,1,-396,970.0,1329.0,359.0,0.0,0.0,0.0
Ron Scheer,Ron Scheer,Minnesota Twins,TWINS,1,2,1,3,1985,1985,0,0.0,0.99,0.99,0,129,129,0,452,452,0.0,0.0,0.0,0.0,0.0,0.0
Ron Selak,Ron Selak,St. Louis Cardinals,CARDS,1,2,1,3,1974,1975,1,-0.69,-0.39,0.3,92,16,-76,63,7,-56,570.0,68.0,-502.0,0.0,100000.0,100000.0
Ron Selak,Ron Selak,Houston Astros,ASTROS,1,1,1,2,1977,1977,0,0.0,0.0,0.0,0,0,0,0,0,0,0.0,0.0,0.0,0.0,0.0,0.0
Ronald Drake,Ronald Drake,San Diego Padres,PADRS,1,2,1,3,1971,1971,0,0.0,0.0,0.0,0,0,0,0,0,0,0.0,0.0,0.0,0.0,0.0,0.0
Ronald Gifford,Ronald Gifford,Cleveland Indians,INDINS,1,2,1,3,1951,1951,0,0.0,0.0,0.0,0,4,4,0,0,0,0.0,12.0,12.0,0.0,0.0,0.0
Ronald Honeycutt,Ronald Honeycutt,Washington Senators,RNGRS,1,2,1,3,1962,1962,0,0.0,0.0,0.0,0,0,0,0,0,0,0.0,0.0,0.0,0.0,0.0,0.0
Ronald Uviedo,Ronald Uviedo,Pittsburgh Pirates,PIRATS,1,1,1,2,2010,2010,0,0.0,-0.24,-0.24,0,4,4,0,1,1,0.0,29.0,29.0,0.0,419500.0,419500.0
Ronaldo Hernandez,Ronaldo Hernandez,Tampa Bay Devil Rays,RAYS,1,2,3,5,2021,2021,0,0.0,0.11,0.11,0,61,61,0,0,0,0.0,216.0,216.0,0.0,0.0,0.0
Ronnie Farkas,Ronnie Farkas,California Angels,ANGELS,2,2,2,4,1976,1977,1,7.88,-0.35,-8.23,549,21,-528,1829,59,-1770,0.0,0.0,0.0,0.0,0.0,0.0
Ronnie Giddens,Ronnie Giddens,Montreal Expos,NATEX,1,2,1,3,1986,1986,0,0.0,-0.23,-0.23,0,30,30,0,69,69,0.0,0.0,0.0,0.0,0.0,0.0
Ronnie Merrill,Ronnie Merrill,Detroit Tigers,TIGRS,1,2,1,3,2002,2002,0,-1.27,-0.52,0.75,48,45,-3,2,0,-2,78.0,125.0,47.0,0.0,0.0,0.0
Ronnie Ray,Ronnie Ray,Anaheim Angels,ANGELS,1,2,1,3,2005,2005,0,0.0,0.15,0.15,0,12,12,0,0,0,0.0,11.0,11.0,0.0,1050000.0,1050000.0
Ronny Brito,Ronny Brito,Los Angeles Dodgers,DOGRS,1,2,2,4,2019,2019,0,0.0,0.72,0.72,0,87,87,0,249,249,0.0,12.0,12.0,0.0,0.0,0.0
Ronny Morla,Ronny Morla,Oakland Athletics,ATLTCS,3,6,5,11,2009,2013,4,-0.36,1.6,1.96,79,247,168,172,718,546,28.0,38.0,10.0,805000.0,2601500.0,1796500.0
Ronny Simon,Ronny Simon,Chicago Cubs,CUBS,2,2,4,6,2020,2021,1,1.44,1.17,-0.27,29,102,73,0,31,31,88.0,127.0,39.0,2250000.0,3045000.0,795000.0
Roque Mercedes,Roque Mercedes,Milwaukee Brewers,BREWRS,1,2,1,3,2009,2009,0,-0.62,2.01,2.63,50,66,16,120,297,177,0.0,0.0,0.0,0.0,3500000.0,3500000.0
Ross Adolph,Ross Adolph,New York Mets,METS,1,3,2,5,2019,2019,0,0.0,1.17,1.17,0,140,140,0,453,453,0.0,0.0,0.0,0.0,0.0,0.0
Roy Broome,Roy Broome,St. Louis Cardinals,CARDS,1,3,1,4,1953,1953,0,0.0,0.0,0.0,0,0,0,0,0,0,0.0,0.0,0.0,0.0,0.0,0.0
Roy Moretti,Roy Moretti,Oakland Athletics,ATLTCS,1,2,3,5,1981,1987,6,0.0,11.95,11.95,0,617,617,0,2241,2241,0.0,0.0,0.0,0.0,0.0,0.0
Rube Rubilotta,Rube Rubilotta,Chicago White Sox,WSOX,2,3,2,5,1969,1969,0,1.28,-1.35,-2.63,213,36,-177,599,8,-591,0.0,125.0,125.0,27500.0,19000.0,-8500.0
Ruben Cardenas,Ruben Cardenas,Cleveland Indians,INDINS,1,2,2,4,2019,2020,1,0.0,0.02,0.02,0,21,21,0,0,0,0.0,49.0,49.0,0.0,0.0,0.0
Ruben Flores,Ruben Flores,Seattle Mariners,MARNRS,2,3,2,5,2009,2010,1,1.78,-0.83,-2.61,120,159,39,382,588,206,3.0,0.0,-3.0,0.0,6925000.0,6925000.0
Ruddy Yan,Ruddy Yan,Pittsburgh Pirates,PIRATS,1,2,1,3,2002,2003,1,7.99,0.0,-7.99,294,0,-294,1,0,-1,777.0,0.0,-777.0,0.0,0.0,0.0
Rudy Darrow,Rudy Darrow,Detroit Tigers,TIGRS,1,1,1,2,2009,2009,0,0.0,-0.32,-0.32,0,74,74,0,175,175,0.0,0.0,0.0,0.0,0.0,0.0
Rudy Kinard,Rudy Kinard,St. Louis Cardinals,CARDS,1,2,1,3,1974,1976,2,0.0,1.8,1.8,0,180,180,0,415,415,0.0,0.0,0.0,0.0,0.0,0.0
Rudy Kinard,Rudy Kinard,Montreal Expos,NATEX,1,1,1,2,1976,1978,2,0.0,0.0,0.0,0,0,0,0,0,0,0.0,0.0,0.0,0.0,0.0,0.0
Rufus Ellis,Rufus Ellis,Kansas City Royals,ROYALS,1,1,1,2,1987,1988,1,0.0,-0.22,-0.22,0,7,7,0,5,5,0.0,0.0,0.0,0.0,0.0,0.0
Russ Cormier,Russ Cormier,Oakland Athletics,ATLTCS,1,2,1,3,1991,1995,4,0.0,3.31,3.31,0,127,127,0,1,1,0.0,2170.0,2170.0,0.0,0.0,0.0
Russ Haltiwanger,Russ Haltiwanger,Cincinnati Reds,REDS,2,2,2,4,2007,2010,3,1.11,-0.14,-1.25,287,232,-55,1089,857,-232,0.0,0.0,0.0,0.0,0.0,0.0
Russ Kibler,Russ Kibler,Oakland Athletics,ATLTCS,1,1,1,2,1988,1992,4,0.0,0.83,0.83,0,105,105,0,0,0,0.0,305.0,305.0,0.0,0.0,0.0
Russ Rohlicek,Russ Rohlicek,Houston Astros,ASTROS,1,3,1,4,2002,2002,0,0.0,0.4,0.4,0,30,30,0,1,1,0.0,57.0,57.0,0.0,2800000.0,2800000.0
Russ Spear,Russ Spear,San Diego Padres,PADRS,4,7,8,15,1996,2006,10,4.5,17.6,13.1,1037,1883,846,3956,6307,2351,0.0,1106.0,1106.0,11375000.0,15550000.0,4175000.0
Ryan Baker,Ryan Baker,Atlanta Braves,BRAVES,1,2,2,4,2002,2008,6,0.15,5.9,5.75,66,176,110,3,203,200,126.0,1529.0,1403.0,200000.0,0.0,-200000.0
Ryan Balfe,Ryan Balfe,Detroit Tigers,TIGRS,2,5,3,8,1997,1998,1,5.42,-0.93,-6.35,622,96,-526,194,193,-1,1023.0,185.0,-838.0,1475000.0,3035000.0,1560000.0
Ryan Bicondoa,Ryan Bicondoa,New York Yankees,YANKS,2,4,2,6,2003,2003,0,0.35,0.36,0.01,27,33,6,0,0,0,75.0,81.0,6.0,300000.0,10920833.0,10620833.0
Ryan Cameron,Ryan Cameron,Colorado Rockies,ROCKS,1,1,1,2,2003,2005,2,0.0,0.01,0.01,0,276,276,0,8,8,0.0,303.0,303.0,0.0,0.0,0.0
Ryan Costello,Ryan Costello,Seattle Mariners,MARNRS,1,2,2,4,2018,2018,0,0.01,-0.01,-0.02,6,28,22,0,0,0,56.0,44.0,-12.0,0.0,2150000.0,2150000.0
Ryan Cullen,Ryan Cullen,Texas Rangers,RNGRS,2,3,3,6,2000,2005,5,0.93,1.27,0.34,41,153,112,59,334,275,326.0,195.0,-131.0,3150000.0,3050000.0,-100000.0
Ryan Gripp,Ryan Gripp,Chicago Cubs,CUBS,1,1,1,2,2002,2004,2,0.0,0.48,0.48,0,119,119,0,370,370,0.0,0.0,0.0,0.0,750000.0,750000.0
Ryan Hannaman,Ryan Hannaman,San Francisco Giants,GIANTS,1,3,1,4,2003,2003,0,-1.54,0.88,2.42,20,20,0,0,25,25,251.0,204.0,-47.0,1852000.0,4250000.0,2398000.0
Ryan Kane,Ryan Kane,Anaheim Angels,ANGELS,2,4,2,6,1996,2000,4,0.66,6.28,5.62,38,162,124,115,353,238,0.0,1167.0,1167.0,1916972.0,6320000.0,4403028.0
Ryan Ketchner,Ryan Ketchner,Seattle Mariners,MARNRS,1,2,1,3,2004,2005,1,0.0,0.37,0.37,0,113,113,0,391,391,0.0,0.0,0.0,0.0,0.0,0.0
Ryan Martindale,Ryan Martindale,Cleveland Indians,INDINS,1,2,1,3,1996,1996,0,0.0,0.0,0.0,0,0,0,0,0,0,0.0,0.0,0.0,0.0,0.0,0.0
Ryan Meaux,Ryan Meaux,San Francisco Giants,GIANTS,1,2,1,3,2002,2002,0,-0.46,1.76,2.22,19,46,27,1,205,204,148.0,0.0,-148.0,0.0,1025000.0,1025000.0
Ryan Meaux,Ryan Meaux,Chicago White Sox,WSOX,1,1,1,2,2005,2005,0,0.0,-0.7,-0.7,0,31,31,0,99,99,0.0,0.0,0.0,0.0,575000.0,575000.0
Ryan Meyers,Ryan Meyers,New York Mets,METS,2,3,3,6,2008,2012,4,6.46,12.32,5.86,583,640,57,2471,2080,-391,0.0,191.0,191.0,3500000.0,3850000.0,350000.0
Ryan Moseley,Ryan Moseley,Baltimore Orioles,ORLS,1,1,1,2,2017,2017,0,0.0,-0.53,-0.53,0,13,13,0,1,1,0.0,44.0,44.0,0.0,0.0,0.0
Ryan Moskau,Ryan Moskau,Los Angeles Dodgers,DOGRS,1,1,1,2,1999,2000,1,0.0,0.34,0.34,0,50,50,0,122,122,0.0,0.0,0.0,0.0,245000.0,245000.0
Ryan Noda,Ryan Noda,Toronto Blue Jays,BJAYS,1,2,1,3,2020,2021,1,0.0,0.0,0.0,0,0,0,0,0,0,0.0,0.0,0.0,0.0,0.0,0.0
Ryan O'Sullivan,Ryan O'Sullivan,Los Angeles Dodgers,DOGRS,1,1,1,2,2012,2012,0,0.0,0.06,0.06,0,20,20,0,21,21,0.0,173.0,173.0,0.0,8500000.0,8500000.0
Ryan Owens,Ryan Owens,Arizona Diamondbacks,DBACKS,1,1,1,2,2001,2001,0,0.0,-0.01,-0.01,0,2,2,0,1,1,0.0,0.0,0.0,0.0,0.0,0.0
Ryan Robowski,Ryan Robowski,Arizona Diamondbacks,DBACKS,1,2,1,3,2011,2011,0,0.0,-1.5,-1.5,0,16,16,0,16,16,0.0,128.0,128.0,0.0,0.0,0.0
Ryan Tatusko,Ryan Tatusko,Texas Rangers,RNGRS,1,2,1,3,2010,2010,0,17.02,-0.67,-17.69,353,15,-338,317,50,-267,2805.0,0.0,-2805.0,0.0,8000000.0,8000000.0
Ryder Ryan,Ryder Ryan,Cleveland Indians,INDINS,1,1,1,2,2017,2017,0,0.0,0.26,0.26,0,43,43,0,169,169,0.0,0.0,0.0,0.0,13000000.0,13000000.0
Ryder Ryan,Ryder Ryan,New York Mets,METS,1,1,1,2,2020,2021,1,0.0,0.14,0.14,0,15,15,0,51,51,0.0,3.0,3.0,0.0,3500000.0,3500000.0
Rylan Bannon,Rylan Bannon,Los Angeles Dodgers,DOGRS,1,5,1,6,2018,2018,0,-0.21,2.49,2.7,29,66,37,41,296,255,217.0,0.0,-217.0,0.0,16000000.0,16000000.0
Ryne Ogren,Ryne Ogren,Seattle Mariners,MARNRS,1,1,1,2,2019,2019,0,0.0,-0.21,-0.21,0,9,9,0,0,0,0.0,48.0,48.0,0.0,567500.0,567500.0
Ryne White,Ryne White,Arizona Diamondbacks,DBACKS,1,2,1,3,2009,2011,2,-0.04,-1.17,-1.13,79,197,118,2,2,0,122.0,322.0,200.0,0.0,1625000.0,1625000.0
Sal Biasi,Sal Biasi,Milwaukee Brewers,BREWRS,1,1,1,2,2019,2021,2,0.0,0.0,0.0,0,16,16,0,16,16,0.0,0.0,0.0,0.0,558500.0,558500.0
Sam Lewis,Sam Lewis,Kansas City Royals,ROYALS,1,1,1,2,2017,2017,0,0.0,0.0,0.0,0,0,0,0,0,0,0.0,0.0,0.0,0.0,0.0,0.0
Sam McWilliams,Sam McWilliams,Philadelphia Phillies,PHILS,3,3,5,8,2015,2020,5,-0.71,3.23,3.94,53,144,91,3,202,199,209.0,906.0,697.0,17200000.0,8475000.0,-8725000.0
Sam McWilliams,Sam McWilliams,Arizona Diamondbacks,DBACKS,1,4,2,6,2018,2019,1,-0.39,-0.4,-0.01,65,72,7,0,272,272,232.0,0.0,-232.0,0.0,0.0,0.0
Sam Sorce,Sam Sorce,Texas Rangers,RNGRS,1,3,1,4,1983,1986,3,7.12,8.55,1.43,212,414,202,0,1715,1715,3956.0,0.0,-3956.0,0.0,250000.0,250000.0
Sam Wolff,Sam Wolff,Texas Rangers,RNGRS,1,2,2,4,2017,2018,1,0.0,-1.31,-1.31,0,42,42,0,0,0,0.0,306.0,306.0,0.0,7000000.0,7000000.0
Samad Taylor,Samad Taylor,Cleveland Indians,INDINS,1,2,1,3,2017,2017,0,0.5,0.32,-0.18,52,21,-31,0,0,0,348.0,55.0,-293.0,0.0,3000000.0,3000000.0
Sammy Bell,Sammy Bell,Brooklyn Dodgers,DOGRS,2,9,3,12,1941,1947,6,3.3,-0.19,-3.49,337,37,-300,419,81,-338,1285.0,0.0,-1285.0,17500.0,0.0,-17500.0
Sammy Liberto,Sammy Liberto,Philadelphia Athletics,ATLTCS,41,87,83,170,1940,1976,36,92.78,73.04,-19.74,10628,9886,-742,25815,30142,4327,12609.0,9315.0,-3294.0,510800.0,639500.0,128700.0
Sammy Ross,Sammy Ross,New York Yankees,YANKS,5,14,8,22,1919,1946,27,28.58,90.66,62.08,995,2697,1702,1312,4980,3668,7730.0,17113.0,9383.0,42500.0,38450.0,-4050.0
Samuel Escudero,Samuel Escudero,Milwaukee Brewers,BREWRS,1,1,2,3,2021,2021,0,0.0,0.06,0.06,0,26,26,0,2,2,0.0,55.0,55.0,0.0,0.0,0.0
Sandy Nin,Sandy Nin,Toronto Blue Jays,BJAYS,1,2,1,3,2003,2006,3,0.0,3.79,3.79,0,199,199,0,1,1,0.0,561.0,561.0,302000.0,850000.0,548000.0
Santiago Nessy,Santiago Nessy,Toronto Blue Jays,BJAYS,3,3,3,6,2014,2017,3,5.97,0.47,-5.5,306,122,-184,0,1,1,866.0,482.0,-384.0,518400.0,2150000.0,1631600.0
Santos Rodriguez,Santos Rodriguez,Atlanta Braves,BRAVES,5,12,14,26,2008,2014,6,17.06,9.0,-8.06,2364,1258,-1106,2896,3420,524,3035.0,1593.0,-1442.0,26080000.0,24455000.0,-1625000.0
Saul Bustos,Saul Bustos,Chicago Cubs,CUBS,1,2,1,3,1997,1997,0,0.0,0.0,0.0,0,0,0,0,0,0,0.0,0.0,0.0,0.0,0.0,0.0
Scot Beahan,Scot Beahan,Kansas City Royals,ROYALS,1,1,1,2,1982,1982,0,0.0,-0.12,-0.12,0,41,41,0,19,19,0.0,0.0,0.0,0.0,0.0,0.0
Scott Adair,Scott Adair,New York Mets,METS,2,3,3,6,1996,1998,2,0.54,-0.29,-0.83,36,62,26,79,131,52,2.0,0.0,-2.0,0.0,0.0,0.0
Scott Bakkum,Scott Bakkum,Boston Red Sox,RSOX,1,1,1,2,1996,1996,0,0.0,-0.62,-0.62,0,92,92,0,209,209,0.0,0.0,0.0,0.0,225000.0,225000.0
Scott Breeden,Scott Breeden,Los Angeles Dodgers,DOGRS,1,1,1,2,1963,1963,0,0.0,0.25,0.25,0,22,22,0,26,26,0.0,0.0,0.0,0.0,0.0,0.0
Scott Comer,Scott Comer,New York Mets,METS,3,8,6,14,1997,2005,8,2.32,3.69,1.37,695,703,8,27,54,27,1207.0,1122.0,-85.0,5800000.0,1505000.0,-4295000.0
Scott Dye,Scott Dye,New York Mets,METS,2,2,2,4,1983,1984,1,0.0,0.0,0.0,0,0,0,0,0,0,0.0,0.0,0.0,0.0,0.0,0.0
Scott Henion,Scott Henion,New York Mets,METS,2,7,3,10,1988,1992,4,34.6,11.89,-22.71,847,584,-263,103,1206,1103,6852.0,1699.0,-5153.0,378000.0,2766666.0,2388666.0
Scott Holcomb,Scott Holcomb,Oakland Athletics,ATLTCS,1,1,1,2,1989,1990,1,0.0,-0.13,-0.13,0,43,43,0,85,85,0.0,0.0,0.0,0.0,655000.0,655000.0
Scott Hunter,Scott Hunter,Los Angeles Dodgers,DOGRS,1,2,1,3,1995,1997,2,0.0,-0.18,-0.18,0,178,178,0,724,724,0.0,0.0,0.0,0.0,2000000.0,2000000.0
Scott Makarewicz,Scott Makarewicz,Florida Marlins,MARLNS,1,2,1,3,1998,2004,6,1.89,0.02,-1.87,314,207,-107,3,531,528,517.0,0.0,-517.0,320000.0,0.0,-320000.0
Scott Manea,Scott Manea,New York Mets,METS,1,3,2,5,2019,2019,0,0.0,1.17,1.17,0,140,140,0,453,453,0.0,0.0,0.0,0.0,0.0,0.0
Scott Moss,Scott Moss,Cincinnati Reds,REDS,1,3,1,4,2019,2020,1,0.49,2.49,2.0,49,30,-19,207,16,-191,0.0,388.0,388.0,9700000.0,13000000.0,3300000.0
Scott Nate,Scott Nate,Milwaukee Brewers,BREWRS,1,2,1,3,1996,1998,2,0.0,1.8,1.8,0,225,225,0,554,554,0.0,0.0,0.0,0.0,0.0,0.0
Scott Patterson,Scott Patterson,Atlanta Braves,BRAVES,1,1,1,2,1982,1982,0,0.0,0.09,0.09,0,57,57,0,130,130,0.0,0.0,0.0,0.0,570000.0,570000.0
Scott Prouty,Scott Prouty,Seattle Mariners,MARNRS,1,1,1,2,1998,1999,1,0.0,-0.33,-0.33,0,8,8,0,0,0,0.0,28.0,28.0,0.0,0.0,0.0
Scott Rivette,Scott Rivette,Oakland Athletics,ATLTCS,1,1,1,2,1998,1998,0,0.0,-0.8,-0.8,0,27,27,0,91,91,0.0,0.0,0.0,0.0,2350000.0,2350000.0
Scott Roberts,Scott Roberts,Milwaukee Brewers,BREWRS,1,1,1,2,1985,1986,1,0.0,0.0,0.0,0,0,0,0,0,0,0.0,0.0,0.0,0.0,0.0,0.0
Scott Robinson,Scott Robinson,Cincinnati Reds,REDS,1,2,1,3,1994,1994,0,-1.17,0.0,1.17,110,0,-110,5,0,-5,197.0,0.0,-197.0,0.0,0.0,0.0
Scott Smith,Scott Smith,Seattle Mariners,MARNRS,1,2,1,3,1998,1998,0,-0.17,0.32,0.49,8,8,0,12,23,11,0.0,0.0,0.0,0.0,0.0,0.0
Scott Sturkie,Scott Sturkie,Cleveland Indians,INDINS,1,1,1,2,2004,2004,0,0.0,0.0,0.0,0,0,0,0,0,0,0.0,0.0,0.0,0.0,0.0,0.0
Scott Tyler,Scott Tyler,Minnesota Twins,TWINS,5,6,6,12,2005,2019,14,3.77,5.35,1.58,558,693,135,2185,2384,199,5.0,417.0,412.0,5750000.0,5166667.0,-583333.0
Scott Vollmer,Scott Vollmer,Chicago White Sox,WSOX,1,1,1,2,1996,1996,0,0.0,-0.34,-0.34,0,14,14,0,39,39,0.0,0.0,0.0,0.0,350000.0,350000.0
Scott Youngbauer,Scott Youngbauer,Philadelphia Phillies,PHILS,1,1,1,2,2004,2005,1,0.0,0.0,0.0,0,0,0,0,0,0,0.0,0.0,0.0,0.0,0.0,0.0
Scottie Allen,Scottie Allen,Arizona Diamondbacks,DBACKS,1,1,1,2,2010,2011,1,0.0,-0.38,-0.38,0,65,65,0,202,202,0.0,0.0,0.0,0.0,400000.0,400000.0
Scotty Pace,Scotty Pace,Florida Marlins,MARLNS,1,1,1,2,1994,1995,1,0.0,-0.1,-0.1,0,6,6,0,5,5,0.0,0.0,0.0,0.0,0.0,0.0
Scotty Pace,Scotty Pace,Milwaukee Brewers,BREWRS,1,1,1,2,1998,1998,0,0.0,0.0,0.0,0,0,0,0,0,0,0.0,0.0,0.0,0.0,0.0,0.0
Sean Danielson,Sean Danielson,St. Louis Cardinals,CARDS,1,1,2,3,2007,2009,2,0.0,2.56,2.56,0,145,145,0,160,160,0.0,1279.0,1279.0,0.0,4000000.0,4000000.0
Sean Fesh,Sean Fesh,Houston Astros,ASTROS,14,30,36,66,1995,2008,13,59.26,31.82,-27.44,4671,6059,1388,11202,15757,4555,6620.0,5977.0,-643.0,24770000.0,12596500.0,-12173500.0
Sean Henry,Sean Henry,New York Mets,METS,1,2,1,3,2007,2007,0,0.0,-0.79,-0.79,0,21,21,0,50,50,0.0,0.0,0.0,0.0,2000000.0,2000000.0
Sean Jamieson,Sean Jamieson,Oakland Athletics,ATLTCS,1,1,1,2,2012,2012,0,0.0,0.06,0.06,0,39,39,0,172,172,0.0,0.0,0.0,0.0,0.0,0.0
Sean McNally,Sean McNally,Kansas City Royals,ROYALS,1,1,1,2,1999,2000,1,0.0,-1.52,-1.52,0,61,61,0,195,195,0.0,0.0,0.0,0.0,222000.0,222000.0
Sean Ratcliffe,Sean Ratcliffe,Toronto Blue Jays,BJAYS,2,3,3,6,2016,2017,1,-0.02,0.03,0.05,22,78,56,0,0,0,58.0,188.0,130.0,0.0,0.0,0.0
Sean Ross,Sean Ross,Atlanta Braves,BRAVES,1,2,1,3,1992,1992,0,-0.49,0.67,1.16,13,28,15,0,0,0,186.0,47.0,-139.0,0.0,2633334.0,2633334.0
Sean Smith,Sean Smith,Cleveland Indians,INDINS,1,1,1,2,2008,2009,1,0.0,4.65,4.65,0,206,206,0,760,760,0.0,0.0,0.0,0.0,0.0,0.0
Sean Twitty,Sean Twitty,Seattle Mariners,MARNRS,1,1,2,3,1992,1993,1,0.0,0.13,0.13,0,42,42,0,0,0,0.0,640.0,640.0,0.0,2175000.0,2175000.0
Sebastien Boucher,Sebastien Boucher,Seattle Mariners,MARNRS,1,1,1,2,2007,2007,0,0.0,-0.07,-0.07,0,8,8,0,0,0,0.0,31.0,31.0,0.0,575000.0,575000.0
Sergio Pedroza,Sergio Pedroza,Los Angeles Dodgers,DOGRS,1,2,1,3,2006,2006,0,-0.26,-0.96,-0.7,16,49,33,39,164,125,0.0,0.0,0.0,0.0,4950000.0,4950000.0
Seth Davidson,Seth Davidson,St. Louis Cardinals,CARDS,1,1,1,2,2002,2002,0,0.0,0.0,0.0,0,0,0,0,0,0,0.0,0.0,0.0,0.0,275000.0,275000.0
Seth McGarry,Seth McGarry,Pittsburgh Pirates,PIRATS,1,1,1,2,2017,2017,0,0.0,-0.57,-0.57,0,15,15,0,0,0,0.0,25.0,25.0,0.0,7500000.0,7500000.0
Seth Shuman,Seth Shuman,Oakland Athletics,ATLTCS,1,3,3,6,2021,2021,0,0.0,-0.1,-0.1,0,88,88,0,339,339,0.0,0.0,0.0,0.0,7000000.0,7000000.0
Seth Streich,Seth Streich,Oakland Athletics,ATLTCS,2,5,5,10,2014,2019,5,3.37,0.99,-2.38,334,186,-148,1020,4,-1016,390.0,952.0,562.0,505000.0,0.0,-505000.0
Seth Taylor,Seth Taylor,New York Yankees,YANKS,2,3,2,5,2001,2001,0,0.68,0.25,-0.43,79,11,-68,1,0,-1,146.0,32.0,-114.0,0.0,0.0,0.0
Seung Song,Seung Song,Boston Red Sox,RSOX,1,2,1,3,2002,2002,0,0.77,1.55,0.78,122,47,-75,49,190,141,598.0,0.0,-598.0,0.0,0.0,0.0
Shane Young,Shane Young,New York Mets,METS,1,2,1,3,1987,1987,0,0.01,-0.06,-0.07,1,6,5,0,5,5,1.0,37.0,36.0,0.0,800000.0,800000.0
Shannon Carter,Shannon Carter,Baltimore Orioles,ORLS,2,4,3,7,1998,2005,7,0.36,10.59,10.23,33,461,428,30,8,-22,263.0,1704.0,1441.0,5250000.0,5000000.0,-250000.0
Shaun Cumberland,Shaun Cumberland,Tampa Bay Devil Rays,RAYS,1,3,2,5,2007,2007,0,0.07,0.0,-0.07,27,0,-27,68,0,-68,0.0,0.0,0.0,0.0,0.0,0.0
Shawn Bryant,Shawn Bryant,Cleveland Indians,INDINS,2,3,2,5,1994,2002,8,-2.57,-1.34,1.23,129,323,194,392,1082,690,0.0,0.0,0.0,450000.0,2166667.0,1716667.0
Shawn Garrett,Shawn Garrett,San Diego Padres,PADRS,1,2,1,3,2001,2001,0,0.0,-0.2,-0.2,0,13,13,0,15,15,0.0,0.0,0.0,0.0,265000.0,265000.0
Shawn Nottingham,Shawn Nottingham,Seattle Mariners,MARNRS,2,3,3,6,2006,2009,3,20.83,-0.89,-21.72,711,185,-526,3021,497,-2524,0.0,0.0,0.0,3550000.0,2487500.0,-1062500.0
Shawn Sonnier,Shawn Sonnier,Kansas City Royals,ROYALS,1,1,1,2,2002,2003,1,0.0,0.26,0.26,0,248,248,0,981,981,0.0,0.0,0.0,0.0,0.0,0.0
Shea Morenz,Shea Morenz,New York Yankees,YANKS,1,2,2,4,1998,1999,1,0.0,0.16,0.16,0,3,3,0,0,0,0.0,27.0,27.0,0.0,0.0,0.0
Shed Long,Shed Long,New York Yankees,YANKS,2,3,3,6,2019,2021,2,0.0,0.33,0.33,0,102,102,0,361,361,0.0,0.0,0.0,0.0,0.0,0.0
Sheldon Fulse,Sheldon Fulse,Seattle Mariners,MARNRS,1,1,1,2,2003,2003,0,0.0,-0.12,-0.12,0,4,4,0,0,0,0.0,6.0,6.0,0.0,300000.0,300000.0
Shendrik Apostel,Shendrik Apostel,Pittsburgh Pirates,PIRATS,1,1,1,2,2021,2021,0,0.0,0.17,0.17,0,82,82,0,4,4,0.0,218.0,218.0,0.0,0.0,0.0
Simeon Woods Richardson,Simeon Woods Richardson,New York Mets,METS,1,2,2,4,2019,2021,2,0.01,4.89,4.88,27,85,58,0,81,81,206.0,716.0,510.0,0.0,7400000.0,7400000.0
Simeon Woods Richardson,Simeon Woods Richardson,Toronto Blue Jays,BJAYS,1,2,1,3,2021,2021,0,0.0,1.38,1.38,0,13,13,0,2,2,0.0,211.0,211.0,0.0,6100000.0,6100000.0
Stan Bledsoe,Stan Bledsoe,Kansas City Athletics,ATLTCS,1,3,2,5,1966,1966,0,0.6,0.0,-0.6,100,0,-100,283,0,-283,0.0,0.0,0.0,0.0,0.0,0.0
Stan Boderick,Stan Boderick,Chicago Cubs,CUBS,1,2,1,3,1984,1984,0,0.0,0.61,0.61,0,116,116,0,12,12,0.0,276.0,276.0,0.0,0.0,0.0
Stan Butkus,Stan Butkus,St. Louis Cardinals,CARDS,1,1,1,2,1977,1981,4,0.0,-1.69,-1.69,0,110,110,0,8,8,0.0,273.0,273.0,0.0,0.0,0.0
Stan Cameron,Stan Cameron,Baltimore Orioles,ORLS,1,2,1,3,1993,1994,1,0.0,-0.1,-0.1,0,44,44,0,104,104,0.0,0.0,0.0,0.0,1000000.0,1000000.0
Stan Hough,Stan Hough,New York Mets,METS,1,2,1,3,1981,1983,2,0.0,0.72,0.72,0,17,17,0,53,53,0.0,0.0,0.0,0.0,0.0,0.0
Stan Keyes,Stan Keyes,St.Louis Browns,ORLS,4,5,7,12,1937,1952,15,5.24,6.19,0.95,522,805,283,1337,1470,133,901.0,2542.0,1641.0,21000.0,7000.0,-14000.0
Stan Keyes,Stan Keyes,Pittsburgh Pirates,PIRATS,2,4,2,6,1934,1939,5,12.93,3.73,-9.2,841,339,-502,3255,906,-2349,89.0,818.0,729.0,0.0,0.0,0.0
Stan Kyles,Stan Kyles,Chicago Cubs,CUBS,1,2,1,3,1984,1984,0,0.0,0.61,0.61,0,116,116,0,12,12,0.0,276.0,276.0,0.0,0.0,0.0
Steele Walker,Steele Walker,Chicago White Sox,WSOX,1,1,1,2,2019,2020,1,0.0,-0.13,-0.13,0,42,42,0,149,149,0.0,0.0,0.0,0.0,3300000.0,3300000.0
Stefan Jarrin,Stefan Jarrin,Los Angeles Dodgers,DOGRS,1,3,1,4,2012,2012,0,-1.0,1.11,2.11,86,53,-33,10,235,225,202.0,0.0,-202.0,483000.0,9500000.0,9017000.0
Stephen Easton,Stephen Easton,Oakland Athletics,ATLTCS,2,3,3,6,1972,1973,1,1.29,0.41,-0.88,134,35,-99,556,136,-420,0.0,22.0,22.0,100000.0,35500.0,-64500.0
Stephen Herman,Stephen Herman,Washington Senators,RNGRS,15,31,25,56,1965,1988,23,51.82,54.95,3.13,3334,4777,1443,9827,13370,3543,6092.0,8276.0,2184.0,551000.0,258500.0,-292500.0
Stephen Johnson,Stephen Johnson,San Francisco Giants,GIANTS,1,1,2,3,2015,2015,0,0.0,0.57,0.57,0,39,39,0,156,156,0.0,0.0,0.0,0.0,0.0,0.0
Stephen Kohlscheen,Stephen Kohlscheen,Seattle Mariners,MARNRS,1,2,1,3,2014,2014,0,0.26,-0.18,-0.44,70,32,-38,182,90,-92,0.0,0.0,0.0,0.0,2250000.0,2250000.0
Stephen Marek,Stephen Marek,Anaheim Angels,ANGELS,1,2,1,3,2008,2008,0,0.7,3.71,3.01,130,54,-76,511,234,-277,0.0,0.0,0.0,1450000.0,12500000.0,11050000.0
Stephen McCartney,Stephen McCartney,Milwaukee Brewers,BREWRS,1,1,1,2,1974,1976,2,0.0,0.0,0.0,0,0,0,0,0,0,0.0,0.0,0.0,0.0,22500.0,22500.0
Stephen Woods,Stephen Woods,San Francisco Giants,GIANTS,1,4,2,6,2017,2017,0,1.25,0.0,-1.25,79,0,-79,289,0,-289,0.0,0.0,0.0,11000000.0,13000000.0,2000000.0
Steve Allen,Steve Allen,Texas Rangers,RNGRS,1,2,2,4,1990,1991,1,0.0,-0.03,-0.03,0,6,6,0,0,0,0.0,18.0,18.0,0.0,0.0,0.0
Steve Barnard,Steve Barnard,St. Louis Cardinals,CARDS,2,3,3,6,1984,1992,8,-0.07,18.07,18.14,99,753,654,295,2368,2073,200.0,2206.0,2006.0,1100000.0,1720000.0,620000.0
Steve Dunnegan,Steve Dunnegan,Philadelphia Phillies,PHILS,1,1,1,2,1982,1983,1,0.0,-0.44,-0.44,0,28,28,0,36,36,0.0,0.0,0.0,0.0,0.0,0.0
Steve Finch,Steve Finch,Texas Rangers,RNGRS,4,10,10,20,1980,1987,7,9.35,8.94,-0.41,686,425,-261,1581,631,-950,2721.0,2684.0,-37.0,817500.0,331000.0,-486500.0
Steve Fincher,Steve Fincher,New York Yankees,YANKS,5,11,11,22,1982,1993,11,53.43,40.75,-12.68,2484,1599,-885,8455,4687,-3768,3002.0,2795.0,-207.0,2627500.0,2285766.0,-341734.0
Steve Gasser,Steve Gasser,Minnesota Twins,TWINS,1,3,2,5,1988,1989,1,0.0,-0.66,-0.66,0,87,87,0,337,337,0.0,0.0,0.0,0.0,650000.0,650000.0
Steve Green,Steve Green,Los Angeles Dodgers,DOGRS,1,2,1,3,1989,1991,2,0.0,-0.42,-0.42,0,51,51,0,76,76,0.0,0.0,0.0,0.0,70400.0,70400.0
Steve Hacker,Steve Hacker,Atlanta Braves,BRAVES,1,1,1,2,1997,1999,2,0.0,0.09,0.09,0,43,43,0,96,96,0.0,0.0,0.0,0.0,575000.0,575000.0
Steve Hammond,Steve Hammond,Milwaukee Brewers,BREWRS,1,2,1,3,2008,2008,0,0.19,0.68,0.49,33,41,8,16,122,106,0.0,0.0,0.0,0.0,7500000.0,7500000.0
Steve Hamrick,Steve Hamrick,Chicago Cubs,CUBS,2,2,2,4,1977,1979,2,-0.17,0.59,0.76,205,59,-146,595,133,-462,0.0,0.0,0.0,0.0,0.0,0.0
Steve Hamrick,Steve Hamrick,Seattle Mariners,MARNRS,1,1,1,2,1978,1978,0,0.0,0.0,0.0,0,0,0,0,0,0,0.0,0.0,0.0,0.0,0.0,0.0
Steve Hecht,Steve Hecht,San Francisco Giants,GIANTS,1,1,1,2,1990,1991,1,0.0,-0.34,-0.34,0,8,8,0,0,0,0.0,14.0,14.0,0.0,0.0,0.0
Steve Hendricks,Steve Hendricks,San Diego Padres,PADRS,1,2,1,3,1990,1991,1,0.0,-0.74,-0.74,0,28,28,0,2,2,0.0,61.0,61.0,0.0,360000.0,360000.0
Steve Herz,Steve Herz,Pittsburgh Pirates,PIRATS,2,2,2,4,1985,1992,7,-0.59,5.5,6.09,40,645,605,158,1767,1609,0.0,0.0,0.0,172500.0,460000.0,287500.0
Steve Hoff,Steve Hoff,San Diego Padres,PADRS,1,3,1,4,1997,1998,1,8.67,9.07,0.4,908,70,-838,3276,93,-3183,272.0,771.0,499.0,0.0,4510000.0,4510000.0
Steve Hoff,Steve Hoff,Florida Marlins,MARLNS,10,20,24,44,1998,2019,21,61.27,65.42,4.15,2318,3439,1121,4579,11330,6751,9272.0,5140.0,-4132.0,30092000.0,14431425.0,-15660575.0
Steve Larose,Steve Larose,New York Mets,METS,1,2,1,3,1990,1990,0,0.0,0.27,0.27,0,12,12,0,0,0,0.0,17.0,17.0,0.0,450000.0,450000.0
Steve Long,Steve Long,New York Mets,METS,2,2,3,5,1994,1999,5,-1.7,17.64,19.34,66,538,472,5,2047,2042,533.0,305.0,-228.0,109000.0,6500000.0,6391000.0
Steve MacFarland,Steve MacFarland,Pittsburgh Pirates,PIRATS,1,2,1,3,2007,2008,1,0.22,-1.2,-1.42,63,32,-31,181,31,-150,0.0,253.0,253.0,0.0,10037283.0,10037283.0
Steve Martin,Steve Martin,San Diego Padres,PADRS,1,2,2,4,1992,1993,1,0.0,0.0,0.0,0,0,0,0,0,0,0.0,0.0,0.0,0.0,0.0,0.0
Steve Miller,Steve Miller,San Francisco Giants,GIANTS,1,2,2,4,1987,1988,1,0.0,0.35,0.35,0,47,47,0,92,92,0.0,0.0,0.0,0.0,0.0,0.0
Steve O'Sullivan,Steve O'Sullivan,Chicago Cubs,CUBS,1,1,1,2,2003,2003,0,0.0,0.34,0.34,0,6,6,0,1,1,0.0,25.0,25.0,0.0,0.0,0.0
Steve Padia,Steve Padia,Baltimore Orioles,ORLS,1,3,1,4,1986,1987,1,0.0,-0.57,-0.57,0,34,34,0,85,85,0.0,0.0,0.0,0.0,0.0,0.0
Steve Patchin,Steve Patchin,Los Angeles Dodgers,DOGRS,2,2,2,4,1976,1980,4,1.54,-0.03,-1.57,452,10,-442,1340,20,-1320,0.0,0.0,0.0,0.0,0.0,0.0
Steve Ray,Steve Ray,New York Mets,METS,15,24,25,49,1983,1999,16,42.44,11.67,-30.77,2771,1788,-983,6235,1810,-4425,4175.0,4754.0,579.0,13614666.0,12979167.0,-635499.0
Steve Staniland,Steve Staniland,Oakland Athletics,ATLTCS,1,2,1,3,1975,1976,1,-0.15,-0.36,-0.21,18,86,68,0,97,97,23.0,0.0,-23.0,0.0,0.0,0.0
Steve Staniland,Steve Staniland,Chicago White Sox,WSOX,1,1,1,2,1977,1979,2,0.0,-1.19,-1.19,0,226,226,0,738,738,0.0,0.0,0.0,0.0,0.0,0.0
Steve Villines,Steve Villines,New York Mets,METS,1,1,1,2,2020,2020,0,0.0,-0.17,-0.17,0,1,1,0,0,0,0.0,12.0,12.0,0.0,0.0,0.0
Steve Walker,Steve Walker,New York Mets,METS,1,3,1,4,1983,1984,1,0.0,-0.14,-0.14,0,73,73,0,115,115,0.0,0.0,0.0,0.0,0.0,0.0
Steven Hensley,Steven Hensley,Seattle Mariners,MARNRS,1,1,2,3,2013,2013,0,0.0,-0.94,-0.94,0,24,24,0,4,4,0.0,361.0,361.0,0.0,0.0,0.0
Stevenson Agosto,Stevenson Agosto,Anaheim Angels,ANGELS,1,3,1,4,1997,1997,0,-0.12,-0.13,-0.01,86,32,-54,233,144,-89,0.0,0.0,0.0,0.0,3045000.0,3045000.0
Stevie Berman,Stevie Berman,Los Angeles Dodgers,DOGRS,1,1,1,2,2021,2021,0,0.0,0.08,0.08,0,4,4,0,0,0,0.0,5.0,5.0,0.0,0.0,0.0
Stoney Briggs,Stoney Briggs,Toronto Blue Jays,BJAYS,2,3,2,5,1993,1993,0,0.04,2.15,2.11,289,140,-149,1142,579,-563,0.0,0.0,0.0,2100000.0,2300000.0,200000.0
T.J. Rumfield,T.J. Rumfield,Philadelphia Phillies,PHILS,1,2,2,4,2021,2021,0,0.0,0.0,0.0,0,0,0,0,0,0,0.0,0.0,0.0,0.0,0.0,0.0
Tack Wilson,Tack Wilson,Philadelphia Phillies,PHILS,1,1,1,2,2003,2003,0,0.0,0.0,0.0,0,0,0,0,0,0,0.0,0.0,0.0,0.0,0.0,0.0
Tahnaj Thomas,Tahnaj Thomas,Cleveland Indians,INDINS,2,5,3,8,2018,2021,3,0.47,1.8,1.33,203,170,-33,650,509,-141,11.0,0.0,-11.0,547800.0,0.0,-547800.0
Taylor Lindsey,Taylor Lindsey,Anaheim Angels,ANGELS,2,6,4,10,2014,2017,3,-0.93,3.94,4.87,94,402,308,26,948,922,108.0,488.0,380.0,0.0,12000000.0,12000000.0
Ted Milner,Ted Milner,California Angels,ANGELS,1,1,1,2,1988,1988,0,0.0,-0.33,-0.33,0,21,21,0,16,16,0.0,0.0,0.0,0.0,0.0,0.0
Ted Norbert,Ted Norbert,New York Yankees,YANKS,1,5,1,6,1934,1934,0,0.0,0.0,0.0,0,0,0,0,0,0,0.0,0.0,0.0,2000.0,0.0,-2000.0
Teodoro Ortega,Teodoro Ortega,Oakland Athletics,ATLTCS,1,2,1,3,2018,2018,0,0.0,-0.06,-0.06,0,6,6,0,0,0,0.0,18.0,18.0,0.0,0.0,0.0
Terrel Hansen,Terrel Hansen,Montreal Expos,NATEX,3,4,4,8,1991,1992,1,-1.13,-1.26,-0.13,147,60,-87,321,92,-229,0.0,52.0,52.0,119000.0,920000.0,801000.0
Terrin Vavra,Terrin Vavra,Colorado Rockies,ROCKS,2,4,3,7,2020,2021,1,0.45,0.91,0.46,52,72,20,18,0,-18,64.0,117.0,53.0,4050000.0,3225000.0,-825000.0
Terry Austin,Terry Austin,Chicago Cubs,CUBS,2,2,2,4,1984,1988,4,0.0,-0.24,-0.24,0,70,70,0,192,192,0.0,0.0,0.0,0.0,0.0,0.0
Terry Bongiovanni,Terry Bongiovanni,Chicago Cubs,CUBS,1,3,1,4,1969,1970,1,0.08,-0.81,-0.89,52,39,-13,133,61,-72,0.0,0.0,0.0,0.0,0.0,0.0
Terry Crowley,Terry Crowley,Baltimore Orioles,ORLS,1,2,1,3,1987,1992,5,0.0,8.01,8.01,0,632,632,0,2276,2276,0.0,0.0,0.0,0.0,0.0,0.0
Terry Dailey,Terry Dailey,New York Mets,METS,1,5,1,6,1970,1971,1,10.78,2.98,-7.8,450,209,-241,470,731,261,3768.0,0.0,-3768.0,0.0,0.0,0.0
Terry Farrar,Terry Farrar,Baltimore Orioles,ORLS,1,2,1,3,1993,1994,1,0.0,-0.1,-0.1,0,44,44,0,104,104,0.0,0.0,0.0,0.0,1000000.0,1000000.0
Terry Powers,Terry Powers,Boston Red Sox,RSOX,1,2,1,3,1992,1993,1,-0.63,-0.29,0.34,48,73,25,5,239,234,114.0,0.0,-114.0,177000.0,2600000.0,2423000.0
Terry Quinn,Terry Quinn,New York Yankees,YANKS,1,5,1,6,1975,1976,1,0.0,0.33,0.33,0,80,80,0,217,217,0.0,0.0,0.0,0.0,0.0,0.0
Terry Wedgewood,Terry Wedgewood,Cleveland Indians,INDINS,4,5,5,10,1972,1978,6,17.47,7.73,-9.74,1096,443,-653,3100,1364,-1736,0.0,1052.0,1052.0,33000.0,79000.0,46000.0
Tex Gressett,Tex Gressett,Detroit Tigers,TIGRS,1,9,2,11,1921,1941,20,0.0,3.03,3.03,0,202,202,0,144,144,0.0,1168.0,1168.0,0.0,0.0,0.0
Theodore Del Guercio,Theodore Del Guercio,New York Yankees,YANKS,12,33,27,60,1954,1970,16,40.55,76.98,36.43,5201,4368,-833,16466,10777,-5689,3212.0,10751.0,7539.0,302500.0,109500.0,-193000.0
Theron Geith,Theron Geith,Tampa Bay Devil Rays,RAYS,1,1,1,2,2012,2012,0,0.0,-0.14,-0.14,0,24,24,0,63,63,0.0,0.0,0.0,0.0,0.0,0.0
Thomas Arruda,Thomas Arruda,Houston Astros,ASTROS,1,1,1,2,1966,1966,0,0.0,-0.12,-0.12,0,4,4,0,5,5,0.0,0.0,0.0,0.0,0.0,0.0
Thomas Arruda,Thomas Arruda,California Angels,ANGELS,2,3,2,5,1967,1968,1,0.18,0.22,0.04,210,95,-115,182,230,48,443.0,0.0,-443.0,0.0,0.0,0.0
Thomas Burrows,Thomas Burrows,Seattle Mariners,MARNRS,2,5,3,8,2017,2017,0,6.57,-0.14,-6.71,362,9,-353,845,0,-845,1646.0,23.0,-1623.0,0.0,0.0,0.0
Thomas Frondorf,Thomas Frondorf,Pittsburgh Pirates,PIRATS,3,5,5,10,1970,1973,3,0.0,0.41,0.41,0,41,41,0,35,35,0.0,36.0,36.0,17500.0,0.0,-17500.0
Thomas Keeling,Thomas Keeling,Milwaukee Brewers,BREWRS,1,1,1,2,2013,2014,1,0.0,-0.74,-0.74,0,89,89,0,270,270,0.0,0.0,0.0,0.0,496250.0,496250.0
Thomas Lessard,Thomas Lessard,Columbus,Columbus,2,2,4,6,1911,1913,2,3.36,0.0,-3.36,200,0,-200,183,0,-183,1648.0,0.0,-1648.0,0.0,2400.0,2400.0
Thomas Sheehan,Thomas Sheehan,St.Louis Browns,ORLS,1,2,1,3,1921,1921,0,0.0,0.08,0.08,0,3,3,0,3,3,0.0,0.0,0.0,0.0,0.0,0.0
Thor Skogan,Thor Skogan,California Angels,ANGELS,2,3,2,5,1973,1974,1,-0.74,0.84,1.58,36,140,104,91,478,387,0.0,0.0,0.0,8550.0,27500.0,18950.0
Ti'Quan Forbes,Ti'Quan Forbes,Texas Rangers,RNGRS,1,1,1,2,2017,2017,0,0.0,-0.03,-0.03,0,6,6,0,1,1,0.0,67.0,67.0,0.0,5900000.0,5900000.0
Tim Alderson,Tim Alderson,San Francisco Giants,GIANTS,1,1,1,2,2009,2012,3,0.0,2.86,2.86,0,196,196,0,847,847,0.0,0.0,0.0,0.0,6250000.0,6250000.0
Tim Alderson,Tim Alderson,Pittsburgh Pirates,PIRATS,1,1,1,2,2013,2013,0,0.0,0.0,0.0,0,0,0,0,0,0,0.0,0.0,0.0,0.0,0.0,0.0
Tim Arnold,Tim Arnold,California Angels,ANGELS,1,2,1,3,1985,1987,2,0.0,0.47,0.47,0,75,75,0,0,0,0.0,360.0,360.0,340000.0,513500.0,173500.0
Tim Barker,Tim Barker,Montreal Expos,NATEX,1,2,1,3,1986,1986,0,6.55,-0.38,-6.93,483,101,-382,101,247,146,1511.0,0.0,-1511.0,0.0,0.0,0.0
Tim Barker,Tim Barker,Los Angeles Dodgers,DOGRS,1,1,1,2,1992,1995,3,0.0,1.78,1.78,0,343,343,0,1350,1350,0.0,0.0,0.0,0.0,1906500.0,1906500.0
Tim Bausher,Tim Bausher,Boston Red Sox,RSOX,1,2,1,3,2006,2007,1,0.0,0.07,0.07,0,7,7,0,0,0,0.0,23.0,23.0,0.0,332500.0,332500.0
Tim Bittner,Tim Bittner,Chicago White Sox,WSOX,1,3,2,5,2003,2004,1,0.04,0.32,0.28,21,41,20,0,2,2,90.0,416.0,326.0,330000.0,1425000.0,1095000.0
Tim Cook,Tim Cook,Milwaukee Brewers,BREWRS,1,2,1,3,1982,1985,3,0.0,4.1,4.1,0,94,94,0,0,0,0.0,542.0,542.0,0.0,0.0,0.0
Tim Hallgren,Tim Hallgren,Seattle Mariners,MARNRS,1,2,1,3,1981,1986,5,-0.02,2.62,2.64,15,104,89,4,0,-4,0.0,696.0,696.0,0.0,0.0,0.0
Tim Henry,Tim Henry,Texas Rangers,RNGRS,1,2,1,3,1984,1985,1,0.0,0.08,0.08,0,46,46,0,0,0,0.0,504.0,504.0,0.0,0.0,0.0
Tim Meeks,Tim Meeks,Los Angeles Dodgers,DOGRS,1,1,1,2,1987,1987,0,0.0,-0.03,-0.03,0,4,4,0,0,0,0.0,7.0,7.0,0.0,0.0,0.0
Tim Smith,Tim Smith,Boston Red Sox,RSOX,3,5,6,11,1994,2011,17,0.04,48.84,48.8,391,2354,1963,170,6630,6460,732.0,3501.0,2769.0,2300000.0,0.0,-2300000.0
Tim Smith,Tim Smith,Texas Rangers,RNGRS,1,2,1,3,2009,2009,0,-0.11,0.0,0.11,5,0,-5,17,0,-17,0.0,0.0,0.0,0.0,0.0,0.0
Tim Sossamon,Tim Sossamon,Philadelphia Phillies,PHILS,2,4,3,7,1989,1996,7,0.28,7.71,7.43,106,447,341,38,1122,1084,145.0,1741.0,1596.0,750000.0,2100000.0,1350000.0
Timber Mead,Timber Mead,San Francisco Giants,GIANTS,1,3,1,4,1987,1987,0,2.82,0.95,-1.87,290,101,-189,7,239,232,505.0,0.0,-505.0,0.0,0.0,0.0
Tito Polo,Tito Polo,Pittsburgh Pirates,PIRATS,2,3,3,6,2016,2018,2,2.04,3.15,1.11,68,138,70,5,140,135,662.0,1238.0,576.0,9167000.0,0.0,-9167000.0
Tito Polo,Tito Polo,New York Yankees,YANKS,1,4,3,7,2017,2020,3,0.5,4.41,3.91,12,310,298,0,241,241,30.0,651.0,621.0,6150000.0,12535000.0,6385000.0
Tobias Myers,Tobias Myers,Baltimore Orioles,ORLS,1,1,1,2,2017,2018,1,0.0,2.45,2.45,0,146,146,0,632,632,0.0,0.0,0.0,0.0,885000.0,885000.0
Tobias Myers,Tobias Myers,Tampa Bay Devil Rays,RAYS,1,1,1,2,2021,2021,0,0.0,0.0,0.0,0,0,0,0,0,0,0.0,0.0,0.0,0.0,0.0,0.0
Tobias Myers,Tobias Myers,Tampa Bay Devil Rays,RAYS,1,1,1,2,2021,2021,0,0.0,0.0,0.0,0,0,0,0,0,0,0.0,0.0,0.0,0.0,0.0,0.0
Toby Nivens,Toby Nivens,Minnesota Twins,TWINS,1,3,2,5,1988,1989,1,0.0,-0.66,-0.66,0,87,87,0,337,337,0.0,0.0,0.0,0.0,650000.0,650000.0
Todd Blackford,Todd Blackford,Atlanta Braves,BRAVES,1,2,1,3,2005,2005,0,0.0,-0.14,-0.14,0,24,24,0,40,40,0.0,0.0,0.0,0.0,900000.0,900000.0
Todd Fischer,Todd Fischer,California Angels,ANGELS,1,1,1,2,1987,1988,1,0.0,-0.63,-0.63,0,33,33,0,86,86,0.0,0.0,0.0,0.0,0.0,0.0
Todd Glaesmann,Todd Glaesmann,Tampa Bay Devil Rays,RAYS,5,10,15,25,2013,2020,7,10.52,4.89,-5.63,1388,715,-673,4818,2481,-2337,195.0,188.0,-7.0,3254200.0,9506400.0,6252200.0
Todd McClure,Todd McClure,Houston Astros,ASTROS,1,1,1,2,1988,1993,5,0.0,10.65,10.65,0,271,271,0,282,282,0.0,2347.0,2347.0,0.0,68800.0,68800.0
Todd Noel,Todd Noel,Chicago Cubs,CUBS,4,13,7,20,1998,2009,11,13.03,10.6,-2.43,859,1301,442,2754,2788,34,471.0,1208.0,737.0,7140000.0,11000000.0,3860000.0
Todd Noel,Todd Noel,Florida Marlins,MARLNS,8,17,20,37,1999,2019,20,61.77,64.47,2.7,1848,3278,1430,4569,10868,6299,8696.0,5082.0,-3614.0,29867000.0,14191425.0,-15675575.0
Todd Ozias,Todd Ozias,San Francisco Giants,GIANTS,1,3,1,4,2001,2001,0,1.58,0.17,-1.41,103,49,-54,31,174,143,323.0,0.0,-323.0,0.0,6000000.0,6000000.0
Todd Ruyak,Todd Ruyak,Cincinnati Reds,REDS,1,1,1,2,1993,1993,0,0.0,-0.56,-0.56,0,66,66,0,2,2,0.0,76.0,76.0,0.0,145000.0,145000.0
Todd Samples,Todd Samples,Montreal Expos,NATEX,1,2,2,4,1993,1994,1,0.0,-0.51,-0.51,0,36,36,0,100,100,0.0,0.0,0.0,0.0,0.0,0.0
Todd Simmons,Todd Simmons,Chicago White Sox,WSOX,3,5,6,11,1984,1997,13,0.78,21.51,20.73,266,2126,1860,135,7098,6963,1605.0,1633.0,28.0,720500.0,260000.0,-460500.0
Todd Simmons,Todd Simmons,San Diego Padres,PADRS,1,2,1,3,1989,1989,0,2.11,-0.17,-2.28,83,14,-69,0,0,0,300.0,19.0,-281.0,0.0,0.0,0.0
Todd Simmons,Todd Simmons,Milwaukee Brewers,BREWRS,1,2,2,4,1989,1990,1,0.0,0.0,0.0,0,0,0,0,0,0,0.0,0.0,0.0,0.0,0.0,0.0
Tom Burns,Tom Burns,Seattle Mariners,MARNRS,1,1,1,2,1985,1985,0,0.0,0.0,0.0,0,0,0,0,0,0,0.0,0.0,0.0,0.0,0.0,0.0
Tom Deidel,Tom Deidel,Milwaukee Brewers,BREWRS,1,1,1,2,1976,1976,0,0.0,-1.0,-1.0,0,69,69,0,163,163,0.0,0.0,0.0,0.0,0.0,0.0
Tom Duggan,Tom Duggan,Texas Rangers,RNGRS,1,2,1,3,1987,1988,1,0.0,0.0,0.0,0,0,0,0,0,0,0.0,0.0,0.0,0.0,0.0,0.0
Tom Farmer,Tom Farmer,Detroit Tigers,TIGRS,1,2,1,3,2002,2003,1,0.0,-0.66,-0.66,0,40,40,0,131,131,0.0,0.0,0.0,0.0,225000.0,225000.0
Tom Francis,Tom Francis,San Diego Padres,PADRS,1,2,1,3,1983,1984,1,-0.3,-0.1,0.2,17,47,30,23,59,36,0.0,0.0,0.0,0.0,0.0,0.0
Tom Grieve,Tom Grieve,Philadelphia Phillies,PHILS,1,2,1,3,1911,1911,0,2.81,0.3,-2.51,88,66,-22,79,238,159,669.0,0.0,-669.0,0.0,0.0,0.0
Tom Hartley,Tom Hartley,Chicago White Sox,WSOX,1,2,1,3,1986,1988,2,0.0,1.98,1.98,0,87,87,0,0,0,0.0,254.0,254.0,0.0,121500.0,121500.0
Tom Heierle,Tom Heierle,Atlanta Braves,BRAVES,1,1,1,2,1973,1973,0,0.0,-0.15,-0.15,0,4,4,0,10,10,0.0,0.0,0.0,0.0,0.0,0.0
Tom Houk,Tom Houk,Minnesota Twins,TWINS,1,2,1,3,1993,1993,0,0.0,0.0,0.0,0,0,0,0,0,0,0.0,0.0,0.0,0.0,0.0,0.0
Tom Johnson,Tom Johnson,Houston Astros,ASTROS,2,4,3,7,1968,1970,2,13.55,1.65,-11.9,563,230,-333,804,931,127,6085.0,0.0,-6085.0,0.0,61000.0,61000.0
Tom Johnson,Tom Johnson,New York Mets,METS,3,5,4,9,1999,2005,6,0.19,1.57,1.38,110,682,572,29,1629,1600,370.0,40.0,-330.0,3750000.0,5463333.0,1713333.0
Tom Meagher,Tom Meagher,San Diego Padres,PADRS,1,2,2,4,1987,1987,0,0.35,0.0,-0.35,47,0,-47,92,0,-92,0.0,0.0,0.0,0.0,0.0,0.0
Tom Michno,Tom Michno,Baltimore Orioles,ORLS,1,2,1,3,1988,1988,0,0.0,-0.57,-0.57,0,20,20,0,30,30,0.0,0.0,0.0,0.0,0.0,0.0
Tom Nevers,Tom Nevers,Houston Astros,ASTROS,1,1,1,2,1995,1996,1,0.0,2.93,2.93,0,187,187,0,523,523,0.0,0.0,0.0,0.0,0.0,0.0
Tom Owens,Tom Owens,Cleveland Indians,INDINS,5,6,6,12,1983,1991,8,-1.49,1.17,2.66,295,310,15,344,378,34,443.0,1475.0,1032.0,250000.0,500000.0,250000.0
Tom Schwarz,Tom Schwarz,Minnesota Twins,TWINS,1,2,2,4,1987,1987,0,-0.38,-0.91,-0.53,34,30,-4,3,0,-3,72.0,131.0,59.0,0.0,425000.0,425000.0
Tom Wegmann,Tom Wegmann,New York Mets,METS,10,20,16,36,1994,2005,11,9.72,5.49,-4.23,1692,2201,509,3051,3605,554,2422.0,2911.0,489.0,20343890.0,14951666.0,-5392224.0
Tom Windle,Tom Windle,Los Angeles Dodgers,DOGRS,1,2,2,4,2014,2015,1,6.34,0.44,-5.9,200,144,-56,184,563,379,1751.0,0.0,-1751.0,0.0,11000000.0,11000000.0
Tommie Sheppard,Tommie Sheppard,New York Yankees,YANKS,1,1,0,1,1972,1972,0,0.0,0.0,0.0,0,0,0,0,0,0,0.0,0.0,0.0,0.0,0.0,0.0
Tommy Alexander,Tommy Alexander,Baltimore Orioles,ORLS,1,1,1,2,1985,1987,2,0.0,0.0,0.0,0,0,0,0,0,0,0.0,0.0,0.0,0.0,0.0,0.0
Tommy Bergjans,Tommy Bergjans,Los Angeles Dodgers,DOGRS,3,5,4,9,2016,2017,1,0.14,0.23,0.09,78,14,-64,181,40,-141,47.0,0.0,-47.0,8500000.0,532900.0,-7967100.0
Tommy DeJuneas,Tommy DeJuneas,Cleveland Indians,INDINS,1,1,1,2,2018,2020,2,0.0,0.22,0.22,0,9,9,0,0,0,0.0,25.0,25.0,0.0,0.0,0.0
Tommy Eason,Tommy Eason,Philadelphia Phillies,PHILS,1,2,1,3,1995,1996,1,-0.14,0.66,0.8,72,35,-37,3,118,115,125.0,0.0,-125.0,109000.0,320000.0,211000.0
Tommy Eveld,Tommy Eveld,Arizona Diamondbacks,DBACKS,1,1,1,2,2018,2018,0,0.0,0.01,0.01,0,56,56,0,0,0,0.0,65.0,65.0,0.0,9000000.0,9000000.0
Tommy Kurczewski,Tommy Kurczewski,Cleveland Indians,INDINS,1,1,1,2,1988,1988,0,0.0,0.04,0.04,0,21,21,0,0,0,0.0,101.0,101.0,0.0,0.0,0.0
Tommy Murray,Tommy Murray,Houston Astros,ASTROS,1,2,1,3,1968,1968,0,0.0,-1.85,-1.85,0,90,90,0,221,221,0.0,0.0,0.0,0.0,0.0,0.0
Tommy Romero,Tommy Romero,Seattle Mariners,MARNRS,3,4,6,10,2018,2019,1,3.4,4.58,1.18,251,276,25,571,810,239,250.0,139.0,-111.0,581200.0,5860000.0,5278800.0
Tommy Smith,Tommy Smith,St. Louis Cardinals,CARDS,3,4,4,8,1968,1971,3,5.4,-0.19,-5.59,715,29,-686,2340,38,-2302,0.0,0.0,0.0,0.0,0.0,0.0
Tommy Smith,Tommy Smith,Houston Astros,ASTROS,1,3,1,4,1968,1968,0,0.37,0.0,-0.37,361,0,-361,1073,0,-1073,0.0,0.0,0.0,0.0,0.0,0.0
Tony Beasley,Tony Beasley,Baltimore Orioles,ORLS,1,1,1,2,1991,1992,1,0.0,0.0,0.0,0,2,2,0,0,0,0.0,0.0,0.0,0.0,0.0,0.0
Tony Butler,Tony Butler,Seattle Mariners,MARNRS,4,9,5,14,2008,2013,5,43.53,3.71,-39.82,1975,169,-1806,6859,413,-6446,3908.0,766.0,-3142.0,1000000.0,1300000.0,300000.0
Tony Canzano,Tony Canzano,New York Mets,METS,1,1,1,2,1971,1971,0,0.0,0.0,0.0,0,0,0,0,0,0,0.0,0.0,0.0,0.0,0.0,0.0
Tony Chance,Tony Chance,Pittsburgh Pirates,PIRATS,1,1,1,2,1989,1989,0,0.0,-0.2,-0.2,0,32,32,0,3,3,0.0,72.0,72.0,0.0,0.0,0.0
Tony Diggs,Tony Diggs,Milwaukee Brewers,BREWRS,1,1,1,2,1993,1993,0,0.0,0.0,0.0,0,0,0,0,0,0,0.0,0.0,0.0,0.0,140000.0,140000.0
Tony Frulio,Tony Frulio,Kansas City Athletics,ATLTCS,3,5,4,9,1961,1962,1,-0.07,-0.4,-0.33,40,30,-10,51,51,0,0.0,0.0,0.0,0.0,0.0,0.0
Tony Gonzalez,Tony Gonzalez,St. Louis Cardinals,CARDS,1,2,1,3,1975,1975,0,3.9,-0.88,-4.78,682,20,-662,2305,1,-2304,0.0,26.0,26.0,0.0,0.0,0.0
Tony Locey,Tony Locey,St. Louis Cardinals,CARDS,1,5,1,6,2021,2021,0,0.69,4.14,3.45,45,157,112,42,653,611,346.0,0.0,-346.0,0.0,0.0,0.0
Tony Medrano,Tony Medrano,Toronto Blue Jays,BJAYS,2,4,4,8,1995,1997,2,19.63,3.81,-15.82,207,44,-163,147,0,-147,2766.0,687.0,-2079.0,8000000.0,0.0,-8000000.0
Tony Mitchell,Tony Mitchell,Pittsburgh Pirates,PIRATS,1,1,1,2,1992,1992,0,0.0,0.29,0.29,0,64,64,0,225,225,0.0,0.0,0.0,0.0,162500.0,162500.0
Tony Mitchell,Tony Mitchell,Cleveland Indians,INDINS,1,2,2,4,1995,1995,0,1.75,0.0,-1.75,147,0,-147,459,0,-459,0.0,0.0,0.0,0.0,0.0,0.0
Tony Nieto,Tony Nieto,Cincinnati Reds,REDS,1,2,1,3,1995,1995,0,-0.16,-0.17,-0.01,13,12,-1,29,2,-27,0.0,29.0,29.0,0.0,0.0,0.0
Tony Phillips,Tony Phillips,Milwaukee Brewers,BREWRS,2,2,2,4,1997,1997,0,0.0,-1.29,-1.29,0,84,84,0,154,154,0.0,0.0,0.0,0.0,0.0,0.0
Tony Ponce,Tony Ponce,Washington Senators,TWINS,1,4,4,8,1956,1956,0,0.0,0.0,0.0,0,0,0,0,0,0,0.0,0.0,0.0,0.0,0.0,0.0
Tony Socarras,Tony Socarras,Los Angeles Dodgers,DOGRS,1,1,1,2,2004,2004,0,0.0,-0.14,-0.14,0,9,9,0,8,8,0.0,0.0,0.0,0.0,0.0,0.0
Tony Thomas,Tony Thomas,Chicago Cubs,CUBS,1,1,1,2,2011,2011,0,0.0,0.0,0.0,0,0,0,0,0,0,0.0,0.0,0.0,0.0,0.0,0.0
Tony Valle,Tony Valle,Atlanta Braves,BRAVES,1,1,1,2,1990,1990,0,0.0,0.02,0.02,0,6,6,0,0,0,0.0,7.0,7.0,0.0,0.0,0.0
Torsten Boss,Torsten Boss,Baltimore Orioles,ORLS,1,1,1,2,2014,2014,0,0.0,-0.1,-0.1,0,11,11,0,0,0,0.0,31.0,31.0,0.0,0.0,0.0
Tracy Sanders,Tracy Sanders,Cleveland Indians,INDINS,2,3,2,5,1993,1994,1,-0.03,1.59,1.62,56,58,2,2,0,-2,91.0,270.0,179.0,0.0,122500.0,122500.0
Tracy Sanders,Tracy Sanders,San Diego Padres,PADRS,2,4,3,7,1993,2000,7,-0.42,-0.7,-0.28,28,54,26,3,11,8,67.0,168.0,101.0,326000.0,0.0,-326000.0
Travis Anderson,Travis Anderson,Houston Astros,ASTROS,1,3,1,4,2002,2002,0,0.0,0.4,0.4,0,30,30,0,1,1,0.0,57.0,57.0,0.0,2800000.0,2800000.0
Travis Buckley,Travis Buckley,Texas Rangers,RNGRS,1,3,1,4,1991,1991,0,2.41,-0.71,-3.12,510,12,-498,30,0,-30,668.0,186.0,-482.0,0.0,1500000.0,1500000.0
Travis Buckley,Travis Buckley,Montreal Expos,NATEX,1,1,1,2,1992,1992,0,0.0,0.0,0.0,0,0,0,0,0,0,0.0,0.0,0.0,0.0,0.0,0.0
Travis Buckley,Travis Buckley,Cincinnati Reds,REDS,1,1,1,2,1993,1993,0,0.0,0.0,0.0,0,0,0,0,0,0,0.0,0.0,0.0,0.0,0.0,0.0
Travis Chambers,Travis Chambers,Philadelphia Phillies,PHILS,2,2,2,4,1988,1990,2,-0.48,-0.53,-0.05,30,18,-12,1,18,17,63.0,137.0,74.0,0.0,0.0,0.0
Travis Ezi,Travis Ezi,Los Angeles Dodgers,DOGRS,3,7,6,13,2003,2008,5,2.71,12.65,9.94,623,585,-38,1632,1399,-233,321.0,2036.0,1715.0,9106667.0,15285000.0,6178333.0
Travis Ezi,Travis Ezi,Chicago Cubs,CUBS,1,1,1,2,2005,2005,0,0.0,0.0,0.0,0,0,0,0,0,0,0.0,0.0,0.0,0.0,0.0,0.0
Travis Hinton,Travis Hinton,Milwaukee Brewers,BREWRS,2,5,5,10,2005,2008,3,16.9,5.78,-11.12,1386,618,-768,5417,1625,-3792,210.0,270.0,60.0,8500000.0,7270260.0,-1229740.0
Travis Ott,Travis Ott,Washington Nationals,NATEX,2,4,6,10,2014,2021,7,10.96,22.51,11.55,452,684,232,1763,2913,1150,205.0,188.0,-17.0,47503480.0,0.0,-47503480.0
Travis Thurmond,Travis Thurmond,Anaheim Angels,ANGELS,1,1,1,2,1997,1999,2,0.0,2.02,2.02,0,98,98,0,0,0,0.0,342.0,342.0,0.0,625000.0,625000.0
Travis Willis,Travis Willis,Chicago Cubs,CUBS,1,1,1,2,1994,1996,2,0.0,0.3,0.3,0,213,213,0,341,341,0.0,0.0,0.0,0.0,0.0,0.0
Trent Weaver,Trent Weaver,Oakland Athletics,ATLTCS,1,1,1,2,1991,1992,1,0.0,0.0,0.0,0,0,0,0,0,0,0.0,0.0,0.0,0.0,0.0,0.0
Trevor Belicek,Trevor Belicek,Atlanta Braves,BRAVES,1,2,2,4,2016,2016,0,0.0,0.0,0.0,0,0,0,0,0,0,0.0,0.0,0.0,0.0,0.0,0.0
Trevor Hauver,Trevor Hauver,New York Yankees,YANKS,1,4,3,7,2021,2021,0,-0.87,0.78,1.65,6,82,76,0,228,228,70.0,57.0,-13.0,0.0,8700000.0,8700000.0
Trevor Lawhorn,Trevor Lawhorn,Cincinnati Reds,REDS,1,1,1,2,2006,2006,0,0.0,0.94,0.94,0,32,32,0,0,0,0.0,43.0,43.0,0.0,2750000.0,2750000.0
Trevor Schaffer,Trevor Schaffer,Chicago Cubs,CUBS,1,1,1,2,1997,1999,2,0.0,-0.43,-0.43,0,62,62,0,132,132,0.0,0.0,0.0,0.0,0.0,0.0
Trevor Seidenberger,Trevor Seidenberger,Milwaukee Brewers,BREWRS,1,1,1,2,2016,2016,0,0.0,0.0,0.0,0,0,0,0,0,0,0.0,0.0,0.0,0.0,0.0,0.0
Trey Cochran-Gill,Trey Cochran-Gill,Seattle Mariners,MARNRS,1,1,1,2,2015,2017,2,0.0,0.4,0.4,0,20,20,0,0,0,0.0,64.0,64.0,0.0,512500.0,512500.0
Trey Dyson,Trey Dyson,Kansas City Royals,ROYALS,1,3,2,5,2003,2005,2,0.0,0.71,0.71,0,50,50,0,2,2,0.0,739.0,739.0,0.0,1500000.0,1500000.0
Trey Dyson,Trey Dyson,Cleveland Indians,INDINS,1,1,1,2,2004,2004,0,0.0,-0.61,-0.61,0,65,65,0,0,0,0.0,235.0,235.0,0.0,0.0,0.0
Trey Johnston,Trey Johnston,San Diego Padres,PADRS,1,2,1,3,2006,2006,0,0.0,0.0,0.0,0,0,0,0,0,0,0.0,0.0,0.0,0.0,0.0,0.0
Trey Supak,Trey Supak,Pittsburgh Pirates,PIRATS,1,2,1,3,2015,2017,2,4.25,-0.14,-4.39,269,23,-246,796,33,-763,0.0,0.0,0.0,0.0,507500.0,507500.0
Tristan Beck,Tristan Beck,Atlanta Braves,BRAVES,1,2,1,3,2019,2020,1,0.0,1.32,1.32,0,68,68,0,0,0,0.0,131.0,131.0,1610000.0,14000000.0,12390000.0
Tristan Gray,Tristan Gray,Pittsburgh Pirates,PIRATS,2,4,2,6,2018,2019,1,0.39,4.09,3.7,34,179,145,137,675,538,0.0,0.0,0.0,8500000.0,0.0,-8500000.0
Trovin Valdez,Trovin Valdez,Baltimore Orioles,ORLS,1,2,1,3,1995,1996,1,-0.58,2.88,3.46,134,34,-100,453,0,-453,0.0,673.0,673.0,109000.0,0.0,-109000.0
Troy Cameron,Troy Cameron,Atlanta Braves,BRAVES,1,2,2,4,2001,2001,0,-0.15,0.35,0.5,40,162,122,0,2,2,104.0,227.0,123.0,1900000.0,4300000.0,2400000.0
Troy Evers,Troy Evers,New York Yankees,YANKS,2,4,2,6,1988,1989,1,22.92,1.01,-21.91,1483,131,-1352,5913,342,-5571,0.0,0.0,0.0,722000.0,670000.0,-52000.0
Troy Hughes,Troy Hughes,Atlanta Braves,BRAVES,1,1,1,2,1995,1995,0,0.0,-0.18,-0.18,0,28,28,0,57,57,0.0,0.0,0.0,0.0,1500000.0,1500000.0
Troy Miller,Troy Miller,Toronto Blue Jays,BJAYS,1,1,1,2,2021,2021,0,0.0,-0.07,-0.07,0,11,11,0,0,0,0.0,30.0,30.0,0.0,750000.0,750000.0
Troy Montgomery,Troy Montgomery,Anaheim Angels,ANGELS,3,5,4,9,2017,2019,2,0.03,1.41,1.38,49,135,86,143,393,250,20.0,182.0,162.0,11000000.0,11000000.0,0.0
Ty Narcisse,Ty Narcisse,Florida Marlins,MARLNS,1,2,1,3,1995,2004,9,0.38,0.0,-0.38,53,0,-53,163,0,-163,0.0,0.0,0.0,255000.0,0.0,-255000.0
Ty'Relle Harris,Ty'Relle Harris,Atlanta Braves,BRAVES,1,3,1,4,2010,2010,0,0.0,0.92,0.92,0,39,39,0,151,151,0.0,0.0,0.0,0.0,13250000.0,13250000.0
Tyler Bortnick,Tyler Bortnick,Tampa Bay Devil Rays,RAYS,1,1,1,2,2012,2013,1,0.0,0.9,0.9,0,120,120,0,382,382,0.0,0.0,0.0,0.0,2012500.0,2012500.0
Tyler Bremer,Tyler Bremer,Chicago Cubs,CUBS,1,2,1,3,2014,2015,1,0.0,-0.66,-0.66,0,15,15,0,10,10,0.0,104.0,104.0,0.0,0.0,0.0
Tyler Burch,Tyler Burch,Philadelphia Phillies,PHILS,1,1,1,2,2021,2021,0,0.0,0.32,0.32,0,32,32,0,120,120,0.0,0.0,0.0,0.0,1500000.0,1500000.0
Tyler Henson,Tyler Henson,Baltimore Orioles,ORLS,1,2,1,3,2011,2012,1,0.0,0.14,0.14,0,16,16,0,0,0,0.0,97.0,97.0,0.0,0.0,0.0
Tyler Herb,Tyler Herb,Seattle Mariners,MARNRS,1,1,1,2,2017,2018,1,0.0,-0.55,-0.55,0,2,2,0,0,0,0.0,15.0,15.0,0.0,0.0,0.0
Tyler Herb,Tyler Herb,San Francisco Giants,GIANTS,1,1,1,2,2019,2019,0,0.0,2.56,2.56,0,107,107,0,411,411,0.0,0.0,0.0,0.0,0.0,0.0
Tyler Jones,Tyler Jones,Miami Marlins,MARLNS,1,1,1,2,2020,2021,1,0.0,0.0,0.0,0,0,0,0,0,0,0.0,0.0,0.0,0.0,0.0,0.0
Tyler Lumsden,Tyler Lumsden,Chicago White Sox,WSOX,1,2,1,3,2006,2009,3,0.0,0.32,0.32,0,103,103,0,0,0,0.0,266.0,266.0,0.0,430000.0,430000.0
Tyler Pelland,Tyler Pelland,Boston Red Sox,RSOX,1,2,1,3,2003,2004,1,-1.4,0.92,2.32,12,55,43,6,0,-6,54.0,147.0,93.0,0.0,1600000.0,1600000.0
Tyler Pike,Tyler Pike,Seattle Mariners,MARNRS,1,2,2,4,2016,2019,3,-0.61,0.04,0.65,19,6,-13,50,0,-50,0.0,45.0,45.0,0.0,0.0,0.0
Tyler Stevens,Tyler Stevens,Anaheim Angels,ANGELS,1,1,1,2,2018,2021,3,0.0,-0.28,-0.28,0,18,18,0,0,0,0.0,221.0,221.0,0.0,1090000.0,1090000.0
Tyler Thomas,Tyler Thomas,Chicago Cubs,CUBS,1,1,1,2,2018,2018,0,0.0,1.95,1.95,0,61,61,0,0,0,0.0,117.0,117.0,0.0,1000000.0,1000000.0
Tyler Watson,Tyler Watson,Washington Nationals,NATEX,2,3,2,5,2017,2018,1,1.17,1.31,0.14,168,141,-27,1,0,-1,225.0,206.0,-19.0,5000000.0,2925000.0,-2075000.0
Tyler Ybarra,Tyler Ybarra,Toronto Blue Jays,BJAYS,1,1,1,2,2015,2015,0,0.0,0.0,0.0,0,0,0,0,0,0,0.0,0.0,0.0,0.0,0.0,0.0
Tyrone Horne,Tyrone Horne,Montreal Expos,NATEX,1,1,1,2,1995,1996,1,0.0,-0.71,-0.71,0,125,125,0,283,283,0.0,0.0,0.0,0.0,116000.0,116000.0
Tyson Gillies,Tyson Gillies,Seattle Mariners,MARNRS,6,11,9,20,2009,2014,5,2.34,8.64,6.3,470,811,341,626,2617,1991,956.0,1416.0,460.0,10564000.0,427200.0,-10136800.0
Vernon Maxwell,Vernon Maxwell,San Diego Padres,PADRS,2,7,4,11,1997,2001,4,12.93,12.25,-0.68,1051,464,-587,3386,1273,-2113,1459.0,771.0,-688.0,0.0,4510000.0,4510000.0
Vic Hithe,Vic Hithe,Houston Astros,ASTROS,1,2,1,3,1989,1991,2,0.47,-0.34,-0.81,66,60,-6,0,130,130,1060.0,0.0,-1060.0,0.0,0.0,0.0
Victor Araujo,Victor Araujo,Los Angeles Dodgers,DOGRS,9,31,24,55,2015,2021,6,13.68,18.97,5.29,1948,1113,-835,5665,1311,-4354,2367.0,3323.0,956.0,37486500.0,81903480.0,44416980.0
Victor Diaz,Victor Diaz,Boston Red Sox,RSOX,1,4,1,5,2016,2016,0,14.34,0.0,-14.34,583,0,-583,2288,0,-2288,251.0,0.0,-251.0,0.0,9150000.0,9150000.0
Victor Garcia,Victor Garcia,New York Mets,METS,3,5,7,12,1987,1991,4,-1.46,0.62,2.08,394,117,-277,613,186,-427,350.0,0.0,-350.0,250000.0,0.0,-250000.0
Victor González,Victor González,New York Mets,METS,1,2,1,3,2020,2020,0,0.0,0.15,0.15,0,10,10,0,0,0,0.0,27.0,27.0,0.0,1050000.0,1050000.0
Victor Hall,Victor Hall,Colorado Rockies,ROCKS,1,1,1,2,2002,2003,1,0.0,-0.43,-0.43,0,39,39,0,15,15,0.0,161.0,161.0,0.0,375000.0,375000.0
Victor Nova,Victor Nova,San Diego Padres,PADRS,2,7,4,11,2019,2021,2,6.96,0.42,-6.54,597,36,-561,2267,75,-2192,192.0,42.0,-150.0,570500.0,0.0,-570500.0
Victor Rodriguez,Victor Rodriguez,Florida Marlins,MARLNS,1,1,1,2,2000,2000,0,0.0,0.0,0.0,0,0,0,0,0,0,0.0,0.0,0.0,0.0,0.0,0.0
Victor Rodriguez,Victor Rodriguez,Kansas City Royals,ROYALS,2,3,2,5,2003,2004,1,-0.09,-0.19,-0.1,2,17,15,1,19,18,9.0,0.0,-9.0,0.0,0.0,0.0
Victor Santos,Victor Santos,Philadelphia Phillies,PHILS,1,1,1,2,2021,2021,0,0.0,0.0,0.0,0,0,0,0,0,0,0.0,0.0,0.0,0.0,0.0,0.0
Vince Faison,Vince Faison,San Diego Padres,PADRS,1,4,3,7,2004,2004,0,0.63,-0.51,-1.14,139,46,-93,232,85,-147,39.0,43.0,4.0,0.0,0.0,0.0
Vince Harris,Vince Harris,Chicago White Sox,WSOX,1,2,2,4,1988,1989,1,0.0,0.5,0.5,0,6,6,0,0,0,0.0,39.0,39.0,0.0,0.0,0.0
Vince Moore,Vince Moore,Atlanta Braves,BRAVES,1,3,1,4,1993,1997,4,-0.25,11.08,11.33,189,636,447,337,2705,2368,105.0,0.0,-105.0,0.0,4300000.0,4300000.0
Vince Sinisi,Vince Sinisi,Texas Rangers,RNGRS,2,3,3,6,2006,2008,2,0.0,0.45,0.45,0,58,58,0,132,132,0.0,0.0,0.0,0.0,0.0,0.0
Vincent Polito,Vincent Polito,Philadelphia Athletics,ATLTCS,1,3,1,4,1944,1946,2,0.0,0.0,0.0,0,0,0,0,0,0,0.0,0.0,0.0,0.0,0.0,0.0
Vladimir Perez,Vladimir Perez,Philadelphia Phillies,PHILS,1,2,1,3,1988,1988,0,0.0,-0.19,-0.19,0,20,20,0,31,31,0.0,0.0,0.0,0.0,0.0,0.0
Wade Parrish,Wade Parrish,Los Angeles Dodgers,DOGRS,1,1,1,2,2001,2002,1,0.0,0.05,0.05,0,28,28,0,55,55,0.0,0.0,0.0,0.0,0.0,0.0
Wade Parrish,Wade Parrish,Chicago White Sox,WSOX,2,2,2,4,2003,2008,5,0.28,-1.03,-1.31,224,235,11,764,471,-293,0.0,42.0,42.0,350000.0,346500.0,-3500.0
Wade Robinson,Wade Robinson,Houston Astros,ASTROS,1,1,1,2,2007,2007,0,0.0,0.0,0.0,0,0,0,0,0,0,0.0,0.0,0.0,0.0,0.0,0.0
Wallace Williams,Wallace Williams,Cincinnati Reds,REDS,2,3,4,7,1973,1977,4,7.62,0.16,-7.46,351,195,-156,338,503,165,2723.0,0.0,-2723.0,29000.0,40000.0,11000.0
Wally Lammers,Wally Lammers,St. Louis Cardinals,CARDS,15,35,30,65,1956,1972,16,38.58,60.99,22.41,4144,2647,-1497,9926,7589,-2337,4766.0,5429.0,663.0,32500.0,36000.0,3500.0
Walt White,Walt White,Florida Marlins,MARLNS,1,1,1,2,1998,1999,1,0.0,0.39,0.39,0,10,10,0,6,6,0.0,58.0,58.0,0.0,0.0,0.0
Walter Klimczak,Walter Klimczak,Toronto,Toronto,1,1,1,2,1941,1941,0,0.0,0.0,0.0,0,0,0,0,0,0,0.0,0.0,0.0,0.0,3000.0,3000.0
Walter Poole,Walter Poole,Detroit Tigers,TIGRS,1,2,1,3,1983,1983,0,0.0,-0.13,-0.13,0,4,4,0,5,5,0.0,0.0,0.0,0.0,0.0,0.0
Wander Cabrera,Wander Cabrera,Chicago Cubs,CUBS,1,1,1,2,2015,2016,1,0.0,0.0,0.0,0,0,0,0,0,0,0.0,0.0,0.0,0.0,1400000.0,1400000.0
Wayne Caughey,Wayne Caughey,Minnesota Twins,TWINS,1,1,1,2,1980,1987,7,0.0,1.54,1.54,0,452,452,0,1340,1340,0.0,0.0,0.0,0.0,0.0,0.0
Weldon Swift,Weldon Swift,Milwaukee Brewers,BREWRS,1,2,1,3,1982,1985,3,0.0,4.1,4.1,0,94,94,0,0,0,0.0,542.0,542.0,0.0,0.0,0.0
Wendell Rijo,Wendell Rijo,Boston Red Sox,RSOX,1,2,2,4,2016,2016,0,-0.35,-0.44,-0.09,28,47,19,9,137,128,106.0,0.0,-106.0,0.0,0.0,0.0
Wendell Rijo,Wendell Rijo,Milwaukee Brewers,BREWRS,2,2,2,4,2018,2019,1,-0.21,-0.02,0.19,15,70,55,36,219,183,0.0,9.0,9.0,0.0,0.0,0.0
Wes Bailey,Wes Bailey,New York Giants,GIANTS,1,5,3,8,1950,1954,4,0.0,-0.44,-0.44,0,186,186,0,308,308,0.0,172.0,172.0,0.0,0.0,0.0
Wes Bailey,Wes Bailey,Boston Red Sox,RSOX,2,4,4,8,1948,1948,0,0.0,0.0,0.0,2,0,-2,1,0,-1,0.0,0.0,0.0,0.0,0.0,0.0
Wes Livengood,Wes Livengood,Cincinnati Reds,REDS,1,3,1,4,1939,1939,0,0.0,-0.1,-0.1,0,6,6,0,14,14,0.0,0.0,0.0,0.0,0.0,0.0
Wes Musick,Wes Musick,Colorado Rockies,ROCKS,3,5,3,8,2010,2012,2,6.7,0.04,-6.66,199,171,-28,28,33,5,2842.0,468.0,-2374.0,8200000.0,7225000.0,-975000.0
Wes Scott,Wes Scott,San Francisco Giants,GIANTS,1,2,1,3,1971,1975,4,-1.59,-0.22,1.37,49,62,13,28,2,-26,375.0,100.0,-275.0,0.0,0.0,0.0
Widd Workman,Widd Workman,San Diego Padres,PADRS,2,3,3,6,1998,1998,0,0.16,-0.02,-0.18,3,8,5,0,0,0,27.0,21.0,-6.0,0.0,200000.0,200000.0
Wilber Perez,Wilber Perez,Milwaukee Brewers,BREWRS,1,2,2,4,2018,2018,0,0.0,-0.17,-0.17,0,52,52,0,0,0,0.0,66.0,66.0,0.0,0.0,0.0
Wilfrido Laureano,Wilfrido Laureano,Milwaukee Brewers,BREWRS,1,1,1,2,2006,2006,0,0.0,1.05,1.05,0,53,53,0,201,201,0.0,0.0,0.0,0.0,4700000.0,4700000.0
Wilkel Hernandez,Wilkel Hernandez,Anaheim Angels,ANGELS,3,5,4,9,2017,2019,2,0.03,1.41,1.38,49,135,86,143,393,250,20.0,182.0,162.0,11000000.0,11000000.0,0.0
Wilkin Ramos,Wilkin Ramos,Oakland Athletics,ATLTCS,1,1,1,2,2018,2021,3,0.0,-0.22,-0.22,0,6,6,0,1,1,0.0,67.0,67.0,0.0,0.0,0.0
Will Dupont,Will Dupont,Toronto Blue Jays,BJAYS,1,2,1,3,2014,2014,0,0.0,0.0,0.0,0,0,0,0,0,0,0.0,0.0,0.0,0.0,0.0,0.0
Will Hafey,Will Hafey,Oakland,Oakland,3,3,7,10,1948,1951,3,-0.16,0.0,0.16,106,0,-106,394,0,-394,0.0,0.0,0.0,0.0,0.0,0.0
Will Inman,Will Inman,Milwaukee Brewers,BREWRS,1,3,1,4,2007,2007,0,2.56,0.04,-2.52,559,54,-505,1,1,0,595.0,76.0,-519.0,0.0,2150000.0,2150000.0
Will Lamb,Will Lamb,Texas Rangers,RNGRS,2,3,2,5,2015,2016,1,-1.41,0.37,1.78,25,30,5,62,94,32,38.0,4.0,-34.0,0.0,0.0,0.0
Will Silverthorn,Will Silverthorn,Boston Red Sox,RSOX,1,2,1,3,1999,2000,1,0.0,0.0,0.0,0,0,0,0,0,0,0.0,0.0,0.0,0.0,272500.0,272500.0
Will Smith,Will Smith,Florida Marlins,MARLNS,1,3,1,4,2003,2003,0,-0.88,2.14,3.02,60,66,6,206,2,-204,10.0,115.0,105.0,0.0,4500000.0,4500000.0
Will Startup,Will Startup,Atlanta Braves,BRAVES,1,2,1,3,2007,2008,1,-0.32,-1.08,-0.76,68,103,35,14,0,-14,206.0,82.0,-124.0,0.0,0.0,0.0
Will Stewart,Will Stewart,Philadelphia Phillies,PHILS,1,4,1,5,2019,2021,2,1.81,9.39,7.58,260,326,66,876,1325,449,117.0,0.0,-117.0,0.0,0.0,0.0
Will Taylor,Will Taylor,San Diego Padres,PADRS,9,16,18,34,1992,2006,14,5.41,23.05,17.64,988,2335,1347,2783,7191,4408,251.0,517.0,266.0,12344680.0,13775000.0,1430320.0
Will Toffey,Will Toffey,Oakland Athletics,ATLTCS,1,3,1,4,2018,2018,0,-0.32,0.3,0.62,13,30,17,0,0,0,16.0,94.0,78.0,0.0,7925000.0,7925000.0
Will Toffey,Will Toffey,New York Mets,METS,1,1,1,2,2021,2021,0,0.0,-0.37,-0.37,0,10,10,0,1,1,0.0,22.0,22.0,0.0,0.0,0.0
Will Wilson,Will Wilson,Anaheim Angels,ANGELS,1,2,2,4,2019,2019,0,0.0,0.0,0.0,0,0,0,0,0,0,0.0,0.0,0.0,12666667.0,0.0,-12666667.0
William Frost,William Frost,San Francisco Giants,GIANTS,2,3,2,5,1970,1971,1,-1.33,0.72,2.05,165,78,-87,493,2,-491,0.0,134.0,134.0,0.0,0.0,0.0
William Juarez,William Juarez,Arizona Diamondbacks,DBACKS,2,6,2,8,2005,2009,4,0.95,0.24,-0.71,303,273,-30,1104,1118,14,0.0,0.0,0.0,10213898.0,0.0,-10213898.0
William Killinger,William Killinger,Charleston,Charleston,2,4,2,6,1955,1955,0,0.0,0.0,0.0,0,0,0,0,0,0,0.0,0.0,0.0,0.0,0.0,0.0
William Manning,William Manning,Philadelphia Phillies,PHILS,1,1,1,2,1924,1924,0,0.0,0.1,0.1,0,24,24,0,5,5,0.0,54.0,54.0,0.0,0.0,0.0
William Rothan,William Rothan,California Angels,ANGELS,3,5,3,8,1976,1979,3,0.01,3.49,3.48,36,153,117,0,0,0,119.0,938.0,819.0,0.0,0.0,0.0
William Wood,William Wood,Baltimore Orioles,ORLS,1,3,2,5,1973,1977,4,4.01,5.74,1.73,498,137,-361,1375,0,-1375,0.0,2543.0,2543.0,40000.0,29000.0,-11000.0
Willie Duke,Willie Duke,Brooklyn Dodgers,DOGRS,2,3,3,6,1938,1940,2,-0.62,-0.15,0.47,35,7,-28,67,20,-47,0.0,0.0,0.0,0.0,0.0,0.0
Willie Magallanes,Willie Magallanes,Chicago White Sox,WSOX,1,1,1,2,1991,1995,4,0.0,0.3,0.3,0,17,17,0,31,31,0.0,0.0,0.0,0.0,0.0,0.0
Willy Mota,Willy Mota,Boston Red Sox,RSOX,11,30,18,48,2008,2019,11,37.8,29.22,-8.58,3009,1818,-1191,5076,5902,826,5204.0,2054.0,-3150.0,4708000.0,21865000.0,17157000.0
Wilmy Caceres,Wilmy Caceres,Cincinnati Reds,REDS,1,1,1,2,2000,2002,2,0.0,0.0,0.0,0,0,0,0,0,0,0.0,0.0,0.0,0.0,200000.0,200000.0
Wilmy Caceres,Wilmy Caceres,Anaheim Angels,ANGELS,1,1,1,2,2001,2003,2,0.0,-0.61,-0.61,0,26,26,0,0,0,0.0,218.0,218.0,0.0,0.0,0.0
Wilton Chavez,Wilton Chavez,Chicago Cubs,CUBS,1,1,1,2,2003,2005,2,0.0,-0.64,-0.64,0,210,210,0,394,394,0.0,0.0,0.0,0.0,825000.0,825000.0
Winston Cole,Winston Cole,Kansas City Royals,ROYALS,2,4,3,7,1973,1978,5,2.68,1.78,-0.9,438,157,-281,817,247,-570,955.0,645.0,-310.0,49000.0,68500.0,19500.0
Woody Woodson,Woody Woodson,Cleveland Indians,INDINS,1,1,1,2,1969,1969,0,0.0,-0.29,-0.29,0,76,76,0,137,137,0.0,0.0,0.0,0.0,0.0,0.0
Wray Bergendahl,Wray Bergendahl,Seattle Mariners,MARNRS,1,1,1,2,1985,1986,1,0.0,-0.89,-0.89,0,24,24,0,0,0,0.0,369.0,369.0,0.0,0.0,0.0
Wuilmer Becerra,Wuilmer Becerra,Toronto Blue Jays,BJAYS,1,4,3,7,2012,2016,4,18.37,4.87,-13.5,742,311,-431,2152,493,-1659,2154.0,2473.0,319.0,0.0,5229800.0,5229800.0
Wynn Pelzer,Wynn Pelzer,San Diego Padres,PADRS,1,1,2,3,2010,2010,0,0.0,1.18,1.18,0,59,59,0,253,253,0.0,0.0,0.0,0.0,6000000.0,6000000.0
Xavier Edwards,Xavier Edwards,San Diego Padres,PADRS,1,3,2,5,2019,2021,2,-0.02,1.32,1.34,42,186,144,139,686,547,0.0,0.0,0.0,582100.0,4100000.0,3517900.0
Xavier Moore,Xavier Moore,Texas Rangers,RNGRS,1,2,1,3,2019,2019,0,0.0,0.0,0.0,0,0,0,0,0,0,0.0,0.0,0.0,0.0,0.0,0.0
Yader Peralta,Yader Peralta,Boston Red Sox,RSOX,1,2,1,3,2005,2005,0,0.0,0.05,0.05,0,1,1,0,0,0,0.0,3.0,3.0,0.0,0.0,0.0
Yaifer Perdomo,Yaifer Perdomo,Toronto Blue Jays,BJAYS,1,2,1,3,2021,2021,0,0.0,-0.26,-0.26,0,10,10,0,0,0,0.0,24.0,24.0,0.0,3500000.0,3500000.0
Yainer Diaz,Yainer Diaz,Cleveland Indians,INDINS,1,2,1,3,2021,2021,0,-0.24,1.78,2.02,31,60,29,0,268,268,76.0,0.0,-76.0,975000.0,0.0,-975000.0
Yeison Coca,Yeison Coca,Boston Red Sox,RSOX,1,4,1,5,2017,2019,2,5.97,-0.24,-6.21,440,43,-397,1667,0,-1667,0.0,128.0,128.0,0.0,0.0,0.0
Yeison Santana,Yeison Santana,San Diego Padres,PADRS,1,5,2,7,2020,2020,0,-0.94,0.0,0.94,63,0,-63,44,0,-44,444.0,0.0,-444.0,5250000.0,22000000.0,16750000.0
Yoel Espinal,Yoel Espinal,Tampa Bay Devil Rays,RAYS,2,4,5,9,2018,2020,2,-0.58,3.27,3.85,173,118,-55,2,160,158,374.0,210.0,-164.0,0.0,0.0,0.0
Yohanse Morel,Yohanse Morel,Washington Nationals,NATEX,1,3,1,4,2018,2018,0,-0.73,0.15,0.88,62,41,-21,233,0,-233,0.0,56.0,56.0,0.0,0.0,0.0
Yoiber Marquina,Yoiber Marquina,Cleveland Indians,INDINS,1,1,1,2,2017,2019,2,0.0,0.97,0.97,0,113,113,0,0,0,0.0,321.0,321.0,0.0,0.0,0.0
Yordi Rosario,Yordi Rosario,Chicago White Sox,WSOX,1,2,1,3,2018,2019,1,0.0,2.34,2.34,0,37,37,0,5,5,0.0,561.0,561.0,0.0,9167000.0,9167000.0
Yordy Cabrera,Yordy Cabrera,Oakland Athletics,ATLTCS,1,2,2,4,2012,2013,1,0.0,-0.37,-0.37,0,107,107,0,375,375,0.0,0.0,0.0,490000.0,0.0,-490000.0
Yudith Ozorio,Yudith Ozorio,New York Mets,METS,5,9,7,16,1996,1999,3,12.32,10.55,-1.77,1251,422,-829,4420,1607,-2813,1041.0,86.0,-955.0,5050000.0,4845000.0,-205000.0
Yuri Sanchez,Yuri Sanchez,Detroit Tigers,TIGRS,2,2,3,5,1996,2001,5,-0.01,0.5,0.51,18,44,26,0,0,0,28.0,129.0,101.0,400000.0,0.0,-400000.0
Yuri Sanchez,Yuri Sanchez,Cincinnati Reds,REDS,1,1,1,2,1998,1998,0,0.0,0.52,0.52,0,34,34,0,79,79,0.0,0.0,0.0,0.0,0.0,0.0
Yusniel Diaz,Yusniel Diaz,Los Angeles Dodgers,DOGRS,1,5,1,6,2018,2018,0,-0.21,2.49,2.7,29,66,37,41,296,255,217.0,0.0,-217.0,0.0,16000000.0,16000000.0
Zac Stott,Zac Stott,Cincinnati Reds,REDS,1,1,2,3,2006,2006,0,0.0,0.14,0.14,0,40,40,0,2,2,0.0,73.0,73.0,0.0,2600000.0,2600000.0
Zach Borenstein,Zach Borenstein,Anaheim Angels,ANGELS,1,2,2,4,2014,2014,0,0.11,-0.49,-0.6,4,34,30,0,15,15,9.0,19.0,10.0,0.0,2884500.0,2884500.0
Zach Bryant,Zach Bryant,Chicago Cubs,CUBS,1,1,1,2,2021,2021,0,0.0,0.0,0.0,0,0,0,0,0,0,0.0,0.0,0.0,0.0,0.0,0.0
Zach Cates,Zach Cates,San Diego Padres,PADRS,5,14,11,25,2012,2021,9,38.08,3.36,-34.72,1863,479,-1384,6550,569,-5981,976.0,2402.0,1426.0,10660200.0,4650000.0,-6010200.0
Zach McCormack,Zach McCormack,Florida Marlins,MARLNS,1,2,1,3,2006,2006,0,0.0,-0.02,-0.02,0,36,36,0,0,0,0.0,64.0,64.0,0.0,0.0,0.0
Zach Peek,Zach Peek,Anaheim Angels,ANGELS,1,4,1,5,2019,2021,2,0.0,1.39,1.39,4,37,33,0,4,4,13.0,469.0,456.0,0.0,2800000.0,2800000.0
Zach Simons,Zach Simons,Colorado Rockies,ROCKS,1,1,1,2,2008,2009,1,0.0,1.2,1.2,0,141,141,0,6,6,0.0,242.0,242.0,0.0,420000.0,420000.0
Zach Ward,Zach Ward,Cincinnati Reds,REDS,2,2,2,4,2006,2011,5,0.65,2.3,1.65,26,108,82,23,90,67,183.0,824.0,641.0,4200000.0,3950000.0,-250000.0
Zach Willeman,Zach Willeman,Los Angeles Dodgers,DOGRS,1,1,2,3,2021,2021,0,0.0,0.0,0.0,0,0,0,0,0,0,0.0,0.0,0.0,0.0,15500000.0,15500000.0
Zachary Bird,Zachary Bird,Los Angeles Dodgers,DOGRS,9,31,24,55,2015,2021,6,13.41,18.97,5.56,1905,1113,-792,5768,1311,-4457,2200.0,3323.0,1123.0,37486500.0,75153480.0,37666980.0
Zack Cox,Zack Cox,St. Louis Cardinals,CARDS,1,1,1,2,2012,2013,1,0.0,2.77,2.77,0,183,183,0,2,2,0.0,273.0,273.0,0.0,1625000.0,1625000.0
Zack Erwin,Zack Erwin,Chicago White Sox,WSOX,1,2,1,3,2015,2017,2,1.38,1.19,-0.19,101,94,-7,0,384,384,336.0,0.0,-336.0,0.0,1925000.0,1925000.0
Zack Thornton,Zack Thornton,Oakland Athletics,ATLTCS,1,1,1,2,2012,2013,1,0.0,-0.32,-0.32,0,19,19,0,0,0,0.0,54.0,54.0,0.0,850000.0,850000.0
Zack Thornton,Zack Thornton,Pittsburgh Pirates,PIRATS,1,2,1,3,2014,2014,0,0.0,-0.07,-0.07,0,131,131,0,397,397,0.0,0.0,0.0,0.0,0.0,0.0
Zeek White,Zeek White,Miami Marlins,MARLNS,1,3,1,4,2017,2019,2,13.54,1.87,-11.67,336,112,-224,228,107,-121,2332.0,912.0,-1420.0,0.0,0.0,0.0
aardd001,David Aardsma,San Francisco Giants,GIANTS,2,3,3,6,2005,2008,3,2.36,1.11,-1.25,196,369,173,41,1,-40,695.0,405.0,-290.0,336000.0,7000000.0,6664000.0
aardd001,David Aardsma,Chicago Cubs,CUBS,1,2,1,3,2006,2009,3,-0.4,0.17,0.57,27,164,137,0,1,1,97.0,190.0,93.0,0.0,400000.0,400000.0
aardd001,David Aardsma,Chicago White Sox,WSOX,1,1,2,3,2008,2011,3,-0.33,0.0,0.33,52,0,-52,1,0,-1,146.0,0.0,-146.0,0.0,0.0,0.0
aardd001,David Aardsma,Boston Red Sox,RSOX,10,28,17,45,2009,2019,10,37.8,29.55,-8.25,3009,1766,-1243,5076,5901,825,5204.0,1908.0,-3296.0,4708000.0,21865000.0,17157000.0
aaroh101,Hank Aaron,Atlanta Braves,BRAVES,4,9,5,14,1974,1983,9,4.19,7.49,3.3,717,753,36,1866,2551,685,923.0,87.0,-836.0,253500.0,0.0,-253500.0
aased001,Don Aase,Boston Red Sox,RSOX,1,2,1,3,1977,1985,8,10.47,6.5,-3.97,192,710,518,0,3118,3118,2086.0,0.0,-2086.0,0.0,80000.0,80000.0
abadf001,Fernando Abad,Washington Nationals,NATEX,1,1,1,2,2013,2013,0,1.97,0.0,-1.97,142,0,-142,0,0,0,315.0,0.0,-315.0,0.0,0.0,0.0
abadf001,Fernando Abad,Minnesota Twins,TWINS,2,2,2,4,2016,2017,1,0.22,-0.48,-0.7,72,16,-56,0,0,0,169.0,42.0,-127.0,0.0,0.0,0.0
abbae101,Ed Abbaticchio,Boston Braves,BRAVES,2,2,5,7,1906,1910,4,6.87,14.92,8.05,408,829,421,1496,3044,1548,0.0,1374.0,1374.0,0.0,0.0,0.0
abbeb101,Bert Abbey,Pittsburgh Pirates,PIRATS,2,2,2,4,1893,1898,5,2.42,1.37,-1.05,115,147,32,191,295,104,1263.0,1301.0,38.0,0.0,0.0,0.0
abbof101,Fred Abbott,Columbus,Columbus,1,1,1,2,1905,1907,2,-0.18,0.0,0.18,42,0,-42,142,0,-142,0.0,0.0,0.0,0.0,0.0,0.0
abboj001,Jim Abbott,California Angels,ANGELS,3,4,6,10,1992,1998,6,15.27,-0.9,-16.17,1393,613,-780,4599,2002,-2597,1493.0,1346.0,-147.0,2825000.0,490000.0,-2335000.0
abboj001,Jim Abbott,Chicago White Sox,WSOX,6,9,10,19,1995,2008,13,-3.17,23.46,26.63,359,1502,1143,866,3855,2989,1206.0,2082.0,876.0,3255000.0,346500.0,-2908500.0
abboj002,Jeff Abbott,Chicago White Sox,WSOX,1,1,1,2,2000,2002,2,0.03,-0.49,-0.52,28,22,-6,46,39,-7,0.0,0.0,0.0,255000.0,0.0,-255000.0
abbok001,Kyle Abbott,California Angels,ANGELS,1,2,1,3,1991,1992,1,-0.16,-0.8,-0.64,519,94,-425,970,350,-620,485.0,0.0,-485.0,0.0,2200000.0,2200000.0
abbok002,Kurt Abbott,Oakland Athletics,ATLTCS,1,1,1,2,1993,1996,3,1.96,-0.07,-2.03,424,22,-402,1461,18,-1443,0.0,0.0,0.0,109000.0,0.0,-109000.0
abbok002,Kurt Abbott,Florida Marlins,MARLNS,1,1,1,2,1997,1998,1,-0.55,-1.15,-0.6,35,26,-9,136,7,-129,0.0,98.0,98.0,650000.0,0.0,-650000.0
abbok002,Kurt Abbott,Oakland Athletics,ATLTCS,1,1,2,3,1998,1998,0,-0.8,0.0,0.8,138,0,-138,381,0,-381,0.0,0.0,0.0,1000000.0,0.0,-1000000.0
abbop001,Paul Abbott,Arizona Diamondbacks,DBACKS,1,1,1,2,2003,2003,0,0.4,0.0,-0.4,10,0,-10,0,0,0,143.0,0.0,-143.0,0.0,0.0,0.0
abera101,Al Aber,Cleveland Indians,INDINS,4,8,7,15,1953,1960,7,29.6,3.08,-26.52,1527,466,-1061,3515,525,-2990,4632.0,1595.0,-3037.0,15900.0,10000.0,-5900.0
aberb001,Brent Abernathy,Toronto Blue Jays,BJAYS,1,1,2,3,2000,2000,0,0.98,1.0,0.02,198,34,-164,846,0,-846,0.0,251.0,251.0,0.0,1000000.0,1000000.0
aberb101,Bill Abernathie,Cleveland Indians,INDINS,1,2,1,3,1953,1954,1,0.0,-0.16,-0.16,0,4,4,0,4,4,0.0,0.0,0.0,0.0,0.0,0.0
abert101,Ted Abernathy,Chicago Cubs,CUBS,2,2,3,5,1966,1968,2,-1.96,-1.51,0.45,166,152,-14,230,379,149,196.0,0.0,-196.0,0.0,0.0,0.0
abert101,Ted Abernathy,Cincinnati Reds,REDS,1,1,3,4,1969,1978,9,1.7,-3.64,-5.34,134,324,190,8,899,891,283.0,0.0,-283.0,0.0,0.0,0.0
abert101,Ted Abernathy,Chicago Cubs,CUBS,2,2,2,4,1970,1974,4,1.49,-0.89,-2.38,121,253,132,178,707,529,55.0,0.0,-55.0,0.0,25000.0,25000.0
abert101,Ted Abernathy,St. Louis Cardinals,CARDS,2,2,2,4,1970,1971,1,5.43,-1.11,-6.54,338,47,-291,40,33,-7,700.0,269.0,-431.0,0.0,0.0,0.0
abnes001,Shawn Abner,New York Mets,METS,12,24,21,45,1986,2006,20,25.44,47.58,22.14,2466,2918,452,5573,6399,826,2555.0,3756.0,1201.0,24986257.0,19799833.0,-5186424.0
abnes001,Shawn Abner,San Diego Padres,PADRS,1,1,1,2,1991,1991,0,-0.68,0.71,1.39,41,58,17,105,179,74,0.0,0.0,0.0,180000.0,652500.0,472500.0
abrac101,Cal Abrams,Brooklyn Dodgers,DOGRS,1,1,2,3,1952,1952,0,0.81,0.0,-0.81,71,0,-71,177,0,-177,0.0,0.0,0.0,9500.0,0.0,-9500.0
abrac101,Cal Abrams,Cincinnati Reds,REDS,1,3,1,4,1952,1961,9,1.64,13.15,11.51,150,1235,1085,601,5109,4508,0.0,0.0,0.0,0.0,10500.0,10500.0
abrac101,Cal Abrams,Pittsburgh Pirates,PIRATS,2,3,2,5,1954,1965,11,5.86,19.95,14.09,341,1537,1196,1230,5949,4719,29.0,893.0,864.0,11000.0,10000.0,-1000.0
abrac101,Cal Abrams,Baltimore Orioles,ORLS,1,1,1,2,1955,1956,1,0.13,0.22,0.09,4,41,37,5,143,138,0.0,0.0,0.0,16000.0,0.0,-16000.0
abrea001,Albert Abreu,Houston Astros,ASTROS,1,2,2,4,2016,2018,2,-0.24,1.81,2.05,33,160,127,0,615,615,114.0,0.0,-114.0,0.0,17000000.0,17000000.0
abreb001,Bobby Abreu,Tampa Bay Devil Rays,RAYS,1,1,1,2,1997,2000,3,47.18,2.72,-44.46,1353,231,-1122,5885,804,-5081,0.0,0.0,0.0,0.0,890000.0,890000.0
abreb001,Bobby Abreu,Philadelphia Phillies,PHILS,1,2,4,6,2006,2009,3,7.5,0.06,-7.44,382,46,-336,1631,0,-1631,136.0,38.0,-98.0,16900000.0,0.0,-16900000.0
abrej002,Juan Abreu,Atlanta Braves,BRAVES,1,4,2,6,2011,2012,1,1.07,6.78,5.71,249,208,-41,481,952,471,1075.0,0.0,-1075.0,0.0,4400000.0,4400000.0
abrej101,Joe Abreu,Cincinnati Reds,REDS,1,3,1,4,1942,1942,0,-0.7,0.0,0.7,176,38,-138,37,128,91,438.0,0.0,-438.0,0.0,0.0,0.0
abret001,Tony Abreu,Los Angeles Dodgers,DOGRS,1,1,1,2,2009,2009,0,-1.3,0.17,1.47,81,12,-69,201,13,-188,0.0,109.0,109.0,400000.0,6250000.0,5850000.0
abrew001,Winston Abreu,Atlanta Braves,BRAVES,1,1,1,2,2001,2001,0,0.0,0.2,0.2,0,24,24,0,0,0,0.0,36.0,36.0,0.0,0.0,0.0
abrew001,Winston Abreu,San Diego Padres,PADRS,1,1,1,2,2002,2002,0,0.0,0.0,0.0,0,0,0,0,0,0,0.0,0.0,0.0,0.0,0.0,0.0
abrew001,Winston Abreu,Tampa Bay Devil Rays,RAYS,1,1,1,2,2009,2009,0,-0.25,0.0,0.25,3,0,-3,0,0,0,7.0,0.0,-7.0,0.0,0.0,0.0
accaj001,Jeremy Accardo,San Francisco Giants,GIANTS,1,1,2,3,2006,2008,2,1.81,0.24,-1.57,144,281,137,0,251,251,419.0,321.0,-98.0,330000.0,6148500.0,5818500.0
acevj001,Juan Acevedo,Colorado Rockies,ROCKS,1,2,2,4,1995,1996,1,-0.04,0.08,0.12,47,18,-29,7,15,8,143.0,129.0,-14.0,109000.0,5562990.0,5453990.0
acevj001,Juan Acevedo,New York Mets,METS,4,6,5,11,1998,2005,7,2.27,1.88,-0.39,307,737,430,71,1631,1560,972.0,157.0,-815.0,3750000.0,5463333.0,1713333.0
acevj001,Juan Acevedo,St. Louis Cardinals,CARDS,1,3,1,4,1999,2003,4,0.9,5.69,4.79,122,488,366,2,2221,2219,248.0,0.0,-248.0,475000.0,2000000.0,1525000.0
acevj001,Juan Acevedo,Milwaukee Brewers,BREWRS,2,4,5,9,2001,2004,3,0.49,3.61,3.12,225,470,245,5,59,54,355.0,808.0,453.0,1700000.0,0.0,-1700000.0
acevj001,Juan Acevedo,Colorado Rockies,ROCKS,1,1,1,2,2001,2001,0,0.5,0.0,-0.5,40,0,-40,4,0,-4,85.0,0.0,-85.0,0.0,0.0,0.0
acevj002,Jose Acevedo,Cincinnati Reds,REDS,1,1,1,2,2005,2006,1,-0.77,-0.07,0.7,72,18,-54,11,0,-11,192.0,20.0,-172.0,0.0,318000.0,318000.0
ackej001,Jim Acker,Toronto Blue Jays,BJAYS,1,1,1,2,1986,1987,1,3.97,1.22,-2.75,338,30,-308,56,0,-56,1048.0,464.0,-584.0,0.0,105000.0,105000.0
ackej001,Jim Acker,Atlanta Braves,BRAVES,2,3,3,6,1989,1993,4,1.07,1.23,0.16,147,447,300,6,375,369,696.0,468.0,-228.0,853000.0,1071500.0,218500.0
acket101,Tom Acker,Buffalo,Buffalo,1,2,1,3,1951,1952,1,4.75,0.0,-4.75,338,0,-338,99,0,-99,1213.0,0.0,-1213.0,0.0,6000.0,6000.0
acket101,Tom Acker,Cincinnati Reds,REDS,1,1,1,2,1959,1961,2,0.0,-0.26,-0.26,0,23,23,0,28,28,0.0,0.0,0.0,10000.0,14000.0,4000.0
ackld001,Dustin Ackley,Seattle Mariners,MARNRS,4,4,5,9,2015,2017,2,-1.26,-0.89,0.37,431,38,-393,589,77,-512,306.0,17.0,-289.0,3112000.0,0.0,-3112000.0
acose101,Ed Acosta,Pittsburgh Pirates,PIRATS,1,2,1,3,1971,1973,2,1.19,1.07,-0.12,236,104,-132,456,7,-449,405.0,247.0,-158.0,0.0,0.0,0.0
acosj101,Jose Acosta,Washington Senators,TWINS,3,6,4,10,1922,1933,11,25.21,14.57,-10.64,1580,710,-870,6114,2665,-3449,0.0,616.0,616.0,0.0,0.0,0.0
adaij101,Jerry Adair,Baltimore Orioles,ORLS,6,13,9,22,1966,1973,7,1.41,-0.48,-1.89,684,433,-251,1106,498,-608,1557.0,550.0,-1007.0,66000.0,36600.0,-29400.0
adaij101,Jerry Adair,Chicago White Sox,WSOX,2,2,3,5,1967,1968,1,2.07,2.58,0.51,271,188,-83,571,21,-550,218.0,507.0,289.0,31250.0,24500.0,-6750.0
adama001,Austin Adams,Cleveland Indians,INDINS,1,1,1,2,2017,2017,0,0.0,0.0,0.0,0,0,0,0,0,0,0.0,0.0,0.0,0.0,0.0,0.0
adama002,Austin Adams,Anaheim Angels,ANGELS,1,2,1,3,2016,2017,1,-0.03,-0.47,-0.44,104,77,-27,6,254,248,215.0,0.0,-215.0,0.0,2875000.0,2875000.0
adama002,Austin Adams,Washington Nationals,NATEX,1,1,2,3,2019,2019,0,0.65,0.0,-0.65,32,0,-32,1,0,-1,93.0,0.0,-93.0,0.0,0.0,0.0
adama002,Austin Adams,Seattle Mariners,MARNRS,1,3,4,7,2020,2020,0,1.48,0.43,-1.05,218,41,-177,269,159,-110,200.0,0.0,-200.0,0.0,0.0,0.0
adamb101,Buster Adams,St. Louis Cardinals,CARDS,1,3,2,5,1943,1946,3,7.07,3.43,-3.64,654,226,-428,2414,842,-1572,0.0,0.0,0.0,0.0,0.0,0.0
adamb101,Buster Adams,Philadelphia Phillies,PHILS,1,1,2,3,1945,1945,0,2.98,0.82,-2.16,221,207,-14,855,882,27,0.0,0.0,0.0,0.0,0.0,0.0
adamb103,Bobby Adams,Chicago White Sox,WSOX,1,1,1,2,1955,1955,0,0.22,0.0,-0.22,41,0,-41,143,0,-143,0.0,0.0,0.0,0.0,16000.0,16000.0
adamb106,Jack Adams,New York Giants,GIANTS,1,3,1,4,1915,1915,0,8.83,1.16,-7.67,856,106,-750,2811,431,-2380,1477.0,0.0,-1477.0,0.0,0.0,0.0
adamc002,Chance Adams,New York Yankees,YANKS,1,1,1,2,2019,2019,0,-0.19,0.0,0.19,6,0,-6,0,0,0,26.0,0.0,-26.0,556725.0,0.0,-556725.0
adamh101,Herb Adams,Houston,Houston,1,2,1,3,1959,1959,0,0.0,0.0,0.0,0,0,0,0,0,0,0.0,0.0,0.0,0.0,0.0,0.0
adamj001,Joel Adamson,Philadelphia Phillies,PHILS,1,2,1,3,1992,1994,2,-0.36,6.59,6.95,27,115,88,0,149,149,41.0,1169.0,1128.0,0.0,0.0,0.0
adamj001,Joel Adamson,Florida Marlins,MARLNS,1,1,1,2,1996,1996,0,0.84,0.0,-0.84,34,0,-34,3,0,-3,229.0,0.0,-229.0,0.0,0.0,0.0
adamj002,Jason Adam,Kansas City Royals,ROYALS,1,1,1,2,2014,2014,0,0.0,0.18,0.18,0,24,24,0,86,86,0.0,0.0,0.0,0.0,7000000.0,7000000.0
adamm001,Mike Adams,Milwaukee Brewers,BREWRS,1,1,1,2,2006,2006,0,0.0,-0.65,-0.65,0,40,40,0,5,5,0.0,126.0,126.0,0.0,0.0,0.0
adamm001,Mike Adams,Cleveland Indians,INDINS,1,1,1,2,2006,2007,1,6.42,0.16,-6.26,406,17,-389,2,0,-2,651.0,59.0,-592.0,0.0,0.0,0.0
adamm001,Mike Adams,San Diego Padres,PADRS,3,6,6,12,2011,2019,8,10.84,-0.18,-11.02,776,478,-298,2593,1171,-1422,260.0,1056.0,796.0,3828600.0,21000000.0,17171400.0
adamm002,Matt Adams,St. Louis Cardinals,CARDS,1,2,1,3,2017,2017,0,-0.02,0.0,0.02,116,0,-116,365,0,-365,0.0,0.0,0.0,0.0,0.0,0.0
adamm102,Mike Adams,Detroit Tigers,TIGRS,1,2,1,3,1971,1971,0,0.24,-0.53,-0.77,58,32,-26,90,4,-86,0.0,95.0,95.0,0.0,0.0,0.0
adamm102,Mike Adams,Minnesota Twins,TWINS,1,1,1,2,1974,1974,0,-0.22,0.0,0.22,27,0,-27,40,0,-40,0.0,0.0,0.0,0.0,0.0,0.0
adamr004,Riley Adams,Toronto Blue Jays,BJAYS,1,1,1,2,2021,2021,0,0.89,-0.62,-1.51,35,12,-23,90,0,-90,0.0,26.0,26.0,0.0,10500000.0,10500000.0
adams101,Sparky Adams,Chicago Cubs,CUBS,1,2,1,3,1927,1935,8,1.8,26.3,24.5,269,949,680,1048,4196,3148,0.0,0.0,0.0,15500.0,11000.0,-4500.0
adams101,Sparky Adams,St. Louis Cardinals,CARDS,2,4,7,11,1933,1941,8,35.44,3.4,-32.04,1483,791,-692,3153,2855,-298,8479.0,390.0,-8089.0,10000.0,10000.0,0.0
adams101,Sparky Adams,St. Louis Cardinals,CARDS,1,3,1,4,1921,1921,0,0.0,-0.04,-0.04,0,22,22,0,57,57,0.0,0.0,0.0,0.0,0.0,0.0
adams101,Sparky Adams,WichitaFalls,WichitaFalls,1,1,2,3,1922,1922,0,12.04,0.0,-12.04,672,0,-672,2968,0,-2968,0.0,0.0,0.0,0.0,0.0,0.0
adams102,Spencer Adams,St.Louis Browns,ORLS,23,46,52,98,1927,1952,25,139.77,131.99,-7.78,6854,9855,3001,22708,32907,10199,12609.0,15510.0,2901.0,218500.0,207450.0,-11050.0
adams102,Spencer Adams,Seattle,Seattle,2,3,5,8,1922,1925,3,11.84,0.0,-11.84,653,0,-653,687,0,-687,5104.0,0.0,-5104.0,0.0,7000.0,7000.0
adamt001,Terry Adams,Chicago Cubs,CUBS,2,4,5,9,1999,2002,3,1.82,4.66,2.84,231,348,117,64,1392,1328,872.0,299.0,-573.0,6473500.0,8775000.0,2301500.0
adamt001,Terry Adams,Toronto Blue Jays,BJAYS,1,1,1,2,2004,2007,3,-0.09,0.29,0.38,19,13,-6,0,29,29,81.0,0.0,-81.0,1700000.0,0.0,-1700000.0
adamw002,Willy Adames,Detroit Tigers,TIGRS,3,5,5,10,2014,2021,7,13.54,10.17,-3.37,428,201,-227,1262,19,-1243,1153.0,2223.0,1070.0,29745000.0,14508700.0,-15236300.0
adamw002,Willy Adames,Tampa Bay Devil Rays,RAYS,1,2,2,4,2021,2021,0,3.81,2.17,-1.64,129,60,-69,414,3,-411,59.0,287.0,228.0,0.0,0.0,0.0
adcoj101,Joe Adcock,Cincinnati Reds,REDS,1,1,2,3,1953,1957,4,26.58,0.53,-26.05,1207,346,-861,4697,754,-3943,0.0,0.0,0.0,0.0,0.0,0.0
adcoj101,Joe Adcock,Milwaukee Braves,BRAVES,3,5,6,11,1962,1966,4,-0.69,3.0,3.69,105,383,278,317,708,391,15.0,0.0,-15.0,0.0,0.0,0.0
adcoj101,Joe Adcock,Cleveland Indians,INDINS,9,16,15,31,1963,1978,15,26.81,13.21,-13.6,2236,1670,-566,5404,5743,339,2936.0,1183.0,-1753.0,115500.0,141500.0,26000.0
adcon001,Nathan Adcock,Seattle Mariners,MARNRS,2,6,3,9,2009,2011,2,-0.04,2.82,2.86,447,179,-268,1426,514,-912,0.0,332.0,332.0,5822500.0,10600000.0,4777500.0
addib101,Bob Addis,Brooklyn Dodgers,DOGRS,1,2,3,5,1949,1949,0,8.82,0.0,-8.82,541,0,-541,2215,0,-2215,0.0,0.0,0.0,0.0,0.0,0.0
addib101,Bob Addis,Boston Braves,BRAVES,1,1,1,2,1951,1951,0,0.91,0.0,-0.91,103,0,-103,331,0,-331,0.0,0.0,0.0,6600.0,4800.0,-1800.0
addib101,Bob Addis,Chicago Cubs,CUBS,7,18,16,34,1953,1965,12,5.64,21.93,16.29,1405,1825,420,3839,2173,-1666,1451.0,4951.0,3500.0,82000.0,75000.0,-7000.0
adduj001,Jim Adduci,St. Louis Cardinals,CARDS,1,2,3,5,1984,1984,0,0.51,0.0,-0.51,168,0,-168,529,0,-529,0.0,0.0,0.0,0.0,0.0,0.0
aderm101,Morrie Aderholt,Washington Senators,TWINS,1,1,1,2,1943,1950,7,-0.33,-0.38,-0.05,56,165,109,126,573,447,0.0,0.0,0.0,0.0,0.0,0.0
adkij001,Jon Adkins,Oakland Athletics,ATLTCS,1,1,2,3,2002,2002,0,0.09,1.21,1.12,62,54,-8,0,248,248,239.0,0.0,-239.0,0.0,6300000.0,6300000.0
adkij001,Jon Adkins,San Diego Padres,PADRS,2,3,4,7,2006,2011,5,-1.25,8.23,9.48,114,791,677,30,16,-14,85.0,1373.0,1288.0,327500.0,0.0,-327500.0
adkis001,Steve Adkins,New York Yankees,YANKS,1,1,1,2,1991,1991,0,0.0,0.0,0.0,0,0,0,0,0,0,0.0,0.0,0.0,0.0,0.0,0.0
adled101,Dave Adlesh,Houston Astros,ASTROS,2,5,3,8,1968,1968,0,1.27,0.0,-1.27,405,0,-405,1102,0,-1102,299.0,0.0,-299.0,0.0,0.0,0.0
adled101,Dave Adlesh,St. Louis Cardinals,CARDS,2,2,2,4,1969,1971,2,0.47,-0.19,-0.66,81,29,-52,123,38,-85,0.0,0.0,0.0,0.0,0.0,0.0
adled101,Dave Adlesh,Atlanta Braves,BRAVES,1,1,1,2,1969,1969,0,0.0,0.0,0.0,0,0,0,0,0,0,0.0,0.0,0.0,0.0,12000.0,12000.0
adled101,Dave Adlesh,California Angels,ANGELS,4,9,9,18,1971,1976,5,0.53,5.03,4.5,382,668,286,431,1911,1480,1134.0,244.0,-890.0,35000.0,131300.0,96300.0
afent001,Troy Afenir,Houston Astros,ASTROS,1,1,1,2,1989,1989,0,-0.28,0.0,0.28,19,0,-19,26,0,-26,0.0,0.0,0.0,0.0,0.0,0.0
affej001,Jeremy Affeldt,Kansas City Royals,ROYALS,1,2,2,4,2006,2009,3,-0.8,0.46,1.26,227,144,-83,3,478,475,305.0,71.0,-234.0,1335500.0,662000.0,-673500.0
agbab001,Benny Agbayani,New York Mets,METS,11,24,26,50,2002,2021,19,23.06,23.68,0.62,980,1702,722,2021,4506,2485,5255.0,3554.0,-1701.0,30731467.0,4325000.0,-26406467.0
ageet101,Tommie Agee,Cleveland Indians,INDINS,3,5,5,10,1965,1968,3,40.72,5.22,-35.5,1111,420,-691,2880,1615,-1265,4479.0,0.0,-4479.0,0.0,25000.0,25000.0
ageet101,Tommie Agee,Chicago White Sox,WSOX,9,20,20,40,1967,1979,12,42.61,39.14,-3.47,3793,2645,-1148,10113,8109,-2004,6603.0,4869.0,-1734.0,267950.0,412200.0,144250.0
ageet101,Tommie Agee,New York Mets,METS,1,1,2,3,1972,1974,2,0.56,-0.15,-0.71,84,8,-76,221,25,-196,0.0,0.0,0.0,0.0,0.0,0.0
ageet101,Tommie Agee,Houston Astros,ASTROS,1,1,2,3,1973,1973,0,0.54,0.18,-0.36,26,9,-17,67,15,-52,0.0,0.0,0.0,0.0,0.0,0.0
ageet101,Tommie Agee,St. Louis Cardinals,CARDS,1,1,1,2,1973,1974,1,0.0,-0.11,-0.11,0,26,26,0,0,0,0.0,34.0,34.0,0.0,0.0,0.0
agual001,Luis Aguayo,Philadelphia Phillies,PHILS,1,1,1,2,1988,1991,3,-0.68,-0.34,0.34,50,6,-44,149,1,-148,0.0,10.0,10.0,375000.0,0.0,-375000.0
aguih101,Hank Aguirre,Cleveland Indians,INDINS,7,13,11,24,1958,1965,7,29.75,2.89,-26.86,2675,596,-2079,5199,1979,-3220,7620.0,347.0,-7273.0,7500.0,10500.0,3000.0
aguih101,Hank Aguirre,Detroit Tigers,TIGRS,1,1,1,2,1968,1968,0,0.95,0.0,-0.95,50,0,-50,3,0,-3,117.0,0.0,-117.0,0.0,0.0,0.0
aguij001,Jesus Aguilar,Milwaukee Brewers,BREWRS,1,1,1,2,2019,2020,1,0.24,-0.56,-0.8,37,18,-19,107,0,-107,0.0,26.0,26.0,637500.0,0.0,-637500.0
aguir001,Rick Aguilera,New York Mets,METS,1,5,1,6,1989,1991,2,34.39,9.58,-24.81,807,164,-643,0,204,204,6852.0,1699.0,-5153.0,378000.0,2766666.0,2388666.0
aguir001,Rick Aguilera,Minnesota Twins,TWINS,1,1,2,3,1995,1999,4,1.05,2.15,1.1,30,120,90,0,1,1,91.0,1528.0,1437.0,4350000.0,109000.0,-4241000.0
aguir001,Rick Aguilera,Minnesota Twins,TWINS,2,3,3,6,1999,2006,7,2.68,7.1,4.42,288,208,-80,99,24,-75,1148.0,2925.0,1777.0,8250000.0,0.0,-8250000.0
ahmen001,Nick Ahmed,Atlanta Braves,BRAVES,4,10,11,21,2013,2019,6,22.68,8.16,-14.52,2194,1203,-991,6430,4358,-2072,1394.0,147.0,-1247.0,14250000.0,0.0,-14250000.0
aikew001,Willie Aikens,California Angels,ANGELS,4,5,7,12,1979,1983,4,17.81,3.93,-13.88,1525,241,-1284,5870,846,-5024,0.0,43.0,43.0,0.0,0.0,0.0
aikew001,Willie Aikens,Kansas City Royals,ROYALS,1,1,1,2,1983,1986,3,-0.87,1.59,2.46,105,338,233,289,1129,840,0.0,0.0,0.0,0.0,250000.0,250000.0
ainse101,Eddie Ainsmith,Washington Senators,TWINS,3,5,4,9,1919,1933,14,-0.71,14.2,14.91,37,1313,1276,32,5773,5741,106.0,0.0,-106.0,34200.0,0.0,-34200.0
ainse101,Eddie Ainsmith,Boston Red Sox,RSOX,1,3,1,4,1919,1919,0,4.45,1.63,-2.82,567,133,-434,1739,583,-1156,282.0,0.0,-282.0,0.0,0.0,0.0
ainsk001,Kurt Ainsworth,San Francisco Giants,GIANTS,1,3,1,4,2003,2003,0,-1.54,0.88,2.42,20,20,0,0,25,25,251.0,204.0,-47.0,1852000.0,4250000.0,2398000.0
akerb101,Bill Akers,Boston Braves,BRAVES,1,3,1,4,1932,1937,5,0.0,10.04,10.04,0,601,601,0,2506,2506,0.0,0.0,0.0,0.0,0.0,0.0
akerd001,Darrel Akerfelds,Seattle Mariners,MARNRS,1,2,2,4,1983,1987,4,2.3,0.84,-1.46,79,391,312,1,1067,1066,329.0,228.0,-101.0,0.0,0.0,0.0
akerd001,Darrel Akerfelds,Oakland Athletics,ATLTCS,1,2,1,3,1987,1987,0,-0.62,0.31,0.93,21,61,40,12,249,237,224.0,0.0,-224.0,0.0,630000.0,630000.0
akerj101,Jerry Akers,Washington Senators,TWINS,1,3,1,4,1912,1916,4,0.0,13.55,13.55,0,546,546,0,2246,2246,0.0,0.0,0.0,0.0,0.0,0.0
akerj102,Jack Aker,Seattle Pilots,BREWRS,6,9,7,16,1969,1976,7,9.24,16.25,7.01,956,826,-130,2252,2810,558,990.0,497.0,-493.0,176100.0,42000.0,-134100.0
akerj102,Jack Aker,New York Yankees,YANKS,1,1,1,2,1972,1973,1,0.4,-0.69,-1.09,190,137,-53,14,442,428,392.0,0.0,-392.0,0.0,0.0,0.0
albaj001,Jonathan Albaladejo,Washington Nationals,NATEX,3,4,4,8,2007,2019,12,2.72,11.59,8.87,309,1013,704,948,605,-343,294.0,1476.0,1182.0,5000000.0,0.0,-5000000.0
albeb101,Butch Alberts,California Angels,ANGELS,1,2,1,3,1977,1977,0,-0.09,0.0,0.09,9,0,-9,25,0,-25,0.0,0.0,0.0,0.0,0.0,0.0
albem001,Matt Albers,Houston Astros,ASTROS,1,5,1,6,2007,2009,2,11.62,3.81,-7.81,860,316,-544,1797,1340,-457,1330.0,0.0,-1330.0,382000.0,13811415.0,13429415.0
albem001,Matt Albers,Boston Red Sox,RSOX,1,2,1,3,2012,2015,3,0.39,1.0,0.61,46,199,153,0,0,0,63.0,597.0,534.0,1075000.0,1795000.0,720000.0
albem001,Matt Albers,Arizona Diamondbacks,DBACKS,3,6,6,12,2012,2021,9,44.83,10.87,-33.96,1441,607,-834,2691,1018,-1673,5272.0,2512.0,-2760.0,11602833.0,504900.0,-11097933.0
albua001,Al Alburquerque,Chicago Cubs,CUBS,2,2,3,5,2009,2012,3,-0.35,1.63,1.98,15,283,268,37,804,767,0.0,0.0,0.0,1375000.0,415000.0,-960000.0
alcaa001,Arismendy Alcantara,Chicago Cubs,CUBS,1,1,1,2,2016,2016,0,-0.34,0.6,0.94,16,48,32,19,128,109,0.0,0.0,0.0,0.0,0.0,0.0
alcaj001,Jorge Alcala,Houston Astros,ASTROS,1,2,1,3,2018,2018,0,0.45,1.4,0.95,104,28,-76,62,0,-62,256.0,70.0,-186.0,0.0,1600000.0,1600000.0
alcal101,Luis Alcaraz,Kansas City Royals,ROYALS,1,2,1,3,1971,1972,1,0.0,-0.92,-0.92,0,116,116,0,287,287,0.0,0.0,0.0,0.0,0.0,0.0
alcar001,Raul Alcantara,Boston Red Sox,RSOX,1,3,2,5,2011,2013,2,15.82,0.39,-15.43,609,113,-496,2364,219,-2145,139.0,132.0,-7.0,0.0,1865000.0,1865000.0
alcas001,Sandy Alcantara,St. Louis Cardinals,CARDS,1,4,1,5,2017,2019,2,8.96,4.59,-4.37,386,278,-108,632,1177,545,1696.0,0.0,-1696.0,0.0,3500000.0,3500000.0
alcas002,Sergio Alcantara,Arizona Diamondbacks,DBACKS,1,3,1,4,2017,2017,0,-1.37,2.41,3.78,123,62,-61,423,257,-166,0.0,0.0,0.0,0.0,0.0,0.0
alcas101,Santo Alcala,Cincinnati Reds,REDS,2,2,3,5,1977,1981,4,4.46,6.7,2.24,270,473,203,27,1574,1547,1438.0,25.0,-1413.0,0.0,0.0,0.0
alcav001,Victor Alcantara,Anaheim Angels,ANGELS,1,1,1,2,2016,2017,1,1.15,1.49,0.34,87,93,6,0,387,387,240.0,0.0,-240.0,0.0,8000000.0,8000000.0
aldrj001,Jay Aldrich,Milwaukee Brewers,BREWRS,1,1,1,2,1989,1989,0,0.03,-0.38,-0.41,16,15,-1,1,50,49,37.0,0.0,-37.0,0.0,0.0,0.0
aldrm001,Mike Aldrete,San Francisco Giants,GIANTS,2,2,2,4,1988,1989,1,0.15,-0.12,-0.27,268,110,-158,666,278,-388,0.0,0.0,0.0,460000.0,430000.0,-30000.0
aldrm001,Mike Aldrete,Oakland Athletics,ATLTCS,1,1,1,2,1995,1995,0,-0.45,0.0,0.45,49,0,-49,71,0,-71,0.0,0.0,0.0,430000.0,0.0,-430000.0
aldrm001,Mike Aldrete,California Angels,ANGELS,1,1,1,2,1996,1996,0,0.02,-0.12,-0.14,33,12,-21,77,0,-77,3.0,46.0,43.0,250000.0,0.0,-250000.0
aldrs001,Scott Aldred,Tampa Bay Devil Rays,RAYS,1,1,1,2,1999,1999,0,0.33,0.0,-0.33,104,0,-104,1,0,-1,158.0,0.0,-158.0,545000.0,0.0,-545000.0
aldrv101,Vic Aldridge,LosAngeles,LosAngeles,1,2,5,7,1922,1922,0,14.87,0.0,-14.87,633,0,-633,2280,0,-2280,2159.0,0.0,-2159.0,0.0,0.0,0.0
aldrv101,Vic Aldridge,Chicago Cubs,CUBS,1,3,3,6,1924,1926,2,29.39,2.01,-27.38,1120,155,-965,4097,410,-3687,1929.0,802.0,-1127.0,13500.0,18700.0,5200.0
aldrv101,Vic Aldridge,Pittsburgh Pirates,PIRATS,2,2,3,5,1928,1930,2,-1.29,12.5,13.79,66,180,114,61,239,178,505.0,1746.0,1241.0,0.0,0.0,0.0
alexa001,A.J. Alexy,Los Angeles Dodgers,DOGRS,1,3,1,4,2017,2017,0,-1.3,0.52,1.82,240,18,-222,874,20,-854,69.0,149.0,80.0,0.0,11000000.0,11000000.0
alexb101,Bob Alexander,Portland,Portland,1,1,1,2,1954,1954,0,-0.58,0.0,0.58,8,0,-8,0,0,0,12.0,0.0,-12.0,0.0,0.0,0.0
alexb101,Bob Alexander,Chicago Cubs,CUBS,1,1,1,2,1957,1957,0,-0.32,0.0,0.32,10,0,-10,1,0,-1,21.0,0.0,-21.0,0.0,0.0,0.0
alexd001,Doyle Alexander,Los Angeles Dodgers,DOGRS,3,10,5,15,1971,1976,5,18.58,22.72,4.14,838,611,-227,2013,960,-1053,3623.0,2900.0,-723.0,259900.0,282000.0,22100.0
alexd001,Doyle Alexander,Baltimore Orioles,ORLS,4,12,12,24,1976,1988,12,17.24,67.8,50.56,919,3227,2308,801,6729,5928,6521.0,11016.0,4495.0,558333.0,0.0,-558333.0
alexd001,Doyle Alexander,Texas Rangers,RNGRS,2,4,4,8,1979,1981,2,4.64,-2.56,-7.2,264,133,-131,467,246,-221,1400.0,101.0,-1299.0,150000.0,0.0,-150000.0
alexd001,Doyle Alexander,Atlanta Braves,BRAVES,1,1,2,3,1980,1981,1,3.53,0.68,-2.85,48,52,4,58,15,-43,457.0,232.0,-225.0,150000.0,0.0,-150000.0
alexd001,Doyle Alexander,San Francisco Giants,GIANTS,1,1,2,3,1982,1984,2,-1.33,0.77,2.1,24,94,70,0,34,34,285.0,427.0,142.0,0.0,0.0,0.0
alexd001,Doyle Alexander,Toronto Blue Jays,BJAYS,1,1,1,2,1986,1995,9,3.76,10.47,6.71,67,453,386,87,0,-87,705.0,1952.0,1247.0,700000.0,0.0,-700000.0
alexd001,Doyle Alexander,Atlanta Braves,BRAVES,1,1,1,2,1987,2008,21,6.3,69.53,63.23,78,1409,1331,0,1151,1151,1621.0,10185.0,8564.0,650000.0,0.0,-650000.0
alexd101,Dale Alexander,Detroit Tigers,TIGRS,1,2,1,3,1932,1933,1,12.96,0.98,-11.98,710,94,-616,2975,392,-2583,0.0,0.0,0.0,13000.0,7000.0,-6000.0
alexd101,Dale Alexander,Toronto,Toronto,1,2,3,5,1928,1933,5,9.1,0.0,-9.1,535,0,-535,1990,0,-1990,281.0,0.0,-281.0,0.0,8000.0,8000.0
alexg001,Gerald Alexander,Texas Rangers,RNGRS,1,2,1,3,1993,1993,0,0.0,0.0,0.0,0,0,0,0,0,0,0.0,0.0,0.0,0.0,0.0,0.0
alexg101,Gary Alexander,San Francisco Giants,GIANTS,4,14,8,22,1978,1992,14,8.18,23.62,15.44,767,1277,510,1656,1600,-56,2714.0,7759.0,5045.0,0.0,0.0,0.0
alexg101,Gary Alexander,Oakland Athletics,ATLTCS,1,1,1,2,1978,1980,2,0.61,-1.7,-2.31,276,108,-168,978,402,-576,0.0,0.0,0.0,0.0,0.0,0.0
alexg101,Gary Alexander,Cleveland Indians,INDINS,5,10,10,20,1980,2004,24,35.2,53.01,17.81,1530,2520,990,5654,9198,3544,2682.0,3776.0,1094.0,1767500.0,1412500.0,-355000.0
alexg102,Pete Alexander,Philadelphia Phillies,PHILS,5,11,13,24,1917,1929,12,74.14,17.51,-56.63,2587,762,-1825,7576,2068,-5508,10093.0,3446.0,-6647.0,21000.0,24850.0,3850.0
alexg102,Pete Alexander,St. Louis Cardinals,CARDS,1,2,2,4,1929,1932,3,0.24,-1.21,-1.45,299,26,-273,578,77,-501,65.0,0.0,-65.0,7500.0,6000.0,-1500.0
alexm001,Manny Alexander,Baltimore Orioles,ORLS,1,2,1,3,1997,1998,1,0.7,0.0,-0.7,54,0,-54,161,0,-161,0.0,0.0,0.0,0.0,0.0,0.0
alexm001,Manny Alexander,New York Mets,METS,7,15,13,28,1997,2005,8,5.2,5.1,-0.1,1347,1947,600,1609,2988,1379,2422.0,1675.0,-747.0,19588333.0,14951666.0,-4636667.0
alexm001,Manny Alexander,Chicago Cubs,CUBS,1,1,1,2,1999,2001,2,-0.72,0.18,0.9,101,185,84,209,645,436,0.0,0.0,0.0,475000.0,1100000.0,625000.0
alexm001,Manny Alexander,Texas Rangers,RNGRS,1,1,1,2,2005,2005,0,-0.38,0.0,0.38,32,0,-32,60,0,-60,0.0,0.0,0.0,0.0,0.0,0.0
alexm101,Matt Alexander,Chicago Cubs,CUBS,1,1,1,2,1975,1975,0,-1.9,0.0,1.9,214,0,-214,88,0,-88,0.0,0.0,0.0,0.0,0.0,0.0
alexs001,Scott Alexander,Kansas City Royals,ROYALS,1,3,2,5,2018,2021,3,0.86,-0.68,-1.54,242,21,-221,6,43,37,333.0,41.0,-292.0,0.0,0.0,0.0
alfaj002,Jorge Alfaro,Texas Rangers,RNGRS,5,14,16,30,2015,2021,6,11.03,13.28,2.25,790,293,-497,1664,16,-1648,2536.0,2164.0,-372.0,3762500.0,1106250.0,-2656250.0
alfaj002,Jorge Alfaro,Philadelphia Phillies,PHILS,1,4,1,5,2019,2021,2,1.81,9.39,7.58,260,326,66,876,1325,449,117.0,0.0,-117.0,0.0,0.0,0.0
alfoa001,Antonio Alfonseca,Florida Marlins,MARLNS,7,9,16,25,2002,2013,11,71.73,23.4,-48.33,3136,1557,-1579,9615,1244,-8371,3483.0,5887.0,2404.0,18420219.0,799800.0,-17620419.0
alfoe001,Edgardo Alfonzo,San Francisco Giants,GIANTS,1,1,1,2,2005,2006,1,-0.63,1.13,1.76,18,139,121,52,481,429,0.0,0.0,0.0,7500000.0,6000000.0,-1500000.0
alfoe002,Eliezer Alfonzo,St. Louis Cardinals,CARDS,1,3,1,4,2000,2003,3,0.9,5.69,4.79,122,488,366,2,2221,2219,248.0,0.0,-248.0,0.0,0.0,0.0
alicl001,Luis Alicea,St. Louis Cardinals,CARDS,1,1,2,3,1994,1995,1,2.28,0.0,-2.28,132,0,-132,511,0,-511,0.0,0.0,0.0,650000.0,122000.0,-528000.0
allaa001,Andy Allanson,Kansas City Royals,ROYALS,1,1,1,2,1991,1991,0,0.24,0.0,-0.24,60,0,-60,160,0,-160,0.0,0.0,0.0,0.0,0.0,0.0
allab101,Brian Allard,Texas Rangers,RNGRS,4,10,10,20,1980,1987,7,9.35,8.94,-0.41,686,425,-261,1581,631,-950,2721.0,2684.0,-37.0,817500.0,331000.0,-486500.0
allak001,Kolby Allard,Atlanta Braves,BRAVES,1,1,1,2,2019,2021,2,-0.75,1.69,2.44,54,146,92,4,0,-4,611.0,237.0,-374.0,0.0,2250000.0,2250000.0
allea001,Austin Allen,San Diego Padres,PADRS,1,2,1,3,2019,2021,2,-0.02,1.34,1.36,18,193,175,40,614,574,0.0,0.0,0.0,0.0,3600000.0,3600000.0
alleb001,Brandon Allen,Chicago White Sox,WSOX,1,1,1,2,2009,2011,2,-0.56,0.39,0.95,65,106,41,209,0,-209,0.0,471.0,471.0,0.0,430000.0,430000.0
alleb001,Brandon Allen,Arizona Diamondbacks,DBACKS,2,3,3,6,2011,2016,5,1.57,7.2,5.63,125,680,555,165,7,-158,265.0,1007.0,742.0,0.0,1250000.0,1250000.0
alleb105,Bernie Allen,Minnesota Twins,TWINS,2,3,2,5,1966,1968,2,10.51,0.41,-10.1,831,108,-723,1841,6,-1835,1694.0,215.0,-1479.0,90000.0,0.0,-90000.0
alleb105,Bernie Allen,Texas Rangers,RNGRS,17,39,29,68,1971,1988,17,50.9,56.03,5.13,3324,3490,166,10647,10376,-271,4537.0,8004.0,3467.0,592000.0,355800.0,-236200.0
alled001,Dusty Allen,San Diego Padres,PADRS,1,1,1,2,2000,2000,0,0.34,-0.25,-0.59,18,11,-7,18,14,-4,0.0,0.0,0.0,200000.0,0.0,-200000.0
alled101,Dick Allen,Philadelphia Phillies,PHILS,5,9,11,20,1969,1977,8,2.27,5.62,3.35,374,740,366,889,1587,698,321.0,625.0,304.0,70000.0,163500.0,93500.0
alled101,Dick Allen,St. Louis Cardinals,CARDS,21,44,39,83,1970,1994,24,95.99,150.49,54.5,8773,7536,-1237,24631,26296,1665,10540.0,4019.0,-6521.0,3173333.0,832667.0,-2340666.0
alled101,Dick Allen,Los Angeles Dodgers,DOGRS,1,1,2,3,1971,1978,7,15.35,14.16,-1.19,348,364,16,1422,463,-959,0.0,3594.0,3594.0,125000.0,58750.0,-66250.0
alled101,Dick Allen,Chicago White Sox,WSOX,2,3,3,6,1974,1979,5,6.89,4.63,-2.26,401,220,-181,1175,610,-565,453.0,189.0,-264.0,200000.0,0.0,-200000.0
alled101,Dick Allen,Atlanta Braves,BRAVES,3,7,6,13,1975,1986,11,13.14,5.38,-7.76,1203,1387,184,3551,4502,951,1023.0,3.0,-1020.0,0.0,0.0,0.0
allee101,Ethan Allen,Cincinnati Reds,REDS,4,9,4,13,1930,1932,2,-0.65,6.36,7.01,300,397,97,801,1584,783,303.0,0.0,-303.0,27500.0,0.0,-27500.0
allee101,Ethan Allen,New York Giants,GIANTS,3,11,6,17,1932,1949,17,15.21,55.77,40.56,1303,2528,1225,3690,9780,6090,2269.0,40.0,-2229.0,0.0,0.0,0.0
allee101,Ethan Allen,Philadelphia Phillies,PHILS,1,2,2,4,1936,1939,3,4.25,4.0,-0.25,195,450,255,507,1597,1090,830.0,231.0,-599.0,0.0,0.0,0.0
allef101,Frank Allen,Detroit Tigers,TIGRS,1,3,1,4,1909,1909,0,0.0,-0.16,-0.16,0,8,8,0,8,8,0.0,60.0,60.0,0.0,0.0,0.0
alleg002,Greg Allen,Cleveland Indians,INDINS,1,3,6,9,2020,2020,0,0.62,-0.12,-0.74,5,36,31,4,78,74,57.0,44.0,-13.0,4100000.0,3000000.0,-1100000.0
alleg002,Greg Allen,San Diego Padres,PADRS,1,1,1,2,2021,2021,0,0.42,0.0,-0.42,15,0,-15,48,0,-48,0.0,0.0,0.0,0.0,0.0,0.0
alleh104,Hank Allen,Washington Senators,RNGRS,1,2,1,3,1970,1970,0,4.46,0.11,-4.35,279,77,-202,994,154,-840,0.0,0.0,0.0,19000.0,0.0,-19000.0
alleh104,Hank Allen,Milwaukee Brewers,BREWRS,1,3,1,4,1970,1971,1,0.0,0.0,0.0,0,0,0,0,0,0,0.0,0.0,0.0,0.0,0.0,0.0
allej001,Jermaine Allensworth,Pittsburgh Pirates,PIRATS,1,1,1,2,1998,1998,0,0.02,0.0,-0.02,30,0,-30,91,0,-91,0.0,0.0,0.0,260000.0,0.0,-260000.0
allej001,Jermaine Allensworth,Kansas City Royals,ROYALS,1,1,1,2,1998,1998,0,-0.35,0.0,0.35,74,0,-74,143,0,-143,0.0,0.0,0.0,0.0,0.0,0.0
allej001,Jermaine Allensworth,New York Mets,METS,1,1,1,2,1999,2000,1,0.0,-0.02,-0.02,0,48,48,0,92,92,0.0,0.0,0.0,284000.0,0.0,-284000.0
allej102,Johnny Allen,New York Yankees,YANKS,2,2,4,6,1935,1942,7,18.6,14.33,-4.27,322,396,74,390,481,91,2862.0,3424.0,562.0,13500.0,0.0,-13500.0
allej102,Johnny Allen,Brooklyn Dodgers,DOGRS,1,2,1,3,1942,1942,0,0.0,0.0,0.0,0,0,0,0,0,0,0.0,0.0,0.0,0.0,0.0,0.0
allej102,Johnny Allen,Brooklyn Dodgers,DOGRS,3,7,5,12,1943,1947,4,-0.39,6.32,6.71,76,587,511,39,2174,2135,380.0,123.0,-257.0,0.0,0.0,0.0
allel001,Luke Allen,Los Angeles Dodgers,DOGRS,3,4,3,7,2003,2017,14,0.93,22.0,21.07,178,1603,1425,599,5763,5164,0.0,0.0,0.0,2830000.0,0.0,-2830000.0
allel002,Logan Allen,Boston Red Sox,RSOX,1,4,1,5,2015,2018,3,5.44,6.73,1.29,670,203,-467,2136,0,-2136,153.0,553.0,400.0,0.0,9000000.0,9000000.0
allel002,Logan Allen,San Diego Padres,PADRS,2,7,4,11,2019,2021,2,6.96,0.42,-6.54,597,36,-561,2267,75,-2192,192.0,42.0,-150.0,570500.0,0.0,-570500.0
allel101,Lloyd Allen,California Angels,ANGELS,3,4,5,9,1973,1975,2,-0.57,1.96,2.53,414,169,-245,1273,459,-814,189.0,261.0,72.0,0.0,130000.0,130000.0
allen001,Neil Allen,New York Mets,METS,1,2,1,3,1983,1989,6,-0.78,26.61,27.39,253,880,627,88,3684,3596,994.0,0.0,-994.0,0.0,0.0,0.0
allen001,Neil Allen,New York Yankees,YANKS,4,10,9,19,1986,1992,6,2.03,5.24,3.21,652,1255,603,1902,3999,2097,488.0,0.0,-488.0,400873.0,475000.0,74127.0
aller001,Rod Allen,Chicago White Sox,WSOX,6,11,9,20,1981,1994,13,14.41,9.4,-5.01,691,899,208,1049,2235,1186,4103.0,4503.0,400.0,1513333.0,147500.0,-1365833.0
aller001,Rod Allen,Detroit Tigers,TIGRS,1,1,1,2,1985,1985,0,0.0,0.0,0.0,0,0,0,0,0,0,0.0,0.0,0.0,0.0,0.0,0.0
aller101,Ron Allen,Philadelphia Phillies,PHILS,2,2,2,4,1970,1972,2,0.0,0.23,0.23,0,44,44,0,77,77,0.0,0.0,0.0,0.0,0.0,0.0
aller101,Ron Allen,New York Mets,METS,1,1,1,2,1971,1971,0,-0.16,0.0,0.16,7,0,-7,14,0,-14,0.0,0.0,0.0,0.0,0.0,0.0
allim102,Mack Allison,St.Louis Browns,ORLS,1,4,1,5,1913,1916,3,0.0,8.53,8.53,0,318,318,0,1249,1249,0.0,0.0,0.0,3200.0,0.0,-3200.0
almaa001,Armando Almanza,St. Louis Cardinals,CARDS,1,3,1,4,1998,2004,6,3.02,16.68,13.66,1222,903,-319,88,3759,3671,1761.0,0.0,-1761.0,170000.0,255000.0,85000.0
almac001,Carlos Almanzar,Toronto Blue Jays,BJAYS,1,3,1,4,1998,2001,3,7.56,0.33,-7.23,451,52,-399,328,5,-323,2800.0,760.0,-2040.0,1787500.0,3250000.0,1462500.0
almac001,Carlos Almanzar,San Diego Padres,PADRS,1,1,1,2,2001,2001,0,0.25,0.68,0.43,11,79,68,0,1,1,32.0,146.0,114.0,0.0,0.0,0.0
almam101,Mel Almada,Boston Red Sox,RSOX,3,7,5,12,1937,1940,3,25.02,12.69,-12.33,1633,702,-931,5994,2554,-3440,2353.0,1424.0,-929.0,33500.0,42500.0,9000.0
almam101,Mel Almada,Washington Senators,TWINS,1,1,1,2,1938,1942,4,0.82,4.51,3.69,144,290,146,624,1024,400,0.0,0.0,0.0,7000.0,0.0,-7000.0
almoa001,Abraham Almonte,New York Yankees,YANKS,3,3,3,6,2013,2017,4,1.25,-0.52,-1.77,202,132,-70,196,0,-196,240.0,354.0,114.0,1765000.0,0.0,-1765000.0
almoa001,Abraham Almonte,Seattle Mariners,MARNRS,1,2,1,3,2014,2014,0,0.26,-0.18,-0.44,70,32,-38,182,90,-92,0.0,0.0,0.0,0.0,2250000.0,2250000.0
almoa001,Abraham Almonte,San Diego Padres,PADRS,5,6,9,15,2015,2021,6,7.93,1.78,-6.15,582,405,-177,1491,448,-1043,1057.0,783.0,-274.0,1650000.0,17468125.0,15818125.0
almob001,Bill Almon,San Diego Padres,PADRS,1,2,1,3,1979,1981,2,-0.61,-0.55,0.06,27,130,103,51,437,386,0.0,0.0,0.0,0.0,300000.0,300000.0
almob001,Bill Almon,Pittsburgh Pirates,PIRATS,1,1,2,3,1987,1988,1,0.12,0.96,0.84,49,138,89,62,411,349,0.0,0.0,0.0,250000.0,0.0,-250000.0
almob001,Bill Almon,New York Mets,METS,1,1,2,3,1988,1990,2,-0.19,0.0,0.19,20,0,-20,31,0,-31,0.0,0.0,0.0,0.0,0.0,0.0
almoe002,Edwin Almonte,Chicago White Sox,WSOX,1,3,2,5,2003,2003,0,-0.24,0.07,0.31,72,67,-5,1,296,295,104.0,0.0,-104.0,0.0,8000000.0,8000000.0
almom001,Miguel Almonte,Kansas City Royals,ROYALS,1,1,1,2,2018,2018,0,-0.24,0.0,0.24,8,0,-8,0,0,0,21.0,0.0,-21.0,0.0,0.0,0.0
almoy001,Yency Almonte,Anaheim Angels,ANGELS,1,1,1,2,2015,2020,5,0.0,0.0,0.0,0,0,0,0,0,0,0.0,0.0,0.0,0.0,2000000.0,2000000.0
almoy001,Yency Almonte,Chicago White Sox,WSOX,3,5,6,11,2015,2017,2,4.1,2.11,-1.99,528,83,-445,250,0,-250,1065.0,220.0,-845.0,12535000.0,6150000.0,-6385000.0
aloml101,Luis Aloma,Detroit Tigers,TIGRS,1,1,1,2,1949,1949,0,4.52,0.0,-4.52,232,0,-232,51,0,-51,705.0,0.0,-705.0,0.0,9600.0,9600.0
alomr001,Roberto Alomar,San Diego Padres,PADRS,6,11,15,26,1990,1998,8,43.43,14.07,-29.36,3426,1340,-2086,13331,3496,-9835,1355.0,1888.0,533.0,8656667.0,3185000.0,-5471667.0
alomr001,Roberto Alomar,Cleveland Indians,INDINS,3,5,7,12,2001,2008,7,0.76,6.93,6.17,461,824,363,1426,2856,1430,357.0,576.0,219.0,15000000.0,0.0,-15000000.0
alomr001,Roberto Alomar,New York Mets,METS,2,4,5,9,2003,2008,5,7.82,-0.41,-8.23,808,83,-725,363,31,-332,1167.0,107.0,-1060.0,8000000.0,327500.0,-7672500.0
alomr001,Roberto Alomar,Arizona Diamondbacks,DBACKS,1,1,1,2,2004,2005,1,-0.8,0.0,0.8,18,0,-18,65,0,-65,0.0,0.0,0.0,1000000.0,0.0,-1000000.0
aloms001,Sandy Alomar,San Diego Padres,PADRS,7,14,16,30,1989,1998,9,77.02,12.33,-64.69,5607,1502,-4105,22003,4193,-17810,1355.0,1888.0,533.0,8656667.0,4815000.0,-3841667.0
aloms001,Sandy Alomar,Chicago White Sox,WSOX,1,1,1,2,2002,2002,0,-0.19,0.0,0.19,38,0,-38,120,0,-120,0.0,0.0,0.0,2500000.0,0.0,-2500000.0
aloms001,Sandy Alomar,Los Angeles Dodgers,DOGRS,1,1,1,2,2006,2006,0,0.01,0.0,-0.01,19,0,-19,51,0,-51,0.0,0.0,0.0,650000.0,0.0,-650000.0
aloms101,Sandy Alomar,Atlanta Braves,BRAVES,1,3,2,5,1966,1968,2,0.94,-0.28,-1.22,101,10,-91,383,29,-354,0.0,0.0,0.0,0.0,0.0,0.0
aloms101,Sandy Alomar,Houston Astros,ASTROS,2,3,3,6,1967,1972,5,-0.13,-3.37,-3.24,209,234,25,39,135,96,428.0,1228.0,800.0,0.0,0.0,0.0
aloms101,Sandy Alomar,New York Mets,METS,2,3,3,6,1967,1970,3,-1.49,0.67,2.16,346,144,-202,991,467,-524,0.0,0.0,0.0,55000.0,20000.0,-35000.0
aloms101,Sandy Alomar,Chicago White Sox,WSOX,2,3,3,6,1969,1971,2,9.0,0.38,-8.62,941,234,-707,3605,831,-2774,79.0,0.0,-79.0,15500.0,0.0,-15500.0
aloms101,Sandy Alomar,New York Yankees,YANKS,1,1,3,4,1977,1980,3,-0.56,-0.74,-0.18,93,93,0,128,171,43,0.0,0.0,0.0,0.0,0.0,0.0
alony001,Yonder Alonso,Cincinnati Reds,REDS,2,5,3,8,2011,2020,9,8.75,14.41,5.66,882,376,-506,2596,411,-2185,1389.0,3437.0,2048.0,9475000.0,460700.0,-9014300.0
alony001,Yonder Alonso,San Diego Padres,PADRS,4,5,8,13,2015,2021,6,6.15,2.58,-3.57,395,351,-44,906,448,-458,1057.0,739.0,-318.0,1650000.0,15068125.0,13418125.0
alony001,Yonder Alonso,Oakland Athletics,ATLTCS,1,1,1,2,2017,2018,1,0.38,0.63,0.25,42,36,-6,150,117,-33,0.0,0.0,0.0,4000000.0,0.0,-4000000.0
alony001,Yonder Alonso,Cleveland Indians,INDINS,1,1,1,2,2018,2018,0,-1.03,0.0,1.03,67,0,-67,251,0,-251,0.0,0.0,0.0,7000000.0,0.0,-7000000.0
alouf101,Felipe Alou,San Francisco Giants,GIANTS,8,14,12,26,1963,1972,9,20.6,12.56,-8.04,1709,1303,-406,5210,1731,-3479,1169.0,4789.0,3620.0,50000.0,89000.0,39000.0
alouf101,Felipe Alou,Atlanta Braves,BRAVES,3,4,4,8,1969,1973,4,5.9,-0.55,-6.45,463,248,-215,1622,157,-1465,168.0,1238.0,1070.0,60000.0,21000.0,-39000.0
alouf101,Felipe Alou,Oakland Athletics,ATLTCS,3,6,4,10,1971,1972,1,0.83,1.09,0.26,472,138,-334,1300,198,-1102,313.0,159.0,-154.0,33250.0,36000.0,2750.0
alouj101,Jesus Alou,Montreal Expos,NATEX,6,9,10,19,1969,1985,16,41.28,49.25,7.97,3185,3689,504,11568,12567,999,812.0,1543.0,731.0,243500.0,237000.0,-6500.0
aloum001,Moises Alou,Pittsburgh Pirates,PIRATS,1,3,1,4,1990,1994,4,13.0,10.16,-2.84,782,221,-561,2388,261,-2127,274.0,2055.0,1781.0,200000.0,860000.0,660000.0
aloum001,Moises Alou,Florida Marlins,MARLNS,18,38,43,81,1997,2019,22,128.34,108.22,-20.12,5126,6567,1441,17202,20483,3281,10556.0,10228.0,-328.0,73250667.0,35694968.0,-37555699.0
aloum101,Matty Alou,San Francisco Giants,GIANTS,2,2,3,5,1965,1969,4,17.69,1.65,-16.04,895,234,-661,3234,46,-3188,277.0,702.0,425.0,0.0,0.0,0.0
aloum101,Matty Alou,Pittsburgh Pirates,PIRATS,4,6,8,14,1971,1978,7,4.65,9.98,5.33,393,854,461,1279,1834,555,673.0,1651.0,978.0,94500.0,49000.0,-45500.0
aloum101,Matty Alou,St. Louis Cardinals,CARDS,2,2,3,5,1972,1972,0,0.47,-0.1,-0.57,32,11,-21,136,18,-118,0.0,0.0,0.0,0.0,0.0,0.0
aloum101,Matty Alou,Oakland Athletics,ATLTCS,1,1,2,3,1972,1973,1,1.39,-0.06,-1.45,123,3,-120,538,0,-538,0.0,22.0,22.0,100000.0,35500.0,-64500.0
alstd101,Dell Alston,New York Yankees,YANKS,8,15,13,28,1978,1992,14,6.29,14.79,8.5,1596,742,-854,3686,2169,-1517,2564.0,669.0,-1895.0,913333.0,1045000.0,131667.0
alstt101,Tom Alston,SanDiego,SanDiego,1,1,3,4,1954,1954,0,-0.23,0.0,0.23,91,0,-91,299,0,-299,0.0,0.0,0.0,0.0,0.0,0.0
altad001,Dan Altavilla,Seattle Mariners,MARNRS,1,3,4,7,2020,2020,0,1.48,0.43,-1.05,218,41,-177,269,159,-110,200.0,0.0,-200.0,0.0,0.0,0.0
altap001,Porfi Altamirano,Philadelphia Phillies,PHILS,3,6,4,10,1984,1986,2,8.36,-0.43,-8.79,1292,232,-1060,3847,16,-3831,227.0,557.0,330.0,0.0,0.0,0.0
altap001,Porfi Altamirano,Chicago Cubs,CUBS,2,7,4,11,1984,1987,3,2.88,0.38,-2.5,447,379,-68,818,354,-464,766.0,789.0,23.0,873333.0,878000.0,4667.0
altmg101,George Altman,Chicago Cubs,CUBS,16,27,26,53,1962,1982,20,54.43,129.03,74.6,2307,6354,4047,4353,15923,11570,10563.0,16087.0,5524.0,552500.0,88500.0,-464000.0
altmg101,George Altman,St. Louis Cardinals,CARDS,2,4,2,6,1963,1966,3,0.61,-0.46,-1.07,354,142,-212,526,97,-429,552.0,871.0,319.0,0.0,0.0,0.0
altmg101,George Altman,New York Mets,METS,4,6,5,11,1965,1968,3,-2.95,-0.74,2.21,496,87,-409,1178,167,-1011,0.0,0.0,0.0,11000.0,0.0,-11000.0
altoj101,Joe Altobelli,Toronto,Toronto,1,1,1,2,1960,1960,0,0.0,0.0,0.0,0,0,0,0,0,0,0.0,0.0,0.0,0.0,0.0,0.0
altoj101,Joe Altobelli,Los Angeles Dodgers,DOGRS,1,2,2,4,1961,1961,0,-0.97,0.0,0.97,59,0,-59,114,0,-114,63.0,0.0,-63.0,0.0,0.0,0.0
altrn101,Nick Altrock,Chicago White Sox,WSOX,1,3,1,4,1909,1910,1,-0.91,1.19,2.1,140,48,-92,366,63,-303,237.0,502.0,265.0,2400.0,3500.0,1100.0
alusg101,George Alusik,Kansas City Athletics,ATLTCS,1,1,1,2,1965,1965,0,0.0,0.0,0.0,0,0,0,0,0,0,0.0,0.0,0.0,0.0,0.0,0.0
alvad001,Dario Alvarez,Atlanta Braves,BRAVES,2,4,2,6,2016,2021,5,-1.23,0.82,2.05,102,117,15,219,0,-219,140.0,208.0,68.0,0.0,4000000.0,4000000.0
alvag001,Gabe Alvarez,Arizona Diamondbacks,DBACKS,2,6,2,8,1997,2003,6,6.66,8.29,1.63,875,595,-280,3219,2462,-757,172.0,0.0,-172.0,0.0,13550000.0,13550000.0
alvag001,Gabe Alvarez,Detroit Tigers,TIGRS,1,1,1,2,2000,2000,0,-0.25,0.34,0.59,11,18,7,14,18,4,0.0,0.0,0.0,0.0,200000.0,200000.0
alvah001,Henderson Alvarez,Toronto Blue Jays,BJAYS,3,15,11,26,2012,2018,6,24.75,21.38,-3.37,2099,1087,-1012,5739,3162,-2577,4668.0,4579.0,-89.0,8732900.0,43179800.0,34446900.0
alvaj001,Jose Alvarez,Atlanta Braves,BRAVES,2,2,2,4,1984,1984,0,0.14,0.0,-0.14,70,0,-70,5,0,-5,155.0,0.0,-155.0,0.0,0.0,0.0
alvaj003,Jose Alvarez,Boston Red Sox,RSOX,1,2,1,3,2009,2010,1,0.08,-0.48,-0.56,6,52,46,0,171,171,5.0,0.0,-5.0,400000.0,2250000.0,1850000.0
alvaj003,Jose Alvarez,Detroit Tigers,TIGRS,1,1,1,2,2014,2017,3,2.37,0.81,-1.56,286,439,153,1,1018,1017,710.0,8.0,-702.0,0.0,0.0,0.0
alvaj003,Jose Alvarez,Anaheim Angels,ANGELS,1,1,1,2,2018,2019,1,1.13,0.16,-0.97,137,69,-68,0,0,0,196.0,186.0,-10.0,1050000.0,1200000.0,150000.0
alvaj004,Jose Alvarado,Tampa Bay Devil Rays,RAYS,1,1,2,3,2020,2020,0,0.33,0.0,-0.33,123,0,-123,0,0,0,167.0,0.0,-167.0,0.0,0.0,0.0
alval101,Luis Alvarado,Boston Red Sox,RSOX,1,2,1,3,1970,1974,4,-1.93,4.15,6.08,599,367,-232,1963,1576,-387,0.0,0.0,0.0,69000.0,38000.0,-31000.0
alval101,Luis Alvarado,Chicago White Sox,WSOX,1,1,1,2,1974,1974,0,-0.35,0.12,0.47,33,11,-22,85,1,-84,0.0,62.0,62.0,20000.0,0.0,-20000.0
alval101,Luis Alvarado,St. Louis Cardinals,CARDS,5,7,6,13,1974,1977,3,-2.01,-0.59,1.42,565,81,-484,1331,100,-1231,66.0,23.0,-43.0,0.0,0.0,0.0
alval101,Luis Alvarado,Cleveland Indians,INDINS,2,3,2,5,1975,1978,3,1.75,-1.29,-3.04,221,75,-146,802,99,-703,0.0,442.0,442.0,0.0,0.0,0.0
alvao101,Ossie Alvarez,Washington Senators,TWINS,1,1,1,2,1958,1959,1,0.0,-0.32,-0.32,0,37,37,0,121,121,0.0,0.0,0.0,0.0,0.0,0.0
alvao101,Ossie Alvarez,Cleveland Indians,INDINS,4,8,7,15,1958,1965,7,18.0,1.46,-16.54,1595,479,-1116,4009,1716,-2293,3556.0,132.0,-3424.0,7500.0,10500.0,3000.0
alvao102,Orlando Alvarez,Los Angeles Dodgers,DOGRS,1,2,1,3,1976,1977,1,-0.34,0.1,0.44,15,36,21,42,90,48,0.0,0.0,0.0,0.0,0.0,0.0
alvar001,R.J. Alvarez,Anaheim Angels,ANGELS,2,6,4,10,2014,2017,3,-0.93,3.94,4.87,94,402,308,26,948,922,108.0,488.0,380.0,0.0,12000000.0,12000000.0
alvar001,R.J. Alvarez,San Diego Padres,PADRS,2,3,4,7,2014,2019,5,-0.29,3.01,3.3,62,274,212,4,1017,1013,698.0,16.0,-682.0,2925000.0,505000.0,-2420000.0
alvar101,Rogelio Alvarez,Cincinnati Reds,REDS,1,1,1,2,1962,1963,1,0.0,-0.03,-0.03,0,1,1,0,1,1,0.0,0.0,0.0,0.0,0.0,0.0
alvaw001,Wilson Alvarez,Texas Rangers,RNGRS,3,5,6,11,1989,1992,3,24.82,3.73,-21.09,1170,237,-933,3620,767,-2853,3192.0,327.0,-2865.0,2411539.0,192500.0,-2219039.0
alvaw001,Wilson Alvarez,Chicago White Sox,WSOX,7,14,18,32,1997,2011,14,8.23,24.04,15.81,946,1419,473,129,1458,1329,2956.0,3428.0,472.0,22052500.0,11583333.0,-10469167.0
alvay001,Yordan Alvarez,Los Angeles Dodgers,DOGRS,1,1,1,2,2016,2019,3,6.87,1.94,-4.93,233,245,12,976,1,-975,0.0,352.0,352.0,0.0,900000.0,900000.0
alvim101,Max Alvis,Cleveland Indians,INDINS,7,13,13,26,1970,1978,8,23.54,10.24,-13.3,1728,850,-878,4111,2770,-1341,2427.0,1183.0,-1244.0,83000.0,120000.0,37000.0
alvob101,Billy Alvord,Toledo,Toledo,1,1,1,2,1889,1889,0,-0.4,0.0,0.4,50,0,-50,196,0,-196,0.0,0.0,0.0,0.0,0.0,0.0
alyeb101,Brant Alyea,Washington Senators,RNGRS,13,25,24,49,1970,1986,16,55.11,26.78,-28.33,3093,1935,-1158,6211,4741,-1470,9904.0,4628.0,-5276.0,229000.0,387000.0,158000.0
alyeb101,Brant Alyea,Oakland Athletics,ATLTCS,3,5,4,9,1972,1975,3,-3.4,1.69,5.09,461,363,-98,1348,687,-661,48.0,183.0,135.0,66000.0,0.0,-66000.0
alyeb101,Brant Alyea,Oakland Athletics,ATLTCS,1,2,1,3,1972,1977,5,0.0,3.91,3.91,0,223,223,0,1,1,0.0,1247.0,1247.0,36400.0,31000.0,-5400.0
amalj101,Joey Amalfitano,Houston Astros,ASTROS,5,9,8,17,1962,1965,3,7.58,1.73,-5.85,944,266,-678,2225,950,-1275,382.0,0.0,-382.0,0.0,0.0,0.0
amara001,Alexi Amarista,Anaheim Angels,ANGELS,2,3,2,5,2012,2014,2,0.27,1.16,0.89,644,214,-430,1673,0,-1673,125.0,563.0,438.0,481000.0,489100.0,8100.0
amarr002,Ruben Amaro,California Angels,ANGELS,1,2,1,3,1991,1992,1,-0.16,-0.8,-0.64,519,94,-425,970,350,-620,485.0,0.0,-485.0,0.0,2200000.0,2200000.0
amarr002,Ruben Amaro,Philadelphia Phillies,PHILS,3,5,5,10,1993,1999,6,1.62,1.73,0.11,274,527,253,302,176,-126,390.0,857.0,467.0,375000.0,165000.0,-210000.0
amarr101,Ruben Amaro,St. Louis Cardinals,CARDS,18,33,27,60,1958,1972,14,36.26,15.94,-20.32,4243,2613,-1630,10647,7952,-2695,2795.0,1167.0,-1628.0,49500.0,24000.0,-25500.0
amarr101,Ruben Amaro,Philadelphia Phillies,PHILS,2,2,2,4,1965,1967,2,-2.11,-0.67,1.44,293,94,-199,883,137,-746,0.0,0.0,0.0,20000.0,39200.0,19200.0
amblw101,Wayne Ambler,New York Giants,GIANTS,1,1,1,2,1940,1940,0,0.0,0.0,0.0,0,0,0,0,0,0,0.0,0.0,0.0,0.0,5000.0,5000.0
ambrc001,Chip Ambres,Boston Red Sox,RSOX,1,2,1,3,2005,2006,1,-0.16,1.26,1.42,53,51,-2,167,200,33,0.0,0.0,0.0,0.0,1100000.0,1100000.0
amesr101,Red Ames,New York Giants,GIANTS,1,4,1,5,1913,1913,0,44.86,-0.25,-45.11,1467,52,-1415,5586,39,-5547,1664.0,335.0,-1329.0,8100.0,3800.0,-4300.0
amess001,Steve Ames,Los Angeles Dodgers,DOGRS,1,3,2,5,2013,2013,0,0.0,0.91,0.91,8,31,23,0,30,30,12.0,261.0,249.0,0.0,0.0,0.0
ameza001,Alfredo Amezaga,Colorado Rockies,ROCKS,1,1,1,2,2011,2011,0,-0.56,0.0,0.56,20,0,-20,49,0,-49,0.0,0.0,0.0,0.0,0.0,0.0
amold101,Doc Amole,Baltimore Orioles,BLN,2,4,4,8,1897,1899,2,2.28,18.6,16.32,271,446,175,1095,1688,593,148.0,1122.0,974.0,0.0,0.0,0.0
amors101,Sandy Amoros,Los Angeles Dodgers,DOGRS,1,1,1,2,1960,1960,0,-0.38,0.0,0.38,65,0,-65,81,0,-81,0.0,0.0,0.0,0.0,0.0,0.0
andea001,Allan Anderson,Texas Rangers,RNGRS,1,2,1,3,1993,1993,0,0.0,0.0,0.0,0,0,0,0,0,0,0.0,0.0,0.0,0.0,0.0,0.0
andea102,Alf Anderson,Atlanta,Atlanta,1,1,1,2,1940,1940,0,-0.09,0.0,0.09,126,0,-126,430,0,-430,0.0,0.0,0.0,0.0,0.0,0.0
andeb001,Brady Anderson,Boston Red Sox,RSOX,1,2,1,3,1988,1990,2,35.17,11.38,-23.79,1803,83,-1720,7464,0,-7464,208.0,1586.0,1378.0,62500.0,850000.0,787500.0
andeb002,Brian Anderson,California Angels,ANGELS,1,1,2,3,1996,1996,0,1.45,-0.79,-2.24,46,46,0,2,0,-2,742.0,488.0,-254.0,0.0,0.0,0.0
andeb002,Brian Anderson,Cleveland Indians,INDINS,2,3,4,7,2003,2004,1,0.71,-0.61,-1.32,50,65,15,2,0,-2,739.0,235.0,-504.0,1500000.0,0.0,-1500000.0
andeb003,Brian Anderson,Chicago White Sox,WSOX,1,1,1,2,2009,2010,1,-0.1,-0.65,-0.55,21,147,126,21,486,465,0.0,0.0,0.0,440000.0,1500000.0,1060000.0
andeb004,Brett Anderson,Arizona Diamondbacks,DBACKS,6,14,16,30,2007,2018,11,24.99,30.17,5.18,855,1190,335,1319,2038,719,6760.0,6326.0,-434.0,14741000.0,15790000.0,1049000.0
andeb004,Brett Anderson,Oakland Athletics,ATLTCS,5,10,7,17,2013,2018,5,6.98,4.69,-2.29,626,433,-193,1007,1020,13,821.0,573.0,-248.0,10267500.0,2983333.0,-7284167.0
andeb101,Bud Anderson,Seattle Mariners,MARNRS,1,3,1,4,1980,1981,1,2.1,-0.37,-2.47,64,83,19,0,269,269,447.0,0.0,-447.0,0.0,0.0,0.0
andeb102,Bob Anderson,Chicago Cubs,CUBS,1,1,1,2,1962,1963,1,0.42,-0.24,-0.66,64,41,-23,9,104,95,180.0,0.0,-180.0,0.0,0.0,0.0
andeb102,Bob Anderson,Detroit Tigers,TIGRS,4,6,6,12,1963,1972,9,7.82,5.86,-1.96,636,1217,581,727,2715,1988,1071.0,2815.0,1744.0,103000.0,29000.0,-74000.0
andec001,Chase Anderson,Arizona Diamondbacks,DBACKS,2,7,4,11,2016,2019,3,30.63,10.0,-20.63,1052,220,-832,3757,754,-3003,1784.0,544.0,-1240.0,2600000.0,1044000.0,-1556000.0
andec001,Chase Anderson,Milwaukee Brewers,BREWRS,1,1,1,2,2019,2019,0,-0.44,0.0,0.44,10,0,-10,0,0,0,101.0,0.0,-101.0,6500000.0,0.0,-6500000.0
anded101,Dwain Anderson,Oakland Athletics,ATLTCS,2,2,2,4,1972,1974,2,-0.21,-0.58,-0.37,75,30,-45,165,26,-139,0.0,16.0,16.0,9600.0,22000.0,12400.0
anded101,Dwain Anderson,St. Louis Cardinals,CARDS,3,4,3,7,1973,1974,1,-1.33,-0.2,1.13,97,65,-32,163,91,-72,0.0,34.0,34.0,0.0,0.0,0.0
anded101,Dwain Anderson,San Diego Padres,PADRS,1,1,1,2,1973,1973,0,-0.03,0.0,0.03,2,0,-2,3,0,-3,0.0,0.0,0.0,0.0,0.0,0.0
anded101,Dwain Anderson,Cleveland Indians,INDINS,1,1,1,2,1974,1974,0,0.0,0.0,0.0,0,0,0,0,0,0,0.0,0.0,0.0,0.0,0.0,0.0
andeh101,Harry Anderson,Philadelphia Phillies,PHILS,1,3,2,5,1960,1968,8,5.52,24.2,18.68,336,1274,938,998,4678,3680,0.0,0.0,0.0,0.0,0.0,0.0
andeh102,Hal Anderson,Chicago White Sox,WSOX,1,1,2,3,1932,1932,0,0.0,0.0,0.0,0,0,0,0,0,0,0.0,0.0,0.0,4800.0,0.0,-4800.0
andej001,Jim Anderson,California Angels,ANGELS,1,1,1,2,1979,1981,2,0.29,-0.93,-1.22,186,51,-135,536,0,-536,0.0,274.0,274.0,0.0,0.0,0.0
andej001,Jim Anderson,Texas Rangers,RNGRS,1,2,1,3,1985,1991,6,2.79,7.32,4.53,107,694,587,87,2718,2631,806.0,0.0,-806.0,0.0,0.0,0.0
andej002,Jimmy Anderson,Chicago Cubs,CUBS,1,1,1,2,2004,2004,0,0.01,0.0,-0.01,6,0,-6,0,0,0,18.0,0.0,-18.0,0.0,0.0,0.0
andej003,Jason Anderson,New York Yankees,YANKS,2,4,2,6,2003,2003,0,0.35,0.36,0.01,27,33,6,0,0,0,75.0,81.0,6.0,300000.0,10920833.0,10620833.0
andej004,Josh Anderson,Houston Astros,ASTROS,1,1,1,2,2007,2008,1,1.24,-0.3,-1.54,40,68,28,146,1,-145,0.0,113.0,113.0,0.0,925000.0,925000.0
andej004,Josh Anderson,Atlanta Braves,BRAVES,1,1,1,2,2009,2009,0,-0.32,0.0,0.32,74,0,-74,175,0,-175,0.0,0.0,0.0,0.0,0.0,0.0
andej101,John Anderson,St.Louis Browns,ORLS,1,1,1,2,1903,1903,0,3.02,0.0,-3.02,175,0,-175,705,0,-705,0.0,0.0,0.0,0.0,0.0,0.0
andej102,John Anderson,St. Louis Cardinals,CARDS,2,5,4,9,1962,1965,3,0.93,8.59,7.66,640,305,-335,1722,489,-1233,727.0,472.0,-255.0,0.0,12000.0,12000.0
andel001,Larry Andersen,Cleveland Indians,INDINS,2,2,3,5,1979,1982,3,0.0,-1.05,-1.05,0,108,108,0,346,346,0.0,0.0,0.0,0.0,0.0,0.0
andel001,Larry Andersen,Pittsburgh Pirates,PIRATS,1,2,1,3,1980,1982,2,0.54,0.88,0.34,81,26,-55,0,13,13,442.0,163.0,-279.0,0.0,0.0,0.0
andel001,Larry Andersen,Houston Astros,ASTROS,1,1,1,2,1990,1990,0,1.24,0.0,-1.24,15,0,-15,0,0,0,66.0,0.0,-66.0,965000.0,0.0,-965000.0
andel002,Lars Anderson,Boston Red Sox,RSOX,1,1,1,2,2012,2019,7,0.0,3.15,3.15,0,87,87,0,6,6,0.0,1043.0,1043.0,482000.0,0.0,-482000.0
andel002,Lars Anderson,Cleveland Indians,INDINS,4,8,11,19,2012,2019,7,4.46,23.51,19.05,328,937,609,554,910,356,512.0,4479.0,3967.0,22963900.0,12041333.0,-10922567.0
andel101,Larry Anderson,Toronto Blue Jays,BJAYS,1,1,1,2,1977,1977,0,-0.58,-0.11,0.47,6,3,-3,0,5,5,26.0,0.0,-26.0,0.0,0.0,0.0
andel101,Larry Anderson,Chicago White Sox,WSOX,2,4,2,6,1977,1979,2,6.89,0.93,-5.96,401,36,-365,1175,0,-1175,453.0,349.0,-104.0,0.0,0.0,0.0
andel101,Larry Anderson,Chicago Cubs,CUBS,1,1,1,2,1978,1978,0,0.0,0.52,0.52,0,24,24,0,56,56,0.0,0.0,0.0,0.0,0.0,0.0
andel101,Larry Anderson,Baltimore Orioles,ORLS,1,3,2,5,1980,1980,0,0.0,0.0,0.0,0,0,0,0,0,0,0.0,0.0,0.0,0.0,0.0,0.0
andem001,Mike Anderson,Cincinnati Reds,REDS,2,4,2,6,1993,1996,3,1.51,1.69,0.18,53,302,249,0,11,11,157.0,464.0,307.0,817000.0,2412500.0,1595500.0
andem003,Marlon Anderson,Washington Nationals,NATEX,3,3,4,7,2006,2016,10,0.51,0.37,-0.14,150,256,106,369,568,199,0.0,26.0,26.0,925000.0,0.0,-925000.0
andem101,Mike Anderson,Philadelphia Phillies,PHILS,2,2,2,4,1975,1985,10,2.58,13.14,10.56,233,1026,793,400,231,-169,219.0,3397.0,3178.0,0.0,0.0,0.0
anden001,Nick Anderson,Minnesota Twins,TWINS,1,1,1,2,2018,2018,0,0.57,0.0,-0.57,86,0,-86,0,0,0,131.0,0.0,-131.0,0.0,0.0,0.0
anden001,Nick Anderson,Miami Marlins,MARLNS,1,2,2,4,2019,2020,1,1.9,-0.48,-2.38,73,53,-20,0,0,0,333.0,94.0,-239.0,1125000.0,564200.0,-560800.0
ander001,Rick Anderson,New York Mets,METS,11,23,20,43,1987,2005,18,11.67,39.4,27.73,1493,3560,2067,1978,7962,5984,3113.0,6312.0,3199.0,27998333.0,20210666.0,-7787667.0
ander101,Rick Anderson,New York Yankees,YANKS,7,17,13,30,1979,1992,13,39.2,19.95,-19.25,2768,1137,-1631,6569,3883,-2686,8301.0,701.0,-7600.0,913333.0,1745000.0,831667.0
andes001,Scott Anderson,Texas Rangers,RNGRS,1,1,1,2,1988,1988,0,0.3,0.0,-0.3,8,0,-8,5,0,-5,54.0,0.0,-54.0,0.0,0.0,0.0
andes002,Shaun Anderson,Boston Red Sox,RSOX,1,2,1,3,2017,2019,2,-0.97,-1.55,-0.58,77,226,149,28,849,821,340.0,3.0,-337.0,0.0,4200000.0,4200000.0
andes002,Shaun Anderson,San Francisco Giants,GIANTS,1,1,1,2,2021,2021,0,-0.46,1.22,1.68,4,109,105,0,381,381,26.0,0.0,-26.0,0.0,0.0,0.0
andes101,Sparky Anderson,Los Angeles Dodgers,DOGRS,2,2,4,6,1958,1961,3,-1.37,-0.64,0.73,240,115,-125,704,120,-584,0.0,147.0,147.0,17000.0,0.0,-17000.0
andet002,Tyler Anderson,Pittsburgh Pirates,PIRATS,1,1,2,3,2021,2021,0,0.27,0.0,-0.27,14,0,-14,3,0,-3,191.0,0.0,-191.0,2500000.0,0.0,-2500000.0
andet003,Tanner Anderson,Pittsburgh Pirates,PIRATS,1,1,1,2,2018,2018,0,-0.22,0.0,0.22,6,0,-6,1,0,-1,67.0,0.0,-67.0,0.0,0.0,0.0
andir001,Robert Andino,Florida Marlins,MARLNS,1,1,1,2,2009,2010,1,3.07,-1.06,-4.13,360,32,-328,1223,2,-1221,0.0,66.0,66.0,0.0,0.0,0.0
andir001,Robert Andino,Baltimore Orioles,ORLS,1,1,1,2,2012,2013,1,-0.4,0.0,0.4,29,0,-29,85,0,-85,0.0,0.0,0.0,1300000.0,0.0,-1300000.0
andir001,Robert Andino,Seattle Mariners,MARNRS,1,1,1,2,2013,2013,0,0.0,0.0,0.0,0,0,0,0,0,0,0.0,0.0,0.0,0.0,0.0,0.0
andrc001,Clayton Andrews,Toronto Blue Jays,BJAYS,1,2,1,3,2000,2002,2,0.0,0.91,0.91,0,36,36,0,6,6,0.0,543.0,543.0,0.0,1400000.0,1400000.0
andre001,Elvis Andrus,Atlanta Braves,BRAVES,3,7,5,12,2007,2009,2,51.72,9.48,-42.24,2314,404,-1910,8153,1445,-6708,2789.0,84.0,-2705.0,15385000.0,11700000.0,-3685000.0
andre001,Elvis Andrus,Texas Rangers,RNGRS,1,3,3,6,2021,2021,0,0.18,-0.26,-0.44,178,104,-74,635,346,-289,0.0,0.0,0.0,0.0,0.0,0.0
andrf101,Fred Andrews,Philadelphia Phillies,PHILS,1,2,1,3,1978,1980,2,0.0,0.97,0.97,0,124,124,0,214,214,0.0,0.0,0.0,0.0,0.0,0.0
andri101,Ivy Andrews,New York Yankees,YANKS,1,3,1,4,1932,1934,2,4.01,-1.32,-5.33,261,128,-133,217,129,-88,1777.0,923.0,-854.0,12000.0,8500.0,-3500.0
andri101,Ivy Andrews,Boston Red Sox,RSOX,2,5,2,7,1933,1936,3,13.03,1.41,-11.62,347,273,-74,502,1053,551,1631.0,0.0,-1631.0,28000.0,21000.0,-7000.0
andri101,Ivy Andrews,St.Louis Browns,ORLS,12,23,32,55,1937,1952,15,55.87,54.37,-1.5,2736,6464,3728,7991,19515,11524,6789.0,12669.0,5880.0,129000.0,122100.0,-6900.0
andrj001,John Andreoli,San Francisco Giants,GIANTS,1,2,1,3,2019,2019,0,0.0,-0.32,-0.32,0,4,4,0,8,8,0.0,0.0,0.0,0.0,0.0,0.0
andrj101,John Andrews,St. Louis Cardinals,CARDS,1,1,1,2,1973,1974,1,0.0,0.0,0.0,0,0,0,0,0,0,0.0,0.0,0.0,10000.0,30000.0,20000.0
andrm001,Matt Andriese,San Diego Padres,PADRS,5,10,9,19,2014,2019,5,13.64,2.43,-11.21,896,526,-370,1526,1044,-482,2446.0,524.0,-1922.0,2925000.0,2005000.0,-920000.0
andrm001,Matt Andriese,Tampa Bay Devil Rays,RAYS,1,1,2,3,2018,2020,2,-0.97,0.68,1.65,133,84,-49,7,228,221,269.0,0.0,-269.0,0.0,0.0,0.0
andrm001,Matt Andriese,Arizona Diamondbacks,DBACKS,1,1,1,2,2020,2021,1,0.6,0.01,-0.59,16,1,-15,0,0,0,96.0,1.0,-95.0,0.0,0.0,0.0
andrm101,Mike Andrews,Boston Red Sox,RSOX,1,2,1,3,1970,1974,4,-1.93,4.15,6.08,599,367,-232,1963,1576,-387,0.0,0.0,0.0,69000.0,38000.0,-31000.0
andrn101,Nate Andrews,Cincinnati Reds,REDS,5,8,7,15,1942,1958,16,10.73,21.22,10.49,1014,1434,420,2886,5138,2252,2587.0,1210.0,-1377.0,0.0,12500.0,12500.0
andrr101,Rob Andrews,Baltimore Orioles,ORLS,1,2,2,4,1974,1980,6,10.57,4.54,-6.03,1279,794,-485,5010,3158,-1852,0.0,0.0,0.0,16000.0,0.0,-16000.0
andrr101,Rob Andrews,Houston Astros,ASTROS,3,4,5,9,1977,1989,12,-2.24,11.47,13.71,506,1255,749,1320,3239,1919,0.0,408.0,408.0,705000.0,400000.0,-305000.0
andrs101,Stan Andrews,Philadelphia Phillies,PHILS,1,2,1,3,1945,1946,1,0.0,-0.34,-0.34,0,6,6,0,20,20,0.0,0.0,0.0,0.0,0.0,0.0
anduj001,Joaquin Andujar,Cincinnati Reds,REDS,1,1,2,3,1975,1976,1,3.32,0.0,-3.32,405,0,-405,279,0,-279,2580.0,0.0,-2580.0,0.0,0.0,0.0
anduj001,Joaquin Andujar,Houston Astros,ASTROS,1,1,1,2,1981,1984,3,11.67,1.18,-10.49,325,292,-33,410,954,544,3231.0,0.0,-3231.0,0.0,225000.0,225000.0
anduj001,Joaquin Andujar,St. Louis Cardinals,CARDS,3,3,5,8,1985,1992,7,17.92,0.16,-17.76,664,404,-260,1685,909,-776,2317.0,1412.0,-905.0,1718333.0,497500.0,-1220833.0
andul001,Luis Andujar,Chicago White Sox,WSOX,1,2,2,4,1996,1998,2,-0.91,-1.48,-0.57,26,123,97,0,23,23,210.0,336.0,126.0,0.0,890000.0,890000.0
angen101,Norm Angelini,Kansas City Royals,ROYALS,1,3,2,5,1975,1976,1,1.17,0.35,-0.82,138,8,-130,32,0,-32,436.0,23.0,-413.0,0.0,0.0,0.0
ankir001,Rick Ankiel,Kansas City Royals,ROYALS,1,2,3,5,2010,2016,6,-0.01,2.01,2.02,93,319,226,139,204,65,60.0,734.0,674.0,7250000.0,415000.0,-6835000.0
annad001,Dean Anna,San Diego Padres,PADRS,1,1,1,2,2013,2013,0,0.12,0.0,-0.12,13,0,-13,25,0,-25,3.0,0.0,-3.0,0.0,0.0,0.0
anthe001,Eric Anthony,Houston Astros,ASTROS,5,10,10,20,1993,2008,15,7.76,34.5,26.74,563,2409,1846,1619,4787,3168,1469.0,4907.0,3438.0,15790000.0,7196500.0,-8593500.0
antoj101,John Antonelli,St. Louis Cardinals,CARDS,1,2,1,3,1945,1947,2,0.82,2.98,2.16,208,221,13,883,855,-28,0.0,0.0,0.0,0.0,0.0,0.0
antoj103,Johnny Antonelli,Milwaukee Braves,BRAVES,2,8,3,11,1954,1960,6,39.41,8.38,-31.03,1145,621,-524,1887,2335,448,6059.0,0.0,-6059.0,0.0,42000.0,42000.0
antoj103,Johnny Antonelli,San Francisco Giants,GIANTS,4,7,5,12,1960,1968,8,1.33,3.3,1.97,705,765,60,1946,2705,759,636.0,0.0,-636.0,33000.0,70000.0,37000.0
aokin001,Nori Aoki,Milwaukee Brewers,BREWRS,3,3,4,7,2013,2021,8,4.33,0.59,-3.74,419,370,-49,577,31,-546,410.0,459.0,49.0,2000000.0,0.0,-2000000.0
aokin001,Nori Aoki,Houston Astros,ASTROS,1,2,1,3,2017,2017,0,8.07,-0.16,-8.23,490,21,-469,1918,0,-1918,0.0,43.0,43.0,5500000.0,13666667.0,8166667.0
aparl101,Luis Aparicio,Chicago White Sox,WSOX,8,13,17,30,1963,1971,8,31.42,56.47,25.05,2785,3257,472,9290,8734,-556,740.0,2775.0,2035.0,72500.0,33000.0,-39500.0
aparl101,Luis Aparicio,Baltimore Orioles,ORLS,2,4,4,8,1967,1973,6,9.46,19.82,10.36,579,770,191,2185,2951,766,146.0,306.0,160.0,72000.0,40300.0,-31700.0
aparl101,Luis Aparicio,Chicago White Sox,WSOX,2,2,3,5,1970,1974,4,3.8,-1.81,-5.61,400,610,210,1661,1964,303,0.0,62.0,62.0,58000.0,69000.0,11000.0
aponl001,Luis Aponte,Boston Red Sox,RSOX,1,1,2,3,1984,1984,0,0.34,0.0,-0.34,25,0,-25,0,0,0,151.0,0.0,-151.0,0.0,0.0,0.0
aposs001,Sherten Apostel,Pittsburgh Pirates,PIRATS,1,2,1,3,2018,2020,2,-0.62,1.6,2.22,66,95,29,21,0,-21,366.0,141.0,-225.0,0.0,1200000.0,1200000.0
appik001,Kevin Appier,Kansas City Royals,ROYALS,2,2,4,6,1999,2002,3,2.45,1.1,-1.35,57,146,89,7,7,0,808.0,1368.0,560.0,5020000.0,526500.0,-4493500.0
appik001,Kevin Appier,New York Mets,METS,1,1,1,2,2001,2001,0,1.49,0.0,-1.49,55,0,-55,9,0,-9,843.0,0.0,-843.0,8500000.0,0.0,-8500000.0
applp101,Pete Appleton,Cleveland Indians,INDINS,2,3,2,5,1932,1932,0,3.51,1.94,-1.57,352,36,-316,168,43,-125,1511.0,339.0,-1172.0,4500.0,5500.0,1000.0
applp101,Pete Appleton,Washington Senators,TWINS,5,8,6,14,1939,1946,7,15.27,0.38,-14.89,1887,491,-1396,7336,1848,-5488,270.0,315.0,45.0,42250.0,35000.0,-7250.0
applp101,Pete Appleton,New York Yankees,YANKS,3,7,3,10,1933,1948,15,-3.37,1.52,4.89,613,291,-322,2436,971,-1465,0.0,0.0,0.0,9000.0,3000.0,-6000.0
aquig001,Greg Aquino,Arizona Diamondbacks,DBACKS,7,17,19,36,2006,2018,12,24.81,35.93,11.12,1150,1382,232,1829,2226,397,7355.0,7967.0,612.0,18358000.0,18990000.0,632000.0
aquij001,Jayson Aquino,Colorado Rockies,ROCKS,1,1,1,2,2015,2015,0,0.0,0.0,0.0,0,0,0,0,0,0,0.0,0.0,0.0,0.0,0.0,0.0
aquil001,Luis Aquino,Toronto Blue Jays,BJAYS,1,1,1,2,1987,1988,1,8.02,0.16,-7.86,114,66,-48,0,156,156,1390.0,0.0,-1390.0,0.0,0.0,0.0
aquil001,Luis Aquino,Montreal Expos,NATEX,1,1,1,2,1995,1997,2,-0.63,0.0,0.63,10,0,-10,1,0,-1,15.0,0.0,-15.0,420000.0,0.0,-420000.0
aranv001,Victor Arano,Los Angeles Dodgers,DOGRS,1,2,1,3,2014,2014,0,1.78,-0.44,-2.22,191,18,-173,89,15,-74,227.0,131.0,-96.0,0.0,0.0,0.0
arauj001,Jonathan Arauz,Philadelphia Phillies,PHILS,2,3,6,9,2015,2021,6,1.74,5.44,3.7,212,305,93,3,183,180,772.0,1899.0,1127.0,519000.0,515800.0,-3200.0
archc001,Chris Archer,Cleveland Indians,INDINS,2,4,3,7,2008,2013,5,-0.38,5.27,5.65,140,382,242,264,314,50,120.0,883.0,763.0,5500000.0,4750000.0,-750000.0
archc001,Chris Archer,Chicago Cubs,CUBS,4,8,9,17,2011,2019,8,18.8,9.35,-9.45,836,1392,556,1720,408,-1312,3536.0,2716.0,-820.0,1500000.0,0.0,-1500000.0
archc001,Chris Archer,Tampa Bay Devil Rays,RAYS,1,1,3,4,2018,2018,0,1.43,0.42,-1.01,64,21,-43,58,26,-32,516.0,167.0,-349.0,0.0,556500.0,556500.0
archg101,George Archie,Detroit Tigers,TIGRS,1,5,1,6,1938,1952,14,0.0,25.69,25.69,0,589,589,0,728,728,0.0,4363.0,4363.0,11000.0,0.0,-11000.0
archg101,George Archie,Washington Senators,TWINS,2,4,2,6,1941,1943,2,8.38,6.04,-2.34,404,250,-154,1593,1022,-571,0.0,0.0,0.0,5000.0,3500.0,-1500.0
archj101,Jim Archer,Baltimore Orioles,ORLS,4,11,7,18,1961,1973,12,20.55,30.35,9.8,1602,1797,195,5528,6131,603,845.0,306.0,-539.0,72000.0,40300.0,-31700.0
archm101,Maurice Archdeacon,Chicago White Sox,WSOX,1,1,2,3,1925,1932,7,0.0,22.29,22.29,0,491,491,0,595,595,0.0,4665.0,4665.0,4800.0,0.0,-4800.0
arcij101,Jose Arcia,San Diego Padres,PADRS,1,2,1,3,1971,1971,0,0.0,0.0,0.0,0,0,0,0,0,0,0.0,0.0,0.0,0.0,0.0,0.0
arcio001,Oswaldo Arcia,Minnesota Twins,TWINS,1,1,1,2,2016,2016,0,-0.05,0.0,0.05,21,0,-21,61,0,-61,0.0,0.0,0.0,535000.0,0.0,-535000.0
arcio002,Orlando Arcia,Milwaukee Brewers,BREWRS,1,1,2,3,2021,2021,0,-0.18,0.01,0.19,32,6,-26,78,0,-78,0.0,12.0,12.0,2000000.0,0.0,-2000000.0
ardod001,Danny Ardoin,Oakland Athletics,ATLTCS,1,1,1,2,2000,2002,2,-0.17,-0.21,-0.04,15,37,22,40,79,39,0.0,0.0,0.0,0.0,0.0,0.0
ardod001,Danny Ardoin,Washington Nationals,NATEX,1,1,1,2,2007,2007,0,0.0,0.0,0.0,0,0,0,0,0,0,0.0,0.0,0.0,0.0,0.0,0.0
arenn001,Nolan Arenado,Colorado Rockies,ROCKS,1,1,5,6,2021,2021,0,4.14,0.69,-3.45,157,45,-112,653,42,-611,0.0,346.0,346.0,0.0,0.0,0.0
ariaa001,Alex Arias,Chicago Cubs,CUBS,1,2,1,3,1992,1993,1,1.43,0.32,-1.11,423,63,-360,1012,70,-942,0.0,573.0,573.0,116000.0,0.0,-116000.0
ariaa001,Alex Arias,San Diego Padres,PADRS,3,8,7,15,2001,2006,5,0.42,8.49,8.07,330,730,400,847,2213,1366,693.0,843.0,150.0,3727500.0,2445000.0,-1282500.0
ariag001,George Arias,Anaheim Angels,ANGELS,1,3,1,4,1997,1997,0,-0.12,-0.13,-0.01,86,32,-54,233,144,-89,0.0,0.0,0.0,0.0,3045000.0,3045000.0
ariaj001,Joaquin Arias,New York Yankees,YANKS,1,2,2,4,2004,2016,12,3.52,53.95,50.43,392,1509,1117,1582,6520,4938,0.0,0.0,0.0,0.0,0.0,0.0
ariaj001,Joaquin Arias,Texas Rangers,RNGRS,1,1,2,3,2010,2010,0,-0.15,0.25,0.4,22,15,-7,33,56,23,0.0,0.0,0.0,402000.0,5000000.0,4598000.0
arlis101,Steve Arlin,San Diego Padres,PADRS,1,1,2,3,1974,1978,4,-1.01,1.74,2.75,11,126,115,0,121,121,131.0,1043.0,912.0,0.0,0.0,0.0
armat001,Tony Armas,Pittsburgh Pirates,PIRATS,5,10,11,21,1977,1988,11,53.71,31.99,-21.72,2929,1675,-1254,9660,6568,-3092,5429.0,149.0,-5280.0,807000.0,0.0,-807000.0
armat001,Tony Armas,Oakland Athletics,ATLTCS,2,3,4,7,1982,1991,9,1.92,23.98,22.06,609,1229,620,2373,4812,2439,0.0,48.0,48.0,0.0,440000.0,440000.0
armat002,Tony Armas,New York Yankees,YANKS,1,2,2,4,1997,1997,0,0.0,0.17,0.17,0,28,28,0,103,103,0.0,0.0,0.0,0.0,2100000.0,2100000.0
armat002,Tony Armas,Boston Red Sox,RSOX,1,2,1,3,1997,2004,7,9.91,53.51,43.6,450,211,-239,430,21,-409,3819.0,4151.0,332.0,0.0,3615000.0,3615000.0
armbe101,Ed Armbrister,Houston Astros,ASTROS,8,15,14,29,1971,1989,18,76.39,55.08,-21.31,4763,4769,6,15346,14810,-536,3810.0,5622.0,1812.0,705000.0,416000.0,-289000.0
armsj001,Jack Armstrong,Cincinnati Reds,REDS,1,3,1,4,1991,1992,1,-2.2,4.96,7.16,60,62,2,0,87,87,839.0,641.0,-198.0,215000.0,2025000.0,1810000.0
armsm001,Mike Armstrong,Cincinnati Reds,REDS,1,1,1,2,1979,1979,0,-0.76,0.0,0.76,42,0,-42,3,0,-3,79.0,0.0,-79.0,0.0,0.0,0.0
armsm001,Mike Armstrong,Kansas City Royals,ROYALS,1,2,2,4,1983,1986,3,0.96,2.85,1.89,53,424,371,0,1712,1712,233.0,0.0,-233.0,0.0,180000.0,180000.0
armss001,Shawn Armstrong,Cleveland Indians,INDINS,1,1,1,2,2017,2017,0,0.35,0.0,-0.35,19,0,-19,0,0,0,55.0,0.0,-55.0,535700.0,0.0,-535700.0
arndh101,Harry Arndt,Louisville,Louisville,2,2,4,6,1905,1910,5,-0.59,0.0,0.59,21,0,-21,69,0,-69,0.0,0.0,0.0,0.0,0.0,0.0
arndl001,Larry Arndt,Oakland Athletics,ATLTCS,1,1,1,2,1991,1991,0,0.0,0.0,0.0,0,0,0,0,0,0,0.0,0.0,0.0,0.0,0.0,0.0
arnoj001,Jamie Arnold,Los Angeles Dodgers,DOGRS,1,3,1,4,2000,2000,0,-0.56,-0.49,0.07,24,18,-6,10,13,3,98.0,120.0,22.0,0.0,5737500.0,5737500.0
arnom101,Morrie Arnovich,Philadelphia Phillies,PHILS,1,1,1,2,1940,1941,1,0.41,2.66,2.25,62,202,140,226,672,446,0.0,0.0,0.0,0.0,0.0,0.0
arnsb001,Brad Arnsberg,New York Yankees,YANKS,2,2,3,5,1987,1992,5,11.66,5.12,-6.54,555,268,-287,1624,750,-874,361.0,266.0,-95.0,718000.0,1181500.0,463500.0
arnto101,Orie Arntzen,Cleveland Indians,INDINS,1,1,1,2,1940,1940,0,0.18,0.0,-0.18,64,0,-64,54,0,-54,493.0,0.0,-493.0,0.0,0.0,0.0
arnto101,Orie Arntzen,Philadelphia Athletics,ATLTCS,40,86,82,168,1943,1976,33,92.78,72.86,-19.92,10628,9822,-806,25815,30088,4273,12609.0,8822.0,-3787.0,510800.0,639500.0,128700.0
aro-j001,Jonathan Aro,Boston Red Sox,RSOX,2,3,3,6,2015,2019,4,1.53,0.12,-1.41,94,36,-58,9,0,-9,632.0,95.0,-537.0,3666000.0,0.0,-3666000.0
arocr001,Rene Arocha,St. Louis Cardinals,CARDS,1,1,1,2,1997,1998,1,-0.71,0.64,1.35,12,201,189,1,515,514,31.0,0.0,-31.0,0.0,0.0,0.0
arozr001,Randy Arozarena,St. Louis Cardinals,CARDS,1,3,3,6,2020,2020,0,5.13,0.0,-5.13,188,0,-188,756,0,-756,0.0,0.0,0.0,0.0,0.0,0.0
arrig101,Gerry Arrigo,Minnesota Twins,TWINS,3,3,5,8,1964,1974,10,2.72,24.52,21.8,336,1245,909,505,4929,4424,1317.0,136.0,-1181.0,63500.0,14500.0,-49000.0
arrig101,Gerry Arrigo,Cincinnati Reds,REDS,2,2,2,4,1969,1971,2,-1.46,0.08,1.54,62,102,40,73,120,47,40.0,0.0,-40.0,21500.0,0.0,-21500.0
arrig101,Gerry Arrigo,Cincinnati Reds,REDS,1,1,2,3,1966,1966,0,0.78,0.0,-0.78,34,0,-34,12,0,-12,130.0,0.0,-130.0,0.0,0.0,0.0
arrij001,Jake Arrieta,Baltimore Orioles,ORLS,2,4,4,8,2013,2019,6,26.47,2.52,-23.95,1116,493,-623,389,1879,1490,3793.0,272.0,-3521.0,514000.0,6900000.0,6386000.0
arrob001,Bronson Arroyo,Boston Red Sox,RSOX,3,6,3,9,2006,2009,3,17.68,-0.09,-17.77,761,185,-576,1172,502,-670,5284.0,41.0,-5243.0,2275000.0,10500000.0,8225000.0
arrob001,Bronson Arroyo,Arizona Diamondbacks,DBACKS,2,3,2,5,2015,2017,2,-1.46,1.06,2.52,118,146,28,80,316,236,435.0,0.0,-435.0,0.0,507500.0,507500.0
arrob001,Bronson Arroyo,Atlanta Braves,BRAVES,3,7,11,18,2015,2020,5,4.88,-1.29,-6.17,588,465,-123,687,1320,633,1642.0,246.0,-1396.0,24400000.0,34929500.0,10529500.0
arroc001,Christian Arroyo,San Francisco Giants,GIANTS,1,4,2,6,2017,2017,0,1.25,0.0,-1.25,79,0,-79,289,0,-289,0.0,0.0,0.0,11000000.0,13000000.0,2000000.0
arroc001,Christian Arroyo,Tampa Bay Devil Rays,RAYS,1,2,2,4,2019,2019,0,0.02,0.0,-0.02,21,0,-21,0,0,0,49.0,0.0,-49.0,0.0,0.0,0.0
arrof001,Fernando Arroyo,Detroit Tigers,TIGRS,1,1,1,2,1979,1979,0,1.41,0.0,-1.41,50,0,-50,0,0,0,703.0,0.0,-703.0,0.0,0.0,0.0
arrol101,Luis Arroyo,St. Louis Cardinals,CARDS,1,1,1,2,1956,1956,0,-0.66,-0.24,0.42,146,10,-136,40,1,-39,478.0,17.0,-461.0,0.0,0.0,0.0
arrol101,Luis Arroyo,Pittsburgh Pirates,PIRATS,1,1,1,2,1958,1958,0,-0.2,0.0,0.2,20,0,-20,2,0,-2,41.0,0.0,-41.0,0.0,0.0,0.0
arrol101,Luis Arroyo,Cincinnati Reds,REDS,1,3,2,5,1960,1960,0,3.11,0.0,-3.11,276,0,-276,63,0,-63,598.0,0.0,-598.0,0.0,0.0,0.0
arror001,Rolando Arrojo,Tampa Bay Devil Rays,RAYS,1,2,1,3,1999,2001,2,-0.33,-0.6,-0.27,69,109,40,75,451,376,304.0,0.0,-304.0,477500.0,6000000.0,5522500.0
arror001,Rolando Arrojo,Colorado Rockies,ROCKS,7,13,12,25,2000,2002,2,6.04,1.37,-4.67,876,433,-443,660,150,-510,2239.0,928.0,-1311.0,9375000.0,6575000.0,-2800000.0
arror101,Rudy Arroyo,St. Louis Cardinals,CARDS,5,7,6,13,1972,1977,5,20.99,-1.61,-22.6,875,118,-757,2900,9,-2891,1249.0,251.0,-998.0,47500.0,42500.0,-5000.0
asadr001,Randy Asadoor,Texas Rangers,RNGRS,1,1,1,2,1985,1985,0,0.27,0.0,-0.27,15,0,-15,60,0,-60,0.0,0.0,0.0,0.0,0.0,0.0
ascaj001,Jose Ascanio,Atlanta Braves,BRAVES,2,3,3,6,2007,2014,7,6.73,9.57,2.84,1059,962,-97,992,3068,2076,1047.0,176.0,-871.0,2225000.0,8700000.0,6475000.0
ascaj001,Jose Ascanio,Chicago Cubs,CUBS,2,4,5,9,2009,2013,4,14.85,0.73,-14.12,1031,310,-721,3072,59,-3013,719.0,863.0,144.0,405000.0,2300000.0,1895000.0
asenm001,Miguel Asencio,Colorado Rockies,ROCKS,1,2,3,5,2006,2010,4,-0.73,4.59,5.32,38,489,451,30,1012,982,297.0,873.0,576.0,4500000.0,727000.0,-3773000.0
ashba001,Alan Ashby,Cleveland Indians,INDINS,1,2,1,3,1976,1978,2,1.98,-0.52,-2.5,205,36,-169,757,0,-757,0.0,442.0,442.0,0.0,0.0,0.0
ashba001,Alan Ashby,Toronto Blue Jays,BJAYS,1,1,3,4,1978,1982,4,7.9,-1.25,-9.15,965,29,-936,3318,9,-3309,0.0,249.0,249.0,0.0,22500.0,22500.0
ashba002,Andy Ashby,Colorado Rockies,ROCKS,1,3,2,5,1993,1994,1,28.53,-1.48,-30.01,973,90,-883,1500,70,-1430,4150.0,636.0,-3514.0,150000.0,5025000.0,4875000.0
ashba002,Andy Ashby,San Diego Padres,PADRS,10,22,23,45,1999,2021,22,50.39,35.68,-14.71,2323,2114,-209,7874,5307,-2567,1816.0,6592.0,4776.0,20585200.0,5572500.0,-15012700.0
ashba002,Andy Ashby,Philadelphia Phillies,PHILS,2,3,4,7,2000,2003,3,1.01,1.86,0.85,55,250,195,58,64,6,475.0,810.0,335.0,6200000.0,5707500.0,-492500.0
ashbr101,Richie Ashburn,Philadelphia Phillies,PHILS,3,4,5,9,1960,1964,4,10.16,6.52,-3.64,727,567,-160,1672,1669,-3,2599.0,1208.0,-1391.0,0.0,34000.0,34000.0
ashea001,Alec Asher,Texas Rangers,RNGRS,5,14,16,30,2015,2021,6,11.03,13.28,2.25,790,293,-497,1664,16,-1648,2536.0,2164.0,-372.0,3762500.0,1106250.0,-2656250.0
ashea001,Alec Asher,Philadelphia Phillies,PHILS,1,1,1,2,2017,2017,0,0.0,0.0,0.0,26,0,-26,1,0,-1,180.0,0.0,-180.0,0.0,0.0,0.0
ashft001,Tucker Ashford,San Diego Padres,PADRS,4,8,6,14,1980,1984,4,16.75,2.24,-14.51,1038,424,-614,3623,1747,-1876,529.0,0.0,-529.0,0.0,0.0,0.0
ashft001,Tucker Ashford,Texas Rangers,RNGRS,1,2,1,3,1980,1980,0,-0.01,0.0,0.01,3,0,-3,0,0,0,0.0,0.0,0.0,0.0,0.0,0.0
ashft001,Tucker Ashford,New York Yankees,YANKS,1,1,2,3,1983,1983,0,-0.35,0.0,0.35,35,0,-35,63,0,-63,0.0,0.0,0.0,0.0,0.0,0.0
ashft001,Tucker Ashford,New York Mets,METS,14,22,24,46,1984,1999,15,42.44,12.02,-30.42,2771,1753,-1018,6235,1747,-4488,4175.0,4754.0,579.0,13614666.0,12979167.0,-635499.0
asprb101,Bob Aspromonte,Houston Astros,ASTROS,2,2,2,4,1968,1973,5,-1.08,-1.54,-0.46,153,213,60,364,475,111,0.0,2.0,2.0,35000.0,0.0,-35000.0
asprb101,Bob Aspromonte,Atlanta Braves,BRAVES,1,1,1,2,1970,1972,2,-1.27,-0.11,1.16,104,50,-54,377,11,-366,0.0,155.0,155.0,0.0,0.0,0.0
asprk101,Ken Aspromonte,Boston Red Sox,RSOX,3,3,4,7,1958,1960,2,-0.4,-0.52,-0.12,351,65,-286,1197,201,-996,0.0,26.0,26.0,0.0,0.0,0.0
asprk101,Ken Aspromonte,Washington Senators,TWINS,1,1,1,2,1960,1961,1,2.45,-0.14,-2.59,159,68,-91,633,140,-493,0.0,0.0,0.0,0.0,0.0,0.0
asprk101,Ken Aspromonte,Washington Senators,RNGRS,1,1,1,2,1960,1961,1,0.58,-0.75,-1.33,66,69,3,276,252,-24,0.0,0.0,0.0,0.0,0.0,0.0
asprk101,Ken Aspromonte,Milwaukee Braves,BRAVES,1,1,1,2,1962,1962,0,0.03,0.0,-0.03,20,0,-20,38,0,-38,0.0,0.0,0.0,0.0,0.0,0.0
assep001,Paul Assenmacher,Atlanta Braves,BRAVES,4,5,5,10,1989,1999,10,5.35,0.43,-4.92,606,237,-369,109,498,389,1445.0,0.0,-1445.0,3565833.0,185000.0,-3380833.0
assep001,Paul Assenmacher,Chicago Cubs,CUBS,1,1,1,2,1993,1995,2,0.43,0.73,0.3,26,123,97,0,388,388,52.0,0.0,-52.0,2665333.0,0.0,-2665333.0
assep001,Paul Assenmacher,New York Yankees,YANKS,1,1,1,2,1994,1997,3,0.85,0.92,0.07,44,58,14,0,0,0,99.0,336.0,237.0,0.0,0.0,0.0
astae001,Ezequiel Astacio,Philadelphia Phillies,PHILS,1,3,1,4,2003,2005,2,-3.72,3.94,7.66,149,236,87,71,5,-66,766.0,378.0,-388.0,325000.0,8000000.0,7675000.0
astap001,Pedro Astacio,Los Angeles Dodgers,DOGRS,4,6,7,13,1997,2006,9,13.38,15.79,2.41,691,1443,752,1987,3702,1715,2898.0,1435.0,-1463.0,15075000.0,14736000.0,-339000.0
astap001,Pedro Astacio,Colorado Rockies,ROCKS,1,2,1,3,2001,2004,3,0.82,-2.27,-3.09,8,45,37,12,39,27,86.0,348.0,262.0,6850000.0,400000.0,-6450000.0
astib001,Barrett Astin,Milwaukee Brewers,BREWRS,2,4,2,6,2014,2015,1,-0.1,-0.55,-0.45,292,98,-194,5,0,-5,440.0,141.0,-299.0,0.0,0.0,0.0
asuac001,Carlos Asuaje,Boston Red Sox,RSOX,1,4,1,5,2015,2018,3,5.44,6.73,1.29,670,203,-467,2136,0,-2136,153.0,553.0,400.0,0.0,9000000.0,9000000.0
athek001,Keith Atherton,Oakland Athletics,ATLTCS,2,2,3,5,1986,1987,1,2.66,0.0,-2.66,159,0,-159,0,0,0,705.0,0.0,-705.0,183700.0,0.0,-183700.0
athek001,Keith Atherton,Minnesota Twins,TWINS,1,1,1,2,1989,1991,2,-0.06,-2.66,-2.6,32,167,135,0,395,395,117.0,0.0,-117.0,0.0,0.0,0.0
atill001,Luis Atilano,Atlanta Braves,BRAVES,1,1,1,2,2006,2006,0,-0.89,0.15,1.04,29,20,-9,27,27,0,257.0,0.0,-257.0,0.0,700000.0,700000.0
atwet101,Toby Atwell,Brooklyn Dodgers,DOGRS,2,2,2,4,1951,1953,2,1.06,-0.26,-1.32,148,8,-140,517,9,-508,0.0,0.0,0.0,0.0,0.0,0.0
atwet101,Toby Atwell,Chicago Cubs,CUBS,7,18,16,34,1953,1965,12,5.64,21.93,16.29,1405,1825,420,3839,2173,-1666,1451.0,4951.0,3500.0,82000.0,75000.0,-7000.0
atwet101,Toby Atwell,Pittsburgh Pirates,PIRATS,4,4,6,10,1956,1962,6,-0.33,0.42,0.75,123,127,4,369,338,-31,0.0,0.0,0.0,11000.0,0.0,-11000.0
atwob101,Bill Atwood,Baltimore,Baltimore,1,1,1,2,1935,1935,0,-1.37,0.0,1.37,342,0,-342,1070,0,-1070,0.0,0.0,0.0,0.0,0.0,0.0
atz-j101,John Atz,Chicago White Sox,WSOX,2,8,2,10,1910,1928,18,0.0,33.7,33.7,0,1837,1837,0,6519,6519,0.0,0.0,0.0,0.0,0.0,0.0
atz-j101,John Atz,Cleveland Indians,INDINS,1,6,1,7,1913,1914,1,0.0,-0.98,-0.98,0,48,48,0,37,37,0.0,303.0,303.0,0.0,0.0,0.0
auerr101,Rick Auerbach,Milwaukee Brewers,BREWRS,2,2,2,4,1973,1978,5,-0.65,-0.27,0.38,277,407,130,511,1228,717,0.0,0.0,0.0,111500.0,0.0,-111500.0
auerr101,Rick Auerbach,Los Angeles Dodgers,DOGRS,1,1,2,3,1977,1977,0,0.0,0.2,0.2,0,10,10,0,0,0,0.0,24.0,24.0,0.0,0.0,0.0
auerr101,Rick Auerbach,New York Mets,METS,1,2,1,3,1977,1979,2,0.0,5.03,5.03,0,268,268,0,1093,1093,0.0,0.0,0.0,0.0,0.0,0.0
auerr101,Rick Auerbach,Texas Rangers,RNGRS,4,10,10,20,1980,1987,7,9.35,8.94,-0.41,686,425,-261,1581,631,-950,2721.0,2684.0,-37.0,817500.0,331000.0,-486500.0
augud001,Don August,Houston Astros,ASTROS,1,2,1,3,1986,1990,4,4.82,13.16,8.34,196,416,220,0,208,208,2588.0,2180.0,-408.0,0.0,610000.0,610000.0
augud101,Dave Augustine,Pittsburgh Pirates,PIRATS,1,1,1,2,1978,1978,0,0.0,0.0,0.0,0,0,0,0,0,0,0.0,0.0,0.0,0.0,0.0,0.0
aukee101,Elden Auker,Detroit Tigers,TIGRS,1,3,2,5,1938,1946,8,-0.33,15.76,16.09,102,1005,903,69,3681,3612,596.0,671.0,75.0,19500.0,16000.0,-3500.0
aumop001,Phillippe Aumont,Seattle Mariners,MARNRS,6,11,9,20,2009,2014,5,2.34,8.64,6.3,470,811,341,626,2617,1991,956.0,1416.0,460.0,10564000.0,427200.0,-10136800.0
aurir001,Rich Aurilia,Texas Rangers,RNGRS,1,2,1,3,1994,1995,1,14.18,0.0,-14.18,1333,0,-1333,5009,0,-5009,0.0,0.0,0.0,0.0,3550000.0,3550000.0
ausmb001,Brad Ausmus,Colorado Rockies,ROCKS,1,3,2,5,1993,1994,1,28.53,-1.48,-30.01,973,90,-883,1500,70,-1430,4150.0,636.0,-3514.0,150000.0,5025000.0,4875000.0
ausmb001,Brad Ausmus,San Diego Padres,PADRS,4,7,8,15,1996,2006,10,4.5,17.6,13.1,1037,1883,846,3956,6307,2351,0.0,1106.0,1106.0,11375000.0,15550000.0,4175000.0
ausmb001,Brad Ausmus,Detroit Tigers,TIGRS,5,12,14,26,1996,2010,14,13.89,24.32,10.43,4127,1434,-2693,10052,2196,-7856,4562.0,6757.0,2195.0,11529000.0,4780000.0,-6749000.0
ausmb001,Brad Ausmus,Houston Astros,ASTROS,1,2,5,7,1999,2001,2,6.68,0.38,-6.3,481,94,-387,1132,260,-872,710.0,103.0,-607.0,0.0,0.0,0.0
ausmb001,Brad Ausmus,Detroit Tigers,TIGRS,1,3,3,6,2000,2002,2,3.02,0.94,-2.08,1389,171,-1218,3537,610,-2927,741.0,454.0,-287.0,5550000.0,3640000.0,-1910000.0
austj001,Jim Austin,San Diego Padres,PADRS,1,2,1,3,1989,1989,0,2.11,-0.17,-2.28,83,14,-69,0,0,0,300.0,19.0,-281.0,0.0,0.0,0.0
austj002,Jeff Austin,Kansas City Royals,ROYALS,1,2,2,4,2003,2003,0,-0.36,0.0,0.36,139,0,-139,11,0,-11,223.0,0.0,-223.0,0.0,0.0,0.0
austj101,Jimmy Austin,New York Yankees,YANKS,1,2,2,4,1911,1911,0,24.82,2.99,-21.83,1527,144,-1383,6167,615,-5552,0.0,0.0,0.0,0.0,0.0,0.0
austt001,Tyler Austin,New York Yankees,YANKS,1,2,2,4,2018,2018,0,0.29,0.32,0.03,37,12,-25,141,2,-139,0.0,163.0,163.0,0.0,12000000.0,12000000.0
austt001,Tyler Austin,Minnesota Twins,TWINS,1,1,1,2,2019,2019,0,0.33,0.0,-0.33,70,0,-70,147,0,-147,0.0,0.0,0.0,0.0,0.0,0.0
autra101,Al Autry,Kansas City Royals,ROYALS,1,3,2,5,1975,1976,1,1.17,0.35,-0.82,138,8,-130,32,0,-32,436.0,23.0,-413.0,0.0,0.0,0.0
autrc101,Chick Autry,Lynn,Lynn,1,1,1,2,1909,1909,0,-0.66,0.0,0.66,65,0,-65,234,0,-234,0.0,0.0,0.0,0.0,0.0,0.0
autrc102,Chick Autry,Cleveland Indians,INDINS,1,1,1,2,1929,1929,0,-0.79,2.38,3.17,77,125,48,178,489,311,0.0,0.0,0.0,0.0,0.0,0.0
avela001,Abiatal Avelino,New York Yankees,YANKS,1,2,2,4,2018,2018,0,-0.04,0.93,0.97,10,25,15,19,114,95,0.0,0.0,0.0,0.0,14750000.0,14750000.0
avenb001,Bruce Aven,Florida Marlins,MARLNS,2,2,2,4,1999,2002,3,-0.36,2.72,3.08,72,108,36,153,146,-7,0.0,632.0,632.0,515000.0,290000.0,-225000.0
avenb001,Bruce Aven,Cleveland Indians,INDINS,1,1,1,2,2002,2002,0,0.0,0.0,0.0,0,0,0,0,0,0,0.0,0.0,0.0,0.0,0.0,0.0
avere101,Earl Averill,Cleveland Indians,INDINS,1,1,2,3,1939,1946,7,0.45,4.92,4.47,151,206,55,490,69,-421,0.0,771.0,771.0,0.0,0.0,0.0
avere102,Earl Averill,Cleveland Indians,INDINS,2,4,3,7,1959,1960,1,-1.11,0.25,1.36,167,69,-98,374,39,-335,7.0,147.0,140.0,0.0,0.0,0.0
avere102,Earl Averill,Chicago Cubs,CUBS,1,2,1,3,1960,1961,1,0.0,2.07,2.07,0,150,150,0,479,479,0.0,0.0,0.0,0.0,0.0,0.0
avere102,Earl Averill,Milwaukee Braves,BRAVES,1,1,2,3,1960,1960,0,0.03,0.0,-0.03,10,0,-10,18,0,-18,0.0,0.0,0.0,0.0,0.0,0.0
avere102,Earl Averill,Los Angeles Angels,ANGELS,2,2,2,4,1962,1963,1,0.4,0.59,0.19,47,60,13,83,227,144,0.0,0.0,0.0,0.0,0.0,0.0
averx001,Xavier Avery,Baltimore Orioles,ORLS,1,1,1,2,2013,2013,0,0.0,-0.49,-0.49,0,12,12,0,30,30,0.0,0.0,0.0,0.0,0.0,0.0
avila001,Alex Avila,Detroit Tigers,TIGRS,1,2,3,5,2017,2017,0,1.19,0.18,-1.01,218,27,-191,113,106,-7,217.0,0.0,-217.0,4700000.0,0.0,-4700000.0
avilb101,Bobby Avila,Cleveland Indians,INDINS,1,1,2,3,1958,1961,3,-0.65,0.11,0.76,20,12,-8,51,1,-50,0.0,30.0,30.0,20000.0,0.0,-20000.0
avill001,Luis Avilan,Atlanta Braves,BRAVES,3,7,11,18,2015,2020,5,4.88,-1.29,-6.17,588,465,-123,687,1320,633,1642.0,246.0,-1396.0,24400000.0,34929500.0,10529500.0
avill001,Luis Avilan,Los Angeles Dodgers,DOGRS,1,4,2,6,2018,2021,3,0.31,0.86,0.55,61,242,181,1,6,5,119.0,333.0,214.0,0.0,0.0,0.0
avill001,Luis Avilan,Chicago White Sox,WSOX,1,1,1,2,2018,2018,0,0.21,0.0,-0.21,23,0,-23,0,0,0,17.0,0.0,-17.0,2450000.0,0.0,-2450000.0
avilm001,Mike Aviles,Kansas City Royals,ROYALS,3,3,5,8,2011,2016,5,2.16,-0.51,-2.67,214,19,-195,709,26,-683,31.0,38.0,7.0,640000.0,0.0,-640000.0
avilm001,Mike Aviles,Boston Red Sox,RSOX,1,1,2,3,2012,2012,0,0.0,0.0,0.0,0,0,0,0,0,0,0.0,0.0,0.0,1200000.0,0.0,-1200000.0
avilm001,Mike Aviles,Toronto Blue Jays,BJAYS,1,2,1,3,2012,2014,2,11.57,-0.01,-11.58,944,66,-878,3396,7,-3389,0.0,475.0,475.0,0.0,481000.0,481000.0
avilm001,Mike Aviles,Detroit Tigers,TIGRS,1,2,1,3,2016,2016,0,0.0,0.21,0.21,0,29,29,0,91,91,0.0,0.0,0.0,0.0,0.0,0.0
avilp001,Pedro Avila,Washington Nationals,NATEX,1,1,1,2,2016,2017,1,0.31,0.0,-0.31,4,0,-4,3,0,-3,28.0,0.0,-28.0,0.0,2925000.0,2925000.0
avilr101,Ramon Aviles,Philadelphia Phillies,PHILS,1,1,1,2,1981,1982,1,0.0,0.0,0.0,0,0,0,0,0,0,0.0,0.0,0.0,0.0,0.0,0.0
axfoj001,John Axford,Milwaukee Brewers,BREWRS,1,1,1,2,2013,2017,4,0.31,-0.23,-0.54,26,192,166,0,6,6,31.0,338.0,307.0,5000000.0,0.0,-5000000.0
axfoj001,John Axford,Toronto Blue Jays,BJAYS,1,1,1,2,2018,2018,0,-0.4,0.0,0.4,10,0,-10,0,0,0,11.0,0.0,-11.0,1500000.0,0.0,-1500000.0
ayalb001,Benny Ayala,New York Mets,METS,1,1,1,2,1977,1977,0,0.1,0.0,-0.1,1,0,-1,3,0,-3,0.0,0.0,0.0,0.0,0.0,0.0
ayalb001,Benny Ayala,St. Louis Cardinals,CARDS,1,1,1,2,1979,1979,0,1.56,0.02,-1.54,333,6,-327,761,3,-758,0.0,0.0,0.0,0.0,0.0,0.0
ayalb002,Bobby Ayala,Cincinnati Reds,REDS,9,15,18,33,1993,2013,20,45.48,40.95,-4.53,3672,3082,-590,10149,8976,-1173,3098.0,6878.0,3780.0,12546000.0,18840000.0,6294000.0
ayalb002,Bobby Ayala,Seattle Mariners,MARNRS,1,1,1,2,1999,1999,0,0.43,0.0,-0.43,101,0,-101,1,0,-1,198.0,0.0,-198.0,0.0,0.0,0.0
ayall001,Luis Ayala,Washington Nationals,NATEX,2,2,2,4,2008,2009,1,-0.39,0.89,1.28,84,105,21,149,346,197,54.0,0.0,-54.0,2100000.0,0.0,-2100000.0
ayall001,Luis Ayala,Baltimore Orioles,ORLS,1,1,1,2,2013,2013,0,0.43,0.0,-0.43,73,0,-73,0,0,0,93.0,0.0,-93.0,0.0,0.0,0.0
aybae001,Erick Aybar,Anaheim Angels,ANGELS,1,4,2,6,2015,2020,5,2.92,20.49,17.57,366,607,241,466,2409,1943,1135.0,0.0,-1135.0,8500000.0,3000000.0,-5500000.0
aybae001,Erick Aybar,Atlanta Braves,BRAVES,1,1,2,3,2016,2016,0,0.21,0.0,-0.21,29,0,-29,91,0,-91,0.0,0.0,0.0,0.0,0.0,0.0
aybam001,Manny Aybar,St. Louis Cardinals,CARDS,2,6,4,10,1999,2003,4,3.2,2.78,-0.42,870,638,-232,626,106,-520,1171.0,1638.0,467.0,860000.0,10709647.0,9849647.0
aybam001,Manny Aybar,Colorado Rockies,ROCKS,5,7,8,15,2000,2003,3,2.36,5.24,2.88,579,451,-128,516,260,-256,1078.0,573.0,-505.0,5086667.0,7355000.0,2268333.0
aybam001,Manny Aybar,Cincinnati Reds,REDS,2,4,4,8,2000,2002,2,0.68,-0.66,-1.34,42,20,-22,0,16,16,82.0,130.0,48.0,0.0,2400000.0,2400000.0
aybam001,Manny Aybar,Florida Marlins,MARLNS,1,1,1,2,2001,2003,2,-0.19,-0.3,-0.11,34,58,24,4,0,-4,68.0,101.0,33.0,0.0,0.0,0.0
aybam001,Manny Aybar,Chicago Cubs,CUBS,1,2,1,3,2001,2002,1,-0.39,3.26,3.65,27,195,168,73,796,723,0.0,0.0,0.0,665000.0,6500000.0,5835000.0
aybaw001,Willy Aybar,Los Angeles Dodgers,DOGRS,2,4,2,6,2006,2008,2,-0.19,0.14,0.33,182,280,98,417,385,-32,30.0,212.0,182.0,4405000.0,800923.0,-3604077.0
aybaw001,Willy Aybar,Atlanta Braves,BRAVES,1,2,1,3,2008,2009,1,1.25,0.21,-1.04,300,18,-282,1007,0,-1007,0.0,29.0,29.0,0.0,0.0,0.0
ayerb101,Bill Ayers,New York Giants,GIANTS,1,5,3,8,1950,1954,4,0.0,-0.44,-0.44,0,186,186,0,308,308,0.0,172.0,172.0,0.0,0.0,0.0
ayerd101,Doc Ayers,Washington Senators,TWINS,1,1,1,2,1919,1919,0,2.43,0.34,-2.09,144,40,-104,90,54,-36,909.0,396.0,-513.0,3000.0,0.0,-3000.0
ayrab001,Bob Ayrault,Philadelphia Phillies,PHILS,3,3,3,6,1993,1994,1,3.53,-0.58,-4.11,201,41,-160,193,32,-161,1523.0,273.0,-1250.0,125000.0,300000.0,175000.0
azcuj101,Joe Azcue,Milwaukee Braves,BRAVES,11,17,20,37,1961,1973,12,24.16,33.51,9.35,2325,1915,-410,6983,5059,-1924,2257.0,3206.0,949.0,95000.0,38000.0,-57000.0
azcuj101,Joe Azcue,Kansas City Athletics,ATLTCS,12,26,19,45,1963,1976,13,41.52,16.46,-25.06,5320,2149,-3171,12652,5616,-7036,5181.0,2140.0,-3041.0,368100.0,463000.0,94900.0
azcuj101,Joe Azcue,Cleveland Indians,INDINS,1,3,3,6,1969,1970,1,13.72,3.96,-9.76,502,371,-131,436,691,255,3166.0,784.0,-2382.0,34500.0,0.0,-34500.0
azcuj101,Joe Azcue,Boston Red Sox,RSOX,1,1,1,2,1969,1971,2,-1.03,-1.04,-0.01,197,106,-91,665,348,-317,0.0,0.0,0.0,26500.0,0.0,-26500.0
azcuj101,Joe Azcue,California Angels,ANGELS,4,7,6,13,1972,1976,4,1.77,3.03,1.26,444,170,-274,1491,564,-927,0.0,90.0,90.0,63500.0,54000.0,-9500.0
azoco001,Oscar Azocar,New York Yankees,YANKS,1,1,1,2,1990,1991,1,-1.09,0.0,1.09,137,25,-112,242,50,-192,0.0,0.0,0.0,100000.0,0.0,-100000.0
babbc101,Charlie Babb,New York Giants,GIANTS,5,14,7,21,1903,1921,18,51.29,48.92,-2.37,2751,2179,-572,9350,7604,-1746,2651.0,2915.0,264.0,6400.0,5200.0,-1200.0
babcb101,Bob Babcock,Baltimore Orioles,ORLS,1,1,1,2,1976,1976,0,0.27,0.0,-0.27,39,0,-39,0,0,0,172.0,0.0,-172.0,0.0,0.0,0.0
babcb101,Bob Babcock,Texas Rangers,RNGRS,1,1,1,2,1983,1983,0,0.0,0.0,0.0,0,0,0,0,0,0,0.0,0.0,0.0,0.0,0.0,0.0
babel101,Loren Babe,Philadelphia Athletics,ATLTCS,46,109,116,225,1953,1976,23,189.08,109.39,-79.69,16486,13560,-2926,40867,38903,-1964,20759.0,16429.0,-4330.0,546100.0,754900.0,208800.0
babij101,Johnny Babich,Mission,Mission,1,1,2,3,1934,1934,0,-3.62,0.0,3.62,124,0,-124,102,0,-102,835.0,0.0,-835.0,0.0,0.0,0.0
babij101,Johnny Babich,Brooklyn Dodgers,DOGRS,2,3,2,5,1936,1939,3,16.05,5.67,-10.38,637,216,-421,2368,193,-2175,132.0,1522.0,1390.0,0.0,0.0,0.0
babij101,Johnny Babich,Boston Braves,BRAVES,6,18,10,28,1938,1952,14,22.0,33.53,11.53,1506,1625,119,5516,5420,-96,0.0,2449.0,2449.0,12500.0,0.0,-12500.0
babij101,Johnny Babich,Philadelphia Athletics,ATLTCS,1,2,1,3,1941,1941,0,0.0,0.0,0.0,0,0,0,0,0,0,0.0,0.0,0.0,7500.0,0.0,-7500.0
babij101,Johnny Babich,New York Yankees,YANKS,1,2,1,3,1944,1950,6,0.0,-1.41,-1.41,0,90,90,0,41,41,0.0,394.0,394.0,0.0,0.0,0.0
backb001,Brandon Backe,Tampa Bay Devil Rays,RAYS,1,1,1,2,2003,2004,1,2.75,-0.65,-3.4,216,112,-104,158,369,211,1403.0,0.0,-1403.0,0.0,1500000.0,1500000.0
backw001,Wally Backman,New York Mets,METS,1,2,3,5,1988,1988,0,-0.66,0.0,0.66,87,0,-87,337,0,-337,0.0,0.0,0.0,650000.0,0.0,-650000.0
bacsm001,Michael Bacsik,Cleveland Indians,INDINS,3,5,7,12,2001,2008,7,0.76,6.93,6.17,461,824,363,1426,2856,1430,357.0,576.0,219.0,15000000.0,0.0,-15000000.0
bacsm101,Mike Bacsik,Texas Rangers,RNGRS,1,1,1,2,1978,1978,0,0.0,0.0,0.0,41,0,-41,0,0,0,266.0,0.0,-266.0,0.0,0.0,0.0
bacsm101,Mike Bacsik,Minnesota Twins,TWINS,1,1,1,2,1980,1981,1,0.0,0.0,0.0,0,0,0,0,0,0,0.0,0.0,0.0,0.0,0.0,0.0
bacud001,Dakota Bacus,Oakland Athletics,ATLTCS,1,1,1,2,2013,2013,0,-0.13,0.33,0.46,11,15,4,0,35,35,34.0,0.0,-34.0,0.0,0.0,0.0
baczf101,Fred Baczewski,Chicago Cubs,CUBS,4,9,6,15,1953,1961,8,2.91,2.3,-0.61,226,408,182,136,878,742,1159.0,691.0,-468.0,0.0,0.0,0.0
badeb001,Burke Badenhop,Detroit Tigers,TIGRS,2,8,3,11,2007,2010,3,-0.1,-1.19,-1.09,705,27,-678,1077,3,-1074,1506.0,303.0,-1203.0,12380000.0,13850000.0,1470000.0
badeb001,Burke Badenhop,Florida Marlins,MARLNS,1,1,1,2,2011,2011,0,0.74,0.0,-0.74,71,0,-71,1,0,-1,187.0,0.0,-187.0,750000.0,0.0,-750000.0
badeb001,Burke Badenhop,Tampa Bay Devil Rays,RAYS,1,1,1,2,2012,2012,0,-0.36,0.0,0.36,124,0,-124,1,0,-1,187.0,0.0,-187.0,1075000.0,0.0,-1075000.0
badeb001,Burke Badenhop,Milwaukee Brewers,BREWRS,1,1,1,2,2013,2013,0,1.52,0.0,-1.52,76,0,-76,0,0,0,212.0,0.0,-212.0,1550000.0,0.0,-1550000.0
baece101,Ed Baecht,Chicago Cubs,CUBS,2,7,2,9,1933,1938,5,10.27,0.77,-9.5,576,293,-283,361,754,393,2894.0,224.0,-2670.0,0.0,0.0,0.0
baekc001,Cha-Seung Baek,Seattle Mariners,MARNRS,1,1,1,2,2008,2009,1,0.31,-0.17,-0.48,45,6,-39,38,0,-38,333.0,16.0,-317.0,392500.0,0.0,-392500.0
baerc001,Carlos Baerga,San Diego Padres,PADRS,7,14,16,30,1989,1998,9,77.02,12.33,-64.69,5607,1502,-4105,22003,4193,-17810,1355.0,1888.0,533.0,8656667.0,4815000.0,-3841667.0
baerc001,Carlos Baerga,Cleveland Indians,INDINS,5,12,10,22,1996,2001,5,73.82,8.63,-65.19,4077,457,-3620,13151,1605,-11546,1815.0,172.0,-1643.0,13083332.0,17360000.0,4276668.0
baezd001,Danys Baez,Tampa Bay Devil Rays,RAYS,5,6,7,13,2006,2018,12,2.76,13.6,10.84,309,789,480,288,2263,1975,1120.0,1336.0,216.0,7137700.0,1462500.0,-5675200.0
baezd001,Danys Baez,Los Angeles Dodgers,DOGRS,2,4,2,6,2006,2008,2,-0.19,0.14,0.33,182,280,98,417,385,-32,30.0,212.0,182.0,4405000.0,800923.0,-3604077.0
baezj001,Javier Baez,Chicago Cubs,CUBS,1,3,1,4,2021,2021,0,2.33,0.0,-2.33,66,0,-66,194,0,-194,97.0,0.0,-97.0,14100000.0,0.0,-14100000.0
baezj101,Jose Baez,Seattle Mariners,MARNRS,1,1,1,2,1978,1978,0,0.0,0.0,0.0,0,0,0,0,0,0,0.0,0.0,0.0,0.0,0.0,0.0
baezk001,Kevin Baez,New York Mets,METS,10,20,16,36,1994,2005,11,9.72,5.49,-4.23,1692,2201,509,3051,3605,554,2422.0,2911.0,489.0,20343890.0,14951666.0,-5392224.0
baezk001,Kevin Baez,Detroit Tigers,TIGRS,1,1,1,2,1998,1998,0,0.0,0.0,0.0,0,0,0,0,0,0,0.0,0.0,0.0,0.0,0.0,0.0
bagbj102,Jim Bagby,Boston Red Sox,RSOX,4,12,11,23,1940,1956,16,20.74,30.94,10.2,2288,1730,-558,6966,4243,-2723,4828.0,6235.0,1407.0,124000.0,52122.0,-71878.0
bagbj102,Jim Bagby,Cleveland Indians,INDINS,1,1,2,3,1945,1945,0,-0.36,0.0,0.36,42,0,-42,44,0,-44,320.0,0.0,-320.0,10200.0,4000.0,-6200.0
bagwb101,Bill Bagwell,Philadelphia Athletics,ATLTCS,1,4,1,5,1925,1925,0,0.0,0.15,0.15,0,133,133,0,522,522,0.0,0.0,0.0,4850.0,0.0,-4850.0
bagwb101,Bill Bagwell,Philadelphia Athletics,ATLTCS,1,4,1,5,1925,1925,0,0.0,0.15,0.15,0,133,133,0,522,522,0.0,0.0,0.0,4850.0,0.0,-4850.0
bagwj001,Jeff Bagwell,Boston Red Sox,RSOX,1,1,1,2,1990,1990,0,79.9,1.24,-78.66,2150,15,-2135,9431,0,-9431,0.0,66.0,66.0,0.0,965000.0,965000.0
bahns101,Stan Bahnsen,New York Yankees,YANKS,2,3,2,5,1971,1973,2,7.07,0.79,-6.28,331,160,-171,403,666,263,2477.0,0.0,-2477.0,68500.0,109000.0,40500.0
bahns101,Stan Bahnsen,Chicago White Sox,WSOX,3,6,4,10,1975,1982,7,34.65,31.64,-3.01,1494,1083,-411,4882,3877,-1005,2522.0,716.0,-1806.0,0.0,600000.0,600000.0
bahns101,Stan Bahnsen,Oakland Athletics,ATLTCS,1,1,1,2,1977,1977,0,0.19,0.77,0.58,408,66,-342,97,236,139,1311.0,0.0,-1311.0,0.0,0.0,0.0
bahre101,Ed Bahr,Pittsburgh Pirates,PIRATS,1,2,1,3,1949,1949,0,0.0,0.0,0.0,0,0,0,0,0,0,0.0,0.0,0.0,0.0,0.0,0.0
baila001,Andrew Bailey,Oakland Athletics,ATLTCS,2,4,6,10,2011,2019,8,6.28,16.11,9.83,292,639,347,512,2366,1854,1216.0,614.0,-602.0,1865000.0,0.0,-1865000.0
bailb001,Bob Bailor,Toronto Blue Jays,BJAYS,1,1,1,2,1980,1985,5,3.92,4.3,0.38,279,191,-88,867,0,-867,0.0,1011.0,1011.0,130000.0,0.0,-130000.0
bailb001,Bob Bailor,New York Mets,METS,1,2,2,4,1983,1993,10,1.25,29.07,27.82,343,528,185,279,590,311,437.0,4754.0,4317.0,314167.0,0.0,-314167.0
bailb002,Brandon Bailey,Oakland Athletics,ATLTCS,1,1,1,2,2017,2017,0,0.13,0.0,-0.13,5,0,-5,0,0,0,22.0,0.0,-22.0,0.0,0.0,0.0
bailb101,Bill Bailey,Baltimore Terrapins,BLF,1,1,1,2,1915,1915,0,0.66,0.0,-0.66,10,0,-10,11,0,-11,100.0,0.0,-100.0,0.0,0.0,0.0
bailb101,Bill Bailey,St.Louis Browns,ORLS,1,1,1,2,1911,1911,0,0.0,0.0,0.0,0,0,0,0,0,0,0.0,0.0,0.0,0.0,0.0,0.0
bailb103,Bob Bailey,Pittsburgh Pirates,PIRATS,1,2,1,3,1966,1968,2,-0.49,7.77,8.26,319,302,-17,982,1350,368,0.0,0.0,0.0,0.0,85000.0,85000.0
bailb103,Bob Bailey,Montreal Expos,NATEX,1,1,1,2,1975,1976,1,0.41,-1.62,-2.03,118,44,-74,233,25,-208,0.0,236.0,236.0,0.0,0.0,0.0
bailb103,Bob Bailey,Cincinnati Reds,REDS,1,1,2,3,1977,1977,0,-0.29,0.0,0.29,45,0,-45,118,0,-118,0.0,0.0,0.0,0.0,0.0,0.0
bailc001,Cory Bailey,Boston Red Sox,RSOX,4,7,6,13,1995,1997,2,2.06,3.71,1.65,881,324,-557,1600,1071,-529,1046.0,345.0,-701.0,1638268.0,2000000.0,361732.0
bailc001,Cory Bailey,St. Louis Cardinals,CARDS,1,1,1,2,1996,1996,0,0.0,0.0,0.0,0,0,0,0,0,0,0.0,0.0,0.0,125000.0,0.0,-125000.0
bailc001,Cory Bailey,Texas Rangers,RNGRS,1,1,1,2,1997,1997,0,-0.19,0.0,0.19,23,0,-23,1,0,-1,39.0,0.0,-39.0,0.0,0.0,0.0
baile101,Ed Bailey,Cincinnati Reds,REDS,4,6,7,13,1961,1966,5,12.35,2.83,-9.52,1092,854,-238,3026,2045,-981,1452.0,592.0,-860.0,0.0,0.0,0.0
baile101,Ed Bailey,San Francisco Giants,GIANTS,8,14,12,26,1963,1972,9,20.6,12.56,-8.04,1709,1303,-406,5210,1731,-3479,1169.0,4789.0,3620.0,50000.0,89000.0,39000.0
baile101,Ed Bailey,Milwaukee Braves,BRAVES,2,2,2,4,1965,1967,2,-0.65,3.59,4.24,153,198,45,83,47,-36,474.0,596.0,122.0,0.0,0.0,0.0
baile101,Ed Bailey,San Francisco Giants,GIANTS,3,5,4,9,1965,1968,3,-1.4,-0.01,1.39,272,250,-22,397,696,299,492.0,0.0,-492.0,33000.0,30000.0,-3000.0
bailg101,Gene Bailey,Brooklyn Dodgers,DOGRS,3,7,5,12,1924,1927,3,6.65,3.39,-3.26,787,606,-181,3022,2382,-640,0.0,0.0,0.0,32500.0,4800.0,-27700.0
bailh001,Homer Bailey,Cincinnati Reds,REDS,2,6,6,12,2018,2020,2,0.33,2.24,1.91,53,294,241,210,761,551,24.0,499.0,475.0,30700000.0,49964000.0,19264000.0
bailh001,Homer Bailey,Kansas City Royals,ROYALS,1,1,1,2,2019,2019,0,0.92,0.0,-0.92,15,0,-15,4,0,-4,220.0,0.0,-220.0,100000.0,0.0,-100000.0
bailm001,Mark Bailey,Houston Astros,ASTROS,1,1,1,2,1988,1993,5,0.0,3.13,3.13,0,512,512,0,1327,1327,0.0,0.0,0.0,100000.0,110000.0,10000.0
bailm001,Mark Bailey,Montreal Expos,NATEX,1,2,1,3,1989,1992,3,0.25,-0.1,-0.35,91,204,113,144,4,-140,0.0,350.0,350.0,0.0,0.0,0.0
bails001,Scott Bailes,Pittsburgh Pirates,PIRATS,1,1,1,2,1985,1986,1,1.54,-0.13,-1.67,174,22,-152,0,65,65,1475.0,0.0,-1475.0,0.0,0.0,0.0
bails001,Scott Bailes,Cleveland Indians,INDINS,1,1,2,3,1990,1991,1,-1.98,0.04,2.02,101,77,-24,0,245,245,377.0,0.0,-377.0,0.0,0.0,0.0
bainh001,Harold Baines,Chicago White Sox,WSOX,9,18,22,40,1989,2011,22,68.5,42.52,-25.98,3028,2464,-564,8796,4720,-4076,3081.0,6620.0,3539.0,22245000.0,12851333.0,-9393667.0
bainh001,Harold Baines,Texas Rangers,RNGRS,1,1,2,3,1990,1992,2,3.9,1.62,-2.28,313,30,-283,1227,0,-1227,0.0,327.0,327.0,1143539.0,0.0,-1143539.0
bainh001,Harold Baines,Oakland Athletics,ATLTCS,1,1,2,3,1993,1997,4,9.51,0.46,-9.05,666,13,-653,2415,0,-2415,0.0,177.0,177.0,0.0,0.0,0.0
bainh001,Harold Baines,Chicago White Sox,WSOX,1,1,1,2,1997,1997,0,4.23,0.0,-4.23,327,0,-327,1119,0,-1119,0.0,0.0,0.0,1925000.0,0.0,-1925000.0
bainh001,Harold Baines,Baltimore Orioles,ORLS,2,2,3,5,1999,2001,2,-0.27,0.0,0.27,28,0,-28,96,0,-96,0.0,0.0,0.0,1730000.0,0.0,-1730000.0
bainh001,Harold Baines,Baltimore Orioles,ORLS,1,2,4,6,2000,2003,3,0.48,0.13,-0.35,100,312,212,320,1036,716,0.0,0.0,0.0,6600000.0,675000.0,-5925000.0
baird001,Doug Bair,Pittsburgh Pirates,PIRATS,5,10,11,21,1977,1988,11,53.71,31.99,-21.72,2929,1675,-1254,9660,6568,-3092,5429.0,149.0,-5280.0,807000.0,0.0,-807000.0
baird001,Doug Bair,Oakland Athletics,ATLTCS,2,4,4,8,1978,1983,5,2.08,8.1,6.02,514,624,110,229,1866,1637,956.0,1046.0,90.0,0.0,0.0,0.0
baird001,Doug Bair,Cincinnati Reds,REDS,1,1,2,3,1981,1981,0,2.2,0.51,-1.69,204,12,-192,20,4,-16,417.0,38.0,-379.0,0.0,0.0,0.0
baird001,Doug Bair,St. Louis Cardinals,CARDS,2,2,3,5,1983,1985,2,-1.06,1.29,2.35,215,327,112,15,98,83,908.0,523.0,-385.0,450000.0,0.0,-450000.0
baird101,Doug Baird,Pittsburgh Pirates,PIRATS,1,1,1,2,1917,1918,1,5.51,2.15,-3.36,202,80,-122,798,95,-703,0.0,687.0,687.0,1800.0,2500.0,700.0
baird101,Doug Baird,St. Louis Cardinals,CARDS,4,7,6,13,1919,1928,9,6.49,22.08,15.59,1385,1345,-40,4793,5431,638,403.0,0.0,-403.0,33500.0,21000.0,-12500.0
baird101,Doug Baird,Philadelphia Phillies,PHILS,3,6,7,13,1919,1925,6,15.32,16.37,1.05,851,640,-211,1993,1730,-263,4451.0,3043.0,-1408.0,8500.0,16850.0,8350.0
baird101,Doug Baird,New York Giants,GIANTS,2,6,2,8,1920,1926,6,11.79,12.89,1.1,909,766,-143,3326,3233,-93,0.0,0.0,0.0,8100.0,5000.0,-3100.0
bajej001,Jeff Bajenaru,Chicago White Sox,WSOX,1,1,1,2,2006,2007,1,-0.3,-2.54,-2.24,2,159,157,0,500,500,3.0,0.0,-3.0,0.0,0.0,0.0
bakeb001,Bryan Baker,Colorado Rockies,ROCKS,1,3,1,4,2018,2019,1,0.04,0.16,0.12,1,90,89,0,0,0,3.0,119.0,116.0,0.0,0.0,0.0
bakec101,Chuck Baker,San Diego Padres,PADRS,1,1,1,2,1980,1982,2,-0.46,-0.7,-0.24,40,129,89,70,181,111,0.0,0.0,0.0,0.0,0.0,0.0
baked001,Doug Baker,Detroit Tigers,TIGRS,1,1,1,2,1988,1988,0,0.64,0.0,-0.64,57,0,-57,100,0,-100,0.0,0.0,0.0,0.0,0.0,0.0
baked002,Dusty Baker,Atlanta Braves,BRAVES,2,4,5,9,1975,1984,9,23.22,0.43,-22.79,1629,1492,-137,5388,5061,-327,292.0,128.0,-164.0,0.0,135000.0,135000.0
baked002,Dusty Baker,San Francisco Giants,GIANTS,1,1,2,3,1985,1985,0,2.32,0.0,-2.32,194,0,-194,667,0,-667,0.0,0.0,0.0,0.0,0.0,0.0
baked101,Dave Baker,Toronto Blue Jays,BJAYS,2,2,2,4,1982,1984,2,-0.06,-0.05,0.01,7,4,-3,0,0,0,30.0,16.0,-14.0,0.0,0.0,0.0
bakef101,Frank Baker,New York Yankees,YANKS,1,1,1,2,1973,1973,0,-0.36,0.0,0.36,68,0,-68,103,0,-103,0.0,0.0,0.0,0.0,0.0,0.0
bakef102,Home Run Baker,Reading,Reading,1,1,1,2,1908,1908,0,42.2,0.0,-42.2,899,0,-899,3853,0,-3853,0.0,0.0,0.0,0.0,0.0,0.0
bakef103,Floyd Baker,Chicago White Sox,WSOX,3,4,4,8,1951,1954,3,0.47,0.91,0.44,828,226,-602,2411,504,-1907,0.0,0.0,0.0,32500.0,0.0,-32500.0
bakef104,Frank Baker,Cleveland Indians,INDINS,8,13,14,27,1971,1984,13,47.87,7.93,-39.94,2666,2447,-219,9920,8254,-1666,38.0,317.0,279.0,169250.0,286600.0,117350.0
bakeg101,Gene Baker,Chicago Cubs,CUBS,4,7,6,13,1957,1961,4,9.53,8.89,-0.64,897,921,24,1516,3331,1815,802.0,0.0,-802.0,17500.0,0.0,-17500.0
bakej001,Jeff Baker,Colorado Rockies,ROCKS,1,1,1,2,2009,2010,1,1.63,0.0,-1.63,283,0,-283,804,0,-804,0.0,0.0,0.0,415000.0,0.0,-415000.0
bakej001,Jeff Baker,Detroit Tigers,TIGRS,1,1,1,2,2012,2012,0,-0.38,0.0,0.38,14,0,-14,20,0,-20,0.0,0.0,0.0,0.0,0.0,0.0
bakej001,Jeff Baker,Chicago Cubs,CUBS,1,1,2,3,2012,2012,0,-0.35,0.0,0.35,15,0,-15,37,0,-37,0.0,0.0,0.0,1375000.0,0.0,-1375000.0
bakej002,John Baker,Oakland Athletics,ATLTCS,1,1,1,2,2007,2007,0,1.7,0.0,-1.7,212,0,-212,760,0,-760,0.0,0.0,0.0,0.0,0.0,0.0
bakej002,John Baker,Florida Marlins,MARLNS,1,1,1,2,2011,2013,2,0.2,1.02,0.82,79,75,-4,260,29,-231,0.0,352.0,352.0,417000.0,0.0,-417000.0
bakej103,Jack Baker,Boston Red Sox,RSOX,2,4,3,7,1977,1986,9,26.9,0.41,-26.49,1356,730,-626,5373,2641,-2732,4.0,0.0,-4.0,440000.0,0.0,-440000.0
bakes001,Scott Baker,Florida Marlins,MARLNS,1,2,1,3,1992,1993,1,-0.34,1.48,1.82,54,158,104,120,591,471,11.0,0.0,-11.0,0.0,760000.0,760000.0
bakes101,Steve Baker,Oakland Athletics,ATLTCS,1,1,2,3,1983,1983,0,0.1,0.0,-0.1,16,0,-16,0,0,0,30.0,0.0,-30.0,0.0,0.0,0.0
bakes101,Steve Baker,Montreal Expos,NATEX,1,1,1,2,1985,1987,2,0.0,-0.2,-0.2,0,1,1,0,4,4,0.0,0.0,0.0,0.0,0.0,0.0
baket101,Tracy Baker,Boston Red Sox,RSOX,10,29,25,54,1911,1935,24,51.77,27.79,-23.98,3792,3076,-716,15081,11324,-3757,0.0,1203.0,1203.0,45050.0,29350.0,-15700.0
baket103,Tom Baker,Brooklyn Dodgers,DOGRS,1,1,1,2,1937,1942,5,0.19,12.0,11.81,30,202,172,10,256,246,105.0,1994.0,1889.0,0.0,0.0,0.0
baket103,Tom Baker,New York Giants,GIANTS,1,3,1,4,1938,1940,2,0.0,3.47,3.47,0,123,123,0,517,517,0.0,0.0,0.0,0.0,0.0,0.0
bakop001,Paul Bako,Cincinnati Reds,REDS,1,2,1,3,1997,1998,1,0.65,-0.13,-0.78,96,83,-13,333,147,-186,0.0,0.0,0.0,0.0,335000.0,335000.0
bakop001,Paul Bako,Detroit Tigers,TIGRS,3,10,6,16,1999,2002,3,3.62,7.62,4.0,1493,652,-841,3797,1742,-2055,861.0,1164.0,303.0,6750000.0,3640000.0,-3110000.0
bakop001,Paul Bako,Atlanta Braves,BRAVES,1,2,1,3,2002,2003,1,-3.2,-1.6,1.6,184,136,-48,277,415,138,310.0,0.0,-310.0,0.0,0.0,0.0
bakop001,Paul Bako,Milwaukee Brewers,BREWRS,1,1,1,2,2002,2002,0,0.48,0.0,-0.48,119,0,-119,370,0,-370,0.0,0.0,0.0,750000.0,0.0,-750000.0
balaj101,John Balaz,California Angels,ANGELS,2,4,2,6,1976,1979,3,0.01,3.49,3.48,36,153,117,0,0,0,119.0,938.0,819.0,0.0,0.0,0.0
balbs001,Steve Balboni,New York Yankees,YANKS,1,2,2,4,1983,1986,3,1.05,0.96,-0.09,566,53,-513,2201,0,-2201,0.0,233.0,233.0,180000.0,0.0,-180000.0
balbs001,Steve Balboni,Seattle Mariners,MARNRS,1,1,1,2,1989,1989,0,-0.57,0.0,0.57,226,0,-226,641,0,-641,0.0,0.0,0.0,0.0,0.0,0.0
baldb101,Billy Baldwin,Detroit Tigers,TIGRS,2,3,4,7,1975,1979,4,1.24,6.09,4.85,109,575,466,196,2407,2211,578.0,284.0,-294.0,95000.0,110000.0,15000.0
baldd101,Dave Baldwin,Washington Senators,RNGRS,17,36,26,62,1969,1988,19,50.01,50.13,0.12,3095,3348,253,9917,9957,40,4531.0,7211.0,2680.0,573500.0,336000.0,-237500.0
baldj001,Jeff Baldwin,Houston Astros,ASTROS,1,1,1,2,1991,1991,0,0.0,-1.78,-1.78,0,14,14,0,1,1,0.0,24.0,24.0,0.0,0.0,0.0
baldj002,James Baldwin,Chicago White Sox,WSOX,1,2,3,5,2001,2002,1,0.96,0.0,-0.96,24,0,-24,27,0,-27,238.0,0.0,-238.0,5950000.0,0.0,-5950000.0
baldj101,Jack Baldschun,Philadelphia Phillies,PHILS,3,4,4,8,1965,1969,4,9.35,1.85,-7.5,553,451,-102,133,871,738,1272.0,301.0,-971.0,34500.0,45500.0,11000.0
baldj101,Jack Baldschun,Baltimore Orioles,ORLS,6,17,17,34,1965,1988,23,25.25,102.26,77.01,1580,4270,2690,1563,10311,8748,8511.0,12795.0,4284.0,757833.0,65400.0,-692433.0
baldr102,Reggie Baldwin,Houston Astros,ASTROS,1,1,1,2,1980,1980,0,0.0,0.0,0.0,0,0,0,0,0,0,0.0,0.0,0.0,0.0,0.0,0.0
balec001,Collin Balester,Washington Nationals,NATEX,1,1,1,2,2011,2014,3,-0.24,-0.38,-0.14,11,14,3,0,0,0,54.0,24.0,-30.0,0.0,430000.0,430000.0
balej001,John Bale,Toronto Blue Jays,BJAYS,4,8,8,16,2000,2014,14,3.7,13.0,9.3,601,969,368,810,1750,940,922.0,1398.0,476.0,7829600.0,16693000.0,8863400.0
balej001,John Bale,Baltimore Orioles,ORLS,1,1,1,2,2002,2003,1,0.0,1.85,1.85,0,150,150,0,569,569,0.0,0.0,0.0,0.0,237500.0,237500.0
balel101,Lee Bales,Atlanta Braves,BRAVES,1,3,3,6,1966,1970,4,-2.48,0.0,2.48,260,0,-260,50,0,-50,409.0,0.0,-409.0,0.0,0.0,0.0
balew001,Wladimir Balentien,Seattle Mariners,MARNRS,1,1,1,2,2009,2009,0,0.78,0.0,-0.78,40,0,-40,125,0,-125,0.0,0.0,0.0,405000.0,400000.0,-5000.0
balfg001,Grant Balfour,Milwaukee Brewers,BREWRS,1,1,1,2,2007,2009,2,3.21,1.11,-2.1,295,179,-116,1,29,28,809.0,538.0,-271.0,0.0,0.0,0.0
ballj001,Jay Baller,Philadelphia Phillies,PHILS,5,11,8,19,1982,1999,17,22.81,28.42,5.61,2142,1948,-194,7615,5685,-1930,390.0,1257.0,867.0,2950000.0,165000.0,-2785000.0
ballj001,Jay Baller,Cleveland Indians,INDINS,1,1,1,2,1985,1986,1,-0.27,-0.05,0.22,158,6,-152,16,11,-5,405.0,0.0,-405.0,0.0,0.0,0.0
ballj101,Jim Ball,Boston Braves,BRAVES,1,1,1,2,1909,1909,0,0.0,0.0,0.0,0,0,0,0,0,0,0.0,0.0,0.0,0.0,0.0,0.0
ballw101,Win Ballou,Washington Senators,TWINS,1,2,2,4,1926,1926,0,4.68,-1.0,-5.68,222,56,-166,205,69,-136,1704.0,214.0,-1490.0,0.0,0.0,0.0
ballw101,Win Ballou,Chicago Cubs,CUBS,2,8,3,11,1933,1946,13,22.35,18.34,-4.01,627,903,276,2568,3781,1213,0.0,0.0,0.0,0.0,0.0,0.0
bambg101,George Bamberger,New York Giants,GIANTS,1,2,1,3,1952,1952,0,0.0,-0.43,-0.43,0,34,34,0,8,8,0.0,109.0,109.0,7000.0,0.0,-7000.0
bancd101,Dave Bancroft,Philadelphia Phillies,PHILS,1,1,2,3,1920,1920,0,22.88,3.58,-19.3,534,102,-432,2462,411,-2051,0.0,0.0,0.0,9000.0,0.0,-9000.0
bancd101,Dave Bancroft,New York Giants,GIANTS,2,4,3,7,1923,1927,4,14.64,1.52,-13.12,912,442,-470,3712,1550,-2162,0.0,87.0,87.0,25500.0,9875.0,-15625.0
banda001,Anthony Banda,Milwaukee Brewers,BREWRS,3,5,5,10,2014,2019,5,6.43,9.84,3.41,307,369,62,1146,703,-443,285.0,1843.0,1558.0,8837500.0,5968900.0,-2868600.0
banda001,Anthony Banda,Arizona Diamondbacks,DBACKS,1,4,2,6,2018,2019,1,-0.39,-0.4,-0.01,65,72,7,0,272,272,232.0,0.0,-232.0,0.0,0.0,0.0
banda001,Anthony Banda,San Francisco Giants,GIANTS,1,1,1,2,2021,2021,0,-0.37,0.0,0.37,10,0,-10,1,0,-1,22.0,0.0,-22.0,0.0,0.0,0.0
bandj001,Jett Bandy,Anaheim Angels,ANGELS,2,2,4,6,2016,2018,2,0.4,1.97,1.57,324,216,-108,1062,761,-301,0.0,0.0,0.0,3900000.0,1125000.0,-2775000.0
baned101,Dick Baney,Milwaukee Brewers,BREWRS,2,4,2,6,1970,1974,4,1.37,11.49,10.12,187,678,491,473,2707,2234,0.0,0.0,0.0,0.0,234000.0,234000.0
banee101,Eddie Bane,Chicago White Sox,WSOX,1,1,1,2,1980,1980,0,0.0,0.0,0.0,0,0,0,0,0,0,0.0,0.0,0.0,0.0,0.0,0.0
bankg101,George Banks,Minnesota Twins,TWINS,4,9,8,17,1964,1971,7,23.37,18.05,-5.32,1251,1468,217,3644,1313,-2331,1591.0,4850.0,3259.0,202500.0,192000.0,-10500.0
bankg101,George Banks,Cleveland Indians,INDINS,3,3,3,6,1966,1972,6,-0.38,1.13,1.51,313,410,97,710,821,111,8.0,15.0,7.0,9500.0,42000.0,32500.0
banks001,Scott Bankhead,Kansas City Royals,ROYALS,2,5,4,9,1986,1991,5,17.35,13.35,-4.0,586,809,223,839,3196,2357,3709.0,71.0,-3638.0,1438000.0,747500.0,-690500.0
bankw001,Willie Banks,Minnesota Twins,TWINS,2,2,3,5,1993,1997,4,-3.17,-2.12,1.05,199,411,212,435,1008,573,450.0,575.0,125.0,351000.0,109000.0,-242000.0
bankw001,Willie Banks,Chicago Cubs,CUBS,1,1,1,2,1995,1995,0,-0.3,0.0,0.3,12,0,-12,11,0,-11,87.0,0.0,-87.0,240000.0,0.0,-240000.0
bankw001,Willie Banks,New York Yankees,YANKS,1,1,2,3,1998,1998,0,0.27,0.0,-0.27,64,0,-64,1,0,-1,131.0,0.0,-131.0,342500.0,225000.0,-117500.0
banna001,Alan Bannister,Philadelphia Phillies,PHILS,1,3,2,5,1975,1979,4,0.71,0.93,0.22,442,215,-227,1620,199,-1421,0.0,1610.0,1610.0,0.0,0.0,0.0
banna001,Alan Bannister,Chicago White Sox,WSOX,1,1,1,2,1980,1981,1,2.72,0.07,-2.65,367,33,-334,1367,79,-1288,0.0,0.0,0.0,0.0,0.0,0.0
banna001,Alan Bannister,Houston Astros,ASTROS,1,1,1,2,1984,1985,1,0.56,0.0,-0.56,104,16,-88,272,15,-257,0.0,0.0,0.0,0.0,0.0,0.0
bannb001,Brian Bannister,New York Mets,METS,1,1,1,2,2006,2008,2,4.29,0.23,-4.06,118,34,-84,20,0,-20,1888.0,71.0,-1817.0,327000.0,339500.0,12500.0
bannf001,Floyd Bannister,Houston Astros,ASTROS,1,1,1,2,1978,1988,10,13.11,10.5,-2.61,118,1070,952,0,3508,3508,2305.0,3.0,-2302.0,26000.0,0.0,-26000.0
bannf001,Floyd Bannister,Chicago White Sox,WSOX,4,7,7,14,1987,1994,7,14.45,7.51,-6.94,385,504,119,1,759,758,4103.0,4503.0,400.0,930000.0,62500.0,-867500.0
banum001,Manny Banuelos,New York Yankees,YANKS,7,12,12,24,2015,2020,5,1.96,10.9,8.94,805,450,-355,1019,158,-861,949.0,1850.0,901.0,6061900.0,21050000.0,14988100.0
banum001,Manny Banuelos,Los Angeles Dodgers,DOGRS,1,1,1,2,2018,2018,0,-0.34,0.0,0.34,17,0,-17,0,0,0,152.0,0.0,-152.0,0.0,0.0,0.0
barbb001,Bret Barberie,Florida Marlins,MARLNS,2,3,2,5,1994,2004,10,2.98,0.43,-2.55,404,566,162,291,541,250,517.0,587.0,70.0,622500.0,0.0,-622500.0
barbj001,Johnny Barbato,San Diego Padres,PADRS,1,1,1,2,2014,2015,1,-0.29,0.74,1.03,13,103,90,0,0,0,39.0,154.0,115.0,0.0,1765000.0,1765000.0
barbj001,Johnny Barbato,New York Yankees,YANKS,1,1,1,2,2017,2017,0,0.24,0.0,-0.24,47,0,-47,1,0,-1,86.0,0.0,-86.0,0.0,0.0,0.0
barbj101,Jap Barbeau,Pittsburgh Pirates,PIRATS,3,9,6,15,1909,1915,6,20.39,14.17,-6.22,2165,858,-1307,7822,3752,-4070,942.0,0.0,-942.0,19200.0,16250.0,-2950.0
barbs102,Steve Barber,Baltimore Orioles,ORLS,1,1,4,5,1967,1967,0,-0.05,0.0,0.05,74,0,-74,79,0,-79,678.0,0.0,-678.0,0.0,0.0,0.0
barbs102,Steve Barber,California Angels,ANGELS,3,7,8,15,1973,1976,3,0.2,6.55,6.35,187,557,370,417,1633,1216,696.0,244.0,-452.0,35000.0,131300.0,96300.0
barbt101,Turner Barber,Washington Senators,TWINS,1,4,1,5,1917,1922,5,0.0,-0.6,-0.6,0,32,32,0,104,104,0.0,0.0,0.0,0.0,0.0,0.0
barbt101,Turner Barber,Baltimore,Baltimore,1,1,2,3,1917,1926,9,1.22,0.0,-1.22,443,0,-443,1564,0,-1564,0.0,0.0,0.0,0.0,0.0,0.0
barbw101,Walter Barbare,Pittsburgh Pirates,PIRATS,5,10,8,18,1921,1932,11,20.59,54.57,33.98,2344,1948,-396,9152,7061,-2091,1307.0,3847.0,2540.0,22300.0,13500.0,-8800.0
barcl001,Lorenzo Barcelo,San Francisco Giants,GIANTS,1,6,3,9,1997,1999,2,21.4,-0.07,-21.47,1008,161,-847,1122,94,-1028,2523.0,875.0,-1648.0,0.0,9757500.0,9757500.0
bardj001,Josh Bard,Colorado Rockies,ROCKS,1,2,1,3,2001,2001,0,4.57,-0.85,-5.42,461,44,-417,1773,90,-1683,0.0,0.0,0.0,0.0,230000.0,230000.0
bardj001,Josh Bard,Cleveland Indians,INDINS,2,4,6,10,2006,2011,5,6.08,6.32,0.24,533,659,126,1913,1893,-20,29.0,785.0,756.0,1950000.0,0.0,-1950000.0
bardj001,Josh Bard,Boston Red Sox,RSOX,1,3,1,4,2006,2008,2,5.93,-0.85,-6.78,724,107,-617,907,303,-604,712.0,0.0,-712.0,353400.0,1500000.0,1146600.0
barfj001,Jesse Barfield,Toronto Blue Jays,BJAYS,1,1,1,2,1989,1995,6,9.91,8.49,-1.42,396,91,-305,1525,0,-1525,0.0,1246.0,1246.0,1300000.0,80000.0,-1220000.0
barfj003,Josh Barfield,San Diego Padres,PADRS,5,6,8,14,2006,2013,7,5.14,8.38,3.24,930,725,-205,2672,2529,-143,264.0,54.0,-210.0,327000.0,4000000.0,3673000.0
barkk001,Kevin Barker,Milwaukee Brewers,BREWRS,1,1,1,2,2002,2002,0,-0.11,0.0,0.11,7,0,-7,20,0,-20,0.0,0.0,0.0,0.0,0.0,0.0
barkl001,Len Barker,Texas Rangers,RNGRS,4,7,8,15,1978,1982,4,19.36,1.68,-17.68,554,422,-132,1098,667,-431,4197.0,810.0,-3387.0,313000.0,280000.0,-33000.0
barkl001,Len Barker,Cleveland Indians,INDINS,2,2,6,8,1983,1992,9,-0.56,32.87,33.43,150,1734,1584,280,7153,6873,699.0,78.0,-621.0,475000.0,110000.0,-365000.0
barkr102,Ray Barker,Baltimore Orioles,ORLS,1,3,1,4,1961,1962,1,-0.1,0.84,0.94,11,78,67,8,316,308,0.0,0.0,0.0,0.0,0.0,0.0
barkr102,Ray Barker,Cleveland Indians,INDINS,1,1,1,2,1965,1965,0,0.11,1.21,1.1,176,116,-60,342,432,90,0.0,0.0,0.0,7500.0,10500.0,3000.0
barkr102,Ray Barker,New York Yankees,YANKS,1,4,1,5,1967,1968,1,0.0,-0.05,-0.05,0,74,74,0,79,79,0.0,678.0,678.0,0.0,0.0,0.0
barks101,Sam Barkley,Kansas City Cowboys,KC2,1,1,1,2,1889,1891,2,0.0,-0.4,-0.4,0,50,50,0,196,196,0.0,0.0,0.0,0.0,0.0,0.0
barlm101,Mike Barlow,Oakland Athletics,ATLTCS,1,2,1,3,1975,1976,1,-0.15,-0.36,-0.21,18,86,68,0,97,97,23.0,0.0,-23.0,0.0,0.0,0.0
barlm101,Mike Barlow,St. Louis Cardinals,CARDS,2,2,2,4,1975,1976,1,-0.72,0.0,0.72,53,0,-53,62,0,-62,66.0,0.0,-66.0,0.0,0.0,0.0
barlm101,Mike Barlow,Houston Astros,ASTROS,1,2,1,3,1976,1978,2,0.55,-0.16,-0.71,312,151,-161,705,515,-190,441.0,0.0,-441.0,0.0,0.0,0.0
barlm101,Mike Barlow,California Angels,ANGELS,1,1,1,2,1980,1980,0,-0.05,0.0,0.05,53,0,-53,0,0,0,210.0,0.0,-210.0,0.0,0.0,0.0
barmc001,Clint Barmes,Colorado Rockies,ROCKS,1,1,1,2,2010,2011,1,3.38,-0.44,-3.82,123,36,-87,495,0,-495,0.0,44.0,44.0,3325000.0,415000.0,-2910000.0
barna001,Austin Barnes,Miami Marlins,MARLNS,3,8,9,17,2014,2020,6,14.59,9.27,-5.32,1600,441,-1159,4137,1747,-2390,525.0,522.0,-3.0,17800000.0,10515000.0,-7285000.0
barnb001,Brian Barnes,Montreal Expos,NATEX,1,1,1,2,1993,1994,1,-0.13,0.0,0.13,6,47,41,0,98,98,40.0,0.0,-40.0,182500.0,0.0,-182500.0
barnb001,Brian Barnes,Cleveland Indians,INDINS,1,1,1,2,1994,1994,0,-0.11,0.0,0.11,10,0,-10,0,0,0,15.0,0.0,-15.0,0.0,0.0,0.0
barnb002,Brandon Barnes,Houston Astros,ASTROS,3,4,5,9,2013,2016,3,5.67,6.06,0.39,774,357,-417,2028,1370,-658,843.0,53.0,-790.0,491700.0,4250000.0,3758300.0
barnb102,Babe Barna,New York Giants,GIANTS,1,1,1,2,1943,1943,0,-0.6,0.15,0.75,30,44,14,127,46,-81,0.0,388.0,388.0,7000.0,9000.0,2000.0
barnb102,Babe Barna,Philadelphia Athletics,ATLTCS,1,4,1,5,1939,1939,0,0.0,0.0,0.0,0,0,0,0,0,0,0.0,0.0,0.0,3000.0,0.0,-3000.0
barnd001,Darwin Barney,Chicago Cubs,CUBS,1,2,1,3,2014,2014,0,0.76,0.0,-0.76,24,0,-24,49,0,-49,0.0,0.0,0.0,0.0,0.0,0.0
barnd001,Darwin Barney,Los Angeles Dodgers,DOGRS,1,1,1,2,2015,2015,0,1.65,0.0,-1.65,249,0,-249,694,0,-694,3.0,0.0,-3.0,2525000.0,0.0,-2525000.0
barne104,Ed Barney,Pittsburgh Pirates,PIRATS,1,1,1,2,1916,1916,0,0.0,0.16,0.16,0,55,55,0,181,181,0.0,0.0,0.0,2125.0,0.0,-2125.0
barnf102,Frank Barnes,Toronto,Toronto,1,1,3,4,1956,1958,2,-0.55,0.0,0.55,36,0,-36,11,0,-11,110.0,0.0,-110.0,0.0,0.0,0.0
barnf102,Frank Barnes,Chicago White Sox,WSOX,1,2,2,4,1961,1962,1,0.0,0.69,0.69,0,79,79,0,145,145,0.0,0.0,0.0,0.0,0.0,0.0
barnj001,John Barnes,Boston Red Sox,RSOX,1,3,2,5,1998,1998,0,0.81,-0.07,-0.88,43,39,-4,66,12,-54,325.0,72.0,-253.0,0.0,2100000.0,2100000.0
barnj002,Jacob Barnes,New York Mets,METS,1,1,1,2,2021,2021,0,-0.07,0.0,0.07,11,0,-11,0,0,0,30.0,0.0,-30.0,750000.0,0.0,-750000.0
barnj102,Jesse Barnes,Boston Braves,BRAVES,2,3,3,6,1918,1921,3,20.68,4.26,-16.42,840,475,-365,2277,2024,-253,3450.0,0.0,-3450.0,0.0,4800.0,4800.0
barnj102,Jesse Barnes,New York Giants,GIANTS,1,2,2,4,1923,1923,0,10.49,3.07,-7.42,305,87,-218,539,194,-345,2035.0,323.0,-1712.0,12500.0,9600.0,-2900.0
barnj102,Jesse Barnes,Boston Braves,BRAVES,8,16,14,30,1925,1938,13,15.59,19.03,3.44,1577,2611,1034,4396,9724,5328,4040.0,1364.0,-2676.0,46800.0,27600.0,-19200.0
barnl101,Les Barnhart,Cleveland Indians,INDINS,2,6,4,10,1930,1939,9,6.18,20.8,14.62,372,942,570,1331,2752,1421,1093.0,2939.0,1846.0,2400.0,0.0,-2400.0
barnr101,Rich Barnes,Chicago White Sox,WSOX,3,4,4,8,1983,1985,2,0.14,0.07,-0.07,81,9,-72,7,3,-4,156.0,16.0,-140.0,0.0,225000.0,225000.0
barnr104,Red Barnes,Washington Senators,TWINS,3,5,4,9,1930,1939,9,0.68,6.27,5.59,134,542,408,466,1630,1164,0.0,0.0,0.0,10500.0,5000.0,-5500.0
barns001,Skeeter Barnes,Cincinnati Reds,REDS,1,1,1,2,1985,1987,2,-0.31,0.71,1.02,19,192,173,26,321,295,0.0,0.0,0.0,0.0,0.0,0.0
barns001,Skeeter Barnes,Montreal Expos,NATEX,1,2,2,4,1986,1992,6,0.09,3.06,2.97,102,697,595,18,1867,1849,201.0,144.0,-57.0,415000.0,210000.0,-205000.0
barns002,Scott Barnes,San Francisco Giants,GIANTS,1,1,1,2,2009,2009,0,0.05,-0.79,-0.84,24,40,16,0,127,127,83.0,0.0,-83.0,0.0,446100.0,446100.0
barnt001,Tucker Barnhart,Cincinnati Reds,REDS,1,1,1,2,2021,2021,0,0.0,0.0,0.0,0,0,0,0,0,0,0.0,0.0,0.0,4187500.0,0.0,-4187500.0
barnv101,Virgil Barnes,New York Giants,GIANTS,1,4,1,5,1928,1928,0,11.88,2.32,-9.56,1432,52,-1380,2925,68,-2857,4700.0,475.0,-4225.0,21900.0,7000.0,-14900.0
barnv102,Vic Barnhart,Pittsburgh Pirates,PIRATS,1,2,1,3,1947,1955,8,0.0,-1.57,-1.57,0,200,200,0,569,569,0.0,0.0,0.0,0.0,0.0,0.0
baros001,Salome Barojas,Chicago White Sox,WSOX,2,3,3,6,1984,1989,5,4.09,3.15,-0.94,327,357,30,0,703,703,1915.0,1149.0,-766.0,440000.0,218200.0,-221800.0
barrb104,Bob Barrett,Chicago Cubs,CUBS,1,1,1,2,1925,1925,0,-0.34,0.17,0.51,100,76,-24,384,262,-122,0.0,0.0,0.0,0.0,5500.0,5500.0
barrb104,Bob Barrett,Brooklyn Dodgers,DOGRS,1,2,1,3,1927,1927,0,0.0,0.0,0.0,0,0,0,0,0,0,0.0,0.0,0.0,12000.0,0.0,-12000.0
barrb105,Bill Barrett,Chicago White Sox,WSOX,1,1,1,2,1929,1929,0,1.29,-1.14,-2.43,117,47,-70,457,136,-321,0.0,0.0,0.0,7000.0,4500.0,-2500.0
barrb105,Bill Barrett,Boston Red Sox,RSOX,3,4,4,8,1930,1936,6,1.11,20.6,19.49,189,1028,839,715,4354,3639,0.0,0.0,0.0,30500.0,25000.0,-5500.0
barrc101,Cuno Barragan,Chicago Cubs,CUBS,1,2,1,3,1963,1963,0,15.76,0.0,-15.76,949,0,-949,117,0,-117,2466.0,0.0,-2466.0,0.0,0.0,0.0
barrd101,Dick Barrett,Boston Braves,BRAVES,2,5,2,7,1934,1940,6,0.0,6.69,6.69,0,395,395,0,958,958,0.0,2031.0,2031.0,0.0,0.0,0.0
barrd101,Dick Barrett,Philadelphia Athletics,ATLTCS,1,2,1,3,1933,1935,2,0.0,0.57,0.57,0,102,102,0,81,81,0.0,680.0,680.0,3000.0,0.0,-3000.0
barrf001,Franklin Barreto,Toronto Blue Jays,BJAYS,2,6,2,8,2014,2018,4,6.54,19.48,12.94,350,462,112,887,2066,1179,1411.0,0.0,-1411.0,23516100.0,500000.0,-23016100.0
barrf001,Franklin Barreto,Oakland Athletics,ATLTCS,1,1,1,2,2020,2020,0,-0.23,0.42,0.65,6,27,21,18,111,93,0.0,0.0,0.0,0.0,3250000.0,3250000.0
barrf101,Francisco Barrios,Jalisco,Jalisco,1,2,1,3,1973,1973,0,8.38,0.0,-8.38,129,0,-129,0,0,0,2154.0,0.0,-2154.0,0.0,0.0,0.0
barrf104,Frank Barrett,St. Louis Cardinals,CARDS,1,1,1,2,1944,1946,2,1.31,-0.16,-1.47,150,16,-134,51,3,-48,529.0,40.0,-489.0,0.0,0.0,0.0
barrg101,German Barranca,Kansas City Royals,ROYALS,1,1,1,2,1981,1983,2,0.03,0.76,0.73,55,150,95,60,355,295,0.0,0.0,0.0,0.0,0.0,0.0
barrj001,Jeff Barry,Montreal Expos,NATEX,1,1,1,2,1991,1991,0,-0.13,0.0,0.13,15,0,-15,16,0,-16,0.0,0.0,0.0,0.0,0.0,0.0
barrj001,Jeff Barry,New York Mets,METS,1,1,1,2,1995,1996,1,0.0,-0.24,-0.24,0,10,10,0,0,0,0.0,21.0,21.0,109000.0,0.0,-109000.0
barrj001,Jeff Barry,Los Angeles Dodgers,DOGRS,1,3,2,5,2001,2001,0,0.0,0.96,0.96,0,24,24,0,27,27,0.0,238.0,238.0,0.0,5950000.0,5950000.0
barrj104,Jack Barry,Boston Red Sox,RSOX,14,27,32,59,1919,1937,18,90.7,63.54,-27.16,3925,3492,-433,10546,11886,1340,11819.0,5915.0,-5904.0,73300.0,64200.0,-9100.0
barrj106,Johnny Barrett,Pittsburgh Pirates,PIRATS,1,1,1,2,1946,1946,0,-0.14,0.37,0.51,24,58,34,55,162,107,0.0,0.0,0.0,0.0,0.0,0.0
barrk002,Kyle Barraclough,St. Louis Cardinals,CARDS,1,1,1,2,2015,2015,0,2.64,0.45,-2.19,441,54,-387,2,0,-2,656.0,70.0,-586.0,0.0,6650000.0,6650000.0
barrk002,Kyle Barraclough,Miami Marlins,MARLNS,1,1,0,1,2018,2018,0,-0.72,0.0,0.72,65,0,-65,0,0,0,77.0,0.0,-77.0,1113000.0,0.0,-1113000.0
barrm002,Manuel Barrios,Houston Astros,ASTROS,1,3,1,4,1997,2001,4,-0.79,11.75,12.54,34,421,387,1,1777,1776,68.0,0.0,-68.0,0.0,4500000.0,4500000.0
barrm002,Manuel Barrios,Florida Marlins,MARLNS,15,33,38,71,1998,2019,21,116.45,94.42,-22.03,4698,5470,772,15425,16217,792,10496.0,10160.0,-336.0,68580667.0,35694968.0,-32885699.0
barrm002,Manuel Barrios,Florida Marlins,MARLNS,1,1,1,2,1998,1999,1,0.0,-0.03,-0.03,0,4,4,0,4,4,0.0,0.0,0.0,0.0,0.0,0.0
barrm003,Michael Barrett,Montreal Expos,NATEX,1,1,1,2,2003,2003,0,0.0,0.0,0.0,0,0,0,0,0,0,0.0,0.0,0.0,2600000.0,0.0,-2600000.0
barrm003,Michael Barrett,Oakland Athletics,ATLTCS,1,1,2,3,2003,2004,1,5.98,1.37,-4.61,431,110,-321,1632,442,-1190,0.0,0.0,0.0,0.0,2700000.0,2700000.0
barrm003,Michael Barrett,Chicago Cubs,CUBS,2,4,4,8,2007,2007,0,2.34,-0.92,-3.26,429,67,-362,396,238,-158,801.0,0.0,-801.0,4533333.0,13240494.0,8707161.0
barrr101,Red Barrett,Boston Braves,BRAVES,3,4,5,9,1945,1951,6,3.22,9.25,6.03,172,361,189,151,486,335,1205.0,2522.0,1317.0,0.0,15000.0,15000.0
barrs101,Shad Barry,Philadelphia Phillies,PHILS,1,1,1,2,1904,1905,1,0.21,2.0,1.79,100,94,-6,403,118,-285,0.0,908.0,908.0,0.0,0.0,0.0
barrs101,Shad Barry,Cincinnati Reds,REDS,1,1,1,2,1906,1906,0,-0.34,0.15,0.49,217,60,-157,895,238,-657,0.0,0.0,0.0,0.0,0.0,0.0
barrs103,Steve Barr,Boston Red Sox,RSOX,2,4,3,7,1975,1977,2,14.8,6.95,-7.85,545,58,-487,1514,0,-1514,2654.0,1206.0,-1448.0,200000.0,190000.0,-10000.0
barrt002,Tom Barrett,New York Yankees,YANKS,2,3,3,6,1986,1989,3,-1.2,3.08,4.28,102,129,27,211,183,-28,200.0,783.0,583.0,658333.0,277500.0,-380833.0
barry001,Yhonathan Barrios,Pittsburgh Pirates,PIRATS,1,1,2,3,2015,2015,0,0.3,-0.29,-0.59,10,56,46,0,214,214,20.0,0.0,-20.0,0.0,0.0,0.0
bartb001,Brian Barton,St. Louis Cardinals,CARDS,1,1,1,2,2009,2009,0,0.0,-0.16,-0.16,1,30,29,0,1,1,0.0,49.0,49.0,0.0,432500.0,432500.0
bartb101,Bob Barton,San Francisco Giants,GIANTS,1,3,1,4,1969,1969,0,1.07,0.0,-1.07,369,0,-369,821,0,-821,333.0,0.0,-333.0,0.0,0.0,0.0
bartb101,Bob Barton,San Diego Padres,PADRS,1,1,1,2,1972,1974,2,0.02,-0.44,-0.46,3,73,70,2,214,212,0.0,0.0,0.0,0.0,0.0,0.0
bartc001,Cliff Bartosh,Cleveland Indians,INDINS,1,1,1,2,2005,2005,0,-0.01,0.0,0.01,37,0,-37,1,0,-1,59.0,0.0,-59.0,0.0,0.0,0.0
bartd001,Daric Barton,St. Louis Cardinals,CARDS,1,3,1,4,2004,2008,4,22.03,0.48,-21.55,848,107,-741,2102,105,-1997,2465.0,933.0,-1532.0,305000.0,4450000.0,4145000.0
bartd101,Dick Bartell,Pittsburgh Pirates,PIRATS,1,1,2,3,1930,1935,5,9.93,-1.59,-11.52,587,484,-103,2703,1804,-899,0.0,0.0,0.0,6250.0,13500.0,7250.0
bartd101,Dick Bartell,Philadelphia Phillies,PHILS,1,1,5,6,1934,1936,2,27.34,-1.93,-29.27,835,371,-464,3520,1512,-2008,0.0,0.0,0.0,10500.0,0.0,-10500.0
bartd101,Dick Bartell,New York Giants,GIANTS,2,7,4,11,1938,1949,11,11.69,46.84,35.15,813,1845,1032,2964,7276,4312,38.0,0.0,-38.0,0.0,0.0,0.0
bartd101,Dick Bartell,Chicago Cubs,CUBS,1,1,1,2,1939,1940,1,-0.5,-0.57,-0.07,144,33,-111,635,63,-572,0.0,0.0,0.0,20500.0,11000.0,-9500.0
bartj001,Jason Bartlett,San Diego Padres,PADRS,1,1,1,2,2002,2004,2,8.98,0.26,-8.72,324,201,-123,1212,399,-813,0.0,0.0,0.0,0.0,225000.0,225000.0
bartj001,Jason Bartlett,Minnesota Twins,TWINS,3,6,7,13,2007,2015,8,34.0,-0.38,-34.38,1580,849,-731,6027,3046,-2981,1777.0,138.0,-1639.0,12330000.0,1726100.0,-10603900.0
bartj001,Jason Bartlett,Tampa Bay Devil Rays,RAYS,2,2,5,7,2010,2015,5,-0.05,1.36,1.41,239,435,196,716,53,-663,157.0,1270.0,1113.0,4750000.0,401300.0,-4348700.0
bartk001,Kimera Bartee,Baltimore Orioles,ORLS,1,2,1,3,1995,2003,8,-1.6,13.23,14.83,28,211,183,0,27,27,231.0,3863.0,3632.0,109000.0,1862500.0,1753500.0
bartk001,Kimera Bartee,Anaheim Angels,ANGELS,1,1,1,2,2001,2009,8,-0.35,22.36,22.71,12,936,924,19,4075,4056,0.0,0.0,0.0,0.0,0.0,0.0
barts001,Shawn Barton,Philadelphia Phillies,PHILS,1,2,1,3,1988,1988,0,0.0,-0.19,-0.19,0,20,20,0,31,31,0.0,0.0,0.0,0.0,0.0,0.0
basal001,Luis Basabe,Boston Red Sox,RSOX,1,4,1,5,2016,2016,0,14.34,0.0,-14.34,583,0,-583,2288,0,-2288,251.0,0.0,-251.0,0.0,9150000.0,9150000.0
basgm101,Monty Basgall,Brooklyn Dodgers,DOGRS,3,3,6,9,1947,1949,2,-1.55,0.0,1.55,447,0,-447,1458,0,-1458,0.0,0.0,0.0,0.0,0.0,0.0
basie101,Eddie Basinski,Brooklyn Dodgers,DOGRS,1,1,1,2,1946,1947,1,-0.61,0.0,0.61,56,0,-56,182,0,-182,0.0,0.0,0.0,0.0,0.0,0.0
baskj101,Jim Baskette,Cleveland Indians,INDINS,1,1,1,2,1913,1913,0,0.0,-0.14,-0.14,0,2,2,0,0,0,0.0,3.0,3.0,2400.0,0.0,-2400.0
bassa001,Anthony Bass,San Diego Padres,PADRS,1,2,1,3,2013,2014,1,-0.87,0.0,0.87,21,0,-21,0,0,0,81.0,0.0,-81.0,503600.0,0.0,-503600.0
bassa001,Anthony Bass,Texas Rangers,RNGRS,2,3,4,7,2015,2020,5,1.97,-1.24,-3.21,224,21,-203,698,0,-698,144.0,64.0,-80.0,5475000.0,1400000.0,-4075000.0
bassc001,Chris Bassitt,Chicago White Sox,WSOX,1,4,2,6,2014,2018,4,32.02,0.52,-31.5,1179,80,-1099,4237,2,-4235,1580.0,819.0,-761.0,500000.0,5345000.0,4845000.0
bassk001,Kevin Bass,Milwaukee Brewers,BREWRS,2,5,4,9,1982,1986,4,18.77,6.8,-11.97,1695,100,-1595,3977,0,-3977,2039.0,1974.0,-65.0,625000.0,1425000.0,800000.0
bassk001,Kevin Bass,San Francisco Giants,GIANTS,1,1,1,2,1992,1992,0,0.11,0.0,-0.11,46,0,-46,145,0,-145,0.0,0.0,0.0,2000000.0,0.0,-2000000.0
bassr101,Randy Bass,Montreal Expos,NATEX,1,1,2,3,1980,1980,0,-0.35,0.35,0.7,101,22,-79,292,0,-292,0.0,62.0,62.0,0.0,0.0,0.0
basta001,Antonio Bastardo,Philadelphia Phillies,PHILS,2,2,2,4,2014,2017,3,-0.02,-0.74,-0.72,246,76,-170,3,0,-3,391.0,110.0,-281.0,2535000.0,0.0,-2535000.0
basta001,Antonio Bastardo,New York Mets,METS,1,2,1,3,2016,2016,0,-0.74,-0.56,0.18,73,11,-62,1,1,0,99.0,33.0,-66.0,0.0,0.0,0.0
batcr001,Rich Batchelor,New York Yankees,YANKS,1,1,1,2,1993,1993,0,-0.38,0.45,0.83,60,8,-52,2,0,-2,123.0,24.0,-99.0,0.0,2691667.0,2691667.0
batcr001,Rich Batchelor,St. Louis Cardinals,CARDS,1,3,3,6,1997,1997,0,-0.21,-1.09,-0.88,425,93,-332,688,180,-508,185.0,68.0,-117.0,4942500.0,2250000.0,-2692500.0
bateb001,Billy Bates,Milwaukee Brewers,BREWRS,1,2,2,4,1990,1990,0,3.07,2.88,-0.19,257,33,-224,822,0,-822,0.0,478.0,478.0,675000.0,500000.0,-175000.0
bated101,Del Bates,California Angels,ANGELS,1,1,1,2,1966,1967,1,0.0,0.0,0.0,0,0,0,0,0,0,0.0,0.0,0.0,0.0,0.0,0.0
bated101,Del Bates,Baltimore Orioles,ORLS,1,2,2,4,1968,1968,0,0.0,0.0,0.0,0,0,0,0,0,0,0.0,0.0,0.0,0.0,0.0,0.0
bated101,Del Bates,Pittsburgh Pirates,PIRATS,1,1,2,3,1970,1970,0,-0.64,0.0,0.64,22,0,-22,70,0,-70,0.0,0.0,0.0,0.0,0.0,0.0
batej101,Johnny Bates,Boston Braves,BRAVES,5,7,8,15,1909,1927,18,12.27,37.78,25.51,647,1815,1168,1592,4784,3192,2058.0,9235.0,7177.0,6000.0,0.0,-6000.0
batej101,Johnny Bates,Philadelphia Phillies,PHILS,12,24,28,52,1910,1931,21,100.95,91.27,-9.68,4848,5202,354,15981,18765,2784,10753.0,6282.0,-4471.0,25000.0,31850.0,6850.0
batej102,John Bateman,Montreal Expos,NATEX,2,2,2,4,1972,1972,0,-1.18,0.44,1.62,286,77,-209,783,259,-524,0.0,0.0,0.0,0.0,0.0,0.0
bater101,Ray Bates,Philadelphia Athletics,ATLTCS,1,3,1,4,1919,1921,2,0.0,-1.44,-1.44,0,50,50,0,86,86,0.0,133.0,133.0,0.0,0.0,0.0
bathb001,Bill Bathe,Oakland Athletics,ATLTCS,1,1,1,2,1986,1986,0,0.0,0.0,0.0,0,0,0,0,0,0,0.0,0.0,0.0,0.0,0.0,0.0
batik001,Kevin Batiste,Toronto Blue Jays,BJAYS,1,2,1,3,1989,1993,4,-1.22,-0.11,1.11,67,2,-65,204,0,-204,0.0,5.0,5.0,800000.0,0.0,-800000.0
batim001,Miguel Batista,Chicago Cubs,CUBS,6,10,9,19,1997,2007,10,4.72,8.86,4.14,878,964,86,1047,3569,2522,1883.0,0.0,-1883.0,11986333.0,18190494.0,6204161.0
batim001,Miguel Batista,Montreal Expos,NATEX,1,1,1,2,2000,2000,0,-0.99,-0.18,0.81,16,12,-4,3,1,-2,171.0,16.0,-155.0,325000.0,220000.0,-105000.0
batim001,Miguel Batista,Toronto Blue Jays,BJAYS,5,10,12,22,2005,2014,9,23.63,23.44,-0.19,1360,1086,-274,3834,4118,284,1461.0,175.0,-1286.0,24569600.0,28118000.0,3548400.0
batit001,Tony Batista,Arizona Diamondbacks,DBACKS,1,2,1,3,1999,2000,1,6.98,0.84,-6.14,434,187,-247,1364,1,-1363,379.0,185.0,-194.0,720000.0,1500000.0,780000.0
batta001,Allen Battle,St. Louis Cardinals,CARDS,6,12,11,23,1996,2004,8,8.44,23.16,14.72,1305,1318,13,4128,1707,-2421,1089.0,4162.0,3073.0,14483333.0,16620281.0,2136948.0
battc101,Chris Batton,Oakland Athletics,ATLTCS,5,10,14,24,1977,1991,14,17.32,67.59,50.27,1802,3570,1768,5305,11715,6410,956.0,6372.0,5416.0,0.0,440000.0,440000.0
batte101,Earl Battey,Chicago White Sox,WSOX,3,5,6,11,1960,1967,7,32.09,12.95,-19.14,2200,685,-1515,7735,1568,-6167,0.0,2599.0,2599.0,44000.0,0.0,-44000.0
batth001,Howard Battle,Toronto Blue Jays,BJAYS,2,4,3,7,1995,2002,7,7.82,10.52,2.7,990,426,-564,2406,2,-2404,537.0,1768.0,1231.0,1909000.0,442500.0,-1466500.0
battm101,Matt Batts,Boston Red Sox,RSOX,3,7,4,11,1951,1954,3,1.03,-2.94,-3.97,539,149,-390,1347,410,-937,675.0,0.0,-675.0,8500.0,0.0,-8500.0
battm101,Matt Batts,St.Louis Browns,ORLS,17,42,41,83,1952,1988,36,52.55,138.07,85.52,3971,7990,4019,7618,22164,14546,14427.0,15253.0,826.0,829333.0,135900.0,-693433.0
battm101,Matt Batts,Detroit Tigers,TIGRS,2,3,2,5,1954,1960,6,-0.4,5.2,5.6,97,511,414,306,1772,1466,0.0,0.0,0.0,12000.0,0.0,-12000.0
battm101,Matt Batts,Chicago White Sox,WSOX,29,56,55,111,1954,1971,17,64.71,122.48,57.77,7633,8254,621,20626,20005,-621,7158.0,13512.0,6354.0,248750.0,225500.0,-23250.0
baueh101,Hank Bauer,New York Yankees,YANKS,4,7,6,13,1959,1969,10,14.99,27.57,12.58,1233,1032,-201,4340,4017,-323,296.0,0.0,-296.0,175000.0,51000.0,-124000.0
bauej001,Jake Bauers,San Diego Padres,PADRS,3,7,6,13,2014,2020,6,-1.53,-1.48,0.05,295,146,-149,1021,301,-720,0.0,78.0,78.0,506400.0,10644200.0,10137800.0
bauej001,Jake Bauers,Tampa Bay Devil Rays,RAYS,1,2,2,4,2018,2019,1,-1.03,0.28,1.31,160,8,-152,536,0,-536,0.0,22.0,22.0,0.0,0.0,0.0
bauej001,Jake Bauers,Cleveland Indians,INDINS,1,1,1,2,2021,2021,0,-0.04,0.0,0.04,72,0,-72,202,0,-202,0.0,0.0,0.0,0.0,0.0,0.0
bauet001,Trevor Bauer,Arizona Diamondbacks,DBACKS,3,6,6,12,2012,2021,9,44.83,10.87,-33.96,1441,607,-834,2691,1018,-1673,5272.0,2512.0,-2760.0,11602833.0,504900.0,-11097933.0
bauet001,Trevor Bauer,Cleveland Indians,INDINS,1,1,5,6,2019,2019,0,2.49,0.68,-1.81,30,101,71,16,401,385,388.0,7.0,-381.0,13000000.0,9700000.0,-3300000.0
baumf101,Frank Baumholtz,Cincinnati Reds,REDS,3,4,5,9,1949,1951,2,25.39,2.56,-22.83,1630,361,-1269,6349,1295,-5054,0.0,0.0,0.0,10000.0,9000.0,-1000.0
baumf102,Frank Baumann,Boston Red Sox,RSOX,2,2,2,4,1959,1960,1,4.03,-0.89,-4.92,374,44,-330,184,121,-63,1725.0,0.0,-1725.0,0.0,22000.0,22000.0
baumf102,Frank Baumann,Chicago White Sox,WSOX,2,2,2,4,1964,1965,1,-0.71,0.21,0.92,32,45,13,38,37,-1,11.0,80.0,69.0,30500.0,0.0,-30500.0
baumg101,George Baumgardner,St.Louis Browns,ORLS,1,3,1,4,1916,1916,0,0.0,0.05,0.05,0,27,27,0,42,42,0.0,0.0,0.0,4200.0,0.0,-4200.0
baumj102,Jim Baumer,Chicago White Sox,WSOX,4,10,7,17,1954,1961,7,23.22,8.09,-15.13,1221,1065,-156,3572,3021,-551,2246.0,488.0,-1758.0,62000.0,80000.0,18000.0
baumj102,Jim Baumer,Cincinnati Reds,REDS,1,1,1,2,1961,1961,0,0.0,0.25,0.25,0,40,40,0,72,72,0.0,0.0,0.0,0.0,0.0,0.0
baump101,Paddy Baumann,NewBedford,NewBedford,1,1,2,3,1911,1911,0,0.64,0.0,-0.64,95,0,-95,385,0,-385,0.0,0.0,0.0,0.0,0.0,0.0
baumr101,Ross Baumgarten,Chicago White Sox,WSOX,2,3,3,6,1982,1987,5,4.43,7.04,2.61,422,580,158,1527,1402,-125,154.0,667.0,513.0,0.0,0.0,0.0
baums101,Stan Baumgartner,NewHaven,NewHaven,1,1,3,4,1924,1924,0,8.0,0.0,-8.0,166,0,-166,103,0,-103,950.0,0.0,-950.0,0.0,0.0,0.0
bautd001,Danny Bautista,Detroit Tigers,TIGRS,2,2,2,4,1996,1999,3,0.37,-0.1,-0.47,163,32,-131,291,0,-291,0.0,78.0,78.0,185000.0,0.0,-185000.0
bautd001,Danny Bautista,Florida Marlins,MARLNS,1,1,1,2,2000,2003,3,-0.42,-0.72,-0.3,456,326,-130,1595,905,-690,0.0,0.0,0.0,500000.0,750000.0,250000.0
bautd002,Denny Bautista,Florida Marlins,MARLNS,1,2,1,3,2003,2005,2,-0.35,2.59,2.94,2,296,294,0,1062,1062,6.0,0.0,-6.0,0.0,4250000.0,4250000.0
bautd002,Denny Bautista,Baltimore Orioles,ORLS,1,1,1,2,2004,2005,1,0.22,-0.61,-0.83,20,65,45,0,0,0,295.0,175.0,-120.0,0.0,1000000.0,1000000.0
bautd002,Denny Bautista,Kansas City Royals,ROYALS,1,2,2,4,2006,2009,3,-0.8,0.46,1.26,227,144,-83,3,478,475,305.0,71.0,-234.0,1335500.0,662000.0,-673500.0
bautd002,Denny Bautista,Colorado Rockies,ROCKS,1,1,1,2,2007,2007,0,0.41,0.0,-0.41,16,0,-16,0,0,0,57.0,0.0,-57.0,0.0,0.0,0.0
bautd002,Denny Bautista,Detroit Tigers,TIGRS,1,1,1,2,2008,2008,0,-0.59,0.0,0.59,98,0,-98,5,0,-5,165.0,0.0,-165.0,395000.0,0.0,-395000.0
baute101,Ed Bauta,Pittsburgh Pirates,PIRATS,2,3,3,6,1960,1962,2,13.99,2.03,-11.96,1772,159,-1613,6120,213,-5907,474.0,816.0,342.0,0.0,0.0,0.0
baute101,Ed Bauta,St. Louis Cardinals,CARDS,14,27,22,49,1963,1972,9,30.41,1.96,-28.45,3351,779,-2572,8522,1730,-6792,1979.0,729.0,-1250.0,32500.0,24000.0,-8500.0
bautg001,Gerson Bautista,Boston Red Sox,RSOX,1,3,1,4,2017,2017,0,-0.57,0.56,1.13,43,31,-12,1,0,-1,62.0,81.0,19.0,0.0,7750000.0,7750000.0
bautg001,Gerson Bautista,New York Mets,METS,1,5,3,8,2018,2018,0,-0.49,0.0,0.49,191,0,-191,565,0,-565,376.0,0.0,-376.0,16500000.0,12258065.0,-4241935.0
bautj002,Jose Bautista,Kansas City Royals,ROYALS,1,1,1,2,2004,2008,4,1.21,-1.32,-2.53,83,38,-45,302,106,-196,0.0,0.0,0.0,0.0,0.0,0.0
bautj002,Jose Bautista,New York Mets,METS,4,6,6,12,2004,2010,6,-0.86,11.14,12.0,655,533,-122,1973,723,-1250,683.0,3210.0,2527.0,2841000.0,10775000.0,7934000.0
bautj002,Jose Bautista,Pittsburgh Pirates,PIRATS,1,1,1,2,2008,2009,1,38.31,0.65,-37.66,1235,43,-1192,5272,144,-5128,0.0,0.0,0.0,1800000.0,0.0,-1800000.0
bautj002,Jose Bautista,New York Mets,METS,1,1,1,2,2018,2018,0,0.39,0.0,-0.39,27,0,-27,57,0,-57,0.0,0.0,0.0,545000.0,0.0,-545000.0
baxej101,Jim Baxes,Los Angeles Dodgers,DOGRS,2,4,4,8,1959,1959,0,0.68,0.0,-0.68,77,0,-77,270,0,-270,0.0,0.0,0.0,10000.0,0.0,-10000.0
baxej101,Jim Baxes,Chicago White Sox,WSOX,1,1,1,2,1960,1961,1,0.0,0.0,0.0,0,0,0,0,0,0,0.0,0.0,0.0,0.0,0.0,0.0
baxem101,Mike Baxes,Kansas City Athletics,ATLTCS,25,53,47,100,1959,1976,17,93.37,60.18,-33.19,8944,6275,-2669,21756,18191,-3565,9976.0,4965.0,-5011.0,504100.0,545500.0,41400.0
bay-j001,Jason Bay,Montreal Expos,NATEX,1,2,1,3,2002,2002,0,1.77,-0.23,-2.0,288,13,-275,1125,14,-1111,0.0,0.0,0.0,0.0,0.0,0.0
bay-j001,Jason Bay,New York Mets,METS,1,3,2,5,2002,2003,1,0.08,0.83,0.75,11,64,53,13,7,-6,29.0,147.0,118.0,0.0,500000.0,500000.0
bay-j001,Jason Bay,San Diego Padres,PADRS,1,3,1,4,2003,2009,6,19.18,17.35,-1.83,859,833,-26,3184,3689,505,1194.0,0.0,-1194.0,305000.0,8833333.0,8528333.0
bay-j001,Jason Bay,Pittsburgh Pirates,PIRATS,2,2,5,7,2008,2014,6,9.76,-1.02,-10.78,453,695,242,850,1678,828,364.0,347.0,-17.0,6511500.0,0.0,-6511500.0
bayld001,Don Baylor,Baltimore Orioles,ORLS,5,15,15,30,1976,1988,12,24.68,74.72,50.04,1245,3374,2129,1799,7287,5488,7873.0,11309.0,3436.0,558333.0,0.0,-558333.0
bayld001,Don Baylor,New York Yankees,YANKS,3,4,4,8,1986,1989,3,0.87,5.14,4.27,370,275,-95,1307,729,-578,200.0,783.0,583.0,658333.0,277500.0,-380833.0
bayld001,Don Baylor,Boston Red Sox,RSOX,1,1,1,2,1987,1987,0,-0.07,0.0,0.07,20,0,-20,58,0,-58,0.0,0.0,0.0,0.0,0.0,0.0
baylj001,Jonah Bayliss,Kansas City Royals,ROYALS,1,2,1,3,2005,2006,1,-1.27,0.11,1.38,95,30,-65,0,3,3,157.0,501.0,344.0,0.0,4500000.0,4500000.0
baynb101,Bill Bayne,St.Louis Browns,ORLS,29,55,62,117,1924,1952,28,152.63,143.12,-9.51,7484,11236,3752,22593,31279,8686,18747.0,30694.0,11947.0,281100.0,219150.0,-61950.0
baz-s001,Shane Baz,Pittsburgh Pirates,PIRATS,1,3,1,4,2018,2020,2,12.58,1.43,-11.15,379,64,-315,1364,58,-1306,825.0,516.0,-309.0,556500.0,0.0,-556500.0
bazay001,Yorman Bazardo,Florida Marlins,MARLNS,2,3,2,5,2005,2005,0,0.68,-0.67,-1.35,117,54,-63,0,1,1,368.0,71.0,-297.0,0.0,1950000.0,1950000.0
bazay001,Yorman Bazardo,Seattle Mariners,MARNRS,1,1,1,2,2007,2008,1,0.37,0.0,-0.37,15,0,-15,0,0,0,80.0,0.0,-80.0,0.0,0.0,0.0
bealb101,Bob Beall,Philadelphia Phillies,PHILS,1,1,1,2,1973,1973,0,-0.36,0.0,0.36,145,0,-145,282,0,-282,0.0,0.0,0.0,0.0,0.0,0.0
bealb101,Bob Beall,Atlanta Braves,BRAVES,1,1,1,2,1980,1980,0,0.0,0.0,0.0,3,0,-3,3,0,-3,0.0,0.0,0.0,0.0,0.0,0.0
bealj101,Johnny Beall,Cleveland Indians,INDINS,1,1,1,2,1913,1915,2,0.0,2.31,2.31,0,265,265,0,1014,1014,0.0,0.0,0.0,2040.0,0.0,-2040.0
bealj101,Johnny Beall,Chicago White Sox,WSOX,2,6,2,8,1913,1916,3,11.33,-0.33,-11.66,533,82,-451,1606,278,-1328,1090.0,0.0,-1090.0,0.0,0.0,0.0
bealj101,Johnny Beall,Milwaukee,Milwaukee,1,2,2,4,1918,1918,0,-0.15,0.0,0.15,31,0,-31,60,0,-60,69.0,0.0,-69.0,0.0,0.0,0.0
beamt001,Trey Beamon,Pittsburgh Pirates,PIRATS,2,3,3,6,1997,1998,1,-0.39,-0.19,0.2,43,160,117,68,469,401,0.0,0.0,0.0,0.0,0.0,0.0
beamt001,Trey Beamon,San Diego Padres,PADRS,11,16,16,32,1997,2005,8,0.63,9.5,8.87,874,1331,457,1663,2360,697,1171.0,1867.0,696.0,13510000.0,3990000.0,-9520000.0
beanb001,Billy Beane,New York Mets,METS,2,4,3,7,1986,1991,5,0.96,6.32,5.36,405,543,138,1082,1694,612,117.0,0.0,-117.0,637500.0,530000.0,-107500.0
beanb001,Billy Beane,Minnesota Twins,TWINS,2,2,2,4,1988,1989,1,0.01,-0.69,-0.7,6,11,5,6,0,-6,0.0,52.0,52.0,0.0,0.0,0.0
beanb002,Bill Bean,Detroit Tigers,TIGRS,1,1,2,3,1989,1989,0,-0.42,0.0,0.42,51,0,-51,76,0,-76,0.0,0.0,0.0,70400.0,0.0,-70400.0
beanb101,Belve Bean,Cleveland Indians,INDINS,1,1,1,2,1935,1935,0,-0.22,-0.66,-0.44,20,48,28,9,33,24,93.0,273.0,180.0,4200.0,7000.0,2800.0
beard001,Dave Beard,Oakland Athletics,ATLTCS,5,10,9,19,1983,1994,11,10.8,21.09,10.29,1624,930,-694,3370,2503,-867,1865.0,4119.0,2254.0,1837653.0,2467500.0,629847.0
beard001,Dave Beard,Cleveland Indians,INDINS,1,1,1,2,1985,1985,0,-0.09,0.0,0.09,18,0,-18,0,0,0,38.0,0.0,-38.0,0.0,0.0,0.0
bearg101,Gary Beare,Milwaukee Brewers,BREWRS,1,1,1,2,1979,1981,2,0.0,-0.61,-0.61,0,16,16,0,0,0,0.0,71.0,71.0,0.0,0.0,0.0
bearg102,Gene Bearden,New York Yankees,YANKS,3,10,5,15,1946,1954,8,30.84,1.34,-29.5,1405,374,-1031,2470,260,-2210,6379.0,1746.0,-4633.0,11500.0,10000.0,-1500.0
bearg102,Gene Bearden,Detroit Tigers,TIGRS,11,26,24,50,1952,1961,9,21.38,15.7,-5.68,2119,2215,96,3938,6442,2504,5639.0,2357.0,-3282.0,45200.0,36000.0,-9200.0
bearg102,Gene Bearden,Chicago White Sox,WSOX,1,1,2,3,1954,1954,0,0.0,0.0,0.0,0,0,0,0,0,0,0.0,0.0,0.0,0.0,0.0,0.0
bearm101,Mike Beard,Atlanta Braves,BRAVES,2,2,2,4,1977,1980,3,2.36,4.13,1.77,123,174,51,99,133,34,822.0,1142.0,320.0,0.0,0.0,0.0
beasj001,Jeremy Beasley,Anaheim Angels,ANGELS,1,1,1,2,2020,2020,0,0.01,0.6,0.59,1,16,15,0,0,0,1.0,96.0,95.0,0.0,0.0,0.0
beatb001,Blaine Beatty,Baltimore Orioles,ORLS,1,2,1,3,1987,1988,1,0.54,1.0,0.46,14,52,38,2,0,-2,47.0,283.0,236.0,0.0,330000.0,330000.0
beatb001,Blaine Beatty,New York Mets,METS,2,2,2,4,1991,1996,5,0.0,-0.37,-0.37,0,25,25,0,16,16,0.0,21.0,21.0,109000.0,0.0,-109000.0
beatj001,Jim Beattie,New York Yankees,YANKS,7,17,13,30,1979,1992,13,39.2,19.95,-19.25,2768,1137,-1631,6569,3883,-2686,8301.0,701.0,-7600.0,913333.0,1745000.0,831667.0
beatp001,Pedro Beato,New York Mets,METS,1,1,1,2,2012,2012,0,0.03,0.1,0.07,14,28,14,0,87,87,53.0,0.0,-53.0,487500.0,1135000.0,647500.0
beaug101,Ginger Beaumont,Milwaukee,Milwaukee,1,1,2,3,1898,1901,3,22.3,0.0,-22.3,989,0,-989,4449,0,-4449,0.0,0.0,0.0,0.0,0.0,0.0
beaug101,Ginger Beaumont,Pittsburgh Pirates,PIRATS,1,3,1,4,1906,1910,4,14.38,6.11,-8.27,866,332,-534,3143,1286,-1857,1417.0,0.0,-1417.0,0.0,0.0,0.0
beaug101,Ginger Beaumont,Boston Braves,BRAVES,1,1,2,3,1910,1910,0,0.76,0.0,-0.76,76,5,-71,210,4,-206,0.0,0.0,0.0,0.0,0.0,0.0
beauj101,Jim Beauchamp,St. Louis Cardinals,CARDS,1,2,1,3,1964,1965,1,-0.99,-0.76,0.23,78,138,60,148,253,105,0.0,0.0,0.0,0.0,0.0,0.0
beauj101,Jim Beauchamp,Houston Astros,ASTROS,5,7,7,14,1965,1978,13,10.97,1.23,-9.74,645,1545,900,1174,5736,4562,2468.0,122.0,-2346.0,0.0,29000.0,29000.0
beauj101,Jim Beauchamp,Atlanta Braves,BRAVES,1,3,1,4,1967,1968,1,0.5,-0.77,-1.27,233,127,-106,406,383,-23,170.0,0.0,-170.0,0.0,0.0,0.0
beauj101,Jim Beauchamp,Cincinnati Reds,REDS,1,1,2,3,1969,1970,1,-0.13,0.0,0.13,31,0,-31,29,0,-29,0.0,0.0,0.0,0.0,23500.0,23500.0
beauj101,Jim Beauchamp,Houston Astros,ASTROS,1,2,1,3,1970,1973,3,-0.36,4.11,4.47,121,272,151,243,41,-202,0.0,713.0,713.0,0.0,0.0,0.0
beauj101,Jim Beauchamp,St. Louis Cardinals,CARDS,9,16,14,30,1971,1976,5,14.55,3.01,-11.54,1564,430,-1134,3017,530,-2487,3834.0,1012.0,-2822.0,0.0,0.0,0.0
beavb001,Blake Beavan,Texas Rangers,RNGRS,1,4,2,6,2010,2012,2,2.66,1.99,-0.67,576,111,-465,1946,0,-1946,977.0,588.0,-389.0,0.0,10150000.0,10150000.0
beckb101,Beals Becker,Boston Braves,BRAVES,13,25,26,51,1910,1938,28,36.88,50.32,13.44,3190,4555,1365,9582,15721,6139,4682.0,4013.0,-669.0,56400.0,46100.0,-10300.0
beckb101,Beals Becker,Cincinnati Reds,REDS,1,1,1,2,1913,1913,0,6.96,0.1,-6.86,338,94,-244,1275,344,-931,0.0,0.0,0.0,3500.0,1800.0,-1700.0
beckb103,Bill Beckmann,Toronto,Toronto,1,2,1,3,1942,1943,1,0.32,0.0,-0.32,4,0,-4,2,0,-2,21.0,0.0,-21.0,0.0,0.0,0.0
beckc001,Chad Beck,Arizona Diamondbacks,DBACKS,1,1,1,2,2008,2008,0,-0.21,-0.14,0.07,19,18,-1,0,73,73,54.0,0.0,-54.0,0.0,4500000.0,4500000.0
beckc102,Charlie Becker,Washington Senators,TWINS,1,3,1,4,1912,1916,4,0.0,13.55,13.55,0,546,546,0,2246,2246,0.0,0.0,0.0,0.0,0.0,0.0
beckf101,Fred Beck,Cincinnati Reds,REDS,4,9,7,16,1911,1913,2,9.68,9.52,-0.16,908,358,-550,2525,783,-1742,1567.0,1169.0,-398.0,11280.0,7925.0,-3355.0
beckg001,Gordon Beckham,Chicago White Sox,WSOX,4,6,7,13,2014,2017,3,4.3,2.11,-2.19,554,83,-471,311,0,-311,1065.0,220.0,-845.0,16710000.0,6150000.0,-10560000.0
beckg001,Gordon Beckham,Atlanta Braves,BRAVES,1,1,1,2,2016,2016,0,-0.23,0.0,0.23,3,0,-3,6,0,-6,0.0,0.0,0.0,1250000.0,0.0,-1250000.0
beckg101,Glenn Beckert,Chicago Cubs,CUBS,13,24,24,48,1973,1990,17,18.74,18.43,-0.31,3099,2396,-703,8125,5700,-2425,1137.0,4804.0,3667.0,1020000.0,140000.0,-880000.0
beckh102,Heinz Becker,Chicago Cubs,CUBS,1,1,2,3,1946,1946,0,0.89,0.0,-0.89,52,0,-52,174,0,-174,0.0,0.0,0.0,8500.0,0.0,-8500.0
beckh102,Heinz Becker,Boston Braves,BRAVES,1,3,1,4,1948,1952,4,0.0,-0.21,-0.21,0,104,104,0,35,35,0.0,376.0,376.0,0.0,0.0,0.0
beckj001,Joe Beckwith,Los Angeles Dodgers,DOGRS,1,1,3,4,1983,1990,7,2.06,0.0,-2.06,98,0,-98,0,0,0,587.0,0.0,-587.0,0.0,0.0,0.0
beckj002,Josh Beckett,Florida Marlins,MARLNS,7,14,19,33,2005,2019,14,61.63,50.29,-11.34,1841,2297,456,4569,6863,2294,8636.0,5082.0,-3554.0,29867000.0,14191425.0,-15675575.0
beckj002,Josh Beckett,Boston Red Sox,RSOX,7,22,14,36,2012,2019,7,37.54,19.18,-18.36,2738,1439,-1299,4768,4566,-202,4720.0,1908.0,-2812.0,4708000.0,16585000.0,11877000.0
beckj102,Joe Becker,Brooklyn Dodgers,DOGRS,2,9,3,12,1941,1947,6,3.3,-0.19,-3.49,337,37,-300,419,81,-338,1285.0,0.0,-1285.0,17500.0,0.0,-17500.0
beckj103,Jake Beckley,Pittsburgh Pirates,PIRATS,1,1,2,3,1896,1898,2,1.45,2.13,0.68,63,213,150,270,903,633,0.0,0.0,0.0,0.0,0.0,0.0
beckr001,Rod Beck,Oakland Athletics,ATLTCS,1,1,1,2,1988,1988,0,7.12,0.0,-7.12,827,0,-827,18,0,-18,1389.0,0.0,-1389.0,0.0,0.0,0.0
beckr001,Rod Beck,Chicago Cubs,CUBS,3,4,4,8,1999,2000,1,3.32,-1.65,-4.97,197,144,-53,135,190,55,502.0,93.0,-409.0,7100000.0,3600000.0,-3500000.0
beckr002,Rich Becker,Minnesota Twins,TWINS,2,2,2,4,1997,1998,1,3.21,-1.81,-5.02,253,94,-159,702,260,-442,0.0,0.0,0.0,442500.0,152000.0,-290500.0
beckr002,Rich Becker,Milwaukee Brewers,BREWRS,1,1,1,2,1999,1999,0,0.82,-0.37,-1.19,63,8,-55,212,0,-212,0.0,12.0,12.0,475000.0,0.0,-475000.0
beckt001,Tim Beckham,Tampa Bay Devil Rays,RAYS,2,2,2,4,2017,2021,4,2.45,0.0,-2.45,146,0,-146,632,0,-632,0.0,0.0,0.0,885000.0,0.0,-885000.0
beckz101,Zinn Beck,New York Yankees,YANKS,5,14,8,22,1919,1946,27,28.58,90.66,62.08,995,2697,1702,1312,4980,3668,7730.0,17113.0,9383.0,42500.0,38450.0,-4050.0
bedae001,Erik Bedard,Baltimore Orioles,ORLS,4,5,10,15,2008,2018,10,5.58,43.61,38.03,799,2337,1538,68,8243,8175,1735.0,3798.0,2063.0,3152500.0,833333.0,-2319167.0
bedae001,Erik Bedard,Seattle Mariners,MARNRS,3,4,4,8,2011,2013,2,0.23,-0.5,-0.73,8,119,111,0,404,404,114.0,0.0,-114.0,1000000.0,1300000.0,300000.0
bedeh101,Howie Bedell,Milwaukee Braves,BRAVES,3,5,5,10,1963,1970,7,-2.43,1.09,3.52,280,128,-152,53,23,-30,470.0,329.0,-141.0,12000.0,0.0,-12000.0
bednd001,David Bednar,San Diego Padres,PADRS,1,5,1,6,2021,2021,0,2.1,3.49,1.39,119,68,-51,1,57,56,182.0,544.0,362.0,0.0,0.0,0.0
bedrs001,Steve Bedrosian,Atlanta Braves,BRAVES,2,3,3,6,1985,1994,9,11.78,9.36,-2.42,1062,684,-378,2024,1673,-351,1256.0,1991.0,735.0,1575000.0,850000.0,-725000.0
bedrs001,Steve Bedrosian,Philadelphia Phillies,PHILS,5,8,9,17,1989,2002,13,6.14,8.58,2.44,1265,1614,349,3340,3565,225,859.0,4310.0,3451.0,1570000.0,1070000.0,-500000.0
bedrs001,Steve Bedrosian,San Francisco Giants,GIANTS,1,1,2,3,1990,1995,5,-0.05,0.0,0.05,56,0,-56,0,0,0,232.0,0.0,-232.0,1450000.0,0.0,-1450000.0
beebf101,Fred Beebe,Chicago Cubs,CUBS,1,3,1,4,1906,1906,0,1.84,2.12,0.28,366,34,-332,716,57,-659,2561.0,440.0,-2121.0,0.0,0.0,0.0
beebf101,Fred Beebe,St. Louis Cardinals,CARDS,1,2,3,5,1910,1914,4,0.92,4.47,3.55,70,779,709,75,3039,2964,641.0,470.0,-171.0,0.0,0.0,0.0
beebf101,Fred Beebe,Cincinnati Reds,REDS,2,6,5,11,1910,1914,4,23.79,7.43,-16.36,1495,715,-780,6220,2571,-3649,283.0,231.0,-52.0,0.0,0.0,0.0
beebf101,Fred Beebe,Philadelphia Phillies,PHILS,6,13,14,27,1911,1929,18,74.14,24.32,-49.82,2587,1398,-1189,7576,4163,-3413,10093.0,3446.0,-6647.0,21000.0,24850.0,3850.0
beekj001,Jalen Beeks,Boston Red Sox,RSOX,1,1,1,2,2018,2018,0,0.51,0.83,0.32,62,14,-48,5,3,-2,504.0,162.0,-342.0,0.0,2000000.0,2000000.0
beenf101,Fred Beene,Baltimore Orioles,ORLS,10,29,24,53,1970,1988,18,23.09,129.53,106.44,2838,6114,3276,6187,12778,6591,10078.0,22814.0,12736.0,733833.0,72500.0,-661333.0
beenf101,Fred Beene,Baltimore Orioles,ORLS,1,1,1,2,1972,1972,0,3.54,0.0,-3.54,84,0,-84,9,0,-9,476.0,0.0,-476.0,0.0,0.0,0.0
beenf101,Fred Beene,New York Yankees,YANKS,16,29,28,57,1974,1997,23,45.9,36.13,-9.77,3504,2957,-547,6462,7155,693,12175.0,7546.0,-4629.0,4780000.0,3079500.0,-1700500.0
beers001,Seth Beer,Houston Astros,ASTROS,1,4,2,6,2019,2021,2,-0.93,3.35,4.28,254,54,-200,791,4,-787,100.0,902.0,802.0,0.0,34500000.0,34500000.0
beggj101,Joe Beggs,New York Yankees,YANKS,1,1,1,2,1940,1940,0,9.81,0.32,-9.49,382,10,-372,183,0,-183,1707.0,14.0,-1693.0,0.0,0.0,0.0
beggj101,Joe Beggs,Cincinnati Reds,REDS,2,2,2,4,1947,1948,1,-0.25,1.45,1.7,107,176,69,142,565,423,199.0,122.0,-77.0,0.0,0.0,0.0
beher001,Rick Behenna,Atlanta Braves,BRAVES,1,4,1,5,1983,1986,3,32.51,0.13,-32.38,1861,94,-1767,7480,76,-7404,166.0,699.0,533.0,110000.0,475000.0,365000.0
behnm101,Mel Behney,Cincinnati Reds,REDS,1,1,2,3,1973,1974,1,0.0,0.47,0.47,0,189,189,0,309,309,0.0,0.0,0.0,0.0,0.0,0.0
behrh101,Hank Behrman,Brooklyn Dodgers,DOGRS,1,5,2,7,1947,1947,0,3.3,-0.19,-3.49,337,37,-300,419,81,-338,1285.0,0.0,-1285.0,17500.0,0.0,-17500.0
behrh101,Hank Behrman,New York Giants,GIANTS,1,2,2,4,1950,1957,7,0.0,-0.62,-0.62,0,132,132,0,152,152,0.0,0.0,0.0,0.0,0.0,0.0
beimj001,Joe Beimel,Washington Nationals,NATEX,1,1,2,3,2009,2014,5,1.09,1.26,0.17,192,282,90,1,1,0,182.0,427.0,245.0,2000000.0,0.0,-2000000.0
beirk001,Kevin Beirne,Chicago White Sox,WSOX,2,5,3,8,2001,2001,0,-0.46,1.34,1.8,81,17,-64,117,2,-115,78.0,302.0,224.0,0.0,0.0,0.0
bejmo101,Ollie Bejma,Chicago White Sox,WSOX,2,3,2,5,1940,1946,6,-0.96,-2.59,-1.63,232,359,127,719,1342,623,0.0,0.0,0.0,6000.0,3600.0,-2400.0
belaw101,Wayne Belardi,Brooklyn Dodgers,DOGRS,1,1,4,5,1954,1954,0,0.11,-0.25,-0.36,170,13,-157,476,12,-464,0.0,0.0,0.0,8000.0,0.0,-8000.0
belaw101,Wayne Belardi,Detroit Tigers,TIGRS,4,10,9,19,1956,1961,5,13.15,0.77,-12.38,602,579,-23,394,1616,1222,3228.0,40.0,-3188.0,13200.0,0.0,-13200.0
belaw101,Wayne Belardi,Kansas City Athletics,ATLTCS,38,80,81,161,1957,1976,19,137.3,59.64,-77.66,12943,8836,-4107,29783,24655,-5128,18720.0,9434.0,-9286.0,506100.0,626500.0,120400.0
belct001,Tim Belcher,Oakland Athletics,ATLTCS,1,1,1,2,1987,1993,6,12.61,2.96,-9.65,276,344,68,282,2,-280,2418.0,1085.0,-1333.0,0.0,805000.0,805000.0
belct001,Tim Belcher,Los Angeles Dodgers,DOGRS,3,4,4,8,1991,1994,3,3.76,0.59,-3.17,176,242,66,364,733,369,1120.0,132.0,-988.0,2900000.0,3708000.0,808000.0
belct001,Tim Belcher,Cincinnati Reds,REDS,1,1,2,3,1993,1996,3,0.47,1.84,1.37,12,262,250,0,17,17,215.0,550.0,335.0,3825000.0,0.0,-3825000.0
belct001,Tim Belcher,Cincinnati Reds,REDS,1,1,1,2,1995,1995,0,2.23,0.0,-2.23,28,0,-28,0,0,0,538.0,0.0,-538.0,0.0,0.0,0.0
belfm001,Mike Belfiore,Arizona Diamondbacks,DBACKS,1,1,1,2,2012,2012,0,-0.06,-0.4,-0.34,1,21,20,0,56,56,4.0,0.0,-4.0,0.0,0.0,0.0
belib101,Bo Belinsky,California Angels,ANGELS,1,1,2,3,1964,1974,10,-0.7,5.02,5.72,79,410,331,37,308,271,375.0,3416.0,3041.0,15000.0,5400.0,-9600.0
belib101,Bo Belinsky,Pittsburgh Pirates,PIRATS,1,1,1,2,1970,1970,0,0.04,0.0,-0.04,6,0,-6,2,0,-2,24.0,0.0,-24.0,0.0,0.0,0.0
belim001,Matt Belisle,Atlanta Braves,BRAVES,1,1,1,2,2003,2003,0,0.56,0.54,-0.02,262,36,-226,88,1,-87,1025.0,51.0,-974.0,0.0,550000.0,550000.0
belis001,Stan Belinda,Pittsburgh Pirates,PIRATS,4,4,5,9,1993,2000,7,12.81,4.07,-8.74,462,868,406,382,770,388,3100.0,2733.0,-367.0,3125000.0,489000.0,-2636000.0
belis001,Stan Belinda,Cincinnati Reds,REDS,3,4,6,10,1999,2006,7,1.74,1.96,0.22,719,376,-343,1050,622,-428,650.0,1259.0,609.0,10318333.0,7250000.0,-3068333.0
belit001,Todd Belitz,Tampa Bay Devil Rays,RAYS,1,2,1,3,2000,2006,6,2.82,0.05,-2.77,267,200,-67,0,2,2,762.0,753.0,-9.0,350000.0,0.0,-350000.0
belit001,Todd Belitz,Oakland Athletics,ATLTCS,1,3,1,4,2001,2004,3,0.03,2.82,2.79,154,394,240,507,1663,1156,28.0,0.0,-28.0,201000.0,0.0,-201000.0
belkt001,Tim Belk,Cincinnati Reds,REDS,1,1,1,2,1998,1998,0,0.0,0.0,0.0,0,0,0,0,0,0,0.0,0.0,0.0,0.0,0.0,0.0
bellb001,Buddy Bell,Cleveland Indians,INDINS,15,26,33,59,1978,2001,23,146.54,85.55,-60.99,7272,5776,-1496,23009,21264,-1745,7708.0,2374.0,-5334.0,19613332.0,19125000.0,-488332.0
bellb001,Buddy Bell,Texas Rangers,RNGRS,3,6,5,11,1985,1996,11,13.65,11.7,-1.95,1024,786,-238,4041,1776,-2265,1191.0,1995.0,804.0,15083333.0,7550000.0,-7533333.0
bellb001,Buddy Bell,Cincinnati Reds,REDS,1,1,1,2,1988,1988,0,0.38,0.0,-0.38,74,0,-74,289,0,-289,0.0,0.0,0.0,790909.0,0.0,-790909.0
bellb102,Beau Bell,St.Louis Browns,ORLS,6,10,14,24,1939,1952,13,23.39,27.61,4.22,1164,2723,1559,2963,7190,4227,3417.0,6493.0,3076.0,67500.0,49800.0,-17700.0
bellb102,Beau Bell,Detroit Tigers,TIGRS,2,3,3,6,1940,1948,8,-0.05,6.09,6.14,316,1306,990,1084,5263,4179,0.0,0.0,0.0,10000.0,17000.0,7000.0
bellc003,Chad Bell,Texas Rangers,RNGRS,1,1,1,2,2016,2016,0,-0.76,-0.37,0.39,32,42,10,0,141,141,209.0,0.0,-209.0,0.0,0.0,0.0
belld001,Derek Bell,Toronto Blue Jays,BJAYS,2,3,2,5,1993,1993,0,0.04,2.15,2.11,289,140,-149,1142,579,-563,0.0,0.0,0.0,2100000.0,2300000.0,200000.0
belld001,Derek Bell,San Diego Padres,PADRS,6,15,16,31,1994,2006,12,12.56,40.19,27.63,2713,3390,677,9058,12055,2997,712.0,1324.0,612.0,13007500.0,22494000.0,9486500.0
belld001,Derek Bell,Houston Astros,ASTROS,4,9,8,17,1999,2008,9,8.59,17.4,8.81,484,1965,1481,1331,4299,2968,1469.0,1829.0,360.0,15440000.0,6237500.0,-9202500.0
belld002,David Bell,Cleveland Indians,INDINS,1,3,1,4,1995,1995,0,-1.28,1.44,2.72,177,12,-165,474,0,-474,13.0,224.0,211.0,0.0,4525000.0,4525000.0
belld002,David Bell,Cleveland Indians,INDINS,1,1,1,2,1998,1998,0,5.9,-0.39,-6.29,446,24,-422,1774,97,-1677,0.0,0.0,0.0,0.0,1700000.0,1700000.0
belld002,David Bell,Seattle Mariners,MARNRS,1,1,2,3,2002,2002,0,3.15,1.16,-1.99,154,112,-42,628,376,-252,0.0,0.0,0.0,0.0,0.0,0.0
belld002,David Bell,Philadelphia Phillies,PHILS,1,1,1,2,2006,2006,0,1.05,0.0,-1.05,53,0,-53,201,0,-201,0.0,0.0,0.0,4700000.0,0.0,-4700000.0
bellg001,George Bell,Chicago Cubs,CUBS,5,7,9,16,1992,2010,18,-3.63,62.45,66.08,624,2516,1892,2196,9772,7576,0.0,125.0,125.0,3300000.0,10472409.0,7172409.0
bellg102,Gary Bell,Cleveland Indians,INDINS,1,1,2,3,1967,1967,0,2.77,1.88,-0.89,128,157,29,127,517,390,1094.0,0.0,-1094.0,24000.0,17000.0,-7000.0
bellg102,Gary Bell,Seattle Pilots,BREWRS,1,1,1,2,1969,1970,1,-0.44,1.78,2.22,46,158,112,6,14,8,116.0,331.0,215.0,40000.0,0.0,-40000.0
bellg103,Gus Bell,Pittsburgh Pirates,PIRATS,3,4,5,9,1952,1965,13,19.01,21.51,2.5,1576,1673,97,6339,6514,175,29.0,893.0,864.0,21500.0,10000.0,-11500.0
bellg103,Gus Bell,New York Mets,METS,4,7,8,15,1962,1966,4,1.85,3.31,1.46,189,508,319,493,1517,1024,71.0,326.0,255.0,0.0,0.0,0.0
bellh001,Heath Bell,New York Mets,METS,1,2,2,4,2006,2008,2,8.55,-0.17,-8.72,723,11,-712,2,30,28,1167.0,3.0,-1164.0,0.0,327500.0,327500.0
bellh001,Heath Bell,Miami Marlins,MARLNS,1,2,1,3,2012,2012,0,-0.16,0.0,0.16,133,0,-133,0,0,0,197.0,0.0,-197.0,6000000.0,0.0,-6000000.0
bellh001,Heath Bell,Arizona Diamondbacks,DBACKS,1,3,2,5,2013,2013,0,-0.62,0.0,0.62,14,0,-14,0,0,0,52.0,0.0,-52.0,9000000.0,0.0,-9000000.0
bellj001,Jay Bell,Minnesota Twins,TWINS,4,9,7,16,1985,1995,10,10.17,8.8,-1.37,960,260,-700,2169,213,-1956,3138.0,2882.0,-256.0,1000000.0,650000.0,-350000.0
bellj001,Jay Bell,Cleveland Indians,INDINS,2,4,3,7,1989,2004,15,23.64,33.2,9.56,1343,2138,795,5598,8809,3211,0.0,0.0,0.0,1117500.0,1112500.0,-5000.0
bellj001,Jay Bell,Pittsburgh Pirates,PIRATS,1,2,4,6,1996,2000,4,11.41,4.01,-7.4,460,303,-157,1938,501,-1437,0.0,260.0,260.0,7200000.0,120000.0,-7080000.0
bellj003,Juan Bell,Los Angeles Dodgers,DOGRS,1,3,1,4,1988,1991,3,-1.54,8.44,9.98,185,468,283,229,1974,1745,523.0,0.0,-523.0,305000.0,2142904.0,1837904.0
bellj003,Juan Bell,Baltimore Orioles,ORLS,2,2,2,4,1992,1993,1,1.58,-0.36,-1.94,351,21,-330,1051,40,-1011,0.0,0.0,0.0,0.0,0.0,0.0
bellj004,Josh Bell,Los Angeles Dodgers,DOGRS,1,2,1,3,2009,2010,1,0.18,0.62,0.44,106,187,81,226,1,-225,178.0,192.0,14.0,0.0,2750000.0,2750000.0
bellj004,Josh Bell,Baltimore Orioles,ORLS,1,1,1,2,2012,2014,2,-0.4,-0.06,0.34,21,1,-20,56,0,-56,0.0,4.0,4.0,0.0,0.0,0.0
bellj005,Josh Bell,Pittsburgh Pirates,PIRATS,1,1,2,3,2020,2020,0,3.1,0.0,-3.1,144,0,-144,568,0,-568,0.0,0.0,0.0,4800000.0,0.0,-4800000.0
bellk101,Kevin Bell,San Diego Padres,PADRS,2,4,3,7,1981,1984,3,15.21,2.85,-12.36,959,296,-663,3500,1221,-2279,64.0,0.0,-64.0,0.0,0.0,0.0
belll101,Les Bell,St. Louis Cardinals,CARDS,2,2,4,6,1928,1931,3,2.14,2.41,0.27,400,392,-8,1478,1482,4,0.0,0.0,0.0,0.0,0.0,0.0
bellm002,Mark Bellhorn,Oakland Athletics,ATLTCS,1,1,1,2,2001,2001,0,3.5,0.0,-3.5,197,0,-197,702,0,-702,0.0,0.0,0.0,0.0,0.0,0.0
bellm002,Mark Bellhorn,Chicago Cubs,CUBS,2,4,4,8,2003,2011,8,-0.12,25.65,25.77,358,1203,845,855,5013,4158,0.0,0.0,0.0,465000.0,5025000.0,4560000.0
bellm003,Mike Bell,Texas Rangers,RNGRS,2,2,3,5,1997,2001,4,-0.7,-2.09,-1.39,35,48,13,0,4,4,149.0,378.0,229.0,220000.0,0.0,-220000.0
bellm003,Mike Bell,Arizona Diamondbacks,DBACKS,2,3,2,5,1998,1998,0,0.0,0.27,0.27,0,64,64,0,1,1,0.0,131.0,131.0,225000.0,342500.0,117500.0
bellr002,Ronnie Belliard,Cleveland Indians,INDINS,1,1,1,2,2006,2007,1,0.14,-0.77,-0.91,54,37,-17,211,134,-77,0.0,0.0,0.0,4000000.0,340000.0,-3660000.0
bellr002,Ronnie Belliard,Washington Nationals,NATEX,1,1,2,3,2009,2010,1,0.65,-0.17,-0.82,106,8,-98,268,0,-268,0.0,6.0,6.0,1900000.0,0.0,-1900000.0
bellr003,Rob Bell,Atlanta Braves,BRAVES,2,6,5,11,1998,2002,4,23.0,11.12,-11.88,1472,1098,-374,4934,1979,-2955,1246.0,898.0,-348.0,12520000.0,11751680.0,-768320.0
bellr003,Rob Bell,Cincinnati Reds,REDS,2,4,3,7,2001,2012,11,23.96,9.78,-14.18,1069,964,-105,4207,3624,-583,758.0,0.0,-758.0,2675000.0,11925000.0,9250000.0
bellr102,Rob Belloir,Cleveland Indians,INDINS,2,3,2,5,1975,1976,1,-3.18,0.49,3.67,111,22,-89,203,0,-203,168.0,399.0,231.0,0.0,0.0,0.0
bellt001,Terry Bell,Seattle Mariners,MARNRS,2,2,2,4,1986,1987,1,0.0,1.07,1.07,28,42,14,5,0,-5,106.0,284.0,178.0,0.0,100000.0,100000.0
bellt001,Terry Bell,Kansas City Royals,ROYALS,1,1,1,2,1987,1988,1,0.0,0.69,0.69,1,39,38,1,0,-1,0.0,141.0,141.0,0.0,786667.0,786667.0
bellz101,Zeke Bella,New York Yankees,YANKS,1,2,1,3,1958,1959,1,-0.62,-0.64,-0.02,47,12,-35,93,7,-86,0.0,61.0,61.0,0.0,0.0,0.0
belnv001,Vince Belnome,San Diego Padres,PADRS,1,1,1,2,2012,2015,3,-0.13,-0.16,-0.03,4,10,6,14,0,-14,0.0,9.0,9.0,0.0,0.0,0.0
beltc001,Carlos Beltran,Kansas City Royals,ROYALS,2,2,6,8,2004,2013,9,2.07,8.04,5.97,347,1699,1352,1300,6027,4727,0.0,839.0,839.0,12575000.0,811000.0,-11764000.0
beltc001,Carlos Beltran,New York Mets,METS,1,2,1,3,2011,2019,8,1.17,10.76,9.59,44,246,202,179,250,71,0.0,2248.0,2248.0,19325436.0,0.0,-19325436.0
beltc001,Carlos Beltran,New York Yankees,YANKS,3,7,5,12,2016,2020,4,-1.49,4.55,6.04,291,134,-157,212,8,-204,1269.0,772.0,-497.0,0.0,16900000.0,16900000.0
belte001,Esteban Beltre,Milwaukee Brewers,BREWRS,1,1,1,2,1991,1991,0,-1.12,0.0,1.12,57,0,-57,123,0,-123,0.0,0.0,0.0,0.0,0.0,0.0
belte001,Esteban Beltre,Chicago White Sox,WSOX,3,5,4,9,1994,2004,10,0.31,0.69,0.38,194,240,46,252,8,-244,327.0,1874.0,1547.0,580000.0,1425000.0,845000.0
belte001,Esteban Beltre,Baltimore Orioles,ORLS,1,1,1,2,1999,1999,0,0.0,0.0,0.0,0,0,0,0,0,0,0.0,0.0,0.0,0.0,0.0,0.0
belte002,Engel Beltre,Boston Red Sox,RSOX,1,3,2,5,2007,2007,0,10.71,-0.24,-10.95,871,20,-851,3012,0,-3012,292.0,56.0,-236.0,0.0,6000000.0,6000000.0
beltf001,Francis Beltran,Chicago Cubs,CUBS,2,8,4,12,2004,2009,5,11.71,9.74,-1.97,643,537,-106,2292,1477,-815,256.0,718.0,462.0,5750000.0,6525000.0,775000.0
beltr001,Rigo Beltran,St. Louis Cardinals,CARDS,2,4,2,6,1998,2003,5,1.21,7.77,6.56,177,685,508,4,2263,2259,365.0,602.0,237.0,475000.0,2000000.0,1525000.0
beltr001,Rigo Beltran,New York Mets,METS,3,5,4,9,1999,2005,6,0.19,1.57,1.38,110,682,572,29,1629,1600,370.0,40.0,-330.0,3750000.0,5463333.0,1713333.0
benaf001,Freddie Benavides,Colorado Rockies,ROCKS,1,1,2,3,1994,1994,0,-1.1,0.0,1.1,47,0,-47,90,0,-90,0.0,0.0,0.0,0.0,0.0,0.0
benea001,Andy Benes,San Diego Padres,PADRS,6,15,14,29,1995,2006,11,8.74,38.72,29.98,1384,2329,945,3649,8703,5054,1217.0,136.0,-1081.0,12941680.0,19624000.0,6682320.0
benea002,Alan Benes,Chicago Cubs,CUBS,1,1,1,2,2003,2003,0,-0.73,0.0,0.73,4,0,-4,0,0,0,45.0,0.0,-45.0,0.0,0.0,0.0
benea002,Alan Benes,Texas Rangers,RNGRS,1,1,1,2,2003,2003,0,0.34,0.0,-0.34,6,0,-6,1,0,-1,25.0,0.0,-25.0,0.0,0.0,0.0
bengb101,Benny Bengough,Milwaukee,Milwaukee,1,1,1,2,1931,1933,2,-0.56,0.0,0.56,94,0,-94,295,0,-295,0.0,0.0,0.0,0.0,0.0,0.0
bengr101,Ray Benge,Philadelphia Phillies,PHILS,2,5,4,9,1932,1934,2,2.5,-0.26,-2.76,192,259,67,226,508,282,1744.0,864.0,-880.0,0.0,0.0,0.0
bengr101,Ray Benge,Brooklyn Dodgers,DOGRS,5,10,8,18,1935,1948,13,23.18,15.94,-7.24,1423,1121,-302,4586,3821,-765,1769.0,791.0,-978.0,0.0,0.0,0.0
benia001,Armando Benitez,Baltimore Orioles,ORLS,2,3,5,8,1998,2003,5,10.22,6.28,-3.94,749,531,-218,327,1848,1521,1041.0,0.0,-1041.0,7700000.0,675000.0,-7025000.0
benia001,Armando Benitez,New York Mets,METS,1,1,3,4,2003,2006,3,0.18,0.03,-0.15,9,12,3,0,0,0,28.0,32.0,4.0,6937500.0,300000.0,-6637500.0
benia001,Armando Benitez,New York Yankees,YANKS,1,1,1,2,2003,2003,0,0.32,0.18,-0.14,15,24,9,0,0,0,43.0,53.0,10.0,0.0,3983333.0,3983333.0
benia001,Armando Benitez,San Francisco Giants,GIANTS,1,2,1,3,2007,2008,1,-0.9,0.01,0.91,70,73,3,0,0,0,99.0,122.0,23.0,9866219.0,380000.0,-9486219.0
benia002,Andrew Benintendi,Boston Red Sox,RSOX,1,2,5,7,2021,2021,0,2.43,-0.67,-3.1,134,48,-86,538,136,-402,0.0,0.0,0.0,0.0,0.0,0.0
benij001,Juan Beniquez,Boston Red Sox,RSOX,2,4,3,7,1975,1977,2,14.8,6.95,-7.85,545,58,-487,1514,0,-1514,2654.0,1206.0,-1448.0,200000.0,190000.0,-10000.0
benij001,Juan Beniquez,Texas Rangers,RNGRS,8,18,14,32,1978,1986,8,37.88,13.97,-23.91,1966,931,-1035,3128,2213,-915,8593.0,2102.0,-6491.0,0.0,250000.0,250000.0
benij001,Juan Beniquez,New York Yankees,YANKS,7,17,13,30,1979,1992,13,39.2,19.95,-19.25,2768,1137,-1631,6569,3883,-2686,8301.0,701.0,-7600.0,913333.0,1745000.0,831667.0
benij001,Juan Beniquez,Baltimore Orioles,ORLS,1,1,2,3,1986,1986,0,-1.59,0.0,1.59,57,0,-57,190,0,-190,0.0,0.0,0.0,450000.0,0.0,-450000.0
benij001,Juan Beniquez,Kansas City Royals,ROYALS,1,1,1,2,1987,1993,6,0.16,8.02,7.86,66,114,48,156,0,-156,0.0,1390.0,1390.0,0.0,0.0,0.0
beniy001,Yamil Benitez,Montreal Expos,NATEX,1,1,1,2,1997,1998,1,0.35,0.0,-0.35,53,0,-53,204,0,-204,0.0,0.0,0.0,0.0,0.0,0.0
benjm001,Mike Benjamin,San Francisco Giants,GIANTS,1,1,2,3,1995,1996,1,0.66,-0.14,-0.8,35,72,37,118,3,-115,0.0,125.0,125.0,320000.0,109000.0,-211000.0
bennd101,Dennis Bennett,Philadelphia Phillies,PHILS,2,2,4,6,1964,1968,4,2.36,-0.09,-2.45,157,159,2,197,605,408,859.0,0.0,-859.0,14000.0,41000.0,27000.0
bennd101,Dennis Bennett,Boston Red Sox,RSOX,2,2,3,5,1967,1974,7,-0.01,2.98,2.99,40,197,157,60,15,-45,79.0,485.0,406.0,20000.0,33000.0,13000.0
bennd102,Dave Bennett,Philadelphia Phillies,PHILS,1,2,1,3,1970,1970,0,0.0,-0.64,-0.64,0,22,22,0,70,70,0.0,0.0,0.0,0.0,0.0,0.0
benng001,Gary Bennett,Philadelphia Phillies,PHILS,1,1,1,2,2001,2005,4,0.0,2.88,2.88,1,222,221,1,751,750,0.0,0.0,0.0,237500.0,600000.0,362500.0
benng001,Gary Bennett,New York Mets,METS,1,1,1,2,2001,2001,0,-1.08,0.0,1.08,109,0,-109,375,0,-375,0.0,0.0,0.0,0.0,0.0,0.0
benns001,Shayne Bennett,Boston Red Sox,RSOX,2,4,3,7,1996,1997,1,-1.72,2.82,4.54,535,239,-296,705,937,232,864.0,0.0,-864.0,0.0,0.0,0.0
benoj001,Joaquin Benoit,San Diego Padres,PADRS,2,2,3,5,2015,2018,3,-1.19,1.85,3.04,102,162,60,6,656,650,247.0,0.0,-247.0,8000000.0,4350000.0,-3650000.0
benoj001,Joaquin Benoit,Seattle Mariners,MARNRS,1,1,2,3,2016,2016,0,1.44,0.26,-1.18,26,21,-5,0,0,0,71.0,55.0,-16.0,0.0,0.0,0.0
benoj001,Joaquin Benoit,Philadelphia Phillies,PHILS,1,1,1,2,2017,2017,0,-0.57,0.0,0.57,15,0,-15,0,0,0,25.0,0.0,-25.0,7500000.0,0.0,-7500000.0
bensk001,Kris Benson,Pittsburgh Pirates,PIRATS,2,3,4,7,2004,2009,5,40.94,-2.9,-43.84,1344,558,-786,5481,2041,-3440,727.0,0.0,-727.0,7950000.0,316000.0,-7634000.0
bensk001,Kris Benson,New York Mets,METS,2,2,3,5,2006,2010,4,2.56,8.43,5.87,118,326,208,9,303,294,683.0,2483.0,1800.0,2525000.0,4625000.0,2100000.0
bensv101,Vern Benson,Philadelphia Athletics,ATLTCS,1,4,1,5,1946,1954,8,0.34,26.76,26.42,48,917,869,112,4210,4098,0.0,0.0,0.0,7000.0,0.0,-7000.0
benta101,Al Benton,Philadelphia Athletics,ATLTCS,1,4,1,5,1937,1940,3,0.0,6.28,6.28,0,278,278,0,321,321,0.0,1514.0,1514.0,0.0,0.0,0.0
benta101,Al Benton,SanDiego,SanDiego,1,1,1,2,1952,1952,0,1.46,0.0,-1.46,48,0,-48,11,0,-11,113.0,0.0,-113.0,0.0,0.0,0.0
bentb001,Butch Benton,Chicago Cubs,CUBS,1,1,1,2,1983,1983,0,0.0,0.0,0.0,0,0,0,0,0,0,0.0,0.0,0.0,0.0,0.0,0.0
bentj101,Jack Bentley,New York Giants,GIANTS,5,8,6,14,1925,1932,7,44.2,17.47,-26.73,1941,1197,-744,7676,4275,-3401,795.0,550.0,-245.0,27600.0,44000.0,16400.0
bentj101,Jack Bentley,Washington Senators,TWINS,1,4,1,5,1917,1922,5,0.0,-0.6,-0.6,0,32,32,0,104,104,0.0,0.0,0.0,0.0,0.0,0.0
bentl101,Larry Benton,New York Giants,GIANTS,3,8,5,13,1922,1930,8,4.92,14.44,9.52,1096,750,-346,1706,1477,-229,6029.0,4662.0,-1367.0,17500.0,39500.0,22000.0
bentl101,Larry Benton,Boston Braves,BRAVES,7,13,11,24,1927,1938,11,17.24,17.06,-0.18,1140,2433,1293,3084,9081,5997,3328.0,1364.0,-1964.0,42000.0,12100.0,-29900.0
bentl101,Larry Benton,New York Giants,GIANTS,1,1,1,2,1930,1930,0,2.73,-1.03,-3.76,316,124,-192,266,592,326,2226.0,0.0,-2226.0,0.0,16000.0,16000.0
bentr101,Rabbit Benton,Charleston,Charleston,1,1,2,3,1922,1933,11,-0.19,0.0,0.19,6,0,-6,21,0,-21,0.0,0.0,0.0,0.0,0.0,0.0
benzt001,Todd Benzinger,Boston Red Sox,RSOX,3,6,4,10,1988,1993,5,-2.7,4.47,7.17,436,419,-17,1235,872,-363,258.0,1268.0,1010.0,397000.0,3235000.0,2838000.0
benzt001,Todd Benzinger,Cincinnati Reds,REDS,1,1,1,2,1991,1991,0,0.77,0.44,-0.33,78,53,-25,315,156,-159,0.0,0.0,0.0,705000.0,0.0,-705000.0
benzt001,Todd Benzinger,Kansas City Royals,ROYALS,1,1,2,3,1991,1994,3,-0.93,0.26,1.19,121,137,16,313,406,93,0.0,0.0,0.0,0.0,260000.0,260000.0
beraj101,Johnny Berardino,St.Louis Browns,ORLS,2,2,3,5,1947,1950,3,6.81,5.09,-1.72,451,315,-136,1933,1294,-639,0.0,43.0,43.0,14000.0,6000.0,-8000.0
beraj101,Johnny Berardino,St.Louis Browns,ORLS,1,1,2,3,1947,1955,8,-0.31,0.0,0.31,155,0,-155,361,0,-361,0.0,0.0,0.0,14000.0,0.0,-14000.0
beraj101,Johnny Berardino,Cleveland Indians,INDINS,1,3,2,5,1952,1960,8,-0.35,6.71,7.06,19,748,729,60,2451,2391,0.0,35.0,35.0,10000.0,0.0,-10000.0
berbj001,Jeff Berblinger,Detroit Tigers,TIGRS,1,1,2,3,1996,2001,5,0.0,5.99,5.99,0,703,703,0,2550,2550,0.0,0.0,0.0,0.0,0.0,0.0
berbl101,Lou Berberet,New York Yankees,YANKS,7,20,15,35,1956,1970,14,3.04,33.17,30.13,2442,2492,50,6615,5619,-996,2999.0,5239.0,2240.0,115500.0,43000.0,-72500.0
berbl101,Lou Berberet,Washington Senators,TWINS,2,2,2,4,1958,1961,3,2.61,-0.85,-3.46,216,234,18,833,680,-153,0.0,0.0,0.0,0.0,0.0,0.0
berbl101,Lou Berberet,Boston Red Sox,RSOX,2,2,3,5,1958,1960,2,0.31,-0.68,-0.99,185,8,-177,657,1,-656,0.0,26.0,26.0,0.0,0.0,0.0
bereb001,Bruce Berenyi,Cincinnati Reds,REDS,4,7,7,14,1984,1988,4,12.33,8.43,-3.9,964,327,-637,681,447,-234,4756.0,2505.0,-2251.0,1777500.0,937500.0,-840000.0
berej001,Juan Berenguer,New York Mets,METS,2,3,4,7,1981,1984,3,-3.49,-1.63,1.86,387,108,-279,1480,288,-1192,193.0,0.0,-193.0,0.0,0.0,0.0
berej001,Juan Berenguer,Detroit Tigers,TIGRS,5,7,8,15,1985,1991,6,13.23,9.61,-3.62,999,888,-111,2374,2066,-308,1829.0,1754.0,-75.0,1440000.0,1070000.0,-370000.0
berej001,Juan Berenguer,Atlanta Braves,BRAVES,2,2,2,4,1992,1993,1,-0.92,-0.44,0.48,69,28,-41,3,1,-2,228.0,50.0,-178.0,1200000.0,3625000.0,2425000.0
berej002,Jason Bere,Milwaukee Brewers,BREWRS,9,19,22,41,2000,2012,12,44.17,39.37,-4.8,3016,3033,17,9285,7113,-2172,2619.0,7597.0,4978.0,13997000.0,20222667.0,6225667.0
bergb101,Boze Berger,Chicago White Sox,WSOX,1,1,1,2,1938,1940,2,0.03,1.32,1.29,20,195,175,33,793,760,0.0,0.0,0.0,4000.0,10500.0,6500.0
bergb101,Boze Berger,Brooklyn Dodgers,DOGRS,1,1,1,2,1940,1946,6,0.0,-0.05,-0.05,0,2,2,0,5,5,0.0,0.0,0.0,0.0,0.0,0.0
bergd001,Dave Bergman,New York Yankees,YANKS,2,4,2,6,1977,1979,2,-0.57,3.2,3.77,493,187,-306,951,449,-502,300.0,202.0,-98.0,0.0,0.0,0.0
bergd001,Dave Bergman,Houston Astros,ASTROS,1,2,1,3,1981,1982,1,11.7,-0.13,-11.83,1042,26,-1016,3644,52,-3592,0.0,0.0,0.0,0.0,0.0,0.0
bergd001,Dave Bergman,San Francisco Giants,GIANTS,2,2,2,4,1984,1988,4,-0.31,-0.95,-0.64,71,55,-16,133,84,-49,0.0,347.0,347.0,0.0,0.0,0.0
bergd001,Dave Bergman,Philadelphia Phillies,PHILS,3,6,6,12,1984,1989,5,21.01,8.65,-12.36,1868,885,-983,3542,3171,-371,2761.0,15.0,-2746.0,1629900.0,750000.0,-879900.0
bergd003,Dusty Bergman,Anaheim Angels,ANGELS,1,2,1,3,2005,2005,0,0.0,0.15,0.15,0,12,12,0,0,0,0.0,11.0,11.0,0.0,1050000.0,1050000.0
bergj002,Justin Berg,New York Yankees,YANKS,1,1,1,2,2005,2005,0,0.28,-0.42,-0.7,119,21,-98,2,57,55,192.0,0.0,-192.0,0.0,0.0,0.0
bergp001,Peter Bergeron,Los Angeles Dodgers,DOGRS,4,8,8,16,1998,2006,8,3.75,12.46,8.71,1576,982,-594,3524,3610,86,1585.0,233.0,-1352.0,12365000.0,8350000.0,-4015000.0
bergp001,Peter Bergeron,Montreal Expos,NATEX,1,2,2,4,2004,2004,0,0.0,0.0,0.0,0,0,0,0,0,0,0.0,0.0,0.0,300000.0,0.0,-300000.0
bergs001,Sean Bergman,Detroit Tigers,TIGRS,7,19,14,33,1996,2002,6,8.66,7.11,-1.55,2368,1295,-1073,4185,3631,-554,2521.0,1620.0,-901.0,8560000.0,6675000.0,-1885000.0
bergs001,Sean Bergman,San Diego Padres,PADRS,1,1,1,2,1998,1998,0,1.9,-1.01,-2.91,98,55,-43,97,71,-26,813.0,0.0,-813.0,0.0,0.0,0.0
bergt001,Travis Bergen,Toronto Blue Jays,BJAYS,1,1,2,3,2020,2021,1,0.07,6.89,6.82,7,39,32,0,5,5,20.0,642.0,622.0,0.0,9430000.0,9430000.0
bergw101,Wally Berger,LosAngeles,LosAngeles,1,1,3,4,1929,1929,0,36.6,0.0,-36.6,1057,0,-1057,4551,0,-4551,0.0,0.0,0.0,0.0,15000.0,15000.0
bergw101,Wally Berger,Boston Braves,BRAVES,1,1,2,3,1937,1938,1,1.82,-0.86,-2.68,75,40,-35,255,24,-231,0.0,229.0,229.0,12000.0,0.0,-12000.0
bergw101,Wally Berger,New York Giants,GIANTS,4,11,7,18,1938,1954,16,3.71,9.13,5.42,198,921,723,814,3167,2353,0.0,172.0,172.0,6000.0,0.0,-6000.0
berkl001,Lance Berkman,Houston Astros,ASTROS,4,5,9,14,2010,2020,10,12.52,9.56,-2.96,1152,1169,17,4030,2853,-1177,460.0,1904.0,1444.0,15511100.0,450000.0,-15061100.0
berlj101,Jack Berly,New York Giants,GIANTS,1,4,1,5,1931,1931,0,0.0,0.0,0.0,0,0,0,0,0,0,0.0,0.0,0.0,0.0,0.0,0.0
berna001,Adam Bernero,Detroit Tigers,TIGRS,1,1,1,2,2003,2004,1,0.08,0.19,0.11,94,43,-51,8,129,121,195.0,0.0,-195.0,314000.0,0.0,-314000.0
bernd101,Dwight Bernard,New York Mets,METS,3,5,4,9,1979,1984,5,-1.09,5.09,6.18,271,220,-51,297,188,-109,1199.0,1734.0,535.0,0.0,375000.0,375000.0
bernj101,Juan Bernhardt,Seattle Mariners,MARNRS,1,1,1,2,1979,1979,0,0.0,-0.2,-0.2,0,14,14,0,0,0,0.0,60.0,60.0,0.0,0.0,0.0
bernt001,Tony Bernazard,Montreal Expos,NATEX,1,1,1,2,1980,1982,2,7.71,0.0,-7.71,302,0,-302,1339,0,-1339,0.0,0.0,0.0,0.0,0.0,0.0
bernt001,Tony Bernazard,Chicago White Sox,WSOX,1,1,1,2,1983,1987,4,0.85,4.14,3.29,80,414,334,347,1370,1023,0.0,0.0,0.0,252000.0,425000.0,173000.0
bernt001,Tony Bernazard,Seattle Mariners,MARNRS,1,1,2,3,1983,1986,3,3.77,5.97,2.2,518,507,-11,2036,2147,111,0.0,0.0,0.0,0.0,0.0,0.0
bernt001,Tony Bernazard,Cleveland Indians,INDINS,2,2,3,5,1987,1989,2,0.17,-0.62,-0.79,68,21,-47,261,12,-249,0.0,224.0,224.0,630000.0,0.0,-630000.0
beroj101,Johnny Bero,St.Louis Browns,ORLS,18,45,42,87,1951,1988,37,52.55,137.89,85.34,3971,8023,4052,7618,22268,14650,14427.0,15253.0,826.0,834433.0,135900.0,-698533.0
berra001,Angel Berroa,Oakland Athletics,ATLTCS,3,5,7,12,2001,2013,12,4.13,35.82,31.69,847,1285,438,3142,5045,1903,578.0,1155.0,577.0,8550000.0,0.0,-8550000.0
berra001,Angel Berroa,Kansas City Royals,ROYALS,1,1,2,3,2008,2008,0,-0.21,0.0,0.21,84,0,-84,256,0,-256,0.0,0.0,0.0,0.0,0.0,0.0
berrc103,Charlie Berry,Boston Red Sox,RSOX,4,10,7,17,1932,1937,5,13.6,8.5,-5.1,544,1121,577,1112,4164,3052,1631.0,0.0,-1631.0,49250.0,42500.0,-6750.0
berrc103,Charlie Berry,Chicago White Sox,WSOX,1,2,2,4,1933,1935,2,0.0,3.6,3.6,175,72,-103,526,95,-431,0.0,735.0,735.0,8000.0,7500.0,-500.0
berrd001,Dale Berra,Pittsburgh Pirates,PIRATS,1,3,3,6,1984,1986,2,0.69,0.08,-0.61,132,124,-8,338,327,-11,92.0,0.0,-92.0,0.0,1340000.0,1340000.0
berrd002,Damon Berryhill,Chicago Cubs,CUBS,3,6,6,12,1991,2001,10,5.81,3.91,-1.9,1572,1078,-494,2118,2224,106,1917.0,1553.0,-364.0,10348333.0,6555000.0,-3793333.0
berrg001,Geronimo Berroa,Oakland Athletics,ATLTCS,5,10,10,20,1997,2003,6,22.77,7.36,-15.41,1712,306,-1406,3519,230,-3289,6649.0,1770.0,-4879.0,6013333.0,5053333.0,-960000.0
berrg001,Geronimo Berroa,Cleveland Indians,INDINS,3,3,5,8,1998,2001,3,5.51,0.14,-5.37,436,78,-358,1334,182,-1152,316.0,16.0,-300.0,2412000.0,1000000.0,-1412000.0
berrj001,Jose Berrios,Minnesota Twins,TWINS,1,1,2,3,2021,2021,0,1.38,0.0,-1.38,13,0,-13,2,0,-2,211.0,0.0,-211.0,6100000.0,0.0,-6100000.0
berrk101,Ken Berry,Chicago White Sox,WSOX,5,12,9,21,1970,1979,9,24.46,26.69,2.23,2016,1630,-386,4784,5459,675,4690.0,2166.0,-2524.0,87700.0,263100.0,175400.0
berrk101,Ken Berry,California Angels,ANGELS,3,7,8,15,1973,1976,3,0.2,6.55,6.35,187,557,370,417,1633,1216,696.0,244.0,-452.0,35000.0,131300.0,96300.0
berrn101,Neil Berry,Detroit Tigers,TIGRS,1,3,1,4,1952,1952,0,-0.5,0.0,0.5,62,0,-62,121,0,-121,0.0,0.0,0.0,10000.0,0.0,-10000.0
berrn101,Neil Berry,Chicago White Sox,WSOX,22,41,37,78,1954,1969,15,45.6,54.96,9.36,4683,4529,-154,11508,9881,-1627,7275.0,8147.0,872.0,218750.0,240000.0,21250.0
berrn101,Neil Berry,Baltimore Orioles,ORLS,5,10,10,20,1954,1960,6,15.05,10.79,-4.26,745,954,209,1673,2729,1056,2291.0,1208.0,-1083.0,10000.0,0.0,-10000.0
berrq001,Quintin Berry,Kansas City Royals,ROYALS,1,1,1,2,2013,2017,4,0.39,0.0,-0.39,13,0,-13,9,0,-9,0.0,0.0,0.0,0.0,504500.0,504500.0
berrr101,Ray Berres,Pittsburgh Pirates,PIRATS,3,8,3,11,1940,1947,7,-0.52,4.7,5.22,266,678,412,694,2222,1528,0.0,0.0,0.0,5000.0,0.0,-5000.0
berrs001,Sean Berry,Kansas City Royals,ROYALS,1,2,2,4,1992,1998,6,4.48,3.6,-0.88,352,157,-195,1116,0,-1116,0.0,1991.0,1991.0,0.0,293000.0,293000.0
berrs001,Sean Berry,Montreal Expos,NATEX,3,4,5,9,1995,1999,4,8.5,1.98,-6.52,598,385,-213,1155,466,-689,460.0,419.0,-41.0,1010000.0,340000.0,-670000.0
bertd101,Dick Bertell,Chicago Cubs,CUBS,3,4,6,10,1965,1968,3,-0.02,-1.61,-1.59,244,333,89,648,438,-210,220.0,627.0,407.0,0.0,33000.0,33000.0
bertd101,Dick Bertell,San Francisco Giants,GIANTS,1,1,1,2,1967,1968,1,0.01,0.0,-0.01,2,0,-2,7,0,-7,0.0,0.0,0.0,0.0,0.0,0.0
bertf101,Frank Bertaina,Baltimore Orioles,ORLS,6,16,17,33,1967,1988,21,25.3,73.67,48.37,1834,3826,1992,3308,6892,3584,7606.0,13824.0,6218.0,733333.0,8400.0,-724933.0
bertf101,Frank Bertaina,Washington Senators,RNGRS,1,1,1,2,1969,1969,0,0.67,0.0,-0.67,6,0,-6,2,0,-2,18.0,0.0,-18.0,0.0,0.0,0.0
bertr101,Reno Bertoia,Detroit Tigers,TIGRS,2,5,4,9,1958,1960,2,-1.58,7.47,9.05,379,604,225,1361,2163,802,0.0,0.0,0.0,7000.0,9500.0,2500.0
bertr101,Reno Bertoia,Kansas City Athletics,ATLTCS,1,2,2,4,1961,1963,2,0.04,2.6,2.56,55,199,144,51,85,34,40.0,733.0,693.0,0.0,0.0,0.0
bertr101,Reno Bertoia,Minnesota Twins,TWINS,1,3,1,4,1961,1963,2,-0.34,-0.87,-0.53,41,239,198,137,577,440,5.0,0.0,-5.0,0.0,0.0,0.0
berua001,Andres Berumen,Florida Marlins,MARLNS,16,36,40,76,1993,2019,26,141.98,107.88,-34.1,6566,6100,-466,15461,18577,3116,13532.0,10298.0,-3234.0,68689667.0,39069968.0,-29619699.0
berua001,Andres Berumen,San Diego Padres,PADRS,1,1,1,2,1997,1997,0,0.0,0.45,0.45,0,17,17,0,14,14,0.0,132.0,132.0,0.0,0.0,0.0
bescb101,Bob Bescher,Cincinnati Reds,REDS,3,4,7,11,1913,1930,17,8.71,56.49,47.78,629,2132,1503,2672,8901,6229,0.0,27.0,27.0,5200.0,9700.0,4500.0
bescb101,Bob Bescher,New York Giants,GIANTS,1,2,1,3,1915,1921,6,2.98,6.22,3.24,323,339,16,1330,336,-994,0.0,2915.0,2915.0,0.0,0.0,0.0
bescb101,Bob Bescher,St. Louis Cardinals,CARDS,1,5,1,6,1917,1917,0,0.0,0.36,0.36,0,28,28,0,29,29,0.0,256.0,256.0,9800.0,0.0,-9800.0
bessh101,Herman Besse,Memphis,Memphis,1,1,4,5,1939,1945,6,-2.98,0.0,2.98,136,0,-136,99,0,-99,729.0,0.0,-729.0,0.0,3000.0,3000.0
bestk001,Karl Best,Seattle Mariners,MARNRS,1,1,1,2,1987,1987,0,0.0,0.0,0.0,0,0,0,0,0,0,0.0,0.0,0.0,0.0,0.0,0.0
bestk001,Karl Best,Detroit Tigers,TIGRS,1,1,1,2,1988,1988,0,-0.18,0.0,0.18,11,0,-11,0,0,0,36.0,0.0,-36.0,0.0,0.0,0.0
bestk001,Karl Best,Minnesota Twins,TWINS,2,2,2,4,1988,1990,2,0.0,0.0,0.0,0,0,0,0,0,0,0.0,0.0,0.0,0.0,0.0,0.0
betar001,Rafael Betancourt,Cleveland Indians,INDINS,1,1,1,2,2009,2009,0,6.3,0.0,-6.3,606,0,-606,0,0,0,827.0,0.0,-827.0,3350000.0,0.0,-3350000.0
betay001,Yuniesky Betancourt,Seattle Mariners,MARNRS,1,1,2,3,2009,2011,2,-3.4,-0.16,3.24,279,14,-265,1079,0,-1079,0.0,48.0,48.0,2300000.0,0.0,-2300000.0
betay001,Yuniesky Betancourt,Kansas City Royals,ROYALS,4,9,9,18,2010,2021,11,13.5,49.72,36.22,866,2766,1900,2084,9673,7589,3154.0,2429.0,-725.0,26600000.0,13058267.0,-13541733.0
betew001,Wilson Betemit,Atlanta Braves,BRAVES,2,3,4,7,2006,2009,3,1.8,0.38,-1.42,439,76,-363,1392,127,-1265,0.0,59.0,59.0,345000.0,4000000.0,3655000.0
betew001,Wilson Betemit,Los Angeles Dodgers,DOGRS,1,1,1,2,2007,2008,1,-0.36,-0.41,-0.05,124,141,17,290,0,-290,0.0,212.0,212.0,405000.0,455923.0,50923.0
betew001,Wilson Betemit,New York Yankees,YANKS,1,3,2,5,2008,2012,4,-0.72,11.97,12.69,28,599,571,50,2501,2451,20.0,3.0,-17.0,1165000.0,3600000.0,2435000.0
betew001,Wilson Betemit,Kansas City Royals,ROYALS,1,1,2,3,2011,2011,0,0.46,0.0,-0.46,40,0,-40,133,0,-133,0.0,0.0,0.0,1000000.0,0.0,-1000000.0
bethc001,Christian Bethancourt,Atlanta Braves,BRAVES,1,1,2,3,2015,2016,1,-0.48,-0.36,0.12,87,20,-67,211,3,-208,16.0,65.0,49.0,507500.0,0.0,-507500.0
bettl101,Larry Bettencourt,St.Louis Browns,ORLS,2,4,3,7,1932,1938,6,5.05,3.68,-1.37,140,456,316,175,291,116,1317.0,2656.0,1339.0,9500.0,3300.0,-6200.0
bettm001,Mookie Betts,Boston Red Sox,RSOX,1,3,3,6,2020,2020,0,8.46,2.13,-6.33,253,53,-200,814,221,-593,221.0,0.0,-221.0,0.0,0.0,0.0
bevah101,Hal Bevan,Kansas City Athletics,ATLTCS,1,1,1,2,1955,1955,0,0.0,0.0,0.0,3,0,-3,3,0,-3,0.0,0.0,0.0,7000.0,0.0,-7000.0
bevak001,Kurt Bevacqua,Cincinnati Reds,REDS,3,4,4,8,1971,1973,2,0.37,0.09,-0.28,297,115,-182,794,178,-616,24.0,0.0,-24.0,16000.0,19500.0,3500.0
bevak001,Kurt Bevacqua,Cleveland Indians,INDINS,2,2,2,4,1972,1974,2,-1.25,0.0,1.25,138,0,-138,409,0,-409,0.0,0.0,0.0,10500.0,27000.0,16500.0
bevak001,Kurt Bevacqua,Kansas City Royals,ROYALS,2,4,3,7,1973,1978,5,2.68,1.78,-0.9,438,157,-281,817,247,-570,955.0,645.0,-310.0,49000.0,68500.0,19500.0
bevak001,Kurt Bevacqua,Pittsburgh Pirates,PIRATS,1,1,2,3,1974,1974,0,-1.04,0.0,1.04,39,0,-39,100,0,-100,0.0,0.0,0.0,26000.0,0.0,-26000.0
bevak001,Kurt Bevacqua,Texas Rangers,RNGRS,2,7,7,14,1978,1985,7,13.84,11.07,-2.77,1150,730,-420,2985,2621,-364,918.0,0.0,-918.0,475000.0,608333.0,133333.0
bevak001,Kurt Bevacqua,San Diego Padres,PADRS,3,8,6,14,1980,1989,9,23.83,6.58,-17.25,2167,688,-1479,6899,2080,-4819,2009.0,1127.0,-882.0,0.0,0.0,0.0
bevej001,Jason Beverlin,Oakland Athletics,ATLTCS,2,3,3,6,1995,1997,2,-0.97,-0.14,0.83,515,36,-479,1898,98,-1800,0.0,89.0,89.0,6200000.0,5300000.0,-900000.0
biagj001,Joe Biagini,Toronto Blue Jays,BJAYS,2,4,3,7,2019,2021,2,-0.75,-0.48,0.27,26,56,30,8,146,138,113.0,0.0,-113.0,4800000.0,0.0,-4800000.0
bianb001,Buddy Biancalana,Kansas City Royals,ROYALS,1,1,1,2,1987,1987,0,-0.55,0.0,0.55,18,0,-18,25,0,-25,0.0,0.0,0.0,0.0,0.0,0.0
bibbj001,Jim Bibby,New York Mets,METS,1,4,4,8,1971,1975,4,1.94,1.36,-0.58,244,340,96,49,280,231,763.0,880.0,117.0,0.0,0.0,0.0
bibbj001,Jim Bibby,St. Louis Cardinals,CARDS,3,3,4,7,1973,1974,1,10.5,-0.07,-10.57,783,18,-765,2118,11,-2107,1625.0,122.0,-1503.0,0.0,0.0,0.0
bibbj001,Jim Bibby,Texas Rangers,RNGRS,2,5,3,8,1975,1978,3,27.68,13.0,-14.68,537,88,-449,186,0,-186,7504.0,2017.0,-5487.0,60000.0,160000.0,100000.0
bichd001,Dante Bichette,California Angels,ANGELS,1,1,1,2,1991,1991,0,-0.31,-1.23,-0.92,246,119,-127,886,501,-385,0.0,0.0,0.0,0.0,0.0,0.0
bichd001,Dante Bichette,Milwaukee Brewers,BREWRS,1,1,1,2,1992,1993,1,4.76,-0.36,-5.12,1018,125,-893,4352,477,-3875,0.0,0.0,0.0,230000.0,0.0,-230000.0
bichd001,Dante Bichette,Colorado Rockies,ROCKS,1,2,2,4,1999,2000,1,0.45,1.52,1.07,125,214,89,514,512,-2,0.0,107.0,107.0,7250000.0,3318333.0,-3931667.0
bichd001,Dante Bichette,Cincinnati Reds,REDS,2,2,4,6,2000,2006,6,0.22,1.51,1.29,505,251,-254,538,108,-430,543.0,1259.0,716.0,7000000.0,0.0,-7000000.0
bickp001,Phil Bickford,San Francisco Giants,GIANTS,1,2,1,3,2016,2019,3,-0.35,3.53,3.88,20,278,258,31,2,-29,6.0,410.0,404.0,0.0,0.0,0.0
bickv101,Vern Bickford,Milwaukee Braves,BRAVES,1,1,2,3,1954,1956,2,-0.22,0.12,0.34,2,62,60,1,138,137,12.0,0.0,-12.0,0.0,0.0,0.0
biddj001,Jesse Biddle,Philadelphia Phillies,PHILS,1,1,1,2,2016,2016,0,0.0,0.0,0.0,0,0,0,0,0,0,0.0,0.0,0.0,0.0,0.0,0.0
biddj001,Jesse Biddle,Atlanta Braves,BRAVES,1,2,2,4,2019,2019,0,-0.53,0.41,0.94,11,85,74,0,0,0,33.0,119.0,86.0,5375000.0,8500000.0,3125000.0
biddr001,Rocky Biddle,Chicago White Sox,WSOX,1,4,2,6,2003,2003,0,-4.18,5.0,9.18,270,36,-234,107,7,-100,449.0,726.0,277.0,0.0,0.0,0.0
bielm001,Mike Bielecki,Pittsburgh Pirates,PIRATS,1,1,1,2,1988,1988,0,4.7,0.0,-4.7,254,0,-254,200,0,-200,1802.0,0.0,-1802.0,0.0,0.0,0.0
bielm001,Mike Bielecki,Chicago Cubs,CUBS,3,6,6,12,1991,2001,10,5.81,3.91,-1.9,1572,1078,-494,2118,2224,106,1917.0,1553.0,-364.0,10348333.0,6555000.0,-3793333.0
biern001,Nick Bierbrodt,Arizona Diamondbacks,DBACKS,1,2,2,4,2001,2001,0,-0.05,0.9,0.95,103,38,-65,245,52,-193,290.0,243.0,-47.0,200000.0,3750000.0,3550000.0
bierr001,Randor Bierd,Baltimore Orioles,ORLS,1,1,1,2,2009,2009,0,0.0,0.0,0.0,0,0,0,0,0,0,0.0,0.0,0.0,0.0,0.0,0.0
bigbl001,Larry Bigbie,Baltimore Orioles,ORLS,1,1,1,2,2005,2005,0,-0.58,-0.09,0.49,23,52,29,70,181,111,0.0,0.0,0.0,380000.0,0.0,-380000.0
bigbl001,Larry Bigbie,Colorado Rockies,ROCKS,1,2,1,3,2005,2006,1,1.78,0.15,-1.63,503,131,-372,1507,1,-1506,15.0,134.0,119.0,326000.0,1850000.0,1524000.0
bigbl101,Lyle Bigbee,Seattle,Seattle,1,1,3,4,1919,1921,2,-1.44,0.0,1.44,50,0,-50,86,0,-86,133.0,0.0,-133.0,0.0,0.0,0.0
bigee101,Elliot Bigelow,Washington Senators,TWINS,1,5,1,6,1928,1941,13,14.54,41.49,26.95,801,1492,691,1696,6460,4764,3390.0,0.0,-3390.0,20500.0,6000.0,-14500.0
biitl101,Larry Biittner,Texas Rangers,RNGRS,1,1,1,2,1973,1974,1,0.76,0.0,-0.76,150,0,-150,443,0,-443,0.0,0.0,0.0,0.0,40000.0,40000.0
biitl101,Larry Biittner,Montreal Expos,NATEX,2,3,2,5,1976,1978,2,19.9,-0.47,-20.37,1883,153,-1730,6872,280,-6592,648.0,557.0,-91.0,0.0,0.0,0.0
bilad001,Dann Bilardello,Cincinnati Reds,REDS,3,6,4,10,1985,1988,3,12.45,4.93,-7.52,892,228,-664,620,336,-284,4251.0,1549.0,-2702.0,1777500.0,937500.0,-840000.0
bilks101,Steve Bilko,Cincinnati Reds,REDS,1,4,1,5,1958,1960,2,0.85,9.64,8.79,265,190,-75,151,233,82,590.0,1314.0,724.0,14000.0,30000.0,16000.0
billb002,Bruce Billings,Colorado Rockies,ROCKS,1,2,1,3,2011,2011,0,-0.29,1.57,1.86,3,70,67,0,286,286,15.0,0.0,-15.0,0.0,6000000.0,6000000.0
billj101,Jack Billingham,Houston Astros,ASTROS,8,15,14,29,1971,1989,18,76.39,55.08,-21.31,4763,4769,6,15346,14810,-536,3810.0,5622.0,1812.0,705000.0,416000.0,-289000.0
billj101,Jack Billingham,Cincinnati Reds,REDS,1,1,2,3,1978,1980,2,4.64,0.0,-4.64,73,0,-73,0,0,0,1101.0,0.0,-1101.0,0.0,0.0,0.0
billj103,Josh Billings,Cleveland Indians,INDINS,1,1,1,2,1919,1923,4,-0.67,0.22,0.89,133,131,-2,324,316,-8,0.0,0.0,0.0,0.0,0.0,0.0
binkg101,George Binks,Milwaukee,Milwaukee,1,1,1,2,1944,1944,0,1.67,0.0,-1.67,215,0,-215,747,0,-747,0.0,0.0,0.0,0.0,0.0,0.0
binkg101,George Binks,Washington Senators,TWINS,1,1,2,3,1947,1947,0,-0.75,-0.26,0.49,121,18,-103,407,2,-405,0.0,46.0,46.0,0.0,0.0,0.0
binkg101,George Binks,Philadelphia Athletics,ATLTCS,37,81,79,160,1948,1976,28,93.04,74.67,-18.37,10610,9528,-1082,25813,29511,3698,12563.0,7417.0,-5146.0,507800.0,639500.0,131700.0
birdd101,Doug Bird,Kansas City Royals,ROYALS,4,6,5,11,1979,1986,7,14.16,8.78,-5.38,1336,964,-372,3943,3382,-561,183.0,0.0,-183.0,0.0,250000.0,250000.0
birdd101,Doug Bird,New York Yankees,YANKS,1,3,1,4,1981,1983,2,0.87,1.55,0.68,126,12,-114,98,0,-98,955.0,212.0,-743.0,0.0,0.0,0.0
birdd101,Doug Bird,Chicago Cubs,CUBS,3,4,3,7,1982,1988,6,-1.41,4.87,6.28,122,600,478,169,660,491,295.0,1469.0,1174.0,490000.0,730000.0,240000.0
birdk001,Kyle Bird,Tampa Bay Devil Rays,RAYS,2,4,5,9,2018,2020,2,-0.58,3.27,3.85,173,118,-55,2,160,158,374.0,210.0,-164.0,0.0,0.0,0.0
birkr101,Ralph Birkofer,Pittsburgh Pirates,PIRATS,1,2,1,3,1936,1939,3,12.93,4.3,-8.63,841,114,-727,3255,108,-3147,89.0,818.0,729.0,0.0,0.0,0.0
birkr101,Ralph Birkofer,Brooklyn Dodgers,DOGRS,1,1,2,3,1937,1939,2,0.0,-0.42,-0.42,0,48,48,0,121,121,0.0,0.0,0.0,0.0,0.0,0.0
birtt001,Tim Birtsas,New York Yankees,YANKS,3,7,8,15,1984,1993,9,53.43,36.99,-16.44,2484,1135,-1349,8455,3089,-5366,3002.0,2795.0,-207.0,2415000.0,2187766.0,-227234.0
birtt001,Tim Birtsas,Oakland Athletics,ATLTCS,1,2,1,3,1987,1989,2,38.12,0.55,-37.57,775,245,-530,532,1011,479,4990.0,0.0,-4990.0,0.0,1100000.0,1100000.0
bishm102,Max Bishop,Philadelphia Athletics,ATLTCS,1,3,3,6,1933,1936,3,51.32,1.87,-49.45,848,361,-487,1283,1356,73,5977.0,119.0,-5858.0,31000.0,8500.0,-22500.0
bissd101,Del Bissonette,Brooklyn Dodgers,DOGRS,3,7,4,11,1933,1940,7,2.67,10.0,7.33,454,955,501,1715,3466,1751,0.0,317.0,317.0,0.0,0.0,0.0
bitkj001,Joe Bitker,Oakland Athletics,ATLTCS,2,3,3,6,1990,1997,7,11.13,4.36,-6.77,696,326,-370,2415,1227,-1188,327.0,177.0,-150.0,0.0,1143539.0,1143539.0
bittj001,Jeff Bittiger,New York Mets,METS,2,4,3,7,1986,1986,0,-0.05,0.0,0.05,49,0,-49,136,0,-136,44.0,0.0,-44.0,0.0,0.0,0.0
bittj001,Jeff Bittiger,Chicago White Sox,WSOX,1,1,1,2,1989,1990,1,0.0,0.0,0.0,0,0,0,0,0,0,0.0,0.0,0.0,0.0,0.0,0.0
bivij101,Jim Bivin,Philadelphia Phillies,PHILS,1,1,1,2,1935,1935,0,0.0,0.0,0.0,0,0,0,0,0,0,0.0,0.0,0.0,0.0,0.0,0.0
bixlb001,Brian Bixler,Pittsburgh Pirates,PIRATS,1,1,1,2,2010,2010,0,0.0,0.0,0.0,0,0,0,0,0,0,0.0,0.0,0.0,0.0,0.0,0.0
bjorg101,George Bjorkman,St. Louis Cardinals,CARDS,1,1,1,2,1983,1983,0,0.26,0.0,-0.26,29,0,-29,93,0,-93,0.0,0.0,0.0,0.0,0.0,0.0
bjorg101,George Bjorkman,Houston Astros,ASTROS,1,1,1,2,1984,1984,0,0.0,-0.34,-0.34,0,6,6,0,12,12,0.0,0.0,0.0,0.0,0.0,0.0
blacb001,Buddy Black,Seattle Mariners,MARNRS,1,1,1,2,1982,1984,2,12.93,-2.39,-15.32,217,229,12,0,757,757,2933.0,8.0,-2925.0,0.0,0.0,0.0
blacb001,Buddy Black,Kansas City Royals,ROYALS,3,4,4,8,1988,1998,10,11.52,1.16,-10.36,458,446,-12,1163,984,-179,1559.0,1998.0,439.0,1360000.0,1093000.0,-267000.0
blacb001,Buddy Black,Cleveland Indians,INDINS,18,24,30,54,1990,2020,30,34.13,110.71,76.58,3254,3355,101,9795,9199,-596,4030.0,9522.0,5492.0,45429400.0,15791500.0,-29637900.0
blacb101,Bud Black,St.Louis Browns,ORLS,8,14,16,30,1952,1960,8,32.49,23.42,-9.07,2082,1835,-247,5453,4904,-549,5614.0,2626.0,-2988.0,41000.0,25800.0,-15200.0
blacb103,Bill Black,Beaumont,Beaumont,1,1,4,5,1924,1924,0,-0.04,0.0,0.04,6,0,-6,5,0,-5,0.0,0.0,0.0,0.0,0.0,0.0
blacd102,Dave Black,Chicago Whales,CHF,1,1,1,2,1915,1916,1,0.0,0.66,0.66,0,10,10,0,11,11,0.0,100.0,100.0,0.0,0.0,0.0
blace101,Earl Blackburn,Boston Braves,BRAVES,1,2,2,4,1917,1919,2,0.0,-1.02,-1.02,2,181,179,2,722,720,0.0,0.0,0.0,0.0,0.0,0.0
blace102,Ewell Blackwell,Cincinnati Reds,REDS,6,11,19,30,1952,1965,13,65.09,23.38,-41.71,3612,2003,-1609,11350,4683,-6667,2670.0,1071.0,-1599.0,27000.0,15500.0,-11500.0
blace103,Ethan Blackaby,Atlanta Braves,BRAVES,1,1,1,2,1966,1968,2,0.0,0.0,0.0,0,0,0,0,0,0,0.0,0.0,0.0,0.0,0.0,0.0
blace103,Ethan Blackaby,California Angels,ANGELS,1,1,1,2,1968,1968,0,0.0,0.0,0.0,0,0,0,0,0,0,0.0,0.0,0.0,0.0,0.0,0.0
blacj103,Joe Black,Brooklyn Dodgers,DOGRS,1,1,2,3,1955,1955,0,0.74,-0.33,-1.07,130,9,-121,44,20,-24,492.0,0.0,-492.0,0.0,0.0,0.0
blacl101,Lena Blackburne,Providence,Providence,1,1,3,4,1909,1913,4,2.75,0.0,-2.75,323,0,-323,1203,0,-1203,1.0,0.0,-1.0,0.0,2400.0,2400.0
blacl101,Lena Blackburne,Chicago White Sox,WSOX,1,5,1,6,1912,1928,16,0.0,33.22,33.22,0,1757,1757,0,6239,6239,0.0,0.0,0.0,0.0,0.0,0.0
blacl101,Lena Blackburne,Cincinnati Reds,REDS,1,1,1,2,1919,1919,0,0.14,-0.11,-0.25,31,5,-26,92,14,-78,0.0,0.0,0.0,0.0,0.0,0.0
blacp001,Paul Blackburn,Chicago Cubs,CUBS,4,5,5,10,2016,2020,4,4.67,3.17,-1.5,619,278,-341,1969,187,-1782,208.0,960.0,752.0,2440000.0,3083600.0,643600.0
blacp001,Paul Blackburn,Seattle Mariners,MARNRS,1,1,1,2,2016,2017,1,-0.33,1.0,1.33,32,130,98,5,500,495,414.0,0.0,-414.0,0.0,3150000.0,3150000.0
blacr001,Ray Black,San Francisco Giants,GIANTS,1,2,1,3,2019,2019,0,0.99,0.61,-0.38,83,28,-55,2,109,107,130.0,0.0,-130.0,1500000.0,0.0,-1500000.0
blact001,Travis Blackley,Seattle Mariners,MARNRS,1,1,1,2,2007,2007,0,-0.38,-0.24,0.14,12,63,51,3,48,45,41.0,0.0,-41.0,0.0,0.0,0.0
blact001,Travis Blackley,Oakland Athletics,ATLTCS,2,3,2,5,2013,2014,1,-0.02,0.59,0.61,96,21,-75,115,56,-59,105.0,0.0,-105.0,0.0,988000.0,988000.0
blact001,Travis Blackley,Houston Astros,ASTROS,1,1,1,2,2013,2013,0,-0.03,0.0,0.03,4,0,-4,0,0,0,46.0,0.0,-46.0,0.0,0.0,0.0
blact101,Tim Blackwell,Philadelphia Phillies,PHILS,12,28,21,49,1977,1999,22,39.49,55.77,16.28,5043,4716,-327,14497,10321,-4176,7936.0,3859.0,-4077.0,2950000.0,1495000.0,-1455000.0
blacv001,Vic Black,Pittsburgh Pirates,PIRATS,1,2,3,5,2013,2013,0,0.44,0.95,0.51,159,39,-120,169,139,-30,143.0,0.0,-143.0,0.0,0.0,0.0
bladr101,Rick Bladt,Chicago Cubs,CUBS,1,3,1,4,1970,1970,0,0.08,-0.37,-0.45,52,28,-24,133,36,-97,0.0,0.0,0.0,0.0,0.0,0.0
bladr101,Rick Bladt,New York Yankees,YANKS,1,2,1,3,1977,1979,2,0.81,-0.33,-1.14,49,160,111,128,324,196,0.0,0.0,0.0,0.0,0.0,0.0
blaeg101,George Blaeholder,St.Louis Browns,ORLS,4,5,5,10,1935,1939,4,3.13,1.95,-1.18,153,471,318,166,1259,1093,1298.0,1025.0,-273.0,16000.0,9500.0,-6500.0
blaer101,Rae Blaemire,New York Giants,GIANTS,1,2,1,3,1941,1942,1,0.0,0.0,0.0,0,0,0,0,0,0,0.0,0.0,0.0,0.0,0.0,0.0
blaia001,Aaron Blair,Arizona Diamondbacks,DBACKS,2,5,3,8,2015,2018,3,16.27,-1.52,-17.79,1329,142,-1187,5122,368,-4754,281.0,417.0,136.0,513000.0,535000.0,22000.0
blaib102,Buddy Blair,New York Yankees,YANKS,3,4,5,9,1941,1950,9,8.96,-1.41,-10.37,588,90,-498,2279,41,-2238,0.0,394.0,394.0,0.0,7500.0,7500.0
blaid101,Dennis Blair,Montreal Expos,NATEX,1,1,1,2,1977,1979,2,0.0,0.07,0.07,0,40,40,0,10,10,0.0,153.0,153.0,0.0,0.0,0.0
blaid101,Dennis Blair,Baltimore Orioles,ORLS,1,1,1,2,1979,1979,0,-0.31,0.0,0.31,10,0,-10,5,0,-5,42.0,0.0,-42.0,0.0,0.0,0.0
blaip101,Paul Blair,Baltimore Orioles,ORLS,1,1,2,3,1977,1977,0,-0.37,0.81,1.18,172,49,-123,326,128,-198,0.0,0.0,0.0,0.0,0.0,0.0
blaiw001,Willie Blair,Toronto Blue Jays,BJAYS,1,1,1,2,1990,1990,0,-0.37,0.0,0.37,11,0,-11,0,0,0,108.0,0.0,-108.0,100000.0,0.0,-100000.0
blaiw001,Willie Blair,Cleveland Indians,INDINS,15,21,25,46,1991,2020,29,33.95,111.42,77.47,3251,3340,89,9795,9199,-596,3983.0,9391.0,5408.0,44654400.0,15589000.0,-29065400.0
blaiw001,Willie Blair,San Diego Padres,PADRS,2,3,3,6,1996,1997,1,2.37,0.0,-2.37,183,0,-183,158,0,-158,1473.0,0.0,-1473.0,920000.0,0.0,-920000.0
blaiw001,Willie Blair,Arizona Diamondbacks,DBACKS,6,17,15,32,1998,2008,10,43.09,23.72,-19.37,2989,1020,-1969,6928,1129,-5799,9149.0,3551.0,-5598.0,27973667.0,16759000.0,-11214667.0
blaiw001,Willie Blair,New York Mets,METS,2,2,2,4,1998,1998,0,13.23,0.0,-13.23,981,0,-981,3718,0,-3718,944.0,0.0,-944.0,0.0,375000.0,375000.0
blakc001,Casey Blake,Cleveland Indians,INDINS,2,3,3,6,2008,2017,9,9.15,24.02,14.87,406,1121,715,1608,4782,3174,0.0,13.0,13.0,6100000.0,0.0,-6100000.0
blake101,Ed Blake,St. Louis Cardinals,CARDS,1,1,1,2,1949,1949,0,0.01,0.0,-0.01,12,0,-12,0,0,0,21.0,0.0,-21.0,0.0,0.0,0.0
blaks101,Sheriff Blake,Pittsburgh Pirates,PIRATS,1,3,1,4,1922,1927,5,0.0,-0.21,-0.21,0,25,25,0,62,62,0.0,0.0,0.0,3600.0,0.0,-3600.0
blaks101,Sheriff Blake,Seattle,Seattle,1,2,2,4,1923,1925,2,12.05,0.0,-12.05,628,0,-628,625,0,-625,5104.0,0.0,-5104.0,0.0,3400.0,3400.0
blang001,Gregor Blanco,Atlanta Braves,BRAVES,1,3,2,5,2010,2010,0,2.01,-0.01,-2.02,319,93,-226,204,139,-65,734.0,60.0,-674.0,415000.0,7250000.0,6835000.0
blang101,Gil Blanco,New York Yankees,YANKS,3,5,4,9,1966,1973,7,1.66,4.77,3.11,451,607,156,554,678,124,1018.0,1714.0,696.0,17000.0,41500.0,24500.0
blanh001,Henry Blanco,Colorado Rockies,ROCKS,3,5,7,12,1999,2008,9,2.61,15.28,12.67,628,1324,696,1684,1373,-311,1546.0,2205.0,659.0,5440000.0,6737500.0,1297500.0
blanh001,Henry Blanco,Milwaukee Brewers,BREWRS,2,2,3,5,2002,2002,0,-1.12,-3.2,-2.08,255,184,-71,785,277,-508,0.0,310.0,310.0,750000.0,0.0,-750000.0
blanj001,Joe Blanton,Oakland Athletics,ATLTCS,6,10,10,20,2008,2014,6,5.46,7.89,2.43,637,601,-36,939,1576,637,2311.0,709.0,-1602.0,8180000.0,5801500.0,-2378500.0
blanj001,Joe Blanton,Philadelphia Phillies,PHILS,1,1,1,2,2012,2012,0,1.95,0.0,-1.95,166,0,-166,21,0,-21,413.0,0.0,-413.0,8500000.0,0.0,-8500000.0
blanj101,Johnny Blanchard,New York Yankees,YANKS,2,3,2,5,1965,1967,2,0.45,-0.46,-0.91,144,131,-13,217,298,81,767.0,0.0,-767.0,35500.0,12500.0,-23000.0
blank001,Kevin Blankenship,Atlanta Braves,BRAVES,1,2,1,3,1988,1990,2,-1.22,-1.32,-0.1,28,92,64,13,296,283,123.0,0.0,-123.0,65000.0,1108333.0,1043333.0
blank002,Kyle Blanks,San Diego Padres,PADRS,2,2,3,5,2014,2019,5,0.54,0.73,0.19,23,297,274,56,978,922,9.0,0.0,-9.0,988000.0,510000.0,-478000.0
blanl101,Larvell Blanks,Atlanta Braves,BRAVES,6,12,8,20,1975,1987,12,13.66,24.44,10.78,1298,1964,666,3286,2845,-441,3707.0,4072.0,365.0,999667.0,0.0,-999667.0
blanl101,Larvell Blanks,Chicago White Sox,WSOX,1,1,1,2,1975,1977,2,3.52,3.11,-0.41,279,178,-101,934,593,-341,0.0,0.0,0.0,0.0,0.0,0.0
blanl101,Larvell Blanks,Cleveland Indians,INDINS,12,19,27,46,1978,2004,26,61.95,109.09,47.14,2403,4779,2376,7210,16982,9772,7208.0,9771.0,2563.0,2352500.0,1522500.0,-830000.0
blanl101,Larvell Blanks,Texas Rangers,RNGRS,2,4,4,8,1979,1981,2,4.64,-2.56,-7.2,264,133,-131,467,246,-221,1400.0,101.0,-1299.0,150000.0,0.0,-150000.0
blanm001,Matt Blank,Montreal Expos,NATEX,2,4,5,9,2003,2011,8,4.63,14.95,10.32,424,496,72,130,594,464,1491.0,3711.0,2220.0,8000000.0,0.0,-8000000.0
blanm001,Matt Blank,Florida Marlins,MARLNS,1,1,1,2,2006,2006,0,0.0,0.0,0.0,0,0,0,0,0,0,0.0,0.0,0.0,0.0,0.0,0.0
blano101,Ossie Blanco,Chicago White Sox,WSOX,4,5,7,12,1970,1975,5,0.12,0.95,0.83,86,167,81,189,439,250,0.0,6.0,6.0,9500.0,0.0,-9500.0
blant001,Tony Blanco,Boston Red Sox,RSOX,1,2,1,3,2002,2003,1,0.0,1.1,1.1,0,144,144,0,647,647,0.0,0.0,0.0,0.0,2050000.0,2050000.0
blasd101,Don Blasingame,St. Louis Cardinals,CARDS,5,11,9,20,1959,1965,6,3.97,11.52,7.55,923,741,-182,2729,1825,-904,727.0,697.0,-30.0,0.0,12000.0,12000.0
blasd101,Don Blasingame,San Francisco Giants,GIANTS,9,17,13,30,1961,1972,11,22.69,19.49,-3.2,2066,1611,-455,6411,2790,-3621,1334.0,4789.0,3455.0,50000.0,89000.0,39000.0
blasd101,Don Blasingame,Cincinnati Reds,REDS,2,3,2,5,1963,1966,3,2.04,-0.66,-2.7,511,40,-471,1520,5,-1515,336.0,101.0,-235.0,0.0,0.0,0.0
blasj001,Jabari Blash,Oakland Athletics,ATLTCS,4,8,5,13,2015,2018,3,5.93,2.94,-2.99,610,354,-256,992,1020,28,691.0,108.0,-583.0,4517500.0,2983333.0,-1534167.0
blasj001,Jabari Blash,San Diego Padres,PADRS,1,1,3,4,2017,2019,2,0.0,-0.98,-0.98,0,57,57,0,79,79,0.0,219.0,219.0,0.0,13550625.0,13550625.0
blasj001,Jabari Blash,New York Yankees,YANKS,1,1,1,2,2018,2018,0,-0.82,0.0,0.82,24,0,-24,45,0,-45,0.0,0.0,0.0,0.0,0.0,0.0
blasw101,Wade Blasingame,Atlanta Braves,BRAVES,1,2,2,4,1967,1969,2,-3.37,0.31,3.68,234,194,-40,135,17,-118,1228.0,428.0,-800.0,0.0,0.0,0.0
blatj101,Johnny Blatnik,Philadelphia Phillies,PHILS,1,1,1,2,1950,1952,2,-0.3,0.46,0.76,7,91,84,23,57,34,0.0,500.0,500.0,0.0,0.0,0.0
blats101,Steve Blateric,Cincinnati Reds,REDS,1,1,1,2,1973,1975,2,0.0,0.09,0.09,0,6,6,0,7,7,0.0,0.0,0.0,0.0,0.0,0.0
blats101,Steve Blateric,Chicago White Sox,WSOX,1,2,1,3,1974,1976,2,-0.34,0.75,1.09,2,206,204,0,720,720,13.0,0.0,-13.0,0.0,0.0,0.0
blats101,Steve Blateric,Cleveland Indians,INDINS,1,1,1,2,1974,1975,1,0.0,-0.13,-0.13,0,6,6,0,18,18,0.0,0.0,0.0,0.0,0.0,0.0
blaym101,Marv Blaylock,New York Giants,GIANTS,1,1,1,2,1953,1953,0,0.0,0.0,0.0,0,0,0,0,0,0,0.0,0.0,0.0,0.0,0.0,0.0
blazm001,Michael Blazek,St. Louis Cardinals,CARDS,1,1,1,2,2013,2013,0,-0.23,0.31,0.54,192,26,-166,6,0,-6,338.0,31.0,-307.0,0.0,5000000.0,5000000.0
blefc101,Curt Blefary,Baltimore Orioles,ORLS,11,31,27,58,1968,1999,31,24.66,144.75,120.09,2993,6557,3564,6819,13225,6406,10078.0,28899.0,18821.0,759833.0,72500.0,-687333.0
blefc101,Curt Blefary,Houston Astros,ASTROS,1,1,1,2,1969,1970,1,-1.67,0.08,1.75,120,75,-45,357,299,-58,0.0,0.0,0.0,0.0,35000.0,35000.0
blefc101,Curt Blefary,Oakland Athletics,ATLTCS,1,3,1,4,1972,1972,0,-0.03,-0.15,-0.12,84,20,-64,122,60,-62,13.0,0.0,-13.0,20500.0,36000.0,15500.0
blefc101,Curt Blefary,New York Yankees,YANKS,2,3,3,6,1971,1973,2,-0.83,1.22,2.05,208,167,-41,436,571,135,22.0,300.0,278.0,35500.0,112750.0,77250.0
bleir001,Richard Bleier,New York Yankees,YANKS,1,1,1,2,2017,2017,0,3.56,0.0,-3.56,154,0,-154,0,0,0,463.0,0.0,-463.0,0.0,0.0,0.0
bleir001,Richard Bleier,Baltimore Orioles,ORLS,1,1,1,2,2020,2020,0,1.4,0.0,-1.4,151,0,-151,1,0,-1,215.0,0.0,-215.0,915000.0,0.0,-915000.0
blevj001,Jerry Blevins,Chicago Cubs,CUBS,1,2,2,4,2007,2007,0,3.55,-0.3,-3.85,355,57,-298,153,202,49,801.0,0.0,-801.0,0.0,12858194.0,12858194.0
blevj001,Jerry Blevins,Oakland Athletics,ATLTCS,3,3,3,6,2013,2017,4,-1.42,1.88,3.3,174,255,81,82,976,894,172.0,0.0,-172.0,1100000.0,0.0,-1100000.0
blevj001,Jerry Blevins,Washington Nationals,NATEX,1,1,1,2,2015,2016,1,2.89,0.77,-2.12,425,74,-351,3,149,146,416.0,0.0,-416.0,0.0,0.0,0.0
blocb101,Bruno Block,Chicago White Sox,WSOX,1,5,1,6,1912,1928,16,0.0,33.22,33.22,0,1757,1757,0,6239,6239,0.0,0.0,0.0,0.0,0.0,0.0
bloct001,Terry Blocker,New York Mets,METS,2,3,3,6,1987,1993,6,1.96,2.3,0.34,177,236,59,242,659,417,562.0,6.0,-556.0,200000.0,150000.0,-50000.0
blooj101,Jimmy Bloodworth,Washington Senators,TWINS,3,5,4,9,1941,1946,5,3.39,-0.33,-3.72,1062,197,-865,4332,521,-3811,0.0,315.0,315.0,17000.0,10000.0,-7000.0
blooj101,Jimmy Bloodworth,Pittsburgh Pirates,PIRATS,1,2,1,3,1947,1955,8,0.0,-1.57,-1.57,0,200,200,0,569,569,0.0,0.0,0.0,0.0,0.0,0.0
blooj101,Jimmy Bloodworth,Brooklyn Dodgers,DOGRS,2,2,4,6,1948,1949,1,0.02,0.0,-0.02,247,0,-247,889,0,-889,0.0,0.0,0.0,0.0,0.0,0.0
blowm001,Mike Blowers,Montreal Expos,NATEX,1,1,1,2,1989,1990,1,-1.24,-0.03,1.21,76,24,-52,238,0,-238,0.0,49.0,49.0,0.0,800000.0,800000.0
blowm001,Mike Blowers,New York Yankees,YANKS,1,1,2,3,1991,1991,0,5.94,0.0,-5.94,464,0,-464,1534,0,-1534,0.0,0.0,0.0,130000.0,0.0,-130000.0
blowm001,Mike Blowers,Seattle Mariners,MARNRS,3,4,5,9,1995,1997,2,0.63,-0.72,-1.35,191,11,-180,402,0,-402,434.0,126.0,-308.0,829445.0,218000.0,-611445.0
blueb101,Bert Blue,St.Louis Browns,ORLS,1,1,1,2,1908,1910,2,-0.23,-0.11,0.12,6,27,21,19,83,64,0.0,0.0,0.0,0.0,0.0,0.0
bluel101,Lu Blue,Detroit Tigers,TIGRS,2,5,6,11,1927,1932,5,22.97,3.43,-19.54,913,569,-344,3930,2101,-1829,97.0,731.0,634.0,36000.0,31000.0,-5000.0
blueo101,Otto Bluege,Philadelphia Phillies,PHILS,1,3,1,4,1934,1934,0,0.0,-0.13,-0.13,0,10,10,0,32,32,0.0,0.0,0.0,0.0,0.0,0.0
blueo101,Otto Bluege,Cincinnati Reds,REDS,4,6,6,12,1933,1942,9,0.93,12.9,11.97,309,1107,798,770,4269,3499,264.0,0.0,-264.0,23000.0,0.0,-23000.0
bluev001,Vida Blue,Oakland Athletics,ATLTCS,6,8,17,25,1978,1987,9,13.35,12.26,-1.09,965,1823,858,1922,5674,3752,4815.0,2393.0,-2422.0,425000.0,1030000.0,605000.0
bluev001,Vida Blue,San Francisco Giants,GIANTS,3,6,7,13,1982,1992,10,0.93,10.52,9.59,146,1038,892,148,1280,1132,952.0,5228.0,4276.0,0.0,0.0,0.0
blumg001,Geoff Blum,Montreal Expos,NATEX,3,3,3,6,2002,2003,1,0.51,-0.97,-1.48,879,236,-643,2557,652,-1905,0.0,0.0,0.0,1095000.0,375000.0,-720000.0
blumg001,Geoff Blum,Houston Astros,ASTROS,1,1,1,2,2003,2009,6,-0.65,2.75,3.4,112,216,104,369,158,-211,0.0,1403.0,1403.0,1500000.0,0.0,-1500000.0
blumg001,Geoff Blum,San Diego Padres,PADRS,1,1,1,2,2005,2005,0,-0.7,0.0,0.7,31,0,-31,99,0,-99,0.0,0.0,0.0,575000.0,0.0,-575000.0
blylb001,Bert Blyleven,Minnesota Twins,TWINS,4,6,12,18,1976,1992,16,15.53,44.0,28.47,533,2941,2408,1530,9053,7523,1468.0,2182.0,714.0,1325000.0,873333.0,-451667.0
blylb001,Bert Blyleven,Texas Rangers,RNGRS,4,9,7,16,1977,1988,11,14.96,29.07,14.11,537,2027,1490,1603,7192,5589,2093.0,2974.0,881.0,330000.0,165000.0,-165000.0
blylb001,Bert Blyleven,Pittsburgh Pirates,PIRATS,4,6,9,15,1980,1984,4,24.19,-0.04,-24.23,615,106,-509,1402,76,-1326,2781.0,299.0,-2482.0,300000.0,0.0,-300000.0
blylb001,Bert Blyleven,Cleveland Indians,INDINS,4,6,8,14,1985,2004,19,34.25,32.91,-1.34,1463,2416,953,5598,9198,3600,2580.0,1494.0,-1086.0,1767500.0,1112500.0,-655000.0
blylb001,Bert Blyleven,Minnesota Twins,TWINS,3,5,6,11,1988,1995,7,10.18,-1.81,-11.99,698,140,-558,1780,213,-1567,1711.0,302.0,-1409.0,1000000.0,0.0,-1000000.0
blyzm101,Mike Blyzka,Baltimore Orioles,ORLS,15,37,36,73,1954,1988,34,52.13,133.41,81.28,3638,7388,3750,6759,20843,14084,14284.0,13293.0,-991.0,815833.0,128400.0,-687433.0
boakc101,Chet Boak,Washington Senators,RNGRS,2,2,2,4,1961,1964,3,0.0,1.36,1.36,0,237,237,0,754,754,0.0,0.0,0.0,13000.0,7000.0,-6000.0
bobbr101,Randy Bobb,Chicago Cubs,CUBS,1,1,1,2,1970,1973,3,0.0,-0.66,-0.66,0,112,112,0,299,299,0.0,0.0,0.0,0.0,0.0,0.0
bocah001,Hiram Bocachica,Montreal Expos,NATEX,3,8,7,15,1998,2004,6,7.97,-4.29,-12.26,909,664,-245,2909,2173,-736,1579.0,285.0,-1294.0,2150000.0,265000.0,-1885000.0
bocah001,Hiram Bocachica,Los Angeles Dodgers,DOGRS,2,2,3,5,2002,2006,4,5.88,4.3,-1.58,579,191,-388,131,721,590,1514.0,0.0,-1514.0,225000.0,0.0,-225000.0
boccj101,John Boccabella,Montreal Expos,NATEX,1,1,1,2,1974,1977,3,-0.89,2.04,2.93,29,151,122,85,91,6,0.0,904.0,904.0,0.0,0.0,0.0
bochb001,Bruce Bochte,California Angels,ANGELS,1,3,2,5,1977,1982,5,9.5,4.45,-5.05,371,221,-150,444,0,-444,1221.0,1215.0,-6.0,0.0,85000.0,85000.0
bochb002,Bruce Bochy,Houston Astros,ASTROS,1,1,2,3,1981,1981,0,0.72,0.0,-0.72,17,0,-17,53,0,-53,0.0,0.0,0.0,0.0,0.0,0.0
bochd001,Doug Bochtler,Colorado Rockies,ROCKS,1,3,2,5,1993,1994,1,28.53,-1.48,-30.01,973,90,-883,1500,70,-1430,4150.0,636.0,-3514.0,150000.0,5025000.0,4875000.0
bochd001,Doug Bochtler,San Diego Padres,PADRS,3,4,4,8,1997,2000,3,-0.13,-0.75,-0.62,150,123,-27,122,262,140,149.0,49.0,-100.0,693000.0,687500.0,-5500.0
bocke101,Eddie Bockman,New York Yankees,YANKS,1,1,2,3,1946,1946,0,0.17,0.0,-0.17,46,0,-46,71,0,-71,0.0,0.0,0.0,3600.0,0.0,-3600.0
bocob001,Brian Bocock,Washington Nationals,NATEX,1,1,1,2,2013,2013,0,0.0,0.0,0.0,0,0,0,0,0,0,0.0,0.0,0.0,0.0,0.0,0.0
boddm001,Mike Boddicker,Baltimore Orioles,ORLS,2,4,3,7,1988,2001,13,35.55,35.9,0.35,987,1988,1001,2612,8228,5616,4021.0,208.0,-3813.0,850000.0,62500.0,-787500.0
bodip101,Ping Bodie,SanFrancisco,SanFrancisco,1,1,2,3,1916,1921,5,3.85,0.0,-3.85,148,0,-148,635,0,-635,0.0,0.0,0.0,0.0,0.0,0.0
bodip101,Ping Bodie,Philadelphia Athletics,ATLTCS,1,1,1,2,1918,1920,2,3.65,8.03,4.38,385,278,-107,1524,1125,-399,0.0,0.0,0.0,0.0,0.0,0.0
boehb001,Brian Boehringer,Chicago White Sox,WSOX,1,1,1,2,1994,1994,0,1.65,0.85,-0.8,81,44,-37,0,0,0,440.0,99.0,-341.0,0.0,0.0,0.0
boehb001,Brian Boehringer,Tampa Bay Devil Rays,RAYS,1,2,1,3,1997,2002,5,1.57,0.35,-1.22,275,471,196,252,1802,1550,559.0,0.0,-559.0,0.0,900000.0,900000.0
boehb001,Brian Boehringer,New York Yankees,YANKS,1,1,2,3,2001,2002,1,-0.14,-0.01,0.13,54,3,-51,3,6,3,103.0,0.0,-103.0,350000.0,310000.0,-40000.0
boehj101,Joe Boehling,Washington Senators,TWINS,1,2,2,4,1916,1917,1,-0.1,0.72,0.82,82,122,40,78,517,439,360.0,0.0,-360.0,5000.0,0.0,-5000.0
boehl101,Len Boehmer,Cincinnati Reds,REDS,1,1,1,2,1967,1967,0,-0.89,0.0,0.89,48,0,-48,121,0,-121,0.0,0.0,0.0,0.0,0.0,0.0
boevj001,Joe Boever,St. Louis Cardinals,CARDS,1,1,1,2,1987,1988,1,0.52,-0.05,-0.57,258,22,-236,3,21,18,490.0,174.0,-316.0,0.0,0.0,0.0
boevj001,Joe Boever,Atlanta Braves,BRAVES,1,1,1,2,1990,1993,3,1.77,1.35,-0.42,204,244,40,4,13,9,433.0,455.0,22.0,215000.0,0.0,-215000.0
bogat001,Tim Bogar,New York Mets,METS,14,27,29,56,1997,2021,24,25.01,23.23,-1.78,1544,2155,611,3255,5420,2165,6012.0,3574.0,-2438.0,30731467.0,5425000.0,-25306467.0
boggt001,Tommy Boggs,Texas Rangers,RNGRS,4,9,7,16,1977,1988,11,9.87,29.07,19.2,738,2027,1289,1844,7192,5348,1774.0,2974.0,1200.0,330000.0,0.0,-330000.0
bogub001,Brian Bogusevic,Chicago Cubs,CUBS,2,2,2,4,2013,2014,1,-0.53,-0.37,0.16,36,81,45,81,250,169,0.0,0.0,0.0,2000000.0,494500.0,-1505500.0
bohab001,Brian Bohanon,New York Mets,METS,2,3,3,6,1998,1999,1,6.73,-0.73,-7.46,202,177,-25,35,1,-34,834.0,257.0,-577.0,2300000.0,2500000.0,200000.0
bohns101,Sam Bohne,Seattle,Seattle,1,1,3,4,1920,1921,1,8.24,0.0,-8.24,602,0,-602,2409,0,-2409,0.0,0.0,0.0,0.0,6600.0,6600.0
bohns101,Sam Bohne,St. Louis Cardinals,CARDS,1,5,1,6,1917,1917,0,0.0,0.36,0.36,0,28,28,0,29,29,0.0,256.0,256.0,9800.0,0.0,-9800.0
boitd101,Dan Boitano,Philadelphia Phillies,PHILS,1,1,1,2,1979,1979,0,-0.61,0.0,0.61,16,0,-16,0,0,0,71.0,0.0,-71.0,0.0,0.0,0.0
boitd101,Dan Boitano,New York Mets,METS,2,5,2,7,1981,1986,5,-0.02,4.68,4.7,485,655,170,913,2610,1697,596.0,0.0,-596.0,170000.0,163000.0,-7000.0
bokeb101,Bob Boken,Washington Senators,TWINS,2,4,2,6,1934,1940,6,-2.0,1.2,3.2,81,376,295,319,1332,1013,0.0,17.0,17.0,4000.0,6000.0,2000.0
bokeb101,Bob Boken,Nashville,Nashville,1,3,1,4,1940,1954,14,0.0,0.0,0.0,0,0,0,0,0,0,0.0,0.0,0.0,0.0,0.0,0.0
bolar001,Ronald Bolanos,San Diego Padres,PADRS,1,2,1,3,2020,2020,0,-0.21,-0.04,0.17,21,24,3,42,1,-41,30.0,54.0,24.0,0.0,0.0,0.0
bolgj101,Jim Bolger,Cincinnati Reds,REDS,2,2,3,5,1951,1961,10,0.0,4.19,4.19,0,329,329,0,124,124,0.0,1141.0,1141.0,16000.0,14000.0,-2000.0
bolgj101,Jim Bolger,Cincinnati Reds,REDS,2,7,3,10,1954,1960,6,0.48,13.19,12.71,599,458,-141,824,407,-417,733.0,2898.0,2165.0,18000.0,30000.0,12000.0
bolgj101,Jim Bolger,Chicago Cubs,CUBS,2,4,3,7,1959,1961,2,-0.03,1.89,1.92,58,282,224,20,801,781,147.0,7.0,-140.0,0.0,0.0,0.0
bolgj101,Jim Bolger,Cleveland Indians,INDINS,1,2,1,3,1959,1959,0,-0.93,0.28,1.21,35,11,-24,52,19,-33,0.0,0.0,0.0,0.0,0.0,0.0
bolgj101,Jim Bolger,Milwaukee Braves,BRAVES,1,3,1,4,1962,1963,1,3.88,-0.09,-3.97,176,64,-112,179,177,-2,1524.0,0.0,-1524.0,0.0,0.0,0.0
bolib101,Bobby Bolin,San Francisco Giants,GIANTS,1,1,2,3,1969,1969,0,-0.08,0.0,0.08,64,0,-64,45,0,-45,396.0,0.0,-396.0,33000.0,15000.0,-18000.0
bolib101,Bobby Bolin,Milwaukee Brewers,BREWRS,1,1,1,2,1970,1970,0,2.98,0.0,-2.98,197,0,-197,15,0,-15,485.0,0.0,-485.0,33000.0,0.0,-33000.0
bolif001,Frank Bolick,Milwaukee Brewers,BREWRS,1,1,1,2,1990,1990,0,0.0,0.0,0.0,0,0,0,0,0,0,0.0,0.0,0.0,0.0,0.0,0.0
bolif001,Frank Bolick,Seattle Mariners,MARNRS,2,3,3,6,1992,1994,2,-1.19,-0.25,0.94,99,17,-82,244,0,-244,20.0,66.0,46.0,0.0,125000.0,125000.0
bolld101,Don Bollweg,St. Louis Cardinals,CARDS,1,2,1,3,1951,1953,2,1.29,4.57,3.28,70,229,159,178,828,650,0.0,0.0,0.0,0.0,18250.0,18250.0
bolld101,Don Bollweg,New York Yankees,YANKS,16,45,38,83,1953,1970,17,48.62,78.17,29.55,7017,4726,-2291,22732,11340,-11392,3607.0,11554.0,7947.0,313000.0,125500.0,-187500.0
bollf101,Frank Bolling,Detroit Tigers,TIGRS,5,8,11,19,1960,1970,10,40.14,34.88,-5.26,2089,1971,-118,6205,4897,-1308,4562.0,4033.0,-529.0,39000.0,0.0,-39000.0
bollj101,Jack Bolling,Atlanta,Atlanta,1,1,2,3,1939,1939,0,0.32,0.0,-0.32,69,0,-69,222,0,-222,0.0,0.0,0.0,0.0,3000.0,3000.0
bollm101,Milt Bolling,Boston Red Sox,RSOX,3,5,4,9,1957,1961,4,-1.86,-2.15,-0.29,679,212,-467,1371,205,-1166,1950.0,366.0,-1584.0,0.0,36500.0,36500.0
bollm101,Milt Bolling,Washington Senators,TWINS,1,1,1,2,1958,1958,0,0.0,0.0,0.0,0,0,0,0,0,0,0.0,0.0,0.0,0.0,0.0,0.0
bollm101,Milt Bolling,Cleveland Indians,INDINS,1,2,2,4,1958,1958,0,0.0,0.0,0.0,54,0,-54,37,0,-37,56.0,0.0,-56.0,0.0,0.0,0.0
bolsm001,Mike Bolsinger,Los Angeles Dodgers,DOGRS,1,1,1,2,2016,2016,0,-0.42,-0.09,0.33,11,45,34,0,0,0,124.0,77.0,-47.0,0.0,0.0,0.0
boltt001,Tom Bolton,Boston Red Sox,RSOX,3,4,4,8,1992,1995,3,-0.51,-2.13,-1.62,177,341,164,231,1333,1102,767.0,0.0,-767.0,1410000.0,2260000.0,850000.0
bombm101,Mark Bomback,Milwaukee Brewers,BREWRS,1,1,1,2,1979,1983,4,1.87,-0.28,-2.15,72,53,-19,53,0,-53,488.0,252.0,-236.0,0.0,0.0,0.0
bombm101,Mark Bomback,New York Mets,METS,2,4,3,7,1981,1984,3,-0.81,3.22,4.03,218,148,-70,297,135,-162,947.0,1246.0,299.0,0.0,375000.0,375000.0
bondb101,Bobby Bonds,San Francisco Giants,GIANTS,14,29,30,59,1974,1998,24,56.61,75.08,18.47,3751,5439,1688,9431,9063,-368,5201.0,15628.0,10427.0,10587778.0,7076667.0,-3511111.0
bondb101,Bobby Bonds,New York Yankees,YANKS,17,37,36,73,1975,1995,20,36.62,75.73,39.11,3279,4461,1182,8244,12623,4379,6440.0,7138.0,698.0,3694706.0,5935000.0,2240294.0
bondb101,Bobby Bonds,California Angels,ANGELS,1,3,3,6,1977,1990,13,18.22,44.27,26.05,460,1735,1275,586,6912,6326,4818.0,1336.0,-3482.0,175000.0,50000.0,-125000.0
bondb101,Bobby Bonds,Chicago White Sox,WSOX,3,3,4,7,1978,1983,5,4.1,2.64,-1.46,209,355,146,861,1192,331,0.0,0.0,0.0,0.0,0.0,0.0
bondb101,Bobby Bonds,Texas Rangers,RNGRS,4,7,8,15,1978,1982,4,19.36,1.68,-17.68,554,422,-132,1098,667,-431,4197.0,810.0,-3387.0,313000.0,280000.0,-33000.0
bondb101,Bobby Bonds,Cleveland Indians,INDINS,9,15,19,34,1979,2004,25,56.5,61.5,5.0,2052,2755,703,6792,9198,2406,5800.0,6896.0,1096.0,1767500.0,1412500.0,-355000.0
bondj001,Jeremy Bonderman,Oakland Athletics,ATLTCS,6,8,9,17,2002,2009,7,16.13,13.6,-2.53,956,906,-50,1909,3247,1338,5469.0,605.0,-4864.0,947000.0,0.0,-947000.0
bondw101,Walt Bond,Houston Astros,ASTROS,5,6,7,13,1966,1978,12,3.03,1.17,-1.86,387,1322,935,908,4912,4004,159.0,122.0,-37.0,0.0,29000.0,29000.0
boner001,Ricky Bones,San Diego Padres,PADRS,3,6,6,12,1992,2008,16,33.52,31.92,-1.6,1981,2091,110,6462,948,-5514,2787.0,3132.0,345.0,3375000.0,109000.0,-3266000.0
boner001,Ricky Bones,Milwaukee Brewers,BREWRS,11,23,25,48,1996,2012,16,48.89,48.53,-0.36,3405,3905,500,10041,7823,-2218,2917.0,8947.0,6030.0,18537000.0,21422667.0,2885667.0
bongj001,Jung Bong,Atlanta Braves,BRAVES,1,2,1,3,2004,2006,2,-0.35,-0.6,-0.25,5,368,363,4,1,-3,46.0,543.0,497.0,0.0,0.0,0.0
bongn101,Nino Bongiovanni,Cincinnati Reds,REDS,3,5,3,8,1940,1940,0,13.89,1.36,-12.53,908,95,-813,3350,355,-2995,0.0,0.0,0.0,0.0,0.0,0.0
bonhb101,Bill Bonham,Chicago Cubs,CUBS,7,12,11,23,1977,1990,13,21.39,14.29,-7.1,2195,1033,-1162,4948,645,-4303,3120.0,4061.0,941.0,890000.0,170000.0,-720000.0
bonht101,Tiny Bonham,New York Yankees,YANKS,1,1,1,2,1946,1946,0,4.66,0.0,-4.66,146,0,-146,135,0,-135,1123.0,0.0,-1123.0,17000.0,0.0,-17000.0
bonib001,Bobby Bonilla,Chicago White Sox,WSOX,5,6,9,15,1986,1995,9,27.7,25.49,-2.21,1329,1162,-167,3860,3946,86,3561.0,1711.0,-1850.0,1962500.0,2603000.0,640500.0
bonib001,Bobby Bonilla,New York Mets,METS,3,4,4,8,1995,1998,3,1.06,2.23,1.17,526,299,-227,1782,890,-892,0.0,0.0,0.0,5452000.0,260000.0,-5192000.0
bonib001,Bobby Bonilla,Florida Marlins,MARLNS,15,33,38,71,1998,2019,21,116.45,94.42,-22.03,4698,5470,772,15425,16217,792,10496.0,10160.0,-336.0,68580667.0,35694968.0,-32885699.0
bonib001,Bobby Bonilla,Los Angeles Dodgers,DOGRS,2,3,4,7,1998,1999,1,-1.38,-0.94,0.44,141,28,-113,150,4,-146,1195.0,62.0,-1133.0,6833334.0,4583333.0,-2250001.0
bonie001,Emilio Bonifacio,Arizona Diamondbacks,DBACKS,2,2,2,4,2008,2012,4,2.04,-0.52,-2.56,122,181,59,178,7,-171,220.0,311.0,91.0,2525000.0,1200000.0,-1325000.0
bonie001,Emilio Bonifacio,Washington Nationals,NATEX,3,5,5,10,2008,2013,5,5.63,4.16,-1.47,562,556,-6,2188,1050,-1138,12.0,770.0,758.0,5101000.0,810000.0,-4291000.0
bonie001,Emilio Bonifacio,Miami Marlins,MARLNS,12,33,32,65,2012,2020,8,57.99,24.95,-33.04,3997,2605,-1392,9990,7444,-2546,7539.0,4278.0,-3261.0,66200000.0,34658100.0,-31541900.0
bonie001,Emilio Bonifacio,Chicago Cubs,CUBS,2,5,6,11,2014,2021,7,0.58,0.03,-0.55,319,313,-6,628,721,93,572.0,456.0,-116.0,26275000.0,5250000.0,-21025000.0
bonij001,Juan Bonilla,Cleveland Indians,INDINS,1,1,1,2,1981,1981,0,2.85,-0.56,-3.41,296,14,-282,1221,0,-1221,0.0,64.0,64.0,0.0,0.0,0.0
bonil001,Lisalverto Bonilla,Philadelphia Phillies,PHILS,3,6,4,10,2012,2014,2,0.71,-1.18,-1.89,80,130,50,137,512,375,193.0,7.0,-186.0,496000.0,16000000.0,15504000.0
bonnb001,Barry Bonnell,Philadelphia Phillies,PHILS,9,22,16,38,1975,1999,24,25.13,40.88,15.75,3277,4153,876,11430,11792,362,522.0,1259.0,737.0,2950000.0,165000.0,-2785000.0
bonnb001,Barry Bonnell,Atlanta Braves,BRAVES,1,3,2,5,1979,1986,7,6.25,5.96,-0.29,653,1043,390,1647,3360,1713,1023.0,3.0,-1020.0,0.0,0.0,0.0
bonnb001,Barry Bonnell,Toronto Blue Jays,BJAYS,1,1,1,2,1983,1985,2,-1.19,-0.79,0.4,175,20,-155,565,0,-565,0.0,137.0,137.0,0.0,0.0,0.0
bonnf101,Frank Bonner,Baltimore Orioles,BLN,1,2,1,3,1895,1895,0,-4.82,1.63,6.45,136,40,-96,276,66,-210,924.0,426.0,-498.0,0.0,0.0,0.0
bonsb001,Boof Bonser,San Francisco Giants,GIANTS,1,3,2,5,2003,2004,1,27.51,0.25,-27.26,760,131,-629,32,510,478,4915.0,0.0,-4915.0,300000.0,365000.0,65000.0
bonsb001,Boof Bonser,Minnesota Twins,TWINS,1,1,1,2,2009,2009,0,-0.12,0.0,0.12,2,0,-2,0,0,0,6.0,0.0,-6.0,0.0,0.0,0.0
bonuz101,Zeke Bonura,Cleveland Indians,INDINS,2,6,4,10,1930,1939,9,6.18,20.8,14.62,372,942,570,1331,2752,1421,1093.0,2939.0,1846.0,2400.0,0.0,-2400.0
bonuz101,Zeke Bonura,Chicago White Sox,WSOX,1,1,1,2,1938,1943,5,1.97,10.99,9.02,216,832,616,941,3595,2654,0.0,0.0,0.0,0.0,0.0,0.0
bonuz101,Zeke Bonura,Washington Senators,TWINS,1,1,3,4,1938,1938,0,3.47,0.0,-3.47,123,0,-123,517,0,-517,0.0,0.0,0.0,0.0,0.0,0.0
booee101,Everett Booe,Pittsburgh Pirates,PIRATS,1,1,1,2,1913,1913,0,0.0,-0.54,-0.54,0,40,40,0,169,169,0.0,0.0,0.0,1200.0,0.0,-1200.0
bookb101,Buddy Booker,New York Mets,METS,2,5,4,9,1967,1974,7,2.47,11.88,9.41,357,948,591,832,3426,2594,1066.0,0.0,-1066.0,89000.0,31000.0,-58000.0
bookc001,Chris Booker,Chicago Cubs,CUBS,2,3,2,5,2001,2002,1,-0.07,1.18,1.25,254,63,-191,981,235,-746,6.0,0.0,-6.0,0.0,1800000.0,1800000.0
bookg001,Greg Booker,San Diego Padres,PADRS,2,3,3,6,1989,1990,1,-0.28,-0.81,-0.53,20,210,190,0,619,619,275.0,115.0,-160.0,775000.0,575000.0,-200000.0
boola101,Al Bool,Boston Braves,BRAVES,1,2,1,3,1931,1933,2,0.0,-0.39,-0.39,0,82,82,0,328,328,0.0,0.0,0.0,0.0,0.0,0.0
boola101,Al Bool,Baltimore,Baltimore,1,1,1,2,1929,1929,0,0.16,0.0,-0.16,78,0,-78,245,0,-245,0.0,0.0,0.0,0.0,0.0,0.0
boona001,Aaron Boone,Cincinnati Reds,REDS,2,3,4,7,2003,2006,3,1.41,-0.53,-1.94,54,193,139,209,110,-99,0.0,1046.0,1046.0,3700000.0,1925000.0,-1775000.0
boonb002,Bret Boone,Seattle Mariners,MARNRS,2,3,3,6,1993,2005,12,5.9,13.17,7.27,829,1554,725,2754,4500,1746,566.0,1101.0,535.0,1250000.0,221000.0,-1029000.0
boonb002,Bret Boone,Cincinnati Reds,REDS,8,13,16,29,1998,2013,15,32.31,35.48,3.17,2118,2354,236,5649,6223,574,1997.0,6510.0,4513.0,12325000.0,17590000.0,5265000.0
boonb002,Bret Boone,Atlanta Braves,BRAVES,1,3,3,6,1999,2001,2,15.79,3.54,-12.25,961,377,-584,3858,1296,-2562,4.0,0.0,-4.0,7650000.0,8651680.0,1001680.0
boond101,Danny Boone,San Diego Padres,PADRS,2,3,2,5,1982,1984,2,-0.38,0.87,1.25,37,102,65,24,188,164,38.0,0.0,-38.0,0.0,0.0,0.0
boond102,Dan Boone,Cleveland Indians,INDINS,1,4,3,7,1924,1928,4,0.12,9.37,9.25,387,855,468,1555,3344,1789,0.0,0.0,0.0,0.0,0.0,0.0
booni101,Ike Boone,Chicago White Sox,WSOX,5,17,8,25,1927,1936,9,4.13,-0.01,-4.14,711,811,100,2521,3083,562,0.0,39.0,39.0,40200.0,39000.0,-1200.0
booni101,Ike Boone,New York Giants,GIANTS,1,1,1,2,1922,1923,1,0.0,0.0,0.0,0,0,0,0,0,0,0.0,0.0,0.0,2700.0,0.0,-2700.0
booni101,Ike Boone,SanAntonio,SanAntonio,1,5,1,6,1923,1923,0,9.54,0.0,-9.54,1176,0,-1176,4721,0,-4721,0.0,0.0,0.0,0.0,0.0,0.0
boonr101,Ray Boone,Cleveland Indians,INDINS,4,8,7,15,1953,1960,7,29.6,3.08,-26.52,1527,466,-1061,3515,525,-2990,4632.0,1595.0,-3037.0,15900.0,10000.0,-5900.0
boonr101,Ray Boone,Detroit Tigers,TIGRS,2,3,3,6,1958,1959,1,16.44,-3.06,-19.5,1173,107,-1066,3797,151,-3646,1676.0,92.0,-1584.0,32000.0,0.0,-32000.0
boonr101,Ray Boone,Chicago White Sox,WSOX,2,3,2,5,1959,1960,1,0.78,0.48,-0.3,70,150,80,176,397,221,0.0,0.0,0.0,34500.0,12500.0,-22000.0
boonr101,Ray Boone,Milwaukee Braves,BRAVES,1,1,1,2,1960,1960,0,-0.49,0.0,0.49,34,0,-34,89,0,-89,0.0,0.0,0.0,22000.0,0.0,-22000.0
borbp001,Pedro Borbon,Los Angeles Dodgers,DOGRS,6,14,16,30,1999,2008,9,11.13,39.67,28.54,2076,1867,-209,6047,4980,-1067,1264.0,3315.0,2051.0,19163667.0,19160000.0,-3667.0
borbp101,Pedro Borbon,California Angels,ANGELS,3,6,7,13,1969,1974,5,8.36,4.59,-3.77,1680,510,-1170,1673,1948,275,4531.0,88.0,-4443.0,15000.0,105000.0,90000.0
borbp101,Pedro Borbon,Cincinnati Reds,REDS,3,3,3,6,1979,1983,4,-0.67,-1.7,-1.03,148,301,153,178,550,372,138.0,269.0,131.0,0.0,0.0,0.0
borcj001,Joe Borchard,Chicago White Sox,WSOX,5,8,7,15,2006,2020,14,3.49,26.89,23.4,365,985,620,1322,1934,612,399.0,1492.0,1093.0,3255000.0,11824334.0,8569334.0
bordf101,Frenchy Bordagaray,Sacramento,Sacramento,1,1,3,4,1934,1947,13,3.24,0.0,-3.24,625,0,-625,2073,0,-2073,0.0,0.0,0.0,0.0,0.0,0.0
bordf101,Frenchy Bordagaray,Brooklyn Dodgers,DOGRS,1,3,1,4,1936,1938,2,0.05,-0.59,-0.64,177,153,-24,491,535,44,0.0,3.0,3.0,0.0,0.0,0.0
bordf101,Frenchy Bordagaray,St. Louis Cardinals,CARDS,1,1,1,2,1938,1938,0,-1.01,0.0,1.01,63,0,-63,136,0,-136,0.0,0.0,0.0,0.0,0.0,0.0
bordf101,Frenchy Bordagaray,Cincinnati Reds,REDS,3,5,3,8,1940,1940,0,13.89,1.36,-12.53,908,95,-813,3350,355,-2995,0.0,0.0,0.0,0.0,0.0,0.0
bordm001,Mike Bordick,Baltimore Orioles,ORLS,1,1,4,5,2000,2009,9,0.16,28.33,28.17,56,1330,1274,211,5573,5362,0.0,33.0,33.0,3000000.0,210000.0,-2790000.0
bordp001,Pat Borders,Kansas City Royals,ROYALS,1,1,1,2,1995,1995,0,-0.5,-0.09,0.41,11,7,-4,37,0,-37,0.0,29.0,29.0,310000.0,0.0,-310000.0
bordp001,Pat Borders,St. Louis Cardinals,CARDS,1,1,1,2,1996,1996,0,-0.18,0.0,0.18,19,0,-19,61,0,-61,0.0,0.0,0.0,375000.0,0.0,-375000.0
bordp001,Pat Borders,California Angels,ANGELS,1,1,1,2,1996,1997,1,-0.03,0.23,0.26,31,3,-28,102,0,-102,0.0,15.0,15.0,0.0,0.0,0.0
bordp001,Pat Borders,Seattle Mariners,MARNRS,1,1,1,2,2004,2004,0,0.24,0.0,-0.24,19,0,-19,44,0,-44,0.0,0.0,0.0,0.0,0.0,0.0
bordr001,Rich Bordi,Oakland Athletics,ATLTCS,1,1,1,2,1981,1985,4,-0.37,-2.36,-1.99,7,223,216,0,635,635,39.0,0.0,-39.0,0.0,0.0,0.0
bordr001,Rich Bordi,Seattle Mariners,MARNRS,1,1,1,2,1982,1984,2,0.78,1.61,0.83,84,230,146,24,848,824,326.0,0.0,-326.0,0.0,0.0,0.0
bordr001,Rich Bordi,Chicago Cubs,CUBS,2,7,4,11,1984,1987,3,2.88,0.38,-2.5,447,379,-68,818,354,-464,766.0,789.0,23.0,873333.0,878000.0,4667.0
bordr001,Rich Bordi,New York Yankees,YANKS,1,2,2,4,1985,1986,1,0.34,-0.33,-0.67,66,76,10,1,188,187,321.0,0.0,-321.0,0.0,558333.0,558333.0
borip101,Paul Boris,New York Yankees,YANKS,10,16,17,33,1982,1997,15,48.99,20.71,-28.28,2747,1421,-1326,5735,2836,-2899,7707.0,4016.0,-3691.0,4250000.0,2812500.0,-1437500.0
borkb101,Bob Borkowski,Chicago Cubs,CUBS,1,2,2,4,1951,1955,4,6.65,0.0,-6.65,713,1,-712,2114,1,-2113,0.0,0.0,0.0,12500.0,13250.0,750.0
borkb101,Bob Borkowski,Cincinnati Reds,REDS,1,2,1,3,1955,1957,2,-0.33,0.74,1.07,9,130,121,20,44,24,0.0,492.0,492.0,0.0,0.0,0.0
borlt001,Toby Borland,Philadelphia Phillies,PHILS,1,2,1,3,1996,2000,4,-0.52,-2.87,-2.35,69,496,427,2,2022,2020,121.0,0.0,-121.0,284000.0,325000.0,41000.0
borlt001,Toby Borland,New York Mets,METS,1,1,1,2,1997,1997,0,-0.16,-0.32,-0.16,3,18,15,0,0,0,10.0,27.0,17.0,262500.0,184250.0,-78250.0
borlt101,Tom Borland,Boston Red Sox,RSOX,1,1,1,2,1962,1962,0,0.0,-0.33,-0.33,0,38,38,0,48,48,0.0,0.0,0.0,0.0,0.0,0.0
boroh101,Hank Borowy,Chicago Cubs,CUBS,2,3,3,6,1948,1953,5,8.13,13.76,5.63,675,587,-88,2640,227,-2413,597.0,2431.0,1834.0,16000.0,0.0,-16000.0
boroj001,Joe Borowski,Chicago White Sox,WSOX,1,1,1,2,1991,1991,0,0.34,0.0,-0.34,6,0,-6,0,0,0,22.0,0.0,-22.0,0.0,0.0,0.0
boroj001,Joe Borowski,Baltimore Orioles,ORLS,2,3,2,5,1995,1996,1,0.29,-0.9,-1.19,94,78,-16,3,263,260,185.0,174.0,-11.0,2934000.0,4250000.0,1316000.0
boros101,Steve Boros,Detroit Tigers,TIGRS,5,7,7,14,1962,1972,10,7.58,6.28,-1.3,677,1281,604,831,2724,1893,1071.0,2995.0,1924.0,103000.0,29000.0,-74000.0
bortb101,Babe Borton,Chicago White Sox,WSOX,1,2,1,3,1913,1914,1,-0.81,2.78,3.59,83,160,77,319,648,329,0.0,0.0,0.0,0.0,6000.0,6000.0
bortb101,Babe Borton,New York Yankees,YANKS,1,2,1,3,1913,1913,0,0.0,0.28,0.28,0,70,70,0,282,282,0.0,0.0,0.0,0.0,0.0,0.0
boscd101,Don Bosch,Pittsburgh Pirates,PIRATS,2,3,3,6,1966,1968,2,2.29,1.17,-1.12,328,107,-221,391,68,-323,1500.0,578.0,-922.0,46000.0,24500.0,-21500.0
boscd101,Don Bosch,Montreal Expos,NATEX,4,6,7,13,1970,1986,16,19.15,22.86,3.71,1432,1622,190,2872,2203,-669,1885.0,5701.0,3816.0,110000.0,114000.0,4000.0
boscw001,Wilfredo Boscan,Texas Rangers,RNGRS,1,1,1,2,2012,2014,2,0.0,0.18,0.18,0,10,10,0,0,0,0.0,34.0,34.0,0.0,0.0,0.0
boser101,Rick Bosetti,Philadelphia Phillies,PHILS,3,5,4,9,1977,1983,6,1.29,13.57,12.28,795,776,-19,1705,2597,892,551.0,251.0,-300.0,300000.0,80000.0,-220000.0
boser101,Rick Bosetti,St. Louis Cardinals,CARDS,1,1,2,3,1978,1980,2,1.94,1.48,-0.46,376,90,-286,1522,20,-1502,0.0,264.0,264.0,0.0,0.0,0.0
bosks001,Shawn Boskie,Chicago Cubs,CUBS,1,1,1,2,1994,1998,4,-0.16,3.26,3.42,37,185,148,30,193,163,253.0,1456.0,1203.0,300000.0,0.0,-300000.0
bosks001,Shawn Boskie,Philadelphia Phillies,PHILS,1,1,1,2,1994,1994,0,-0.08,0.0,0.08,2,0,-2,0,0,0,8.0,0.0,-8.0,0.0,0.0,0.0
boslt001,Thad Bosley,California Angels,ANGELS,1,3,3,6,1977,1990,13,18.22,44.27,26.05,460,1735,1275,586,6912,6326,4818.0,1336.0,-3482.0,175000.0,50000.0,-125000.0
boslt001,Thad Bosley,Chicago White Sox,WSOX,1,1,1,2,1981,1981,0,-0.41,0.0,0.41,42,0,-42,112,0,-112,0.0,0.0,0.0,0.0,0.0,0.0
boslt001,Thad Bosley,Milwaukee Brewers,BREWRS,1,1,1,2,1982,1982,0,-0.91,0.0,0.91,22,0,-22,50,0,-50,0.0,0.0,0.0,0.0,0.0,0.0
boslt001,Thad Bosley,Chicago Cubs,CUBS,1,2,1,3,1987,1988,1,-0.74,0.52,1.26,103,85,-18,176,227,51,58.0,0.0,-58.0,0.0,0.0,0.0
bosmd101,Dick Bosman,Texas Rangers,RNGRS,3,5,3,8,1973,1977,4,-2.28,-0.02,2.26,64,49,-15,44,0,-44,759.0,568.0,-191.0,0.0,21000.0,21000.0
bosmd101,Dick Bosman,Cleveland Indians,INDINS,3,5,4,9,1975,1976,1,-1.95,0.82,2.77,177,25,-152,203,0,-203,1075.0,430.0,-645.0,68000.0,35000.0,-33000.0
bossh101,Harley Boss,Washington Senators,TWINS,2,2,3,5,1932,1937,5,-0.12,4.34,4.46,158,394,236,477,215,-262,120.0,1888.0,1768.0,7000.0,5500.0,-1500.0
bosta001,Akeem Bostick,Texas Rangers,RNGRS,1,1,1,2,2015,2015,0,0.0,-0.51,-0.51,0,33,33,0,121,121,0.0,0.0,0.0,0.0,0.0,0.0
bostc001,Chris Bostick,Oakland Athletics,ATLTCS,1,2,2,4,2013,2015,2,-2.08,1.42,3.5,87,121,34,281,314,33,0.0,14.0,14.0,0.0,1001100.0,1001100.0
bostc001,Chris Bostick,Texas Rangers,RNGRS,1,2,1,3,2014,2015,1,0.0,-1.13,-1.13,4,18,14,0,0,0,5.0,129.0,124.0,0.0,3000000.0,3000000.0
bostc001,Chris Bostick,Washington Nationals,NATEX,1,1,1,2,2016,2020,4,0.02,0.0,-0.02,22,0,-22,34,0,-34,0.0,0.0,0.0,0.0,0.0,0.0
boswk101,Ken Boswell,New York Mets,METS,3,4,3,7,1974,1976,2,-0.02,-0.55,-0.53,249,97,-152,457,90,-367,0.0,0.0,0.0,0.0,0.0,0.0
boted001,Derek Botelho,Philadelphia Phillies,PHILS,7,17,13,30,1979,1999,20,25.6,38.01,12.41,2807,3562,755,9986,9588,-398,522.0,1259.0,737.0,2950000.0,165000.0,-2785000.0
boted001,Derek Botelho,Kansas City Royals,ROYALS,1,2,1,3,1984,1986,2,-0.02,-0.09,-0.07,22,5,-17,15,0,-15,132.0,39.0,-93.0,0.0,0.0,0.0
boted001,Derek Botelho,Cincinnati Reds,REDS,1,1,2,3,1987,1987,0,0.0,0.0,0.0,0,0,0,0,0,0,0.0,0.0,0.0,0.0,0.0,0.0
bottj101,Jim Bottomley,St. Louis Cardinals,CARDS,2,3,4,7,1932,1942,10,1.14,2.64,1.5,593,243,-350,1978,361,-1617,902.0,474.0,-428.0,0.0,0.0,0.0
bottj101,Jim Bottomley,Cincinnati Reds,REDS,1,1,1,2,1936,1936,0,-0.16,0.0,0.16,205,0,-205,722,0,-722,0.0,0.0,0.0,0.0,0.0,0.0
bottk001,Kent Bottenfield,Montreal Expos,NATEX,1,1,1,2,1993,1995,2,0.25,6.83,6.58,58,110,52,30,89,59,304.0,757.0,453.0,113500.0,152000.0,38500.0
bottk001,Kent Bottenfield,St. Louis Cardinals,CARDS,4,6,6,12,2000,2019,19,27.34,51.35,24.01,1988,2348,360,6641,8016,1375,960.0,194.0,-766.0,13224540.0,0.0,-13224540.0
bottk001,Kent Bottenfield,Anaheim Angels,ANGELS,1,1,1,2,2000,2000,0,0.56,0.73,0.17,16,34,18,17,103,86,132.0,0.0,-132.0,4000000.0,5066667.0,1066667.0
bottr001,Ricky Bottalico,Philadelphia Phillies,PHILS,3,4,5,9,1998,2002,4,4.86,4.39,-0.47,468,569,101,282,1029,747,2055.0,750.0,-1305.0,7696667.0,14670000.0,6973333.0
botzb101,Bob Botz,Milwaukee Braves,BRAVES,1,1,1,2,1962,1962,0,0.37,0.0,-0.37,70,0,-70,10,0,-10,189.0,0.0,-189.0,0.0,0.0,0.0
botzb101,Bob Botz,Los Angeles Angels,ANGELS,2,2,2,4,1963,1965,2,0.53,-0.04,-0.57,78,128,50,8,7,-1,193.0,241.0,48.0,0.0,0.0,0.0
boucd001,Denis Boucher,Toronto Blue Jays,BJAYS,1,4,2,6,1991,1993,2,4.36,3.25,-1.11,538,117,-421,1892,245,-1647,194.0,389.0,195.0,115000.0,2600000.0,2485000.0
boucd001,Denis Boucher,Colorado Rockies,ROCKS,1,1,1,2,1993,1993,0,0.0,-0.42,-0.42,0,23,23,0,45,45,0.0,0.0,0.0,0.0,0.0,0.0
boucd001,Denis Boucher,San Diego Padres,PADRS,1,1,2,3,1993,1993,0,0.67,0.0,-0.67,30,0,-30,12,0,-12,141.0,0.0,-141.0,0.0,0.0,0.0
bouce101,Ed Bouchee,Philadelphia Phillies,PHILS,2,3,4,7,1960,1971,11,11.26,16.56,5.3,652,1580,928,1728,6417,4689,1893.0,0.0,-1893.0,60000.0,0.0,-60000.0
boulc101,Carl Bouldin,Washington Senators,RNGRS,2,3,3,6,1964,1975,11,4.84,-0.04,-4.88,347,541,194,1279,559,-720,0.0,1708.0,1708.0,55000.0,42750.0,-12250.0
bourc101,Chris Bourjos,San Francisco Giants,GIANTS,3,5,4,9,1980,1984,4,13.32,-1.81,-15.13,864,212,-652,1590,613,-977,5214.0,0.0,-5214.0,0.0,0.0,0.0
bourc101,Chris Bourjos,Houston Astros,ASTROS,1,2,1,3,1981,1982,1,0.0,0.83,0.83,0,82,82,0,230,230,0.0,0.0,0.0,0.0,0.0,0.0
bourj001,Jason Bourgeois,Houston Astros,ASTROS,1,2,2,4,2012,2017,5,-0.3,0.42,0.72,73,60,-13,210,0,-210,0.0,165.0,165.0,0.0,0.0,0.0
bourj002,Justin Bour,Miami Marlins,MARLNS,1,2,1,3,2018,2018,0,-0.18,0.0,0.18,29,0,-29,54,0,-54,0.0,0.0,0.0,3400000.0,0.0,-3400000.0
bourm001,Michael Bourn,Philadelphia Phillies,PHILS,1,3,2,5,2007,2011,4,12.75,0.63,-12.12,681,613,-68,2271,356,-1915,252.0,579.0,327.0,1217500.0,5350000.0,4132500.0
bourm001,Michael Bourn,Houston Astros,ASTROS,3,10,7,17,2011,2020,9,14.39,5.69,-8.7,651,525,-126,1291,481,-810,2153.0,1828.0,-325.0,9515800.0,5819000.0,-3696800.0
bourm001,Michael Bourn,Cleveland Indians,INDINS,1,3,1,4,2015,2015,0,-0.91,-0.23,0.68,92,27,-65,305,93,-212,0.0,0.0,0.0,0.0,0.0,0.0
bourm001,Michael Bourn,Arizona Diamondbacks,DBACKS,1,1,1,2,2016,2016,0,0.13,0.0,-0.13,24,0,-24,55,0,-55,0.0,0.0,0.0,0.0,0.0,0.0
bourp001,Peter Bourjos,Anaheim Angels,ANGELS,2,3,3,6,2013,2016,3,6.81,4.69,-2.12,768,456,-312,1907,981,-926,187.0,536.0,349.0,0.0,3662000.0,3662000.0
bourp101,Pat Bourque,Chicago Cubs,CUBS,1,1,1,2,1973,1973,0,0.32,-0.37,-0.69,96,19,-77,172,65,-107,0.0,0.0,0.0,0.0,0.0,0.0
bourp101,Pat Bourque,Oakland Athletics,ATLTCS,1,1,1,2,1974,1974,0,0.09,-0.41,-0.5,23,30,7,71,45,-26,0.0,0.0,0.0,17500.0,25000.0,7500.0
bourp101,Pat Bourque,Minnesota Twins,TWINS,3,3,5,8,1974,1982,8,4.67,8.03,3.36,408,1108,700,1503,4024,2521,0.0,0.0,0.0,260000.0,0.0,-260000.0
bourr001,Rafael Bournigal,Los Angeles Dodgers,DOGRS,2,3,2,5,1995,2002,7,1.42,-0.47,-1.89,279,38,-241,871,0,-871,30.0,70.0,40.0,0.0,2333333.0,2333333.0
boutj101,Jim Bouton,Seattle Pilots,BREWRS,2,3,3,6,1969,1972,3,1.65,-1.38,-3.03,168,83,-85,43,19,-24,594.0,246.0,-348.0,22000.0,23500.0,1500.0
bovem001,Mike Bovee,Kansas City Royals,ROYALS,1,2,1,3,1996,1997,1,-0.59,2.4,2.99,5,140,135,0,567,567,24.0,0.0,-24.0,1600000.0,3800000.0,2200000.0
bowal001,Larry Bowa,Philadelphia Phillies,PHILS,2,4,2,6,1982,1986,4,69.17,2.77,-66.4,2804,581,-2223,11092,1670,-9422,193.0,313.0,120.0,0.0,0.0,0.0
bowdm001,Michael Bowden,Boston Red Sox,RSOX,1,2,2,4,2012,2012,0,0.77,-0.16,-0.93,128,34,-94,2,106,104,223.0,0.0,-223.0,484000.0,0.0,-484000.0
bowef102,Frank Bowerman,New York Giants,GIANTS,4,11,6,17,1907,1921,14,45.64,34.38,-11.26,2445,1600,-845,8369,5323,-3046,1733.0,2915.0,1182.0,6400.0,5200.0,-1200.0
bower002,Rob Bowen,San Diego Padres,PADRS,1,2,2,4,2007,2008,1,-0.62,-1.21,-0.59,10,74,64,36,243,207,0.0,0.0,0.0,382300.0,4533333.0,4151033.0
bower002,Rob Bowen,Chicago Cubs,CUBS,1,2,2,4,2007,2007,0,3.55,-0.3,-3.85,355,57,-298,153,202,49,801.0,0.0,-801.0,0.0,12858194.0,12858194.0
bowim001,Micah Bowie,Atlanta Braves,BRAVES,1,3,2,5,1999,2000,1,-3.84,1.92,5.76,68,186,118,50,245,195,440.0,651.0,211.0,0.0,5325000.0,5325000.0
bowkj001,John Bowker,San Francisco Giants,GIANTS,1,2,1,3,2010,2016,6,0.17,5.3,5.13,55,867,812,96,4,-92,26.0,753.0,727.0,410000.0,775000.0,365000.0
bowmb103,Bob Bowman,New York Giants,GIANTS,1,1,1,2,1941,1941,0,0.07,0.0,-0.07,2,0,-2,0,0,0,3.0,0.0,-3.0,0.0,0.0,0.0
bowme101,Ernie Bowman,San Francisco Giants,GIANTS,8,14,12,26,1964,1972,8,20.6,12.56,-8.04,1709,1303,-406,5210,1731,-3479,1169.0,4789.0,3620.0,50000.0,54000.0,4000.0
bowme101,Ernie Bowman,Milwaukee Braves,BRAVES,4,5,8,13,1965,1971,6,0.93,-0.4,-1.33,225,245,20,724,738,14,0.0,0.0,0.0,0.0,17000.0,17000.0
bowme101,Ernie Bowman,New York Mets,METS,1,2,1,3,1966,1968,2,-0.53,0.0,0.53,142,0,-142,357,0,-357,0.0,0.0,0.0,0.0,0.0,0.0
bowmj101,Joe Bowman,Portland,Portland,1,1,2,3,1933,1943,10,0.61,0.0,-0.61,61,0,-61,32,0,-32,322.0,0.0,-322.0,0.0,0.0,0.0
bowmj101,Joe Bowman,New York Giants,GIANTS,1,1,1,2,1934,1937,3,3.13,-0.11,-3.24,166,150,-16,157,267,110,1053.0,0.0,-1053.0,0.0,0.0,0.0
bowmj101,Joe Bowman,Philadelphia Phillies,PHILS,1,1,1,2,1937,1938,1,3.74,0.24,-3.5,336,126,-210,322,440,118,1889.0,0.0,-1889.0,0.0,0.0,0.0
bowmj101,Joe Bowman,Pittsburgh Pirates,PIRATS,1,1,1,2,1941,1942,1,0.0,0.0,0.0,0,0,0,0,0,0,0.0,0.0,0.0,0.0,0.0,0.0
bowmj101,Joe Bowman,Portland,Portland,1,2,2,4,1931,1931,0,1.71,0.0,-1.71,253,0,-253,858,0,-858,33.0,0.0,-33.0,0.0,0.0,0.0
bowmj101,Joe Bowman,Philadelphia Athletics,ATLTCS,1,2,1,3,1932,1936,4,0.0,1.11,1.11,0,224,224,0,182,182,0.0,1445.0,1445.0,2500.0,0.0,-2500.0
bowmj101,Joe Bowman,St.Paul,St.Paul,1,1,1,2,1943,1943,0,-1.41,0.0,1.41,97,0,-97,115,0,-115,540.0,0.0,-540.0,0.0,0.0,0.0
bowst101,Ted Bowsfield,Boston Red Sox,RSOX,4,8,6,14,1960,1966,6,-2.7,-1.76,0.94,273,963,690,690,2516,1826,122.0,336.0,214.0,18500.0,0.0,-18500.0
bowst101,Ted Bowsfield,Los Angeles Angels,ANGELS,3,4,5,9,1962,1965,3,2.33,1.29,-1.04,351,291,-60,119,108,-11,940.0,979.0,39.0,12500.0,0.0,-12500.0
bowyt001,Travis Bowyer,Minnesota Twins,TWINS,5,6,6,12,2005,2019,14,3.77,5.35,1.58,558,693,135,2185,2384,199,5.0,417.0,412.0,5750000.0,5166667.0,-583333.0
boxbb001,Brad Boxberger,Cincinnati Reds,REDS,2,5,3,8,2011,2020,9,8.75,14.41,5.66,882,376,-506,2596,411,-2185,1389.0,3437.0,2048.0,9475000.0,460700.0,-9014300.0
boxbb001,Brad Boxberger,San Diego Padres,PADRS,5,10,9,19,2014,2019,5,13.64,2.43,-11.21,896,526,-370,1526,1044,-482,2446.0,524.0,-1922.0,2925000.0,2005000.0,-920000.0
boxbb001,Brad Boxberger,Tampa Bay Devil Rays,RAYS,2,3,2,5,2017,2019,2,-0.93,0.71,1.64,118,37,-81,0,119,119,160.0,0.0,-160.0,1600000.0,100000.0,-1500000.0
boydb102,Bob Boyd,Baltimore Orioles,ORLS,4,11,7,18,1961,1973,12,20.55,30.35,9.8,1602,1797,195,5528,6131,603,845.0,306.0,-539.0,72000.0,40300.0,-31700.0
boydj001,Jason Boyd,Arizona Diamondbacks,DBACKS,2,3,2,5,1999,2003,4,-0.64,1.43,2.07,53,629,576,82,2744,2662,55.0,0.0,-55.0,6000000.0,0.0,-6000000.0
boydm001,Matt Boyd,Toronto Blue Jays,BJAYS,1,3,1,4,2015,2015,0,13.77,2.5,-11.27,310,12,-298,26,4,-22,3733.0,223.0,-3510.0,508700.0,19750000.0,19241300.0
boydo001,Oil Can Boyd,Montreal Expos,NATEX,5,6,8,14,1991,2000,9,1.61,1.53,-0.08,564,553,-11,1710,1303,-407,548.0,901.0,353.0,4125000.0,373000.0,-3752000.0
boyeb001,Blaine Boyer,Atlanta Braves,BRAVES,1,1,1,2,2009,2009,0,-0.16,0.0,0.16,30,1,-29,1,0,-1,49.0,0.0,-49.0,432500.0,0.0,-432500.0
boyec102,Clete Boyer,Kansas City Athletics,ATLTCS,38,80,81,161,1957,1976,19,137.3,59.64,-77.66,12943,8836,-4107,29783,24655,-5128,18720.0,9434.0,-9286.0,506100.0,626500.0,120400.0
boyec102,Clete Boyer,New York Yankees,YANKS,2,2,3,5,1966,1970,4,8.56,-2.04,-10.6,533,310,-223,2105,998,-1107,0.0,0.0,0.0,31500.0,5500.0,-26000.0
boyek101,Ken Boyer,St. Louis Cardinals,CARDS,6,8,10,18,1965,1972,7,3.16,6.17,3.01,837,438,-399,1340,759,-581,1318.0,1226.0,-92.0,102500.0,120000.0,17500.0
boyek101,Ken Boyer,New York Mets,METS,2,3,3,6,1967,1970,3,-1.49,0.67,2.16,346,144,-202,991,467,-524,0.0,0.0,0.0,55000.0,20000.0,-35000.0
boylb101,Buzz Boyle,Baltimore,Baltimore,1,1,2,3,1933,1933,0,5.7,0.0,-5.7,348,0,-348,1406,0,-1406,0.0,0.0,0.0,0.0,0.0,0.0
boylb101,Buzz Boyle,Brooklyn Dodgers,DOGRS,2,5,3,8,1936,1940,4,2.67,4.3,1.63,454,607,153,1715,2060,345,0.0,317.0,317.0,0.0,0.0,0.0
boyld101,Doe Boyland,Pittsburgh Pirates,PIRATS,1,1,1,2,1981,1982,1,0.0,-0.96,-0.96,0,12,12,0,9,9,0.0,67.0,67.0,0.0,0.0,0.0
boyle101,Eddie Boyle,Louisville Colonels,LS3,1,2,1,3,1896,1899,3,-0.17,5.69,5.86,17,500,483,58,1976,1918,0.0,0.0,0.0,0.0,0.0,0.0
boylj102,Jack Boyle,Cincinnati Reds,REDS,1,2,1,3,1886,1890,4,1.15,1.51,0.36,379,432,53,1510,1926,416,0.0,0.0,0.0,0.0,1800.0,1800.0
boylj102,Jack Boyle,New York Giants,GIANTS,1,3,1,4,1893,1894,1,-1.18,4.81,5.99,549,157,-392,2414,700,-1714,168.0,0.0,-168.0,0.0,0.0,0.0
brabg101,Gene Brabender,Baltimore Orioles,ORLS,1,2,1,3,1969,1972,3,-0.94,-0.21,0.73,159,174,15,161,395,234,993.0,0.0,-993.0,0.0,0.0,0.0
brabg101,Gene Brabender,Milwaukee Brewers,BREWRS,3,4,4,8,1971,1972,1,0.08,-0.4,-0.48,40,188,148,109,485,376,0.0,0.0,0.0,37000.0,42000.0,5000.0
bracb001,Brad Brach,San Diego Padres,PADRS,1,1,1,2,2013,2013,0,5.96,0.0,-5.96,314,0,-314,2,0,-2,983.0,0.0,-983.0,498200.0,0.0,-498200.0
bracb001,Brad Brach,Baltimore Orioles,ORLS,1,1,1,2,2018,2018,0,0.39,0.0,-0.39,54,0,-54,0,0,0,71.0,0.0,-71.0,5165000.0,0.0,-5165000.0
bracg101,Gibby Brack,Brooklyn Dodgers,DOGRS,1,1,1,2,1938,1940,2,1.49,-0.5,-1.99,163,103,-60,603,318,-285,0.0,0.0,0.0,0.0,0.0,0.0
brada001,Archie Bradley,Arizona Diamondbacks,DBACKS,1,2,2,4,2020,2020,0,0.33,0.3,-0.03,6,12,6,0,41,41,23.0,0.0,-23.0,4100000.0,0.0,-4100000.0
bradb101,Bert Bradley,Oakland Athletics,ATLTCS,8,17,14,31,1984,1998,14,132.59,51.98,-80.61,4207,2365,-1842,7421,6370,-1051,13842.0,7587.0,-6255.0,6670419.0,6477500.0,-192919.0
bradb105,Buddy Bradford,Chicago White Sox,WSOX,3,4,4,8,1970,1971,1,2.16,-0.62,-2.78,446,79,-367,1302,48,-1254,0.0,422.0,422.0,40000.0,53000.0,13000.0
bradb105,Buddy Bradford,Cleveland Indians,INDINS,3,3,3,6,1971,1974,3,-1.35,-1.83,-0.48,217,74,-143,527,183,-344,0.0,0.0,0.0,30000.0,27000.0,-3000.0
bradb105,Buddy Bradford,Chicago White Sox,WSOX,1,1,2,3,1975,1975,0,0.3,0.0,-0.3,50,0,-50,93,0,-93,0.0,0.0,0.0,0.0,0.0,0.0
bradb105,Buddy Bradford,St. Louis Cardinals,CARDS,1,2,1,3,1975,1976,1,0.63,-0.55,-1.18,80,66,-14,258,97,-161,0.0,0.0,0.0,0.0,0.0,0.0
bradb105,Buddy Bradford,Cincinnati Reds,REDS,2,3,3,6,1972,1973,1,2.2,0.19,-2.01,223,36,-187,611,60,-551,24.0,0.0,-24.0,16000.0,0.0,-16000.0
bradc001,Chad Bradford,Chicago White Sox,WSOX,5,10,9,19,2000,2013,13,31.16,26.72,-4.44,2306,672,-1634,7101,1367,-5734,2636.0,4790.0,2154.0,12920000.0,9770000.0,-3150000.0
bradc001,Chad Bradford,Oakland Athletics,ATLTCS,1,1,2,3,2005,2006,1,0.44,3.53,3.09,31,211,180,0,879,879,70.0,0.0,-70.0,0.0,3500000.0,3500000.0
bradf102,Fred Bradley,New York Yankees,YANKS,2,4,2,6,1948,1956,8,8.14,18.41,10.27,334,437,103,647,602,-45,2224.0,4492.0,2268.0,0.0,0.0,0.0
bradj101,Joe Bradshaw,Toledo,Toledo,2,2,4,6,1924,1927,3,-0.91,0.0,0.91,153,0,-153,464,0,-464,0.0,0.0,0.0,0.0,6000.0,6000.0
bradj103,Jack Bradley,Cleveland Indians,INDINS,1,1,1,2,1916,1916,0,0.0,0.21,0.21,0,19,19,0,36,36,0.0,0.0,0.0,0.0,0.0,0.0
bradm001,Milton Bradley,Montreal Expos,NATEX,2,4,2,6,2001,2005,4,3.6,3.17,-0.43,225,211,-14,838,379,-459,74.0,964.0,890.0,881000.0,12500000.0,11619000.0
bradm001,Milton Bradley,Cleveland Indians,INDINS,3,4,5,9,2004,2013,9,22.65,11.89,-10.76,1291,986,-305,5076,2133,-2943,0.0,843.0,843.0,404400.0,327000.0,-77400.0
bradm001,Milton Bradley,Los Angeles Dodgers,DOGRS,1,2,1,3,2005,2017,12,0.96,21.5,20.54,172,1455,1283,589,5425,4836,0.0,0.0,0.0,2830000.0,0.0,-2830000.0
bradm001,Milton Bradley,Oakland Athletics,ATLTCS,1,2,1,3,2007,2009,2,1.87,0.57,-1.3,42,65,23,169,0,-169,0.0,230.0,230.0,4000000.0,0.0,-4000000.0
bradm001,Milton Bradley,Chicago Cubs,CUBS,1,1,2,3,2009,2011,2,0.02,1.59,1.57,101,40,-61,393,40,-353,0.0,339.0,339.0,7000000.0,12250000.0,5250000.0
bradm002,Michael Brady,Anaheim Angels,ANGELS,1,2,2,4,2015,2017,2,-0.45,1.55,2.0,66,221,155,0,948,948,84.0,0.0,-84.0,0.0,5000000.0,5000000.0
bradm101,Mark Bradley,Los Angeles Dodgers,DOGRS,1,1,3,4,1983,1983,0,-0.14,0.0,0.14,73,0,-73,115,0,-115,0.0,0.0,0.0,0.0,0.0,0.0
bradp001,Phil Bradley,Seattle Mariners,MARNRS,5,8,8,16,1987,1993,6,24.41,5.5,-18.91,1467,818,-649,2406,1901,-505,2994.0,1198.0,-1796.0,7690000.0,6424900.0,-1265100.0
bradp001,Phil Bradley,Philadelphia Phillies,PHILS,1,1,2,3,1988,1989,1,3.6,-0.08,-3.68,216,10,-206,963,0,-963,0.0,12.0,12.0,905000.0,0.0,-905000.0
bradp001,Phil Bradley,Baltimore Orioles,ORLS,1,1,1,2,1990,1990,0,-0.07,-0.63,-0.56,45,22,-23,162,64,-98,0.0,0.0,0.0,1150000.0,550000.0,-600000.0
brads001,Scott Bradley,New York Yankees,YANKS,4,10,9,19,1986,1992,6,2.03,5.24,3.21,652,1255,603,1902,3999,2097,488.0,0.0,-488.0,400873.0,475000.0,74127.0
brads001,Scott Bradley,Chicago White Sox,WSOX,3,4,5,9,1986,1996,10,6.56,25.54,18.98,1140,1193,53,3363,5160,1797,266.0,0.0,-266.0,4896500.0,2055555.0,-2840945.0
brads001,Scott Bradley,Cincinnati Reds,REDS,1,1,1,2,1992,1992,0,0.0,0.0,0.0,0,0,0,0,0,0,0.0,0.0,0.0,0.0,0.0,0.0
bradt102,Tom Bradley,California Angels,ANGELS,8,17,17,34,1970,1976,6,13.31,15.37,2.06,1179,1226,47,3267,3750,483,2333.0,345.0,-1988.0,137100.0,240300.0,103200.0
bradt102,Tom Bradley,Chicago White Sox,WSOX,4,9,6,15,1972,1979,7,18.67,15.35,-3.32,1517,1082,-435,3231,4100,869,4679.0,529.0,-4150.0,32700.0,224500.0,191800.0
bragb101,Bobby Bragan,Philadelphia Phillies,PHILS,1,1,2,3,1943,1946,3,0.07,1.98,1.91,202,107,-95,586,100,-486,0.0,847.0,847.0,0.0,0.0,0.0
bragd001,Darren Bragg,Seattle Mariners,MARNRS,2,2,3,5,1996,2006,10,10.51,34.44,23.93,579,337,-242,1584,31,-1553,2162.0,6279.0,4117.0,5630000.0,825000.0,-4805000.0
bragg001,Glenn Braggs,Milwaukee Brewers,BREWRS,1,2,2,4,1990,1990,0,3.07,2.88,-0.19,257,33,-224,822,0,-822,0.0,478.0,478.0,675000.0,500000.0,-175000.0
braid101,Dave Brain,Buffalo,Buffalo,1,1,1,2,1903,1903,0,3.27,0.0,-3.27,290,0,-290,1181,0,-1181,0.0,0.0,0.0,0.0,0.0,0.0
braid101,Dave Brain,St. Louis Cardinals,CARDS,2,3,2,5,1905,1907,2,1.71,-1.89,-3.6,85,193,108,334,714,380,0.0,0.0,0.0,0.0,0.0,0.0
braid101,Dave Brain,Pittsburgh Pirates,PIRATS,1,3,1,4,1905,1910,5,9.35,21.13,11.78,731,320,-411,2264,464,-1800,2702.0,3628.0,926.0,0.0,0.0,0.0
braid101,Dave Brain,Cincinnati Reds,REDS,1,2,2,4,1908,1910,2,-0.57,0.79,1.36,13,104,91,18,143,125,9.0,1093.0,1084.0,0.0,0.0,0.0
branb102,Bucky Brandon,Houston Astros,ASTROS,6,10,11,21,1965,1973,8,1.14,0.64,-0.5,559,971,412,411,1029,618,1907.0,2057.0,150.0,57500.0,108000.0,50500.0
branb102,Bucky Brandon,Chicago White Sox,WSOX,1,1,1,2,1971,1971,0,-0.5,0.0,0.5,260,0,-260,40,0,-40,731.0,0.0,-731.0,0.0,0.0,0.0
brand101,Dud Branom,KansasCity,KansasCity,1,1,2,3,1926,1926,0,-0.86,0.0,0.86,30,0,-30,102,0,-102,0.0,0.0,0.0,0.0,7500.0,7500.0
brane101,Ed Brandt,Boston Braves,BRAVES,9,22,18,40,1935,1952,17,30.65,55.97,25.32,2386,3342,956,8192,10691,2499,702.0,5153.0,4451.0,12500.0,0.0,-12500.0
brane101,Ed Brandt,Brooklyn Dodgers,DOGRS,2,2,4,6,1936,1948,12,4.3,12.51,8.21,114,889,775,108,3376,3268,818.0,89.0,-729.0,0.0,0.0,0.0
branh101,Harvey Branch,Chicago Cubs,CUBS,3,5,5,10,1962,1966,4,41.25,2.73,-38.52,2472,341,-2131,10221,655,-9566,24.0,861.0,837.0,12000.0,0.0,-12000.0
branj001,Jeff Brantley,Cincinnati Reds,REDS,1,1,1,2,1997,1997,0,0.03,0.0,-0.03,94,0,-94,1,0,-1,152.0,0.0,-152.0,2800000.0,155000.0,-2645000.0
branj001,Jeff Brantley,St. Louis Cardinals,CARDS,1,3,2,5,1998,1999,1,3.97,-0.62,-4.59,475,133,-342,1012,3,-1009,549.0,220.0,-329.0,8470000.0,2385000.0,-6085000.0
branj002,Jeff Branson,Cincinnati Reds,REDS,5,9,11,20,1997,2005,8,10.23,15.87,5.64,1063,1597,534,3584,2539,-1045,112.0,2236.0,2124.0,7950000.0,1050000.0,-6900000.0
branj101,Jackie Brandt,San Francisco Giants,GIANTS,5,9,7,16,1959,1968,9,13.15,7.42,-5.73,1312,848,-464,3499,1107,-2392,1130.0,3244.0,2114.0,43000.0,30000.0,-13000.0
branj101,Jackie Brandt,Baltimore Orioles,ORLS,7,19,18,37,1965,1988,23,25.46,102.26,76.8,1816,4270,2454,1785,10311,8526,8812.0,12795.0,3983.0,785333.0,89400.0,-695933.0
branj101,Jackie Brandt,St. Louis Cardinals,CARDS,19,44,38,82,1956,1972,16,56.42,67.4,10.98,5645,3260,-2385,13530,9157,-4373,6309.0,6165.0,-144.0,120500.0,36000.0,-84500.0
brank101,Kitty Bransfield,Pittsburgh Pirates,PIRATS,2,6,3,9,1904,1910,6,14.45,22.9,8.45,1603,573,-1030,5618,1466,-4152,2702.0,3643.0,941.0,0.0,0.0,0.0
branm001,Mickey Brantley,Seattle Mariners,MARNRS,3,4,4,8,1990,1994,4,-1.19,-0.25,0.94,99,17,-82,244,0,-244,20.0,66.0,46.0,0.0,125000.0,125000.0
branm002,Mark Brandenburg,Texas Rangers,RNGRS,1,2,2,4,1996,1996,0,0.03,0.73,0.7,108,23,-85,0,0,0,377.0,67.0,-310.0,123500.0,1975000.0,1851500.0
branm002,Mark Brandenburg,Boston Red Sox,RSOX,4,7,7,14,1997,2000,3,8.97,2.55,-6.42,585,374,-211,1634,946,-688,1253.0,139.0,-1114.0,5063500.0,700000.0,-4363500.0
branm003,Michael Brantley,Milwaukee Brewers,BREWRS,1,4,1,5,2008,2008,0,22.37,5.2,-17.17,1354,34,-1320,5551,50,-5501,190.0,392.0,202.0,0.0,11000000.0,11000000.0
branm101,Marshall Brant,New York Yankees,YANKS,1,3,1,4,1983,1984,1,-1.24,-0.76,0.48,9,12,3,14,0,-14,28.0,167.0,139.0,0.0,0.0,0.0
branr001,Russell Branyan,Cleveland Indians,INDINS,6,11,14,25,2002,2019,17,10.66,51.34,40.68,689,2146,1457,2167,5669,3502,399.0,4479.0,4080.0,25702400.0,10902500.0,-14799900.0
branr001,Russell Branyan,Atlanta Braves,BRAVES,1,1,1,2,2004,2004,0,1.1,0.0,-1.1,52,0,-52,190,0,-190,0.0,0.0,0.0,0.0,0.0,0.0
branr001,Russell Branyan,Tampa Bay Devil Rays,RAYS,1,1,2,3,2006,2010,4,0.94,-0.26,-1.2,88,13,-75,235,1,-234,0.0,47.0,47.0,0.0,0.0,0.0
branr001,Russell Branyan,Cleveland Indians,INDINS,1,1,2,3,2010,2013,3,0.86,0.34,-0.52,57,123,66,238,406,168,0.0,0.0,0.0,1500000.0,0.0,-1500000.0
branr002,Rob Brantly,Detroit Tigers,TIGRS,1,3,2,5,2012,2017,5,-1.8,11.54,13.34,208,344,136,437,741,304,809.0,2395.0,1586.0,1175000.0,8000000.0,6825000.0
bratj101,Joe Bratcher,St. Louis Cardinals,CARDS,1,5,1,6,1924,1925,1,0.0,0.0,0.0,0,0,0,0,0,0,0.0,0.0,0.0,0.0,0.0,0.0
braus001,Steve Braun,Seattle Mariners,MARNRS,1,1,1,2,1978,1979,1,0.35,-0.62,-0.97,136,20,-116,331,0,-331,0.0,343.0,343.0,0.0,0.0,0.0
braus002,Steven Brault,Baltimore Orioles,ORLS,1,2,1,3,2015,2015,0,1.85,1.0,-0.85,210,69,-141,101,236,135,1030.0,0.0,-1030.0,0.0,0.0,0.0
brava101,Angel Bravo,Chicago White Sox,WSOX,1,1,1,2,1969,1969,0,0.02,0.0,-0.02,70,0,-70,83,0,-83,0.0,0.0,0.0,0.0,21500.0,21500.0
brava101,Angel Bravo,Cincinnati Reds,REDS,1,1,1,2,1971,1971,0,-0.52,0.06,0.58,52,32,-20,68,37,-31,0.0,0.0,0.0,0.0,0.0,0.0
braxg101,Garland Braxton,New York Yankees,YANKS,1,2,1,3,1926,1926,0,10.55,0.57,-9.98,311,18,-293,225,24,-201,1748.0,108.0,-1640.0,3000.0,10000.0,7000.0
braxg101,Garland Braxton,Washington Senators,TWINS,1,2,1,3,1930,1930,0,0.86,0.43,-0.43,237,38,-199,612,91,-521,414.0,0.0,-414.0,13500.0,7000.0,-6500.0
brayb001,Bill Bray,Washington Nationals,NATEX,1,5,3,8,2006,2009,3,-0.61,0.43,1.04,705,795,90,181,2860,2679,809.0,139.0,-670.0,1352000.0,4550000.0,3198000.0
braza101,Al Brazle,Boston Red Sox,RSOX,1,1,1,2,1940,1946,6,20.12,5.58,-14.54,888,369,-519,466,211,-255,4131.0,1746.0,-2385.0,0.0,0.0,0.0
brazd001,Dewon Brazelton,Tampa Bay Devil Rays,RAYS,1,1,1,2,2005,2006,1,-0.89,-0.03,0.86,18,8,-10,4,25,21,54.0,0.0,-54.0,1124000.0,1675000.0,551000.0
brazf101,Frank Brazill,Philadelphia Athletics,ATLTCS,1,3,1,4,1922,1925,3,0.0,-0.89,-0.89,0,157,157,0,354,354,0.0,0.0,0.0,2500.0,0.0,-2500.0
brazy001,Yhency Brazoban,New York Yankees,YANKS,1,4,1,5,2003,2005,2,4.25,2.4,-1.85,506,36,-470,179,2,-177,2047.0,616.0,-1431.0,4150000.0,15714286.0,11564286.0
breal001,Leslie Brea,Seattle Mariners,MARNRS,2,2,2,4,1998,1999,1,-0.18,0.95,1.13,45,80,35,131,292,161,0.0,55.0,55.0,1500000.0,300000.0,-1200000.0
breal001,Leslie Brea,New York Mets,METS,1,4,1,5,2000,2000,0,28.33,0.16,-28.17,1330,56,-1274,5573,211,-5362,33.0,0.0,-33.0,210000.0,3000000.0,2790000.0
breas001,Sid Bream,Los Angeles Dodgers,DOGRS,1,3,1,4,1985,1987,2,13.58,2.02,-11.56,1414,166,-1248,4553,618,-3935,0.0,0.0,0.0,0.0,975500.0,975500.0
breed101,Danny Breeden,St. Louis Cardinals,CARDS,3,8,6,14,1968,1972,4,11.85,2.24,-9.61,1182,243,-939,1248,521,-727,1854.0,299.0,-1555.0,17500.0,24000.0,6500.0
breed101,Danny Breeden,Cincinnati Reds,REDS,1,1,1,2,1970,1970,0,-0.52,0.0,0.52,25,0,-25,79,0,-79,0.0,0.0,0.0,0.0,11250.0,11250.0
breed101,Danny Breeden,San Diego Padres,PADRS,2,3,4,7,1974,1977,3,0.29,1.08,0.79,46,347,301,86,318,232,183.0,1079.0,896.0,0.0,42500.0,42500.0
breeh101,Hal Breeden,Atlanta Braves,BRAVES,1,1,1,2,1970,1971,1,-0.34,1.77,2.11,23,106,83,39,13,-26,0.0,242.0,242.0,0.0,0.0,0.0
breeh101,Hal Breeden,Chicago Cubs,CUBS,1,2,2,4,1972,1972,0,0.36,-1.6,-1.96,335,85,-250,844,8,-836,2.0,188.0,186.0,0.0,0.0,0.0
breem101,Marv Breeding,Baltimore Orioles,ORLS,1,3,2,5,1962,1967,5,0.29,3.01,2.72,74,349,275,211,975,764,63.0,22.0,-41.0,7000.0,0.0,-7000.0
breem101,Marv Breeding,Washington Senators,RNGRS,1,1,1,2,1963,1964,1,-0.38,0.54,0.92,20,56,36,40,13,-27,0.0,175.0,175.0,0.0,0.0,0.0
breem101,Marv Breeding,Atlanta Braves,BRAVES,3,4,3,7,1966,1980,14,0.0,0.4,0.4,3,465,462,3,1209,1206,0.0,0.0,0.0,0.0,0.0,0.0
breem101,Marv Breeding,Houston Astros,ASTROS,1,1,1,2,1967,1967,0,0.0,-0.22,-0.22,0,4,4,0,0,0,0.0,4.0,4.0,0.0,0.0,0.0
breif001,Fred Breining,Pittsburgh Pirates,PIRATS,2,4,6,10,1979,1990,11,17.64,30.66,13.02,910,2106,1196,973,7523,6550,3555.0,123.0,-3432.0,975500.0,260000.0,-715500.0
breif001,Fred Breining,San Francisco Giants,GIANTS,3,6,4,10,1984,1992,8,-0.38,4.13,4.51,126,534,408,225,652,427,93.0,2798.0,2705.0,0.0,0.0,0.0
brena101,Ad Brennan,Cincinnati Reds,REDS,4,11,9,20,1910,1914,4,53.01,6.59,-46.42,3186,799,-2387,12273,2663,-9610,3029.0,990.0,-2039.0,0.0,0.0,0.0
brenb102,Bert Brenner,Cleveland Indians,INDINS,1,6,1,7,1913,1914,1,0.0,-0.98,-0.98,0,48,48,0,37,37,0.0,303.0,303.0,0.0,0.0,0.0
brenj001,Jake Brentz,Toronto Blue Jays,BJAYS,1,3,1,4,2015,2015,0,-1.1,0.06,1.16,24,25,1,0,0,0,43.0,57.0,14.0,0.0,0.0,0.0
brenj001,Jake Brentz,Seattle Mariners,MARNRS,1,2,1,3,2016,2016,0,0.0,-0.38,-0.38,0,18,18,0,0,0,0.0,59.0,59.0,0.0,532500.0,532500.0
brenl101,Lynn Brenton,Seattle,Seattle,1,1,2,3,1920,1920,0,-0.78,0.0,0.78,44,0,-44,28,0,-28,235.0,0.0,-235.0,0.0,0.0,0.0
brent001,Tom Brennan,Cleveland Indians,INDINS,1,1,1,2,1984,1987,3,-0.06,0.0,0.06,4,0,-4,0,0,0,20.0,0.0,-20.0,0.0,0.0,0.0
bresc001,Craig Breslow,Oakland Athletics,ATLTCS,3,5,5,10,2011,2015,4,0.11,4.67,4.56,286,252,-34,221,116,-105,1515.0,585.0,-930.0,3722500.0,0.0,-3722500.0
bresc001,Craig Breslow,Arizona Diamondbacks,DBACKS,4,7,8,15,2012,2021,9,45.83,11.26,-34.57,1640,653,-987,2691,1018,-1673,5869.0,2575.0,-3294.0,13397833.0,1579900.0,-11817933.0
brese101,Eddie Bressoud,Houston Astros,ASTROS,1,1,1,2,1961,1962,1,11.94,0.02,-11.92,558,40,-518,2188,100,-2088,0.0,0.0,0.0,0.0,0.0,0.0
brese101,Eddie Bressoud,Boston Red Sox,RSOX,4,7,6,13,1965,1968,3,24.8,3.53,-21.27,1088,233,-855,3047,426,-2621,3084.0,1094.0,-1990.0,44500.0,42000.0,-2500.0
brese101,Eddie Bressoud,New York Mets,METS,2,4,4,8,1967,1969,2,-0.9,-0.52,0.38,52,197,145,76,651,575,0.0,0.0,0.0,0.0,0.0,0.0
bresr102,Roger Bresnahan,New York Giants,GIANTS,1,1,3,4,1908,1915,7,10.02,9.62,-0.4,290,859,569,993,3291,2298,10.0,0.0,-10.0,0.0,0.0,0.0
bretk101,Ken Brett,Boston Red Sox,RSOX,5,10,10,20,1971,1977,6,35.42,11.92,-23.5,1569,736,-833,4628,2092,-2536,3846.0,2344.0,-1502.0,155000.0,100500.0,-54500.0
bretk101,Ken Brett,Milwaukee Brewers,BREWRS,3,6,5,11,1972,1984,12,7.41,27.71,20.3,475,1402,927,547,5127,4580,4062.0,1332.0,-2730.0,59800.0,15000.0,-44800.0
bretk101,Ken Brett,Philadelphia Phillies,PHILS,1,1,1,2,1973,1976,3,4.9,11.68,6.78,119,484,365,149,2238,2089,927.0,0.0,-927.0,0.0,0.0,0.0
bretk101,Ken Brett,Pittsburgh Pirates,PIRATS,6,13,12,25,1975,1988,13,109.3,32.91,-76.39,4660,1733,-2927,17124,6632,-10492,6130.0,687.0,-5443.0,807000.0,0.0,-807000.0
bretk101,Ken Brett,New York Yankees,YANKS,1,2,1,3,1976,1977,1,4.11,0.35,-3.76,80,152,72,116,536,420,850.0,0.0,-850.0,0.0,0.0,0.0
bretk101,Ken Brett,Chicago White Sox,WSOX,1,1,3,4,1977,1979,2,1.23,0.12,-1.11,53,29,-24,0,3,3,726.0,151.0,-575.0,70000.0,0.0,-70000.0
brewb001,Billy Brewer,Kansas City Royals,ROYALS,1,1,1,2,1995,1998,3,0.0,9.67,9.67,0,415,415,0,1825,1825,0.0,0.0,0.0,220000.0,1600000.0,1380000.0
brewb001,Billy Brewer,Los Angeles Dodgers,DOGRS,1,1,1,2,1996,2001,5,-0.11,-0.91,-0.8,4,32,28,0,13,13,17.0,138.0,121.0,0.0,0.0,0.0
brewc002,Colten Brewer,San Diego Padres,PADRS,2,4,3,7,2018,2021,3,0.86,1.32,0.46,113,186,73,139,686,547,244.0,0.0,-244.0,545000.0,0.0,-545000.0
brewc101,Charlie Brewster,Cincinnati Reds,REDS,1,1,1,2,1943,1943,0,-0.61,-0.02,0.59,49,49,0,175,106,-69,0.0,0.0,0.0,0.0,0.0,0.0
brewc101,Charlie Brewster,SanDiego,SanDiego,1,1,1,2,1946,1946,0,-0.01,0.0,0.01,3,0,-3,3,0,-3,0.0,0.0,0.0,0.0,0.0,0.0
brewj001,Jamie Brewington,San Francisco Giants,GIANTS,1,1,1,2,1996,2002,6,0.0,3.32,3.32,0,368,368,0,1045,1045,0.0,0.0,0.0,0.0,0.0,0.0
brewj001,Jamie Brewington,Kansas City Royals,ROYALS,1,1,1,2,1997,1997,0,0.0,0.0,0.0,0,0,0,0,0,0,0.0,0.0,0.0,0.0,0.0,0.0
brewj102,Jim Brewer,Chicago Cubs,CUBS,1,2,1,3,1963,1963,0,15.76,0.0,-15.76,949,0,-949,117,0,-117,2466.0,0.0,-2466.0,0.0,0.0,0.0
brewj102,Jim Brewer,Los Angeles Dodgers,DOGRS,1,1,1,2,1975,1975,0,1.31,0.0,-1.31,34,10,-24,0,1,1,164.0,21.0,-143.0,0.0,0.0,0.0
brica001,Austin Brice,Miami Marlins,MARLNS,1,3,1,4,2017,2019,2,13.54,1.87,-11.67,336,112,-224,228,107,-121,2332.0,912.0,-1420.0,0.0,0.0,0.0
brica001,Austin Brice,Miami Marlins,MARLNS,1,1,1,2,2020,2020,0,-0.06,0.0,0.06,34,0,-34,0,0,0,100.0,0.0,-100.0,0.0,0.0,0.0
brica101,Alan Brice,Chicago White Sox,WSOX,1,1,1,2,1962,1962,0,0.0,0.0,0.0,0,0,0,0,0,0,0.0,0.0,0.0,0.0,0.0,0.0
bricf101,Fred Brickell,Pittsburgh Pirates,PIRATS,1,1,1,2,1930,1930,0,-2.43,-0.43,2.0,236,17,-219,905,54,-851,0.0,0.0,0.0,0.0,5000.0,5000.0
bricf102,Fritz Brickell,New York Yankees,YANKS,1,1,1,2,1961,1961,0,-0.79,-0.14,0.65,21,2,-19,55,0,-55,0.0,1.0,1.0,0.0,0.0,0.0
bricj001,Jose Briceno,Colorado Rockies,ROCKS,1,2,2,4,2015,2016,1,0.0,-0.37,-0.37,0,36,36,0,27,27,0.0,241.0,241.0,0.0,0.0,0.0
bricj001,Jose Briceno,Atlanta Braves,BRAVES,4,9,8,17,2015,2017,2,22.94,1.32,-21.62,894,130,-764,2564,403,-2161,887.0,339.0,-548.0,16307500.0,20000000.0,3692500.0
brida101,Al Bridwell,Cincinnati Reds,REDS,1,1,1,2,1906,1906,0,2.0,2.26,0.26,342,115,-227,1449,451,-998,0.0,0.0,0.0,0.0,0.0,0.0
brida101,Al Bridwell,Boston Braves,BRAVES,2,4,6,10,1907,1911,4,19.52,11.83,-7.69,821,855,34,3252,2714,-538,0.0,1733.0,1733.0,0.0,0.0,0.0
brida101,Al Bridwell,New York Giants,GIANTS,3,6,3,9,1911,1921,10,34.55,14.86,-19.69,1629,779,-850,5823,2071,-3752,0.0,2915.0,2915.0,6400.0,5200.0,-1200.0
bridj101,Jim Brideweser,New York Yankees,YANKS,1,1,3,4,1954,1954,0,0.89,0.0,-0.89,164,0,-164,392,0,-392,0.0,0.0,0.0,0.0,10000.0,10000.0
bridj101,Jim Brideweser,Baltimore Orioles,ORLS,4,7,9,16,1954,1960,6,15.05,10.88,-4.17,745,881,136,1673,2506,833,2291.0,1208.0,-1083.0,0.0,0.0,0.0
bridj101,Jim Brideweser,Chicago White Sox,WSOX,10,18,21,39,1956,1971,15,41.93,77.23,35.3,3299,4500,1201,10984,12532,1548,917.0,5807.0,4890.0,83500.0,48000.0,-35500.0
bridj101,Jim Brideweser,Baltimore Orioles,ORLS,1,2,1,3,1958,1958,0,0.0,0.0,0.0,0,0,0,0,0,0,0.0,0.0,0.0,0.0,0.0,0.0
bridm101,Marshall Bridges,Cincinnati Reds,REDS,3,3,4,7,1961,1964,3,2.16,-1.12,-3.28,380,87,-293,650,145,-505,314.0,0.0,-314.0,0.0,0.0,0.0
bridp001,Parker Bridwell,Baltimore Orioles,ORLS,1,1,1,2,2017,2017,0,1.44,0.0,-1.44,26,0,-26,0,0,0,383.0,0.0,-383.0,0.0,0.0,0.0
bridr101,Rocky Bridges,Brooklyn Dodgers,DOGRS,3,6,5,11,1953,1961,8,18.78,1.43,-17.35,2060,372,-1688,3863,742,-3121,2426.0,1360.0,-1066.0,0.0,0.0,0.0
bridr101,Rocky Bridges,Washington Senators,TWINS,5,10,8,18,1958,1963,5,7.52,-2.19,-9.71,769,798,29,2600,2634,34,5.0,80.0,75.0,9500.0,7000.0,-2500.0
bridr101,Rocky Bridges,Detroit Tigers,TIGRS,1,2,1,3,1960,1960,0,-0.21,0.09,0.3,42,26,-16,127,61,-66,0.0,0.0,0.0,0.0,0.0,0.0
brieb101,Bunny Brief,St.Louis Browns,ORLS,1,4,1,5,1913,1916,3,0.0,8.53,8.53,0,318,318,0,1249,1249,0.0,0.0,0.0,3200.0,0.0,-3200.0
brigb101,Buttons Briggs,Chicago Cubs,CUBS,1,2,2,4,1898,1901,3,0.0,6.83,6.83,0,327,327,0,1338,1338,0.0,0.0,0.0,0.0,0.0,0.0
brigb101,Buttons Briggs,Toronto,Toronto,1,1,4,5,1903,1903,0,5.06,0.0,-5.06,108,0,-108,173,0,-173,1329.0,0.0,-1329.0,0.0,0.0,0.0
brigb101,Buttons Briggs,Chicago Cubs,CUBS,1,5,1,6,1905,1913,8,5.14,19.07,13.93,814,1001,187,3290,4393,1103,0.0,0.0,0.0,0.0,0.0,0.0
brigd101,Dan Briggs,Cleveland Indians,INDINS,1,1,1,2,1979,1979,0,0.14,0.0,-0.14,104,0,-104,254,0,-254,0.0,0.0,0.0,0.0,0.0,0.0
brigd101,Dan Briggs,San Diego Padres,PADRS,1,2,1,3,1979,1981,2,-0.61,-0.55,0.06,27,130,103,51,437,386,0.0,0.0,0.0,0.0,300000.0,300000.0
brigd101,Dan Briggs,Montreal Expos,NATEX,3,3,3,6,1982,1983,1,-0.51,0.0,0.51,62,0,-62,51,0,-51,31.0,0.0,-31.0,0.0,0.0,0.0
brigh101,Harry Bright,Pittsburgh Pirates,PIRATS,1,3,1,4,1960,1961,1,4.94,2.05,-2.89,573,87,-486,984,20,-964,2463.0,268.0,-2195.0,0.0,0.0,0.0
brigh101,Harry Bright,Washington Senators,RNGRS,1,1,1,2,1962,1963,1,-0.03,0.0,0.03,1,0,-1,1,0,-1,0.0,0.0,0.0,0.0,0.0,0.0
brigj001,Jake Brigham,Texas Rangers,RNGRS,1,2,1,3,2012,2014,2,0.0,0.74,0.74,0,111,111,0,386,386,0.0,0.0,0.0,0.0,4300000.0,4300000.0
brigj001,Jake Brigham,Chicago Cubs,CUBS,1,1,1,2,2012,2012,0,0.0,0.0,0.0,0,0,0,0,0,0,0.0,0.0,0.0,0.0,0.0,0.0
brigj002,Jeff Brigham,Los Angeles Dodgers,DOGRS,9,31,24,55,2015,2021,6,13.68,18.97,5.29,1948,1113,-835,5665,1311,-4354,2367.0,3323.0,956.0,37486500.0,81903480.0,44416980.0
brigj101,John Briggs,Sacramento,Sacramento,1,2,3,5,1955,1959,4,0.4,0.0,-0.4,56,0,-56,37,0,-37,317.0,0.0,-317.0,0.0,0.0,0.0
brigj101,John Briggs,Chicago Cubs,CUBS,2,4,3,7,1959,1961,2,-0.03,1.89,1.92,58,282,224,20,801,781,147.0,7.0,-140.0,0.0,0.0,0.0
brigj101,John Briggs,Kansas City Athletics,ATLTCS,1,2,1,3,1961,1961,0,1.89,1.04,-0.85,216,93,-123,188,76,-112,1621.0,384.0,-1237.0,0.0,0.0,0.0
brigj102,John Briggs,Philadelphia Phillies,PHILS,2,2,3,5,1971,1973,2,14.34,-0.93,-15.27,584,53,-531,2237,83,-2154,0.0,0.0,0.0,25000.0,27100.0,2100.0
brigj102,John Briggs,Milwaukee Brewers,BREWRS,3,5,3,8,1975,1976,1,5.39,0.55,-4.84,629,149,-480,2135,501,-1634,335.0,0.0,-335.0,150000.0,0.0,-150000.0
briln101,Nelson Briles,St. Louis Cardinals,CARDS,3,4,5,9,1971,1972,1,10.59,4.12,-6.47,503,282,-221,1140,1112,-28,1651.0,28.0,-1623.0,0.0,0.0,0.0
briln101,Nelson Briles,Pittsburgh Pirates,PIRATS,3,4,6,10,1973,1978,5,0.57,-0.14,-0.71,111,383,272,173,830,657,645.0,0.0,-645.0,94500.0,49000.0,-45500.0
briln101,Nelson Briles,Kansas City Royals,ROYALS,1,1,1,2,1975,1978,3,3.4,-0.07,-3.47,60,105,45,0,226,226,955.0,0.0,-955.0,0.0,0.0,0.0
brine101,Ed Brinkman,Washington Senators,RNGRS,6,10,11,21,1970,1976,6,30.0,-0.41,-30.41,2790,834,-1956,8622,1724,-6898,5481.0,1612.0,-3869.0,75900.0,317100.0,241200.0
brine101,Ed Brinkman,Detroit Tigers,TIGRS,1,3,1,4,1974,1975,1,-0.19,-1.37,-1.18,91,45,-46,191,173,-18,0.0,0.0,0.0,79000.0,80000.0,1000.0
brine101,Ed Brinkman,San Diego Padres,PADRS,2,3,4,7,1974,1977,3,0.29,1.08,0.79,46,347,301,86,318,232,183.0,1079.0,896.0,0.0,42500.0,42500.0
brine101,Ed Brinkman,St. Louis Cardinals,CARDS,3,4,3,7,1975,1976,1,0.91,1.54,0.63,156,98,-58,524,376,-148,63.0,0.0,-63.0,0.0,0.0,0.0
brinl001,Lewis Brinson,Texas Rangers,RNGRS,3,5,4,9,2016,2018,2,3.83,1.66,-2.17,343,178,-165,233,474,241,460.0,162.0,-298.0,7350000.0,0.0,-7350000.0
brinl001,Lewis Brinson,Milwaukee Brewers,BREWRS,1,4,1,5,2018,2018,0,-6.06,7.26,13.32,541,147,-394,1645,651,-994,270.0,0.0,-270.0,0.0,0.0,0.0
brinl101,Leon Brinkopf,Dallas,Dallas,1,1,1,2,1948,1948,0,0.04,0.0,-0.04,9,0,-9,26,0,-26,0.0,0.0,0.0,0.0,0.0,0.0
brisl101,Lou Brissie,Philadelphia Athletics,ATLTCS,35,74,76,150,1951,1976,25,96.76,72.83,-23.93,10509,9253,-1256,24683,28375,3692,13188.0,7417.0,-5771.0,500300.0,626500.0,126200.0
britc001,Chris Britton,Baltimore Orioles,ORLS,1,1,2,3,2006,2007,1,0.34,-0.34,-0.68,28,3,-25,0,0,0,107.0,31.0,-76.0,0.0,7666667.0,7666667.0
britj101,Jim Britton,Atlanta Braves,BRAVES,1,2,1,3,1969,1969,0,-1.08,0.0,1.08,32,0,-32,10,0,-10,137.0,0.0,-137.0,0.0,0.0,0.0
brits001,Socrates Brito,San Diego Padres,PADRS,1,1,1,2,2019,2019,0,-0.82,0.0,0.82,17,0,-17,43,0,-43,0.0,0.0,0.0,0.0,0.0,0.0
britz001,Zack Britton,Baltimore Orioles,ORLS,1,1,3,4,2018,2021,3,2.85,-1.38,-4.23,142,26,-116,0,0,0,371.0,135.0,-236.0,12000000.0,0.0,-12000000.0
broal001,Lance Broadway,Chicago White Sox,WSOX,1,1,2,3,2009,2011,2,-0.14,0.61,0.75,16,91,75,0,287,287,44.0,0.0,-44.0,402500.0,2625000.0,2222500.0
brobp101,Pete Broberg,Texas Rangers,RNGRS,1,1,1,2,1974,1976,2,1.7,-0.25,-1.95,58,25,-33,0,0,0,938.0,280.0,-658.0,0.0,67001.0,67001.0
brobp101,Pete Broberg,Seattle Mariners,MARNRS,1,1,1,2,1977,1979,2,0.1,0.8,0.7,44,49,5,6,0,-6,108.0,320.0,212.0,0.0,0.0,0.0
brobp101,Pete Broberg,Chicago Cubs,CUBS,2,3,3,6,1978,1979,1,3.42,0.91,-2.51,833,109,-724,2458,294,-2164,497.0,0.0,-497.0,0.0,0.0,0.0
brocc001,Chris Brock,San Francisco Giants,GIANTS,2,3,2,5,1999,2001,2,1.19,2.34,1.15,171,189,18,20,469,449,378.0,103.0,-275.0,525000.0,560000.0,35000.0
brocc001,Chris Brock,Philadelphia Phillies,PHILS,1,1,1,2,2001,2001,0,0.12,0.0,-0.12,24,0,-24,2,0,-2,132.0,0.0,-132.0,700000.0,0.0,-700000.0
brocd001,Doug Brocail,San Diego Padres,PADRS,6,15,16,31,1994,2006,12,12.56,40.19,27.63,2713,3390,677,9058,12055,2997,712.0,1324.0,612.0,13007500.0,22494000.0,9486500.0
brocd001,Doug Brocail,Houston Astros,ASTROS,6,12,18,30,1996,2004,8,25.8,6.98,-18.82,2221,1542,-679,3937,2959,-978,4263.0,3434.0,-829.0,7155000.0,5554000.0,-1601000.0
brocd001,Doug Brocail,Detroit Tigers,TIGRS,1,3,3,6,2000,2002,2,3.02,0.94,-2.08,1389,171,-1218,3537,610,-2927,741.0,454.0,-287.0,5550000.0,3640000.0,-1910000.0
brocg001,Greg Brock,Los Angeles Dodgers,DOGRS,3,4,5,9,1986,1993,7,7.41,17.7,10.29,892,1640,748,3202,3057,-145,269.0,2632.0,2363.0,3695000.0,415000.0,-3280000.0
brocl102,Lou Brock,Chicago Cubs,CUBS,2,4,4,8,1964,1966,2,41.31,1.04,-40.27,2470,267,-2203,10220,596,-9624,9.0,335.0,326.0,12000.0,0.0,-12000.0
broct001,Tarrik Brock,Colorado Rockies,ROCKS,1,1,2,3,1999,1999,0,-0.11,0.0,0.11,13,0,-13,16,0,-16,0.0,0.0,0.0,0.0,0.0,0.0
brodb001,Brian Broderick,Anaheim Angels,ANGELS,1,1,1,2,2014,2016,2,0.0,1.39,1.39,0,228,228,0,869,869,0.0,0.0,0.0,0.0,508575.0,508575.0
brodd101,Dick Brodowski,Boston Red Sox,RSOX,2,7,5,12,1955,1963,8,0.69,2.88,2.19,731,424,-307,812,1170,358,1712.0,707.0,-1005.0,7000.0,0.0,-7000.0
brodd101,Dick Brodowski,Washington Senators,TWINS,1,2,1,3,1957,1957,0,0.92,-0.4,-1.32,46,96,50,9,331,322,120.0,0.0,-120.0,8000.0,0.0,-8000.0
brods101,Steve Brodie,Baltimore Orioles,BLN,2,4,6,10,1896,1903,7,2.95,7.66,4.71,454,485,31,1885,2090,205,0.0,0.0,0.0,0.0,0.0,0.0
broge101,Ernie Broglio,San Francisco Giants,GIANTS,2,4,4,8,1958,1961,3,20.2,2.2,-18.0,530,255,-275,497,641,144,4103.0,59.0,-4044.0,0.0,0.0,0.0
broge101,Ernie Broglio,St. Louis Cardinals,CARDS,1,3,3,6,1964,1965,1,-0.83,5.23,6.06,340,107,-233,612,464,-148,674.0,9.0,-665.0,0.0,12000.0,12000.0
brogr001,Rico Brogna,Detroit Tigers,TIGRS,1,1,1,2,1994,1995,1,3.42,0.0,-3.42,228,0,-228,889,0,-889,0.0,0.0,0.0,0.0,0.0,0.0
brogr001,Rico Brogna,New York Mets,METS,2,2,3,5,1996,1997,1,-3.03,-0.84,2.19,499,87,-412,2022,2,-2020,10.0,148.0,138.0,587500.0,468250.0,-119250.0
brohj101,Jack Brohamer,Cleveland Indians,INDINS,13,20,28,48,1975,2004,29,65.06,112.61,47.55,2581,5058,2477,7803,17916,10113,7208.0,9771.0,2563.0,2352500.0,1522500.0,-830000.0
broht001,Troy Brohawn,San Francisco Giants,GIANTS,2,3,3,6,1998,2006,8,0.78,7.92,7.14,162,796,634,1,75,74,211.0,1209.0,998.0,3050000.0,1435000.0,-1615000.0
bronj001,Jeff Bronkey,Texas Rangers,RNGRS,1,1,1,2,1994,1994,0,0.5,0.0,-0.5,24,0,-24,0,0,0,99.0,0.0,-99.0,0.0,0.0,0.0
brooa001,Aaron Brooks,Kansas City Royals,ROYALS,1,2,2,4,2015,2015,0,11.48,1.17,-10.31,167,59,-108,19,264,245,2493.0,0.0,-2493.0,0.0,0.0,0.0
brooa001,Aaron Brooks,Oakland Athletics,ATLTCS,2,2,2,4,2016,2016,0,0.6,-1.55,-2.15,48,67,19,128,191,63,0.0,0.0,0.0,0.0,4800000.0,4800000.0
broob101,Bobby Brooks,Detroit Tigers,TIGRS,1,1,1,2,1973,1979,6,-0.04,1.22,1.26,4,77,73,7,200,193,0.0,0.0,0.0,0.0,0.0,0.0
broof001,Frank Brooks,Philadelphia Phillies,PHILS,1,1,2,3,2003,2003,0,0.01,-0.52,-0.53,22,56,34,1,0,-1,52.0,77.0,25.0,0.0,3500000.0,3500000.0
brooh001,Hubie Brooks,New York Mets,METS,1,4,1,5,1984,1989,5,17.64,11.38,-6.26,1847,600,-1247,5919,2448,-3471,1489.0,0.0,-1489.0,356000.0,0.0,-356000.0
brooh001,Hubie Brooks,Los Angeles Dodgers,DOGRS,2,5,4,9,1990,1998,8,-0.32,5.35,5.67,932,589,-343,3120,151,-2969,618.0,1944.0,1326.0,1584667.0,5710000.0,4125333.0
brooh001,Hubie Brooks,New York Mets,METS,2,2,2,4,1991,1994,3,-1.41,0.9,2.31,171,239,68,497,481,-16,0.0,394.0,394.0,2816666.0,1382500.0,-1434166.0
brooi101,Ike Brookens,Kansas City Royals,ROYALS,2,2,2,4,1970,1972,2,1.74,0.0,-1.74,121,0,-121,14,0,-14,570.0,0.0,-570.0,0.0,0.0,0.0
brooi101,Ike Brookens,St. Louis Cardinals,CARDS,1,1,1,2,1974,1974,0,0.03,0.0,-0.03,3,0,-3,0,0,0,31.0,0.0,-31.0,0.0,0.0,0.0
broom101,Mandy Brooks,Columbus,Columbus,1,1,2,3,1925,1925,0,1.18,0.0,-1.18,116,0,-116,435,0,-435,0.0,0.0,0.0,0.0,4000.0,4000.0
broom101,Mandy Brooks,Chicago Cubs,CUBS,1,2,1,3,1926,1929,3,0.0,3.23,3.23,0,164,164,0,554,554,0.0,0.0,0.0,0.0,0.0,0.0
broot001,Tom Brookens,Detroit Tigers,TIGRS,1,1,1,2,1989,1989,0,-1.23,-0.99,0.24,66,19,-47,183,0,-183,0.0,200.0,200.0,0.0,0.0,0.0
brosj101,Jim Brosnan,Chicago Cubs,CUBS,2,4,2,6,1958,1961,3,6.95,8.63,1.68,339,510,171,491,2091,1600,1652.0,0.0,-1652.0,0.0,40000.0,40000.0
brosj101,Jim Brosnan,St. Louis Cardinals,CARDS,1,1,1,2,1959,1959,0,6.21,-0.5,-6.71,380,23,-357,65,3,-62,995.0,53.0,-942.0,0.0,0.0,0.0
brosj101,Jim Brosnan,Cincinnati Reds,REDS,1,1,1,2,1963,1963,0,1.23,0.02,-1.21,90,62,-28,13,3,-10,219.0,129.0,-90.0,0.0,0.0,0.0
brosm001,Michael Brosseau,Tampa Bay Devil Rays,RAYS,1,1,1,2,2021,2021,0,0.0,0.0,0.0,0,0,0,0,0,0,0.0,0.0,0.0,0.0,0.0,0.0
bross001,Scott Brosius,Oakland Athletics,ATLTCS,4,5,7,12,1997,2012,15,16.92,23.71,6.79,998,1203,205,3641,4574,933,228.0,1280.0,1052.0,11612500.0,9650000.0,-1962500.0
brost001,Terry Bross,New York Mets,METS,1,1,1,2,1992,1992,0,0.0,0.0,0.0,0,0,0,0,0,0,0.0,0.0,0.0,0.0,0.0,0.0
brost001,Terry Bross,San Diego Padres,PADRS,1,1,1,2,1992,1993,1,0.0,0.01,0.01,0,55,55,0,5,5,0.0,95.0,95.0,0.0,0.0,0.0
brotr001,Rex Brothers,Colorado Rockies,ROCKS,1,1,1,2,2015,2015,0,-0.32,0.0,0.32,114,0,-114,2,0,-2,169.0,0.0,-169.0,1400000.0,0.0,-1400000.0
brott101,Tony Brottem,LittleRock,LittleRock,1,2,2,4,1920,1920,0,1.39,0.0,-1.39,118,0,-118,471,0,-471,0.0,0.0,0.0,0.0,3600.0,3600.0
broub001,Ben Broussard,Cincinnati Reds,REDS,1,1,1,2,2002,2003,1,6.04,1.85,-4.19,524,158,-366,1827,460,-1367,0.0,0.0,0.0,0.0,251000.0,251000.0
broub001,Ben Broussard,Cleveland Indians,INDINS,5,10,13,23,2006,2019,13,8.81,45.3,36.49,531,1622,1091,1707,3842,2135,399.0,4479.0,4080.0,25451400.0,10902500.0,-14548900.0
broub001,Ben Broussard,Seattle Mariners,MARNRS,1,1,1,2,2007,2009,2,-0.96,-0.19,0.77,26,30,4,89,56,-33,0.0,0.0,0.0,3550000.0,0.0,-3550000.0
broud101,Dan Brouthers,Brooklyn Dodgers,DOGRS,1,2,2,4,1894,1896,2,29.72,4.69,-25.03,772,328,-444,3764,1481,-2283,0.0,0.0,0.0,0.0,0.0,0.0
brovj101,Joe Brovia,Oakland,Oakland,1,1,2,3,1955,1955,0,0.0,0.0,0.0,21,0,-21,20,0,-20,0.0,0.0,0.0,0.0,0.0,0.0
browa002,Andrew Brown,Atlanta Braves,BRAVES,1,3,1,4,2002,2003,1,12.57,11.23,-1.34,452,290,-162,1035,1257,222,2316.0,0.0,-2316.0,0.0,0.0,0.0
browa002,Andrew Brown,Los Angeles Dodgers,DOGRS,2,4,2,6,2004,2017,13,6.58,25.96,19.38,465,1671,1206,1473,6338,4865,30.0,0.0,-30.0,2830000.0,0.0,-2830000.0
browa002,Andrew Brown,Cleveland Indians,INDINS,1,2,1,3,2006,2009,3,5.38,-0.48,-5.86,440,159,-281,1775,497,-1278,0.0,0.0,0.0,0.0,327000.0,327000.0
browa002,Andrew Brown,San Diego Padres,PADRS,1,1,2,3,2007,2007,0,0.57,1.87,1.3,65,42,-23,0,169,169,230.0,0.0,-230.0,0.0,4000000.0,4000000.0
browb001,Bobby Brown,Philadelphia Phillies,PHILS,1,2,1,3,1978,1980,2,1.16,-1.2,-2.36,257,146,-111,709,10,-699,0.0,369.0,369.0,0.0,220000.0,220000.0
browb001,Bobby Brown,New York Yankees,YANKS,3,6,4,10,1982,1987,5,15.14,5.21,-9.93,593,176,-417,734,188,-546,3682.0,1574.0,-2108.0,62500.0,700000.0,637500.0
browb002,Bob Brower,Texas Rangers,RNGRS,1,1,1,2,1988,1988,0,1.28,0.0,-1.28,26,0,-26,75,0,-75,0.0,0.0,0.0,98000.0,212500.0,114500.0
browb003,Brant Brown,Chicago Cubs,CUBS,1,1,1,2,1998,2002,4,-1.3,12.67,13.97,130,237,107,371,300,-71,0.0,2483.0,2483.0,180000.0,1450000.0,1270000.0
browb003,Brant Brown,Pittsburgh Pirates,PIRATS,1,1,1,2,1999,2000,1,-0.44,-0.36,0.08,41,72,31,76,153,77,0.0,0.0,0.0,290000.0,200000.0,-90000.0
browb003,Brant Brown,Florida Marlins,MARLNS,1,1,1,2,2000,2002,2,0.0,3.16,3.16,0,67,67,0,70,70,0.0,632.0,632.0,315000.0,0.0,-315000.0
browb003,Brant Brown,Texas Rangers,RNGRS,2,2,2,4,2000,2001,1,0.12,0.5,0.38,101,38,-63,308,134,-174,0.0,0.0,0.0,0.0,220000.0,220000.0
browb005,Brooks Brown,Arizona Diamondbacks,DBACKS,1,1,1,2,2009,2009,0,0.0,0.0,0.0,0,0,0,0,0,0,0.0,0.0,0.0,0.0,0.0,0.0
browb101,Byron Browne,Chicago Cubs,CUBS,1,1,1,2,1968,1968,0,0.08,0.0,-0.08,10,0,-10,17,0,-17,0.0,0.0,0.0,0.0,0.0,0.0
browb101,Byron Browne,St. Louis Cardinals,CARDS,26,53,46,99,1969,1994,25,115.3,156.23,40.93,11163,7909,-3254,30164,26894,-3270,12224.0,4453.0,-7771.0,3323333.0,942667.0,-2380666.0
browb101,Byron Browne,Philadelphia Phillies,PHILS,1,1,1,2,1972,1972,0,0.0,0.0,0.0,0,0,0,0,0,0,0.0,0.0,0.0,0.0,0.0,0.0
browb102,Buster Brown,St. Louis Cardinals,CARDS,1,1,1,2,1907,1907,0,0.92,1.27,0.35,63,55,-8,67,83,16,484.0,430.0,-54.0,0.0,0.0,0.0
browb102,Buster Brown,Philadelphia Phillies,PHILS,13,27,30,57,1909,1931,22,110.35,96.74,-13.61,5407,5417,10,17248,19665,2417,13600.0,6282.0,-7318.0,25000.0,31850.0,6850.0
browb102,Buster Brown,Boston Braves,BRAVES,1,2,1,3,1913,1927,14,0.0,23.58,23.58,0,555,555,0,778,778,0.0,6096.0,6096.0,2400.0,0.0,-2400.0
browc001,Curt Brown,California Angels,ANGELS,1,1,1,2,1983,1983,0,0.53,0.0,-0.53,13,0,-13,0,0,0,50.0,0.0,-50.0,0.0,0.0,0.0
browc001,Curt Brown,Milwaukee Brewers,BREWRS,1,1,1,2,1987,1987,0,0.0,0.0,0.0,0,0,0,0,0,0,0.0,0.0,0.0,0.0,0.0,0.0
browc002,Chris Brown,San Francisco Giants,GIANTS,5,11,14,25,1987,1998,11,21.11,35.92,14.81,1313,2149,836,1417,3377,1960,4080.0,4148.0,68.0,9727778.0,6966667.0,-2761111.0
browc002,Chris Brown,San Diego Padres,PADRS,2,4,3,7,1988,1990,2,-0.11,0.47,0.58,120,230,110,406,663,257,249.0,443.0,194.0,2283333.0,1240000.0,-1043333.0
browc003,Corey Brown,Oakland Athletics,ATLTCS,1,2,1,3,2010,2011,1,-0.11,2.27,2.38,253,136,-117,47,563,516,339.0,0.0,-339.0,0.0,4600000.0,4600000.0
browc102,Curtis Brown,New York Mets,METS,1,4,1,5,1971,1974,3,-0.13,-1.66,-1.53,1,64,63,4,139,135,0.0,0.0,0.0,0.0,0.0,0.0
browc103,Clint Brown,Chicago White Sox,WSOX,1,1,1,2,1941,1945,4,0.77,8.14,7.37,96,244,148,20,301,281,250.0,2436.0,2186.0,0.0,0.0,0.0
browc105,Cal Browning,St. Louis Cardinals,CARDS,1,4,1,5,1960,1961,1,0.0,0.08,0.08,0,58,58,0,21,21,0.0,225.0,225.0,0.0,0.0,0.0
browd001,Darrell Brown,Detroit Tigers,TIGRS,1,3,2,5,1982,1982,0,-0.02,0.0,0.02,8,0,-8,20,0,-20,0.0,0.0,0.0,0.0,0.0,0.0
browd102,Dick Brown,Cleveland Indians,INDINS,6,11,11,22,1959,1968,9,95.02,18.27,-76.75,3674,1436,-2238,12659,5344,-7315,4502.0,50.0,-4452.0,0.0,32000.0,32000.0
browd102,Dick Brown,Milwaukee Braves,BRAVES,1,4,2,6,1960,1966,6,17.87,5.81,-12.06,1212,765,-447,3111,2935,-176,1033.0,0.0,-1033.0,0.0,0.0,0.0
browd102,Dick Brown,Detroit Tigers,TIGRS,3,5,6,11,1962,1970,8,33.85,17.8,-16.05,894,735,-159,1860,1781,-79,4562.0,2945.0,-1617.0,39000.0,0.0,-39000.0
browe001,Emil Brown,Pittsburgh Pirates,PIRATS,1,1,2,3,2001,2003,2,-0.2,0.0,0.2,13,0,-13,15,0,-15,0.0,0.0,0.0,265000.0,0.0,-265000.0
browe101,Elmer Brown,St.Louis Browns,ORLS,2,6,5,11,1912,1924,12,0.0,-0.88,-0.88,0,143,143,0,396,396,0.0,10.0,10.0,0.0,0.0,0.0
browe102,Eddie Brown,Indianapolis,Indianapolis,1,1,2,3,1924,1924,0,3.15,0.0,-3.15,267,0,-267,1155,0,-1155,0.0,0.0,0.0,0.0,5000.0,5000.0
browe102,Eddie Brown,Brooklyn Dodgers,DOGRS,2,5,4,9,1925,1927,2,6.65,0.24,-6.41,787,339,-448,3022,1227,-1795,0.0,0.0,0.0,27500.0,4800.0,-22700.0
browe102,Eddie Brown,New York Giants,GIANTS,1,5,1,6,1921,1924,3,0.0,-0.65,-0.65,0,89,89,0,166,166,0.0,0.0,0.0,1500.0,0.0,-1500.0
browe104,Earl Browne,Pittsburgh Pirates,PIRATS,2,2,2,4,1937,1942,5,0.24,3.74,3.5,126,336,210,440,322,-118,0.0,1889.0,1889.0,0.0,0.0,0.0
browf102,Frank Brower,Washington Senators,TWINS,1,1,1,2,1923,1924,1,4.25,-0.16,-4.41,196,106,-90,615,421,-194,26.0,0.0,-26.0,0.0,0.0,0.0
browf102,Frank Brower,Reading,Reading,1,1,2,3,1920,1920,0,3.18,0.0,-3.18,258,0,-258,916,0,-916,0.0,0.0,0.0,0.0,0.0,0.0
browg102,George Browne,New York Giants,GIANTS,4,11,6,17,1907,1921,14,45.64,34.38,-11.26,2445,1600,-845,8369,5323,-3046,1733.0,2915.0,1182.0,6400.0,5200.0,-1200.0
browh101,Hal Brown,Seattle,Seattle,1,2,4,6,1951,1954,3,0.74,0.0,-0.74,138,0,-138,86,0,-86,741.0,0.0,-741.0,0.0,0.0,0.0
browh101,Hal Brown,Chicago White Sox,WSOX,1,3,1,4,1953,1953,0,1.18,-0.21,-1.39,202,44,-158,118,143,25,1116.0,0.0,-1116.0,0.0,0.0,0.0
browh101,Hal Brown,Boston Red Sox,RSOX,1,2,2,4,1949,1950,1,0.0,-0.68,-0.68,0,28,28,0,12,12,0.0,68.0,68.0,0.0,0.0,0.0
browj001,Jerry Browne,Texas Rangers,RNGRS,1,3,1,4,1988,1993,5,6.72,20.24,13.52,624,632,8,2545,2680,135,0.0,0.0,0.0,930000.0,975000.0,45000.0
browj003,Jim Brower,Cleveland Indians,INDINS,1,2,1,3,2000,2002,2,2.43,-0.3,-2.73,134,52,-82,33,128,95,506.0,0.0,-506.0,0.0,1400000.0,1400000.0
browj003,Jim Brower,Cincinnati Reds,REDS,1,1,1,2,2002,2003,1,-0.01,-0.14,-0.13,60,78,18,5,4,-1,123.0,119.0,-4.0,250000.0,0.0,-250000.0
browj003,Jim Brower,Montreal Expos,NATEX,2,4,5,9,2003,2011,8,4.63,14.95,10.32,424,496,72,130,594,464,1491.0,3711.0,2220.0,8000000.0,0.0,-8000000.0
browj003,Jim Brower,San Diego Padres,PADRS,1,1,1,2,2006,2006,0,0.0,0.0,0.0,0,0,0,0,0,0,0.0,0.0,0.0,0.0,0.0,0.0
browj004,Jamie Brown,Cleveland Indians,INDINS,1,1,1,2,2003,2003,0,-0.08,0.2,0.28,4,32,28,0,80,80,23.0,0.0,-23.0,0.0,0.0,0.0
browj102,Joe Brown,OklahomaCity,OklahomaCity,1,2,1,3,1924,1924,0,0.53,0.0,-0.53,98,0,-98,46,0,-46,457.0,0.0,-457.0,0.0,2400.0,2400.0
browj105,Jake Brown,San Francisco Giants,GIANTS,2,5,3,8,1976,1983,7,-0.82,27.35,28.17,287,1701,1414,1089,6469,5380,0.0,0.0,0.0,0.0,0.0,0.0
browj108,Jim Brown,Harrisburg,Harrisburg,1,1,1,2,1916,1919,3,0.1,0.0,-0.1,14,0,-14,49,0,-49,0.0,0.0,0.0,0.0,0.0,0.0
browj109,Jackie Brown,Texas Rangers,RNGRS,2,5,3,8,1975,1978,3,27.68,13.0,-14.68,537,88,-449,186,0,-186,7504.0,2017.0,-5487.0,60000.0,160000.0,100000.0
browj109,Jackie Brown,Cleveland Indians,INDINS,1,1,1,2,1976,1987,11,-0.41,19.05,19.46,84,1225,1141,61,5096,5035,557.0,0.0,-557.0,0.0,0.0,0.0
browj110,Jumbo Brown,New York Giants,GIANTS,1,2,1,3,1941,1941,0,0.0,0.38,0.38,0,4,4,0,6,6,0.0,46.0,46.0,0.0,0.0,0.0
browk001,Kevin Brown,Florida Marlins,MARLNS,16,30,39,69,1997,2019,22,140.21,119.59,-20.62,4768,6251,1483,12938,20835,7897,15799.0,8180.0,-7619.0,60053667.0,23843092.0,-36210575.0
browk001,Kevin Brown,Los Angeles Dodgers,DOGRS,1,1,4,5,2003,2009,6,2.4,4.02,1.62,36,367,331,2,159,157,616.0,1677.0,1061.0,15714286.0,4150000.0,-11564286.0
browk003,Kevin Brown,Atlanta Braves,BRAVES,1,1,1,2,1987,1989,2,0.06,-0.65,-0.71,4,93,89,0,242,242,6.0,3.0,-3.0,0.0,0.0,0.0
browk003,Kevin Brown,New York Mets,METS,1,2,2,4,1990,1993,3,2.61,2.24,-0.37,84,232,148,0,659,659,559.0,0.0,-559.0,200000.0,150000.0,-50000.0
browk004,Kevin Brown,Texas Rangers,RNGRS,1,1,1,2,1998,2001,3,0.48,2.76,2.28,54,234,180,137,1,-136,0.0,762.0,762.0,0.0,0.0,0.0
browk004,Kevin Brown,Toronto Blue Jays,BJAYS,1,1,1,2,2000,2000,0,0.07,0.0,-0.07,22,0,-22,64,0,-64,0.0,0.0,0.0,0.0,0.0,0.0
browl101,Lloyd Brown,Washington Senators,TWINS,3,6,5,11,1932,1936,4,25.58,12.35,-13.23,1434,628,-806,5873,2235,-3638,390.0,1249.0,859.0,38000.0,36200.0,-1800.0
browl101,Lloyd Brown,St.Louis Browns,ORLS,2,3,3,6,1933,1935,2,12.74,1.35,-11.39,735,162,-573,2638,528,-2110,489.0,0.0,-489.0,13500.0,10850.0,-2650.0
browl101,Lloyd Brown,Boston Red Sox,RSOX,4,5,5,10,1933,1943,10,28.33,10.21,-18.12,1088,690,-398,3483,1043,-2440,1883.0,3526.0,1643.0,22500.0,28500.0,6000.0
browl103,Leon Brown,San Francisco Giants,GIANTS,1,1,1,2,1976,1976,0,-0.35,0.0,0.35,64,0,-64,74,0,-74,0.0,0.0,0.0,0.0,0.0,0.0
browl103,Leon Brown,New York Mets,METS,1,2,1,3,1976,1976,0,0.0,0.0,0.0,0,0,0,0,0,0,0.0,0.0,0.0,0.0,0.0,0.0
browl105,Lindsay Brown,Detroit Tigers,TIGRS,1,2,1,3,1937,1937,0,-0.42,0.0,0.42,48,0,-48,121,0,-121,0.0,0.0,0.0,0.0,0.0,0.0
browm001,Mark Brown,Baltimore Orioles,ORLS,2,3,2,5,1985,1988,3,2.81,0.55,-2.26,479,151,-328,1461,0,-1461,182.0,590.0,408.0,300000.0,731250.0,431250.0
browm002,Mike Brown,California Angels,ANGELS,2,4,5,9,1985,1988,3,1.4,3.61,2.21,825,316,-509,630,678,48,1883.0,911.0,-972.0,800000.0,0.0,-800000.0
browm003,Mike Brown,Seattle Mariners,MARNRS,1,1,1,2,1987,1987,0,0.0,0.0,0.0,0,0,0,0,0,0,0.0,0.0,0.0,0.0,0.0,0.0
browm003,Mike Brown,Boston Red Sox,RSOX,3,7,5,12,1986,1993,7,7.37,8.49,1.12,984,1130,146,3351,3154,-197,369.0,1455.0,1086.0,1275000.0,132500.0,-1142500.0
browm102,Mordecai Brown,St. Louis Cardinals,CARDS,4,6,9,15,1903,1914,11,50.1,19.67,-30.43,1069,1341,272,1762,4083,2321,8426.0,5469.0,-2957.0,2400.0,3300.0,900.0
browm102,Mordecai Brown,Louisville,Louisville,1,1,1,2,1913,1921,8,1.62,0.0,-1.62,78,0,-78,58,0,-58,500.0,0.0,-500.0,0.0,0.0,0.0
browm103,Mace Brown,Brooklyn Dodgers,DOGRS,2,3,2,5,1941,1948,7,4.66,22.35,17.69,178,627,449,598,2568,1970,0.0,0.0,0.0,0.0,0.0,0.0
brown101,Norm Brown,Boston Red Sox,RSOX,1,2,2,4,1943,1943,0,-0.43,0.0,0.43,10,0,-10,3,0,-3,43.0,0.0,-43.0,0.0,9500.0,9500.0
browo102,Ollie Brown,San Diego Padres,PADRS,3,3,5,8,1972,1972,0,2.68,-0.33,-3.01,590,123,-467,1233,221,-1012,180.0,13.0,-167.0,36000.0,31000.0,-5000.0
browo102,Ollie Brown,Milwaukee Brewers,BREWRS,3,7,7,14,1973,1978,5,7.23,1.8,-5.43,546,209,-337,1533,327,-1206,524.0,1634.0,1110.0,168301.0,15000.0,-153301.0
browr001,Roosevelt Brown,Atlanta Braves,BRAVES,1,1,1,2,1996,1996,0,0.0,-1.29,-1.29,0,42,42,0,177,177,0.0,0.0,0.0,0.0,1625000.0,1625000.0
brows002,Scott Brow,Arizona Diamondbacks,DBACKS,1,2,1,3,1998,1998,0,0.0,0.27,0.27,0,64,64,0,1,1,0.0,131.0,131.0,225000.0,342500.0,117500.0
brows101,Scott Brown,Cincinnati Reds,REDS,1,1,1,2,1981,1982,1,0.0,-0.43,-0.43,0,19,19,0,37,37,0.0,0.0,0.0,0.0,0.0,0.0
brows103,Sam Brown,Toledo,Toledo,1,1,1,2,1905,1905,0,0.19,0.0,-0.19,141,0,-141,489,0,-489,0.0,0.0,0.0,0.0,0.0,0.0
browt102,Tom Brown,Louisville Colonels,LS3,1,1,1,2,1895,1895,0,-0.94,-0.52,0.42,84,113,29,407,511,104,0.0,0.0,0.0,0.0,0.0,0.0
browt103,Tommy Brown,Brooklyn Dodgers,DOGRS,1,1,2,3,1951,1951,0,-0.41,0.0,0.41,96,0,-96,243,0,-243,0.0,0.0,0.0,9000.0,10000.0,1000.0
broxj001,Jonathan Broxton,Kansas City Royals,ROYALS,1,1,2,3,2012,2014,2,1.66,0.16,-1.5,219,7,-212,0,0,0,304.0,19.0,-285.0,4000000.0,0.0,-4000000.0
broxj001,Jonathan Broxton,Cincinnati Reds,REDS,1,1,2,3,2014,2018,4,-0.55,-0.21,0.34,98,61,-37,0,4,4,141.0,116.0,-25.0,0.0,0.0,0.0
broxj001,Jonathan Broxton,Milwaukee Brewers,BREWRS,1,2,1,3,2015,2015,0,0.24,0.0,-0.24,219,0,-219,0,0,0,300.0,0.0,-300.0,0.0,0.0,0.0
broxk001,Keon Broxton,Pittsburgh Pirates,PIRATS,1,2,1,3,2015,2017,2,4.25,-0.14,-4.39,269,23,-246,796,33,-763,0.0,0.0,0.0,0.0,507500.0,507500.0
broxk001,Keon Broxton,Milwaukee Brewers,BREWRS,2,3,4,7,2019,2021,2,-0.49,-0.15,0.34,34,3,-31,53,0,-53,0.0,7.0,7.0,0.0,581200.0,581200.0
broxk001,Keon Broxton,New York Mets,METS,1,1,1,2,2019,2019,0,0.12,0.0,-0.12,37,0,-37,112,0,-112,0.0,0.0,0.0,571765.0,0.0,-571765.0
brubb102,Bruce Brubaker,Milwaukee Braves,BRAVES,5,10,5,15,1963,1983,20,3.41,33.61,30.2,551,1293,742,1018,2898,1880,1041.0,6668.0,5627.0,33500.0,0.0,-33500.0
brubb102,Bruce Brubaker,Los Angeles Dodgers,DOGRS,1,1,1,2,1970,1970,0,-0.04,-0.2,-0.16,2,6,4,0,1,1,6.0,20.0,14.0,0.0,0.0,0.0
brucb101,Bob Bruce,Detroit Tigers,TIGRS,1,2,1,3,1961,1962,1,12.08,0.99,-11.09,318,60,-258,331,21,-310,2721.0,244.0,-2477.0,0.0,0.0,0.0
brucb101,Bob Bruce,Houston Astros,ASTROS,4,6,8,14,1966,1973,7,0.01,-1.36,-1.37,310,801,491,266,544,278,544.0,2019.0,1475.0,57500.0,75500.0,18000.0
brucj001,Jay Bruce,Cincinnati Reds,REDS,1,1,2,3,2016,2018,2,1.81,-0.19,-2.0,247,53,-194,996,97,-899,0.0,0.0,0.0,0.0,0.0,0.0
brucj001,Jay Bruce,New York Mets,METS,2,2,2,4,2017,2021,4,0.26,0.14,-0.12,43,15,-28,169,51,-118,0.0,3.0,3.0,13000000.0,3500000.0,-9500000.0
brucj001,Jay Bruce,New York Mets,METS,1,5,3,8,2018,2018,0,-0.49,0.0,0.49,191,0,-191,565,0,-565,376.0,0.0,-376.0,16500000.0,12258065.0,-4241935.0
brucj001,Jay Bruce,Seattle Mariners,MARNRS,1,2,1,3,2019,2019,0,0.59,0.0,-0.59,83,0,-83,252,0,-252,0.0,0.0,0.0,14000000.0,0.0,-14000000.0
brucl101,Lou Bruce,Toronto,Toronto,1,1,2,3,1903,1903,0,-0.22,0.0,0.22,32,0,-32,111,0,-111,33.0,0.0,-33.0,0.0,0.0,0.0
brugf101,Frank Bruggy,Portland,Portland,1,1,3,4,1922,1922,0,-0.89,0.0,0.89,157,0,-157,354,0,-354,0.0,0.0,0.0,0.0,2500.0,2500.0
brugf101,Frank Bruggy,Buffalo,Buffalo,1,1,1,2,1921,1921,0,0.6,0.0,-0.6,96,0,-96,306,0,-306,0.0,0.0,0.0,0.0,0.0,0.0
brugj001,Jaycob Brugman,Oakland Athletics,ATLTCS,1,1,1,2,2017,2017,0,0.0,0.0,0.0,0,0,0,0,0,0,0.0,0.0,0.0,0.0,0.0,0.0
bruhm101,Mike Bruhert,New York Mets,METS,1,2,1,3,1979,1979,0,0.0,-1.27,-1.27,0,34,34,0,28,28,0.0,255.0,255.0,0.0,0.0,0.0
brumd001,Duff Brumley,St. Louis Cardinals,CARDS,1,1,1,2,1993,1993,0,-0.16,-0.68,-0.52,2,48,46,0,4,4,10.0,92.0,82.0,0.0,575000.0,575000.0
brumg002,Greg Brummett,San Francisco Giants,GIANTS,1,3,1,4,1993,1993,0,0.3,-0.08,-0.38,64,10,-54,0,6,6,230.0,51.0,-179.0,109000.0,700000.0,591000.0
brumj001,Jacob Brumfield,Cincinnati Reds,REDS,2,3,2,5,1994,1995,1,-0.31,-0.17,0.14,158,12,-146,560,2,-558,0.0,29.0,29.0,170000.0,0.0,-170000.0
brumj001,Jacob Brumfield,Pittsburgh Pirates,PIRATS,1,1,1,2,1996,1996,0,0.55,0.0,-0.55,210,0,-210,726,0,-726,0.0,0.0,0.0,350000.0,0.0,-350000.0
brumm001,Mike Brumley,Boston Red Sox,RSOX,1,2,1,3,1984,1987,3,10.18,-0.52,-10.7,204,504,300,312,2176,1864,1592.0,0.0,-1592.0,0.0,0.0,0.0
brumm001,Mike Brumley,Chicago Cubs,CUBS,2,3,4,7,1988,1989,1,-1.95,-0.22,1.73,155,94,-61,562,6,-556,188.0,131.0,-57.0,0.0,0.0,0.0
brumm001,Mike Brumley,San Diego Padres,PADRS,9,19,22,41,1989,2006,17,9.82,50.98,41.16,3305,4375,1070,10872,14969,4097,712.0,1706.0,994.0,13757500.0,22894000.0,9136500.0
brumm001,Mike Brumley,Detroit Tigers,TIGRS,1,1,1,2,1990,1990,0,0.0,-1.02,-1.02,0,131,131,0,390,390,0.0,0.0,0.0,0.0,0.0,0.0
brunb001,Brian Bruney,New York Yankees,YANKS,1,1,1,2,2009,2010,1,-0.85,0.0,0.85,38,0,-38,0,0,0,53.0,0.0,-53.0,1250000.0,0.0,-1250000.0
brune001,Eric Bruntlett,Houston Astros,ASTROS,5,17,11,28,2007,2020,13,26.64,22.25,-4.39,2124,1522,-602,3444,4092,648,4062.0,2080.0,-1982.0,15247800.0,20847915.0,5600115.0
brung101,George Brunet,Kansas City Athletics,ATLTCS,1,1,1,2,1960,1960,0,-0.66,-0.05,0.61,44,20,-24,11,2,-9,164.0,56.0,-108.0,0.0,0.0,0.0
brung101,George Brunet,Milwaukee Braves,BRAVES,1,1,1,2,1962,1962,0,-0.49,0.0,0.49,44,0,-44,22,0,-22,200.0,0.0,-200.0,0.0,0.0,0.0
brung101,George Brunet,Milwaukee Brewers,BREWRS,1,1,1,2,1969,1971,2,-0.24,1.04,1.28,48,56,8,44,2,-42,354.0,106.0,-248.0,35000.0,14000.0,-21000.0
brung101,George Brunet,Washington Senators,RNGRS,16,35,25,60,1970,1988,18,48.97,50.37,1.4,3039,3300,261,9915,9913,-2,4425.0,6857.0,2432.0,559500.0,301000.0,-258500.0
brung101,George Brunet,Pittsburgh Pirates,PIRATS,4,6,8,14,1971,1978,7,4.65,9.98,5.33,393,854,461,1279,1834,555,673.0,1651.0,978.0,94500.0,49000.0,-45500.0
brunt001,Tom Brunansky,California Angels,ANGELS,1,3,2,5,1982,1987,5,16.27,3.87,-12.4,962,569,-393,3760,1197,-2563,264.0,852.0,588.0,0.0,0.0,0.0
brunt001,Tom Brunansky,Minnesota Twins,TWINS,2,4,3,7,1988,1989,1,5.46,1.87,-3.59,624,113,-511,2491,345,-2146,0.0,435.0,435.0,1243500.0,1775000.0,531500.0
brunt001,Tom Brunansky,St. Louis Cardinals,CARDS,3,5,5,10,1990,1997,7,3.57,2.86,-0.71,890,643,-247,2470,186,-2284,209.0,991.0,782.0,9134167.0,3450000.0,-5684167.0
brunt001,Tom Brunansky,Milwaukee Brewers,BREWRS,1,1,1,2,1994,1994,0,0.23,0.5,0.27,48,16,-32,204,46,-158,0.0,0.0,0.0,1100000.0,1200000.0,100000.0
brunt101,Tom Bruno,Toronto Blue Jays,BJAYS,1,2,1,3,1978,1981,3,1.48,1.94,0.46,90,376,286,20,1522,1502,264.0,0.0,-264.0,0.0,0.0,0.0
brunw001,Will Brunson,Cincinnati Reds,REDS,1,1,1,2,1994,1995,1,-0.13,0.0,0.13,3,0,-3,0,0,0,7.0,0.0,-7.0,0.0,0.0,0.0
brusj001,Jim Bruske,Los Angeles Dodgers,DOGRS,1,1,1,2,1998,1998,0,-0.02,0.0,0.02,8,0,-8,0,0,0,21.0,0.0,-21.0,200000.0,0.0,-200000.0
brusj001,Jim Bruske,San Diego Padres,PADRS,1,2,2,4,1998,1998,0,0.16,0.0,-0.16,3,0,-3,0,0,0,27.0,0.0,-27.0,0.0,0.0,0.0
brusw001,Warren Brusstar,Chicago White Sox,WSOX,4,9,10,19,1983,1991,8,34.9,10.9,-24.0,2508,1101,-1407,7089,2979,-4110,3712.0,567.0,-3145.0,640000.0,879873.0,239873.0
brutb101,Bill Bruton,Milwaukee Braves,BRAVES,1,4,2,6,1960,1966,6,17.87,5.81,-12.06,1212,765,-447,3111,2935,-176,1033.0,0.0,-1033.0,0.0,0.0,0.0
bryab101,Billy Bryan,Kansas City Athletics,ATLTCS,2,3,5,8,1966,1967,1,5.45,-1.25,-6.7,785,201,-584,1910,500,-1410,1121.0,300.0,-821.0,25000.0,30000.0,5000.0
bryad101,Don Bryant,Chicago Cubs,CUBS,1,1,1,2,1967,1967,0,0.0,0.01,0.01,0,2,2,0,7,7,0.0,0.0,0.0,0.0,0.0,0.0
bryak001,Kris Bryant,Chicago Cubs,CUBS,1,1,2,3,2021,2021,0,1.09,0.0,-1.09,51,0,-51,212,0,-212,0.0,0.0,0.0,19500000.0,0.0,-19500000.0
bryar101,Ron Bryant,San Francisco Giants,GIANTS,2,2,4,6,1975,1983,8,10.37,1.91,-8.46,863,740,-123,3014,2323,-691,26.0,218.0,192.0,0.0,0.0,0.0
buchb001,Bob Buchanan,Cincinnati Reds,REDS,1,1,1,2,1985,1987,2,0.0,0.0,0.0,0,0,0,0,0,0,0.0,0.0,0.0,0.0,0.0,0.0
buchb002,Brian Buchanan,New York Yankees,YANKS,1,5,1,6,1998,2001,3,22.8,7.48,-15.32,1163,539,-624,4014,2478,-1536,2978.0,0.0,-2978.0,0.0,0.0,0.0
buchb002,Brian Buchanan,Minnesota Twins,TWINS,4,7,8,15,2002,2015,13,34.26,8.74,-25.52,1781,1170,-611,6426,4254,-2172,1777.0,138.0,-1639.0,12555000.0,1726100.0,-10828900.0
buchc001,Clay Buchholz,Boston Red Sox,RSOX,1,1,1,2,2016,2016,0,-0.41,0.0,0.41,4,0,-4,2,0,-2,22.0,0.0,-22.0,13000000.0,0.0,-13000000.0
buchj101,Jim Bucher,Brooklyn Dodgers,DOGRS,1,4,1,5,1937,1944,7,1.9,1.11,-0.79,125,343,218,330,1190,860,390.0,0.0,-390.0,10000.0,10000.0,0.0
buchj102,Jerry Buchek,St. Louis Cardinals,CARDS,1,3,3,6,1967,1967,0,-0.52,-0.9,-0.38,197,52,-145,651,76,-575,0.0,0.0,0.0,0.0,0.0,0.0
buchj102,Jerry Buchek,New York Mets,METS,1,1,1,2,1968,1969,1,0.0,0.0,0.0,0,0,0,0,0,0,0.0,0.0,0.0,0.0,0.0,0.0
buchj102,Jerry Buchek,St. Louis Cardinals,CARDS,1,2,1,3,1969,1969,0,-0.33,0.06,0.39,57,49,-8,101,68,-33,0.0,0.0,0.0,0.0,0.0,0.0
buchj104,Johnny Bucha,Detroit Tigers,TIGRS,5,14,10,24,1954,1961,7,12.9,0.88,-12.02,615,749,134,406,2092,1686,3228.0,40.0,-3188.0,13200.0,8000.0,-5200.0
buchr001,Ryan Buchter,Chicago Cubs,CUBS,1,1,1,2,2011,2012,1,0.09,-0.51,-0.6,2,59,57,0,33,33,3.0,312.0,309.0,0.0,0.0,0.0
buchr001,Ryan Buchter,Washington Nationals,NATEX,1,1,1,2,2008,2008,0,0.0,0.0,0.0,0,0,0,0,0,0,0.0,0.0,0.0,0.0,0.0,0.0
buchr001,Ryan Buchter,San Diego Padres,PADRS,1,3,4,7,2017,2017,0,-1.51,-0.81,0.7,107,22,-85,1,17,16,304.0,157.0,-147.0,4194700.0,538900.0,-3655800.0
buchr001,Ryan Buchter,Kansas City Royals,ROYALS,1,3,2,5,2018,2021,3,1.28,0.62,-0.66,124,62,-62,0,5,5,254.0,390.0,136.0,0.0,0.0,0.0
bucht001,Taylor Buchholz,Philadelphia Phillies,PHILS,1,3,1,4,2003,2005,2,-3.72,3.94,7.66,149,236,87,71,5,-66,766.0,378.0,-388.0,325000.0,8000000.0,7675000.0
bucht001,Taylor Buchholz,Houston Astros,ASTROS,1,3,2,5,2006,2007,1,4.59,-0.73,-5.32,489,38,-451,1012,30,-982,873.0,297.0,-576.0,727000.0,4500000.0,3773000.0
buckb001,Bill Buckner,Los Angeles Dodgers,DOGRS,2,4,4,8,1977,1984,7,15.47,7.3,-8.17,1806,765,-1041,7323,1796,-5527,184.0,243.0,59.0,0.0,0.0,0.0
buckb001,Bill Buckner,Chicago Cubs,CUBS,4,6,9,15,1984,1989,5,12.74,9.96,-2.78,1223,298,-925,2786,318,-2468,2099.0,1723.0,-376.0,0.0,0.0,0.0
buckb002,Billy Buckner,Kansas City Royals,ROYALS,3,3,4,7,2007,2014,7,7.4,4.46,-2.94,829,510,-319,1649,1790,141,766.0,756.0,-10.0,460000.0,2380000.0,1920000.0
buckb002,Billy Buckner,Arizona Diamondbacks,DBACKS,1,1,2,3,2010,2010,0,0.0,-0.24,-0.24,0,11,11,0,6,6,0.0,67.0,67.0,0.0,12000000.0,12000000.0
buckj001,John Buck,Houston Astros,ASTROS,1,3,1,4,2004,2004,0,2.27,4.49,2.22,611,90,-521,2116,399,-1717,69.0,0.0,-69.0,2800000.0,9000000.0,6200000.0
buckj001,John Buck,Miami Marlins,MARLNS,12,33,32,65,2012,2020,8,57.99,24.95,-33.04,3997,2605,-1392,9990,7444,-2546,7539.0,4278.0,-3261.0,66200000.0,34658100.0,-31541900.0
buckj001,John Buck,Toronto Blue Jays,BJAYS,1,4,3,7,2012,2016,4,18.37,4.87,-13.5,742,311,-431,2152,493,-1659,2154.0,2473.0,319.0,0.0,5229800.0,5229800.0
buckj001,John Buck,New York Mets,METS,4,7,5,12,2013,2021,8,1.02,3.24,2.22,135,327,192,405,855,450,0.0,146.0,146.0,13000000.0,3500000.0,-9500000.0
buckk001,Kevin Buckley,Texas Rangers,RNGRS,1,1,1,2,1985,1986,1,0.0,0.0,0.0,0,0,0,0,0,0,0.0,0.0,0.0,0.0,0.0,0.0
buddd101,Don Buddin,Boston Red Sox,RSOX,5,8,7,15,1961,1968,7,24.82,15.47,-9.35,1128,791,-337,3147,2614,-533,3084.0,1094.0,-1990.0,44500.0,42000.0,-2500.0
budnm101,Mike Budnick,New York Giants,GIANTS,1,4,1,5,1947,1953,6,0.0,-0.83,-0.83,0,19,19,0,46,46,0.0,19.0,19.0,0.0,0.0,0.0
buecs001,Steve Buechele,Texas Rangers,RNGRS,3,4,4,8,1991,1996,5,4.84,-0.13,-4.97,718,182,-536,478,171,-307,1163.0,627.0,-536.0,884000.0,890000.0,6000.0
buecs001,Steve Buechele,Pittsburgh Pirates,PIRATS,1,1,1,2,1992,1992,0,3.16,0.25,-2.91,334,30,-304,1290,30,-1260,0.0,265.0,265.0,2600000.0,2625000.0,25000.0
buehm001,Mark Buehrle,Miami Marlins,MARLNS,12,33,32,65,2012,2020,8,57.99,24.95,-33.04,3997,2605,-1392,9990,7444,-2546,7539.0,4278.0,-3261.0,66200000.0,34658100.0,-31541900.0
buelf101,Fritz Buelow,Cleveland Indians,INDINS,2,3,2,5,1907,1907,0,0.08,0.51,0.43,65,55,-10,229,206,-23,0.0,0.0,0.0,0.0,0.0,0.0
buesa101,Art Bues,Boston Braves,BRAVES,1,1,1,2,1913,1915,2,0.0,1.2,1.2,0,246,246,0,860,860,0.0,0.0,0.0,1800.0,0.0,-1800.0
bufod001,Damon Buford,Baltimore Orioles,ORLS,1,2,2,4,1995,1996,1,2.13,2.23,0.1,250,220,-30,767,956,189,0.0,0.0,0.0,0.0,5300000.0,5300000.0
bufod001,Damon Buford,New York Mets,METS,1,1,1,2,1996,1996,0,0.64,0.0,-0.64,212,0,-212,566,0,-566,0.0,0.0,0.0,0.0,0.0,0.0
bufod001,Damon Buford,Texas Rangers,RNGRS,1,2,3,5,1997,1999,2,2.88,7.0,4.12,229,110,-119,721,120,-601,0.0,1253.0,1253.0,225000.0,1963500.0,1738500.0
bufod001,Damon Buford,Boston Red Sox,RSOX,1,1,1,2,1999,2000,1,0.18,-0.72,-0.9,185,101,-84,645,209,-436,0.0,0.0,0.0,1100000.0,475000.0,-625000.0
bufod101,Don Buford,Chicago White Sox,WSOX,6,9,10,19,1967,1977,10,29.24,13.29,-15.95,1920,1924,4,6795,7037,242,306.0,62.0,-244.0,134800.0,182000.0,47200.0
buhlb101,Bob Buhl,Milwaukee Braves,BRAVES,4,6,7,13,1962,1966,4,5.98,3.18,-2.8,385,443,58,640,729,89,2572.0,227.0,-2345.0,0.0,0.0,0.0
buhlb101,Bob Buhl,Chicago Cubs,CUBS,10,15,17,32,1966,1982,16,38.97,72.32,33.35,1515,3517,2002,3549,10033,6484,7048.0,7391.0,343.0,430000.0,24000.0,-406000.0
buhnj001,Jay Buhner,Pittsburgh Pirates,PIRATS,1,3,3,6,1984,1986,2,0.69,0.08,-0.61,132,124,-8,338,327,-11,92.0,0.0,-92.0,0.0,1340000.0,1340000.0
buhnj001,Jay Buhner,New York Yankees,YANKS,2,4,2,6,1988,1989,1,22.92,1.01,-21.91,1483,131,-1352,5913,342,-5571,0.0,0.0,0.0,722000.0,670000.0,-52000.0
buicd001,DeWayne Buice,California Angels,ANGELS,1,1,1,2,1989,1992,3,-0.3,0.42,0.72,7,28,21,0,0,0,51.0,130.0,79.0,0.0,0.0,0.0
bukaj001,J.B. Bukauskas,Houston Astros,ASTROS,1,4,2,6,2019,2021,2,-0.93,3.35,4.28,254,54,-200,791,4,-787,100.0,902.0,802.0,0.0,34500000.0,34500000.0
bukvr001,Ryan Bukvich,Kansas City Royals,ROYALS,1,2,3,5,2004,2005,1,-0.35,0.13,0.48,40,137,97,10,489,479,178.0,0.0,-178.0,1750000.0,3575000.0,1825000.0
bulgj001,Jason Bulger,Arizona Diamondbacks,DBACKS,3,3,4,7,2006,2010,4,5.39,-2.74,-8.13,442,146,-296,1241,238,-1003,369.0,380.0,11.0,380000.0,12000000.0,11620000.0
bulle001,Eric Bullock,Houston Astros,ASTROS,1,1,1,2,1987,1987,0,0.12,0.0,-0.12,16,0,-16,20,0,-20,0.0,0.0,0.0,0.0,0.0,0.0
bulle001,Eric Bullock,Minnesota Twins,TWINS,1,3,2,5,1988,1989,1,2.78,0.41,-2.37,304,27,-277,1185,0,-1185,0.0,435.0,435.0,103500.0,900000.0,796500.0
bullj001,Jim Bullinger,Chicago White Sox,WSOX,1,1,1,2,1998,1998,0,-0.34,0.0,0.34,2,0,-2,0,0,0,17.0,0.0,-17.0,0.0,0.0,0.0
bullk001,Kirk Bullinger,St. Louis Cardinals,CARDS,2,4,4,8,1995,1998,3,0.65,-1.89,-2.54,140,207,67,86,512,426,308.0,331.0,23.0,4525000.0,0.0,-4525000.0
bulls001,Scott Bullett,Pittsburgh Pirates,PIRATS,1,1,1,2,1994,1994,0,0.3,0.0,-0.3,213,0,-213,341,0,-341,0.0,0.0,0.0,0.0,0.0,0.0
bumpn001,Nate Bump,San Francisco Giants,GIANTS,2,5,3,8,1999,2005,6,17.71,7.22,-10.49,680,557,-123,659,309,-350,4495.0,2909.0,-1586.0,0.0,1875000.0,1875000.0
buncm001,Melvin Bunch,Kansas City Royals,ROYALS,1,1,1,2,1997,1997,0,0.0,0.35,0.35,0,53,53,0,204,204,0.0,0.0,0.0,0.0,0.0,0.0
bundd001,Dylan Bundy,Baltimore Orioles,ORLS,1,1,4,5,2019,2019,0,1.39,0.0,-1.39,37,0,-37,4,0,-4,469.0,0.0,-469.0,2800000.0,0.0,-2800000.0
bunnj101,Jim Bunning,Detroit Tigers,TIGRS,2,4,4,8,1963,1970,7,32.41,16.87,-15.54,651,629,-22,1145,1412,267,4562.0,2945.0,-1617.0,39000.0,0.0,-39000.0
bunnj101,Jim Bunning,Philadelphia Phillies,PHILS,4,8,10,18,1967,1979,12,29.8,35.32,5.52,1773,1867,94,5720,5488,-232,3305.0,6584.0,3279.0,74500.0,80800.0,6300.0
bunnj101,Jim Bunning,Pittsburgh Pirates,PIRATS,1,1,3,4,1969,1973,4,0.15,0.16,0.01,18,6,-12,21,9,-12,169.0,0.0,-169.0,75000.0,0.0,-75000.0
burbb101,Bill Burbach,New York Yankees,YANKS,1,1,1,2,1971,1972,1,0.0,-0.56,-0.56,0,24,24,0,4,4,0.0,85.0,85.0,13000.0,27000.0,14000.0
burbb101,Bill Burbach,Baltimore Orioles,ORLS,1,1,1,2,1972,1972,0,0.0,0.0,0.0,0,0,0,0,0,0,0.0,0.0,0.0,0.0,0.0,0.0
burbd001,Dave Burba,Seattle Mariners,MARNRS,2,4,3,7,1991,1993,2,19.75,1.34,-18.41,1114,134,-980,1118,402,-716,2994.0,104.0,-2890.0,5400000.0,4950000.0,-450000.0
burbd001,Dave Burba,San Francisco Giants,GIANTS,3,5,8,13,1995,1998,3,9.99,0.74,-9.25,311,256,-55,447,555,108,1958.0,96.0,-1862.0,5827778.0,4116667.0,-1711111.0
burbd001,Dave Burba,Cincinnati Reds,REDS,4,6,4,10,1998,2010,12,10.01,17.06,7.05,225,1137,912,273,4616,4343,2499.0,133.0,-2366.0,9600000.0,735000.0,-8865000.0
burbd001,Dave Burba,Milwaukee Brewers,BREWRS,1,1,1,2,2004,2004,0,0.01,0.0,-0.01,12,0,-12,1,0,-1,19.0,0.0,-19.0,440000.0,0.0,-440000.0
burcf101,Fred Burchell,Baltimore,Baltimore,1,1,2,3,1907,1908,1,0.37,0.0,-0.37,87,0,-87,96,0,-96,725.0,0.0,-725.0,0.0,0.0,0.0
burdb102,Bob Burda,St. Louis Cardinals,CARDS,1,1,1,2,1963,1963,0,0.0,0.0,0.0,0,0,0,0,0,0,0.0,0.0,0.0,0.0,0.0,0.0
burdb102,Bob Burda,Pittsburgh Pirates,PIRATS,1,2,1,3,1965,1965,0,0.03,0.41,0.38,287,60,-227,312,157,-155,304.0,0.0,-304.0,0.0,0.0,0.0
burdb102,Bob Burda,Milwaukee Brewers,BREWRS,1,1,1,2,1971,1971,0,0.23,0.0,-0.23,65,0,-65,83,0,-83,0.0,0.0,0.0,0.0,0.0,0.0
burdb102,Bob Burda,St. Louis Cardinals,CARDS,2,3,2,5,1972,1972,0,-0.78,-0.15,0.63,52,17,-35,91,13,-78,0.0,0.0,0.0,24000.0,0.0,-24000.0
burdl101,Lew Burdette,New York Yankees,YANKS,2,4,3,7,1951,1955,4,31.53,5.62,-25.91,1224,273,-951,1581,188,-1393,8049.0,1370.0,-6679.0,20000.0,0.0,-20000.0
burdl101,Lew Burdette,Milwaukee Braves,BRAVES,7,12,11,23,1963,1968,5,0.46,3.02,2.56,765,1080,315,1175,2207,1032,1041.0,1768.0,727.0,15000.0,12500.0,-2500.0
burdl101,Lew Burdette,St. Louis Cardinals,CARDS,2,4,3,7,1964,1965,1,0.31,0.14,-0.17,71,26,-45,56,14,-42,454.0,133.0,-321.0,0.0,0.0,0.0
burdn001,Nick Burdi,Philadelphia Phillies,PHILS,1,1,1,2,2017,2017,0,-0.55,0.0,0.55,28,0,-28,0,0,0,37.0,0.0,-37.0,0.0,0.0,0.0
burga001,Ambiorix Burgos,Kansas City Royals,ROYALS,1,1,1,2,2006,2010,4,0.23,4.29,4.06,34,118,84,0,20,20,71.0,1888.0,1817.0,339500.0,327000.0,-12500.0
burgb101,Bill Burgo,Philadelphia Athletics,ATLTCS,1,5,1,6,1944,1946,2,0.0,1.19,1.19,0,162,162,0,669,669,0.0,0.0,0.0,3000.0,0.0,-3000.0
burge001,Enrique Burgos,Kansas City Royals,ROYALS,1,1,1,2,1995,1995,0,-0.29,-0.49,-0.2,10,22,12,0,38,38,25.0,0.0,-25.0,0.0,0.0,0.0
burgs101,Smoky Burgess,Chicago Cubs,CUBS,1,2,2,4,1951,1955,4,6.65,0.0,-6.65,713,1,-712,2114,1,-2113,0.0,0.0,0.0,12500.0,13250.0,750.0
burgs101,Smoky Burgess,Cincinnati Reds,REDS,8,16,22,38,1951,1965,14,82.9,22.04,-60.86,4576,2061,-2515,14654,4760,-9894,2749.0,1025.0,-1724.0,63000.0,63000.0,0.0
burgs101,Smoky Burgess,Philadelphia Phillies,PHILS,2,4,4,8,1955,1957,2,8.43,2.22,-6.21,540,413,-127,1547,1258,-289,90.0,0.0,-90.0,15500.0,13500.0,-2000.0
burgs101,Smoky Burgess,Cincinnati Reds,REDS,4,7,11,18,1959,1965,6,63.65,9.6,-54.05,3136,1073,-2063,9911,1717,-8194,2563.0,935.0,-1628.0,0.0,0.0,0.0
burgt001,Tom Burgmeier,Kansas City Royals,ROYALS,1,1,1,2,1973,1973,0,3.45,0.0,-3.45,221,0,-221,0,0,0,1140.0,0.0,-1140.0,0.0,0.0,0.0
burgt101,Tom Burgess,St. Louis Cardinals,CARDS,1,1,1,2,1959,1959,0,0.0,0.0,0.0,0,0,0,0,0,0,0.0,0.0,0.0,0.0,0.0,0.0
burgt101,Tom Burgess,Pittsburgh Pirates,PIRATS,2,2,3,5,1960,1962,2,-0.33,0.65,0.98,123,67,-56,369,216,-153,0.0,0.0,0.0,0.0,0.0,0.0
burkb001,Brock Burke,Tampa Bay Devil Rays,RAYS,2,4,5,9,2018,2020,2,-0.58,3.27,3.85,173,118,-55,2,160,158,374.0,210.0,-164.0,0.0,0.0,0.0
burkc001,Chris Burke,Houston Astros,ASTROS,1,3,1,4,2007,2009,2,-1.01,2.95,3.96,701,243,-458,203,1,-202,929.0,378.0,-551.0,856000.0,2000000.0,1144000.0
burke001,Ellis Burks,Colorado Rockies,ROCKS,3,4,7,11,1998,2000,2,9.55,0.76,-8.79,495,181,-314,1665,633,-1032,40.0,49.0,9.0,9563333.0,6500000.0,-3063333.0
burke101,Eddie Burke,Philadelphia Phillies,PHILS,1,3,1,4,1890,1890,0,-0.87,0.47,1.34,43,31,-12,162,139,-23,150.0,0.0,-150.0,0.0,0.0,0.0
burkg101,Glenn Burke,Los Angeles Dodgers,DOGRS,1,1,1,2,1978,1978,0,-1.4,1.8,3.2,101,110,9,311,377,66,0.0,0.0,0.0,0.0,0.0,0.0
burkj001,John Burkett,San Francisco Giants,GIANTS,1,1,2,3,1994,2003,9,5.31,16.23,10.92,108,993,885,10,3948,3938,1801.0,0.0,-1801.0,3550000.0,0.0,-3550000.0
burkj001,John Burkett,Florida Marlins,MARLNS,8,14,15,29,1996,2005,9,13.58,15.44,1.86,714,1374,660,846,2751,1905,5960.0,4460.0,-1500.0,15975000.0,16412500.0,437500.0
burkj101,Jesse Burkett,St.Louis Browns,ORLS,1,1,2,3,1904,1904,0,2.67,0.0,-2.67,148,0,-148,654,0,-654,0.0,0.0,0.0,4500.0,0.0,-4500.0
burkj104,Jimmy Burke,Pittsburgh Pirates,PIRATS,3,7,4,11,1903,1910,7,15.96,23.51,7.55,1958,739,-1219,7001,2073,-4928,2702.0,3643.0,941.0,0.0,0.0,0.0
burkk101,Ken Burkhart,St. Louis Cardinals,CARDS,1,1,1,2,1948,1948,0,0.34,-0.22,-0.56,54,41,-13,18,127,109,207.0,0.0,-207.0,0.0,0.0,0.0
burkl102,Leo Burke,St. Louis Cardinals,CARDS,1,1,1,2,1963,1966,3,-0.13,2.11,2.24,98,176,78,176,10,-166,0.0,381.0,381.0,0.0,0.0,0.0
burkt001,Tim Burke,Pittsburgh Pirates,PIRATS,1,4,1,5,1982,1986,4,0.06,2.65,2.59,23,373,350,0,881,881,83.0,0.0,-83.0,0.0,0.0,0.0
burkt001,Tim Burke,New York Yankees,YANKS,1,1,1,2,1983,1983,0,11.79,0.0,-11.79,850,0,-850,46,0,-46,1801.0,0.0,-1801.0,0.0,0.0,0.0
burkt001,Tim Burke,Montreal Expos,NATEX,2,2,4,6,1991,1991,0,3.57,-0.52,-4.09,227,6,-221,6,7,1,2384.0,51.0,-2333.0,0.0,1966667.0,1966667.0
burkt001,Tim Burke,New York Mets,METS,1,1,1,2,1992,1992,0,0.06,-0.93,-0.99,23,86,63,0,2,2,83.0,130.0,47.0,2266667.0,1600000.0,-666667.0
burlr001,Rick Burleson,Boston Red Sox,RSOX,3,6,6,12,1980,1989,9,34.32,7.26,-27.06,1836,1801,-35,6677,5369,-1308,547.0,1201.0,654.0,1020000.0,523333.0,-496667.0
burna001,A.J. Burnett,New York Mets,METS,4,8,6,14,1998,2004,6,16.46,25.48,9.02,820,471,-349,1355,484,-871,4079.0,4278.0,199.0,362500.0,1350000.0,987500.0
burna001,A.J. Burnett,New York Yankees,YANKS,2,4,3,7,2012,2016,4,6.48,-0.08,-6.56,169,134,-35,190,458,268,1672.0,31.0,-1641.0,0.0,0.0,0.0
burnb001,Britt Burns,Chicago White Sox,WSOX,7,14,13,27,1985,1996,11,11.29,32.32,21.03,1612,1563,-49,4746,6374,1628,301.0,975.0,674.0,6084000.0,2773055.0,-3310945.0
burnb002,Billy Burns,Washington Nationals,NATEX,2,2,2,4,2013,2016,3,5.56,0.37,-5.19,636,200,-436,856,149,-707,416.0,172.0,-244.0,0.0,1100000.0,1100000.0
burnb002,Billy Burns,Oakland Athletics,ATLTCS,2,2,2,4,2016,2017,1,-1.02,-0.79,0.23,48,44,-4,82,123,41,0.0,0.0,0.0,0.0,0.0,0.0
burnb101,Bill Burns,Washington Senators,TWINS,1,1,3,4,1909,1909,0,1.19,-0.8,-1.99,48,109,61,63,350,287,502.0,114.0,-388.0,3500.0,2400.0,-1100.0
burnc001,Cory Burns,Cleveland Indians,INDINS,1,1,1,2,2011,2012,1,-0.16,-0.65,-0.49,34,72,38,1,109,108,54.0,0.0,-54.0,0.0,0.0,0.0
burnc001,Cory Burns,San Diego Padres,PADRS,1,1,1,2,2012,2013,1,0.18,0.0,-0.18,10,0,-10,0,0,0,34.0,0.0,-34.0,0.0,0.0,0.0
burnd101,Dennis Burns,Philadelphia Athletics,ATLTCS,3,9,5,14,1924,1935,11,15.67,38.22,22.55,391,1328,937,1453,5363,3910,735.0,0.0,-735.0,39667.0,10400.0,-29267.0
burne101,Ed Burns,Montreal,Montreal,1,1,2,3,1913,1913,0,0.59,0.0,-0.59,320,0,-320,902,0,-902,0.0,0.0,0.0,0.0,2400.0,2400.0
burng101,George Burns,New York Giants,GIANTS,1,3,1,4,1921,1926,5,3.43,7.56,4.13,403,420,17,1818,1780,-38,0.0,0.0,0.0,15208.0,10591.0,-4617.0
burng102,George Burns,New York Yankees,YANKS,1,1,1,2,1918,1918,0,8.05,1.23,-6.82,307,91,-216,1176,371,-805,0.0,0.0,0.0,0.0,0.0,0.0
burng102,George Burns,Cleveland Indians,INDINS,1,3,1,4,1921,1923,2,18.85,0.33,-18.52,768,142,-626,3109,582,-2527,0.0,0.0,0.0,10000.0,5000.0,-5000.0
burng102,George Burns,Boston Red Sox,RSOX,2,5,5,10,1924,1925,1,9.31,0.12,-9.19,860,387,-473,3360,1555,-1805,0.0,0.0,0.0,3300.0,0.0,-3300.0
burnj001,Jeromy Burnitz,New York Mets,METS,5,9,10,19,1994,1999,5,9.6,7.76,-1.84,747,954,207,324,289,-35,2209.0,3636.0,1427.0,6823000.0,6640000.0,-183000.0
burnj001,Jeromy Burnitz,Cleveland Indians,INDINS,1,1,1,2,1996,1997,1,15.73,0.69,-15.04,782,86,-696,3269,318,-2951,0.0,0.0,0.0,190000.0,1150000.0,960000.0
burnj001,Jeromy Burnitz,Milwaukee Brewers,BREWRS,2,7,6,13,2002,2004,2,1.18,1.8,0.62,314,393,79,929,661,-268,437.0,1049.0,612.0,2750000.0,500000.0,-2250000.0
burnj001,Jeromy Burnitz,New York Mets,METS,8,15,15,30,2003,2021,18,22.85,21.94,-0.91,694,1363,669,1260,3646,2386,4975.0,2970.0,-2005.0,30731467.0,3825000.0,-26906467.0
burnj105,Jack Burns,St.Louis Browns,ORLS,2,2,2,4,1936,1937,1,-0.28,1.4,1.68,201,159,-42,673,143,-530,273.0,1178.0,905.0,13500.0,11000.0,-2500.0
burnj108,Johnny Burnett,Cleveland Indians,INDINS,2,4,2,6,1934,1940,6,1.33,10.59,9.26,342,673,331,1172,2639,1467,96.0,0.0,-96.0,5000.0,4250.0,-750.0
burnj108,Johnny Burnett,St.Louis Browns,ORLS,1,1,1,2,1936,1936,0,0.0,-0.03,-0.03,0,140,140,0,596,596,0.0,0.0,0.0,0.0,0.0,0.0
burnm001,Mike Burns,Cincinnati Reds,REDS,1,1,2,3,2006,2006,0,0.07,0.0,-0.07,7,0,-7,0,0,0,23.0,0.0,-23.0,332500.0,0.0,-332500.0
burnp102,Pete Burnside,Washington Senators,RNGRS,2,3,4,7,1962,1964,2,2.63,0.81,-1.82,369,114,-255,1015,218,-797,22.0,175.0,153.0,0.0,7000.0,7000.0
burns001,Sean Burnett,Pittsburgh Pirates,PIRATS,4,7,9,16,2009,2020,11,14.34,15.86,1.52,1433,1357,-76,3037,658,-2379,1099.0,1818.0,719.0,4920000.0,2593000.0,-2327000.0
burns101,Sheldon Burnside,Detroit Tigers,TIGRS,2,2,3,5,1979,1983,4,0.05,7.42,7.37,113,520,407,178,1791,1613,14.0,0.0,-14.0,0.0,0.0,0.0
burnt001,Todd Burns,Texas Rangers,RNGRS,1,1,1,2,1993,1993,0,-0.68,0.0,0.68,48,0,-48,4,0,-4,92.0,0.0,-92.0,575000.0,0.0,-575000.0
burnw101,Wally Burnette,New York Yankees,YANKS,1,1,1,2,1956,1957,1,3.41,0.0,-3.41,136,0,-136,89,0,-89,787.0,0.0,-787.0,0.0,0.0,0.0
burrj001,Jeff Burroughs,Texas Rangers,RNGRS,6,16,16,32,1976,1988,12,15.83,55.04,39.21,1321,3190,1869,4055,10570,6515,1774.0,6297.0,4523.0,330000.0,0.0,-330000.0
burrj001,Jeff Burroughs,Atlanta Braves,BRAVES,2,2,2,4,1981,1983,2,1.76,-0.3,-2.06,205,44,-161,367,3,-364,261.0,87.0,-174.0,33500.0,0.0,-33500.0
burrl101,Larry Burright,Los Angeles Dodgers,DOGRS,2,5,3,8,1962,1968,6,8.72,5.17,-3.55,1130,752,-378,1613,597,-1016,1656.0,2078.0,422.0,122000.0,73000.0,-49000.0
burrr001,Ray Burris,Chicago Cubs,CUBS,4,7,7,14,1979,1990,11,9.02,17.35,8.33,763,1156,393,2292,336,-1956,512.0,4219.0,3707.0,890000.0,85000.0,-805000.0
burrr001,Ray Burris,Montreal Expos,NATEX,1,1,2,3,1983,1983,0,3.69,0.0,-3.69,37,0,-37,0,0,0,635.0,0.0,-635.0,600000.0,0.0,-600000.0
burrr001,Ray Burris,Oakland Athletics,ATLTCS,2,4,3,7,1984,1985,1,5.99,2.63,-3.36,113,29,-84,0,0,0,1871.0,583.0,-1288.0,600000.0,625000.0,25000.0
burrr002,Ryan Burr,Arizona Diamondbacks,DBACKS,1,1,1,2,2017,2017,0,0.96,0.0,-0.96,61,0,-61,0,0,0,198.0,0.0,-198.0,0.0,0.0,0.0
burrs001,Sean Burroughs,San Diego Padres,PADRS,1,1,1,2,2005,2006,1,-0.03,-0.89,-0.86,8,18,10,25,4,-21,0.0,54.0,54.0,1675000.0,1124000.0,-551000.0
burte101,Ellis Burton,St. Louis Cardinals,CARDS,1,4,1,5,1961,1961,0,0.0,0.08,0.08,0,58,58,0,21,21,0.0,225.0,225.0,0.0,0.0,0.0
burtj101,Jim Burton,Boston Red Sox,RSOX,1,1,1,2,1978,1978,0,0.0,0.0,0.0,0,0,0,0,0,0,0.0,0.0,0.0,0.0,0.0,0.0
burtm101,Moe Burtschy,Kansas City Athletics,ATLTCS,42,95,97,192,1956,1976,20,133.5,78.63,-54.87,13774,10527,-3247,30995,29007,-1988,20345.0,13097.0,-7248.0,522100.0,676700.0,154600.0
burwb101,Bill Burwell,St.Louis Browns,ORLS,1,6,1,7,1921,1921,0,0.0,0.0,0.0,0,0,0,0,0,0,0.0,0.0,0.0,6600.0,0.0,-6600.0
busbj101,Jim Busby,Chicago White Sox,WSOX,23,43,38,81,1952,1969,17,54.0,56.53,2.53,5273,4792,-481,13898,10899,-2999,7275.0,8147.0,872.0,226750.0,240000.0,13250.0
busbj101,Jim Busby,Washington Senators,TWINS,5,7,9,16,1955,1962,7,-2.39,0.04,2.43,319,1553,1234,752,4001,3249,250.0,2448.0,2198.0,39500.0,8500.0,-31000.0
busbj101,Jim Busby,Chicago White Sox,WSOX,16,28,29,57,1955,1969,14,20.76,44.3,23.54,2687,3479,792,5604,6611,1007,4631.0,7668.0,3037.0,148250.0,137500.0,-10750.0
busbj101,Jim Busby,Cleveland Indians,INDINS,9,16,15,31,1957,1968,11,105.59,32.42,-73.17,4771,2513,-2258,16106,9193,-6913,4502.0,562.0,-3940.0,17000.0,32000.0,15000.0
busbj101,Jim Busby,Baltimore Orioles,ORLS,1,1,1,2,1958,1960,2,-0.22,1.54,1.76,62,150,88,110,430,320,0.0,0.0,0.0,18000.0,0.0,-18000.0
busea001,Alan Busenitz,Anaheim Angels,ANGELS,1,2,3,5,2016,2018,2,-0.15,3.27,3.42,80,67,-13,0,11,11,566.0,1029.0,463.0,0.0,0.0,0.0
bushc001,Chris Bushing,Philadelphia Phillies,PHILS,1,1,1,2,1992,1992,0,-0.21,0.0,0.21,12,0,-12,0,0,0,13.0,0.0,-13.0,0.0,0.0,0.0
bushd001,David Bush,Toronto Blue Jays,BJAYS,1,3,2,5,2005,2010,5,4.16,12.24,8.08,549,739,190,828,2857,2029,2736.0,120.0,-2616.0,627000.0,446000.0,-181000.0
bushg101,Guy Bush,Chicago Cubs,CUBS,1,3,2,5,1934,1941,7,3.72,22.26,18.54,346,634,288,358,941,583,2252.0,4458.0,2206.0,0.0,0.0,0.0
bushh001,Homer Bush,San Diego Padres,PADRS,2,7,4,11,1997,2001,4,12.93,12.25,-0.68,1051,464,-587,3386,1273,-2113,1459.0,771.0,-688.0,0.0,4510000.0,4510000.0
bushh001,Homer Bush,New York Yankees,YANKS,1,3,1,4,1999,2003,4,11.64,19.58,7.94,456,165,-291,1235,16,-1219,1600.0,3012.0,1412.0,0.0,0.0,0.0
bushj102,Bullet Joe Bush,Philadelphia Athletics,ATLTCS,2,6,5,11,1917,1924,7,21.83,0.26,-21.57,730,281,-449,2197,867,-1330,2329.0,731.0,-1598.0,12000.0,0.0,-12000.0
bushj102,Bullet Joe Bush,Boston Red Sox,RSOX,10,21,30,51,1921,1937,16,73.06,40.4,-32.66,4195,2010,-2185,13395,5364,-8031,9458.0,7949.0,-1509.0,78550.0,54250.0,-24300.0
bushj102,Bullet Joe Bush,St.Louis Browns,ORLS,23,43,52,95,1926,1952,26,132.07,125.15,-6.92,6541,9540,2999,21287,29892,8605,12928.0,19199.0,6271.0,217500.0,195450.0,-22050.0
bushj102,Bullet Joe Bush,New York Yankees,YANKS,1,3,1,4,1924,1924,0,7.92,0.0,-7.92,312,0,-312,382,0,-382,2741.0,0.0,-2741.0,16500.0,15000.0,-1500.0
buskm101,Mike Buskey,Chicago White Sox,WSOX,4,7,7,14,1975,1981,6,15.97,6.61,-9.36,1143,1143,0,3173,4231,1058,3027.0,0.0,-3027.0,0.0,114500.0,114500.0
buskt101,Tom Buskey,New York Yankees,YANKS,16,29,28,57,1974,1997,23,45.9,36.13,-9.77,3504,2957,-547,6462,7155,693,12175.0,7546.0,-4629.0,4780000.0,3079500.0,-1700500.0
buskt101,Tom Buskey,Cleveland Indians,INDINS,2,4,5,9,1978,1980,2,-0.65,0.26,0.91,196,116,-80,422,243,-179,0.0,597.0,597.0,0.0,0.0,0.0
bussr101,Ray Busse,Houston Astros,ASTROS,2,3,4,7,1972,1977,5,-0.92,-3.42,-2.5,71,191,120,200,517,317,0.0,0.0,0.0,0.0,0.0,0.0
bussr101,Ray Busse,St. Louis Cardinals,CARDS,2,2,2,4,1973,1975,2,-1.05,-0.05,1.0,114,8,-106,266,4,-262,0.0,0.0,0.0,0.0,0.0,0.0
butcj001,John Butcher,Texas Rangers,RNGRS,1,3,1,4,1983,1986,3,7.12,8.55,1.43,212,414,202,0,1715,1715,3956.0,0.0,-3956.0,0.0,250000.0,250000.0
butcj001,John Butcher,Minnesota Twins,TWINS,3,8,5,13,1986,1989,3,1.23,5.31,4.08,563,310,-253,1650,183,-1467,1024.0,1487.0,463.0,488500.0,1210000.0,721500.0
butcm001,Mike Butcher,Seattle Mariners,MARNRS,1,1,1,2,1996,1996,0,0.0,0.0,0.0,0,0,0,0,0,0,0.0,0.0,0.0,0.0,0.0,0.0
butcm101,Max Butcher,Brooklyn Dodgers,DOGRS,1,1,1,2,1938,1938,0,1.85,0.05,-1.8,64,8,-56,77,6,-71,613.0,34.0,-579.0,0.0,0.0,0.0
butcm101,Max Butcher,Philadelphia Phillies,PHILS,1,1,1,2,1939,1940,1,14.95,1.65,-13.3,406,70,-336,430,265,-165,3506.0,0.0,-3506.0,0.0,8000.0,8000.0
buted001,Drew Butera,New York Mets,METS,1,2,1,3,2007,2011,4,-1.44,2.94,4.38,187,365,178,534,1469,935,3.0,0.0,-3.0,0.0,5750000.0,5750000.0
buted001,Drew Butera,Minnesota Twins,TWINS,3,3,3,6,2013,2019,6,0.83,3.09,2.26,193,279,86,716,814,98,5.0,414.0,409.0,0.0,0.0,0.0
buted001,Drew Butera,Los Angeles Dodgers,DOGRS,1,1,1,2,2014,2014,0,-0.54,0.0,0.54,22,0,-22,57,0,-57,0.0,0.0,0.0,700000.0,0.0,-700000.0
buted001,Drew Butera,Anaheim Angels,ANGELS,1,1,1,2,2015,2015,0,-1.21,-0.44,0.77,229,22,-207,575,14,-561,5.0,0.0,-5.0,987500.0,0.0,-987500.0
buted001,Drew Butera,Kansas City Royals,ROYALS,1,2,1,3,2018,2018,0,-0.55,0.0,0.55,55,5,-50,108,0,-108,5.0,11.0,6.0,2300000.0,0.0,-2300000.0
butes001,Sal Butera,Minnesota Twins,TWINS,1,1,2,3,1983,1983,0,-0.13,0.0,0.13,4,0,-4,5,0,-5,0.0,0.0,0.0,0.0,0.0,0.0
butes001,Sal Butera,Montreal Expos,NATEX,6,9,12,21,1985,1996,11,4.45,9.14,4.69,274,1231,957,297,636,339,2341.0,2913.0,572.0,1325000.0,1125000.0,-200000.0
butla101,Art Butler,FallRiver,FallRiver,1,1,2,3,1911,1911,0,-0.45,0.0,0.45,27,0,-27,76,0,-76,0.0,0.0,0.0,0.0,0.0,0.0
butla101,Art Butler,Boston Braves,BRAVES,1,2,1,3,1911,1911,0,0.0,-0.19,-0.19,0,19,19,0,71,71,0.0,0.0,0.0,0.0,0.0,0.0
butla101,Art Butler,StPaul,StPaul,1,2,1,3,1912,1912,0,1.26,0.0,-1.26,125,0,-125,428,0,-428,0.0,0.0,0.0,0.0,2100.0,2100.0
butla101,Art Butler,Pittsburgh Pirates,PIRATS,1,5,3,8,1913,1915,2,18.03,3.31,-14.72,1733,233,-1500,6155,938,-5217,795.0,0.0,-795.0,11400.0,13500.0,2100.0
butlb001,Brett Butler,Atlanta Braves,BRAVES,1,4,1,5,1983,1986,3,32.51,0.13,-32.38,1861,94,-1767,7480,76,-7404,166.0,699.0,533.0,110000.0,475000.0,365000.0
butlb001,Brett Butler,New York Mets,METS,1,1,2,3,1995,1995,0,-0.18,0.0,0.18,178,0,-178,724,0,-724,0.0,0.0,0.0,2000000.0,0.0,-2000000.0
butlb002,Brent Butler,St. Louis Cardinals,CARDS,2,6,4,10,1999,2003,4,3.2,2.78,-0.42,870,638,-232,626,106,-520,1171.0,1638.0,467.0,860000.0,10709647.0,9849647.0
butlb101,Bill Butler,Cleveland Indians,INDINS,1,2,2,4,1973,1973,0,-0.78,0.0,0.78,55,0,-55,0,0,0,604.0,0.0,-604.0,0.0,11000.0,11000.0
butlb101,Bill Butler,Minnesota Twins,TWINS,1,1,1,2,1977,1977,0,0.0,0.0,0.0,0,0,0,0,0,0,0.0,0.0,0.0,0.0,0.0,0.0
butlb103,Bill Butland,Minneapolis,Minneapolis,1,3,2,5,1939,1940,1,2.73,0.0,-2.73,141,0,-141,95,0,-95,836.0,0.0,-836.0,0.0,0.0,0.0
butld001,Dan Butler,Boston Red Sox,RSOX,1,1,1,2,2015,2015,0,0.0,0.0,0.0,0,0,0,0,0,0,0.0,0.0,0.0,0.0,0.0,0.0
butle001,Eddie Butler,Colorado Rockies,ROCKS,1,2,2,4,2017,2017,0,0.65,0.0,-0.65,41,0,-41,22,0,-22,217.0,0.0,-217.0,0.0,0.0,0.0
butle001,Eddie Butler,Chicago Cubs,CUBS,1,3,2,5,2018,2019,1,-0.39,5.6,5.99,25,74,49,0,71,71,96.0,654.0,558.0,570750.0,0.0,-570750.0
butlj001,Josh Butler,Tampa Bay Devil Rays,RAYS,1,1,1,2,2008,2009,1,-0.11,2.02,2.13,6,242,236,0,671,671,12.0,0.0,-12.0,0.0,414000.0,414000.0
butlj101,Johnny Butler,Minneapolis,Minneapolis,1,1,5,6,1926,1933,7,0.6,0.0,-0.6,296,0,-296,1153,0,-1153,0.0,0.0,0.0,0.0,0.0,0.0
butlj101,Johnny Butler,Brooklyn Dodgers,DOGRS,2,4,2,6,1927,1934,7,0.53,8.07,7.54,100,526,426,99,1883,1784,677.0,0.0,-677.0,30000.0,12000.0,-18000.0
butlj101,Johnny Butler,Milwaukee,Milwaukee,1,1,2,3,1927,1927,0,0.3,0.0,-0.3,62,0,-62,201,0,-201,0.0,0.0,0.0,0.0,3300.0,3300.0
buttt001,Ty Buttrey,Boston Red Sox,RSOX,1,2,2,4,2018,2018,0,0.49,-0.14,-0.63,139,37,-102,0,143,143,390.0,0.0,-390.0,0.0,11000000.0,11000000.0
buxtr101,Ralph Buxton,Philadelphia Athletics,ATLTCS,2,6,2,8,1938,1939,1,0.0,-1.04,-1.04,0,60,60,0,37,37,0.0,323.0,323.0,5100.0,0.0,-5100.0
buxtr101,Ralph Buxton,Oakland,Oakland,1,1,3,4,1949,1949,0,0.1,0.0,-0.1,28,0,-28,3,0,-3,80.0,0.0,-80.0,0.0,0.0,0.0
buzhj101,John Buzhardt,Chicago Cubs,CUBS,1,3,1,4,1960,1961,1,4.05,4.05,0.0,233,260,27,447,1040,593,1208.0,0.0,-1208.0,0.0,0.0,0.0
buzhj101,John Buzhardt,Philadelphia Phillies,PHILS,1,2,1,3,1961,1964,3,5.78,3.33,-2.45,417,331,-86,480,1188,708,2599.0,0.0,-2599.0,0.0,34000.0,34000.0
byerb103,Bud Byerly,Cincinnati Reds,REDS,1,2,1,3,1952,1957,5,0.0,2.38,2.38,0,218,218,0,150,150,0.0,1386.0,1386.0,6000.0,0.0,-6000.0
byerb103,Bud Byerly,Brooklyn Dodgers,DOGRS,1,1,1,2,1953,1953,0,0.32,0.0,-0.32,60,0,-60,2,0,-2,105.0,0.0,-105.0,0.0,0.0,0.0
byerb103,Bud Byerly,Washington Senators,TWINS,1,1,1,2,1958,1965,7,0.43,-0.47,-0.9,36,6,-30,4,2,-2,91.0,21.0,-70.0,11000.0,0.0,-11000.0
byerb103,Bud Byerly,Boston Red Sox,RSOX,1,1,2,3,1959,1959,0,0.32,0.0,-0.32,60,0,-60,2,0,-2,105.0,0.0,-105.0,0.0,0.0,0.0
byerr001,Randy Byers,San Diego Padres,PADRS,4,6,6,12,1989,2000,11,0.96,-0.13,-1.09,77,166,89,3,16,13,299.0,424.0,125.0,448500.0,0.0,-448500.0
bynuf001,Freddie Bynum,Oakland Athletics,ATLTCS,1,2,1,3,2006,2006,0,-0.48,0.0,0.48,71,0,-71,148,0,-148,0.0,0.0,0.0,0.0,0.0,0.0
bynuf001,Freddie Bynum,Chicago Cubs,CUBS,3,5,6,11,2006,2013,7,14.01,1.49,-12.52,1141,382,-759,3294,73,-3221,719.0,1062.0,343.0,732500.0,2300000.0,1567500.0
byrdh101,Harry Byrd,Philadelphia Athletics,ATLTCS,46,109,116,225,1953,1976,23,189.08,109.39,-79.69,16486,13560,-2926,40867,38903,-1964,20759.0,16429.0,-4330.0,546100.0,754900.0,208800.0
byrdh101,Harry Byrd,New York Yankees,YANKS,12,33,27,60,1954,1970,16,40.55,76.98,36.43,5201,4368,-833,16466,10777,-5689,3212.0,10751.0,7539.0,302500.0,109500.0,-193000.0
byrdh101,Harry Byrd,Chicago White Sox,WSOX,10,18,21,39,1956,1971,15,41.93,77.23,35.3,3299,4500,1201,10984,12532,1548,917.0,5807.0,4890.0,83500.0,48000.0,-35500.0
byrdm001,Marlon Byrd,Philadelphia Phillies,PHILS,1,1,1,2,2005,2005,0,1.06,-0.42,-1.48,152,91,-61,472,118,-354,0.0,0.0,0.0,0.0,0.0,0.0
byrdm001,Marlon Byrd,Chicago Cubs,CUBS,1,2,2,4,2012,2015,3,-0.16,0.77,0.93,34,128,94,106,2,-104,0.0,223.0,223.0,0.0,484000.0,484000.0
byrdm001,Marlon Byrd,New York Mets,METS,4,7,5,12,2013,2021,8,1.02,3.24,2.22,135,327,192,405,855,450,0.0,146.0,146.0,13000000.0,3500000.0,-9500000.0
byrdm001,Marlon Byrd,Philadelphia Phillies,PHILS,1,2,1,3,2014,2018,4,0.81,1.36,0.55,96,39,-57,388,33,-355,0.0,337.0,337.0,8000000.0,0.0,-8000000.0
byrdm001,Marlon Byrd,Cincinnati Reds,REDS,1,2,1,3,2015,2015,0,0.57,0.0,-0.57,39,0,-39,156,0,-156,0.0,0.0,0.0,0.0,0.0,0.0
byrdp001,Paul Byrd,Cleveland Indians,INDINS,5,11,9,20,1994,2001,7,59.36,5.4,-53.96,3537,380,-3157,10591,1129,-9462,3110.0,195.0,-2915.0,7871666.0,7925000.0,53334.0
byrdp001,Paul Byrd,New York Mets,METS,2,4,3,7,1996,1999,3,1.53,1.68,0.15,165,283,118,98,37,-61,946.0,702.0,-244.0,3273000.0,3260000.0,-13000.0
byrdp001,Paul Byrd,Philadelphia Phillies,PHILS,1,1,1,2,2001,2002,1,7.23,-0.82,-8.05,52,183,131,7,7,0,965.0,328.0,-637.0,0.0,260000.0,260000.0
byrdp001,Paul Byrd,Cleveland Indians,INDINS,1,1,1,2,2008,2009,1,0.81,0.0,-0.81,15,0,-15,0,0,0,249.0,0.0,-249.0,7500000.0,0.0,-7500000.0
byrnb101,Bobby Byrne,St. Louis Cardinals,CARDS,2,3,5,8,1909,1914,5,11.73,6.08,-5.65,660,875,215,2738,3442,704,641.0,470.0,-171.0,0.0,0.0,0.0
byrnb101,Bobby Byrne,Pittsburgh Pirates,PIRATS,2,7,5,12,1913,1915,2,18.65,3.36,-15.29,2062,268,-1794,7394,1089,-6305,942.0,0.0,-942.0,19200.0,16250.0,-2950.0
byrne001,Eric Byrnes,Oakland Athletics,ATLTCS,1,2,2,4,2005,2007,2,0.29,2.31,2.02,231,152,-79,619,3,-616,0.0,786.0,786.0,2200000.0,2200000.0,0.0
byrne001,Eric Byrnes,Colorado Rockies,ROCKS,2,3,2,5,2005,2006,1,1.69,-0.43,-2.12,555,154,-401,1688,71,-1617,15.0,134.0,119.0,326000.0,2230000.0,1904000.0
byrnm101,Milt Byrnes,St.Louis Browns,ORLS,1,2,1,3,1946,1946,0,0.0,0.02,0.02,0,7,7,0,18,18,0.0,0.0,0.0,0.0,0.0,0.0
byrnm101,Milt Byrnes,New York Yankees,YANKS,1,2,2,4,1948,1948,0,0.1,0.0,-0.1,6,0,-6,0,0,0,12.0,0.0,-12.0,0.0,0.0,0.0
byrnt101,Tommy Byrne,New York Yankees,YANKS,1,2,1,3,1951,1952,1,3.65,-0.3,-3.95,122,30,-92,152,9,-143,956.0,134.0,-822.0,18000.0,0.0,-18000.0
byrnt101,Tommy Byrne,St.Louis Browns,ORLS,1,2,2,4,1952,1954,2,-0.79,-0.8,-0.01,24,89,65,20,141,121,48.0,0.0,-48.0,19250.0,0.0,-19250.0
byrnt101,Tommy Byrne,Chicago White Sox,WSOX,1,1,1,2,1953,1953,0,0.0,0.0,0.0,0,0,0,0,0,0,0.0,0.0,0.0,0.0,0.0,0.0
bystm001,Marty Bystrom,Philadelphia Phillies,PHILS,3,5,6,11,1984,1990,6,0.32,13.19,12.87,143,596,453,310,1528,1218,676.0,2713.0,2037.0,1725000.0,103500.0,-1621500.0
cabee001,Enos Cabell,Baltimore Orioles,ORLS,1,2,2,4,1974,1980,6,10.57,4.54,-6.03,1279,794,-485,5010,3158,-1852,0.0,0.0,0.0,16000.0,0.0,-16000.0
cabee001,Enos Cabell,Houston Astros,ASTROS,2,3,3,6,1980,1989,9,-1.4,11.24,12.64,96,653,557,413,857,444,0.0,5214.0,5214.0,0.0,0.0,0.0
cabee001,Enos Cabell,San Francisco Giants,GIANTS,2,3,3,6,1982,1984,2,2.91,-0.41,-3.32,293,116,-177,963,200,-763,0.0,0.0,0.0,0.0,0.0,0.0
cabee001,Enos Cabell,Houston Astros,ASTROS,1,1,2,3,1985,1985,0,0.39,-0.13,-0.52,164,13,-151,506,41,-465,0.0,0.0,0.0,291667.0,0.0,-291667.0
cabra002,Asdrubal Cabrera,Seattle Mariners,MARNRS,1,1,1,2,2006,2006,0,20.73,-0.89,-21.62,914,43,-871,3871,102,-3769,0.0,0.0,0.0,0.0,1750000.0,1750000.0
cabra002,Asdrubal Cabrera,Cleveland Indians,INDINS,1,2,1,3,2014,2016,2,1.51,-0.51,-2.02,139,42,-97,559,124,-435,0.0,0.0,0.0,10000000.0,0.0,-10000000.0
cabra002,Asdrubal Cabrera,New York Mets,METS,1,1,1,2,2018,2021,3,-0.75,-0.31,0.44,49,4,-45,185,0,-185,0.0,34.0,34.0,8250000.0,0.0,-8250000.0
cabrf001,Francisco Cabrera,Toronto Blue Jays,BJAYS,1,2,1,3,1989,1991,2,0.35,0.29,-0.06,335,127,-208,372,0,-372,284.0,625.0,341.0,71500.0,688000.0,616500.0
cabrg001,Genesis Cabrera,Tampa Bay Devil Rays,RAYS,2,5,5,10,2018,2020,2,6.49,6.47,-0.02,634,226,-408,1668,967,-701,343.0,0.0,-343.0,4100000.0,1152200.0,-2947800.0
cabrj001,Jose Cabrera,Cleveland Indians,INDINS,8,13,15,28,1997,2011,14,5.88,12.35,6.47,1245,1518,273,2426,3926,1500,767.0,1598.0,831.0,9756200.0,3392500.0,-6363700.0
cabrj001,Jose Cabrera,Atlanta Braves,BRAVES,1,2,1,3,2002,2003,1,-3.2,-1.6,1.6,184,136,-48,277,415,138,310.0,0.0,-310.0,0.0,0.0,0.0
cabrj002,Jolbert Cabrera,Cleveland Indians,INDINS,1,1,1,2,2002,2002,0,0.55,0.0,-0.55,138,0,-138,395,0,-395,0.0,0.0,0.0,266000.0,0.0,-266000.0
cabrj002,Jolbert Cabrera,Los Angeles Dodgers,DOGRS,2,2,3,5,2004,2004,0,0.37,0.0,-0.37,113,0,-113,391,0,-391,0.0,0.0,0.0,0.0,0.0,0.0
cabrm001,Miguel Cabrera,Florida Marlins,MARLNS,5,6,11,17,2007,2013,6,60.75,3.64,-57.11,2705,1161,-1544,9389,789,-8600,1298.0,2358.0,1060.0,18420219.0,799800.0,-17620419.0
cabrm002,Melky Cabrera,New York Yankees,YANKS,1,4,2,6,2009,2013,4,3.9,2.44,-1.46,585,309,-276,511,6,-505,625.0,1000.0,375.0,1800000.0,11927500.0,10127500.0
cabrm002,Melky Cabrera,Kansas City Royals,ROYALS,2,2,3,5,2011,2015,4,4.43,2.02,-2.41,119,130,11,504,19,-485,34.0,2126.0,2092.0,6850000.0,13000000.0,6150000.0
cabrm002,Melky Cabrera,Chicago White Sox,WSOX,1,2,2,4,2017,2017,0,-1.04,0.0,1.04,58,0,-58,238,0,-238,0.0,0.0,0.0,15000000.0,0.0,-15000000.0
cabro001,Orlando Cabrera,Montreal Expos,NATEX,2,6,6,12,2004,2009,5,1.16,-0.94,-2.1,763,893,130,429,3105,2676,809.0,182.0,-627.0,7352000.0,4550000.0,-2802000.0
cabro001,Orlando Cabrera,Anaheim Angels,ANGELS,1,1,1,2,2007,2008,1,2.56,0.8,-1.76,161,33,-128,730,3,-727,0.0,590.0,590.0,8500000.0,10000000.0,1500000.0
cabro001,Orlando Cabrera,Oakland Athletics,ATLTCS,1,1,1,2,2009,2016,7,-0.05,-0.43,-0.38,59,54,-5,260,68,-192,0.0,3.0,3.0,4000000.0,0.0,-4000000.0
cabro001,Orlando Cabrera,Cleveland Indians,INDINS,1,1,1,2,2011,2013,2,-0.03,-0.32,-0.29,39,9,-30,133,24,-109,0.0,0.0,0.0,1000000.0,0.0,-1000000.0
cabrr001,Ramon Cabrera,Pittsburgh Pirates,PIRATS,1,1,1,2,2012,2014,2,0.0,0.0,0.0,0,0,0,0,0,0,0.0,0.0,0.0,0.0,0.0,0.0
cacec101,Craig Cacek,New York Mets,METS,1,1,1,2,1975,1975,0,-0.52,0.0,0.52,7,0,-7,21,0,-21,0.0,0.0,0.0,0.0,0.0,0.0
cacee001,Edgar Caceres,Montreal Expos,NATEX,1,1,1,2,1988,1988,0,0.0,0.0,0.0,0,0,0,0,0,0,0.0,0.0,0.0,0.0,0.0,0.0
cadag001,Greg Cadaret,Oakland Athletics,ATLTCS,3,5,4,9,1989,1998,9,13.62,32.12,18.5,801,794,-7,1223,2883,1660,2766.0,771.0,-1995.0,4272766.0,2120000.0,-2152766.0
cadyh101,Hick Cady,JerseyCity,JerseyCity,1,1,6,7,1912,1921,9,3.45,0.0,-3.45,321,0,-321,894,0,-894,0.0,0.0,0.0,0.0,0.0,0.0
cadyh101,Hick Cady,Boston Red Sox,RSOX,8,19,22,41,1918,1935,17,51.77,23.6,-28.17,3792,2718,-1074,15081,10291,-4790,0.0,1203.0,1203.0,45050.0,29350.0,-15700.0
cagew101,Wayne Cage,Cleveland Indians,INDINS,1,1,1,2,1981,1985,4,0.0,-0.52,-0.52,0,49,49,0,71,71,0.0,0.0,0.0,0.0,0.0,0.0
cahit001,Trevor Cahill,Oakland Athletics,ATLTCS,3,5,5,10,2011,2015,4,0.11,4.67,4.56,286,252,-34,221,116,-105,1515.0,585.0,-930.0,3722500.0,0.0,-3722500.0
cahit001,Trevor Cahill,Arizona Diamondbacks,DBACKS,1,2,1,3,2015,2015,0,-0.68,0.0,0.68,30,0,-30,5,0,-5,79.0,0.0,-79.0,0.0,0.0,0.0
cahit001,Trevor Cahill,San Diego Padres,PADRS,1,3,4,7,2017,2017,0,-1.51,-0.81,0.7,107,22,-85,1,17,16,304.0,157.0,-147.0,4194700.0,538900.0,-3655800.0
cainb101,Bob Cain,Chicago White Sox,WSOX,2,4,2,6,1951,1955,4,0.66,6.53,5.87,71,225,154,61,356,295,448.0,1666.0,1218.0,7000.0,0.0,-7000.0
cainb101,Bob Cain,Detroit Tigers,TIGRS,11,26,24,50,1952,1961,9,21.38,15.7,-5.68,2119,2215,96,3938,6442,2504,5639.0,2357.0,-3282.0,45200.0,36000.0,-9200.0
cainb101,Bob Cain,Baltimore Orioles,ORLS,1,1,2,3,1953,1955,2,0.0,1.98,1.98,0,78,78,0,84,84,0.0,699.0,699.0,13500.0,7500.0,-6000.0
cainb101,Bob Cain,New York Giants,GIANTS,1,1,1,2,1949,1949,0,3.79,0.0,-3.79,90,0,-90,79,0,-79,627.0,0.0,-627.0,0.0,0.0,0.0
cainl001,Lorenzo Cain,Milwaukee Brewers,BREWRS,8,16,16,32,2010,2020,10,33.31,23.99,-9.32,2772,1309,-1463,10420,3997,-6423,777.0,2948.0,2171.0,20405500.0,10550000.0,-9855500.0
cains101,Sugar Cain,Philadelphia Athletics,ATLTCS,1,2,1,3,1935,1936,1,2.31,1.97,-0.34,270,46,-224,676,55,-621,552.0,447.0,-105.0,9500.0,6000.0,-3500.0
cains101,Sugar Cain,St.Louis Browns,ORLS,1,1,1,2,1936,1939,3,1.16,-0.39,-1.55,107,75,-32,111,50,-61,851.0,427.0,-424.0,5500.0,0.0,-5500.0
cairm001,Miguel Cairo,Los Angeles Dodgers,DOGRS,1,2,1,3,1995,1996,1,0.25,-0.12,-0.37,108,92,-16,250,358,108,0.0,0.0,0.0,0.0,694445.0,694445.0
cairm001,Miguel Cairo,Seattle Mariners,MARNRS,2,3,3,6,1995,1997,2,0.75,-0.72,-1.47,99,11,-88,44,0,-44,434.0,126.0,-308.0,135000.0,218000.0,83000.0
cairm001,Miguel Cairo,Toronto Blue Jays,BJAYS,1,1,1,2,1996,1996,0,0.57,0.0,-0.57,82,0,-82,179,0,-179,0.0,0.0,0.0,0.0,0.0,0.0
cairm001,Miguel Cairo,Oakland Athletics,ATLTCS,4,9,7,16,2001,2003,2,22.23,5.28,-16.95,1569,224,-1345,3188,219,-2969,5533.0,541.0,-4992.0,2433333.0,5053333.0,2620000.0
caldi001,Ivan Calderon,Seattle Mariners,MARNRS,1,1,1,2,1986,1992,6,8.47,-0.89,-9.36,554,562,8,2313,1698,-615,0.0,0.0,0.0,0.0,66500.0,66500.0
caldi001,Ivan Calderon,Chicago White Sox,WSOX,2,3,4,7,1990,1996,6,7.45,16.61,9.16,578,648,70,1665,2873,1208,266.0,0.0,-266.0,4830000.0,2055555.0,-2774445.0
caldi001,Ivan Calderon,Montreal Expos,NATEX,1,1,2,3,1992,1993,1,-0.29,-0.63,-0.34,73,48,-25,239,5,-234,0.0,114.0,114.0,2600000.0,177000.0,-2423000.0
caldm001,Mike Caldwell,San Diego Padres,PADRS,1,1,2,3,1973,1976,3,0.92,5.26,4.34,238,321,83,143,1142,999,1380.0,0.0,-1380.0,0.0,125000.0,125000.0
caldm001,Mike Caldwell,San Francisco Giants,GIANTS,2,5,5,10,1976,1979,3,0.11,-0.39,-0.5,172,638,466,406,1241,835,25.0,782.0,757.0,0.0,0.0,0.0
caldm001,Mike Caldwell,St. Louis Cardinals,CARDS,1,1,1,2,1977,1977,0,0.39,0.0,-0.39,28,0,-28,5,0,-5,74.0,0.0,-74.0,0.0,0.0,0.0
caldm001,Mike Caldwell,Cincinnati Reds,REDS,1,1,2,3,1977,1977,0,17.3,0.0,-17.3,239,0,-239,0,0,0,4814.0,0.0,-4814.0,0.0,0.0,0.0
caldr101,Ray Caldwell,New York Yankees,YANKS,5,19,8,27,1918,1928,10,9.22,7.55,-1.67,1051,1233,182,2808,4705,1897,3476.0,418.0,-3058.0,39950.0,18400.0,-21550.0
calds101,Sam Calderone,New York Giants,GIANTS,15,30,31,61,1954,1968,14,48.23,65.72,17.49,4661,4032,-629,15306,7933,-7373,2020.0,13164.0,11144.0,128000.0,149500.0,21500.0
calek001,Kiko Calero,St. Louis Cardinals,CARDS,1,3,1,4,2004,2008,4,22.03,0.48,-21.55,848,107,-741,2102,105,-1997,2465.0,933.0,-1532.0,305000.0,4450000.0,4145000.0
calhj001,Jeff Calhoun,Houston Astros,ASTROS,1,1,1,2,1987,1987,0,1.02,-0.99,-2.01,90,38,-52,1,107,106,135.0,0.0,-135.0,0.0,0.0,0.0
calhw001,Willie Calhoun,Los Angeles Dodgers,DOGRS,1,3,1,4,2017,2017,0,-1.3,0.52,1.82,240,18,-222,874,20,-854,69.0,149.0,80.0,0.0,11000000.0,11000000.0
calla001,Alberto Callaspo,Anaheim Angels,ANGELS,1,1,1,2,2006,2011,5,-1.33,0.7,2.03,79,125,46,203,0,-203,0.0,369.0,369.0,0.0,0.0,0.0
calla001,Alberto Callaspo,Arizona Diamondbacks,DBACKS,2,2,3,5,2007,2010,3,4.69,-1.41,-6.1,317,67,-250,1241,35,-1206,0.0,380.0,380.0,380000.0,12000000.0,11620000.0
calla001,Alberto Callaspo,Kansas City Royals,ROYALS,2,2,3,5,2010,2014,4,8.57,-0.23,-8.8,773,193,-580,1620,549,-1071,453.0,756.0,303.0,460000.0,2000000.0,1540000.0
calla001,Alberto Callaspo,Anaheim Angels,ANGELS,1,1,1,2,2013,2015,2,-0.57,-0.66,-0.09,177,104,-73,631,284,-347,0.0,0.0,0.0,0.0,0.0,0.0
calla001,Alberto Callaspo,Atlanta Braves,BRAVES,6,15,9,24,2015,2021,6,3.56,2.51,-1.05,557,291,-266,805,489,-316,986.0,676.0,-310.0,21307500.0,11500000.0,-9807500.0
callb101,Ben Callahan,New York Yankees,YANKS,1,3,1,4,1983,1984,1,-1.24,-0.76,0.48,9,12,3,14,0,-14,28.0,167.0,139.0,0.0,0.0,0.0
callf101,Frank Callaway,Philadelphia Athletics,ATLTCS,2,6,2,8,1922,1932,10,0.0,50.56,50.56,0,1369,1369,0,6016,6016,0.0,0.0,0.0,9900.0,0.0,-9900.0
callj001,Jamie Callahan,Boston Red Sox,RSOX,1,3,1,4,2017,2017,0,-0.57,0.56,1.13,43,31,-12,1,0,-1,62.0,81.0,19.0,0.0,7750000.0,7750000.0
callj101,Johnny Callison,Chicago White Sox,WSOX,3,3,4,7,1959,1978,19,41.04,68.05,27.01,1807,1541,-266,6860,1303,-5557,426.0,11173.0,10747.0,26000.0,0.0,-26000.0
callj101,Johnny Callison,Philadelphia Phillies,PHILS,4,8,8,16,1969,1984,15,29.76,14.53,-15.23,1654,1829,175,6186,1998,-4188,0.0,2963.0,2963.0,0.0,123000.0,123000.0
callj101,Johnny Callison,Chicago Cubs,CUBS,1,1,1,2,1972,1974,2,-0.69,0.4,1.09,137,190,53,442,14,-428,0.0,392.0,392.0,0.0,0.0,0.0
callj102,Joe Callahan,Boston Braves,BRAVES,1,1,1,2,1940,1941,1,0.0,-0.83,-0.83,0,44,44,0,24,24,0.0,186.0,186.0,0.0,0.0,0.0
calll101,Leo Callahan,Brooklyn Dodgers,DOGRS,4,9,6,15,1915,1927,12,6.65,17.83,11.18,787,1627,840,3022,6661,3639,0.0,0.0,0.0,27500.0,4800.0,-22700.0
callm001,Mickey Callaway,Tampa Bay Devil Rays,RAYS,1,1,1,2,2001,2001,0,-0.61,0.0,0.61,26,0,-26,0,0,0,218.0,0.0,-218.0,0.0,0.0,0.0
callm101,Marty Callaghan,Cincinnati Reds,REDS,3,7,3,10,1930,1932,2,-0.61,5.83,6.44,32,321,289,78,1329,1251,9.0,0.0,-9.0,5500.0,0.0,-5500.0
callr001,Ron Calloway,Arizona Diamondbacks,DBACKS,1,1,1,2,1999,1999,0,-1.27,0.0,1.27,172,0,-172,460,0,-460,0.0,0.0,0.0,0.0,0.0,0.0
calmd101,Dick Calmus,Los Angeles Dodgers,DOGRS,1,1,1,2,1967,1970,3,-0.13,-0.47,-0.34,2,60,58,2,11,9,13.0,186.0,173.0,0.0,0.0,0.0
calvj101,Jack Calvo,Washington Senators,TWINS,4,8,6,14,1920,1933,13,25.21,15.96,-9.25,1580,828,-752,6114,3136,-2978,0.0,616.0,616.0,3600.0,0.0,-3600.0
camae001,Ernie Camacho,Oakland Athletics,ATLTCS,1,2,1,3,1981,1983,2,-0.08,-0.75,-0.67,14,83,69,5,0,-5,65.0,424.0,359.0,0.0,0.0,0.0
camae001,Ernie Camacho,Pittsburgh Pirates,PIRATS,1,2,2,4,1982,1983,1,4.04,-0.83,-4.87,410,24,-386,1402,12,-1390,0.0,132.0,132.0,0.0,0.0,0.0
camae001,Ernie Camacho,Milwaukee Brewers,BREWRS,1,3,2,5,1983,1987,4,7.32,0.25,-7.07,394,574,180,437,1374,937,1362.0,450.0,-912.0,600000.0,885000.0,285000.0
camed001,Daz Cameron,Houston Astros,ASTROS,1,3,3,6,2017,2021,4,-0.1,16.16,16.26,126,77,-49,429,7,-422,3.0,1431.0,1428.0,0.0,0.0,0.0
cameh101,Hank Camelli,Pittsburgh Pirates,PIRATS,1,2,4,6,1946,1949,3,25.05,-0.22,-25.27,770,168,-602,3219,87,-3132,0.0,478.0,478.0,0.0,0.0,0.0
cameh101,Hank Camelli,Boston Braves,BRAVES,1,1,1,2,1947,1947,0,0.0,0.0,0.0,0,0,0,0,0,0,0.0,0.0,0.0,0.0,0.0,0.0
camem001,Mike Cameron,Chicago White Sox,WSOX,1,1,1,2,1998,2014,16,5.52,29.25,23.73,146,2268,2122,636,9258,8622,0.0,0.0,0.0,230000.0,0.0,-230000.0
camem001,Mike Cameron,Cincinnati Reds,REDS,2,6,3,9,2000,2013,13,18.66,15.9,-2.76,696,1440,744,2678,3953,1275,381.0,721.0,340.0,8282695.0,396000.0,-7886695.0
camem001,Mike Cameron,New York Mets,METS,2,2,3,5,2005,2011,6,10.48,2.06,-8.42,561,317,-244,2335,471,-1864,0.0,1622.0,1622.0,7760333.0,5138000.0,-2622333.0
camia001,Arquimedes Caminero,Pittsburgh Pirates,PIRATS,1,1,2,3,2016,2019,3,-0.38,0.0,0.38,18,0,-18,0,0,0,59.0,0.0,-59.0,532500.0,0.0,-532500.0
camid102,Dolph Camilli,Chicago Cubs,CUBS,1,1,1,2,1934,1935,1,12.75,-0.9,-13.65,540,51,-489,2322,159,-2163,0.0,0.0,0.0,0.0,0.0,0.0
camid102,Dolph Camilli,Philadelphia Phillies,PHILS,1,1,2,3,1938,1938,0,29.74,0.0,-29.74,839,0,-839,3606,0,-3606,0.0,0.0,0.0,0.0,0.0,0.0
camid102,Dolph Camilli,Brooklyn Dodgers,DOGRS,3,7,5,12,1943,1947,4,-0.39,6.32,6.71,76,587,511,39,2174,2135,380.0,123.0,-257.0,0.0,0.0,0.0
camid102,Dolph Camilli,New York Giants,GIANTS,1,1,1,2,1943,1943,0,0.0,0.0,0.0,0,0,0,0,0,0,0.0,0.0,0.0,0.0,0.0,0.0
camik001,Ken Caminiti,Houston Astros,ASTROS,14,30,36,66,1994,2008,14,59.26,31.82,-27.44,4671,6059,1388,11202,15757,4555,6620.0,5977.0,-643.0,31714000.0,14229000.0,-17485000.0
camil101,Lou Camilli,Cleveland Indians,INDINS,2,2,2,4,1973,1974,1,0.0,-0.03,-0.03,0,2,2,0,3,3,0.0,0.0,0.0,0.0,0.0,0.0
camnh101,Howie Camnitz,Pittsburgh Pirates,PIRATS,2,7,5,12,1913,1915,2,18.65,3.36,-15.29,2062,268,-1794,7394,1089,-6305,942.0,0.0,-942.0,19200.0,16250.0,-2950.0
campb001,Bill Campbell,Chicago Cubs,CUBS,4,10,8,18,1984,1987,3,1.78,8.04,6.26,606,1265,659,954,3508,2554,1010.0,823.0,-187.0,1753333.0,878000.0,-875333.0
campb001,Bill Campbell,Philadelphia Phillies,PHILS,1,2,1,3,1985,1986,1,-0.41,-0.15,0.26,159,118,-41,87,15,-72,193.0,313.0,120.0,0.0,0.0,0.0
campb101,Bert Campaneris,Texas Rangers,RNGRS,4,8,4,12,1979,1986,7,15.57,12.79,-2.78,1284,538,-746,3501,1724,-1777,4307.0,1244.0,-3063.0,190000.0,250000.0,60000.0
campb102,Bruce Campbell,Chicago White Sox,WSOX,2,3,2,5,1932,1940,8,17.91,-0.15,-18.06,925,353,-572,3007,1416,-1591,2296.0,0.0,-2296.0,17600.0,12000.0,-5600.0
campb102,Bruce Campbell,St.Louis Browns,ORLS,2,2,4,6,1934,1936,2,10.32,-0.53,-10.85,553,210,-343,2157,827,-1330,0.0,0.0,0.0,4250.0,5000.0,750.0
campb102,Bruce Campbell,Cleveland Indians,INDINS,1,1,1,2,1940,1940,0,2.7,0.27,-2.43,244,120,-124,931,482,-449,0.0,0.0,0.0,0.0,0.0,0.0
campb102,Bruce Campbell,Detroit Tigers,TIGRS,1,2,2,4,1941,1948,7,0.26,3.39,3.13,148,1062,914,484,4332,3848,0.0,0.0,0.0,10000.0,17000.0,7000.0
campc102,Cardell Camper,St. Louis Cardinals,CARDS,1,1,1,2,1976,1976,0,0.09,0.0,-0.09,3,0,-3,0,0,0,28.0,0.0,-28.0,0.0,0.0,0.0
campc102,Cardell Camper,Cleveland Indians,INDINS,1,1,1,2,1978,1984,6,0.0,1.54,1.54,0,201,201,0,722,722,0.0,0.0,0.0,0.0,0.0,0.0
campd101,Dave Campbell,Detroit Tigers,TIGRS,1,2,1,3,1969,1973,4,3.09,4.22,1.13,408,176,-232,1366,140,-1226,753.0,1147.0,394.0,12000.0,0.0,-12000.0
campd101,Dave Campbell,San Diego Padres,PADRS,2,2,2,4,1973,1973,0,-0.66,-1.27,-0.61,15,53,38,27,123,96,0.0,0.0,0.0,0.0,0.0,0.0
campd101,Dave Campbell,St. Louis Cardinals,CARDS,2,3,2,5,1973,1974,1,-0.06,0.43,0.49,44,52,8,40,67,27,0.0,34.0,34.0,0.0,0.0,0.0
campd102,Dave Campbell,Atlanta Braves,BRAVES,3,4,6,10,1979,1981,2,1.23,0.82,-0.41,177,350,173,304,857,553,541.0,927.0,386.0,150000.0,150000.0,0.0
campg101,Gilly Campbell,Montreal,Montreal,1,1,3,4,1938,1940,2,-0.02,0.0,0.02,54,0,-54,147,0,-147,0.0,0.0,0.0,0.0,0.0,0.0
camph102,Howie Camp,New York Yankees,YANKS,3,12,4,16,1920,1928,8,-3.56,9.03,12.59,367,917,550,1242,3654,2412,159.0,0.0,-159.0,28250.0,13000.0,-15250.0
campj103,Jim Campbell,St. Louis Cardinals,CARDS,3,5,4,9,1970,1971,1,0.65,1.05,0.4,128,66,-62,382,156,-226,18.0,0.0,-18.0,27000.0,47000.0,20000.0
campj104,Jim Campbell,Milwaukee Braves,BRAVES,1,1,1,2,1961,1961,0,-0.21,0.0,0.21,82,0,-82,264,0,-264,0.0,0.0,0.0,0.0,0.0,0.0
campj105,Jim Campanis,Kansas City Royals,ROYALS,2,6,5,11,1970,1979,9,2.78,26.16,23.38,582,1576,994,670,5382,4712,1583.0,1688.0,105.0,34500.0,38500.0,4000.0
campk001,Kevin Campbell,Los Angeles Dodgers,DOGRS,1,1,1,2,1991,1992,1,-0.19,0.0,0.19,57,0,-57,0,0,0,312.0,0.0,-312.0,0.0,0.0,0.0
campm001,Mike Campbell,Seattle Mariners,MARNRS,15,25,31,56,1989,2015,26,47.96,108.51,60.55,2885,3632,747,7463,9980,2517,4388.0,14029.0,9641.0,34882500.0,19453000.0,-15429500.0
campm001,Mike Campbell,Montreal Expos,NATEX,1,1,1,2,1990,1990,0,0.0,0.0,0.0,0,0,0,0,0,0,0.0,0.0,0.0,0.0,0.0,0.0
campr101,Ron Campbell,Chicago Cubs,CUBS,1,2,1,3,1969,1969,0,0.26,0.0,-0.26,146,6,-140,17,6,-11,358.0,0.0,-358.0,0.0,0.0,0.0
camps002,Shawn Camp,San Diego Padres,PADRS,1,2,1,3,2001,2001,0,0.0,-0.2,-0.2,0,13,13,0,15,15,0.0,0.0,0.0,0.0,265000.0,265000.0
camps102,Sal Campisi,St. Louis Cardinals,CARDS,1,2,2,4,1970,1970,0,0.05,0.0,-0.05,12,0,-12,0,0,0,13.0,0.0,-13.0,12000.0,8000.0,-4000.0
campt001,Tony Campana,Chicago Cubs,CUBS,2,2,3,5,2013,2016,3,-0.35,0.27,0.62,55,31,-24,115,0,-115,0.0,43.0,43.0,0.0,0.0,0.0
campt001,Tony Campana,Arizona Diamondbacks,DBACKS,1,2,2,4,2014,2019,5,-0.49,0.11,0.6,34,4,-30,15,0,-15,19.0,9.0,-10.0,2884500.0,0.0,-2884500.0
campv001,Vicente Campos,Seattle Mariners,MARNRS,1,2,2,4,2012,2016,4,6.28,-2.3,-8.58,93,246,153,7,800,793,1527.0,405.0,-1122.0,0.0,0.0,0.0
campv001,Vicente Campos,New York Yankees,YANKS,2,5,4,9,2016,2020,4,0.57,4.82,4.25,14,385,371,2,241,239,47.0,836.0,789.0,6150000.0,12535000.0,6385000.0
campv101,Vin Campbell,Pittsburgh Pirates,PIRATS,1,1,1,2,1912,1912,0,0.31,1.3,0.99,145,77,-68,680,274,-406,0.0,0.0,0.0,0.0,0.0,0.0
canag001,George Canale,Milwaukee Brewers,BREWRS,1,1,1,2,1991,1994,3,0.0,-0.85,-0.85,0,133,133,0,284,284,0.0,0.0,0.0,0.0,0.0,0.0
canaj101,Jim Canavan,Louisville Colonels,LS3,1,2,1,3,1892,1895,3,-0.83,5.85,6.68,118,367,249,487,1608,1121,0.0,36.0,36.0,0.0,0.0,0.0
candc001,Casey Candaele,Montreal Expos,NATEX,2,3,2,5,1988,1992,4,3.38,-0.1,-3.48,603,204,-399,1471,4,-1467,0.0,350.0,350.0,110000.0,100000.0,-10000.0
candj001,John Candelaria,Pittsburgh Pirates,PIRATS,2,6,6,12,1985,1992,7,9.22,21.92,12.7,518,1417,899,680,1274,594,2669.0,7059.0,4390.0,1030000.0,180000.0,-850000.0
candj001,John Candelaria,California Angels,ANGELS,1,1,2,3,1987,1987,0,-0.06,0.0,0.06,6,0,-6,5,0,-5,37.0,0.0,-37.0,800000.0,0.0,-800000.0
candj001,John Candelaria,New York Yankees,YANKS,2,2,3,5,1989,1991,2,5.91,-1.24,-7.15,488,76,-412,1534,238,-1296,49.0,0.0,-49.0,930000.0,0.0,-930000.0
candj001,John Candelaria,Minnesota Twins,TWINS,1,1,2,3,1990,1995,5,-0.21,0.48,0.69,13,536,523,0,1913,1913,64.0,0.0,-64.0,500000.0,255000.0,-245000.0
candj002,Jeimer Candelario,Chicago Cubs,CUBS,1,3,2,5,2017,2018,1,6.56,1.19,-5.37,523,218,-305,2136,113,-2023,0.0,217.0,217.0,0.0,4700000.0,4700000.0
candm101,Milo Candini,New York Yankees,YANKS,1,2,2,4,1943,1946,3,9.48,0.6,-8.88,716,132,-584,1943,129,-1814,1434.0,1073.0,-361.0,0.0,0.0,0.0
candm101,Milo Candini,Washington Senators,TWINS,1,1,1,2,1949,1949,0,0.0,0.82,0.82,0,72,72,0,30,30,0.0,327.0,327.0,9000.0,0.0,-9000.0
candt001,Tom Candiotti,Cleveland Indians,INDINS,4,5,9,14,1991,1996,5,12.63,7.08,-5.55,801,582,-219,2368,1823,-545,1452.0,1275.0,-177.0,3575000.0,1765000.0,-1810000.0
cangj001,John Cangelosi,Chicago White Sox,WSOX,1,1,1,2,1987,1988,1,3.32,-0.64,-3.96,350,57,-293,663,0,-663,6.0,282.0,276.0,0.0,0.0,0.0
cangj001,John Cangelosi,Chicago White Sox,WSOX,4,6,5,11,1991,2004,13,0.31,-0.43,-0.74,194,297,103,252,131,-121,327.0,1874.0,1547.0,580000.0,1425000.0,845000.0
canhm001,Mark Canha,Colorado Rockies,ROCKS,1,1,2,3,2014,2014,0,9.92,0.0,-9.92,645,0,-645,2492,0,-2492,0.0,0.0,0.0,0.0,0.0,0.0
cannc101,Chris Cannizzaro,New York Mets,METS,1,1,1,2,1966,1966,0,0.0,0.0,0.0,0,0,0,0,0,0,0.0,0.0,0.0,0.0,0.0,0.0
cannc101,Chris Cannizzaro,Atlanta Braves,BRAVES,1,2,2,4,1966,1966,0,0.0,0.0,0.0,0,0,0,0,0,0,0.0,0.0,0.0,0.0,0.0,0.0
cannc101,Chris Cannizzaro,Detroit Tigers,TIGRS,1,1,1,2,1967,1969,2,0.57,0.0,-0.57,25,0,-25,70,0,-70,0.0,0.0,0.0,0.0,0.0,0.0
cannc101,Chris Cannizzaro,Pittsburgh Pirates,PIRATS,1,2,2,4,1969,1969,0,2.16,-0.66,-2.82,398,62,-336,1040,73,-967,429.0,0.0,-429.0,0.0,0.0,0.0
cannc101,Chris Cannizzaro,San Diego Padres,PADRS,1,1,1,2,1971,1971,0,0.1,0.66,0.56,71,75,4,234,204,-30,0.0,0.0,0.0,0.0,0.0,0.0
cannj101,Joe Cannon,Houston Astros,ASTROS,1,3,1,4,1978,1989,11,-3.72,7.9,11.62,160,965,805,206,3318,3112,249.0,0.0,-249.0,22500.0,0.0,-22500.0
cannr101,Rip Cannell,Boston Braves,BRAVES,1,1,1,2,1905,1908,3,0.0,0.19,0.19,0,141,141,0,489,489,0.0,0.0,0.0,0.0,0.0,0.0
canor001,Robinson Cano,Seattle Mariners,MARNRS,3,7,8,15,2018,2021,3,4.65,-0.82,-5.47,602,81,-521,857,184,-673,558.0,101.0,-457.0,34758065.0,21875000.0,-12883065.0
cansj001,Jose Canseco,Oakland Athletics,ATLTCS,3,4,7,11,1992,1997,5,2.61,2.8,0.19,709,476,-233,2747,1658,-1089,3.0,1280.0,1277.0,10500000.0,15283333.0,4783333.0
cansj001,Jose Canseco,Texas Rangers,RNGRS,1,1,2,3,1994,1996,2,5.55,0.51,-5.04,198,183,-15,882,778,-104,0.0,0.0,0.0,5100000.0,3250000.0,-1850000.0
cansj001,Jose Canseco,Boston Red Sox,RSOX,3,6,7,13,1997,2002,5,1.09,4.19,3.1,233,432,199,580,538,-42,371.0,1801.0,1430.0,3375000.0,6575000.0,3200000.0
canso001,Ozzie Canseco,St. Louis Cardinals,CARDS,1,1,1,2,1993,1993,0,0.0,0.0,0.0,0,0,0,0,0,0,0.0,0.0,0.0,140000.0,0.0,-140000.0
cantb102,Ben Cantwell,New York Giants,GIANTS,1,4,1,5,1928,1928,0,11.88,2.32,-9.56,1432,52,-1380,2925,68,-2857,4700.0,475.0,-4225.0,21900.0,7000.0,-14900.0
cantg101,Guy Cantrell,FortWorth,FortWorth,2,3,4,7,1924,1925,1,-0.54,0.0,0.54,123,0,-123,67,0,-67,480.0,0.0,-480.0,0.0,0.0,0.0
cantg101,Guy Cantrell,Toronto,Toronto,1,1,1,2,1930,1930,0,-0.32,0.0,0.32,32,0,-32,9,0,-9,105.0,0.0,-105.0,0.0,0.0,0.0
cantj001,Jorge Cantu,Tampa Bay Devil Rays,RAYS,1,3,2,5,2007,2007,0,0.07,0.0,-0.07,27,0,-27,68,0,-68,0.0,0.0,0.0,0.0,0.0,0.0
cantj001,Jorge Cantu,Florida Marlins,MARLNS,1,1,2,3,2010,2013,3,-0.56,0.0,0.56,30,0,-30,105,0,-105,0.0,0.0,0.0,6000000.0,0.0,-6000000.0
canzr001,Russ Canzler,Baltimore Orioles,ORLS,1,1,1,2,2013,2013,0,0.0,0.0,0.0,0,0,0,0,0,0,0.0,0.0,0.0,0.0,0.0,0.0
capej001,Jose Capellan,Atlanta Braves,BRAVES,2,3,2,5,2004,2006,2,0.58,-1.28,-1.86,271,128,-143,2,1,-1,443.0,173.0,-270.0,3400000.0,1842000.0,-1558000.0
capej001,Jose Capellan,Milwaukee Brewers,BREWRS,1,1,1,2,2007,2007,0,-0.41,0.0,0.41,10,0,-10,0,0,0,42.0,0.0,-42.0,0.0,0.0,0.0
capej001,Jose Capellan,Detroit Tigers,TIGRS,2,2,2,4,2007,2008,1,-0.6,0.41,1.01,100,16,-84,6,0,-6,171.0,57.0,-114.0,395000.0,0.0,-395000.0
capid101,Doug Capilla,St. Louis Cardinals,CARDS,1,1,1,2,1977,1977,0,-0.48,-0.82,-0.34,67,82,15,42,7,-35,371.0,161.0,-210.0,0.0,23200.0,23200.0
capid101,Doug Capilla,Cincinnati Reds,REDS,1,1,1,2,1979,1984,5,2.35,0.0,-2.35,189,0,-189,25,0,-25,474.0,0.0,-474.0,0.0,0.0,0.0
capid101,Doug Capilla,Chicago Cubs,CUBS,1,1,1,2,1981,1983,2,0.0,0.62,0.62,0,56,56,0,40,40,0.0,368.0,368.0,0.0,0.0,0.0
cappc001,Carter Capps,Seattle Mariners,MARNRS,5,8,7,15,2013,2017,4,10.74,4.38,-6.36,1184,445,-739,3959,1460,-2499,501.0,283.0,-218.0,11171300.0,5514300.0,-5657000.0
cappc001,Carter Capps,Miami Marlins,MARLNS,3,8,6,14,2016,2019,3,12.29,-0.08,-12.37,540,354,-186,600,126,-474,2851.0,1392.0,-1459.0,550000.0,7660200.0,7110200.0
cappg101,George Cappuzzello,Detroit Tigers,TIGRS,1,2,1,3,1978,1980,2,0.0,4.64,4.64,0,73,73,0,0,0,0.0,1101.0,1101.0,0.0,0.0,0.0
cappm001,Matt Capps,Washington Nationals,NATEX,1,1,2,3,2010,2016,6,1.92,10.47,8.55,130,578,448,0,2276,2276,366.0,0.0,-366.0,3500000.0,0.0,-3500000.0
caprn001,Nick Capra,Cincinnati Reds,REDS,1,1,1,2,1992,1993,1,0.0,-0.21,-0.21,0,12,12,0,0,0,0.0,13.0,13.0,0.0,0.0,0.0
capuc001,Chris Capuano,Arizona Diamondbacks,DBACKS,1,6,3,9,2003,2005,2,15.82,-0.12,-15.94,1881,61,-1820,5048,104,-4944,2593.0,37.0,-2556.0,3548667.0,5425000.0,1876333.0
caram001,Matt Carasiti,Colorado Rockies,ROCKS,1,1,1,2,2017,2018,1,0.0,0.03,0.03,0,18,18,0,0,0,0.0,21.0,21.0,0.0,0.0,0.0
carar001,Ramon Caraballo,Atlanta Braves,BRAVES,1,1,1,2,1994,1994,0,-0.54,0.0,0.54,34,0,-34,110,0,-110,0.0,0.0,0.0,0.0,0.0,0.0
carav001,Victor Caratini,Atlanta Braves,BRAVES,1,1,3,4,2014,2015,1,0.97,0.31,-0.66,250,82,-168,677,130,-547,12.0,73.0,61.0,0.0,4275000.0,4275000.0
carav001,Victor Caratini,Chicago Cubs,CUBS,1,2,5,7,2020,2021,1,1.28,-0.94,-2.22,175,63,-112,411,44,-367,499.0,444.0,-55.0,22000000.0,5250000.0,-16750000.0
carbb101,Bernie Carbo,Cincinnati Reds,REDS,1,1,1,2,1972,1974,2,4.23,0.42,-3.81,276,88,-188,828,198,-630,0.0,0.0,0.0,0.0,0.0,0.0
carbb101,Bernie Carbo,St. Louis Cardinals,CARDS,10,15,16,31,1973,1978,5,43.88,7.39,-36.49,1933,556,-1377,5993,1737,-4256,2099.0,259.0,-1840.0,96000.0,140000.0,44000.0
carbb101,Bernie Carbo,Boston Red Sox,RSOX,2,2,3,5,1976,1977,1,0.38,-1.58,-1.96,80,112,32,231,121,-110,0.0,373.0,373.0,0.0,0.0,0.0
carbb101,Bernie Carbo,Milwaukee Brewers,BREWRS,1,2,1,3,1976,1976,0,4.95,0.0,-4.95,442,0,-442,1687,0,-1687,0.0,0.0,0.0,150000.0,0.0,-150000.0
carda001,Adrian Cardenas,Philadelphia Phillies,PHILS,2,4,2,6,2008,2012,4,4.22,2.37,-1.85,203,206,3,28,216,188,867.0,1849.0,982.0,8500000.0,3700000.0,-4800000.0
cardd101,Don Cardwell,Philadelphia Phillies,PHILS,2,3,4,7,1960,1971,11,11.26,16.56,5.3,652,1580,928,1728,6417,4689,1893.0,0.0,-1893.0,60000.0,0.0,-60000.0
cardd101,Don Cardwell,Chicago Cubs,CUBS,16,27,26,53,1962,1982,20,54.43,129.03,74.6,2307,6354,4047,4353,15923,11570,10563.0,16087.0,5524.0,552500.0,88500.0,-464000.0
cardd101,Don Cardwell,St. Louis Cardinals,CARDS,12,25,21,46,1962,1972,10,34.37,14.04,-20.33,3456,1142,-2314,8634,3489,-5145,3590.0,703.0,-2887.0,32500.0,24000.0,-8500.0
cardd101,Don Cardwell,Pittsburgh Pirates,PIRATS,2,3,3,6,1966,1968,2,2.29,1.17,-1.12,328,107,-221,391,68,-323,1500.0,578.0,-922.0,46000.0,24500.0,-21500.0
cardj001,Javier Cardona,Detroit Tigers,TIGRS,1,2,2,4,2002,2002,0,-0.46,0.97,1.43,15,108,93,42,363,321,0.0,0.0,0.0,0.0,0.0,0.0
cardj001,Javier Cardona,St. Louis Cardinals,CARDS,1,1,1,2,2005,2007,2,0.0,0.63,0.63,0,158,158,0,388,388,0.0,0.0,0.0,0.0,0.0,0.0
cardj101,Jose Cardenal,San Francisco Giants,GIANTS,1,1,1,2,1964,1970,6,4.59,5.91,1.32,396,290,-106,1562,803,-759,0.0,0.0,0.0,0.0,6000.0,6000.0
cardj101,Jose Cardenal,California Angels,ANGELS,2,2,2,4,1967,1969,2,5.92,0.27,-5.65,592,183,-409,1768,444,-1324,0.0,0.0,0.0,20000.0,21000.0,1000.0
cardj101,Jose Cardenal,Cleveland Indians,INDINS,9,14,15,29,1969,1984,15,49.1,10.79,-38.31,2903,2741,-162,10858,9463,-1395,38.0,317.0,279.0,169250.0,347100.0,177850.0
cardj101,Jose Cardenal,St. Louis Cardinals,CARDS,2,4,3,7,1971,1971,0,0.65,0.42,-0.23,128,32,-96,382,84,-298,18.0,0.0,-18.0,27000.0,15000.0,-12000.0
cardj101,Jose Cardenal,Milwaukee Brewers,BREWRS,7,11,14,25,1971,1986,15,39.9,45.53,5.63,2646,2463,-183,7439,6326,-1113,5266.0,7453.0,2187.0,592300.0,15000.0,-577300.0
cardj101,Jose Cardenal,Chicago Cubs,CUBS,1,1,1,2,1977,1977,0,-0.61,0.0,0.61,116,0,-116,282,0,-282,0.0,0.0,0.0,150000.0,0.0,-150000.0
cardl101,Leo Cardenas,Cincinnati Reds,REDS,2,2,3,5,1968,1972,4,13.24,2.94,-10.3,539,219,-320,1938,226,-1712,589.0,1800.0,1211.0,36500.0,43000.0,6500.0
cardl101,Leo Cardenas,Minnesota Twins,TWINS,2,2,4,6,1971,1976,5,1.67,8.18,6.51,339,287,-52,635,15,-620,439.0,2568.0,2129.0,70000.0,88000.0,18000.0
cardl101,Leo Cardenas,California Angels,ANGELS,1,1,2,3,1973,1974,1,-1.2,1.35,2.55,72,155,83,212,429,217,0.0,0.0,0.0,0.0,0.0,0.0
cardl101,Leo Cardenas,Cleveland Indians,INDINS,2,4,2,6,1974,1974,0,1.58,-0.11,-1.69,267,15,-252,613,61,-552,0.0,0.0,0.0,19750.0,160000.0,140250.0
carea101,Andy Carey,New York Yankees,YANKS,1,1,1,2,1960,1960,0,0.75,1.28,0.53,141,87,-54,519,249,-270,0.0,0.0,0.0,0.0,0.0,0.0
carea101,Andy Carey,Kansas City Athletics,ATLTCS,19,40,34,74,1961,1976,15,67.84,34.29,-33.55,6835,3922,-2913,16048,11060,-4988,8728.0,3414.0,-5314.0,393100.0,483000.0,89900.0
carea101,Andy Carey,Chicago White Sox,WSOX,1,2,2,4,1961,1962,1,0.0,0.69,0.69,0,79,79,0,145,145,0.0,0.0,0.0,0.0,0.0,0.0
carea101,Andy Carey,Chicago White Sox,WSOX,2,2,4,6,1962,1967,5,0.03,-0.44,-0.47,53,14,-39,130,19,-111,0.0,0.0,0.0,0.0,0.0,0.0
carer001,Rod Carew,Minnesota Twins,TWINS,4,4,10,14,1979,1987,8,25.56,9.14,-16.42,1791,1507,-284,6644,5200,-1444,256.0,1637.0,1381.0,0.0,0.0,0.0
caret102,Tom Carey,St.Louis Browns,ORLS,2,2,2,4,1938,1939,1,-0.2,0.06,0.26,183,80,-103,325,42,-283,270.0,341.0,71.0,6000.0,8500.0,2500.0
carlb001,Buddy Carlyle,Cincinnati Reds,REDS,1,1,1,2,1998,1998,0,-0.55,-0.23,0.32,22,8,-14,11,0,-11,122.0,16.0,-106.0,0.0,176000.0,176000.0
carlh101,Hal Carlson,Philadelphia Phillies,PHILS,2,4,4,8,1927,1929,2,1.34,-1.88,-3.22,190,224,34,187,481,294,1211.0,585.0,-626.0,8850.0,28800.0,19950.0
carlj101,Jim Carlin,New York Giants,GIANTS,1,3,1,4,1938,1940,2,0.0,3.47,3.47,0,123,123,0,517,517,0.0,0.0,0.0,0.0,0.0,0.0
carll101,Leon Carlson,Washington Senators,TWINS,4,8,6,14,1920,1933,13,25.21,15.96,-9.25,1580,828,-752,6114,3136,-2978,0.0,616.0,616.0,3600.0,0.0,-3600.0
carlr101,Roy Carlyle,Washington Senators,TWINS,1,2,1,3,1925,1927,2,1.68,5.81,4.13,272,192,-80,587,672,85,1044.0,0.0,-1044.0,3600.0,8000.0,4400.0
carls001,Steve Carlton,St. Louis Cardinals,CARDS,11,16,17,33,1972,1978,6,113.27,16.17,-97.1,2933,696,-2237,7406,1939,-5467,13191.0,1843.0,-11348.0,96000.0,140000.0,44000.0
carls001,Steve Carlton,Cleveland Indians,INDINS,1,1,1,2,1987,1987,0,-1.35,0.0,1.35,13,0,-13,0,0,0,158.0,0.0,-158.0,0.0,0.0,0.0
carls002,Shane Carle,Pittsburgh Pirates,PIRATS,1,1,1,2,2014,2016,2,-0.02,-0.09,-0.07,6,84,78,0,2,2,12.0,141.0,129.0,0.0,0.0,0.0
carls002,Shane Carle,Pittsburgh Pirates,PIRATS,1,1,1,2,2018,2018,0,0.57,0.0,-0.57,115,0,-115,6,0,-6,217.0,0.0,-217.0,0.0,0.0,0.0
carlt101,Tex Carleton,St. Louis Cardinals,CARDS,1,1,3,4,1934,1934,0,5.38,0.0,-5.38,264,0,-264,289,0,-289,2233.0,0.0,-2233.0,0.0,0.0,0.0
carmd101,Duke Carmel,St. Louis Cardinals,CARDS,1,2,1,3,1960,1960,0,0.0,-0.2,-0.2,0,32,32,0,32,32,0.0,0.0,0.0,0.0,0.0,0.0
carmd101,Duke Carmel,St. Louis Cardinals,CARDS,1,1,1,2,1961,1961,0,0.0,0.0,0.0,0,0,0,0,0,0,0.0,0.0,0.0,0.0,0.0,0.0
carmd101,Duke Carmel,St. Louis Cardinals,CARDS,1,1,2,3,1963,1963,0,0.75,0.0,-0.75,47,0,-47,167,0,-167,0.0,0.0,0.0,0.0,0.0,0.0
carmf001,Fausto Carmona,Philadelphia Phillies,PHILS,1,1,2,3,2014,2021,7,-0.44,1.78,2.22,18,191,173,15,89,74,131.0,227.0,96.0,0.0,0.0,0.0
carne101,Eddie Carnett,Chicago White Sox,WSOX,1,1,1,2,1944,1944,0,-0.29,0.0,0.29,32,0,-32,76,0,-76,6.0,0.0,-6.0,6000.0,7500.0,1500.0
carpc001,Cris Carpenter,Florida Marlins,MARLNS,2,2,5,7,1993,1997,4,11.08,2.51,-8.57,787,607,-180,6,25,19,1408.0,1163.0,-245.0,3805000.0,109000.0,-3696000.0
carpc003,Chris Carpenter,Chicago Cubs,CUBS,1,2,1,3,2012,2012,0,-0.21,0.0,0.21,8,0,-8,0,0,0,18.0,0.0,-18.0,0.0,0.0,0.0
carpd001,David Carpenter,St. Louis Cardinals,CARDS,1,1,2,3,2010,2010,0,0.2,-0.4,-0.6,126,40,-86,2,125,123,172.0,0.0,-172.0,0.0,4500000.0,4500000.0
carpd001,David Carpenter,Houston Astros,ASTROS,4,10,10,20,2012,2019,7,17.22,11.07,-6.15,1238,246,-992,2359,341,-2018,4222.0,1816.0,-2406.0,8335000.0,6555000.0,-1780000.0
carpd001,David Carpenter,Toronto Blue Jays,BJAYS,2,4,2,6,2012,2014,2,11.57,-0.01,-11.58,944,66,-878,3396,7,-3389,0.0,475.0,475.0,0.0,1681000.0,1681000.0
carpd001,David Carpenter,Atlanta Braves,BRAVES,1,2,1,3,2015,2016,1,1.56,-0.24,-1.8,214,14,-200,2,7,5,580.0,79.0,-501.0,0.0,0.0,0.0
carpd001,David Carpenter,New York Yankees,YANKS,5,9,8,17,2015,2020,5,-1.27,8.03,9.3,455,197,-258,1007,8,-999,308.0,1270.0,962.0,5236900.0,21050000.0,15813100.0
carpm001,Mike Carp,New York Mets,METS,1,7,3,10,2008,2010,2,8.89,-1.25,-10.14,554,358,-196,1346,179,-1167,2162.0,325.0,-1837.0,3398000.0,4805000.0,1407000.0
carra001,Amalio Carreno,New York Yankees,YANKS,1,1,1,2,1988,1988,0,-0.34,-0.68,-0.34,6,50,44,1,149,148,10.0,0.0,-10.0,0.0,375000.0,375000.0
carra101,Alex Carrasquel,Chicago White Sox,WSOX,1,1,1,2,1949,1949,0,0.0,0.0,0.0,0,0,0,0,0,0,0.0,0.0,0.0,9600.0,0.0,-9600.0
carrc001,Chuck Carr,Seattle Mariners,MARNRS,1,1,1,2,1988,1988,0,-0.3,0.0,0.3,16,0,-16,13,0,-13,0.0,0.0,0.0,0.0,0.0,0.0
carrc001,Chuck Carr,New York Mets,METS,1,1,1,2,1991,1991,0,0.08,0.0,-0.08,22,0,-22,76,0,-76,0.0,0.0,0.0,0.0,0.0,0.0
carrc001,Chuck Carr,Florida Marlins,MARLNS,1,2,1,3,1995,2004,9,0.38,0.0,-0.38,53,0,-53,163,0,-163,0.0,0.0,0.0,255000.0,0.0,-255000.0
carrc003,Carlos Carrasco,Philadelphia Phillies,PHILS,3,6,6,12,2009,2015,6,27.43,-0.46,-27.89,716,374,-342,1539,630,-909,4038.0,442.0,-3596.0,1175000.0,6421400.0,5246400.0
carrc003,Carlos Carrasco,Cleveland Indians,INDINS,1,2,4,6,2021,2021,0,2.19,2.78,0.59,149,209,60,543,798,255,161.0,0.0,-161.0,0.0,0.0,0.0
carrc004,Cody Carroll,New York Yankees,YANKS,1,3,1,4,2018,2019,1,-0.19,2.71,2.9,121,97,-24,0,0,0,451.0,259.0,-192.0,0.0,12000000.0,12000000.0
carrc102,Cliff Carroll,St. Louis Cardinals,CARDS,1,1,1,2,1893,1899,6,-0.24,-0.54,-0.3,120,527,407,531,2249,1718,0.0,0.0,0.0,0.0,0.0,0.0
carrc103,Clay Carroll,Atlanta Braves,BRAVES,3,5,5,10,1968,1970,2,13.88,3.02,-10.86,1605,185,-1420,1388,304,-1084,4147.0,923.0,-3224.0,0.0,12000.0,12000.0
carrc103,Clay Carroll,Cincinnati Reds,REDS,1,1,2,3,1975,1977,2,2.01,-0.71,-2.72,37,24,-13,0,1,1,266.0,53.0,-213.0,0.0,0.0,0.0
carrc103,Clay Carroll,Chicago White Sox,WSOX,1,1,1,2,1977,1979,2,1.83,2.34,0.51,102,130,28,14,0,-14,270.0,613.0,343.0,0.0,0.0,0.0
carrc103,Clay Carroll,St. Louis Cardinals,CARDS,3,4,5,9,1977,1990,13,5.97,12.77,6.8,378,954,576,1263,2591,1328,1270.0,1727.0,457.0,740000.0,0.0,-740000.0
carrc104,Cam Carreon,Chicago White Sox,WSOX,16,33,31,64,1965,1979,14,64.47,101.26,36.79,4791,5050,259,12435,15211,2776,10650.0,9679.0,-971.0,609700.0,568700.0,-41000.0
carrc104,Cam Carreon,Cleveland Indians,INDINS,1,1,1,2,1966,1968,2,0.23,-0.03,-0.26,4,6,2,12,6,-6,0.0,0.0,0.0,0.0,0.0,0.0
carrc105,Chico Carrasquel,Chicago White Sox,WSOX,16,28,29,57,1955,1969,14,20.76,44.3,23.54,2687,3479,792,5604,6611,1007,4631.0,7668.0,3037.0,148250.0,137500.0,-10750.0
carrc105,Chico Carrasquel,Cleveland Indians,INDINS,1,1,1,2,1958,1958,0,-0.4,-0.18,0.22,59,76,17,182,214,32,0.0,0.0,0.0,0.0,11000.0,11000.0
carrc105,Chico Carrasquel,Kansas City Athletics,ATLTCS,3,4,4,8,1958,1963,5,10.42,2.16,-8.26,1077,611,-466,1138,1646,508,2603.0,934.0,-1669.0,0.0,0.0,0.0
carrc106,Charlie Carr,Detroit Tigers,TIGRS,1,1,1,2,1904,1905,1,0.57,0.7,0.13,121,101,-20,464,399,-65,0.0,0.0,0.0,0.0,0.0,0.0
carrd001,D.J. Carrasco,Pittsburgh Pirates,PIRATS,1,3,3,6,2010,2011,1,-0.12,0.71,0.83,82,105,23,69,301,232,68.0,0.0,-68.0,3450000.0,5250000.0,1800000.0
carrd103,Dixie Carroll,St. Louis Cardinals,CARDS,1,3,1,4,1921,1921,0,0.0,0.87,0.87,0,76,76,0,77,77,0.0,625.0,625.0,0.0,0.0,0.0
carrd104,Don Carrithers,San Francisco Giants,GIANTS,1,1,1,2,1974,1974,0,2.04,-0.89,-2.93,151,29,-122,91,85,-6,904.0,0.0,-904.0,0.0,0.0,0.0
carre001,Ezequiel Carrera,New York Mets,METS,1,7,3,10,2008,2010,2,8.89,-1.25,-10.14,554,358,-196,1346,179,-1167,2162.0,325.0,-1837.0,3398000.0,4805000.0,1407000.0
carre001,Ezequiel Carrera,Seattle Mariners,MARNRS,1,2,1,3,2010,2010,0,0.34,0.86,0.52,123,57,-66,406,238,-168,0.0,0.0,0.0,0.0,1500000.0,1500000.0
carrh001,Hector Carrasco,Houston Astros,ASTROS,2,3,2,5,1992,1995,3,0.14,0.64,0.5,6,255,249,0,176,176,12.0,297.0,285.0,475000.0,1375000.0,900000.0
carrh001,Hector Carrasco,Florida Marlins,MARLNS,1,2,1,3,1993,1996,3,2.43,5.1,2.67,405,217,-188,18,182,164,808.0,1519.0,711.0,0.0,0.0,0.0
carrh001,Hector Carrasco,Cincinnati Reds,REDS,6,8,9,17,1997,2013,16,0.95,26.14,25.19,565,1375,810,1114,3203,2089,629.0,5071.0,4442.0,600000.0,0.0,-600000.0
carrh001,Hector Carrasco,Minnesota Twins,TWINS,1,1,1,2,2000,2007,7,-0.35,8.34,8.69,8,494,486,0,1716,1716,20.0,0.0,-20.0,825000.0,0.0,-825000.0
carrj001,Jamey Carroll,Colorado Rockies,ROCKS,1,1,1,2,2007,2008,1,4.65,0.0,-4.65,206,0,-206,760,0,-760,0.0,0.0,0.0,1700000.0,0.0,-1700000.0
carrm001,Mark Carreon,New York Mets,METS,1,2,2,4,1992,1993,1,-1.21,-0.71,0.5,101,102,1,364,8,-356,0.0,212.0,212.0,0.0,0.0,0.0
carrm001,Mark Carreon,San Francisco Giants,GIANTS,1,1,2,3,1996,1998,2,0.64,-1.36,-2.0,38,243,205,156,9,-147,0.0,316.0,316.0,1000000.0,500000.0,-500000.0
carro101,Ownie Carroll,Detroit Tigers,TIGRS,1,3,2,5,1930,1932,2,0.55,-1.14,-1.69,146,271,125,467,761,294,97.0,731.0,634.0,18000.0,25000.0,7000.0
carro101,Ownie Carroll,Cincinnati Reds,REDS,2,3,2,5,1932,1936,4,1.3,1.6,0.3,315,394,79,966,1624,658,0.0,0.0,0.0,0.0,0.0,0.0
carro101,Ownie Carroll,St. Louis Cardinals,CARDS,1,2,2,4,1933,1934,1,-0.46,1.18,1.64,199,133,-66,354,117,-237,902.0,474.0,-428.0,0.0,0.0,0.0
carrt101,Tom Carroll,Cincinnati Reds,REDS,1,1,1,2,1976,1976,0,0.0,0.0,0.0,0,0,0,0,0,0,0.0,0.0,0.0,0.0,0.0,0.0
carrt102,Tom Carroll,New York Yankees,YANKS,1,2,2,4,1959,1959,0,0.31,0.0,-0.31,212,0,-212,603,0,-603,0.0,0.0,0.0,0.0,0.0,0.0
carsf101,Frank Carswell,Detroit Tigers,TIGRS,1,1,1,2,1954,1955,1,0.0,0.0,0.0,0,0,0,0,0,0,0.0,0.0,0.0,0.0,0.0,0.0
carsk102,Kid Carsey,Philadelphia Phillies,PHILS,1,2,1,3,1897,1902,5,5.09,11.56,6.47,465,423,-42,1577,1709,132,668.0,0.0,-668.0,0.0,0.0,0.0
cartc001,Chris Carter,Washington Nationals,NATEX,1,1,2,3,2007,2009,2,-0.13,-0.35,-0.22,13,101,88,26,351,325,0.0,0.0,0.0,0.0,1875000.0,1875000.0
cartc001,Chris Carter,Arizona Diamondbacks,DBACKS,1,1,1,2,2007,2008,1,0.0,0.0,0.0,0,0,0,0,0,0,0.0,0.0,0.0,0.0,0.0,0.0
cartc001,Chris Carter,Boston Red Sox,RSOX,1,2,1,3,2009,2009,0,-0.21,0.34,0.55,100,15,-85,180,0,-180,0.0,41.0,41.0,400000.0,10500000.0,10100000.0
cartc002,Chris Carter,Chicago White Sox,WSOX,3,4,4,8,2007,2013,6,8.07,7.63,-0.44,904,496,-408,3238,1978,-1260,173.0,202.0,29.0,5530000.0,5881000.0,351000.0
cartc002,Chris Carter,Arizona Diamondbacks,DBACKS,6,14,16,30,2007,2018,11,24.99,30.17,5.18,855,1190,335,1319,2038,719,6760.0,6326.0,-434.0,14741000.0,15790000.0,1049000.0
cartc002,Chris Carter,Oakland Athletics,ATLTCS,1,3,2,5,2013,2016,3,8.06,4.16,-3.9,776,397,-379,2069,1228,-841,1629.0,325.0,-1304.0,0.0,0.0,0.0
cartg001,Gary Carter,Montreal Expos,NATEX,5,8,9,17,1984,1992,8,12.47,19.91,7.44,1633,2252,619,4360,6714,2354,803.0,2583.0,1780.0,580000.0,1123500.0,543500.0
cartj001,Joe Carter,Chicago Cubs,CUBS,4,14,9,23,1984,1991,7,18.76,21.66,2.9,1968,1112,-856,6227,902,-5325,1933.0,5322.0,3389.0,1746666.0,2928000.0,1181334.0
cartj001,Joe Carter,Cleveland Indians,INDINS,6,13,13,26,1989,2001,12,72.08,42.66,-29.42,4239,2616,-1623,13848,10214,-3634,1815.0,172.0,-1643.0,14713332.0,17360000.0,2646668.0
cartj001,Joe Carter,San Diego Padres,PADRS,6,11,15,26,1990,1998,8,43.43,14.07,-29.36,3426,1340,-2086,13331,3496,-9835,1355.0,1888.0,533.0,8656667.0,3185000.0,-5471667.0
cartj001,Joe Carter,Baltimore Orioles,ORLS,1,1,1,2,1998,1998,0,-0.25,0.0,0.25,41,0,-41,115,0,-115,0.0,0.0,0.0,3151380.0,0.0,-3151380.0
cartj002,Jeff Carter,Montreal Expos,NATEX,3,5,6,11,1990,1997,7,15.54,6.93,-8.61,814,1027,213,3114,2899,-215,199.0,380.0,181.0,5530555.0,1307000.0,-4223555.0
cartl002,Lance Carter,Tampa Bay Devil Rays,RAYS,5,6,7,13,2006,2018,12,2.76,13.6,10.84,309,789,480,288,2263,1975,1120.0,1336.0,216.0,7137700.0,1462500.0,-5675200.0
cartr101,Rico Carty,Atlanta Braves,BRAVES,1,1,1,2,1972,1972,0,-0.76,0.0,0.76,86,0,-86,347,0,-347,0.0,0.0,0.0,50000.0,9900.0,-40100.0
cartr101,Rico Carty,Toronto Blue Jays,BJAYS,7,11,12,23,1976,1987,11,14.45,14.78,0.33,2243,2025,-218,7347,6628,-719,668.0,1848.0,1180.0,0.0,240000.0,240000.0
cartr101,Rico Carty,Cleveland Indians,INDINS,2,2,2,4,1978,1979,1,1.56,0.9,-0.66,236,36,-200,942,0,-942,0.0,405.0,405.0,0.0,0.0,0.0
cartr101,Rico Carty,Toronto Blue Jays,BJAYS,2,2,3,5,1978,1992,14,1.35,13.31,11.96,41,1179,1138,163,3597,3434,0.0,519.0,519.0,0.0,0.0,0.0
carts001,Steve Carter,Pittsburgh Pirates,PIRATS,1,1,1,2,1991,1992,1,0.0,0.75,0.75,0,202,202,0,383,383,0.0,0.0,0.0,0.0,0.0,0.0
carts001,Steve Carter,Cincinnati Reds,REDS,1,1,1,2,1993,1993,0,0.0,-0.37,-0.37,0,46,46,0,71,71,0.0,0.0,0.0,0.0,0.0,0.0
carum001,Mike Caruso,San Francisco Giants,GIANTS,1,6,3,9,1997,1999,2,21.4,-0.07,-21.47,1008,161,-847,1122,94,-1028,2523.0,875.0,-1648.0,0.0,9757500.0,9757500.0
carvm001,Marcos Carvajal,Colorado Rockies,ROCKS,1,1,1,2,2005,2009,4,0.0,1.41,1.41,0,312,312,0,1187,1187,0.0,0.0,0.0,316000.0,0.0,-316000.0
carvm001,Marcos Carvajal,Seattle Mariners,MARNRS,1,1,1,2,2006,2006,0,0.0,0.0,0.0,0,0,0,0,0,0,0.0,0.0,0.0,0.0,0.0,0.0
caryc001,Chuck Cary,Detroit Tigers,TIGRS,2,3,4,7,1987,1987,0,-0.06,-0.17,-0.11,109,31,-78,95,74,-21,258.0,0.0,-258.0,425000.0,0.0,-425000.0
casac001,Curt Casali,Detroit Tigers,TIGRS,1,1,1,2,2013,2013,0,1.92,0.0,-1.92,161,0,-161,466,0,-466,0.0,0.0,0.0,0.0,0.0,0.0
casaj101,Jerry Casale,Los Angeles Angels,ANGELS,3,3,3,6,1961,1966,5,0.46,4.96,4.5,86,377,291,16,277,261,255.0,1606.0,1351.0,16500.0,0.0,-16500.0
casap101,Paul Casanova,Texas Rangers,RNGRS,2,3,2,5,1971,1975,4,-1.52,3.08,4.6,228,116,-112,569,150,-419,0.0,589.0,589.0,46000.0,17500.0,-28500.0
casar001,Raul Casanova,New York Mets,METS,2,4,2,6,1992,1993,1,12.22,-0.41,-12.63,490,79,-411,1635,295,-1340,509.0,0.0,-509.0,2535000.0,4200000.0,1665000.0
casar001,Raul Casanova,San Diego Padres,PADRS,2,4,4,8,1996,1998,2,1.67,-1.26,-2.93,549,225,-324,1460,118,-1342,1084.0,637.0,-447.0,0.0,0.0,0.0
cascj101,Joe Cascarella,Boston Red Sox,RSOX,1,1,1,2,1936,1937,1,0.62,0.35,-0.27,64,46,-18,64,7,-57,515.0,120.0,-395.0,5500.0,7000.0,1500.0
cascj101,Joe Cascarella,JerseyCity,JerseyCity,1,1,2,3,1933,1934,1,0.57,0.0,-0.57,102,0,-102,81,0,-81,680.0,0.0,-680.0,0.0,3000.0,3000.0
cased101,Doc Casey,Washington Senators,WSN,1,2,4,6,1899,1905,6,9.84,0.67,-9.17,735,113,-622,2984,291,-2693,0.0,635.0,635.0,0.0,0.0,0.0
cased101,Doc Casey,Chicago Cubs,CUBS,1,5,1,6,1905,1913,8,5.14,19.07,13.93,814,1001,187,3290,4393,1103,0.0,0.0,0.0,0.0,0.0,0.0
caseg101,George Case,Washington Senators,TWINS,2,2,3,5,1945,1947,2,4.37,2.25,-2.12,345,207,-138,1463,828,-635,0.0,8.0,8.0,13500.0,3000.0,-10500.0
caseg101,George Case,Cleveland Indians,INDINS,1,1,1,2,1947,1947,0,-0.8,0.01,0.81,36,14,-22,89,5,-84,0.0,48.0,48.0,0.0,0.0,0.0
cases001,Sean Casey,Cleveland Indians,INDINS,1,1,1,2,1998,2001,3,16.71,10.28,-6.43,1075,138,-937,4478,17,-4461,0.0,2297.0,2297.0,0.0,0.0,0.0
cases001,Sean Casey,Cincinnati Reds,REDS,3,5,3,8,2005,2010,5,-0.54,0.35,0.89,75,62,-13,256,138,-118,100.0,133.0,33.0,9600000.0,735000.0,-8865000.0
cases001,Sean Casey,Pittsburgh Pirates,PIRATS,1,1,1,2,2006,2008,2,-0.09,-0.33,-0.24,196,26,-170,692,0,-692,0.0,32.0,32.0,8500000.0,0.0,-8500000.0
casha001,Andrew Cashner,Chicago Cubs,CUBS,2,4,4,8,2012,2021,9,4.49,36.69,32.2,319,1310,991,393,5639,5246,1826.0,3.0,-1823.0,16500000.0,0.0,-16500000.0
casha001,Andrew Cashner,San Diego Padres,PADRS,4,12,9,21,2016,2021,5,1.39,-0.63,-2.02,553,209,-344,911,376,-535,973.0,576.0,-397.0,10660200.0,4650000.0,-6010200.0
casha001,Andrew Cashner,Baltimore Orioles,ORLS,1,2,2,4,2019,2019,0,-0.16,0.0,0.16,27,0,-27,0,0,0,161.0,0.0,-161.0,9500000.0,0.0,-9500000.0
cashd101,Dave Cash,Pittsburgh Pirates,PIRATS,7,14,13,27,1973,1988,15,120.98,37.81,-83.17,5144,1852,-3292,19362,6781,-12581,6130.0,1614.0,-4516.0,807000.0,0.0,-807000.0
cashd101,Dave Cash,Montreal Expos,NATEX,1,1,2,3,1979,1981,2,-0.55,-0.61,-0.06,130,27,-103,437,51,-386,0.0,0.0,0.0,300000.0,0.0,-300000.0
cashk001,Kevin Cash,Toronto Blue Jays,BJAYS,2,2,2,4,2004,2005,1,2.43,-0.87,-3.3,152,5,-147,38,0,-38,1030.0,39.0,-991.0,302000.0,302500.0,500.0
cashk001,Kevin Cash,Houston Astros,ASTROS,1,1,1,2,2010,2012,2,-0.74,-1.16,-0.42,29,175,146,68,597,529,0.0,0.0,0.0,0.0,0.0,0.0
cashn101,Norm Cash,Chicago White Sox,WSOX,5,8,10,18,1959,1969,10,11.6,14.81,3.21,1350,938,-412,4415,3667,-748,492.0,12.0,-480.0,77250.0,45000.0,-32250.0
cashn101,Norm Cash,Cleveland Indians,INDINS,1,1,1,2,1960,1960,0,51.66,-0.16,-51.82,2018,4,-2014,7776,5,-7771,0.0,0.0,0.0,0.0,0.0,0.0
casia001,Alexi Casilla,Anaheim Angels,ANGELS,1,1,1,2,2005,2006,1,3.58,-0.95,-4.53,515,71,-444,1764,0,-1764,0.0,145.0,145.0,0.0,1250000.0,1250000.0
casia001,Alexi Casilla,Tampa Bay Devil Rays,RAYS,1,1,1,2,2015,2015,0,0.0,0.0,0.0,0,0,0,0,0,0,0.0,0.0,0.0,0.0,0.0,0.0
caskc101,Craig Caskey,Montreal Expos,NATEX,2,2,2,4,1975,1982,7,-0.34,2.72,3.06,51,271,220,126,355,229,0.0,1323.0,1323.0,0.0,0.0,0.0
cassj101,Jack Cassini,Pittsburgh Pirates,PIRATS,4,5,10,15,1949,1958,9,6.64,6.37,-0.27,487,659,172,1903,1670,-233,58.0,1608.0,1550.0,0.0,0.0,0.0
cassp101,Pete Cassidy,Brooklyn Dodgers,DOGRS,1,4,2,6,1899,1903,4,0.67,6.33,5.66,113,445,332,291,1743,1452,635.0,0.0,-635.0,0.0,0.0,0.0
casss001,Scott Cassidy,Boston Red Sox,RSOX,1,1,1,2,2005,2005,0,0.03,0.24,0.21,102,12,-90,3,18,15,165.0,0.0,-165.0,0.0,375000.0,375000.0
casta001,Alberto Castillo,St. Louis Cardinals,CARDS,1,3,2,5,1999,2000,1,0.12,1.62,1.5,212,64,-148,357,72,-285,353.0,583.0,230.0,1025000.0,8600000.0,7575000.0
casta001,Alberto Castillo,Boston Red Sox,RSOX,1,1,1,2,2007,2007,0,-0.12,0.0,0.12,11,0,-11,36,0,-36,0.0,0.0,0.0,0.0,0.0,0.0
casta002,Alberto Castillo,San Francisco Giants,GIANTS,1,2,2,4,1997,1999,2,0.0,0.66,0.66,0,206,206,0,667,667,0.0,0.0,0.0,0.0,1700000.0,1700000.0
casta003,Alex Castellanos,St. Louis Cardinals,CARDS,1,1,2,3,2011,2013,2,-0.64,2.05,2.69,24,171,147,43,748,705,0.0,0.0,0.0,0.0,13000000.0,13000000.0
casta003,Alex Castellanos,Los Angeles Dodgers,DOGRS,1,1,2,3,2013,2015,2,0.0,0.0,0.0,0,0,0,0,0,0,0.0,0.0,0.0,490500.0,0.0,-490500.0
castb001,Braulio Castillo,Los Angeles Dodgers,DOGRS,1,2,1,3,1991,1994,3,-0.35,1.49,1.84,185,369,184,139,10,-129,244.0,706.0,462.0,165000.0,2000000.0,1835000.0
castb001,Braulio Castillo,Colorado Rockies,ROCKS,1,1,1,2,1993,1993,0,0.0,-0.99,-0.99,0,28,28,0,0,0,0.0,43.0,43.0,0.0,0.0,0.0
castb002,Bernie Castro,New York Yankees,YANKS,1,1,1,2,2001,2007,6,0.0,0.18,0.18,0,12,12,0,16,16,0.0,0.0,0.0,0.0,0.0,0.0
castb101,Bill Castro,New York Yankees,YANKS,1,1,1,2,1982,1982,0,0.0,-0.81,-0.81,0,30,30,0,60,60,0.0,0.0,0.0,0.0,0.0,0.0
castc001,Carmelo Castillo,Cleveland Indians,INDINS,1,1,1,2,1989,1989,0,-2.66,-0.06,2.6,167,32,-135,395,0,-395,0.0,117.0,117.0,0.0,0.0,0.0
castd001,Daniel Castro,Los Angeles Dodgers,DOGRS,1,1,1,2,2019,2019,0,0.0,0.14,0.14,0,30,30,0,57,57,0.0,0.0,0.0,0.0,0.0,0.0
castd002,Diego Castillo,Tampa Bay Devil Rays,RAYS,1,1,2,3,2021,2021,0,0.4,0.82,0.42,25,27,2,0,0,0,66.0,71.0,5.0,0.0,100000.0,100000.0
castd003,Daniel Castano,St. Louis Cardinals,CARDS,1,4,1,5,2017,2019,2,8.96,4.59,-4.37,386,278,-108,632,1177,545,1696.0,0.0,-1696.0,0.0,3500000.0,3500000.0
castf001,Frank Castillo,Chicago Cubs,CUBS,1,1,1,2,1997,1997,0,0.51,0.0,-0.51,28,0,-28,33,0,-33,259.0,0.0,-259.0,1740000.0,0.0,-1740000.0
castf002,Fabio Castro,Kansas City Royals,ROYALS,1,1,1,2,2005,2009,4,-0.01,1.76,1.77,4,316,312,0,978,978,25.0,0.0,-25.0,0.0,0.0,0.0
castf002,Fabio Castro,Texas Rangers,RNGRS,1,1,2,3,2006,2006,0,0.84,0.0,-0.84,51,0,-51,3,0,-3,106.0,0.0,-106.0,327000.0,0.0,-327000.0
castf002,Fabio Castro,Philadelphia Phillies,PHILS,1,1,1,2,2008,2009,1,0.0,0.6,0.6,0,115,115,0,148,148,0.0,0.0,0.0,0.0,1625000.0,1625000.0
castj003,Juan Castillo,New York Mets,METS,2,3,2,5,1995,1997,2,0.02,-0.19,-0.21,4,111,107,0,113,113,42.0,991.0,949.0,3213400.0,0.0,-3213400.0
castj004,Juan Castro,Los Angeles Dodgers,DOGRS,1,1,1,2,2000,2000,0,-1.03,0.0,1.03,571,0,-571,1469,0,-1469,0.0,0.0,0.0,0.0,0.0,0.0
castj004,Juan Castro,Minnesota Twins,TWINS,1,1,1,2,2006,2006,0,-0.18,0.0,0.18,115,0,-115,209,0,-209,0.0,0.0,0.0,1000000.0,0.0,-1000000.0
castj004,Juan Castro,Colorado Rockies,ROCKS,1,1,1,2,2008,2009,1,-1.17,-0.02,1.15,54,12,-42,166,6,-160,0.0,0.0,0.0,0.0,0.0,0.0
castj006,Jason Castro,Anaheim Angels,ANGELS,1,1,1,2,2020,2020,0,-0.16,0.0,0.16,9,0,-9,30,0,-30,0.0,0.0,0.0,6850000.0,0.0,-6850000.0
castj007,Jose Castillo,Tampa Bay Devil Rays,RAYS,4,8,12,20,2014,2020,6,10.52,4.14,-6.38,1388,617,-771,4818,2218,-2600,195.0,136.0,-59.0,3254200.0,506400.0,-2747800.0
castl001,Luis Castillo,Florida Marlins,MARLNS,1,1,2,3,2005,2005,0,3.7,0.0,-3.7,227,0,-227,1036,0,-1036,0.0,0.0,0.0,5166667.0,0.0,-5166667.0
castl001,Luis Castillo,Minnesota Twins,TWINS,4,4,5,9,2007,2019,12,3.77,1.65,-2.12,558,466,-92,2185,1348,-837,5.0,417.0,412.0,5750000.0,0.0,-5750000.0
castl003,Luis Castillo,San Francisco Giants,GIANTS,1,2,1,3,2014,2015,1,0.08,-0.84,-0.92,15,49,34,2,138,136,47.0,0.0,-47.0,0.0,1100000.0,1100000.0
castl003,Luis Castillo,Miami Marlins,MARLNS,3,8,6,14,2016,2019,3,12.29,-0.08,-12.37,540,354,-186,600,126,-474,2851.0,1392.0,-1459.0,550000.0,7660200.0,7110200.0
castl003,Luis Castillo,San Diego Padres,PADRS,1,1,1,2,2016,2018,2,0.0,-0.52,-0.52,0,38,38,0,38,38,0.0,298.0,298.0,0.0,0.0,0.0
castl003,Luis Castillo,Miami Marlins,MARLNS,1,3,1,4,2017,2019,2,13.54,1.87,-11.67,336,112,-224,228,107,-121,2332.0,912.0,-1420.0,0.0,0.0,0.0
castm002,Miguel Castro,Toronto Blue Jays,BJAYS,1,4,2,6,2015,2018,3,-2.36,5.17,7.53,267,257,-10,284,987,703,875.0,49.0,-826.0,0.0,0.0,0.0
castm002,Miguel Castro,Colorado Rockies,ROCKS,1,1,1,2,2017,2017,0,3.43,0.0,-3.43,193,0,-193,0,0,0,725.0,0.0,-725.0,0.0,0.0,0.0
castm002,Miguel Castro,Baltimore Orioles,ORLS,1,1,2,3,2020,2020,0,0.7,0.0,-0.7,144,0,-144,0,0,0,238.0,0.0,-238.0,1050000.0,0.0,-1050000.0
castm101,Manny Castillo,Kansas City Royals,ROYALS,4,5,5,10,1981,1998,17,9.13,14.09,4.96,687,663,-24,1920,984,-936,1567.0,4931.0,3364.0,1360000.0,1093000.0,-267000.0
castn001,Nick Castellanos,Detroit Tigers,TIGRS,1,2,2,4,2019,2019,0,1.75,0.0,-1.75,51,0,-51,225,0,-225,0.0,0.0,0.0,9950000.0,0.0,-9950000.0
castp102,Pete Castiglione,Pittsburgh Pirates,PIRATS,2,2,3,5,1953,1954,1,-1.73,1.18,2.91,123,120,-3,136,415,279,0.0,0.0,0.0,10000.0,0.0,-10000.0
castr001,Bobby Castillo,Los Angeles Dodgers,DOGRS,1,2,2,4,1982,1984,2,5.49,0.0,-5.49,260,0,-260,694,0,-694,1207.0,0.0,-1207.0,0.0,0.0,0.0
castr002,Ramon Castro,Houston Astros,ASTROS,2,2,3,5,1998,2001,3,0.69,1.51,0.82,282,374,92,531,18,-513,116.0,721.0,605.0,1600000.0,3120000.0,1520000.0
castr002,Ramon Castro,New York Mets,METS,1,2,1,3,2009,2009,0,0.61,-0.14,-0.75,91,16,-75,287,0,-287,0.0,44.0,44.0,2625000.0,402500.0,-2222500.0
casts001,Starlin Castro,Chicago Cubs,CUBS,2,5,3,8,2015,2016,1,12.91,0.3,-12.61,808,112,-696,2851,4,-2847,353.0,185.0,-168.0,6857143.0,2572600.0,-4284543.0
casts001,Starlin Castro,New York Yankees,YANKS,1,3,1,4,2017,2017,0,2.19,0.0,-2.19,342,0,-342,1369,0,-1369,8.0,0.0,-8.0,9857143.0,14500000.0,4642857.0
casts002,Simon Castro,San Diego Padres,PADRS,7,19,13,32,2011,2021,10,17.4,14.23,-3.17,1323,1189,-134,3711,3610,-101,1751.0,362.0,-1389.0,9570500.0,5050000.0,-4520500.0
castt001,Tony Castillo,Toronto Blue Jays,BJAYS,1,2,1,3,1989,1991,2,0.35,0.29,-0.06,335,127,-208,372,0,-372,284.0,625.0,341.0,71500.0,688000.0,616500.0
castt001,Tony Castillo,Atlanta Braves,BRAVES,1,2,1,3,1991,1992,1,0.78,0.88,0.1,20,112,92,6,3,-3,71.0,184.0,113.0,165000.0,1000000.0,835000.0
castt001,Tony Castillo,New York Mets,METS,1,2,2,4,1992,1993,1,-1.21,-0.71,0.5,101,102,1,364,8,-356,0.0,212.0,212.0,0.0,0.0,0.0
castt001,Tony Castillo,Toronto Blue Jays,BJAYS,1,2,2,4,1996,1998,2,-1.48,-0.91,0.57,123,26,-97,23,0,-23,336.0,210.0,-126.0,890000.0,0.0,-890000.0
castv001,Vinny Castilla,Colorado Rockies,ROCKS,8,14,14,28,1999,2002,3,5.44,1.04,-4.4,985,502,-483,1111,225,-886,2239.0,1232.0,-1007.0,15375000.0,7052500.0,-8322500.0
castv001,Vinny Castilla,Washington Nationals,NATEX,1,1,2,3,2005,2006,1,-0.84,0.0,0.84,72,0,-72,269,0,-269,0.0,0.0,0.0,3000000.0,2375000.0,-625000.0
castw001,Wilkin Castillo,Arizona Diamondbacks,DBACKS,1,3,2,5,2008,2008,0,-0.17,-0.36,-0.19,138,44,-94,113,187,74,459.0,0.0,-459.0,402000.0,13000000.0,12598000.0
castw002,Welington Castillo,Chicago Cubs,CUBS,1,1,1,2,2015,2015,0,-0.34,-0.12,0.22,6,9,3,28,0,-28,0.0,27.0,27.0,0.0,0.0,0.0
castw002,Welington Castillo,Seattle Mariners,MARNRS,3,7,4,11,2015,2017,2,4.57,3.33,-1.24,655,244,-411,2424,508,-1916,92.0,403.0,311.0,9532900.0,9014000.0,-518900.0
castw002,Welington Castillo,Chicago White Sox,WSOX,1,2,1,3,2019,2019,0,0.0,0.0,0.0,0,0,0,0,0,0,0.0,0.0,0.0,7250000.0,0.0,-7250000.0
castw003,Willi Castro,Cleveland Indians,INDINS,1,1,2,3,2018,2019,1,-0.75,0.14,0.89,191,71,-120,700,281,-419,0.0,0.0,0.0,0.0,1750000.0,1750000.0
cataf001,Frank Catalanotto,Detroit Tigers,TIGRS,1,6,3,9,1999,2004,5,20.76,4.31,-16.45,1380,309,-1071,3548,496,-3052,1196.0,551.0,-645.0,1937500.0,9240000.0,7302500.0
cated101,Danny Cater,Philadelphia Phillies,PHILS,1,2,2,4,1964,1966,2,0.7,1.42,0.72,243,96,-147,836,60,-776,0.0,543.0,543.0,6000.0,26500.0,20500.0
cated101,Danny Cater,Chicago White Sox,WSOX,2,2,2,4,1966,1969,3,4.01,0.88,-3.13,561,357,-204,2213,788,-1425,0.0,0.0,0.0,0.0,0.0,0.0
cated101,Danny Cater,Oakland Athletics,ATLTCS,7,16,9,25,1969,1976,7,16.4,13.94,-2.46,3230,1354,-1876,8120,3449,-4671,2546.0,1199.0,-1347.0,314600.0,425500.0,110900.0
cated101,Danny Cater,New York Yankees,YANKS,23,51,43,94,1972,1997,25,84.01,74.64,-9.37,6091,4059,-2032,14328,7586,-6742,18451.0,11941.0,-6510.0,5628333.0,4757500.0,-870833.0
cated101,Danny Cater,Boston Red Sox,RSOX,1,1,1,2,1975,1975,0,-0.29,0.0,0.29,22,0,-22,36,0,-36,0.0,0.0,0.0,0.0,0.0,0.0
catht101,Ted Cather,St. Louis Cardinals,CARDS,1,2,1,3,1914,1914,0,0.65,1.83,1.18,156,44,-112,545,55,-490,0.0,460.0,460.0,2300.0,0.0,-2300.0
catok001,Keefe Cato,Cincinnati Reds,REDS,1,1,1,2,1984,1984,0,0.0,0.0,0.0,0,0,0,0,0,0,0.0,0.0,0.0,0.0,0.0,0.0
caudb001,Bill Caudill,St. Louis Cardinals,CARDS,11,28,20,48,1977,1992,15,92.92,101.73,8.81,7343,4607,-2736,22954,15202,-7752,6532.0,3025.0,-3507.0,1533333.0,576667.0,-956666.0
caudb001,Bill Caudill,Cincinnati Reds,REDS,1,2,1,3,1977,1981,4,2.78,3.66,0.88,288,112,-176,68,126,58,1033.0,1005.0,-28.0,85000.0,0.0,-85000.0
caudb001,Bill Caudill,Chicago Cubs,CUBS,4,8,7,15,1982,1990,8,11.89,11.37,-0.52,835,655,-180,2292,401,-1891,1070.0,3028.0,1958.0,890000.0,85000.0,-805000.0
caudb001,Bill Caudill,New York Yankees,YANKS,3,6,4,10,1982,1987,5,15.14,5.21,-9.93,593,176,-417,734,188,-546,3682.0,1574.0,-2108.0,62500.0,700000.0,637500.0
caudb001,Bill Caudill,Seattle Mariners,MARNRS,1,2,2,4,1983,1987,4,2.3,0.84,-1.46,79,391,312,1,1067,1066,329.0,228.0,-101.0,0.0,0.0,0.0
caudb001,Bill Caudill,Oakland Athletics,ATLTCS,3,6,6,12,1984,1994,10,10.58,18.23,7.65,1212,796,-416,2291,2253,-38,1413.0,3814.0,2401.0,1837653.0,1837500.0,-153.0
caulj101,Jake Caulfield,Philadelphia Athletics,ATLTCS,1,4,1,5,1946,1954,8,0.34,26.76,26.42,48,917,869,112,4210,4098,0.0,0.0,0.0,7000.0,0.0,-7000.0
caulj101,Jake Caulfield,Oakland,Oakland,1,1,3,4,1945,1946,1,-0.24,0.0,0.24,44,0,-44,98,0,-98,0.0,0.0,0.0,0.0,8000.0,8000.0
causr101,Red Causey,New York Giants,GIANTS,1,5,1,6,1919,1926,7,8.66,14.34,5.68,964,460,-504,2314,555,-1759,3291.0,4306.0,1015.0,5412.0,6226.0,814.0
causr101,Red Causey,Philadelphia Phillies,PHILS,6,12,11,23,1921,1936,15,25.95,-0.45,-26.4,1417,2380,963,5389,9549,4160,330.0,992.0,662.0,43100.0,14050.0,-29050.0
causr101,Red Causey,New York Giants,GIANTS,1,5,1,6,1922,1924,2,0.0,-0.65,-0.65,0,89,89,0,166,166,0.0,0.0,0.0,4200.0,0.0,-4200.0
causw101,Wayne Causey,Baltimore Orioles,ORLS,4,11,7,18,1961,1973,12,20.55,30.35,9.8,1602,1797,195,5528,6131,603,845.0,306.0,-539.0,72000.0,40300.0,-31700.0
causw101,Wayne Causey,Kansas City Athletics,ATLTCS,8,17,10,27,1966,1976,10,18.3,18.25,-0.05,3491,1911,-1580,8767,5651,-3116,2546.0,1199.0,-1347.0,314600.0,425500.0,110900.0
causw101,Wayne Causey,Chicago White Sox,WSOX,1,1,1,2,1968,1969,1,-0.3,-1.02,-0.72,4,96,92,11,141,130,0.0,0.0,0.0,0.0,0.0,0.0
cavej001,Jake Cave,New York Yankees,YANKS,1,1,1,2,2018,2018,0,1.75,0.0,-1.75,281,0,-281,838,0,-838,0.0,0.0,0.0,0.0,0.0,0.0
ceasd001,Dylan Cease,Chicago Cubs,CUBS,1,4,1,5,2017,2020,3,6.48,3.51,-2.97,293,156,-137,969,150,-819,891.0,1319.0,428.0,0.0,0.0,0.0
cecca101,Art Ceccarelli,Kansas City Athletics,ATLTCS,52,112,116,228,1956,1976,20,250.68,149.14,-101.54,20796,15499,-5297,51279,47670,-3609,28842.0,13383.0,-15459.0,673600.0,839000.0,165400.0
cecca101,Art Ceccarelli,Chicago Cubs,CUBS,1,1,1,2,1960,1960,0,0.0,-0.85,-0.85,0,60,60,0,22,22,0.0,230.0,230.0,0.0,0.0,0.0
cecca101,Art Ceccarelli,Baltimore Orioles,ORLS,1,2,1,3,1958,1958,0,0.0,0.0,0.0,0,0,0,0,0,0,0.0,0.0,0.0,0.0,0.0,0.0
cecid001,Darrell Ceciliani,New York Mets,METS,1,1,1,2,2016,2016,0,-0.32,0.0,0.32,16,0,-16,34,0,-34,0.0,0.0,0.0,0.0,0.0,0.0
cedaj001,Jose Ceda,San Diego Padres,PADRS,1,1,1,2,2006,2007,1,0.0,0.81,0.81,0,44,44,0,142,142,0.0,0.0,0.0,0.0,2500000.0,2500000.0
cedaj001,Jose Ceda,Chicago Cubs,CUBS,1,1,1,2,2008,2009,1,0.05,0.05,0.0,49,142,93,2,0,-2,87.0,206.0,119.0,0.0,2500000.0,2500000.0
cedea001,Andujar Cedeno,Houston Astros,ASTROS,14,30,36,66,1994,2008,14,59.26,31.82,-27.44,4671,6059,1388,11202,15757,4555,6620.0,5977.0,-643.0,31714000.0,14229000.0,-17485000.0
cedea001,Andujar Cedeno,San Diego Padres,PADRS,4,7,8,15,1996,2006,10,4.5,17.6,13.1,1037,1883,846,3956,6307,2351,0.0,1106.0,1106.0,11375000.0,15550000.0,4175000.0
cedec001,Cesar Cedeno,Houston Astros,ASTROS,2,2,4,6,1981,1992,11,4.7,10.88,6.18,683,996,313,2507,3556,1049,0.0,0.0,0.0,0.0,0.0,0.0
cedec001,Cesar Cedeno,Cincinnati Reds,REDS,1,1,1,2,1985,1985,0,1.15,0.0,-1.15,28,0,-28,82,0,-82,0.0,0.0,0.0,0.0,0.0,0.0
ceded001,Domingo Cedeno,Toronto Blue Jays,BJAYS,1,2,2,4,1996,1998,2,-1.48,-0.91,0.57,123,26,-97,23,0,-23,336.0,210.0,-126.0,890000.0,0.0,-890000.0
ceded001,Domingo Cedeno,Seattle Mariners,MARNRS,1,1,1,2,1999,2000,1,-0.52,0.0,0.52,32,0,-32,72,0,-72,0.0,0.0,0.0,0.0,0.0,0.0
ceder001,Roger Cedeno,Los Angeles Dodgers,DOGRS,1,2,2,4,1998,2000,2,1.05,2.33,1.28,452,204,-248,1614,781,-833,0.0,0.0,0.0,280000.0,4925000.0,4645000.0
ceder001,Roger Cedeno,New York Mets,METS,1,3,2,5,1999,2000,1,10.81,6.86,-3.95,663,212,-451,364,706,342,1347.0,656.0,-691.0,687500.0,8625000.0,7937500.0
ceder001,Roger Cedeno,Houston Astros,ASTROS,2,4,4,8,2000,2008,8,0.51,2.1,1.59,210,1212,1002,625,3536,2911,615.0,482.0,-133.0,4015000.0,5550000.0,1535000.0
ceder001,Roger Cedeno,New York Mets,METS,1,1,1,2,2004,2004,0,-1.41,0.72,2.13,132,42,-90,284,147,-137,0.0,0.0,0.0,0.0,0.0,0.0
ceder002,Ronny Cedeno,Chicago Cubs,CUBS,2,3,3,6,2009,2012,3,-3.45,0.86,4.31,326,217,-109,212,3,-209,676.0,339.0,-337.0,1625000.0,0.0,-1625000.0
ceder002,Ronny Cedeno,Seattle Mariners,MARNRS,2,6,3,9,2009,2011,2,-0.04,2.82,2.86,447,179,-268,1426,514,-912,0.0,332.0,332.0,5822500.0,10600000.0,4777500.0
ceder002,Ronny Cedeno,Philadelphia Phillies,PHILS,1,1,1,2,2014,2014,0,0.0,0.0,0.0,0,0,0,0,0,0,0.0,0.0,0.0,0.0,0.0,0.0
cedex001,Xavier Cedeno,Chicago White Sox,WSOX,1,1,2,3,2018,2018,0,0.32,0.0,-0.32,30,0,-30,0,0,0,24.0,0.0,-24.0,0.0,0.0,0.0
celeg001,Gilberto Celestino,Houston Astros,ASTROS,1,2,1,3,2018,2018,0,0.45,1.4,0.95,104,28,-76,62,0,-62,256.0,70.0,-186.0,0.0,1600000.0,1600000.0
cepeo101,Orlando Cepeda,San Francisco Giants,GIANTS,3,4,4,8,1966,1971,5,19.86,3.15,-16.71,1237,353,-884,3225,458,-2767,1801.0,2055.0,254.0,45000.0,13000.0,-32000.0
cepeo101,Orlando Cepeda,St. Louis Cardinals,CARDS,7,9,9,18,1969,1978,9,20.36,28.08,7.72,1905,1280,-625,3084,4748,1664,2982.0,616.0,-2366.0,202000.0,0.0,-202000.0
cepeo101,Orlando Cepeda,Atlanta Braves,BRAVES,1,1,1,2,1972,1973,1,0.0,-0.92,-0.92,3,30,27,3,16,13,0.0,162.0,162.0,0.0,75000.0,75000.0
cerdj001,Jaime Cerda,New York Mets,METS,1,1,1,2,2004,2004,0,0.63,0.0,-0.63,76,0,-76,0,0,0,194.0,0.0,-194.0,0.0,0.0,0.0
ceror001,Rick Cerone,Cleveland Indians,INDINS,3,4,3,7,1976,1979,3,1.78,5.31,3.53,491,315,-176,1873,1149,-724,0.0,405.0,405.0,0.0,0.0,0.0
ceror001,Rick Cerone,Toronto Blue Jays,BJAYS,5,9,9,18,1979,1987,8,10.29,14.89,4.6,1883,1679,-204,6026,5403,-623,668.0,1848.0,1180.0,0.0,240000.0,240000.0
ceror001,Rick Cerone,New York Yankees,YANKS,9,13,15,28,1984,1997,13,30.52,14.41,-16.11,1346,1172,-174,2196,1524,-672,6414.0,4206.0,-2208.0,4225000.0,2212500.0,-2012500.0
ceror001,Rick Cerone,Atlanta Braves,BRAVES,1,3,1,4,1986,1986,0,1.33,-0.29,-1.62,68,76,8,242,144,-98,0.0,0.0,0.0,0.0,0.0,0.0
cervb101,Bob Cerv,Kansas City Athletics,ATLTCS,20,41,35,76,1960,1976,16,70.19,35.04,-35.15,6993,4063,-2930,16448,11579,-4869,8728.0,3414.0,-5314.0,393100.0,483000.0,89900.0
cervb101,Bob Cerv,Los Angeles Angels,ANGELS,2,3,4,7,1961,1965,4,3.26,2.99,-0.27,414,909,495,1204,2598,1394,209.0,725.0,516.0,0.0,0.0,0.0
cervf001,Francisco Cervelli,New York Yankees,YANKS,3,4,4,8,2014,2021,7,12.5,3.51,-8.99,653,215,-438,1734,2,-1732,424.0,1059.0,635.0,5156000.0,515000.0,-4641000.0
cervh001,Hunter Cervenka,Boston Red Sox,RSOX,1,2,2,4,2012,2012,0,0.77,-0.16,-0.93,128,34,-94,2,106,104,223.0,0.0,-223.0,484000.0,0.0,-484000.0
cervh001,Hunter Cervenka,Atlanta Braves,BRAVES,1,1,2,3,2016,2016,0,-0.38,0.0,0.38,45,0,-45,0,0,0,42.0,0.0,-42.0,0.0,0.0,0.0
cespy001,Yoenis Cespedes,Oakland Athletics,ATLTCS,1,2,3,5,2014,2014,0,1.49,1.27,-0.22,51,46,-5,213,77,-136,0.0,230.0,230.0,0.0,5000000.0,5000000.0
cespy001,Yoenis Cespedes,Boston Red Sox,RSOX,1,3,1,4,2014,2019,5,9.45,9.39,-0.06,366,170,-196,427,24,-403,794.0,2892.0,2098.0,10500000.0,8500000.0,-2000000.0
cespy001,Yoenis Cespedes,Detroit Tigers,TIGRS,3,5,6,11,2015,2017,2,18.85,2.36,-16.49,941,142,-799,1424,106,-1318,2199.0,297.0,-1902.0,15200000.0,556000.0,-14644000.0
cessl001,Luis Cessa,New York Mets,METS,1,2,1,3,2015,2020,5,10.66,7.65,-3.01,148,316,168,14,1304,1290,1660.0,0.0,-1660.0,0.0,10500000.0,10500000.0
cessl001,Luis Cessa,Detroit Tigers,TIGRS,2,4,4,8,2015,2017,2,11.2,2.36,-8.84,625,142,-483,120,106,-14,2199.0,297.0,-1902.0,4700000.0,556000.0,-4144000.0
cessl001,Luis Cessa,New York Yankees,YANKS,1,2,1,3,2021,2021,0,1.83,0.0,-1.83,88,0,-88,0,0,0,127.0,0.0,-127.0,3900000.0,0.0,-3900000.0
cey-r001,Ron Cey,Los Angeles Dodgers,DOGRS,1,1,2,3,1983,1985,2,6.09,0.0,-6.09,547,0,-547,2108,0,-2108,0.0,0.0,0.0,0.0,0.0,0.0
cey-r001,Ron Cey,Chicago Cubs,CUBS,2,2,2,4,1987,1988,1,1.79,-0.42,-2.21,345,63,-282,964,113,-851,0.0,37.0,37.0,0.0,0.0,0.0
chace101,Elio Chacon,New York Mets,METS,1,2,2,4,1964,1964,0,0.41,0.0,-0.41,120,0,-120,87,0,-87,740.0,0.0,-740.0,0.0,0.0,0.0
chacj001,Jhoulys Chacin,Atlanta Braves,BRAVES,1,1,1,2,2016,2018,2,0.37,-0.08,-0.45,30,2,-28,2,0,-2,352.0,3.0,-349.0,0.0,0.0,0.0
chacs001,Shawn Chacon,Colorado Rockies,ROCKS,2,2,3,5,2005,2016,11,4.6,14.9,10.3,108,571,463,3,403,400,641.0,3679.0,3038.0,2350000.0,0.0,-2350000.0
chacs001,Shawn Chacon,New York Yankees,YANKS,1,1,1,2,2006,2006,0,1.4,-0.91,-2.31,143,40,-103,28,109,81,426.0,0.0,-426.0,3600000.0,3300000.0,-300000.0
chadr001,Ray Chadwick,Chicago White Sox,WSOX,1,1,1,2,1989,1989,0,0.0,0.0,0.0,0,0,0,0,0,0,0.0,0.0,0.0,0.0,0.0,0.0
chafa001,Andrew Chafin,Arizona Diamondbacks,DBACKS,1,2,1,3,2020,2020,0,1.53,0.0,-1.53,88,0,-88,0,0,0,127.0,0.0,-127.0,3045000.0,0.0,-3045000.0
chafa001,Andrew Chafin,Chicago Cubs,CUBS,1,1,2,3,2021,2021,0,1.44,-0.36,-1.8,29,14,-15,0,31,31,88.0,0.0,-88.0,2250000.0,0.0,-2250000.0
chagl101,Leon Chagnon,Pittsburgh Pirates,PIRATS,6,9,6,15,1934,1946,12,4.27,17.42,13.15,232,1158,926,671,4034,3363,315.0,687.0,372.0,3000.0,2400.0,-600.0
chakb101,Bob Chakales,Cleveland Indians,INDINS,4,5,6,11,1954,1965,11,10.14,21.84,11.7,1197,1200,3,4089,3837,-252,268.0,1913.0,1645.0,4800.0,0.0,-4800.0
chakb101,Bob Chakales,Baltimore Orioles,ORLS,4,7,9,16,1954,1960,6,15.05,10.88,-4.17,745,881,136,1673,2506,833,2291.0,1208.0,-1083.0,0.0,0.0,0.0
chakb101,Bob Chakales,Chicago White Sox,WSOX,17,31,30,61,1955,1969,14,22.96,44.36,21.4,3375,3578,203,7415,6981,-434,5139.0,7668.0,2529.0,156750.0,157500.0,750.0
chakb101,Bob Chakales,Washington Senators,TWINS,2,3,4,7,1957,1960,3,-2.93,-2.21,0.72,70,643,573,21,1367,1346,250.0,1860.0,1610.0,19500.0,0.0,-19500.0
chald101,Dave Chalk,California Angels,ANGELS,1,1,1,2,1979,1981,2,-0.06,0.18,0.24,9,217,208,9,598,589,0.0,0.0,0.0,0.0,190000.0,190000.0
chald101,Dave Chalk,Texas Rangers,RNGRS,3,7,3,10,1979,1986,7,15.39,12.85,-2.54,1067,529,-538,2903,1715,-1188,4307.0,1244.0,-3063.0,0.0,250000.0,250000.0
chama002,Adron Chambers,Houston Astros,ASTROS,1,1,2,3,2014,2014,0,0.0,0.0,0.0,0,0,0,0,0,0,0.0,0.0,0.0,0.0,0.0,0.0
chamb101,Bill Champion,Philadelphia Phillies,PHILS,3,7,6,13,1972,1979,7,31.4,20.05,-11.35,1669,1025,-644,5610,3103,-2507,2357.0,4062.0,1705.0,29500.0,80800.0,51300.0
chamc001,Chris Chambliss,Cleveland Indians,INDINS,5,10,12,22,1974,1980,6,19.8,1.33,-18.47,1334,439,-895,4058,397,-3661,2358.0,2962.0,604.0,38000.0,65000.0,27000.0
chamc001,Chris Chambliss,New York Yankees,YANKS,13,23,23,46,1979,1997,18,40.16,16.71,-23.45,2656,1808,-848,6433,3520,-2913,8337.0,5150.0,-3187.0,4715000.0,3012500.0,-1702500.0
chamc001,Chris Chambliss,Toronto Blue Jays,BJAYS,2,3,4,7,1979,1985,6,4.77,5.46,0.69,1218,673,-545,3925,1647,-2278,3.0,1160.0,1157.0,0.0,0.0,0.0
chamc101,Craig Chamberlain,Kansas City Royals,ROYALS,3,7,5,12,1982,1990,8,15.6,24.69,9.09,1105,393,-712,1343,512,-831,5715.0,4650.0,-1065.0,1318000.0,662500.0,-655500.0
chamc102,Cliff Chambers,Chicago Cubs,CUBS,1,2,2,4,1948,1955,7,10.4,0.75,-9.65,514,154,-360,1252,339,-913,1459.0,506.0,-953.0,6500.0,0.0,-6500.0
chamc102,Cliff Chambers,Pittsburgh Pirates,PIRATS,20,37,49,86,1951,1973,22,26.24,49.68,23.44,3262,4651,1389,9080,13358,4278,3705.0,3970.0,265.0,216500.0,102000.0,-114500.0
chamj101,Johnnie Chambers,Brooklyn Dodgers,DOGRS,1,1,1,2,1938,1938,0,0.0,-0.08,-0.08,0,26,26,0,4,4,0.0,71.0,71.0,0.0,0.0,0.0
chamj101,Johnnie Chambers,Brooklyn Dodgers,DOGRS,1,2,1,3,1939,1939,0,0.0,0.13,0.13,0,32,32,0,99,99,0.0,0.0,0.0,0.0,0.0,0.0
chamm101,Mike Champion,San Diego Padres,PADRS,2,3,2,5,1979,1981,2,-0.61,-0.41,0.2,27,234,207,51,691,640,0.0,0.0,0.0,0.0,300000.0,300000.0
chamw001,Wes Chamberlain,Pittsburgh Pirates,PIRATS,2,4,2,6,1990,1991,1,3.0,-0.21,-3.21,512,23,-489,1575,37,-1538,0.0,0.0,0.0,925000.0,700000.0,-225000.0
chamw001,Wes Chamberlain,Philadelphia Phillies,PHILS,3,5,5,10,1994,2000,6,9.86,-2.15,-12.01,543,698,155,225,2244,2019,1674.0,703.0,-971.0,876500.0,1319000.0,442500.0
chamw001,Wes Chamberlain,Boston Red Sox,RSOX,1,1,1,2,1995,1995,0,0.0,-0.13,-0.13,0,16,16,0,27,27,0.0,0.0,0.0,0.0,310000.0,310000.0
chamw001,Wes Chamberlain,Pittsburgh Pirates,PIRATS,1,2,2,4,1997,1997,0,0.0,0.0,0.0,0,0,0,0,0,0,0.0,0.0,0.0,0.0,0.0,0.0
chanb101,Bob Chance,Cleveland Indians,INDINS,11,17,17,34,1964,1984,20,50.19,18.25,-31.94,3277,3447,170,11873,12142,269,38.0,317.0,279.0,210250.0,385600.0,175350.0
chanb101,Bob Chance,California Angels,ANGELS,5,10,10,20,1969,1976,7,0.53,5.03,4.5,382,668,286,431,1911,1480,1134.0,244.0,-890.0,47000.0,131300.0,84300.0
chanc101,Charlie Chant,Oakland Athletics,ATLTCS,1,1,1,2,1975,1978,3,-0.07,0.35,0.42,15,109,94,14,44,30,0.0,0.0,0.0,0.0,0.0,0.0
chand101,Darrel Chaney,Cincinnati Reds,REDS,1,1,1,2,1975,1978,3,-1.7,0.12,1.82,379,251,-128,1206,469,-737,0.0,0.0,0.0,0.0,0.0,0.0
chand102,Dean Chance,Washington Senators,RNGRS,1,1,1,2,1960,1962,2,17.91,-0.43,-18.34,446,114,-332,442,220,-222,3710.0,0.0,-3710.0,0.0,0.0,0.0
chand102,Dean Chance,California Angels,ANGELS,3,4,5,9,1966,1969,3,10.95,8.69,-2.26,553,605,52,930,2108,1178,1992.0,0.0,-1992.0,45000.0,44000.0,-1000.0
chand102,Dean Chance,Minnesota Twins,TWINS,2,5,4,9,1969,1971,2,19.42,3.86,-15.56,887,264,-623,3069,67,-3002,587.0,852.0,265.0,120000.0,70000.0,-50000.0
chand102,Dean Chance,New York Mets,METS,1,2,1,3,1971,1971,0,0.49,0.0,-0.49,124,0,-124,28,0,-28,416.0,0.0,-416.0,0.0,0.0,0.0
chapa001,Aroldis Chapman,Cincinnati Reds,REDS,1,1,4,5,2015,2018,3,7.44,-1.95,-9.39,300,91,-209,0,75,75,774.0,145.0,-629.0,8050000.0,0.0,-8050000.0
chapa001,Aroldis Chapman,New York Yankees,YANKS,3,4,6,10,2016,2020,4,0.46,6.64,6.18,349,162,-187,932,8,-924,145.0,1176.0,1031.0,3936900.0,13000000.0,9063100.0
chapb102,Ben Chapman,New York Yankees,YANKS,1,1,1,2,1936,1940,4,4.03,0.53,-3.5,160,272,112,750,1066,316,0.0,0.0,0.0,10000.0,0.0,-10000.0
chapb102,Ben Chapman,Washington Senators,TWINS,3,4,5,9,1937,1942,5,10.77,13.4,2.63,718,1031,313,2678,3529,851,623.0,1269.0,646.0,39500.0,26000.0,-13500.0
chapb102,Ben Chapman,Boston Red Sox,RSOX,1,1,2,3,1938,1940,2,5.73,1.22,-4.51,292,110,-182,1286,104,-1182,0.0,801.0,801.0,12500.0,6500.0,-6000.0
chapb102,Ben Chapman,Cleveland Indians,INDINS,1,1,1,2,1940,1940,0,-0.27,0.0,0.27,28,0,-28,121,0,-121,0.0,0.0,0.0,15000.0,0.0,-15000.0
chapb102,Ben Chapman,Brooklyn Dodgers,DOGRS,1,1,1,2,1945,1945,0,-0.26,0.41,0.67,29,48,19,54,134,80,26.0,0.0,-26.0,0.0,0.0,0.0
chapd001,Darrin Chapin,New York Yankees,YANKS,1,1,1,2,1992,1992,0,-0.07,2.19,2.26,2,142,140,0,549,549,6.0,0.0,-6.0,0.0,0.0,0.0
chape101,Ed Chapman,St. Louis Cardinals,CARDS,1,1,2,3,1933,1934,1,-0.19,0.0,0.19,12,0,-12,3,0,-3,29.0,0.0,-29.0,0.0,3750.0,3750.0
chape101,Ed Chapman,Washington Senators,TWINS,2,4,3,7,1934,1939,5,1.0,0.43,-0.57,49,132,83,167,445,278,0.0,0.0,0.0,6000.0,0.0,-6000.0
chapf102,Fred Chapman,Washington Senators,TWINS,1,1,2,3,1937,1940,3,0.0,0.0,0.0,0,0,0,0,0,0,0.0,0.0,0.0,0.0,0.0,0.0
chapf102,Fred Chapman,Philadelphia Athletics,ATLTCS,1,1,1,2,1941,1941,0,0.0,0.0,0.0,0,0,0,0,0,0,0.0,0.0,0.0,3000.0,0.0,-3000.0
chapg101,Glenn Chapman,Cincinnati Reds,REDS,1,3,1,4,1939,1939,0,0.0,-0.1,-0.1,0,6,6,0,14,14,0.0,0.0,0.0,0.0,0.0,0.0
chaph102,Harry Chapman,Chicago Cubs,CUBS,1,3,5,8,1912,1913,1,3.8,1.08,-2.72,112,82,-30,420,326,-94,0.0,0.0,0.0,7925.0,9780.0,1855.0
chaph102,Harry Chapman,Cincinnati Reds,REDS,1,2,1,3,1913,1913,0,1.26,1.29,0.03,62,80,18,167,226,59,0.0,0.0,0.0,1500.0,0.0,-1500.0
chaph102,Harry Chapman,St.Louis Browns,ORLS,1,3,1,4,1916,1916,0,0.0,0.05,0.05,0,27,27,0,42,42,0.0,0.0,0.0,4200.0,0.0,-4200.0
chapj001,Jaye Chapman,Atlanta Braves,BRAVES,1,2,3,5,2012,2013,1,0.12,-0.62,-0.74,37,188,151,0,323,323,51.0,665.0,614.0,0.0,1150000.0,1150000.0
chapk002,Kevin Chapman,Kansas City Royals,ROYALS,1,2,2,4,2012,2012,0,0.42,-0.3,-0.72,60,73,13,0,210,210,165.0,0.0,-165.0,0.0,0.0,0.0
chapk002,Kevin Chapman,Atlanta Braves,BRAVES,1,2,1,3,2017,2018,1,0.0,-0.09,-0.09,0,84,84,0,184,184,0.0,0.0,0.0,0.0,0.0,0.0
chapl101,Larry Chappell,Milwaukee,Milwaukee,1,1,2,3,1913,1915,2,-0.33,0.0,0.33,82,0,-82,278,0,-278,0.0,0.0,0.0,0.0,0.0,0.0
chapl101,Larry Chappell,Chicago White Sox,WSOX,1,4,1,5,1915,1916,1,11.33,0.0,-11.33,533,0,-533,1606,0,-1606,1090.0,0.0,-1090.0,0.0,0.0,0.0
chaps101,Sam Chapman,Philadelphia Athletics,ATLTCS,1,1,2,3,1951,1953,2,-0.66,0.02,0.68,94,196,102,273,612,339,0.0,0.0,0.0,16500.0,0.0,-16500.0
chapt101,Tiny Chaplin,Boston Braves,BRAVES,7,21,11,32,1936,1952,16,22.0,38.45,16.45,1506,1907,401,5516,6570,1054,0.0,2449.0,2449.0,12500.0,0.0,-12500.0
charc101,Chappy Charles,St. Louis Cardinals,CARDS,2,4,6,10,1909,1920,11,9.92,20.82,10.9,510,1351,841,1289,5062,3773,2306.0,795.0,-1511.0,13500.0,11400.0,-2100.0
chare101,Ed Charles,Milwaukee Braves,BRAVES,11,17,20,37,1961,1973,12,24.16,33.51,9.35,2325,1915,-410,6983,5059,-1924,2257.0,3206.0,949.0,95000.0,38000.0,-57000.0
chare101,Ed Charles,Kansas City Athletics,ATLTCS,1,1,2,3,1967,1967,0,5.12,0.0,-5.12,279,0,-279,963,0,-963,0.0,0.0,0.0,25000.0,0.0,-25000.0
charj001,J.T. Chargois,Seattle Mariners,MARNRS,1,2,1,3,2021,2021,0,0.82,0.4,-0.42,27,25,-2,0,0,0,71.0,66.0,-5.0,100000.0,0.0,-100000.0
charj101,Joe Charboneau,Philadelphia Phillies,PHILS,1,1,1,2,1978,1978,0,1.54,0.0,-1.54,201,0,-201,722,0,-722,0.0,0.0,0.0,0.0,0.0,0.0
charm101,Mike Chartak,Washington Senators,TWINS,1,2,2,4,1942,1942,0,6.64,0.79,-5.85,330,98,-232,878,296,-582,1025.0,122.0,-903.0,7250.0,7500.0,250.0
charn001,Norm Charlton,Montreal Expos,NATEX,1,2,1,3,1986,1986,0,6.55,-0.38,-6.93,483,101,-382,101,247,146,1511.0,0.0,-1511.0,0.0,0.0,0.0
charn001,Norm Charlton,Cincinnati Reds,REDS,1,1,1,2,1992,1994,2,2.11,6.33,4.22,256,188,-68,0,733,733,825.0,0.0,-825.0,1200000.0,3750000.0,2550000.0
chash101,Hal Chase,New York Yankees,YANKS,2,3,3,6,1913,1914,1,2.78,-0.53,-3.31,160,153,-7,648,601,-47,0.0,0.0,0.0,6000.0,0.0,-6000.0
chash101,Hal Chase,Cincinnati Reds,REDS,2,2,4,6,1919,1921,2,1.08,0.47,-0.61,646,102,-544,2661,289,-2372,0.0,0.0,0.0,0.0,0.0,0.0
chask101,Ken Chase,Washington Senators,TWINS,16,29,30,59,1941,1963,22,24.05,43.96,19.91,2536,4015,1479,7469,11713,4244,2727.0,6408.0,3681.0,56000.0,82500.0,26500.0
chask101,Ken Chase,Boston Red Sox,RSOX,1,1,1,2,1943,1943,0,0.15,-0.6,-0.75,44,30,-14,46,127,81,388.0,0.0,-388.0,9000.0,7000.0,-2000.0
chatb101,Buster Chatham,Portland,Portland,1,1,2,3,1930,1930,0,-0.08,0.0,0.08,129,0,-129,512,0,-512,0.0,0.0,0.0,0.0,5000.0,5000.0
chatt001,Tyler Chatwood,Anaheim Angels,ANGELS,1,1,1,2,2011,2015,4,10.24,6.02,-4.22,216,394,178,183,1342,1159,1517.0,0.0,-1517.0,0.0,2550000.0,2550000.0
chava002,Angel Chavez,Philadelphia Phillies,PHILS,2,2,3,5,2006,2006,0,-0.18,-0.09,0.09,80,28,-52,242,107,-135,0.0,0.0,0.0,0.0,1700000.0,1700000.0
chave002,Endy Chavez,New York Mets,METS,1,1,1,2,2001,2001,0,-0.82,0.0,0.82,29,0,-29,80,0,-80,0.0,0.0,0.0,0.0,0.0,0.0
chave002,Endy Chavez,Washington Nationals,NATEX,1,1,1,2,2005,2006,1,-0.42,1.06,1.48,91,152,61,118,472,354,0.0,0.0,0.0,0.0,0.0,0.0
chave002,Endy Chavez,New York Mets,METS,1,7,3,10,2008,2010,2,8.89,-1.25,-10.14,554,358,-196,1346,179,-1167,2162.0,325.0,-1837.0,3398000.0,4805000.0,1407000.0
chavj001,Jesse Chavez,Texas Rangers,RNGRS,1,1,1,2,2006,2006,0,-0.2,-0.07,0.13,174,2,-172,1,0,-1,247.0,24.0,-223.0,0.0,4150000.0,4150000.0
chavj001,Jesse Chavez,Pittsburgh Pirates,PIRATS,1,1,1,2,2009,2010,1,0.0,-1.64,-1.64,0,54,54,0,193,193,0.0,0.0,0.0,402000.0,3250000.0,2848000.0
chavj001,Jesse Chavez,Tampa Bay Devil Rays,RAYS,1,1,1,2,2009,2010,1,0.72,2.11,1.39,115,71,-44,4,0,-4,211.0,187.0,-24.0,0.0,6350000.0,6350000.0
chavj001,Jesse Chavez,Atlanta Braves,BRAVES,1,3,2,5,2010,2010,0,2.01,-0.01,-2.02,319,93,-226,204,139,-65,734.0,60.0,-674.0,415000.0,7250000.0,6835000.0
chavj001,Jesse Chavez,Oakland Athletics,ATLTCS,1,1,1,2,2015,2020,5,-0.06,6.06,6.12,44,261,217,0,0,0,124.0,789.0,665.0,2150000.0,518400.0,-1631600.0
chavj001,Jesse Chavez,Toronto Blue Jays,BJAYS,1,1,1,2,2016,2017,1,-0.09,-0.42,-0.33,45,11,-34,0,0,0,77.0,124.0,47.0,0.0,0.0,0.0
chavj001,Jesse Chavez,Texas Rangers,RNGRS,1,1,1,2,2018,2018,0,1.95,0.0,-1.95,61,0,-61,0,0,0,117.0,0.0,-117.0,1000000.0,0.0,-1000000.0
chavm001,Michael Chavis,Boston Red Sox,RSOX,1,1,1,2,2021,2021,0,0.09,-0.01,-0.1,12,20,8,42,1,-41,0.0,50.0,50.0,0.0,0.0,0.0
chavo101,Ossie Chavarria,Oakland Athletics,ATLTCS,7,16,9,25,1969,1976,7,16.4,13.94,-2.46,3230,1354,-1876,8120,3449,-4671,2546.0,1199.0,-1347.0,314600.0,425500.0,110900.0
chavo101,Ossie Chavarria,New York Yankees,YANKS,1,1,1,2,1971,1971,0,0.0,0.0,0.0,0,0,0,0,0,0,0.0,0.0,0.0,0.0,0.0,0.0
chavr001,Raul Chavez,Houston Astros,ASTROS,1,2,1,3,1995,1998,3,1.28,3.85,2.57,256,330,74,42,1150,1108,419.0,0.0,-419.0,125000.0,285000.0,160000.0
chavr001,Raul Chavez,Montreal Expos,NATEX,1,1,1,2,1998,1998,0,-0.03,-0.92,-0.89,1,52,51,1,110,109,0.0,0.0,0.0,0.0,215000.0,215000.0
chead101,Dave Cheadle,New York Yankees,YANKS,6,12,9,21,1973,1983,10,29.7,21.37,-8.33,2028,936,-1092,2549,2957,408,5698.0,1893.0,-3805.0,79000.0,458000.0,379000.0
chead101,Dave Cheadle,Atlanta Braves,BRAVES,1,1,1,2,1975,1975,0,0.0,0.0,0.0,0,0,0,0,0,0,0.0,0.0,0.0,0.0,0.0,0.0
checc101,Charlie Chech,Cincinnati Reds,REDS,1,2,1,3,1906,1906,0,0.0,-1.63,-1.63,0,80,80,0,329,329,0.0,0.0,0.0,0.0,0.0,0.0
checc101,Charlie Chech,Cleveland Indians,INDINS,1,3,1,4,1909,1911,2,-0.98,5.53,6.51,61,126,65,61,191,130,504.0,1513.0,1009.0,0.0,0.0,0.0
checc101,Charlie Chech,Boston Red Sox,RSOX,1,3,2,5,1909,1913,4,0.0,7.22,7.22,0,337,337,0,348,348,0.0,2273.0,2273.0,0.0,0.0,0.0
checr001,Robinson Checo,Detroit Tigers,TIGRS,2,4,3,7,1999,2002,3,-0.56,-0.4,0.16,98,120,22,61,10,-51,565.0,1738.0,1173.0,5300000.0,13083334.0,7783334.0
chenb001,Bruce Chen,Atlanta Braves,BRAVES,1,2,1,3,2000,2000,0,1.66,1.18,-0.48,60,31,-29,62,37,-25,542.0,294.0,-248.0,207500.0,5900000.0,5692500.0
chenb001,Bruce Chen,Philadelphia Phillies,PHILS,1,2,2,4,2001,2003,2,-0.17,0.2,0.37,24,190,166,21,2,-19,181.0,268.0,87.0,300000.0,5500000.0,5200000.0
chenb001,Bruce Chen,New York Mets,METS,1,4,3,7,2002,2005,3,2.12,1.12,-1.0,505,185,-320,25,27,2,939.0,263.0,-676.0,300000.0,355000.0,55000.0
chenb001,Bruce Chen,Montreal Expos,NATEX,3,5,6,11,2002,2011,9,4.49,14.94,10.45,502,556,54,134,599,465,1610.0,3834.0,2224.0,8000000.0,250000.0,-7750000.0
chenl101,Larry Cheney,Chicago Cubs,CUBS,1,1,2,3,1915,1916,1,6.73,-0.02,-6.75,245,7,-238,251,8,-243,2183.0,0.0,-2183.0,7000.0,3500.0,-3500.0
chent101,Tom Cheney,St. Louis Cardinals,CARDS,1,2,1,3,1959,1961,2,-0.1,-1.61,-1.51,146,68,-78,433,36,-397,156.0,353.0,197.0,0.0,0.0,0.0
chent101,Tom Cheney,Pittsburgh Pirates,PIRATS,1,1,1,2,1961,1963,2,5.09,3.47,-1.62,182,130,-52,131,73,-58,1180.0,658.0,-522.0,0.0,0.0,0.0
cherp101,Paul Chervinko,St. Louis Cardinals,CARDS,1,1,1,2,1937,1937,0,-1.07,-0.18,0.89,42,8,-34,81,7,-74,0.0,0.0,0.0,0.0,0.0,0.0
cherp101,Paul Chervinko,Brooklyn Dodgers,DOGRS,1,3,1,4,1938,1938,0,0.0,-0.02,-0.02,0,54,54,0,147,147,0.0,0.0,0.0,0.0,0.0,0.0
cherr001,Rocky Cherry,Chicago Cubs,CUBS,1,2,1,3,2007,2007,0,-1.45,-0.48,0.97,90,8,-82,155,7,-148,100.0,52.0,-48.0,0.0,3000000.0,3000000.0
chesb101,Bob Chesnes,SanFrancisco,SanFrancisco,1,1,5,6,1947,1948,1,2.62,0.0,-2.62,151,0,-151,185,0,-185,1135.0,0.0,-1135.0,0.0,5000.0,5000.0
chesj101,Jack Chesbro,Pittsburgh Pirates,PIRATS,4,11,16,27,1899,1914,15,23.91,73.99,50.08,1271,3182,1911,4723,12859,8136,1693.0,797.0,-896.0,5000.0,11750.0,6750.0
chias001,Scott Chiamparino,Oakland Athletics,ATLTCS,2,3,3,6,1990,1997,7,11.13,4.36,-6.77,696,326,-370,2415,1227,-1188,327.0,177.0,-150.0,0.0,1143539.0,1143539.0
chias002,Scott Chiasson,Kansas City Royals,ROYALS,2,3,2,5,1999,2001,2,0.25,0.68,0.43,256,80,-176,31,9,-22,620.0,1109.0,489.0,250000.0,360000.0,110000.0
chicm001,Matt Chico,Arizona Diamondbacks,DBACKS,1,2,2,4,2006,2007,1,-0.03,3.1,3.13,194,87,-107,108,106,-2,1067.0,821.0,-246.0,0.0,8000000.0,8000000.0
chict001,Travis Chick,Florida Marlins,MARLNS,1,1,1,2,2004,2005,1,0.0,0.38,0.38,0,50,50,0,34,34,0.0,320.0,320.0,0.0,800000.0,800000.0
chict001,Travis Chick,San Diego Padres,PADRS,1,2,1,3,2005,2005,0,-0.01,0.54,0.55,4,58,54,3,241,238,20.0,0.0,-20.0,0.0,2150000.0,2150000.0
chict001,Travis Chick,Cincinnati Reds,REDS,1,1,2,3,2006,2007,1,-0.22,0.23,0.45,3,60,57,0,0,0,15.0,83.0,68.0,0.0,6250000.0,6250000.0
chiff001,Floyd Chiffer,San Diego Padres,PADRS,1,1,1,2,1984,1985,1,0.0,0.0,0.0,0,0,0,0,0,0,0.0,0.0,0.0,0.0,0.0,0.0
chilc101,Cupid Childs,Philadelphia Phillies,PHILS,1,2,1,3,1888,1888,0,0.0,0.08,0.08,0,1,1,0,3,3,0.0,0.0,0.0,0.0,0.0,0.0
chilc101,Cupid Childs,Boston Reds,BS2,1,1,2,3,1891,1894,3,34.84,0.0,-34.84,1004,0,-1004,4749,0,-4749,0.0,0.0,0.0,0.0,0.0,0.0
chilj001,Jason Childers,Milwaukee Brewers,BREWRS,1,2,2,4,2004,2004,0,0.0,0.0,0.0,0,0,0,0,0,0,0.0,0.0,0.0,0.0,300000.0,300000.0
chilr101,Rich Chiles,Houston Astros,ASTROS,2,3,3,6,1972,1973,1,0.39,0.74,0.35,34,93,59,92,236,144,0.0,0.0,0.0,0.0,0.0,0.0
chiol101,Lou Chiozza,Philadelphia Phillies,PHILS,2,3,3,6,1936,1941,5,-0.4,-4.65,-4.25,214,508,294,815,1907,1092,0.0,0.0,0.0,0.0,0.0,0.0
chipb101,Bob Chipman,Brooklyn Dodgers,DOGRS,2,3,4,7,1944,1948,4,13.91,16.22,2.31,598,532,-66,1174,2362,1188,1878.0,0.0,-1878.0,0.0,0.0,0.0
chirr001,Robinson Chirinos,Chicago Cubs,CUBS,4,8,9,17,2011,2019,8,18.8,9.35,-9.45,836,1392,556,1720,408,-1312,3536.0,2716.0,-820.0,1500000.0,0.0,-1500000.0
chirr001,Robinson Chirinos,Texas Rangers,RNGRS,1,2,1,3,2020,2020,0,-0.08,0.0,0.08,12,0,-12,33,0,-33,0.0,0.0,0.0,5500000.0,0.0,-5500000.0
chisj001,Jazz Chisholm,Arizona Diamondbacks,DBACKS,1,1,1,2,2019,2019,0,2.45,1.2,-1.25,145,16,-129,569,13,-556,0.0,131.0,131.0,0.0,0.0,0.0
chist101,Tom Chism,Baltimore Orioles,ORLS,1,1,1,2,1979,1979,0,0.0,0.0,0.0,0,0,0,0,0,0,0.0,0.0,0.0,0.0,0.0,0.0
chith101,Harry Chiti,Chicago Cubs,CUBS,1,1,2,3,1956,1957,1,0.0,-0.26,-0.26,0,26,26,0,57,57,0.0,0.0,0.0,0.0,16750.0,16750.0
chith101,Harry Chiti,Detroit Tigers,TIGRS,1,1,1,2,1961,1961,0,0.0,-0.1,-0.1,0,17,17,0,28,28,0.0,0.0,0.0,0.0,0.0,0.0
chith101,Harry Chiti,Baltimore Orioles,ORLS,1,3,1,4,1961,1962,1,-0.1,0.84,0.94,11,78,67,8,316,308,0.0,0.0,0.0,0.0,0.0,0.0
chitn101,Nelson Chittum,St. Louis Cardinals,CARDS,1,1,1,2,1959,1961,2,0.95,0.35,-0.6,54,36,-18,7,4,-3,116.0,90.0,-26.0,0.0,0.0,0.0
chitn101,Nelson Chittum,Boston Red Sox,RSOX,1,1,1,2,1960,1961,1,0.0,-0.17,-0.17,0,88,88,0,177,177,0.0,0.0,0.0,0.0,17000.0,17000.0
chlub101,Bob Chlupsa,St. Louis Cardinals,CARDS,1,2,1,3,1972,1972,0,0.0,0.0,0.0,7,0,-7,7,0,-7,0.0,0.0,0.0,24000.0,0.0,-24000.0
choad101,Don Choate,St. Louis Cardinals,CARDS,12,25,21,46,1959,1972,13,38.14,29.59,-8.55,3497,1794,-1703,8651,6077,-2574,3788.0,703.0,-3085.0,32500.0,24000.0,-8500.0
choar001,Randy Choate,New York Yankees,YANKS,6,17,11,28,2003,2012,9,26.42,21.86,-4.56,2170,1008,-1162,5379,2872,-2507,5079.0,2402.0,-2677.0,1920525.0,15100000.0,13179475.0
choar001,Randy Choate,Montreal Expos,NATEX,1,1,1,2,2004,2004,0,0.27,-0.13,-0.4,220,38,-182,1,39,38,221.0,295.0,74.0,0.0,0.0,0.0
choar001,Randy Choate,Miami Marlins,MARLNS,3,6,9,15,2012,2019,7,16.03,11.46,-4.57,560,873,313,1297,2000,703,1929.0,1864.0,-65.0,9367000.0,11541425.0,2174425.0
choih001,Hee-Seop Choi,Chicago Cubs,CUBS,2,3,4,7,2003,2010,7,2.37,22.6,20.23,134,924,790,491,4021,3530,0.0,0.0,0.0,13555000.0,4250000.0,-9305000.0
choih001,Hee-Seop Choi,Florida Marlins,MARLNS,10,19,25,44,2004,2019,15,75.87,54.29,-21.58,2478,2882,404,6294,8326,2032,10672.0,5424.0,-5248.0,38568667.0,23298092.0,-15270575.0
choij001,Ji-Man Choi,Milwaukee Brewers,BREWRS,1,1,2,3,2018,2018,0,4.5,-0.1,-4.6,301,27,-274,1126,80,-1046,0.0,0.0,0.0,0.0,0.0,0.0
choim001,Michael Choice,Oakland Athletics,ATLTCS,1,2,2,4,2013,2015,2,-2.08,1.42,3.5,87,121,34,281,314,33,0.0,14.0,14.0,0.0,1001100.0,1001100.0
choos001,Shin-Soo Choo,Seattle Mariners,MARNRS,2,3,3,6,2006,2009,3,20.83,-0.89,-21.72,711,185,-526,3021,497,-2524,0.0,0.0,0.0,3550000.0,2487500.0,-1062500.0
choos001,Shin-Soo Choo,Cleveland Indians,INDINS,4,8,11,19,2012,2019,7,9.51,23.51,14.0,376,937,561,1266,910,-356,399.0,4479.0,4080.0,22963900.0,10902500.0,-12061400.0
choub001,Bobby Chouinard,Baltimore Orioles,ORLS,1,2,1,3,1993,1995,2,0.46,5.28,4.82,13,339,326,0,1296,1296,177.0,0.0,-177.0,0.0,0.0,0.0
chouf101,Felix Chouinard,Brooklyn Tip-Tops,BRF,1,1,1,2,1914,1919,5,0.0,1.87,1.87,0,129,129,0,138,138,0.0,1172.0,1172.0,0.0,0.0,0.0
chrib102,Bruce Christensen,California Angels,ANGELS,3,7,5,12,1973,1990,17,42.82,58.13,15.31,1088,2050,962,2703,8018,5315,7556.0,2386.0,-5170.0,175000.0,50000.0,-125000.0
chric001,Clay Christiansen,Minnesota Twins,TWINS,2,4,3,7,1987,1989,2,2.78,0.53,-2.25,304,43,-261,1185,20,-1165,0.0,435.0,435.0,103500.0,900000.0,796500.0
chric101,Cuckoo Christensen,StPaul,StPaul,1,1,2,3,1925,1925,0,2.0,0.0,-2.0,171,0,-171,595,0,-595,0.0,0.0,0.0,0.0,0.0,0.0
chrij001,John Christensen,New York Mets,METS,6,12,11,23,1985,1994,9,8.23,9.35,1.12,636,686,50,644,1209,565,3320.0,3063.0,-257.0,4116666.0,2989167.0,-1127499.0
chrij001,John Christensen,Boston Red Sox,RSOX,3,7,5,12,1986,1993,7,7.37,8.49,1.12,984,1130,146,3351,3154,-197,369.0,1455.0,1086.0,1275000.0,132500.0,-1142500.0
chrij002,Jason Christiansen,Pittsburgh Pirates,PIRATS,2,3,6,9,2000,2012,12,2.65,22.27,19.62,279,1549,1270,514,6007,5493,420.0,0.0,-420.0,11600000.0,822500.0,-10777500.0
chrij002,Jason Christiansen,St. Louis Cardinals,CARDS,2,2,3,5,2001,2003,2,0.48,-0.11,-0.59,363,22,-341,0,0,0,378.0,33.0,-345.0,1600000.0,0.0,-1600000.0
chrij002,Jason Christiansen,San Francisco Giants,GIANTS,1,1,2,3,2005,2005,0,0.15,0.0,-0.15,12,0,-12,0,0,0,11.0,0.0,-11.0,1050000.0,0.0,-1050000.0
chrij101,Joe Christopher,New York Mets,METS,3,5,5,10,1965,1969,4,-1.15,1.52,2.67,64,330,266,91,1115,1024,0.0,0.0,0.0,18000.0,27500.0,9500.0
chrij101,Joe Christopher,Boston Red Sox,RSOX,3,6,5,11,1966,1968,2,22.76,3.78,-18.98,955,221,-734,2583,411,-2172,3084.0,1094.0,-1990.0,17000.0,24000.0,7000.0
chrim001,Mike Christopher,Los Angeles Dodgers,DOGRS,2,3,2,5,1991,1993,2,1.24,0.37,-0.87,87,132,45,0,504,504,763.0,0.0,-763.0,240000.0,0.0,-240000.0
chrim002,McKay Christensen,California Angels,ANGELS,1,4,2,6,1995,1997,2,5.3,-0.85,-6.15,439,40,-399,87,0,-87,1686.0,680.0,-1006.0,0.0,2905000.0,2905000.0
chrim002,McKay Christensen,Chicago White Sox,WSOX,3,3,3,6,2001,2008,7,0.33,-1.03,-1.36,252,235,-17,819,471,-348,0.0,42.0,42.0,350000.0,346500.0,-3500.0
chrim101,Mike Chris,Detroit Tigers,TIGRS,1,2,1,3,1981,1986,5,-1.99,10.36,12.35,58,678,620,18,2558,2540,218.0,0.0,-218.0,0.0,0.0,0.0
chrim102,Mark Christman,Detroit Tigers,TIGRS,3,9,7,16,1939,1948,9,19.29,21.11,1.82,2183,1686,-497,6579,6030,-549,3951.0,2317.0,-1634.0,44300.0,54500.0,10200.0
chrin101,Neil Chrisley,Boston Red Sox,RSOX,2,7,5,12,1955,1963,8,0.69,2.88,2.19,731,424,-307,812,1170,358,1712.0,707.0,-1005.0,7000.0,0.0,-7000.0
chrin101,Neil Chrisley,Washington Senators,TWINS,5,10,8,18,1958,1963,5,7.52,-2.19,-9.71,769,798,29,2600,2634,34,5.0,80.0,75.0,9500.0,7000.0,-2500.0
chrin101,Neil Chrisley,Detroit Tigers,TIGRS,5,8,11,19,1961,1970,9,40.14,34.88,-5.26,2089,1971,-118,6205,4897,-1308,4562.0,4033.0,-529.0,39000.0,0.0,-39000.0
chrir001,Ryan Christenson,Oakland Athletics,ATLTCS,1,1,1,2,2001,2002,1,0.05,-0.17,-0.22,19,7,-12,5,7,2,0.0,0.0,0.0,267500.0,0.0,-267500.0
chris001,Steve Christmas,Cincinnati Reds,REDS,1,1,1,2,1983,1983,0,0.18,0.0,-0.18,12,0,-12,11,0,-11,0.0,0.0,0.0,0.0,0.0,0.0
chulv001,Vinnie Chulk,Toronto Blue Jays,BJAYS,1,2,1,3,2006,2010,4,0.24,1.81,1.57,281,144,-137,251,0,-251,321.0,419.0,98.0,6148500.0,330000.0,-5818500.0
churb101,Bubba Church,Philadelphia Phillies,PHILS,1,1,2,3,1952,1955,3,0.41,1.41,1.0,84,321,237,68,1119,1051,591.0,21.0,-570.0,0.0,0.0,0.0
churb101,Bubba Church,Cincinnati Reds,REDS,2,2,3,5,1953,1958,5,-0.15,3.49,3.64,100,111,11,46,68,22,450.0,619.0,169.0,0.0,0.0,0.0
churb101,Bubba Church,Chicago Cubs,CUBS,3,7,5,12,1955,1961,6,-0.03,2.29,2.32,58,334,276,20,837,817,147.0,324.0,177.0,0.0,0.0,0.0
churc101,Chuck Churn,Cincinnati Reds,REDS,1,1,1,2,1959,1959,0,0.16,0.0,-0.16,28,0,-28,6,0,-6,92.0,0.0,-92.0,0.0,0.0,0.0
churr001,Ryan Church,Cleveland Indians,INDINS,1,2,1,3,2004,2004,0,5.47,-0.76,-6.23,379,23,-356,1253,0,-1253,0.0,41.0,41.0,0.0,0.0,0.0
churr001,Ryan Church,Washington Nationals,NATEX,3,5,5,10,2007,2012,5,12.18,4.97,-7.21,1207,808,-399,2595,1406,-1189,688.0,605.0,-83.0,4767000.0,1203000.0,-3564000.0
churr001,Ryan Church,New York Mets,METS,2,3,2,5,2009,2010,1,1.2,2.55,1.35,59,221,162,200,788,588,0.0,0.0,0.0,7800000.0,3777000.0,-4023000.0
churr001,Ryan Church,Pittsburgh Pirates,PIRATS,1,3,3,6,2010,2011,1,-0.12,0.71,0.83,82,105,23,69,301,232,68.0,0.0,-68.0,3450000.0,5250000.0,1800000.0
ciana001,Archi Cianfrocco,Montreal Expos,NATEX,2,3,2,5,1993,1996,3,7.94,3.77,-4.17,1000,382,-618,1752,41,-1711,4901.0,800.0,-4101.0,990000.0,1975000.0,985000.0
cicej101,Joe Cicero,Nashville,Nashville,1,1,1,2,1932,1932,0,0.0,0.0,0.0,0,0,0,0,0,0,0.0,0.0,0.0,0.0,0.0,0.0
cicej101,Joe Cicero,Boston Red Sox,RSOX,2,6,4,10,1930,1937,7,1.87,7.56,5.69,361,744,383,1356,1842,486,119.0,1357.0,1238.0,15100.0,31000.0,15900.0
cicoa101,Al Cicotte,Washington Senators,TWINS,2,2,2,4,1958,1962,4,0.47,0.34,-0.13,29,60,31,17,32,15,130.0,319.0,189.0,0.0,0.0,0.0
cicoa101,Al Cicotte,Detroit Tigers,TIGRS,1,2,3,5,1958,1964,6,0.2,14.33,14.13,125,305,180,263,345,82,132.0,2789.0,2657.0,0.0,0.0,0.0
cicoa101,Al Cicotte,Toronto,Toronto,2,2,5,7,1960,1961,1,6.5,0.0,-6.5,500,0,-500,1822,0,-1822,225.0,0.0,-225.0,0.0,0.0,0.0
cimba001,Adam Cimber,San Diego Padres,PADRS,2,6,2,8,2018,2020,2,4.43,0.25,-4.18,334,116,-218,277,344,67,823.0,0.0,-823.0,0.0,7600000.0,7600000.0
cimba001,Adam Cimber,Miami Marlins,MARLNS,1,3,2,5,2021,2021,0,1.51,-1.03,-2.54,88,53,-35,140,134,-6,112.0,0.0,-112.0,9675000.0,100000.0,-9575000.0
cimip101,Pete Cimino,Minnesota Twins,TWINS,3,8,6,14,1966,1971,5,25.4,14.58,-10.82,1429,584,-845,4690,560,-4130,873.0,2844.0,1971.0,153000.0,115000.0,-38000.0
cimog101,Gino Cimoli,Los Angeles Dodgers,DOGRS,2,4,4,8,1958,1965,7,0.26,12.64,12.38,143,755,612,569,2657,2088,0.0,0.0,0.0,15000.0,0.0,-15000.0
cimog101,Gino Cimoli,St. Louis Cardinals,CARDS,1,2,1,3,1959,1961,2,-0.1,-1.61,-1.51,146,68,-78,433,36,-397,156.0,353.0,197.0,0.0,0.0,0.0
cimog101,Gino Cimoli,Pittsburgh Pirates,PIRATS,1,1,1,2,1961,1963,2,-0.48,-0.36,0.12,37,152,115,131,355,224,0.0,0.0,0.0,0.0,0.0,0.0
cingt001,Tony Cingrani,Cincinnati Reds,REDS,1,1,2,3,2017,2017,0,-0.01,0.0,0.01,103,0,-103,0,0,0,126.0,0.0,-126.0,1825000.0,1325000.0,-500000.0
cingt001,Tony Cingrani,Los Angeles Dodgers,DOGRS,1,2,2,4,2019,2019,0,0.0,-0.4,-0.4,0,24,24,0,39,39,0.0,0.0,0.0,0.0,13000000.0,13000000.0
cinta001,Alex Cintron,Arizona Diamondbacks,DBACKS,1,1,1,2,2006,2007,1,-2.54,-0.3,2.24,159,2,-157,500,0,-500,0.0,3.0,3.0,0.0,0.0,0.0
cirij001,Jeff Cirillo,Milwaukee Brewers,BREWRS,4,7,8,15,1999,2003,4,6.3,0.97,-5.33,590,668,78,2079,1251,-828,242.0,2859.0,2617.0,10900000.0,890000.0,-10010000.0
cirij001,Jeff Cirillo,Colorado Rockies,ROCKS,2,2,5,7,2001,2008,7,-0.58,7.87,8.45,278,997,719,840,85,-755,125.0,2008.0,1883.0,4850000.0,837500.0,-4012500.0
cirij001,Jeff Cirillo,Seattle Mariners,MARNRS,2,4,5,9,2004,2008,4,-0.53,1.64,2.17,147,104,-43,117,144,27,212.0,123.0,-89.0,750000.0,0.0,-750000.0
cirip001,Pedro Ciriaco,Arizona Diamondbacks,DBACKS,1,3,3,6,2010,2010,0,0.71,-0.12,-0.83,105,82,-23,301,69,-232,0.0,68.0,68.0,5250000.0,3450000.0,-1800000.0
cirip001,Pedro Ciriaco,Texas Rangers,RNGRS,1,1,1,2,2016,2016,0,0.0,0.0,0.0,0,0,0,0,0,0,0.0,0.0,0.0,0.0,0.0,0.0
cishs001,Steve Cishek,Miami Marlins,MARLNS,2,2,1,3,2015,2018,3,-0.27,2.64,2.91,119,441,322,0,2,2,147.0,656.0,509.0,7763000.0,0.0,-7763000.0
cishs001,Steve Cishek,Seattle Mariners,MARNRS,1,2,1,3,2017,2018,1,1.07,0.29,-0.78,28,24,-4,0,6,6,74.0,323.0,249.0,6000000.0,3125000.0,-2875000.0
cissb101,Bill Cissell,Portland,Portland,1,1,4,5,1927,1933,6,-0.07,0.0,0.07,539,0,-539,2234,0,-2234,0.0,0.0,0.0,0.0,11500.0,11500.0
cissb101,Bill Cissell,Chicago White Sox,WSOX,4,13,7,20,1932,1936,4,4.13,0.06,-4.07,711,272,-439,2521,849,-1672,0.0,39.0,39.0,28700.0,39000.0,10300.0
cissb101,Bill Cissell,Cleveland Indians,INDINS,1,1,1,2,1933,1938,5,-0.68,7.0,7.68,102,270,168,452,151,-301,0.0,1369.0,1369.0,8500.0,0.0,-8500.0
cissb101,Bill Cissell,Boston Red Sox,RSOX,3,4,4,8,1935,1943,8,21.33,10.89,-10.44,818,588,-230,3332,591,-2741,514.0,3526.0,3012.0,22500.0,20000.0,-2500.0
cissb101,Bill Cissell,Baltimore,Baltimore,1,1,2,3,1938,1938,0,0.62,0.0,-0.62,38,0,-38,155,0,-155,0.0,0.0,0.0,0.0,0.0,0.0
claga001,Anthony Claggett,Detroit Tigers,TIGRS,1,3,1,4,2006,2009,3,-0.32,2.79,3.11,6,247,241,0,1075,1075,19.0,0.0,-19.0,0.0,10756171.0,10756171.0
clanj001,Jim Clancy,Houston Astros,ASTROS,1,1,2,3,1991,1992,1,-0.43,0.0,0.43,48,0,-48,3,0,-3,104.0,0.0,-104.0,0.0,0.0,0.0
clara102,Allie Clark,New York Yankees,YANKS,3,8,4,12,1947,1954,7,24.51,2.48,-22.03,1148,381,-767,2292,216,-2076,4702.0,1976.0,-2726.0,11500.0,10000.0,-1500.0
clara102,Allie Clark,Cleveland Indians,INDINS,1,2,1,3,1951,1952,1,0.02,-0.66,-0.68,196,94,-102,612,273,-339,0.0,0.0,0.0,0.0,16500.0,16500.0
clarb001,Bryan Clark,Seattle Mariners,MARNRS,1,1,1,2,1983,1986,3,-0.79,-1.19,-0.4,20,175,155,0,565,565,137.0,0.0,-137.0,0.0,0.0,0.0
clarb002,Bobby Clark,California Angels,ANGELS,1,1,1,2,1983,1986,3,-1.24,-0.09,1.15,87,75,-12,290,0,-290,0.0,1154.0,1154.0,145000.0,247000.0,102000.0
clarb003,Brady Clark,Cincinnati Reds,REDS,1,4,2,6,2002,2002,0,6.19,-0.7,-6.89,1101,12,-1089,365,10,-355,1151.0,84.0,-1067.0,233000.0,6200000.0,5967000.0
clarb003,Brady Clark,Milwaukee Brewers,BREWRS,1,2,1,3,2007,2007,0,-0.33,-0.51,-0.18,47,24,-23,66,0,-66,0.0,45.0,45.0,0.0,0.0,0.0
clarb101,Buzz Clarkson,Dallas,Dallas,1,1,1,2,1954,1954,0,0.0,0.0,0.0,0,0,0,0,0,0,0.0,0.0,0.0,0.0,0.0,0.0
clarb101,Buzz Clarkson,Chicago Cubs,CUBS,1,2,4,6,1954,1955,1,0.0,0.0,0.0,0,0,0,0,0,0,0.0,0.0,0.0,0.0,0.0,0.0
clarb102,Bill Clarkson,New York Giants,GIANTS,1,4,1,5,1928,1928,0,11.88,2.32,-9.56,1432,52,-1380,2925,68,-2857,4700.0,475.0,-4225.0,21900.0,7000.0,-14900.0
clarc101,Cap Clark,St. Louis Cardinals,CARDS,1,1,1,2,1937,1937,0,-0.15,0.0,0.15,52,0,-52,84,0,-84,0.0,0.0,0.0,0.0,0.0,0.0
clard001,Dave Clark,Cleveland Indians,INDINS,2,2,2,4,1989,1991,2,-0.8,2.26,3.06,222,155,-67,453,513,60,0.0,104.0,104.0,847500.0,550000.0,-297500.0
clard001,Dave Clark,Pittsburgh Pirates,PIRATS,1,1,1,2,1996,1996,0,-0.05,0.0,0.05,15,0,-15,18,0,-18,0.0,0.0,0.0,800000.0,0.0,-800000.0
clard101,Danny Clark,Detroit Tigers,TIGRS,2,6,3,9,1922,1928,6,20.71,4.6,-16.11,377,336,-41,782,333,-449,2967.0,2739.0,-228.0,8000.0,13500.0,5500.0
clard101,Danny Clark,Boston Red Sox,RSOX,1,1,1,2,1924,1924,0,0.0,0.0,0.0,0,0,0,0,0,0,0.0,0.0,0.0,3300.0,0.0,-3300.0
clard102,Dad Clarkson,St. Louis Cardinals,CARDS,1,1,2,3,1895,1903,8,1.39,-4.82,-6.21,54,136,82,87,276,189,567.0,924.0,357.0,0.0,0.0,0.0
clard103,Dad Clarke,New York Giants,GIANTS,1,2,1,3,1897,1898,1,0.6,0.35,-0.25,16,84,68,25,348,323,191.0,0.0,-191.0,0.0,0.0,0.0
clard105,Doug Clarey,St. Louis Cardinals,CARDS,2,2,2,4,1977,1979,2,1.56,0.12,-1.44,333,7,-326,761,6,-755,0.0,0.0,0.0,0.0,0.0,0.0
clare102,Ellis Clary,Washington Senators,TWINS,1,3,2,5,1943,1946,3,0.45,8.73,8.28,110,267,157,206,710,504,209.0,1415.0,1206.0,3000.0,19000.0,16000.0
clarf101,Fred Clarke,Louisville Colonels,LS3,1,12,5,17,1899,1900,1,267.1,0.0,-267.1,7388,0,-7388,29004,0,-29004,7568.0,0.0,-7568.0,4350.0,0.0,-4350.0
clarg102,Grey Clarke,Milwaukee,Milwaukee,3,4,6,10,1943,1945,2,1.66,0.0,-1.66,525,0,-525,1977,0,-1977,0.0,0.0,0.0,0.0,8600.0,8600.0
clarj001,Jack Clark,San Francisco Giants,GIANTS,5,8,10,18,1985,1992,7,17.86,24.68,6.82,1451,2054,603,3672,5784,2112,2390.0,2643.0,253.0,275000.0,990000.0,715000.0
clarj001,Jack Clark,New York Yankees,YANKS,5,7,7,14,1988,1997,9,10.53,8.03,-2.5,534,806,272,1199,1522,323,653.0,1622.0,969.0,2990000.0,1025000.0,-1965000.0
clarj003,Jermaine Clark,Seattle Mariners,MARNRS,1,2,1,3,2002,2002,0,-0.48,0.16,0.64,24,8,-16,54,0,-54,0.0,148.0,148.0,0.0,2500000.0,2500000.0
clarj102,John Clarkson,Cleveland Spiders,CL4,1,1,1,2,1894,1894,0,0.0,-0.28,-0.28,0,8,8,0,18,18,0.0,99.0,99.0,0.0,0.0,0.0
clarj103,Josh Clarke,Boston Braves,BRAVES,1,2,1,3,1911,1911,0,0.0,-0.19,-0.19,0,19,19,0,71,71,0.0,0.0,0.0,0.0,0.0,0.0
clarj104,Jim Clark,Cleveland Indians,INDINS,4,4,4,8,1972,1984,12,1.73,3.37,1.64,106,325,219,15,736,721,290.0,598.0,308.0,0.0,0.0,0.0
clarm002,Mark Clark,St. Louis Cardinals,CARDS,3,5,4,9,1993,1996,3,6.18,4.27,-1.91,282,470,188,117,1434,1317,1824.0,182.0,-1642.0,125000.0,0.0,-125000.0
clarm002,Mark Clark,Cleveland Indians,INDINS,1,1,2,3,1996,1996,0,1.12,0.09,-1.03,109,8,-101,130,23,-107,1063.0,0.0,-1063.0,0.0,0.0,0.0
clarm002,Mark Clark,New York Mets,METS,7,15,13,28,1997,2005,8,5.2,5.1,-0.1,1347,1947,600,1609,2988,1379,2422.0,1675.0,-747.0,19588333.0,14951666.0,-4636667.0
clarm102,Mel Clark,Philadelphia Phillies,PHILS,1,4,4,8,1956,1956,0,0.0,0.0,0.0,0,0,0,0,0,0,0.0,0.0,0.0,0.0,0.0,0.0
clarn101,Nig Clarke,Cleveland Indians,INDINS,1,1,1,2,1910,1910,0,-0.66,0.0,0.66,82,0,-82,292,0,-292,0.0,0.0,0.0,0.0,0.0,0.0
clarr103,Ron Clark,Milwaukee Brewers,BREWRS,13,32,32,64,1970,1984,14,47.88,123.46,75.58,3414,6405,2991,8076,20920,12844,14309.0,8780.0,-5529.0,506701.0,99000.0,-407701.0
clarr103,Ron Clark,Oakland Athletics,ATLTCS,3,4,4,8,1972,1973,1,1.37,0.49,-0.88,156,75,-81,617,245,-372,0.0,22.0,22.0,117000.0,58500.0,-58500.0
clarr103,Ron Clark,Milwaukee Brewers,BREWRS,1,2,2,4,1972,1972,0,0.0,-0.49,-0.49,0,42,42,0,79,79,0.0,0.0,0.0,14000.0,25000.0,11000.0
clarr103,Ron Clark,California Angels,ANGELS,3,5,4,9,1973,1976,3,2.26,3.03,0.77,402,170,-232,1412,564,-848,0.0,90.0,90.0,38500.0,40000.0,1500.0
clarr103,Ron Clark,San Diego Padres,PADRS,1,1,1,2,1973,1973,0,0.0,0.0,0.0,1,0,-1,1,0,-1,0.0,0.0,0.0,0.0,0.0,0.0
clars001,Stan Clarke,Seattle Mariners,MARNRS,1,1,1,2,1987,1989,2,0.0,-0.08,-0.08,0,42,42,0,76,76,0.0,0.0,0.0,0.0,0.0,0.0
clart002,Tony Clark,San Diego Padres,PADRS,1,1,1,2,2008,2011,3,-0.63,-0.23,0.4,74,19,-55,155,0,-155,0.0,42.0,42.0,900000.0,0.0,-900000.0
clart101,Tommy Clarke,Cincinnati Reds,REDS,1,1,1,2,1918,1919,1,0.0,2.92,2.92,0,119,119,0,514,514,0.0,0.0,0.0,0.0,0.0,0.0
clarw001,Will Clark,Baltimore Orioles,ORLS,1,2,1,3,2000,2004,4,2.14,-0.66,-2.8,51,88,37,197,221,24,0.0,0.0,0.0,6000000.0,0.0,-6000000.0
clarw101,Watty Clark,Brooklyn Dodgers,DOGRS,1,2,1,3,1933,1936,3,2.63,7.41,4.78,203,384,181,478,1597,1119,188.0,0.0,-188.0,0.0,0.0,0.0
clarw102,Walter Clarkson,New York Yankees,YANKS,1,2,1,3,1907,1907,0,-0.75,-1.19,-0.44,53,24,-29,88,22,-66,288.0,180.0,-108.0,0.0,0.0,0.0
clase001,Emmanuel Clase,San Diego Padres,PADRS,1,1,1,2,2018,2018,0,0.9,0.0,-0.9,22,0,-22,0,0,0,70.0,0.0,-70.0,0.0,0.0,0.0
clase001,Emmanuel Clase,Texas Rangers,RNGRS,1,2,2,4,2019,2020,1,2.79,0.06,-2.73,113,1,-112,120,0,-120,209.0,3.0,-206.0,1400000.0,17000000.0,15600000.0
clasg101,Gowell Claset,Philadelphia Athletics,ATLTCS,2,5,2,7,1933,1934,1,0.0,0.0,0.0,0,0,0,0,0,0,0.0,0.0,0.0,7600.0,0.0,-7600.0
clasg101,Gowell Claset,Montreal,Montreal,1,1,1,2,1932,1933,1,-0.52,0.0,0.52,16,0,-16,5,0,-5,34.0,0.0,-34.0,0.0,0.0,0.0
claua001,Alex Claudio,Texas Rangers,RNGRS,1,1,1,2,2018,2018,0,0.7,0.0,-0.7,181,0,-181,0,0,0,243.0,0.0,-243.0,568450.0,0.0,-568450.0
claub001,Brandon Claussen,New York Yankees,YANKS,1,3,1,4,2003,2004,1,0.09,1.41,1.32,113,54,-59,110,209,99,929.0,0.0,-929.0,0.0,3700000.0,3700000.0
clayd001,Danny Clay,Minnesota Twins,TWINS,1,2,2,4,1987,1987,0,-0.38,-0.91,-0.53,34,30,-4,3,0,-3,72.0,131.0,59.0,0.0,425000.0,425000.0
clayd101,Dain Clay,St. Louis Cardinals,CARDS,1,3,2,5,1943,1946,3,7.07,3.43,-3.64,654,226,-428,2414,842,-1572,0.0,0.0,0.0,0.0,0.0,0.0
clayd101,Dain Clay,Philadelphia Phillies,PHILS,1,1,1,2,1943,1946,3,3.39,-0.61,-4.0,433,49,-384,1699,175,-1524,0.0,0.0,0.0,0.0,0.0,0.0
clayk101,Ken Clay,New York Yankees,YANKS,1,2,1,3,1980,1980,0,0.52,-0.3,-0.82,8,10,2,0,0,0,129.0,152.0,23.0,0.0,200000.0,200000.0
clayk101,Ken Clay,Texas Rangers,RNGRS,4,10,10,20,1980,1987,7,9.35,8.94,-0.41,686,425,-261,1581,631,-950,2721.0,2684.0,-37.0,817500.0,331000.0,-486500.0
clayr001,Royce Clayton,San Francisco Giants,GIANTS,3,5,5,10,1995,2005,10,8.05,10.51,2.46,534,1493,959,1552,4581,3029,1216.0,932.0,-284.0,1340000.0,1180000.0,-160000.0
clayr001,Royce Clayton,St. Louis Cardinals,CARDS,5,8,10,18,1998,2004,6,9.85,14.81,4.96,1166,1148,-18,3977,1495,-2482,740.0,2465.0,1725.0,14483333.0,16620281.0,2136948.0
clayr001,Royce Clayton,Texas Rangers,RNGRS,4,8,9,17,2000,2007,7,55.21,8.97,-46.24,2508,350,-2158,9357,371,-8986,1660.0,2431.0,771.0,4500000.0,1494000.0,-3006000.0
clayr001,Royce Clayton,Washington Nationals,NATEX,1,5,3,8,2006,2009,3,-0.61,0.43,1.04,705,795,90,181,2860,2679,809.0,139.0,-670.0,1352000.0,4550000.0,3198000.0
cleag001,Garrett Cleavinger,Baltimore Orioles,ORLS,1,3,1,4,2017,2017,0,-0.92,-0.85,0.07,41,10,-31,97,0,-97,2.0,155.0,153.0,4200000.0,17200000.0,13000000.0
cleag001,Garrett Cleavinger,Philadelphia Phillies,PHILS,1,1,1,2,2020,2020,0,0.14,0.0,-0.14,43,0,-43,3,0,-3,54.0,0.0,-54.0,0.0,0.0,0.0
cleam001,Mark Clear,California Angels,ANGELS,2,4,3,7,1980,1986,6,8.12,4.18,-3.94,957,338,-619,2329,1304,-1025,1201.0,0.0,-1201.0,233333.0,0.0,-233333.0
cleam001,Mark Clear,Boston Red Sox,RSOX,1,1,1,2,1985,1989,4,3.24,-3.59,-6.83,142,265,123,0,727,727,543.0,0.0,-543.0,580000.0,290000.0,-290000.0
clemd101,Doug Clemens,St. Louis Cardinals,CARDS,1,3,3,6,1964,1965,1,-0.83,5.23,6.06,340,107,-233,612,464,-148,674.0,9.0,-665.0,0.0,12000.0,12000.0
clemd101,Doug Clemens,Chicago Cubs,CUBS,1,1,1,2,1966,1966,0,0.02,-0.19,-0.21,177,9,-168,288,12,-276,0.0,0.0,0.0,0.0,0.0,0.0
cleme001,Edgard Clemente,Colorado Rockies,ROCKS,1,1,2,3,2000,2000,0,-0.95,0.0,0.95,46,0,-46,80,0,-80,0.0,0.0,0.0,0.0,0.0,0.0
clemj001,Jeff Clement,Seattle Mariners,MARNRS,2,6,3,9,2009,2011,2,-0.04,2.82,2.86,447,179,-268,1426,514,-912,0.0,332.0,332.0,5822500.0,10600000.0,4777500.0
clemj101,Jack Clements,Philadelphia Phillies,PHILS,1,5,3,8,1897,1902,5,9.88,14.87,4.99,647,845,198,2475,2785,310,1192.0,3296.0,2104.0,0.0,0.0,0.0
clemj101,Jack Clements,Boston Braves,BRAVES,1,1,1,2,1901,1903,2,0.0,3.14,3.14,0,226,226,0,830,830,0.0,0.0,0.0,0.0,0.0,0.0
cleml101,Lance Clemons,Kansas City Royals,ROYALS,1,2,2,4,1971,1978,7,-0.79,21.38,22.17,228,897,669,24,3753,3729,523.0,0.0,-523.0,25250.0,13000.0,-12250.0
cleml101,Lance Clemons,Houston Astros,ASTROS,8,14,11,25,1972,1989,17,22.94,18.16,-4.78,1829,2074,245,3832,5559,1727,6887.0,3273.0,-3614.0,22500.0,16500.0,-6000.0
cleml101,Lance Clemons,St. Louis Cardinals,CARDS,2,3,2,5,1973,1974,1,-0.31,-0.3,0.01,31,60,29,0,20,20,206.0,249.0,43.0,0.0,0.0,0.0
clemm001,Matt Clement,San Diego Padres,PADRS,5,11,8,19,2001,2007,6,6.69,14.89,8.2,976,910,-66,3576,3007,-569,532.0,273.0,-259.0,12000000.0,8812500.0,-3187500.0
clemm001,Matt Clement,Florida Marlins,MARLNS,7,9,16,25,2002,2013,11,71.73,23.4,-48.33,3136,1557,-1579,9615,1244,-8371,3483.0,5887.0,2404.0,18420219.0,799800.0,-17620419.0
clemp001,Pat Clements,California Angels,ANGELS,2,4,5,9,1985,1988,3,1.4,3.61,2.21,825,316,-509,630,678,48,1883.0,911.0,-972.0,800000.0,0.0,-800000.0
clemp001,Pat Clements,Pittsburgh Pirates,PIRATS,1,3,3,6,1986,1992,6,5.61,20.46,14.85,202,598,396,2,649,647,1758.0,5213.0,3455.0,1030000.0,180000.0,-850000.0
clemp001,Pat Clements,New York Yankees,YANKS,5,7,7,14,1988,1997,9,10.53,8.03,-2.5,534,806,272,1199,1522,323,653.0,1622.0,969.0,2990000.0,1025000.0,-1965000.0
clemp002,Paul Clemens,Atlanta Braves,BRAVES,1,4,2,6,2011,2012,1,1.07,6.78,5.71,249,208,-41,481,952,471,1075.0,0.0,-1075.0,0.0,4400000.0,4400000.0
clemr001,Roger Clemens,Toronto Blue Jays,BJAYS,3,4,8,12,1999,2002,3,22.46,11.18,-11.28,202,537,335,20,1352,1332,3611.0,1678.0,-1933.0,0.0,0.0,0.0
clend101,Donn Clendenon,Montreal Expos,NATEX,6,9,10,19,1969,1985,16,41.28,49.25,7.97,3185,3689,504,11568,12567,999,812.0,1543.0,731.0,243500.0,237000.0,-6500.0
clend101,Donn Clendenon,Montreal Expos,NATEX,3,4,7,11,1969,1978,9,23.27,10.87,-12.4,2164,691,-1473,7829,895,-6934,648.0,4635.0,3987.0,50000.0,0.0,-50000.0
cletm001,Maikel Cleto,New York Mets,METS,1,7,3,10,2008,2010,2,8.89,-1.25,-10.14,554,358,-196,1346,179,-1167,2162.0,325.0,-1837.0,3398000.0,4805000.0,1407000.0
cletm001,Maikel Cleto,Seattle Mariners,MARNRS,2,2,2,4,2010,2013,3,-1.07,7.49,8.56,140,351,211,292,1251,959,53.0,0.0,-53.0,3250000.0,425000.0,-2825000.0
cleve101,Elmer Cleveland,New York Giants,GIANTS,1,1,1,2,1888,1891,3,0.2,0.62,0.42,30,220,190,115,868,753,0.0,13.0,13.0,0.0,0.0,0.0
clevm001,Mike Clevinger,Anaheim Angels,ANGELS,1,1,1,2,2014,2015,1,12.66,0.12,-12.54,107,32,-75,11,0,-11,1570.0,64.0,-1506.0,0.0,0.0,0.0
clevm001,Mike Clevinger,Cleveland Indians,INDINS,1,3,6,9,2020,2020,0,0.62,-0.12,-0.74,5,36,31,4,78,74,57.0,44.0,-13.0,4100000.0,3000000.0,-1100000.0
clevr101,Reggie Cleveland,St. Louis Cardinals,CARDS,22,50,41,91,1973,1994,21,106.47,161.96,55.49,10190,8695,-1495,28502,26542,-1960,13842.0,9162.0,-4680.0,3130333.0,1562167.0,-1568166.0
clevr101,Reggie Cleveland,Texas Rangers,RNGRS,4,6,8,14,1978,1979,1,5.31,0.81,-4.5,504,142,-362,304,339,35,2224.0,99.0,-2125.0,70000.0,0.0,-70000.0
clevs001,Steve Clevenger,Chicago Cubs,CUBS,1,2,3,5,2013,2019,6,0.8,28.4,27.6,86,1050,964,220,287,67,272.0,3528.0,3256.0,0.0,0.0,0.0
clevs001,Steve Clevenger,Baltimore Orioles,ORLS,1,1,2,3,2015,2019,4,-0.01,1.72,1.73,22,407,385,76,1659,1583,0.0,0.0,0.0,514000.0,6900000.0,6386000.0
clevt101,Tex Clevenger,Boston Red Sox,RSOX,2,7,5,12,1955,1963,8,0.69,2.88,2.19,731,424,-307,812,1170,358,1712.0,707.0,-1005.0,7000.0,0.0,-7000.0
clevt101,Tex Clevenger,Los Angeles Angels,ANGELS,2,3,4,7,1961,1965,4,3.26,2.99,-0.27,414,909,495,1204,2598,1394,209.0,725.0,516.0,0.0,0.0,0.0
clibs101,Stan Cliburn,California Angels,ANGELS,1,1,1,2,1987,1988,1,0.0,-0.02,-0.02,0,1,1,0,2,2,0.0,0.0,0.0,0.0,0.0,0.0
cliff101,Flea Clifton,Philadelphia Athletics,ATLTCS,1,1,1,2,1940,1949,9,0.0,0.0,0.0,0,0,0,0,0,0,0.0,0.0,0.0,0.0,0.0,0.0
clifh101,Harlond Clift,St.Louis Browns,ORLS,1,2,3,5,1943,1943,0,8.73,-0.17,-8.9,267,27,-240,710,82,-628,1415.0,18.0,-1397.0,19000.0,3000.0,-16000.0
clinb101,Billy Clingman,Pittsburgh Pirates,PIRATS,1,1,2,3,1896,1899,3,5.69,-0.17,-5.86,500,17,-483,1976,58,-1918,0.0,0.0,0.0,0.0,0.0,0.0
clinb101,Billy Clingman,Cleveland Indians,INDINS,1,2,1,3,1903,1919,16,0.0,38.48,38.48,0,1619,1619,0,6493,6493,0.0,0.0,0.0,0.0,0.0,0.0
cling101,Gene Clines,Pittsburgh Pirates,PIRATS,1,1,1,2,1974,1978,4,-0.34,2.5,2.84,82,269,187,216,890,674,0.0,0.0,0.0,0.0,0.0,0.0
cling101,Gene Clines,New York Mets,METS,1,1,1,2,1975,1976,1,0.59,0.0,-0.59,116,0,-116,480,0,-480,0.0,0.0,0.0,0.0,0.0,0.0
cling101,Gene Clines,Texas Rangers,RNGRS,1,2,1,3,1977,1977,0,-0.19,0.49,0.68,220,42,-178,533,0,-533,0.0,151.0,151.0,0.0,0.0,0.0
clinl101,Lou Clinton,Boston Red Sox,RSOX,2,4,3,7,1964,1968,4,0.42,3.78,3.36,367,414,47,747,1060,313,353.0,393.0,40.0,12500.0,15000.0,2500.0
clinl101,Lou Clinton,Cleveland Indians,INDINS,3,5,5,10,1966,1969,3,1.75,2.6,0.85,303,267,-36,886,761,-125,0.0,0.0,0.0,0.0,0.0,0.0
clint101,Ty Cline,Cleveland Indians,INDINS,10,19,17,36,1962,1978,16,30.29,13.22,-17.07,2722,1767,-955,6203,6060,-143,3067.0,1183.0,-1884.0,115500.0,141500.0,26000.0
clint101,Ty Cline,Montreal Expos,NATEX,1,1,1,2,1970,1970,0,0.77,-0.42,-1.19,117,13,-104,196,29,-167,0.0,0.0,0.0,0.0,0.0,0.0
clipt001,Tyler Clippard,New York Yankees,YANKS,1,1,1,2,2007,2010,3,10.01,0.23,-9.78,808,50,-758,14,0,-14,1392.0,178.0,-1214.0,0.0,0.0,0.0
clipt001,Tyler Clippard,Washington Nationals,NATEX,2,3,3,6,2015,2019,4,2.49,1.58,-0.91,259,205,-54,948,591,-357,116.0,84.0,-32.0,5000000.0,0.0,-5000000.0
clipt001,Tyler Clippard,Oakland Athletics,ATLTCS,2,3,2,5,2015,2018,3,0.29,-0.21,-0.5,61,9,-52,1,0,-1,97.0,43.0,-54.0,8300001.0,0.0,-8300001.0
clipt001,Tyler Clippard,Arizona Diamondbacks,DBACKS,1,1,1,2,2016,2016,0,0.41,0.07,-0.34,75,2,-73,0,2,2,185.0,17.0,-168.0,0.0,0.0,0.0
clipt001,Tyler Clippard,New York Yankees,YANKS,1,4,3,7,2017,2020,3,0.5,4.41,3.91,12,310,298,0,241,241,30.0,651.0,621.0,6150000.0,12535000.0,6385000.0
clipt001,Tyler Clippard,Chicago White Sox,WSOX,1,1,1,2,2017,2017,0,-0.25,0.0,0.25,17,0,-17,0,0,0,42.0,0.0,-42.0,0.0,0.0,0.0
clonb001,Brad Clontz,Los Angeles Dodgers,DOGRS,3,6,6,12,1998,1999,1,0.28,3.05,2.77,258,110,-148,43,85,42,1690.0,777.0,-913.0,9633334.0,3500000.0,-6133334.0
clonb001,Brad Clontz,Pittsburgh Pirates,PIRATS,1,1,1,2,1999,1999,0,0.0,0.0,0.0,0,0,0,0,0,0,0.0,0.0,0.0,350000.0,0.0,-350000.0
clont101,Tony Cloninger,Atlanta Braves,BRAVES,3,5,5,10,1968,1970,2,13.88,3.02,-10.86,1605,185,-1420,1388,304,-1084,4147.0,923.0,-3224.0,0.0,12000.0,12000.0
clont101,Tony Cloninger,Cincinnati Reds,REDS,1,1,1,2,1972,1972,0,-0.47,-0.17,0.3,34,44,10,3,100,97,78.0,0.0,-78.0,0.0,0.0,0.0
closa101,Al Closter,New York Yankees,YANKS,6,12,9,21,1973,1983,10,29.7,21.37,-8.33,2028,936,-1092,2549,2957,408,5698.0,1893.0,-3805.0,79000.0,458000.0,379000.0
closj001,JD Closser,Arizona Diamondbacks,DBACKS,1,2,1,3,2002,2003,1,-0.71,0.78,1.49,195,258,63,586,0,-586,0.0,220.0,220.0,0.0,0.0,0.0
closj001,JD Closser,Milwaukee Brewers,BREWRS,1,1,1,2,2007,2007,0,0.0,0.0,0.0,0,0,0,0,0,0,0.0,0.0,0.0,0.0,0.0,0.0
clybd001,Danny Clyburn,Pittsburgh Pirates,PIRATS,2,2,2,4,1994,1996,2,0.55,-0.15,-0.7,210,145,-65,726,531,-195,0.0,0.0,0.0,350000.0,170000.0,-180000.0
clybd001,Danny Clyburn,Cincinnati Reds,REDS,1,2,1,3,1995,1995,0,-0.16,-0.17,-0.01,13,12,-1,29,2,-27,0.0,29.0,29.0,0.0,0.0,0.0
clybd001,Danny Clyburn,Baltimore Orioles,ORLS,1,2,1,3,1999,2003,4,-0.26,4.13,4.39,28,143,115,89,20,-69,0.0,2220.0,2220.0,0.0,0.0,0.0
clydd101,David Clyde,Texas Rangers,RNGRS,1,2,2,4,1978,1978,0,0.81,0.78,-0.03,88,77,-11,186,217,31,597.0,0.0,-597.0,0.0,0.0,0.0
clydd101,David Clyde,Cleveland Indians,INDINS,1,2,3,5,1980,1980,0,-1.43,-0.55,0.88,119,28,-91,205,57,-148,0.0,0.0,0.0,0.0,0.0,0.0
clymo101,Otis Clymer,Philadelphia Phillies,PHILS,1,2,3,5,1905,1911,6,1.77,5.1,3.33,253,872,619,1002,3354,2352,15.0,0.0,-15.0,0.0,0.0,0.0
coang101,Gil Coan,Washington Senators,TWINS,5,10,10,20,1954,1971,17,31.61,55.11,23.5,1852,3047,1195,6210,9678,3468,873.0,2844.0,1971.0,153000.0,115000.0,-38000.0
coang101,Gil Coan,Chicago White Sox,WSOX,1,1,1,2,1955,1957,2,-0.19,0.73,0.92,13,107,94,14,116,102,0.0,0.0,0.0,0.0,0.0,0.0
coatb001,Buck Coats,Chicago Cubs,CUBS,1,1,1,2,2007,2013,6,-0.15,-0.08,0.07,20,88,68,38,4,-34,0.0,134.0,134.0,0.0,0.0,0.0
coatb001,Buck Coats,Cincinnati Reds,REDS,1,1,1,2,2007,2009,2,0.07,0.0,-0.07,8,0,-8,6,0,-6,0.0,0.0,0.0,0.0,0.0,0.0
coatj101,Jim Coates,New York Yankees,YANKS,1,1,1,2,1963,1970,7,-0.87,9.42,10.29,40,624,584,6,95,89,133.0,1458.0,1325.0,0.0,0.0,0.0
coatj101,Jim Coates,Washington Senators,RNGRS,1,1,1,2,1963,1966,3,-0.18,2.2,2.38,18,409,391,3,1505,1502,49.0,0.0,-49.0,0.0,0.0,0.0
coatj101,Jim Coates,Cincinnati Reds,REDS,1,2,1,3,1965,1966,1,-0.16,-0.48,-0.32,102,22,-80,15,2,-13,336.0,52.0,-284.0,0.0,0.0,0.0
cobba001,Alex Cobb,Baltimore Orioles,ORLS,1,2,1,3,2021,2021,0,1.73,-0.62,-2.35,19,26,7,1,72,71,280.0,0.0,-280.0,0.0,0.0,0.0
cochd001,Dave Cochrane,New York Mets,METS,1,1,1,2,1985,1985,0,-0.38,-0.01,0.37,19,46,27,68,124,56,0.0,0.0,0.0,0.0,333333.0,333333.0
cochd001,Dave Cochrane,Chicago White Sox,WSOX,4,7,7,14,1987,1994,7,14.45,7.51,-6.94,385,504,119,1,759,758,4103.0,4503.0,400.0,930000.0,62500.0,-867500.0
cochd001,Dave Cochrane,Kansas City Royals,ROYALS,1,1,1,2,1988,1988,0,-1.02,0.0,1.02,199,0,-199,494,0,-494,0.0,0.0,0.0,0.0,0.0,0.0
cochm101,Mickey Cochrane,Portland,Portland,1,1,6,7,1924,1925,1,37.87,0.0,-37.87,1167,0,-1167,4861,0,-4861,0.0,0.0,0.0,0.0,13500.0,13500.0
cochm101,Mickey Cochrane,Philadelphia Athletics,ATLTCS,2,3,4,7,1933,1935,2,15.67,0.35,-15.32,391,161,-230,1453,502,-951,735.0,0.0,-735.0,26167.0,10400.0,-15767.0
cocka001,Alan Cockrell,San Francisco Giants,GIANTS,1,1,1,2,1988,1988,0,0.0,0.0,0.0,0,0,0,0,0,0,0.0,0.0,0.0,0.0,0.0,0.0
cocka001,Alan Cockrell,Minnesota Twins,TWINS,1,1,1,2,1990,1990,0,0.0,0.0,0.0,0,0,0,0,0,0,0.0,0.0,0.0,0.0,0.0,0.0
coelr001,Robert Coello,Boston Red Sox,RSOX,1,1,1,2,2011,2011,0,0.0,0.0,0.0,0,0,0,0,0,0,0.0,0.0,0.0,0.0,0.0,0.0
coffd101,Dick Coffman,Washington Senators,TWINS,6,16,10,26,1927,1941,14,54.71,66.87,12.16,4079,2617,-1462,12814,9775,-3039,8820.0,3821.0,-4999.0,91600.0,78200.0,-13400.0
coffd101,Dick Coffman,St.Louis Browns,ORLS,2,2,2,4,1932,1935,3,0.49,2.6,2.11,102,270,168,68,199,131,594.0,1667.0,1073.0,4500.0,6500.0,2000.0
coffd101,Dick Coffman,Washington Senators,TWINS,3,4,3,7,1932,1937,5,8.57,12.76,4.19,616,294,-322,554,447,-107,4404.0,3142.0,-1262.0,6500.0,0.0,-6500.0
coffk001,Kevin Coffman,Atlanta Braves,BRAVES,1,2,1,3,1988,1990,2,-1.22,-1.32,-0.1,28,92,64,13,296,283,123.0,0.0,-123.0,65000.0,1108333.0,1043333.0
coffs101,Slick Coffman,Detroit Tigers,TIGRS,1,1,1,2,1940,1942,2,-0.71,2.31,3.02,63,163,100,18,525,507,224.0,0.0,-224.0,0.0,0.0,0.0
coggf101,Frank Coggins,Washington Senators,RNGRS,1,1,1,2,1969,1969,0,0.0,0.0,0.0,0,0,0,0,0,0,0.0,0.0,0.0,0.0,12000.0,12000.0
coggf101,Frank Coggins,Milwaukee Brewers,BREWRS,1,3,2,5,1970,1971,1,1.89,-2.52,-4.41,337,186,-151,1153,421,-732,0.0,0.0,0.0,0.0,0.0,0.0
coggr101,Rich Coggins,Baltimore Orioles,ORLS,6,18,17,35,1974,1988,14,24.52,108.22,83.7,1282,4856,3574,1868,13359,11491,8105.0,12121.0,4016.0,705333.0,98500.0,-606833.0
coggr101,Rich Coggins,New York Yankees,YANKS,1,2,1,3,1976,1977,1,4.11,0.35,-3.76,80,152,72,116,536,420,850.0,0.0,-850.0,0.0,0.0,0.0
coggr101,Rich Coggins,Chicago White Sox,WSOX,2,2,2,4,1976,1982,6,-1.26,0.67,1.93,72,526,454,197,1539,1342,0.0,6.0,6.0,0.0,0.0,0.0
coghc001,Chris Coghlan,Chicago Cubs,CUBS,1,1,1,2,2016,2017,1,-1.21,0.0,1.21,51,0,-51,172,0,-172,0.0,0.0,0.0,4800000.0,0.0,-4800000.0
coghc001,Chris Coghlan,Oakland Athletics,ATLTCS,1,1,1,2,2016,2016,0,0.6,-0.34,-0.94,48,16,-32,128,19,-109,0.0,0.0,0.0,0.0,0.0,0.0
cokej101,Jimmie Coker,Baltimore Orioles,ORLS,11,25,25,50,1962,1988,26,22.28,92.11,69.83,2229,4677,2448,3893,9050,5157,9525.0,13707.0,4182.0,725833.0,57000.0,-668833.0
cokej101,Jimmie Coker,San Francisco Giants,GIANTS,1,1,1,2,1963,1964,1,0.0,-0.21,-0.21,0,20,20,0,0,0,0.0,27.0,27.0,0.0,0.0,0.0
cokej101,Jimmie Coker,St. Louis Cardinals,CARDS,12,25,20,45,1964,1972,8,30.8,2.13,-28.67,3297,763,-2534,8519,1730,-6789,1865.0,703.0,-1162.0,32500.0,24000.0,-8500.0
cokep001,Phil Coke,New York Yankees,YANKS,1,3,1,4,2009,2013,4,21.17,14.94,-6.23,983,513,-470,2996,2148,-848,971.0,0.0,-971.0,812225.0,3500000.0,2687775.0
colar101,Rocky Colavito,Cleveland Indians,INDINS,3,3,5,8,1960,1964,4,21.16,4.21,-16.95,1210,620,-590,4904,2233,-2671,0.0,144.0,144.0,40000.0,36500.0,-3500.0
colar101,Rocky Colavito,Detroit Tigers,TIGRS,4,6,6,12,1963,1972,9,7.82,5.86,-1.96,636,1217,581,727,2715,1988,1071.0,2815.0,1744.0,103000.0,29000.0,-74000.0
colar101,Rocky Colavito,Kansas City Athletics,ATLTCS,14,30,24,54,1965,1976,11,49.39,42.65,-6.74,5788,4015,-1773,12719,12980,261,7766.0,2197.0,-5569.0,387100.0,458500.0,71400.0
colar101,Rocky Colavito,Cleveland Indians,INDINS,1,1,2,3,1967,1968,1,0.06,-0.19,-0.25,60,19,-41,220,22,-198,0.0,0.0,0.0,0.0,25000.0,25000.0
colbg001,Greg Colbrunn,Minnesota Twins,TWINS,1,1,1,2,1997,1997,0,0.19,0.0,-0.19,56,0,-56,107,0,-107,0.0,0.0,0.0,750000.0,0.0,-750000.0
colbg001,Greg Colbrunn,Colorado Rockies,ROCKS,2,2,3,5,1998,2000,2,0.16,-0.01,-0.17,36,31,-5,49,0,-49,11.0,44.0,33.0,735000.0,0.0,-735000.0
colbg001,Greg Colbrunn,Seattle Mariners,MARNRS,1,2,1,3,2003,2004,1,-0.58,-0.37,0.21,20,19,-1,28,23,-5,0.0,0.0,0.0,750000.0,1750000.0,1000000.0
colbj101,Jim Colborn,Chicago Cubs,CUBS,2,4,2,6,1971,1977,6,12.52,9.33,-3.19,493,821,328,508,3274,2766,3595.0,0.0,-3595.0,150000.0,45000.0,-105000.0
colbj101,Jim Colborn,Milwaukee Brewers,BREWRS,3,4,6,10,1976,1986,10,23.16,4.69,-18.47,1350,684,-666,3618,973,-2645,1204.0,2526.0,1322.0,487500.0,0.0,-487500.0
colbj101,Jim Colborn,Kansas City Royals,ROYALS,1,1,1,2,1978,1980,2,-0.62,0.35,0.97,20,136,116,0,331,331,343.0,0.0,-343.0,0.0,0.0,0.0
colbm101,Mike Colbern,Chicago White Sox,WSOX,3,4,4,8,1981,1987,6,4.43,7.04,2.61,422,580,158,1527,1402,-125,154.0,667.0,513.0,0.0,0.0,0.0
colbn101,Nate Colbert,San Diego Padres,PADRS,4,5,8,13,1974,1977,3,-1.08,2.59,3.67,91,579,488,259,1031,772,183.0,1079.0,896.0,80000.0,121500.0,41500.0
colbv101,Vince Colbert,Cleveland Indians,INDINS,1,1,1,2,1972,1972,0,0.0,0.0,0.0,0,0,0,0,0,0,0.0,0.0,0.0,0.0,9900.0,9900.0
colbv101,Vince Colbert,Texas Rangers,RNGRS,1,2,1,3,1973,1974,1,0.0,1.79,1.79,0,272,272,0,1149,1149,0.0,0.0,0.0,0.0,0.0,0.0
colea001,Alex Cole,St. Louis Cardinals,CARDS,1,2,1,3,1990,1995,5,0.0,4.64,4.64,0,288,288,0,209,209,0.0,1818.0,1818.0,0.0,0.0,0.0
colea001,Alex Cole,San Diego Padres,PADRS,1,1,1,2,1990,1993,3,2.56,0.15,-2.41,226,73,-153,817,152,-665,0.0,0.0,0.0,0.0,0.0,0.0
colea001,Alex Cole,Cleveland Indians,INDINS,2,3,3,6,1992,1995,3,2.04,0.0,-2.04,211,0,-211,684,0,-684,0.0,0.0,0.0,162500.0,0.0,-162500.0
colea002,A.J. Cole,Washington Nationals,NATEX,2,6,4,10,2011,2018,7,12.32,19.68,7.36,414,407,-7,1035,430,-605,1666.0,3760.0,2094.0,12000000.0,420000.0,-11580000.0
colea002,A.J. Cole,Oakland Athletics,ATLTCS,8,15,10,25,2013,2018,5,10.44,2.58,-7.86,1089,362,-727,2080,1057,-1023,1184.0,312.0,-872.0,8300001.0,4800000.0,-3500001.0
coleb101,Bert Cole,SanFrancisco,SanFrancisco,1,1,1,2,1920,1920,0,0.72,0.0,-0.72,299,0,-299,192,0,-192,1487.0,0.0,-1487.0,0.0,0.0,0.0
coleb101,Bert Cole,Chicago White Sox,WSOX,5,17,8,25,1927,1936,9,4.13,-0.01,-4.14,711,811,100,2521,3083,562,0.0,39.0,39.0,40200.0,39000.0,-1200.0
coleb102,Bob Coleman,Columbus,Columbus,1,1,1,2,1916,1916,0,0.21,0.0,-0.21,19,0,-19,36,0,-36,0.0,0.0,0.0,0.0,0.0,0.0
colec102,Chris Coletta,Boston Red Sox,RSOX,2,3,2,5,1972,1973,1,0.48,0.42,-0.06,203,17,-186,340,50,-290,0.0,0.0,0.0,0.0,27000.0,27000.0
colec102,Chris Coletta,California Angels,ANGELS,2,4,3,7,1973,1976,3,2.26,3.34,1.08,402,155,-247,1412,564,-848,0.0,0.0,0.0,38500.0,40000.0,1500.0
coled001,Darnell Coles,Seattle Mariners,MARNRS,1,1,1,2,1985,1988,3,0.21,-0.01,-0.22,247,3,-244,878,0,-878,0.0,21.0,21.0,0.0,0.0,0.0
coled001,Darnell Coles,Detroit Tigers,TIGRS,1,2,1,3,1987,1988,1,0.01,-0.36,-0.37,138,58,-80,389,196,-193,59.0,0.0,-59.0,170000.0,317500.0,147500.0
coled001,Darnell Coles,Pittsburgh Pirates,PIRATS,4,4,5,9,1988,1993,5,1.39,3.45,2.06,719,180,-539,2572,594,-1978,0.0,18.0,18.0,1125000.0,850000.0,-275000.0
coled001,Darnell Coles,Seattle Mariners,MARNRS,1,1,1,2,1990,1991,1,-0.86,0.55,1.41,52,104,52,122,289,167,0.0,0.0,0.0,690000.0,375000.0,-315000.0
coled003,Dylan Coleman,San Diego Padres,PADRS,1,2,1,3,2020,2021,1,0.01,0.64,0.63,62,10,-52,176,0,-176,19.0,30.0,11.0,0.0,100000.0,100000.0
coled101,Dick Cole,St. Louis Cardinals,CARDS,3,10,5,15,1951,1954,3,10.75,2.71,-8.04,1144,382,-762,2713,1234,-1479,1601.0,388.0,-1213.0,41500.0,63500.0,22000.0
coled101,Dick Cole,Pittsburgh Pirates,PIRATS,10,17,19,36,1957,1973,16,-1.46,37.76,39.22,579,1672,1093,1223,4937,3714,386.0,2327.0,1941.0,17500.0,0.0,-17500.0
coled102,Dave Coleman,Boston Red Sox,RSOX,1,1,1,2,1979,1979,0,0.0,0.53,0.53,0,47,47,0,100,100,0.0,0.0,0.0,0.0,0.0,0.0
coled103,Dave Cole,Milwaukee Braves,BRAVES,1,2,1,3,1954,1955,1,-0.23,-0.06,0.17,37,25,-12,31,42,11,252.0,0.0,-252.0,0.0,0.0,0.0
coled103,Dave Cole,Philadelphia Phillies,PHILS,3,10,5,15,1955,1962,7,1.07,-1.95,-3.02,707,737,30,1985,2099,114,115.0,415.0,300.0,9000.0,0.0,-9000.0
colee101,Ed Cole,Cleveland Indians,INDINS,1,3,1,4,1938,1941,3,1.14,1.94,0.8,388,390,2,935,1415,480,285.0,0.0,-285.0,0.0,0.0,0.0
colee102,Ed Coleman,Philadelphia Athletics,ATLTCS,1,2,1,3,1935,1936,1,2.31,1.97,-0.34,270,46,-224,676,55,-621,552.0,447.0,-105.0,9500.0,6000.0,-3500.0
colee102,Ed Coleman,St.Louis Browns,ORLS,2,3,2,5,1937,1938,1,0.0,0.03,0.03,0,126,126,0,533,533,0.0,46.0,46.0,4500.0,0.0,-4500.0
colee102,Ed Coleman,Portland,Portland,1,2,2,4,1931,1931,0,1.71,0.0,-1.71,253,0,-253,858,0,-858,33.0,0.0,-33.0,0.0,0.0,0.0
coleg001,Gerrit Cole,Pittsburgh Pirates,PIRATS,2,2,9,11,2018,2021,3,15.58,5.92,-9.66,139,632,493,73,615,542,1782.0,1498.0,-284.0,0.0,0.0,0.0
coleg101,Gordy Coleman,Cleveland Indians,INDINS,3,5,5,10,1959,1965,6,6.43,1.26,-5.17,1198,354,-844,3637,1453,-2184,454.0,0.0,-454.0,7500.0,10500.0,3000.0
colej101,Joe Coleman,Philadelphia Athletics,ATLTCS,1,2,1,3,1953,1954,1,1.98,0.0,-1.98,78,0,-78,84,0,-84,699.0,0.0,-699.0,7500.0,13500.0,6000.0
colej102,Joe Coleman,Washington Senators,RNGRS,6,10,11,21,1970,1976,6,30.0,-0.41,-30.41,2790,834,-1956,8622,1724,-6898,5481.0,1612.0,-3869.0,75900.0,317100.0,241200.0
colej102,Joe Coleman,Chicago Cubs,CUBS,4,5,5,10,1977,1979,2,7.62,-0.47,-8.09,937,193,-744,2458,302,-2156,1259.0,200.0,-1059.0,0.0,0.0,0.0
colek101,King Cole,Chicago Cubs,CUBS,1,2,2,4,1912,1915,3,-1.23,9.99,11.22,69,392,323,172,1573,1401,147.0,212.0,65.0,7400.0,5000.0,-2400.0
colem001,Michael Coleman,Boston Red Sox,RSOX,1,2,1,3,2000,2001,1,-0.55,1.15,1.7,39,96,57,95,386,291,0.0,0.0,0.0,0.0,375000.0,375000.0
colem001,Michael Coleman,Cincinnati Reds,REDS,2,3,3,6,2001,2013,12,-0.92,19.24,20.16,177,833,656,524,1510,986,0.0,5071.0,5071.0,0.0,0.0,0.0
coler101,Rip Coleman,New York Yankees,YANKS,6,15,13,28,1957,1970,13,5.72,32.98,27.26,1633,2423,790,4235,5558,1323,2553.0,4978.0,2425.0,115500.0,43000.0,-72500.0
coler102,Ray Coleman,St.Louis Browns,ORLS,1,1,2,3,1948,1948,0,-0.27,-0.18,0.09,68,15,-53,249,27,-222,0.0,0.0,0.0,0.0,7500.0,7500.0
coler102,Ray Coleman,Philadelphia Athletics,ATLTCS,36,79,78,157,1949,1976,27,93.22,74.94,-18.28,10595,9460,-1135,25786,29262,3476,12563.0,7417.0,-5146.0,500300.0,639500.0,139200.0
coler102,Ray Coleman,Chicago White Sox,WSOX,8,14,15,29,1952,1969,17,11.54,36.17,24.63,1591,2618,1027,4750,8911,4161,1710.0,1860.0,150.0,87250.0,45000.0,-42250.0
coler102,Ray Coleman,St.Louis Browns,ORLS,16,41,37,78,1952,1988,36,52.13,131.97,79.84,3638,7667,4029,6759,21898,15139,14284.0,13293.0,-991.0,815833.0,128400.0,-687433.0
colev001,Vince Coleman,New York Mets,METS,1,2,1,3,1994,1994,0,-1.52,0.27,1.79,179,51,-128,801,201,-600,0.0,0.0,0.0,0.0,0.0,0.0
colev001,Vince Coleman,Kansas City Royals,ROYALS,1,1,1,2,1995,1997,2,0.28,0.01,-0.27,40,12,-28,176,0,-176,0.0,52.0,52.0,250000.0,115000.0,-135000.0
colev002,Victor Cole,Kansas City Royals,ROYALS,3,3,4,7,1991,1994,3,-0.79,1.48,2.27,190,259,69,474,869,395,69.0,0.0,-69.0,0.0,1890000.0,1890000.0
collb101,Bill Collins,New York Giants,GIANTS,1,2,1,3,1910,1913,3,4.09,2.02,-2.07,544,293,-251,2338,817,-1521,0.0,0.0,0.0,0.0,0.0,0.0
collb101,Bill Collins,Boston Braves,BRAVES,2,5,6,11,1911,1914,3,3.16,-2.55,-5.71,559,378,-181,1829,1028,-801,21.0,614.0,593.0,0.0,6000.0,6000.0
collb101,Bill Collins,Newark,Newark,1,1,1,2,1913,1913,0,-0.85,0.0,0.85,32,0,-32,107,0,-107,0.0,0.0,0.0,0.0,2400.0,2400.0
colld001,Dave Collins,Seattle Mariners,MARNRS,4,6,7,13,1977,1987,10,16.55,11.78,-4.77,1031,881,-150,1983,1334,-649,2811.0,2774.0,-37.0,0.0,200000.0,200000.0
colld001,Dave Collins,New York Yankees,YANKS,1,4,2,6,1982,1985,3,24.16,-0.71,-24.87,840,62,-778,3265,0,-3265,136.0,360.0,224.0,650000.0,0.0,-650000.0
colld001,Dave Collins,Toronto Blue Jays,BJAYS,1,3,1,4,1984,1987,3,7.47,0.63,-6.84,580,109,-471,2252,0,-2252,0.0,317.0,317.0,650000.0,0.0,-650000.0
colld001,Dave Collins,Oakland Athletics,ATLTCS,1,1,1,2,1985,1986,1,1.38,0.0,-1.38,124,0,-124,476,0,-476,0.0,0.0,0.0,700000.0,0.0,-700000.0
colld101,Don Collins,Atlanta Braves,BRAVES,1,1,1,2,1980,1980,0,-0.05,0.0,0.05,4,0,-4,0,0,0,18.0,0.0,-18.0,0.0,0.0,0.0
collj102,Jackie Collum,St. Louis Cardinals,CARDS,2,4,2,6,1953,1954,1,4.37,-0.14,-4.51,196,106,-90,110,278,168,1014.0,107.0,-907.0,0.0,0.0,0.0
collj102,Jackie Collum,Cincinnati Reds,REDS,1,1,2,3,1956,1960,4,0.48,7.46,6.98,76,388,312,17,278,261,180.0,2357.0,2177.0,0.0,0.0,0.0
collj102,Jackie Collum,St. Louis Cardinals,CARDS,15,35,30,65,1956,1972,16,38.58,60.99,22.41,4144,2647,-1497,9926,7589,-2337,4766.0,5429.0,663.0,32500.0,36000.0,3500.0
collj102,Jackie Collum,Chicago Cubs,CUBS,1,2,1,3,1957,1965,8,-0.13,9.65,9.78,10,894,884,1,138,137,23.0,2255.0,2232.0,0.0,0.0,0.0
collj102,Jackie Collum,Minnesota Twins,TWINS,1,3,1,4,1962,1963,1,-0.08,-0.13,-0.05,2,12,10,0,6,6,4.0,58.0,54.0,0.0,0.0,0.0
collj103,Jimmy Collins,Boston Red Sox,RSOX,2,3,2,5,1907,1907,0,2.23,0.41,-1.82,214,102,-112,868,395,-473,0.0,30.0,30.0,0.0,0.0,0.0
collk101,Kevin Collins,New York Mets,METS,1,5,1,6,1969,1971,2,11.34,3.37,-7.97,538,281,-257,615,957,342,4078.0,0.0,-4078.0,0.0,50000.0,50000.0
collk101,Kevin Collins,Detroit Tigers,TIGRS,2,4,2,6,1973,1975,2,0.22,-0.05,-0.27,33,98,65,0,215,215,403.0,135.0,-268.0,27500.0,0.0,-27500.0
colll001,Lou Collier,Milwaukee Brewers,BREWRS,2,7,6,13,2002,2004,2,1.18,1.8,0.62,314,393,79,929,661,-268,437.0,1049.0,612.0,2750000.0,500000.0,-2250000.0
colll001,Lou Collier,New York Mets,METS,2,4,4,8,2002,2003,1,-0.15,0.83,0.98,24,64,40,27,7,-20,29.0,147.0,118.0,0.0,500000.0,500000.0
collp101,Pat Collins,St.Louis Browns,ORLS,1,4,1,5,1925,1928,3,0.0,-0.47,-0.47,0,145,145,0,462,462,0.0,0.0,0.0,0.0,0.0,0.0
collp101,Pat Collins,StPaul,StPaul,6,8,13,21,1925,1930,5,6.53,0.0,-6.53,925,0,-925,2834,0,-2834,611.0,0.0,-611.0,0.0,45550.0,45550.0
collr101,Ripper Collins,St. Louis Cardinals,CARDS,1,2,1,3,1936,1942,6,2.86,15.14,12.28,328,366,38,1111,461,-650,437.0,3473.0,3036.0,0.0,15500.0,15500.0
collr104,Rip Collins,New York Yankees,YANKS,4,11,7,18,1921,1946,25,28.58,81.31,52.73,995,2473,1478,1312,4729,3417,7730.0,15194.0,7464.0,42500.0,38450.0,-4050.0
collr104,Rip Collins,Boston Red Sox,RSOX,5,10,13,23,1922,1937,15,16.16,24.39,8.23,675,750,75,1305,1574,269,3851.0,4650.0,799.0,45550.0,18500.0,-27050.0
collr104,Rip Collins,Detroit Tigers,TIGRS,1,1,1,2,1928,1928,0,0.0,0.2,0.2,0,58,58,0,63,63,0.0,511.0,511.0,0.0,0.0,0.0
colls101,Shano Collins,Chicago White Sox,WSOX,1,2,1,3,1921,1921,0,-2.09,3.07,5.16,680,108,-572,2600,485,-2115,0.0,0.0,0.0,0.0,0.0,0.0
collt001,Tim Collins,Toronto Blue Jays,BJAYS,4,18,13,31,2010,2018,8,25.98,29.42,3.44,2444,1447,-997,6892,4630,-2262,4668.0,4909.0,241.0,11482900.0,44024800.0,32541900.0
collt001,Tim Collins,Atlanta Braves,BRAVES,1,3,2,5,2010,2010,0,2.01,-0.01,-2.02,319,93,-226,204,139,-65,734.0,60.0,-674.0,415000.0,7250000.0,6835000.0
colmf101,Frank Colman,Toronto,Toronto,1,2,1,3,1942,1942,0,4.35,0.0,-4.35,338,0,-338,630,0,-630,555.0,0.0,-555.0,0.0,0.0,0.0
coloa001,Alex Colome,Tampa Bay Devil Rays,RAYS,1,3,2,5,2018,2019,1,2.35,0.0,-2.35,144,0,-144,328,0,-328,139.0,0.0,-139.0,5300000.0,0.0,-5300000.0
coloa001,Alex Colome,Seattle Mariners,MARNRS,2,2,3,5,2018,2019,1,3.4,2.23,-1.17,251,132,-119,571,482,-89,250.0,0.0,-250.0,581200.0,560000.0,-21200.0
colob001,Bartolo Colon,Cleveland Indians,INDINS,10,19,27,46,2002,2021,19,63.04,99.19,36.15,2801,3478,677,9898,8220,-1678,3587.0,12440.0,8853.0,39810300.0,19652500.0,-20157800.0
colob001,Bartolo Colon,Montreal Expos,NATEX,1,2,4,6,2003,2004,1,5.15,-4.18,-9.33,48,270,222,7,107,100,913.0,449.0,-464.0,0.0,0.0,0.0
coloj001,Jesus Colome,Oakland Athletics,ATLTCS,2,4,3,7,2000,2004,4,0.08,5.64,5.56,354,661,307,509,1663,1154,781.0,762.0,-19.0,201000.0,350000.0,149000.0
color001,Roman Colon,Atlanta Braves,BRAVES,1,2,1,3,2005,2005,0,3.3,0.97,-2.33,202,52,-150,7,0,-7,1262.0,82.0,-1180.0,318500.0,1975000.0,1656500.0
color001,Roman Colon,Detroit Tigers,TIGRS,1,1,1,2,2007,2007,0,0.27,0.0,-0.27,56,0,-56,1,0,-1,181.0,0.0,-181.0,0.0,0.0,0.0
colpd101,Dick Colpaert,Cleveland Indians,INDINS,1,2,2,4,1973,1973,0,-0.78,0.0,0.78,55,0,-55,0,0,0,604.0,0.0,-604.0,0.0,11000.0,11000.0
coltl101,Larry Colton,Philadelphia Phillies,PHILS,4,8,8,16,1970,1984,14,29.76,14.53,-15.23,1654,1829,175,6186,1998,-4188,0.0,2963.0,2963.0,0.0,123000.0,123000.0
colub101,Bob Coluccio,Milwaukee Brewers,BREWRS,1,1,1,2,1975,1975,0,-0.16,0.72,0.88,81,125,44,220,407,187,0.0,0.0,0.0,0.0,0.0,0.0
colub101,Bob Coluccio,Houston Astros,ASTROS,1,1,1,2,1978,1980,2,-0.06,0.27,0.33,5,26,21,4,6,2,0.0,75.0,75.0,0.0,0.0,0.0
colub101,Bob Coluccio,St. Louis Cardinals,CARDS,1,1,1,2,1978,1979,1,0.0,0.0,0.0,0,0,0,0,0,0,0.0,0.0,0.0,0.0,0.0,0.0
colvt001,Tyler Colvin,Chicago Cubs,CUBS,1,2,2,4,2011,2013,2,17.66,0.03,-17.63,1081,55,-1026,4267,202,-4065,0.0,0.0,0.0,440000.0,2287500.0,1847500.0
colys001,Steve Colyer,Los Angeles Dodgers,DOGRS,2,2,2,4,2004,2006,2,-0.54,0.28,0.82,47,22,-25,5,40,35,96.0,0.0,-96.0,327500.0,0.0,-327500.0
colys001,Steve Colyer,Detroit Tigers,TIGRS,1,1,1,2,2005,2005,0,0.0,-0.39,-0.39,0,14,14,0,0,0,0.0,105.0,105.0,0.0,0.0,0.0
combe101,Earle Combs,Louisville,Louisville,1,1,2,3,1924,1924,0,44.77,0.0,-44.77,1455,0,-1455,6514,0,-6514,0.0,0.0,0.0,0.0,0.0,0.0
combm101,Merl Combs,Boston Red Sox,RSOX,1,2,1,3,1950,1953,3,0.17,2.98,2.81,40,263,223,137,929,792,0.0,0.0,0.0,0.0,0.0,0.0
combm101,Merl Combs,St.Louis Browns,ORLS,2,4,3,7,1951,1952,1,-0.57,0.21,0.78,160,272,112,343,951,608,171.0,0.0,-171.0,6000.0,14500.0,8500.0
comew101,Wayne Comer,Washington Senators,RNGRS,1,1,1,2,1963,1963,0,-0.87,-0.15,0.72,79,125,46,64,416,352,0.0,0.0,0.0,0.0,0.0,0.0
comew101,Wayne Comer,Milwaukee Brewers,BREWRS,2,4,3,7,1970,1971,1,0.11,-0.05,-0.16,77,28,-49,154,68,-86,0.0,0.0,0.0,0.0,19000.0,19000.0
comoa101,Adam Comorosky,Pittsburgh Pirates,PIRATS,1,2,2,4,1933,1939,6,-1.61,11.63,13.24,298,385,87,1097,447,-650,0.0,2051.0,2051.0,0.0,0.0,0.0
compc101,Clint Compton,Atlanta Braves,BRAVES,1,2,2,4,1969,1970,1,9.24,2.87,-6.37,457,118,-339,1833,14,-1819,0.0,278.0,278.0,0.0,37000.0,37000.0
compp101,Pete Compton,St.Louis Browns,ORLS,1,4,1,5,1913,1916,3,0.0,8.53,8.53,0,318,318,0,1249,1249,0.0,0.0,0.0,3200.0,0.0,-3200.0
comsk001,Keith Comstock,San Francisco Giants,GIANTS,5,11,14,25,1987,1998,11,21.11,35.92,14.81,1313,2149,836,1417,3377,1960,4080.0,4148.0,68.0,9727778.0,6966667.0,-2761111.0
condr101,Ramon Conde,Los Angeles Dodgers,DOGRS,1,2,1,3,1962,1962,0,-0.44,0.03,0.47,14,53,39,19,130,111,0.0,0.0,0.0,0.0,0.0,0.0
condr101,Ramon Conde,Chicago White Sox,WSOX,1,1,2,3,1967,1967,0,0.0,0.0,0.0,0,0,0,0,0,0,0.0,0.0,0.0,0.0,0.0,0.0
coned001,David Cone,Kansas City Royals,ROYALS,1,2,3,5,1987,1988,1,20.17,-0.31,-20.48,379,19,-360,466,21,-445,3628.0,141.0,-3487.0,0.0,0.0,0.0
coned001,David Cone,New York Mets,METS,10,20,18,38,1992,2005,13,12.19,19.18,6.99,1467,3191,1724,1939,7500,5561,2972.0,2738.0,-234.0,27998333.0,20210666.0,-7787667.0
coned001,David Cone,Kansas City Royals,ROYALS,2,3,5,8,1995,1999,4,11.8,0.62,-11.18,520,251,-269,1598,135,-1463,391.0,629.0,238.0,0.0,0.0,0.0
coned001,David Cone,Toronto Blue Jays,BJAYS,1,1,3,4,1995,1997,2,20.23,-0.54,-20.77,149,27,-122,13,0,-13,2766.0,296.0,-2470.0,8000000.0,0.0,-8000000.0
congd101,Dick Conger,Philadelphia Phillies,PHILS,2,4,2,6,1943,1949,6,23.82,3.95,-19.87,519,273,-246,570,454,-116,4467.0,1587.0,-2880.0,0.0,0.0,0.0
congh001,Hank Conger,Anaheim Angels,ANGELS,2,2,3,5,2014,2019,5,0.06,3.14,3.08,81,228,147,251,604,353,0.0,587.0,587.0,517500.0,0.0,-517500.0
conib101,Billy Conigliaro,Boston Red Sox,RSOX,5,10,10,20,1971,1977,6,35.42,11.92,-23.5,1569,736,-833,4628,2092,-2536,3846.0,2344.0,-1502.0,155000.0,100500.0,-54500.0
conij001,Jeff Conine,Florida Marlins,MARLNS,1,1,1,2,1997,1997,0,0.14,0.0,-0.14,93,0,-93,343,0,-343,0.0,0.0,0.0,2800000.0,0.0,-2800000.0
conij001,Jeff Conine,Kansas City Royals,ROYALS,1,1,1,2,1999,2002,3,6.89,-1.4,-8.29,751,38,-713,3005,2,-3003,0.0,378.0,378.0,0.0,0.0,0.0
conij001,Jeff Conine,Baltimore Orioles,ORLS,2,2,3,5,2003,2005,2,2.81,-0.96,-3.77,316,67,-249,1062,0,-1062,295.0,181.0,-114.0,4250000.0,1000000.0,-3250000.0
conij001,Jeff Conine,Baltimore Orioles,ORLS,1,1,1,2,2006,2006,0,-0.09,0.0,0.09,28,0,-28,107,0,-107,0.0,0.0,0.0,1700000.0,0.0,-1700000.0
conij001,Jeff Conine,Philadelphia Phillies,PHILS,1,1,2,3,2006,2006,0,-0.18,0.0,0.18,80,0,-80,242,0,-242,0.0,0.0,0.0,0.0,0.0,0.0
conij001,Jeff Conine,Cincinnati Reds,REDS,1,1,2,3,2007,2007,0,-0.79,0.0,0.79,21,0,-21,50,0,-50,0.0,0.0,0.0,2000000.0,0.0,-2000000.0
conit101,Tony Conigliaro,Boston Red Sox,RSOX,6,13,11,24,1970,1987,17,23.72,33.07,9.35,1247,1904,657,3411,5540,2129,3997.0,6601.0,2604.0,192500.0,125000.0,-67500.0
conlg101,Gene Conley,Milwaukee Braves,BRAVES,2,4,4,8,1959,1964,5,9.25,-0.88,-10.13,355,69,-286,908,184,-724,1090.0,0.0,-1090.0,0.0,0.0,0.0
conlg101,Gene Conley,Philadelphia Phillies,PHILS,1,1,1,2,1960,1962,2,3.74,-0.05,-3.79,152,136,-16,188,41,-147,1447.0,547.0,-900.0,0.0,0.0,0.0
connb102,Bud Connolly,Boston Red Sox,RSOX,2,6,3,9,1925,1926,1,0.0,-1.32,-1.32,0,98,98,0,337,337,0.0,0.0,0.0,21750.0,0.0,-21750.0
connb104,Bruce Connatser,Cleveland Indians,INDINS,1,2,1,3,1932,1932,0,3.72,0.0,-3.72,330,0,-330,151,0,-151,1373.0,0.0,-1373.0,0.0,0.0,0.0
connc101,Chuck Connors,Brooklyn Dodgers,DOGRS,1,2,2,4,1950,1951,1,4.4,0.0,-4.4,849,35,-814,3484,35,-3449,0.0,0.0,0.0,0.0,0.0,0.0
connf001,Fritzie Connally,Chicago Cubs,CUBS,1,3,1,4,1983,1989,6,15.56,10.82,-4.74,1534,321,-1213,2801,249,-2552,1977.0,2213.0,236.0,0.0,0.0,0.0
connf001,Fritzie Connally,San Diego Padres,PADRS,1,1,1,2,1985,1985,0,0.35,0.0,-0.35,50,0,-50,135,0,-135,0.0,0.0,0.0,0.0,0.0,0.0
connj101,Joe Connolly,New York Giants,GIANTS,1,1,1,2,1922,1922,0,0.0,0.0,0.0,0,0,0,0,0,0,0.0,0.0,0.0,0.0,0.0,0.0
connj101,Joe Connolly,Cleveland Indians,INDINS,1,4,3,7,1924,1928,4,0.12,9.37,9.25,387,855,468,1555,3344,1789,0.0,0.0,0.0,0.0,0.0,0.0
connj101,Joe Connolly,Boston Red Sox,RSOX,1,2,1,3,1924,1924,0,0.0,0.0,0.0,0,0,0,0,0,0,0.0,0.0,0.0,3300.0,0.0,-3300.0
connj105,John Connor,Louisville Colonels,LS2,2,3,2,5,1885,1889,4,4.44,0.0,-4.44,98,0,-98,171,0,-171,1169.0,0.0,-1169.0,0.0,0.0,0.0
connr102,Roger Connor,Philadelphia Phillies,PHILS,1,1,3,4,1893,1898,5,4.81,-1.18,-5.99,157,549,392,700,2414,1714,0.0,168.0,168.0,0.0,0.0,0.0
conrb101,Bill Conroy,Philadelphia Athletics,ATLTCS,2,4,2,6,1937,1946,9,1.34,-1.59,-2.93,190,315,125,733,931,198,0.0,888.0,888.0,5300.0,8000.0,2700.0
conrt001,Tim Conroy,Oakland Athletics,ATLTCS,1,2,1,3,1985,1987,2,-1.98,1.12,3.1,136,41,-95,273,0,-273,468.0,648.0,180.0,425000.0,1030000.0,605000.0
consb101,Billy Consolo,Boston Red Sox,RSOX,1,2,2,4,1959,1960,1,0.88,-0.17,-1.05,192,13,-179,454,12,-442,4.0,0.0,-4.0,0.0,13000.0,13000.0
consb101,Billy Consolo,Minnesota Twins,TWINS,1,1,1,2,1961,1962,1,0.0,-0.89,-0.89,0,108,108,0,398,398,0.0,0.0,0.0,0.0,0.0,0.0
contj001,Jason Conti,Arizona Diamondbacks,DBACKS,1,2,2,4,2001,2001,0,-0.05,0.9,0.95,103,38,-65,245,52,-193,290.0,243.0,-47.0,200000.0,3750000.0,3550000.0
contj001,Jason Conti,Tampa Bay Devil Rays,RAYS,1,1,1,2,2003,2003,0,-0.18,-0.18,0.0,30,49,19,52,142,90,0.0,0.0,0.0,0.0,0.0,0.0
contj002,Jose Contreras,New York Yankees,YANKS,1,2,1,3,2004,2004,0,9.88,-1.02,-10.9,156,10,-146,18,0,-18,2700.0,127.0,-2573.0,8500000.0,4000000.0,-4500000.0
contj002,Jose Contreras,Chicago White Sox,WSOX,1,2,1,3,2009,2009,0,0.9,0.0,-0.9,14,0,-14,4,0,-4,51.0,0.0,-51.0,10000000.0,0.0,-10000000.0
contr001,Roansy Contreras,New York Yankees,YANKS,1,4,1,5,2021,2021,0,-0.2,2.23,2.43,9,31,22,3,2,-1,54.0,433.0,379.0,0.0,0.0,0.0
convj001,Jim Converse,Seattle Mariners,MARNRS,1,1,1,2,1995,1995,0,0.01,0.28,0.27,12,40,28,0,176,176,52.0,0.0,-52.0,115000.0,250000.0,135000.0
conwb101,Bill Conway,Lawrence,Lawrence,1,3,1,4,1886,1886,0,0.0,0.0,0.0,0,0,0,0,0,0,0.0,0.0,0.0,0.0,0.0,0.0
conwd101,Dick Conway,Lawrence,Lawrence,1,3,1,4,1886,1886,0,0.0,0.0,0.0,0,0,0,0,0,0,0.0,0.0,0.0,0.0,0.0,0.0
cookb001,Brent Cookson,San Francisco Giants,GIANTS,1,1,1,2,1995,1995,0,-0.49,-0.29,0.2,22,10,-12,38,0,-38,0.0,25.0,25.0,0.0,0.0,0.0
cookc101,Cliff Cook,Cincinnati Reds,REDS,2,3,2,5,1962,1963,1,-1.36,0.31,1.67,146,63,-83,266,207,-59,61.0,0.0,-61.0,0.0,0.0,0.0
cookd001,Dennis Cook,San Francisco Giants,GIANTS,2,4,4,8,1989,1995,6,14.97,0.18,-14.79,1080,283,-797,2467,146,-2321,4215.0,391.0,-3824.0,1545000.0,1450000.0,-95000.0
cookd001,Dennis Cook,Philadelphia Phillies,PHILS,2,3,2,5,1990,1992,2,3.82,-1.61,-5.43,693,143,-550,2178,167,-2011,96.0,163.0,67.0,120000.0,975000.0,855000.0
cookd001,Dennis Cook,Los Angeles Dodgers,DOGRS,2,3,2,5,1991,1993,2,1.24,0.37,-0.87,87,132,45,0,504,504,763.0,0.0,-763.0,240000.0,0.0,-240000.0
cookd001,Dennis Cook,Cleveland Indians,INDINS,1,1,1,2,1995,1995,0,1.82,0.0,-1.82,95,0,-95,0,0,0,346.0,0.0,-346.0,0.0,0.0,0.0
cookd001,Dennis Cook,Florida Marlins,MARLNS,1,1,2,3,1997,1997,0,2.74,0.0,-2.74,494,0,-494,6,0,-6,678.0,0.0,-678.0,850000.0,0.0,-850000.0
cookd001,Dennis Cook,New York Mets,METS,2,6,5,11,2001,2005,4,2.32,0.95,-1.37,695,209,-486,27,48,21,1207.0,444.0,-763.0,5800000.0,655000.0,-5145000.0
cookd102,Dusty Cooke,New York Yankees,YANKS,4,8,6,14,1933,1948,15,2.19,1.52,-0.67,1017,291,-726,3931,971,-2960,0.0,0.0,0.0,9000.0,11250.0,2250.0
cookd102,Dusty Cooke,Cincinnati Reds,REDS,4,6,4,10,1938,1940,2,13.89,0.35,-13.54,908,158,-750,3350,491,-2859,0.0,0.0,0.0,0.0,0.0,0.0
cooke101,Earl Cook,Cincinnati Reds,REDS,1,2,1,3,1939,1939,0,0.0,-0.02,-0.02,0,2,2,0,0,0,0.0,3.0,3.0,0.0,0.0,0.0
cookm001,Mike Cook,California Angels,ANGELS,1,3,2,5,1988,1992,4,-0.32,6.07,6.39,96,81,-15,213,0,-213,64.0,1524.0,1460.0,0.0,1000000.0,1000000.0
cookr001,Ryan Cook,Arizona Diamondbacks,DBACKS,6,12,12,24,2011,2021,10,55.85,12.58,-43.27,1986,909,-1077,2819,1176,-1643,7668.0,4077.0,-3591.0,13397833.0,3419900.0,-9977933.0
cookr001,Ryan Cook,Oakland Athletics,ATLTCS,1,1,1,2,2015,2015,0,-0.75,0.0,0.75,7,0,-7,0,0,0,13.0,0.0,-13.0,1400000.0,0.0,-1400000.0
coold101,Duff Cooley,St. Louis Cardinals,CARDS,1,1,3,4,1896,1896,0,6.22,-0.47,-6.69,440,102,-338,2080,456,-1624,0.0,0.0,0.0,0.0,0.0,0.0
cools001,Scott Coolbaugh,Texas Rangers,RNGRS,1,1,1,2,1990,1991,1,-0.69,-0.03,0.66,60,3,-57,205,1,-204,0.0,0.0,0.0,100000.0,190000.0,90000.0
cools001,Scott Coolbaugh,San Diego Padres,PADRS,1,1,1,2,1992,1992,0,0.0,0.0,0.0,0,0,0,0,0,0,0.0,0.0,0.0,0.0,0.0,0.0
coomr001,Ron Coomer,Chicago White Sox,WSOX,1,1,1,2,1993,1995,2,0.26,-0.04,-0.3,69,7,-62,137,0,-137,0.0,20.0,20.0,0.0,0.0,0.0
coomr001,Ron Coomer,Los Angeles Dodgers,DOGRS,1,4,2,6,1995,1998,3,-0.49,1.39,1.88,829,429,-400,2713,30,-2683,618.0,819.0,201.0,218000.0,4410000.0,4192000.0
coonj101,Johnny Cooney,New York Giants,GIANTS,1,4,1,5,1931,1931,0,0.0,0.0,0.0,0,0,0,0,0,0,0.0,0.0,0.0,0.0,0.0,0.0
coonj101,Johnny Cooney,Brooklyn Dodgers,DOGRS,1,4,1,5,1937,1944,7,1.9,1.11,-0.79,125,343,218,330,1190,860,390.0,0.0,-390.0,10000.0,10000.0,0.0
coonj101,Johnny Cooney,Indianapolis,Indianapolis,1,2,3,5,1935,1936,1,2.11,0.0,-2.11,313,0,-313,1102,0,-1102,0.0,0.0,0.0,0.0,0.0,0.0
coonj103,Jimmy Cooney,St. Louis Cardinals,CARDS,1,1,1,2,1925,1925,0,2.01,0.0,-2.01,174,0,-174,707,0,-707,0.0,0.0,0.0,4850.0,7000.0,2150.0
coonj103,Jimmy Cooney,Chicago Cubs,CUBS,1,2,1,3,1927,1927,0,-0.69,2.92,3.61,89,54,-35,289,70,-219,56.0,552.0,496.0,15500.0,0.0,-15500.0
coonj103,Jimmy Cooney,Philadelphia Phillies,PHILS,1,3,2,5,1927,1929,2,-0.72,-1.19,-0.47,18,135,117,33,192,159,0.0,529.0,529.0,8850.0,13300.0,4450.0
coonj103,Jimmy Cooney,Boston Braves,BRAVES,1,3,1,4,1928,1928,0,0.0,-0.51,-0.51,0,14,14,0,6,6,0.0,65.0,65.0,10080.0,0.0,-10080.0
coons001,Sam Coonrod,San Francisco Giants,GIANTS,1,1,1,2,2021,2021,0,0.39,0.0,-0.39,82,0,-82,1,0,-1,127.0,0.0,-127.0,0.0,0.0,0.0
coopb001,Brian Cooper,Anaheim Angels,ANGELS,1,1,1,2,2002,2003,1,-0.5,4.23,4.73,2,193,191,0,714,714,25.0,0.0,-25.0,0.0,0.0,0.0
coopc001,Cecil Cooper,Boston Red Sox,RSOX,2,2,3,5,1976,1981,5,30.69,4.95,-25.74,1534,508,-1026,6654,1859,-4795,0.0,0.0,0.0,200000.0,150000.0,-50000.0
coopd001,Don Cooper,Minnesota Twins,TWINS,1,1,1,2,1982,1982,0,-0.05,0.0,0.05,4,0,-4,0,0,0,16.0,0.0,-16.0,0.0,0.0,0.0
coopd001,Don Cooper,Toronto Blue Jays,BJAYS,1,1,1,2,1984,1984,0,-0.06,0.0,0.06,7,0,-7,0,0,0,30.0,0.0,-30.0,0.0,0.0,0.0
coopg002,Garrett Cooper,Milwaukee Brewers,BREWRS,1,1,1,2,2017,2018,1,0.11,-0.14,-0.25,13,4,-9,45,0,-45,0.0,6.0,6.0,0.0,0.0,0.0
coopg002,Garrett Cooper,New York Yankees,YANKS,1,2,2,4,2017,2017,0,5.67,0.0,-5.67,313,0,-313,917,0,-917,701.0,0.0,-701.0,0.0,0.0,0.0
coopm101,Mort Cooper,St. Louis Cardinals,CARDS,1,1,2,3,1945,1946,1,4.41,4.13,-0.28,116,118,2,118,121,3,973.0,941.0,-32.0,15000.0,0.0,-15000.0
coopm101,Mort Cooper,Boston Braves,BRAVES,2,2,4,6,1947,1951,4,-0.91,4.84,5.75,54,245,191,30,368,338,264.0,1549.0,1285.0,0.0,0.0,0.0
coops001,Scott Cooper,Boston Red Sox,RSOX,4,7,6,13,1995,1997,2,2.06,3.71,1.65,881,324,-557,1600,1071,-529,1046.0,345.0,-701.0,1638268.0,2000000.0,361732.0
coopw101,Wilbur Cooper,Columbus,Columbus,1,1,1,2,1912,1912,0,52.68,0.0,-52.68,942,0,-942,1206,0,-1206,9590.0,0.0,-9590.0,0.0,0.0,0.0
coopw101,Wilbur Cooper,Pittsburgh Pirates,PIRATS,4,6,7,13,1924,1932,8,11.08,42.87,31.79,1606,1347,-259,6101,4357,-1744,1307.0,3847.0,2540.0,22300.0,13500.0,-8800.0
coopw102,Walker Cooper,New York Giants,GIANTS,1,1,1,2,1949,1950,1,1.35,0.01,-1.34,97,60,-37,378,197,-181,0.0,0.0,0.0,0.0,0.0,0.0
coopw102,Walker Cooper,Cincinnati Reds,REDS,9,17,23,40,1950,1965,15,91.55,24.9,-66.65,4942,2303,-2639,15926,5746,-10180,2749.0,1025.0,-1724.0,63000.0,63000.0,0.0
coppr001,Rocky Coppinger,Baltimore Orioles,ORLS,2,2,3,5,1999,2001,2,0.82,-0.96,-1.78,122,85,-37,12,0,-12,275.0,241.0,-34.0,620000.0,2250000.0,1630000.0
coraa001,Alex Cora,Cleveland Indians,INDINS,1,1,1,2,2005,2006,1,2.32,-1.15,-3.47,301,46,-255,791,103,-688,0.0,0.0,0.0,1300000.0,700000.0,-600000.0
coraj001,Joey Cora,San Diego Padres,PADRS,2,4,3,7,1991,1994,3,4.76,-1.77,-6.53,685,201,-484,2072,489,-1583,0.0,199.0,199.0,130000.0,0.0,-130000.0
coraj001,Joey Cora,Seattle Mariners,MARNRS,2,2,3,5,1998,2002,4,2.76,7.06,4.3,178,558,380,725,2150,1425,0.0,0.0,0.0,1700000.0,0.0,-1700000.0
corba001,Archie Corbin,New York Mets,METS,1,1,1,2,1990,1990,0,0.03,0.32,0.29,2,17,15,0,47,47,7.0,0.0,-7.0,0.0,725000.0,725000.0
corba001,Archie Corbin,Kansas City Royals,ROYALS,1,2,2,4,1992,1998,6,4.48,3.6,-0.88,352,157,-195,1116,0,-1116,0.0,1991.0,1991.0,0.0,293000.0,293000.0
corbc101,Claude Corbitt,Syracuse,Syracuse,1,1,1,2,1953,1954,1,0.0,0.0,0.0,0,0,0,0,0,0,0.0,0.0,0.0,0.0,0.0,0.0
corbc101,Claude Corbitt,Milwaukee,Milwaukee,1,1,3,4,1941,1941,0,0.04,0.0,-0.04,2,0,-2,5,0,-5,0.0,0.0,0.0,0.0,0.0,0.0
corbd001,Doug Corbett,Minnesota Twins,TWINS,3,6,6,12,1982,1989,7,9.33,17.94,8.61,1193,1029,-164,3688,4105,417,852.0,435.0,-417.0,1243500.0,1775000.0,531500.0
corbg101,Gene Corbett,Philadelphia Phillies,PHILS,1,1,1,2,1938,1938,0,0.0,2.49,2.49,0,100,100,0,421,421,0.0,0.0,0.0,0.0,0.0,0.0
corbp001,Patrick Corbin,Anaheim Angels,ANGELS,1,4,1,5,2010,2012,2,13.1,6.5,-6.6,498,84,-414,497,11,-486,4323.0,1527.0,-2796.0,3700000.0,8250000.0,4550000.0
corct001,Tim Corcoran,Detroit Tigers,TIGRS,1,1,1,2,1981,1981,0,-0.31,0.78,1.09,22,31,9,58,104,46,0.0,0.0,0.0,0.0,200000.0,200000.0
corct101,Tommy Corcoran,Brooklyn Dodgers,DOGRS,1,1,3,4,1896,1901,5,7.82,1.26,-6.56,1229,40,-1189,5155,66,-5089,0.0,447.0,447.0,0.0,0.0,0.0
corde001,Erik Cordier,Kansas City Royals,ROYALS,1,1,1,2,2007,2009,2,0.0,-1.12,-1.12,0,288,288,0,824,824,0.0,3.0,3.0,0.0,0.0,0.0
cordf002,Francisco Cordero,Detroit Tigers,TIGRS,1,6,3,9,1999,2004,5,20.76,4.31,-16.45,1380,309,-1071,3548,496,-3052,1196.0,551.0,-645.0,1937500.0,9240000.0,7302500.0
cordf002,Francisco Cordero,Texas Rangers,RNGRS,1,4,2,6,2006,2013,7,2.6,12.97,10.37,354,855,501,502,3435,2933,270.0,0.0,-270.0,7270260.0,8500000.0,1229740.0
cordf002,Francisco Cordero,Toronto Blue Jays,BJAYS,4,12,6,18,2012,2016,4,10.83,2.99,-7.84,1068,309,-759,3494,605,-2889,904.0,1431.0,527.0,11237500.0,12316000.0,1078500.0
cordf003,Franchy Cordero,San Diego Padres,PADRS,1,2,1,3,2020,2020,0,-0.21,-0.04,0.17,21,24,3,42,1,-41,30.0,54.0,24.0,0.0,0.0,0.0
cordf003,Franchy Cordero,Kansas City Royals,ROYALS,1,4,2,6,2021,2021,0,-0.67,2.43,3.1,48,134,86,136,538,402,0.0,0.0,0.0,0.0,0.0,0.0
cordj001,Jimmy Cordero,Toronto Blue Jays,BJAYS,3,6,4,10,2015,2016,1,-0.69,1.54,2.23,124,124,0,375,246,-129,55.0,171.0,116.0,0.0,4100000.0,4100000.0
cordj001,Jimmy Cordero,Philadelphia Phillies,PHILS,1,1,1,2,2016,2016,0,-0.14,0.0,0.14,44,0,-44,0,0,0,57.0,0.0,-57.0,0.0,0.0,0.0
cordr001,Ryan Cordell,Texas Rangers,RNGRS,3,5,4,9,2016,2018,2,3.83,1.66,-2.17,343,178,-165,233,474,241,460.0,162.0,-298.0,7350000.0,0.0,-7350000.0
cordr001,Ryan Cordell,Milwaukee Brewers,BREWRS,1,1,1,2,2017,2017,0,-1.3,0.9,2.2,116,56,-60,287,0,-287,0.0,87.0,87.0,0.0,900000.0,900000.0
cordw001,Wil Cordero,Montreal Expos,NATEX,1,2,3,5,1996,1999,3,2.1,0.16,-1.94,199,370,171,822,693,-129,0.0,483.0,483.0,0.0,0.0,0.0
cordw001,Wil Cordero,Pittsburgh Pirates,PIRATS,3,4,4,8,2000,2003,3,3.54,-2.48,-6.02,691,175,-516,1112,396,-716,777.0,109.0,-668.0,2801667.0,450000.0,-2351667.0
coreb001,Bryan Corey,Texas Rangers,RNGRS,1,1,1,2,2006,2010,4,0.28,-2.25,-2.53,32,34,2,0,2,2,111.0,241.0,130.0,0.0,0.0,0.0
corem001,Mark Corey,Cincinnati Reds,REDS,1,1,1,2,1999,1999,0,-0.3,0.0,0.3,29,0,-29,1,0,-1,35.0,0.0,-35.0,0.0,0.0,0.0
corem001,Mark Corey,New York Mets,METS,2,4,3,7,2002,2002,0,4.04,-0.58,-4.62,267,21,-246,904,25,-879,36.0,163.0,127.0,362500.0,1350000.0,987500.0
corml001,Lance Cormier,Arizona Diamondbacks,DBACKS,8,19,20,39,2005,2018,13,24.88,36.62,11.74,1440,1497,57,1874,2669,795,8219.0,7967.0,-252.0,18358000.0,19450000.0,1092000.0
cormr001,Rheal Cormier,St. Louis Cardinals,CARDS,2,3,3,6,1995,1996,1,1.59,0.67,-0.92,214,226,12,117,434,317,740.0,182.0,-558.0,125000.0,0.0,-125000.0
cormr001,Rheal Cormier,Boston Red Sox,RSOX,2,4,3,7,1996,1997,1,-1.72,2.82,4.54,535,239,-296,705,937,232,864.0,0.0,-864.0,0.0,0.0,0.0
cormr001,Rheal Cormier,Philadelphia Phillies,PHILS,1,1,1,2,2006,2007,1,0.06,0.0,-0.06,54,0,-54,0,0,0,51.0,0.0,-51.0,2500000.0,0.0,-2500000.0
cornj001,Jeff Cornell,Kansas City Royals,ROYALS,1,1,1,2,1982,1982,0,-0.98,0.0,0.98,46,0,-46,4,0,-4,115.0,0.0,-115.0,0.0,0.0,0.0
cornm101,Mardie Cornejo,New York Mets,METS,3,5,3,8,1979,1987,8,3.46,0.88,-2.58,161,240,79,111,73,-38,1165.0,842.0,-323.0,0.0,0.0,0.0
cornr001,Reid Cornelius,Montreal Expos,NATEX,1,1,1,2,1995,1997,2,-0.1,4.43,4.53,20,337,317,20,1419,1399,173.0,0.0,-173.0,0.0,755557.0,755557.0
cornr001,Reid Cornelius,New York Mets,METS,8,17,14,31,1996,2005,9,5.29,6.22,0.93,1355,2056,701,1632,3118,1486,2422.0,2738.0,316.0,19588333.0,14951666.0,-4636667.0
cornr001,Reid Cornelius,Arizona Diamondbacks,DBACKS,1,1,1,2,1998,1998,0,0.99,0.0,-0.99,53,0,-53,47,0,-47,433.0,0.0,-433.0,0.0,0.0,0.0
corpc001,Carlos Corporan,Houston Astros,ASTROS,1,1,1,2,2015,2019,4,-0.51,0.0,0.51,33,0,-33,121,0,-121,0.0,0.0,0.0,0.0,0.0,0.0
corre001,Ed Correa,Chicago White Sox,WSOX,2,6,5,11,1985,1991,6,14.64,2.56,-12.08,1223,446,-777,4038,1366,-2672,817.0,277.0,-540.0,640000.0,879873.0,239873.0
corrf101,Frank Corridon,Chicago Cubs,CUBS,1,1,1,2,1904,1905,1,7.74,0.21,-7.53,277,100,-177,367,403,36,2861.0,0.0,-2861.0,0.0,0.0,0.0
corrf101,Frank Corridon,Philadelphia Phillies,PHILS,1,2,2,4,1910,1914,4,-1.76,8.98,10.74,14,260,246,17,282,265,118.0,2276.0,2158.0,0.0,0.0,0.0
corrf101,Frank Corridon,Cincinnati Reds,REDS,3,9,7,16,1910,1914,4,44.03,8.35,-35.68,2926,785,-2141,11991,2646,-9345,753.0,872.0,119.0,0.0,0.0,0.0
corrk001,Kevin Correia,Minnesota Twins,TWINS,1,1,1,2,2014,2014,0,-1.38,0.0,1.38,18,0,-18,6,0,-6,74.0,0.0,-74.0,5500000.0,0.0,-5500000.0
corrp102,Pat Corrales,Philadelphia Phillies,PHILS,9,17,16,33,1965,1984,19,32.54,23.78,-8.76,2044,2671,627,6114,5833,-281,1729.0,2166.0,437.0,32000.0,138000.0,106000.0
corrp102,Pat Corrales,St. Louis Cardinals,CARDS,4,6,5,11,1968,1971,3,5.07,0.97,-4.1,849,114,-735,2705,290,-2415,0.0,0.0,0.0,0.0,0.0,0.0
corrp102,Pat Corrales,Cincinnati Reds,REDS,1,1,1,2,1972,1973,1,-0.44,0.02,0.46,73,3,-70,214,2,-212,0.0,0.0,0.0,0.0,0.0,0.0
corrr001,Rod Correia,Oakland Athletics,ATLTCS,1,1,1,2,1992,1992,0,-0.45,0.0,0.45,84,0,-84,184,0,-184,0.0,0.0,0.0,0.0,0.0,0.0
corrr101,Red Corriden,Cincinnati Reds,REDS,3,8,5,13,1912,1913,1,9.38,6.71,-2.67,842,270,-572,2287,704,-1583,1567.0,500.0,-1067.0,11280.0,7925.0,-3355.0
corrv101,Vic Correll,Boston Red Sox,RSOX,1,1,1,2,1974,1974,0,-0.68,0.02,0.7,299,2,-297,1000,1,-999,0.0,0.0,0.0,0.0,0.0,0.0
cortd001,David Cortes,Atlanta Braves,BRAVES,1,2,1,3,1998,1998,0,1.03,0.19,-0.84,187,28,-159,2,49,47,290.0,0.0,-290.0,0.0,735000.0,735000.0
cortd001,David Cortes,Colorado Rockies,ROCKS,1,1,1,2,1998,1998,0,-0.03,0.0,0.03,8,0,-8,0,0,0,11.0,0.0,-11.0,0.0,0.0,0.0
cortd002,Dan Cortes,Chicago White Sox,WSOX,1,2,1,3,2006,2009,3,0.0,0.32,0.32,0,103,103,0,0,0,0.0,266.0,266.0,0.0,430000.0,430000.0
cortd002,Dan Cortes,Kansas City Royals,ROYALS,5,11,10,21,2009,2021,12,13.34,47.45,34.11,880,2988,2108,2084,10524,8440,3202.0,2429.0,-773.0,26600000.0,15358267.0,-11241733.0
cortf001,Fernando Cortez,Tampa Bay Devil Rays,RAYS,1,2,1,3,2006,2012,6,0.65,3.83,3.18,266,274,8,855,7,-848,0.0,991.0,991.0,337200.0,0.0,-337200.0
cortn001,Nestor Cortes,New York Yankees,YANKS,1,1,1,2,2019,2019,0,-0.64,0.0,0.64,5,0,-5,0,0,0,23.0,0.0,-23.0,0.0,0.0,0.0
cosaj001,Jarred Cosart,Philadelphia Phillies,PHILS,2,5,5,10,2011,2018,7,10.84,2.57,-8.27,1005,441,-564,3635,1629,-2006,674.0,0.0,-674.0,10400000.0,8200000.0,-2200000.0
cosaj001,Jarred Cosart,Houston Astros,ASTROS,3,8,7,15,2014,2019,5,5.86,22.81,16.95,902,718,-184,1801,1734,-67,1776.0,1238.0,-538.0,2712000.0,500000.0,-2212000.0
cosaj001,Jarred Cosart,Miami Marlins,MARLNS,3,8,6,14,2016,2019,3,12.29,-0.08,-12.37,540,354,-186,600,126,-474,2851.0,1392.0,-1459.0,550000.0,7660200.0,7110200.0
coscj101,Joe Coscarart,Seattle,Seattle,1,1,3,4,1934,1936,2,-1.51,0.0,1.51,190,0,-190,705,0,-705,0.0,0.0,0.0,0.0,0.0,0.0
coscj101,Joe Coscarart,Boston Braves,BRAVES,1,2,1,3,1936,1940,4,0.0,8.2,8.2,0,205,205,0,253,253,0.0,2031.0,2031.0,0.0,0.0,0.0
coscp101,Pete Coscarart,Brooklyn Dodgers,DOGRS,1,4,1,5,1941,1948,7,4.25,10.42,6.17,798,406,-392,2943,1540,-1403,336.0,0.0,-336.0,0.0,0.0,0.0
cosgm101,Mike Cosgrove,Toronto Blue Jays,BJAYS,1,1,1,2,1978,1978,0,0.0,0.0,0.0,0,0,0,0,0,0,0.0,0.0,0.0,0.0,0.0,0.0
cosmj101,Jim Cosman,St. Louis Cardinals,CARDS,2,3,2,5,1968,1969,1,-0.33,0.06,0.39,57,49,-8,101,68,-33,0.0,0.0,0.0,0.0,0.0,0.0
costj001,John Costello,St. Louis Cardinals,CARDS,1,1,1,2,1990,1992,2,-0.22,0.35,0.57,8,251,243,0,558,558,19.0,0.0,-19.0,105000.0,135000.0,30000.0
costj001,John Costello,Montreal Expos,NATEX,1,1,1,2,1990,1990,0,0.08,0.0,-0.08,54,0,-54,2,0,-2,105.0,0.0,-105.0,0.0,0.0,0.0
costm001,Mike Costanzo,Philadelphia Phillies,PHILS,1,3,2,5,2007,2011,4,12.75,0.63,-12.12,681,613,-68,2271,356,-1915,252.0,579.0,327.0,1217500.0,5350000.0,4132500.0
costm001,Mike Costanzo,Houston Astros,ASTROS,1,5,1,6,2007,2009,2,11.62,3.81,-7.81,860,316,-544,1797,1340,-457,1330.0,0.0,-1330.0,382000.0,13811415.0,13429415.0
costt001,Tim Costo,Cleveland Indians,INDINS,2,4,2,6,1991,2004,13,-0.89,29.66,30.55,280,1641,1361,957,7141,6184,0.0,0.0,0.0,1117500.0,1212500.0,95000.0
costt001,Tim Costo,Cincinnati Reds,REDS,4,6,5,11,1994,1998,4,1.13,0.5,-0.63,524,257,-267,786,677,-109,1638.0,269.0,-1369.0,299000.0,2483167.0,2184167.0
cotah001,Humberto Cota,Tampa Bay Devil Rays,RAYS,1,2,2,4,1999,2001,2,-1.06,1.13,2.19,241,216,-25,708,680,-28,0.0,91.0,91.0,0.0,375000.0,375000.0
cothc001,Caleb Cotham,New York Yankees,YANKS,4,8,7,15,2015,2020,5,-1.49,8.03,9.52,440,197,-243,1007,8,-999,290.0,1270.0,980.0,3936900.0,21050000.0,17113100.0
cottc101,Chuck Cottier,Milwaukee Braves,BRAVES,1,4,2,6,1960,1966,6,17.87,5.81,-12.06,1212,765,-447,3111,2935,-176,1033.0,0.0,-1033.0,0.0,0.0,0.0
cottc101,Chuck Cottier,Detroit Tigers,TIGRS,1,1,1,2,1961,1961,0,0.48,-0.79,-1.27,430,24,-406,1410,5,-1405,0.0,55.0,55.0,0.0,0.0,0.0
cottc101,Chuck Cottier,Seattle Pilots,BREWRS,1,2,1,3,1968,1968,0,0.0,0.0,0.0,0,0,0,0,0,0,0.0,0.0,0.0,0.0,0.0,0.0
cottd101,Dick Cotter,Philadelphia Phillies,PHILS,1,2,1,3,1912,1912,0,-0.17,-0.4,-0.23,26,24,-2,61,67,6,0.0,0.0,0.0,0.0,0.0,0.0
cotth001,Henry Cotto,Chicago Cubs,CUBS,2,7,4,11,1984,1987,3,2.88,0.38,-2.5,447,379,-68,818,354,-464,766.0,789.0,23.0,873333.0,878000.0,4667.0
cotth001,Henry Cotto,New York Yankees,YANKS,3,5,5,10,1987,1994,7,0.83,10.26,9.43,742,738,-4,1734,1510,-224,631.0,1551.0,920.0,2400000.0,2999167.0,599167.0
cotth001,Henry Cotto,Seattle Mariners,MARNRS,3,4,4,8,1993,1995,2,2.56,0.14,-2.42,232,106,-126,671,357,-314,133.0,12.0,-121.0,900000.0,1100000.0,200000.0
cottj001,Jharel Cotton,Los Angeles Dodgers,DOGRS,1,3,2,5,2016,2019,3,5.79,5.89,0.1,131,179,48,13,293,280,1774.0,1084.0,-690.0,0.0,0.0,0.0
cottn001,Neal Cotts,Oakland Athletics,ATLTCS,2,6,5,11,2002,2003,1,15.18,3.47,-11.71,801,134,-667,480,219,-261,4974.0,260.0,-4714.0,2433333.0,4320000.0,1886667.0
cottn001,Neal Cotts,Chicago White Sox,WSOX,2,2,4,6,2006,2011,5,-0.16,-0.4,-0.24,216,27,-189,2,0,-2,336.0,97.0,-239.0,400000.0,0.0,-400000.0
cottn001,Neal Cotts,Milwaukee Brewers,BREWRS,1,1,1,2,2015,2015,0,-0.08,0.0,0.08,18,0,-18,0,0,0,41.0,0.0,-41.0,3000000.0,0.0,-3000000.0
cougm101,Marlan Coughtry,Los Angeles Angels,ANGELS,1,1,1,2,1962,1962,0,0.19,-0.07,-0.26,6,40,34,16,51,35,0.0,0.0,0.0,0.0,0.0,0.0
coulc101,Chip Coulter,St. Louis Cardinals,CARDS,9,16,14,30,1971,1976,5,14.55,3.01,-11.54,1564,430,-1134,3017,530,-2487,3834.0,1012.0,-2822.0,0.0,0.0,0.0
coumf101,Fritz Coumbe,Boston Red Sox,RSOX,23,51,62,113,1914,1937,23,210.47,131.21,-79.26,10024,6525,-3499,28339,20821,-7518,29017.0,15462.0,-13555.0,136800.0,133950.0,-2850.0
coumf101,Fritz Coumbe,Cleveland Indians,INDINS,2,4,3,7,1920,1922,2,0.0,4.94,4.94,0,176,176,0,151,151,0.0,1214.0,1214.0,0.0,0.0,0.0
counc001,Craig Counsell,Colorado Rockies,ROCKS,2,2,2,4,1997,1999,2,2.24,-0.51,-2.75,215,135,-80,663,189,-474,51.0,38.0,-13.0,0.0,205000.0,205000.0
counc001,Craig Counsell,Florida Marlins,MARLNS,1,1,1,2,1999,1999,0,0.34,0.0,-0.34,50,0,-50,122,0,-122,0.0,0.0,0.0,245000.0,0.0,-245000.0
counc001,Craig Counsell,Arizona Diamondbacks,DBACKS,1,6,3,9,2003,2005,2,15.82,-0.12,-15.94,1881,61,-1820,5048,104,-4944,2593.0,37.0,-2556.0,3548667.0,5425000.0,1876333.0
courc101,Clint Courtney,New York Yankees,YANKS,13,34,28,62,1951,1970,19,44.17,77.56,33.39,5653,4508,-1145,17995,10870,-7125,3212.0,11561.0,8349.0,302500.0,109500.0,-193000.0
courc101,Clint Courtney,Baltimore Orioles,ORLS,4,7,9,16,1954,1960,6,15.05,10.88,-4.17,745,881,136,1673,2506,833,2291.0,1208.0,-1083.0,0.0,0.0,0.0
courc101,Clint Courtney,Chicago White Sox,WSOX,17,31,30,61,1955,1969,14,22.96,44.36,21.4,3375,3578,203,7415,6981,-434,5139.0,7668.0,2529.0,156750.0,157500.0,750.0
courc101,Clint Courtney,Washington Senators,TWINS,2,3,2,5,1960,1962,2,0.48,0.05,-0.43,150,222,72,361,823,462,0.0,80.0,80.0,0.0,0.0,0.0
courc101,Clint Courtney,Baltimore Orioles,ORLS,4,11,7,18,1961,1973,12,20.55,30.35,9.8,1602,1797,195,5528,6131,603,845.0,306.0,-539.0,72000.0,40300.0,-31700.0
coure101,Ernie Courtney,New York Yankees,YANKS,1,2,1,3,1903,1909,6,0.01,19.09,19.08,92,667,575,343,2757,2414,0.0,0.0,0.0,0.0,0.0,0.0
coure101,Ernie Courtney,Detroit Tigers,TIGRS,1,4,2,6,1903,1911,8,0.0,16.79,16.79,0,801,801,0,3453,3453,0.0,39.0,39.0,0.0,0.0,0.0
courj001,John Courtright,Cincinnati Reds,REDS,6,12,8,20,1995,2010,15,11.19,26.95,15.76,438,1436,998,728,5040,4312,2595.0,2089.0,-506.0,13266667.0,6712778.0,-6553889.0
coutj001,Jon Coutlangus,Cincinnati Reds,REDS,1,1,1,2,2008,2008,0,0.0,0.0,0.0,0,0,0,0,0,0,0.0,0.0,0.0,0.0,0.0,0.0
coveh101,Harry Coveleski,Philadelphia Phillies,PHILS,1,2,2,4,1910,1914,4,-1.76,8.98,10.74,14,260,246,17,282,265,118.0,2276.0,2158.0,0.0,0.0,0.0
coves101,Stan Coveleski,Cleveland Indians,INDINS,1,1,2,3,1924,1926,2,9.07,1.24,-7.83,146,60,-86,190,31,-159,1502.0,281.0,-1221.0,7500.0,2100.0,-5400.0
covit101,Tex Covington,Boston Braves,BRAVES,1,2,1,3,1918,1924,6,0.0,6.61,6.61,0,377,377,0,384,384,0.0,3083.0,3083.0,0.0,0.0,0.0
coviw101,Wes Covington,Chicago White Sox,WSOX,11,17,21,38,1961,1969,8,15.81,27.33,11.52,1761,2250,489,3197,3489,292,3384.0,5251.0,1867.0,77750.0,58000.0,-19750.0
coviw101,Wes Covington,Kansas City Athletics,ATLTCS,1,1,1,2,1961,1964,3,4.13,1.74,-2.39,522,327,-195,1544,1037,-507,0.0,0.0,0.0,0.0,0.0,0.0
coviw101,Wes Covington,Philadelphia Phillies,PHILS,1,1,1,2,1966,1966,0,-0.19,0.56,0.75,9,79,70,12,139,127,0.0,0.0,0.0,0.0,0.0,0.0
cowab101,Billy Cowan,Chicago Cubs,CUBS,1,1,1,2,1965,1965,0,-0.74,-0.18,0.56,82,90,8,162,216,54,0.0,0.0,0.0,0.0,0.0,0.0
cowab101,Billy Cowan,New York Mets,METS,3,5,4,9,1965,1968,3,-1.53,0.0,1.53,303,5,-298,741,5,-736,0.0,0.0,0.0,11000.0,0.0,-11000.0
cowab101,Billy Cowan,Atlanta Braves,BRAVES,3,3,7,10,1966,1971,5,0.93,0.07,-0.86,220,226,6,719,711,-8,0.0,0.0,0.0,0.0,6000.0,6000.0
cowab101,Billy Cowan,Chicago Cubs,CUBS,1,1,1,2,1966,1966,0,-0.17,0.0,0.17,34,0,-34,66,0,-66,0.0,0.0,0.0,0.0,0.0,0.0
cowea001,Al Cowens,Kansas City Royals,ROYALS,3,5,4,9,1979,1986,7,14.42,8.44,-5.98,1272,909,-363,3936,3256,-680,0.0,0.0,0.0,0.0,250000.0,250000.0
cowea001,Al Cowens,California Angels,ANGELS,2,2,3,5,1980,1983,3,11.24,4.47,-6.77,864,189,-675,3432,669,-2763,0.0,43.0,43.0,0.0,0.0,0.0
cowgc001,Collin Cowgill,Arizona Diamondbacks,DBACKS,6,12,12,24,2011,2021,10,55.85,12.58,-43.27,1986,909,-1077,2819,1176,-1643,7668.0,4077.0,-3591.0,13397833.0,3419900.0,-9977933.0
cowgc001,Collin Cowgill,Oakland Athletics,ATLTCS,1,1,1,2,2012,2014,2,-0.46,0.0,0.46,23,0,-23,63,0,-63,0.0,0.0,0.0,482500.0,0.0,-482500.0
cowgc001,Collin Cowgill,New York Mets,METS,1,1,1,2,2013,2013,0,2.7,0.0,-2.7,211,0,-211,466,0,-466,0.0,0.0,0.0,493520.0,0.0,-493520.0
cowlj001,Joe Cowley,New York Yankees,YANKS,6,14,14,28,1985,1995,10,3.51,16.99,13.48,797,1920,1123,2241,6176,3935,1174.0,66.0,-1108.0,945873.0,1202500.0,256627.0
cowlj001,Joe Cowley,Chicago White Sox,WSOX,2,3,2,5,1987,1988,1,3.17,2.88,-0.29,408,247,-161,1164,1016,-148,35.0,0.0,-35.0,460000.0,172500.0,-287500.0
cox-b101,Billy Cox,Pittsburgh Pirates,PIRATS,1,3,3,6,1947,1950,3,26.56,1.84,-24.72,1156,287,-869,3340,710,-2630,3832.0,295.0,-3537.0,0.0,0.0,0.0
cox-b101,Billy Cox,Brooklyn Dodgers,DOGRS,1,2,3,5,1954,1954,0,0.54,0.0,-0.54,53,0,-53,213,0,-213,0.0,0.0,0.0,19000.0,0.0,-19000.0
cox-b101,Billy Cox,Baltimore Orioles,ORLS,2,3,3,6,1955,1956,1,5.21,-0.32,-5.53,337,154,-183,1279,434,-845,0.0,0.0,0.0,0.0,0.0,0.0
cox-b102,Bill Cox,Chicago White Sox,WSOX,2,2,2,4,1938,1947,9,-2.43,6.39,8.82,179,330,151,132,908,776,1157.0,1317.0,160.0,11300.0,10000.0,-1300.0
cox-b103,Bobby Cox,Chicago Cubs,CUBS,2,3,2,5,1966,1966,0,-0.17,0.0,0.17,34,0,-34,66,0,-66,0.0,0.0,0.0,0.0,0.0,0.0
cox-b103,Bobby Cox,Atlanta Braves,BRAVES,2,2,5,7,1967,1971,4,0.93,0.07,-0.86,220,226,6,719,711,-8,0.0,0.0,0.0,0.0,6000.0,6000.0
cox-c101,Casey Cox,Texas Rangers,RNGRS,1,1,1,2,1972,1972,0,-0.07,-0.11,-0.04,11,10,-1,1,0,-1,44.0,10.0,-34.0,22500.0,0.0,-22500.0
cox-d002,Darron Cox,Cincinnati Reds,REDS,2,4,2,6,1993,1996,3,1.51,1.69,0.18,53,302,249,0,11,11,157.0,464.0,307.0,817000.0,2412500.0,1595500.0
cox-d101,Dick Cox,Portland,Portland,1,1,1,2,1924,1924,0,2.99,0.0,-2.99,246,0,-246,937,0,-937,0.0,0.0,0.0,0.0,4500.0,4500.0
cox-j101,Jeff Cox,Oakland Athletics,ATLTCS,1,2,3,5,1982,1982,0,0.0,-0.02,-0.02,0,8,8,0,20,20,0.0,0.0,0.0,0.0,0.0,0.0
cox-l101,Larry Cox,Philadelphia Phillies,PHILS,2,2,2,4,1975,1977,2,0.0,0.0,0.0,0,0,0,0,0,0,0.0,0.0,0.0,0.0,0.0,0.0
cox-l101,Larry Cox,Seattle Mariners,MARNRS,2,2,2,4,1977,1978,1,0.54,0.0,-0.54,61,0,-61,139,0,-139,0.0,0.0,0.0,0.0,0.0,0.0
cox-l101,Larry Cox,Chicago Cubs,CUBS,1,1,1,2,1979,1979,0,-0.17,0.0,0.17,205,0,-205,595,0,-595,0.0,0.0,0.0,0.0,0.0,0.0
cox-l101,Larry Cox,Seattle Mariners,MARNRS,2,7,7,14,1980,1985,5,8.79,3.61,-5.18,489,434,-55,632,1358,726,2623.0,1017.0,-1606.0,175000.0,512500.0,337500.0
cox-t101,Ted Cox,Boston Red Sox,RSOX,2,6,3,9,1978,1987,9,14.86,20.93,6.07,699,715,16,1362,2220,858,3997.0,3996.0,-1.0,0.0,0.0,0.0
cox-t101,Ted Cox,Cleveland Indians,INDINS,6,11,13,24,1979,2004,25,34.83,53.01,18.18,1613,2520,907,5923,9198,3275,2682.0,3776.0,1094.0,1767500.0,1412500.0,-355000.0
cozac101,Charlie Cozart,Boston Braves,BRAVES,5,9,7,16,1945,1952,7,-0.23,24.05,24.28,358,893,535,547,3244,2697,596.0,423.0,-173.0,0.0,0.0,0.0
cozaz001,Zack Cozart,Anaheim Angels,ANGELS,1,2,2,4,2019,2019,0,0.0,0.0,0.0,0,0,0,0,0,0,0.0,0.0,0.0,12666667.0,0.0,-12666667.0
crabe101,Estel Crabtree,Cincinnati Reds,REDS,2,3,2,5,1932,1936,4,1.3,1.6,0.3,315,394,79,966,1624,658,0.0,0.0,0.0,0.0,0.0,0.0
crabt001,Tim Crabtree,Toronto Blue Jays,BJAYS,2,2,2,4,1998,2000,2,2.83,0.48,-2.35,256,54,-202,65,137,72,762.0,0.0,-762.0,0.0,0.0,0.0
cradw101,Walt Craddock,Kansas City Athletics,ATLTCS,2,3,2,5,1959,1960,1,0.38,0.95,0.57,208,110,-98,47,6,-41,663.0,207.0,-456.0,0.0,0.0,0.0
crafh101,Harry Craft,Cincinnati Reds,REDS,1,2,1,3,1942,1946,4,0.0,8.15,8.15,0,451,451,0,1756,1756,0.0,0.0,0.0,0.0,0.0,0.0
crafm101,Molly Craft,Washington Senators,TWINS,3,6,4,10,1920,1933,13,2.2,13.36,11.16,219,847,628,852,3211,2359,0.0,616.0,616.0,2000.0,0.0,-2000.0
cragh101,Howard Craghead,Oakland,Oakland,1,1,1,2,1931,1931,0,-0.09,0.0,0.09,30,0,-30,3,0,-3,69.0,0.0,-69.0,0.0,0.0,0.0
cragh101,Howard Craghead,Brooklyn Dodgers,DOGRS,1,1,1,2,1934,1934,0,0.0,-0.05,-0.05,0,12,12,0,1,1,0.0,30.0,30.0,0.0,0.0,0.0
craia001,Allen Craig,St. Louis Cardinals,CARDS,1,2,3,5,2014,2015,1,1.43,5.3,3.87,264,83,-181,204,89,-115,1078.0,836.0,-242.0,0.0,0.0,0.0
crair001,Rod Craig,Seattle Mariners,MARNRS,1,1,1,2,1981,1981,0,-0.52,0.0,0.52,49,0,-49,71,0,-71,0.0,0.0,0.0,0.0,0.0,0.0
crair101,Roger Craig,New York Mets,METS,5,7,7,14,1963,1968,5,-1.04,-0.58,0.46,574,211,-363,1232,612,-620,498.0,0.0,-498.0,11000.0,0.0,-11000.0
crair101,Roger Craig,St. Louis Cardinals,CARDS,1,2,1,3,1964,1966,2,-0.38,-2.37,-1.99,106,64,-42,54,43,-11,193.0,373.0,180.0,0.0,0.0,0.0
cramd102,Doc Cramer,Philadelphia Athletics,ATLTCS,1,2,3,5,1936,1936,0,2.69,-1.63,-4.32,1023,75,-948,4530,240,-4290,12.0,35.0,23.0,0.0,0.0,0.0
cramd102,Doc Cramer,Boston Red Sox,RSOX,5,13,12,25,1940,1956,16,20.2,30.94,10.74,2442,1730,-712,7673,4243,-3430,4828.0,6235.0,1407.0,136500.0,65122.0,-71378.0
cramd102,Doc Cramer,Washington Senators,TWINS,3,5,4,9,1941,1946,5,3.39,-0.33,-3.72,1062,197,-865,4332,521,-3811,0.0,315.0,315.0,17000.0,10000.0,-7000.0
cramg101,Jerry Cram,Kansas City Royals,ROYALS,2,3,2,5,1973,1975,2,0.3,0.06,-0.24,41,220,179,3,772,769,132.0,15.0,-117.0,0.0,0.0,0.0
cramg101,Jerry Cram,New York Mets,METS,1,1,1,2,1976,1976,0,-0.04,0.0,0.04,4,0,-4,0,0,0,13.0,0.0,-13.0,0.0,0.0,0.0
crand101,Doc Crandall,New York Giants,GIANTS,1,1,1,2,1913,1913,0,0.0,0.07,0.07,2,30,28,2,79,77,0.0,0.0,0.0,3300.0,0.0,-3300.0
crand102,Del Crandall,Milwaukee Braves,BRAVES,10,14,18,32,1963,1973,10,11.77,26.43,14.66,1218,1711,493,2811,4870,2059,2257.0,2054.0,-203.0,95000.0,38000.0,-57000.0
crand102,Del Crandall,San Francisco Giants,GIANTS,4,5,5,10,1965,1972,7,-1.79,6.98,8.77,417,676,259,885,653,-232,457.0,3174.0,2717.0,17000.0,24000.0,7000.0
crans102,Sam Crane,Baltimore,Baltimore,2,2,6,8,1917,1926,9,0.62,0.0,-0.62,475,0,-475,1668,0,-1668,0.0,0.0,0.0,0.0,0.0,0.0
cravg101,Gavvy Cravath,Chicago White Sox,WSOX,1,3,1,4,1909,1910,1,-0.91,1.19,2.1,140,48,-92,366,63,-303,237.0,502.0,265.0,2400.0,3500.0,1100.0
crawc002,Carl Crawford,Boston Red Sox,RSOX,7,22,14,36,2012,2019,7,37.54,19.18,-18.36,2738,1439,-1299,4768,4566,-202,4720.0,1908.0,-2812.0,4708000.0,16585000.0,11877000.0
crawg101,Glenn Crawford,St. Louis Cardinals,CARDS,1,2,1,3,1945,1947,2,0.82,2.98,2.16,208,221,13,883,855,-28,0.0,0.0,0.0,0.0,0.0,0.0
crawj002,J.P. Crawford,Philadelphia Phillies,PHILS,2,3,4,7,2018,2019,1,7.13,-0.08,-7.21,336,92,-244,1315,2,-1313,47.0,142.0,95.0,18878833.0,17350000.0,-1528833.0
crawj101,Jake Crawford,St.Louis Browns,ORLS,1,1,3,4,1952,1953,1,0.0,-0.5,-0.5,0,57,57,0,111,111,0.0,0.0,0.0,0.0,10000.0,10000.0
crawj102,Jim Crawford,Houston Astros,ASTROS,6,11,9,20,1975,1989,14,10.73,12.05,1.32,1452,1687,235,3403,4505,1102,3386.0,1859.0,-1527.0,22500.0,16500.0,-6000.0
crawp101,Pat Crawford,New York Giants,GIANTS,4,12,8,20,1930,1949,19,15.74,55.73,39.99,1379,2796,1417,3945,10503,6558,2269.0,334.0,-1935.0,0.0,22000.0,22000.0
crawp101,Pat Crawford,Cincinnati Reds,REDS,3,7,3,10,1930,1932,2,-0.61,5.83,6.44,32,321,289,78,1329,1251,9.0,0.0,-9.0,5500.0,0.0,-5500.0
craww101,Willie Crawford,Los Angeles Dodgers,DOGRS,2,2,3,5,1976,1980,4,3.14,0.58,-2.56,380,210,-170,1405,594,-811,0.0,0.0,0.0,0.0,0.0,0.0
craww101,Willie Crawford,St. Louis Cardinals,CARDS,17,40,34,74,1976,1994,18,91.08,139.58,48.5,8485,6698,-1787,23608,22939,-669,10540.0,4019.0,-6521.0,3088333.0,809167.0,-2279166.0
craww101,Willie Crawford,San Francisco Giants,GIANTS,1,2,2,4,1977,1979,2,-0.16,-0.23,-0.07,100,281,181,275,873,598,0.0,0.0,0.0,0.0,0.0,0.0
craww101,Willie Crawford,Houston Astros,ASTROS,2,2,3,5,1977,1989,12,-2.01,11.63,13.64,225,1155,930,447,2964,2517,0.0,408.0,408.0,705000.0,400000.0,-305000.0
creeb101,Birdie Cree,Baltimore,Baltimore,1,1,2,3,1914,1914,0,3.24,0.0,-3.24,151,0,-151,567,0,-567,0.0,0.0,0.0,0.0,0.0,0.0
creed001,Doug Creek,St. Louis Cardinals,CARDS,6,11,12,23,1995,2004,9,7.92,19.88,11.96,1477,1521,44,4061,3047,-1014,1672.0,2465.0,793.0,14938333.0,17095281.0,2156948.0
creek001,Keith Creel,Kansas City Royals,ROYALS,1,1,1,2,1985,1988,3,0.31,-0.07,-0.38,15,4,-11,0,2,2,186.0,0.0,-186.0,0.0,0.0,0.0
cresc001,Cesar Crespo,New York Mets,METS,3,6,4,10,1998,2002,4,4.04,-0.58,-4.62,267,21,-246,904,25,-879,36.0,163.0,127.0,362500.0,1350000.0,987500.0
cresc001,Cesar Crespo,Florida Marlins,MARLNS,8,11,19,30,2001,2013,12,78.22,23.68,-54.54,3802,1869,-1933,11801,2165,-9636,3483.0,6395.0,2912.0,18420219.0,799800.0,-17620419.0
cresc001,Cesar Crespo,San Diego Padres,PADRS,1,1,1,2,2002,2007,5,-0.39,0.0,0.39,52,0,-52,79,0,-79,0.0,0.0,0.0,0.0,0.0,0.0
cresf001,Felipe Crespo,San Francisco Giants,GIANTS,1,1,1,2,2001,2001,0,-0.27,-0.56,-0.29,33,26,-7,47,0,-47,0.0,45.0,45.0,425000.0,925000.0,500000.0
crewt001,Tim Crews,Milwaukee Brewers,BREWRS,1,2,1,3,1986,1991,5,9.4,4.13,-5.27,749,517,-232,173,1958,1785,2632.0,0.0,-2632.0,90000.0,325000.0,235000.0
crick001,Kyle Crick,San Francisco Giants,GIANTS,3,8,5,13,2018,2020,2,12.26,2.28,-9.98,738,296,-442,1562,1215,-347,600.0,0.0,-600.0,14750000.0,0.0,-14750000.0
crics001,Stefan Crichton,Baltimore Orioles,ORLS,1,1,1,2,2018,2018,0,0.6,0.0,-0.6,143,0,-143,0,0,0,239.0,0.0,-239.0,0.0,0.0,0.0
cridj101,Jerry Crider,Minnesota Twins,TWINS,1,1,1,2,1969,1970,1,0.19,0.0,-0.19,64,0,-64,26,0,-26,273.0,0.0,-273.0,0.0,0.0,0.0
crigl101,Lou Criger,Boston Red Sox,RSOX,1,1,2,3,1908,1908,0,0.74,0.0,-0.74,75,0,-75,254,0,-254,0.0,0.0,0.0,0.0,0.0,0.0
crigl101,Lou Criger,St.Louis Browns,ORLS,1,1,2,3,1909,1914,5,-0.17,4.1,4.27,27,164,137,82,228,146,0.0,1597.0,1597.0,0.0,0.0,0.0
crimc001,Chuck Crim,Milwaukee Brewers,BREWRS,3,6,5,11,1991,2001,10,-0.34,7.28,7.62,339,916,577,839,2349,1510,388.0,1418.0,1030.0,9763333.0,4970000.0,-4793333.0
crimj101,Jack Crimian,St. Louis Cardinals,CARDS,3,5,3,8,1953,1957,4,0.94,3.21,2.27,322,305,-17,645,897,252,0.0,0.0,0.0,0.0,0.0,0.0
crimj101,Jack Crimian,Toronto,Toronto,1,1,2,3,1955,1956,1,-0.36,0.0,0.36,109,0,-109,30,0,-30,383.0,0.0,-383.0,0.0,0.0,0.0
crimj101,Jack Crimian,Kansas City Athletics,ATLTCS,40,86,88,174,1956,1976,20,134.11,73.29,-60.82,13270,9412,-3858,30102,25264,-4838,19786.0,12575.0,-7211.0,506100.0,652200.0,146100.0
crisc001,Coco Crisp,St. Louis Cardinals,CARDS,1,2,1,3,2002,2002,0,9.03,0.46,-8.57,435,28,-407,1848,33,-1815,0.0,256.0,256.0,0.0,7911948.0,7911948.0
crisc001,Coco Crisp,Cleveland Indians,INDINS,2,4,6,10,2006,2011,5,6.08,6.32,0.24,533,659,126,1913,1893,-20,29.0,785.0,756.0,1950000.0,0.0,-1950000.0
crisc001,Coco Crisp,Boston Red Sox,RSOX,3,3,3,6,2008,2011,3,2.63,2.03,-0.6,242,122,-120,216,1,-215,304.0,336.0,32.0,6238333.0,397000.0,-5841333.0
crisc001,Coco Crisp,Oakland Athletics,ATLTCS,1,2,1,3,2016,2016,0,0.12,0.0,-0.12,20,0,-20,64,0,-64,0.0,0.0,0.0,0.0,0.0,0.0
crisd102,Dave Criscione,Texas Rangers,RNGRS,2,2,2,4,1976,1983,7,0.06,0.27,0.21,7,39,32,10,0,-10,0.0,172.0,172.0,0.0,0.0,0.0
crisl101,Leo Cristante,Chicago White Sox,WSOX,3,8,6,14,1954,1961,7,23.22,8.09,-15.13,1221,1065,-156,3572,3021,-551,2246.0,488.0,-1758.0,62000.0,80000.0,18000.0
crisl101,Leo Cristante,Detroit Tigers,TIGRS,4,7,7,14,1955,1964,9,0.54,14.97,14.43,185,396,211,295,399,104,451.0,2991.0,2540.0,0.0,0.0,0.0
crisp101,Pat Crisham,Brooklyn Dodgers,DOGRS,2,4,2,6,1899,1902,3,3.35,2.49,-0.86,192,219,27,742,830,88,0.0,0.0,0.0,0.0,0.0,0.0
crith101,Hughie Critz,Cincinnati Reds,REDS,1,1,1,2,1930,1935,5,4.07,2.73,-1.34,676,316,-360,2985,266,-2719,0.0,2226.0,2226.0,16000.0,0.0,-16000.0
cronc002,C.J. Cron,Anaheim Angels,ANGELS,1,1,1,2,2018,2018,0,2.33,0.0,-2.33,140,0,-140,560,0,-560,0.0,0.0,0.0,0.0,0.0,0.0
cronj001,Jake Cronenworth,Tampa Bay Devil Rays,RAYS,1,2,3,5,2019,2020,1,7.81,-0.02,-7.83,393,42,-351,1521,139,-1382,2.0,0.0,-2.0,4100000.0,582100.0,-3517900.0
cronj101,Joe Cronin,Washington Senators,TWINS,2,2,3,5,1934,1937,3,31.56,-0.69,-32.25,1409,59,-1350,5830,180,-5650,0.0,0.0,0.0,30000.0,3500.0,-26500.0
cronj102,Jack Cronin,New York Giants,GIANTS,5,14,7,21,1903,1921,18,51.29,48.92,-2.37,2751,2179,-572,9350,7604,-1746,2651.0,2915.0,264.0,6400.0,5200.0,-1200.0
cronj103,Jim Cronin,Philadelphia Athletics,ATLTCS,1,4,2,6,1929,1936,7,0.0,5.27,5.27,0,394,394,0,395,395,0.0,2946.0,2946.0,7500.0,0.0,-7500.0
cronj103,Jim Cronin,Portland,Portland,1,1,2,3,1929,1930,1,0.04,0.0,-0.04,25,0,-25,63,0,-63,0.0,0.0,0.0,0.0,0.0,0.0
cronr101,Ray Crone,Milwaukee Braves,BRAVES,1,3,1,4,1957,1960,3,3.25,5.66,2.41,395,272,-123,1122,1140,18,434.0,0.0,-434.0,0.0,42000.0,42000.0
cronr101,Ray Crone,San Francisco Giants,GIANTS,1,1,1,2,1958,1958,0,0.0,-0.49,-0.49,0,34,34,0,3,3,0.0,69.0,69.0,0.0,0.0,0.0
crooj101,Jack Crooks,Washington Senators,WSN,1,3,1,4,1896,1897,1,-1.24,0.18,1.42,153,159,6,636,662,26,0.0,0.0,0.0,0.0,0.0,0.0
crosb001,Bubba Crosby,Los Angeles Dodgers,DOGRS,1,2,1,3,2003,2004,1,0.65,0.19,-0.46,406,152,-254,260,302,42,712.0,3.0,-709.0,0.0,5000000.0,5000000.0
crosb002,Bobby Crosby,Pittsburgh Pirates,PIRATS,1,3,3,6,2010,2011,1,-0.12,0.71,0.83,82,105,23,69,301,232,68.0,0.0,-68.0,3450000.0,5250000.0,1800000.0
crose101,Ed Crosby,St. Louis Cardinals,CARDS,1,2,2,4,1973,1974,1,0.19,0.24,0.05,36,16,-20,60,0,-60,0.0,24.0,24.0,0.0,16000.0,16000.0
crose101,Ed Crosby,St. Louis Cardinals,CARDS,5,7,6,13,1974,1977,3,-2.01,-0.59,1.42,565,81,-484,1331,100,-1231,66.0,23.0,-43.0,0.0,0.0,0.0
crosf103,Frankie Crosetti,SanFrancisco,SanFrancisco,1,1,2,3,1930,1931,1,24.49,0.0,-24.49,1683,0,-1683,7268,0,-7268,0.0,0.0,0.0,0.0,0.0,0.0
crosk101,Ken Crosby,New York Yankees,YANKS,1,2,1,3,1973,1974,1,0.0,0.04,0.04,0,7,7,0,0,0,0.0,46.0,46.0,0.0,47500.0,47500.0
crosk101,Ken Crosby,St. Louis Cardinals,CARDS,2,2,2,4,1975,1977,2,3.7,-0.38,-4.08,206,52,-154,136,5,-131,1203.0,111.0,-1092.0,0.0,0.0,0.0
crosl101,Lave Cross,Philadelphia Phillies,PHILS,1,5,3,8,1897,1902,5,9.88,14.87,4.99,647,845,198,2475,2785,310,1192.0,3296.0,2104.0,0.0,0.0,0.0
crosm101,Monte Cross,Pittsburgh Pirates,PIRATS,1,3,1,4,1896,1901,5,1.66,8.07,6.41,433,743,310,1375,3049,1674,1892.0,0.0,-1892.0,0.0,0.0,0.0
crosm101,Monte Cross,St. Louis Cardinals,CARDS,2,4,7,11,1897,1899,2,17.28,9.65,-7.63,1436,631,-805,5066,2410,-2656,3837.0,1192.0,-2645.0,0.0,0.0,0.0
croub101,Buck Crouse,Muskegon,Muskegon,1,1,1,2,1923,1923,0,3.5,0.0,-3.5,470,0,-470,1469,0,-1469,0.0,0.0,0.0,0.0,1950.0,1950.0
croub103,Bill Crouch,Brooklyn Dodgers,DOGRS,2,9,3,12,1940,1947,7,2.8,7.69,4.89,657,371,-286,1221,447,-774,1499.0,2793.0,1294.0,17500.0,0.0,-17500.0
crouf101,Frank Croucher,Detroit Tigers,TIGRS,1,2,2,4,1941,1948,7,0.26,3.39,3.13,148,1062,914,484,4332,3848,0.0,0.0,0.0,10000.0,17000.0,7000.0
crouf101,Frank Croucher,Washington Senators,TWINS,2,3,2,5,1942,1943,1,0.0,-0.59,-0.59,0,49,49,0,37,37,0.0,315.0,315.0,0.0,0.0,0.0
crouh001,Hans Crouse,Texas Rangers,RNGRS,1,4,3,7,2021,2021,0,0.8,-1.21,-2.01,74,9,-65,29,0,-29,300.0,64.0,-236.0,9766666.0,0.0,-9766666.0
crouj101,Jack Crouch,St.Louis Browns,ORLS,6,8,9,17,1933,1947,14,4.89,14.56,9.67,718,1651,933,2367,5208,2841,122.0,1515.0,1393.0,19500.0,20750.0,1250.0
crouj101,Jack Crouch,St.Louis Browns,ORLS,1,1,1,2,1931,1931,0,0.0,-0.51,-0.51,0,40,40,0,144,144,0.0,0.0,0.0,0.0,0.0,0.0
crour001,Rich Croushore,St. Louis Cardinals,CARDS,2,6,4,10,1999,2003,4,3.2,2.78,-0.42,870,638,-232,626,106,-520,1171.0,1638.0,467.0,860000.0,10709647.0,9849647.0
crour001,Rich Croushore,Colorado Rockies,ROCKS,7,13,12,25,2000,2002,2,6.04,1.37,-4.67,876,433,-443,660,150,-510,2239.0,928.0,-1311.0,9375000.0,6575000.0,-2800000.0
crour001,Rich Croushore,Boston Red Sox,RSOX,1,1,1,2,2001,2001,0,0.0,0.0,0.0,0,0,0,0,0,0,0.0,0.0,0.0,0.0,0.0,0.0
crowa001,Aaron Crow,Kansas City Royals,ROYALS,1,1,2,3,2014,2019,5,0.0,1.69,1.69,0,103,103,0,1,1,0.0,488.0,488.0,1475000.0,0.0,-1475000.0
crowd001,Dean Crow,Seattle Mariners,MARNRS,1,3,2,5,1997,1998,1,0.42,-0.64,-1.06,53,29,-24,0,2,2,389.0,290.0,-99.0,1300000.0,1410000.0,110000.0
crowd001,Dean Crow,Detroit Tigers,TIGRS,3,10,6,16,1999,2002,3,3.62,7.62,4.0,1493,652,-841,3797,1742,-2055,861.0,1164.0,303.0,6750000.0,3640000.0,-3110000.0
crowg101,George Crowe,Milwaukee Braves,BRAVES,1,1,2,3,1956,1958,2,2.52,1.6,-0.92,321,61,-260,1082,221,-861,0.0,0.0,0.0,0.0,0.0,0.0
crowg101,George Crowe,Cincinnati Reds,REDS,3,5,8,13,1958,1966,8,5.3,5.9,0.6,751,639,-112,1876,2223,347,111.0,126.0,15.0,0.0,10500.0,10500.0
crowg102,General Crowder,Washington Senators,TWINS,1,1,1,2,1927,1928,1,10.9,0.35,-10.55,230,70,-160,243,79,-164,1985.0,612.0,-1373.0,6000.0,10000.0,4000.0
crowg102,General Crowder,St.Louis Browns,ORLS,21,40,49,89,1930,1952,22,132.72,109.57,-23.15,6415,9088,2673,21139,29444,8305,12102.0,15510.0,3408.0,207500.0,189450.0,-18050.0
crowj001,Jim Crowell,Cleveland Indians,INDINS,1,4,2,6,1997,1998,1,5.24,-0.51,-5.75,1014,98,-916,190,187,-3,2567.0,112.0,-2455.0,0.0,4300000.0,4300000.0
crowt101,Terry Crowley,Cincinnati Reds,REDS,2,2,2,4,1976,1976,0,0.0,0.0,0.0,7,0,-7,7,0,-7,0.0,0.0,0.0,0.0,0.0,0.0
croww001,Wil Crowe,Washington Nationals,NATEX,1,2,1,3,2020,2020,0,-0.15,0.0,0.15,53,0,-53,41,0,-41,350.0,0.0,-350.0,0.0,4800000.0,4800000.0
croze001,Eric Crozier,Cleveland Indians,INDINS,1,1,1,2,2004,2004,0,0.08,0.37,0.29,14,24,10,39,80,41,0.0,0.0,0.0,0.0,342000.0,342000.0
crucf001,Francisco Cruceta,Los Angeles Dodgers,DOGRS,1,3,1,4,2002,2004,2,-0.33,0.6,0.93,92,177,85,4,5,1,830.0,299.0,-531.0,3250000.0,3250000.0,0.0
crudm001,Mike Crudale,St. Louis Cardinals,CARDS,1,2,1,3,2003,2003,0,0.23,0.18,-0.05,18,36,18,0,0,0,28.0,54.0,26.0,0.0,1700000.0,1700000.0
cruiw101,Walton Cruise,Jacksonville,Jacksonville,1,1,1,2,1914,1914,0,4.18,0.0,-4.18,330,0,-330,1185,0,-1185,0.0,0.0,0.0,0.0,0.0,0.0
crumc101,Cal Crum,Boston Braves,BRAVES,1,2,1,3,1918,1924,6,0.0,6.61,6.61,0,377,377,0,384,384,0.0,3083.0,3083.0,0.0,0.0,0.0
crumr101,Roy Crumpler,Detroit Tigers,TIGRS,1,9,2,11,1921,1941,20,0.0,3.03,3.03,0,202,202,0,144,144,0.0,1168.0,1168.0,3000.0,0.0,-3000.0
cruzd001,Deivi Cruz,Los Angeles Dodgers,DOGRS,1,2,1,3,1996,1997,1,5.99,0.0,-5.99,703,0,-703,2550,0,-2550,0.0,0.0,0.0,0.0,0.0,0.0
cruzd001,Deivi Cruz,San Francisco Giants,GIANTS,1,1,1,2,2005,2005,0,-0.11,0.0,0.11,20,0,-20,54,0,-54,0.0,0.0,0.0,800000.0,0.0,-800000.0
cruze001,Enrique Cruz,Milwaukee Brewers,BREWRS,1,2,1,3,2006,2008,2,0.0,2.38,2.38,0,391,391,0,0,0,0.0,399.0,399.0,0.0,725000.0,725000.0
cruzf001,Fausto Cruz,Oakland Athletics,ATLTCS,1,2,1,3,1996,1996,0,-0.36,-1.09,-0.73,14,73,59,40,263,223,0.0,0.0,0.0,0.0,0.0,0.0
cruzh101,Hector Cruz,St. Louis Cardinals,CARDS,14,34,29,63,1977,1994,17,91.47,138.33,46.86,7749,6510,-1239,23063,22802,-261,8671.0,3716.0,-4955.0,3088333.0,809167.0,-2279166.0
cruzh101,Hector Cruz,Chicago Cubs,CUBS,2,2,2,4,1978,1982,4,-0.38,6.63,7.01,106,367,261,248,237,-11,65.0,1587.0,1522.0,0.0,0.0,0.0
cruzh101,Hector Cruz,San Francisco Giants,GIANTS,1,1,1,2,1979,1980,1,0.27,-0.45,-0.72,126,60,-66,298,3,-295,0.0,138.0,138.0,0.0,0.0,0.0
cruzh101,Hector Cruz,Cincinnati Reds,REDS,2,2,2,4,1980,1983,3,-0.22,-1.97,-1.75,88,175,87,175,252,77,0.0,269.0,269.0,0.0,0.0,0.0
cruzj002,Julio Cruz,Seattle Mariners,MARNRS,2,2,3,5,1983,1986,3,7.91,6.82,-1.09,932,587,-345,3406,2494,-912,0.0,0.0,0.0,425000.0,252000.0,-173000.0
cruzj003,Jacob Cruz,San Francisco Giants,GIANTS,1,2,3,5,1998,1998,0,1.81,-0.51,-2.32,252,118,-134,209,56,-153,512.0,113.0,-399.0,1172500.0,2920000.0,1747500.0
cruzj003,Jacob Cruz,Cleveland Indians,INDINS,4,6,9,15,2001,2011,10,5.18,10.77,5.59,588,1134,546,2019,3716,1697,29.0,785.0,756.0,2536200.0,320000.0,-2216200.0
cruzj004,Jose Cruz,Seattle Mariners,MARNRS,2,2,3,5,1997,1999,2,10.57,1.4,-9.17,708,182,-526,2905,0,-2905,34.0,637.0,603.0,255000.0,3485000.0,3230000.0
cruzj004,Jose Cruz,Tampa Bay Devil Rays,RAYS,1,2,1,3,2005,2007,2,-1.33,-0.8,0.53,64,109,45,245,5,-240,0.0,1106.0,1106.0,0.0,0.0,0.0
cruzj004,Jose Cruz,Arizona Diamondbacks,DBACKS,1,2,2,4,2005,2005,0,-0.2,0.0,0.2,4,0,-4,13,0,-13,0.0,0.0,0.0,4000000.0,0.0,-4000000.0
cruzj005,Juan Cruz,Chicago Cubs,CUBS,2,4,3,7,2004,2004,0,1.21,-0.22,-1.43,97,23,-74,6,19,13,216.0,5.0,-211.0,300000.0,700000.0,400000.0
cruzj005,Juan Cruz,Atlanta Braves,BRAVES,1,3,1,4,2004,2013,9,-3.0,25.61,28.61,78,476,398,55,578,523,230.0,4719.0,4489.0,370000.0,5000000.0,4630000.0
cruzj005,Juan Cruz,Oakland Athletics,ATLTCS,1,1,1,2,2006,2008,2,3.52,0.44,-3.08,276,54,-222,28,0,-28,622.0,283.0,-339.0,0.0,0.0,0.0
cruzl001,Luis Cruz,Boston Red Sox,RSOX,1,1,1,2,2002,2004,2,0.0,-0.39,-0.39,0,52,52,0,79,79,0.0,0.0,0.0,0.0,0.0,0.0
cruzn001,Nelson Cruz,Detroit Tigers,TIGRS,1,3,3,6,2000,2002,2,3.02,0.94,-2.08,1389,171,-1218,3537,610,-2927,741.0,454.0,-287.0,5550000.0,3640000.0,-1910000.0
cruzn001,Nelson Cruz,Houston Astros,ASTROS,1,1,1,2,2002,2002,0,-0.43,0.0,0.43,39,0,-39,15,0,-15,161.0,0.0,-161.0,375000.0,0.0,-375000.0
cruzn002,Nelson Cruz,New York Mets,METS,1,1,1,2,2000,2003,3,0.0,0.01,0.01,0,47,47,0,92,92,0.0,0.0,0.0,0.0,219500.0,219500.0
cruzn002,Nelson Cruz,Oakland Athletics,ATLTCS,1,2,1,3,2004,2006,2,-0.55,-0.87,-0.32,86,51,-35,10,156,146,151.0,0.0,-151.0,0.0,383333.0,383333.0
cruzn002,Nelson Cruz,Milwaukee Brewers,BREWRS,1,2,4,6,2006,2008,2,12.97,2.6,-10.37,855,354,-501,3435,502,-2933,0.0,270.0,270.0,8500000.0,7270260.0,-1229740.0
cruzn002,Nelson Cruz,Minnesota Twins,TWINS,1,2,2,4,2021,2021,0,0.48,0.33,-0.15,55,6,-49,238,2,-236,0.0,80.0,80.0,13000000.0,0.0,-13000000.0
cruzo001,Oneil Cruz,Los Angeles Dodgers,DOGRS,1,2,1,3,2017,2017,0,0.11,0.39,0.28,2,48,46,9,0,-9,0.0,60.0,60.0,0.0,5600000.0,5600000.0
cruzt001,Todd Cruz,Philadelphia Phillies,PHILS,1,1,1,2,1979,1980,1,0.34,-0.26,-0.6,55,64,9,126,7,-119,0.0,183.0,183.0,0.0,0.0,0.0
cruzt001,Todd Cruz,Kansas City Royals,ROYALS,3,5,4,9,1979,1986,7,14.42,8.44,-5.98,1272,909,-363,3936,3256,-680,0.0,0.0,0.0,0.0,250000.0,250000.0
cruzt001,Todd Cruz,California Angels,ANGELS,1,1,1,2,1980,1980,0,-0.28,0.0,0.28,90,0,-90,311,0,-311,0.0,0.0,0.0,0.0,0.0,0.0
cruzt001,Todd Cruz,Chicago White Sox,WSOX,6,11,9,20,1981,1994,13,14.41,9.4,-5.01,691,899,208,1049,2235,1186,4103.0,4503.0,400.0,1513333.0,147500.0,-1365833.0
cruzt002,Tony Cruz,St. Louis Cardinals,CARDS,1,1,1,2,2015,2015,0,-0.12,0.0,0.12,4,0,-4,5,0,-5,0.0,0.0,0.0,775000.0,0.0,-775000.0
cruzt101,Tommy Cruz,St. Louis Cardinals,CARDS,5,9,6,15,1973,1976,3,2.63,1.5,-1.13,416,182,-234,619,510,-109,1142.0,401.0,-741.0,7800.0,0.0,-7800.0
cruzt101,Tommy Cruz,Chicago White Sox,WSOX,1,3,3,6,1977,1978,1,1.55,0.0,-1.55,299,0,-299,869,0,-869,0.0,0.0,0.0,70000.0,0.0,-70000.0
cruzv101,Victor Cruz,St. Louis Cardinals,CARDS,8,20,14,34,1977,1992,15,72.28,107.29,35.01,5696,4011,-1685,17434,13849,-3585,7151.0,4578.0,-2573.0,1533333.0,19000.0,-1514333.0
cruzv101,Victor Cruz,Toronto Blue Jays,BJAYS,2,4,3,7,1978,1987,9,9.74,-0.53,-10.27,696,982,286,2252,3389,1137,494.0,317.0,-177.0,650000.0,0.0,-650000.0
cruzv101,Victor Cruz,Cleveland Indians,INDINS,5,10,10,20,1980,2004,24,35.2,53.01,17.81,1530,2520,990,5654,9198,3544,2682.0,3776.0,1094.0,1767500.0,1412500.0,-355000.0
cruzv101,Victor Cruz,Pittsburgh Pirates,PIRATS,1,1,1,2,1982,1984,2,0.8,-0.08,-0.88,18,3,-15,0,3,3,75.0,0.0,-75.0,0.0,0.0,0.0
cubbm101,Mike Cubbage,Texas Rangers,RNGRS,5,14,9,23,1976,1988,12,43.04,39.52,-3.52,2266,2145,-121,8188,7408,-780,2609.0,4285.0,1676.0,330000.0,165000.0,-165000.0
cubid001,Darwin Cubillan,Toronto Blue Jays,BJAYS,1,2,1,3,2000,2002,2,25.41,3.65,-21.76,1836,80,-1756,8047,8,-8039,53.0,1300.0,1247.0,0.0,2650000.0,2650000.0
cubid001,Darwin Cubillan,Texas Rangers,RNGRS,1,1,1,2,2001,2001,0,0.24,0.0,-0.24,55,0,-55,0,0,0,79.0,0.0,-79.0,0.0,220000.0,220000.0
cuccc101,Cookie Cuccurullo,Pittsburgh Pirates,PIRATS,1,1,1,2,1946,1946,0,0.0,0.0,0.0,0,0,0,0,0,0,0.0,0.0,0.0,0.0,17000.0,17000.0
cucct101,Tony Cuccinello,Cincinnati Reds,REDS,5,9,12,21,1932,1942,10,46.0,30.81,-15.19,3034,1950,-1084,10521,6810,-3711,2379.0,542.0,-1837.0,5500.0,0.0,-5500.0
cucct101,Tony Cuccinello,Brooklyn Dodgers,DOGRS,5,10,8,18,1935,1948,13,23.18,15.94,-7.24,1423,1121,-302,4586,3821,-765,1769.0,791.0,-978.0,0.0,0.0,0.0
cucct101,Tony Cuccinello,Boston Braves,BRAVES,1,1,2,3,1940,1943,3,-0.49,4.14,4.63,88,264,176,324,377,53,0.0,1753.0,1753.0,0.0,0.0,0.0
cuelb101,Bobby Cuellar,Texas Rangers,RNGRS,2,3,2,5,1978,1984,6,4.64,3.01,-1.63,361,454,93,939,1279,340,0.0,259.0,259.0,0.0,0.0,0.0
cuelm101,Mike Cuellar,St. Louis Cardinals,CARDS,10,18,16,34,1965,1976,11,25.61,13.65,-11.96,1956,974,-982,3292,632,-2660,6302.0,2494.0,-3808.0,0.0,0.0,0.0
cuelm101,Mike Cuellar,Houston Astros,ASTROS,2,4,3,7,1968,1970,2,13.55,1.65,-11.9,563,230,-333,804,931,127,6085.0,0.0,-6085.0,0.0,61000.0,61000.0
cuetd101,Bert Cueto,Minnesota Twins,TWINS,1,1,1,2,1962,1969,7,0.0,-0.14,-0.14,0,21,21,0,53,53,0.0,0.0,0.0,0.0,0.0,0.0
cuetj001,Johnny Cueto,Cincinnati Reds,REDS,2,3,4,7,2015,2021,6,0.37,-1.23,-1.6,27,231,204,0,147,147,281.0,1419.0,1138.0,10000000.0,0.0,-10000000.0
cuetm101,Manuel Cueto,Cincinnati Reds,REDS,1,2,1,3,1920,1920,0,0.0,-0.61,-0.61,0,10,10,0,8,8,0.0,55.0,55.0,0.0,0.0,0.0
cuevn001,Noel Cuevas,Los Angeles Dodgers,DOGRS,1,1,1,2,2014,2015,1,-1.35,0.28,1.63,76,105,29,155,1,-154,0.0,175.0,175.0,0.0,2025000.0,2025000.0
culbc001,Charlie Culberson,San Francisco Giants,GIANTS,1,1,2,3,2012,2015,3,-1.89,4.02,5.91,142,193,51,337,828,491,0.0,0.0,0.0,0.0,6000000.0,6000000.0
culbc001,Charlie Culberson,Los Angeles Dodgers,DOGRS,4,17,9,26,2017,2021,4,6.07,9.48,3.41,927,279,-648,2727,1007,-1720,545.0,229.0,-316.0,71371000.0,90253480.0,18882480.0
culbl101,Leon Culberson,Boston Red Sox,RSOX,5,13,10,23,1947,1956,9,13.4,14.7,1.3,2053,1460,-593,7010,4777,-2233,1880.0,1611.0,-269.0,136000.0,54500.0,-81500.0
culbl101,Leon Culberson,Washington Senators,TWINS,2,3,2,5,1948,1952,4,2.29,4.22,1.93,258,435,177,600,1605,1005,0.0,0.0,0.0,11000.0,0.0,-11000.0
culld101,Dick Culler,Chicago White Sox,WSOX,1,3,1,4,1943,1943,0,0.0,0.0,0.0,0,0,0,0,0,0,0.0,0.0,0.0,8600.0,0.0,-8600.0
culld101,Dick Culler,Milwaukee,Milwaukee,1,2,2,4,1944,1945,1,2.0,0.0,-2.0,395,0,-395,1542,0,-1542,0.0,0.0,0.0,0.0,0.0,0.0
culld101,Dick Culler,Boston Braves,BRAVES,1,2,1,3,1948,1948,0,-0.05,-0.28,-0.23,48,34,-14,105,82,-23,0.0,0.0,0.0,0.0,0.0,0.0
cullj101,Jack Cullen,New York Yankees,YANKS,1,3,1,4,1967,1968,1,-0.17,-0.55,-0.38,26,78,52,40,208,168,0.0,0.0,0.0,0.0,0.0,0.0
culln101,Nick Cullop,NewOrleans,NewOrleans,1,1,6,7,1913,1915,2,-0.98,0.0,0.98,48,0,-48,37,0,-37,303.0,0.0,-303.0,0.0,0.0,0.0
culln101,Nick Cullop,New York Yankees,YANKS,5,14,12,26,1918,1931,13,64.97,61.9,-3.07,2396,2093,-303,7435,5797,-1638,6303.0,6917.0,614.0,44500.0,41500.0,-3000.0
culln101,Nick Cullop,Cleveland Indians,INDINS,1,3,1,4,1912,1915,3,0.0,1.09,1.09,0,280,280,0,1151,1151,0.0,0.0,0.0,0.0,0.0,0.0
culln102,Nick Cullop,New York Yankees,YANKS,1,2,1,3,1926,1926,0,10.55,0.57,-9.98,311,18,-293,225,24,-201,1748.0,108.0,-1640.0,3000.0,10000.0,7000.0
culln102,Nick Cullop,Cincinnati Reds,REDS,1,2,1,3,1931,1933,2,0.0,-0.65,-0.65,0,108,108,0,270,270,0.0,0.0,0.0,0.0,0.0,0.0
culln102,Nick Cullop,Omaha,Omaha,1,1,2,3,1924,1924,0,0.0,0.0,0.0,2,0,-2,2,0,-2,0.0,0.0,0.0,0.0,0.0,0.0
cullr101,Roy Cullenbine,Brooklyn Dodgers,DOGRS,1,1,1,2,1940,1940,0,5.56,-0.12,-5.68,273,57,-216,1080,113,-967,0.0,0.0,0.0,5000.0,5000.0,0.0
cullr101,Roy Cullenbine,St.Louis Browns,ORLS,1,2,2,4,1942,1947,5,0.79,6.64,5.85,98,330,232,296,878,582,122.0,1025.0,903.0,7500.0,7250.0,-250.0
cullr101,Roy Cullenbine,New York Yankees,YANKS,1,2,2,4,1942,1946,4,14.72,6.82,-7.9,514,360,-154,2082,1425,-657,0.0,0.0,0.0,17500.0,6500.0,-11000.0
cullr101,Roy Cullenbine,Cleveland Indians,INDINS,2,3,3,6,1945,1948,3,14.82,4.87,-9.95,401,354,-47,1659,1291,-368,0.0,0.0,0.0,9500.0,3600.0,-5900.0
cullt101,Tim Cullen,Washington Senators,RNGRS,12,27,21,48,1968,1988,20,46.51,51.95,5.44,2991,4295,1304,9420,12528,3108,3885.0,6824.0,2939.0,527000.0,241500.0,-285500.0
cullt101,Tim Cullen,Chicago White Sox,WSOX,1,1,1,2,1968,1970,2,1.36,0.33,-1.03,414,125,-289,1147,306,-841,0.0,0.0,0.0,15500.0,33000.0,17500.0
culmw101,Wil Culmer,Philadelphia Phillies,PHILS,3,6,5,11,1982,1987,5,5.02,15.9,10.88,358,462,104,942,672,-270,1316.0,2480.0,1164.0,1109333.0,1060833.0,-48500.0
culpr101,Ray Culp,Philadelphia Phillies,PHILS,3,5,4,9,1966,1974,8,1.53,-0.19,-1.72,157,456,299,216,1329,1113,1082.0,376.0,-706.0,32000.0,15000.0,-17000.0
culpr101,Ray Culp,Chicago Cubs,CUBS,1,1,3,4,1967,1969,2,10.79,0.0,-10.79,312,0,-312,404,0,-404,3277.0,0.0,-3277.0,17500.0,0.0,-17500.0
culvg101,George Culver,Cleveland Indians,INDINS,1,3,1,4,1967,1968,1,1.38,0.99,-0.39,316,130,-186,387,265,-122,982.0,0.0,-982.0,27000.0,25000.0,-2000.0
culvg101,George Culver,Cincinnati Reds,REDS,1,1,1,2,1969,1971,2,0.66,-2.29,-2.95,22,70,48,20,16,-4,170.0,199.0,29.0,0.0,35000.0,35000.0
culvg101,George Culver,St. Louis Cardinals,CARDS,10,17,16,33,1970,1976,6,18.66,2.65,-16.01,1836,551,-1285,3058,773,-2285,4547.0,1012.0,-3535.0,0.0,0.0,0.0
cumbj101,John Cumberland,New York Yankees,YANKS,1,1,1,2,1970,1971,1,1.35,-0.37,-1.72,122,18,-104,71,5,-66,663.0,62.0,-601.0,0.0,0.0,0.0
cumbj101,John Cumberland,San Francisco Giants,GIANTS,1,1,1,2,1972,1972,0,-0.81,0.0,0.81,28,0,-28,6,0,-6,65.0,0.0,-65.0,0.0,0.0,0.0
cumbj101,John Cumberland,St. Louis Cardinals,CARDS,4,5,5,10,1972,1977,5,20.99,-1.61,-22.6,875,118,-757,2900,9,-2891,1249.0,251.0,-998.0,47500.0,42500.0,-5000.0
cummj001,John Cummings,Los Angeles Dodgers,DOGRS,1,2,1,3,1996,1996,0,0.39,0.36,-0.03,64,43,-21,0,121,121,244.0,0.0,-244.0,305000.0,2000000.0,1695000.0
cummm001,Midre Cummings,Minnesota Twins,TWINS,1,2,1,3,1992,1992,0,7.13,5.07,-2.06,551,34,-517,733,0,-733,2091.0,723.0,-1368.0,0.0,0.0,0.0
cummm001,Midre Cummings,Minnesota Twins,TWINS,1,1,1,2,2000,2000,0,0.06,0.0,-0.06,21,0,-21,31,0,-31,0.0,0.0,0.0,300000.0,0.0,-300000.0
cumms001,Steve Cummings,Toronto Blue Jays,BJAYS,1,3,1,4,1990,1990,0,-0.34,0.18,0.52,4,3,-1,0,0,0,23.0,47.0,24.0,102500.0,775000.0,672500.0
cumms001,Steve Cummings,Cleveland Indians,INDINS,1,1,1,2,1991,1991,0,0.0,0.0,0.0,0,0,0,0,0,0,0.0,0.0,0.0,0.0,0.0,0.0
cunna001,Aaron Cunningham,Chicago White Sox,WSOX,2,3,3,6,2007,2008,1,3.05,0.09,-2.96,495,97,-398,49,356,307,721.0,0.0,-721.0,396000.0,8282695.0,7886695.0
cunna001,Aaron Cunningham,Arizona Diamondbacks,DBACKS,6,14,16,30,2007,2018,11,24.99,30.17,5.18,855,1190,335,1319,2038,719,6760.0,6326.0,-434.0,14741000.0,15790000.0,1049000.0
cunna001,Aaron Cunningham,Oakland Athletics,ATLTCS,1,2,2,4,2010,2016,6,1.29,5.52,4.23,209,624,415,584,2066,1482,0.0,0.0,0.0,0.0,0.0,0.0
cunna001,Aaron Cunningham,San Diego Padres,PADRS,2,2,2,4,2011,2013,2,-0.47,-0.16,0.31,82,34,-48,109,1,-108,34.0,54.0,20.0,0.0,0.0,0.0
cunnb101,Bill Cunningham,Washington Senators,TWINS,1,3,1,4,1912,1916,4,0.0,13.55,13.55,0,546,546,0,2246,2246,0.0,0.0,0.0,0.0,0.0,0.0
cunnb102,Bill Cunningham,New York Giants,GIANTS,2,4,3,7,1923,1927,4,14.64,1.52,-13.12,912,442,-470,3712,1550,-2162,0.0,87.0,87.0,25500.0,9875.0,-15625.0
cunnb103,Bert Cunningham,Louisville Colonels,LS3,1,12,5,17,1899,1900,1,267.1,0.0,-267.1,7388,0,-7388,29004,0,-29004,7568.0,0.0,-7568.0,4350.0,0.0,-4350.0
cunnb104,Bruce Cunningham,Chicago Cubs,CUBS,1,6,1,7,1928,1932,4,4.13,16.12,11.99,1036,317,-719,2232,1321,-911,4216.0,0.0,-4216.0,13000.0,30600.0,17600.0
cunnb104,Bruce Cunningham,Boston Braves,BRAVES,1,3,1,4,1932,1937,5,0.0,10.04,10.04,0,601,601,0,2506,2506,0.0,0.0,0.0,0.0,0.0,0.0
cunnj101,Joe Cunningham,St. Louis Cardinals,CARDS,1,1,1,2,1961,1963,2,6.2,-0.25,-6.45,256,39,-217,1030,108,-922,0.0,0.0,0.0,0.0,0.0,0.0
cunnj101,Joe Cunningham,Chicago White Sox,WSOX,3,4,5,9,1964,1969,5,-1.84,4.73,6.57,327,350,23,584,1283,699,492.0,0.0,-492.0,70250.0,45000.0,-25250.0
cunnt001,Todd Cunningham,Pittsburgh Pirates,PIRATS,1,1,1,2,2018,2018,0,0.0,0.0,0.0,0,0,0,0,0,0,0.0,0.0,0.0,0.0,0.0,0.0
cunnw001,Will Cunnane,San Diego Padres,PADRS,1,2,2,4,2000,2001,1,-1.16,-0.17,0.99,82,43,-39,8,97,89,184.0,0.0,-184.0,230000.0,0.0,-230000.0
currc101,Clarence Currie,Chicago Cubs,CUBS,2,9,2,11,1903,1913,10,5.14,24.13,18.99,814,1109,295,3290,4566,1276,0.0,1329.0,1329.0,0.0,0.0,0.0
currl101,Lafayette Currence,Pittsburgh Pirates,PIRATS,1,1,1,2,1973,1975,2,-0.47,0.0,0.47,8,0,-8,0,0,0,56.0,0.0,-56.0,0.0,0.0,0.0
currt101,Tony Curry,Philadelphia Phillies,PHILS,1,2,1,3,1962,1962,0,0.0,-1.42,-1.42,19,65,46,19,111,92,0.0,0.0,0.0,0.0,0.0,0.0
currt101,Tony Curry,Cleveland Indians,INDINS,1,1,1,2,1966,1966,0,0.0,-0.53,-0.53,0,33,33,0,52,52,0.0,0.0,0.0,0.0,0.0,0.0
currt101,Tony Curry,Houston Astros,ASTROS,1,1,1,2,1966,1969,3,0.0,0.09,0.09,0,8,8,0,4,4,0.0,55.0,55.0,0.0,0.0,0.0
curtc001,Chad Curtis,California Angels,ANGELS,1,1,1,2,1995,1995,0,2.21,4.36,2.15,248,139,-109,1136,643,-493,0.0,0.0,0.0,0.0,0.0,0.0
curtc001,Chad Curtis,Detroit Tigers,TIGRS,3,4,5,9,1996,1998,2,2.51,3.69,1.18,198,147,-51,668,163,-505,0.0,769.0,769.0,2600000.0,1376500.0,-1223500.0
curtc001,Chad Curtis,Cleveland Indians,INDINS,1,1,1,2,1997,1997,0,4.23,-0.27,-4.5,340,9,-331,1162,0,-1162,0.0,50.0,50.0,900000.0,435000.0,-465000.0
curtc001,Chad Curtis,New York Yankees,YANKS,1,1,2,3,1999,2005,6,0.61,0.05,-0.56,146,1,-145,511,0,-511,0.0,4.0,4.0,2000000.0,0.0,-2000000.0
curtc101,Cliff Curtis,Boston Braves,BRAVES,2,5,6,11,1911,1914,3,3.16,-2.55,-5.71,559,378,-181,1829,1028,-801,21.0,614.0,593.0,0.0,6000.0,6000.0
curtc101,Cliff Curtis,Chicago Cubs,CUBS,1,1,1,2,1911,1911,0,0.3,-0.25,-0.55,36,2,-34,32,1,-31,285.0,6.0,-279.0,0.0,0.0,0.0
curtc101,Cliff Curtis,Brooklyn Dodgers,DOGRS,1,1,1,2,1913,1914,1,0.0,-0.85,-0.85,0,32,32,0,107,107,0.0,0.0,0.0,2400.0,0.0,-2400.0
curtj001,John Curtis,Boston Red Sox,RSOX,1,3,3,6,1973,1978,5,14.84,4.69,-10.15,678,283,-395,435,79,-356,3953.0,2795.0,-1158.0,53000.0,42000.0,-11000.0
curtj001,John Curtis,St. Louis Cardinals,CARDS,17,40,34,74,1976,1994,18,91.08,139.58,48.5,8485,6698,-1787,23608,22939,-669,10540.0,4019.0,-6521.0,3088333.0,809167.0,-2279166.0
curtj003,John Curtiss,Minnesota Twins,TWINS,1,1,1,2,2019,2019,0,0.04,0.0,-0.04,1,0,-1,0,0,0,7.0,0.0,-7.0,0.0,0.0,0.0
curtj003,John Curtiss,Tampa Bay Devil Rays,RAYS,1,1,1,2,2021,2021,0,0.85,0.0,-0.85,70,0,-70,5,0,-5,120.0,0.0,-120.0,0.0,0.0,0.0
curtj003,John Curtiss,Miami Marlins,MARLNS,1,1,1,2,2021,2021,0,-0.78,0.02,0.8,12,5,-7,0,16,16,13.0,0.0,-13.0,0.0,0.0,0.0
curtj102,Jack Curtis,Chicago Cubs,CUBS,11,16,18,34,1962,1982,20,39.15,78.99,39.84,1575,3797,2222,3570,10356,6786,7275.0,9948.0,2673.0,430000.0,24000.0,-406000.0
curtj102,Jack Curtis,Milwaukee Braves,BRAVES,3,5,6,11,1962,1966,4,-0.69,3.0,3.69,105,383,278,317,708,391,15.0,0.0,-15.0,0.0,0.0,0.0
curtz001,Zac Curtis,Arizona Diamondbacks,DBACKS,1,3,2,5,2016,2019,3,21.55,3.22,-18.33,745,61,-684,3265,58,-3207,14.0,514.0,500.0,2600000.0,1044000.0,-1556000.0
cusij101,Jack Cusick,Chicago Cubs,CUBS,8,19,17,36,1951,1965,14,4.94,22.84,17.9,1454,1928,474,3922,2504,-1418,1451.0,4951.0,3500.0,86800.0,81600.0,-5200.0
custj001,Jack Cust,Arizona Diamondbacks,DBACKS,1,2,1,3,2002,2003,1,-0.71,0.78,1.49,195,258,63,586,0,-586,0.0,220.0,220.0,0.0,0.0,0.0
custj001,Jack Cust,Colorado Rockies,ROCKS,1,1,1,2,2003,2003,0,0.41,-0.18,-0.59,28,19,-9,85,30,-55,0.0,0.0,0.0,0.0,0.0,0.0
cutsg101,George Cutshaw,Brooklyn Dodgers,DOGRS,2,3,4,7,1918,1929,11,13.23,38.94,25.71,700,1051,351,2619,1612,-1007,779.0,8893.0,8114.0,0.0,0.0,0.0
cuylk101,Kiki Cuyler,Pittsburgh Pirates,PIRATS,1,1,2,3,1927,1929,2,26.3,0.83,-25.47,949,209,-740,4196,845,-3351,0.0,0.0,0.0,11000.0,15500.0,4500.0
cvenm101,Mike Cvengros,Pittsburgh Pirates,PIRATS,1,2,1,3,1927,1927,0,0.0,0.0,0.0,0,0,0,0,0,0,0.0,0.0,0.0,3500.0,0.0,-3500.0
czajj001,Jim Czajkowski,Pittsburgh Pirates,PIRATS,1,1,1,2,1990,1990,0,0.0,0.0,0.0,0,0,0,0,0,0,0.0,0.0,0.0,0.0,0.0,0.0
daalo001,Omar Daal,Los Angeles Dodgers,DOGRS,1,1,1,2,1995,1995,0,-1.33,0.0,1.33,193,0,-193,16,0,-16,353.0,0.0,-353.0,156000.0,0.0,-156000.0
daalo001,Omar Daal,Arizona Diamondbacks,DBACKS,5,14,12,26,2000,2008,8,42.79,24.27,-18.52,2947,854,-2093,6888,689,-6199,9063.0,3504.0,-5559.0,23673667.0,11709000.0,-11964667.0
daalo001,Omar Daal,Philadelphia Phillies,PHILS,1,1,2,3,2001,2004,3,1.59,0.34,-1.25,77,20,-57,48,3,-45,484.0,61.0,-423.0,2750000.0,0.0,-2750000.0
dacqj101,John D'Acquisto,San Francisco Giants,GIANTS,2,5,5,10,1976,1979,3,0.11,-0.39,-0.5,172,638,466,406,1241,835,25.0,782.0,757.0,0.0,0.0,0.0
dacqj101,John D'Acquisto,St. Louis Cardinals,CARDS,1,2,1,3,1977,1978,1,-0.62,0.98,1.6,351,116,-235,172,6,-166,1013.0,278.0,-735.0,0.0,0.0,0.0
dacqj101,John D'Acquisto,San Diego Padres,PADRS,1,2,1,3,1980,1982,2,0.35,-0.35,-0.7,22,101,79,0,292,292,62.0,0.0,-62.0,0.0,0.0,0.0
dadep101,Paul Dade,Cleveland Indians,INDINS,1,1,1,2,1979,1985,6,0.22,13.96,13.74,144,888,744,375,3538,3163,0.0,0.0,0.0,0.0,0.0,0.0
dahlb101,Babe Dahlgren,Brooklyn Dodgers,DOGRS,1,1,2,3,1943,1944,1,1.46,-0.98,-2.44,136,102,-34,565,268,-297,0.0,0.0,0.0,0.0,0.0,0.0
dahlb101,Babe Dahlgren,Philadelphia Phillies,PHILS,1,1,2,3,1943,1943,0,1.71,0.0,-1.71,302,0,-302,1252,0,-1252,0.0,0.0,0.0,0.0,0.0,0.0
dahlb102,Bill Dahlen,Chicago Cubs,CUBS,2,2,2,4,1899,1904,5,0.82,1.9,1.08,60,141,81,257,578,321,0.0,0.0,0.0,0.0,0.0,0.0
dahlb102,Bill Dahlen,Brooklyn Dodgers,DOGRS,1,1,3,4,1903,1903,0,14.54,0.0,-14.54,579,0,-579,2281,0,-2281,0.0,0.0,0.0,0.0,0.0,0.0
dahlb102,Bill Dahlen,New York Giants,GIANTS,4,11,6,17,1907,1921,14,45.64,34.38,-11.26,2445,1600,-845,8369,5323,-3046,1733.0,2915.0,1182.0,6400.0,5200.0,-1200.0
dahlj101,Jerry Dahlke,Chicago White Sox,WSOX,3,10,4,14,1951,1953,2,2.36,0.32,-2.04,404,226,-178,236,372,136,2232.0,741.0,-1491.0,0.0,0.0,0.0
dalcb101,Bruce Dal Canton,Pittsburgh Pirates,PIRATS,3,5,5,10,1970,1974,4,25.46,1.32,-24.14,1582,453,-1129,5382,666,-4716,1881.0,1147.0,-734.0,76500.0,34500.0,-42000.0
dalcb101,Bruce Dal Canton,Kansas City Royals,ROYALS,1,3,2,5,1975,1976,1,1.17,0.35,-0.82,138,8,-130,32,0,-32,436.0,23.0,-413.0,0.0,0.0,0.0
daleb102,Bud Daley,Cleveland Indians,INDINS,8,15,14,29,1958,1968,10,101.35,32.49,-68.86,4418,2446,-1972,15260,8973,-6287,4502.0,562.0,-3940.0,0.0,32000.0,32000.0
daleb102,Bud Daley,Baltimore Orioles,ORLS,1,1,1,2,1958,1958,0,7.09,3.24,-3.85,236,64,-172,216,72,-144,1742.0,614.0,-1128.0,0.0,0.0,0.0
daleb102,Bud Daley,Kansas City Athletics,ATLTCS,1,1,2,3,1961,1963,2,0.61,-2.0,-2.61,160,152,-8,86,345,259,813.0,227.0,-586.0,0.0,0.0,0.0
daleb102,Bud Daley,New York Yankees,YANKS,2,4,3,7,1964,1966,2,1.12,2.59,1.47,72,260,188,65,33,-32,521.0,611.0,90.0,84000.0,27500.0,-56500.0
dalec001,Carl Dale,St. Louis Cardinals,CARDS,6,12,11,23,1996,2004,8,8.44,23.16,14.72,1305,1318,13,4128,1707,-2421,1089.0,4162.0,3073.0,14483333.0,16620281.0,2136948.0
dalec001,Carl Dale,Oakland Athletics,ATLTCS,1,1,1,2,1999,2000,1,-0.37,0.82,1.19,8,63,55,0,212,212,12.0,0.0,-12.0,0.0,475000.0,475000.0
dalep101,Pete Daley,Boston Red Sox,RSOX,1,1,1,2,1959,1960,1,0.26,0.22,-0.04,73,80,7,243,24,-219,0.0,304.0,304.0,0.0,0.0,0.0
dalet101,Tom Daley,Cincinnati Reds,REDS,4,11,8,19,1909,1914,5,44.03,9.97,-34.06,2926,905,-2021,11991,3124,-8867,753.0,872.0,119.0,0.0,0.0,0.0
dalet101,Tom Daley,Philadelphia Athletics,ATLTCS,2,2,2,4,1914,1916,2,2.39,4.17,1.78,150,333,183,485,1339,854,0.0,0.0,0.0,0.0,0.0,0.0
dallb001,Brian Dallimore,Houston Astros,ASTROS,1,1,1,2,2000,2000,0,0.0,0.0,0.0,0,0,0,0,0,0,0.0,0.0,0.0,0.0,0.0,0.0
dalld101,Dom Dallessandro,SanDiego,SanDiego,1,1,1,2,1939,1939,0,8.69,0.0,-8.69,678,0,-678,2093,0,-2093,0.0,0.0,0.0,0.0,0.0,0.0
dalld101,Dom Dallessandro,Boston Red Sox,RSOX,1,4,1,5,1937,1937,0,0.0,0.0,0.0,0,0,0,0,0,0,0.0,0.0,0.0,3000.0,0.0,-3000.0
dalrc101,Clay Dalrymple,Philadelphia Phillies,PHILS,1,1,1,2,1969,1969,0,1.63,-2.28,-3.91,73,103,30,201,259,58,0.0,0.0,0.0,0.0,0.0,0.0
daltj101,Jack Dalton,DesMoines,DesMoines,1,1,2,3,1910,1910,0,2.48,0.0,-2.48,205,0,-205,830,0,-830,0.0,0.0,0.0,0.0,0.0,0.0
dalyt101,Tom Daly,Chicago White Sox,WSOX,2,3,2,5,1903,1905,2,1.3,-0.02,-1.32,324,98,-226,1382,394,-988,0.0,0.0,0.0,0.0,0.0,0.0
dalyt102,Tom Daly,Chicago Cubs,CUBS,2,8,5,13,1921,1926,5,29.39,11.6,-17.79,1120,351,-769,4097,694,-3403,1929.0,2961.0,1032.0,13500.0,18700.0,5200.0
damaj101,Jack Damaska,St. Louis Cardinals,CARDS,1,2,2,4,1964,1967,3,0.0,-0.48,-0.48,0,55,55,0,111,111,0.0,0.0,0.0,0.0,0.0,0.0
damaj101,Jack Damaska,Pittsburgh Pirates,PIRATS,5,8,9,17,1968,1973,5,-0.64,0.41,1.05,22,41,19,70,35,-35,0.0,36.0,36.0,17500.0,0.0,-17500.0
damij001,Jeff D'Amico,Milwaukee Brewers,BREWRS,2,7,6,13,2002,2004,2,1.18,1.8,0.62,314,393,79,929,661,-268,437.0,1049.0,612.0,2750000.0,500000.0,-2250000.0
damij002,Jeff D'Amico,Oakland Athletics,ATLTCS,1,3,1,4,1999,2000,1,2.09,2.63,0.54,130,45,-85,4,6,2,1197.0,792.0,-405.0,201500.0,4800000.0,4598500.0
damij002,Jeff D'Amico,Cleveland Indians,INDINS,1,1,1,2,2002,2002,0,0.0,0.0,0.0,0,0,0,0,0,0,0.0,0.0,0.0,0.0,0.0,0.0
damij002,Jeff D'Amico,Philadelphia Phillies,PHILS,1,1,1,2,2002,2002,0,0.0,0.0,0.0,0,0,0,0,0,0,0.0,0.0,0.0,0.0,0.0,0.0
damoj001,Johnny Damon,Kansas City Royals,ROYALS,2,3,5,8,2001,2008,7,28.96,3.25,-25.71,1295,867,-428,5271,2850,-2421,0.0,359.0,359.0,0.0,0.0,0.0
danfd101,Dave Danforth,Columbus,Columbus,1,1,6,7,1921,1928,7,8.94,0.0,-8.94,274,0,-274,261,0,-261,2053.0,0.0,-2053.0,0.0,6600.0,6600.0
danib101,Bert Daniels,New York Yankees,YANKS,6,17,13,30,1913,1931,18,64.97,69.67,4.7,2396,2595,199,7435,7892,457,6303.0,6917.0,614.0,44500.0,41500.0,-3000.0
danib102,Bennie Daniels,Pittsburgh Pirates,PIRATS,1,3,1,4,1960,1961,1,4.94,2.05,-2.89,573,87,-486,984,20,-964,2463.0,268.0,-2195.0,0.0,0.0,0.0
danij101,Jake Daniel,Washington Senators,TWINS,1,1,2,3,1937,1944,7,-0.16,0.0,0.16,12,0,-12,30,0,-30,0.0,0.0,0.0,0.0,0.0,0.0
danij102,Jack Daniels,Milwaukee Braves,BRAVES,3,5,4,9,1956,1961,5,0.97,1.02,0.05,134,117,-17,436,294,-142,0.0,0.0,0.0,0.0,0.0,0.0
danik001,Kal Daniels,Cincinnati Reds,REDS,2,4,4,8,1989,1997,8,8.78,16.08,7.3,969,1208,239,2884,4618,1734,1277.0,269.0,-1008.0,325000.0,870000.0,545000.0
danik001,Kal Daniels,Los Angeles Dodgers,DOGRS,1,1,1,2,1992,1992,0,-0.61,0.0,0.61,48,0,-48,122,0,-122,0.0,0.0,0.0,2500000.0,0.0,-2500000.0
dankj001,John Danks,Texas Rangers,RNGRS,1,3,2,5,2006,2010,4,19.87,1.7,-18.17,323,47,-276,31,7,-24,4762.0,663.0,-4099.0,0.0,332000.0,332000.0
danni101,Ike Danning,Pittsburgh Pirates,PIRATS,1,2,1,3,1927,1927,0,0.0,0.0,0.0,0,0,0,0,0,0,0.0,0.0,0.0,3500.0,0.0,-3500.0
danzb101,Babe Danzig,St.Louis Browns,ORLS,2,6,5,11,1912,1924,12,0.0,-0.88,-0.88,0,143,143,0,396,396,0.0,10.0,10.0,0.0,0.0,0.0
darcp101,Pat Darcy,Houston Astros,ASTROS,1,2,1,3,1974,1974,0,0.18,-0.02,-0.2,88,30,-58,67,34,-33,560.0,0.0,-560.0,0.0,0.0,0.0
darcp101,Pat Darcy,Cincinnati Reds,REDS,2,2,3,5,1977,1977,0,17.3,0.39,-16.91,239,28,-211,0,5,5,4814.0,74.0,-4740.0,0.0,0.0,0.0
darev001,Vic Darensbourg,Florida Marlins,MARLNS,4,9,11,20,2002,2015,13,11.51,22.72,11.21,893,1533,640,2983,2710,-273,1797.0,5078.0,3281.0,13177000.0,10303543.0,-2873457.0
darka101,Al Dark,Boston Braves,BRAVES,3,12,6,18,1949,1960,11,49.35,33.68,-15.67,2025,1559,-466,7279,6319,-960,2138.0,0.0,-2138.0,0.0,42000.0,42000.0
darka101,Al Dark,St. Louis Cardinals,CARDS,2,2,2,4,1958,1959,1,10.79,2.4,-8.39,630,129,-501,1116,47,-1069,995.0,497.0,-498.0,40000.0,0.0,-40000.0
darka101,Al Dark,Chicago Cubs,CUBS,1,3,1,4,1960,1961,1,4.05,4.05,0.0,233,260,27,447,1040,593,1208.0,0.0,-1208.0,0.0,0.0,0.0
darka101,Al Dark,Philadelphia Phillies,PHILS,1,1,1,2,1960,1960,0,0.33,-0.9,-1.23,50,26,-24,152,89,-63,0.0,0.0,0.0,0.0,0.0,0.0
darka101,Al Dark,Milwaukee Braves,BRAVES,2,3,3,6,1960,1961,1,3.31,-0.59,-3.9,499,56,-443,1886,5,-1881,0.0,122.0,122.0,0.0,0.0,0.0
darka101,Al Dark,New York Giants,GIANTS,11,22,22,44,1956,1968,12,37.88,26.25,-11.63,3162,2563,-599,10326,4535,-5791,1384.0,7539.0,6155.0,95000.0,109500.0,14500.0
darlr001,Ron Darling,Texas Rangers,RNGRS,2,3,2,5,1982,1984,2,21.02,0.29,-20.73,680,235,-445,875,838,-37,5969.0,0.0,-5969.0,400000.0,0.0,-400000.0
darlr001,Ron Darling,New York Mets,METS,2,3,2,5,1991,1992,1,-0.46,-0.67,-0.21,29,186,157,7,7,0,134.0,344.0,210.0,4233334.0,1600000.0,-2633334.0
darlr001,Ron Darling,Montreal Expos,NATEX,1,1,2,3,1991,1991,0,3.31,0.0,-3.31,127,0,-127,1,0,-1,2170.0,0.0,-2170.0,0.0,0.0,0.0
darnt001,Travis d'Arnaud,Philadelphia Phillies,PHILS,1,3,2,5,2009,2013,4,-0.14,16.2,16.34,41,202,161,2,264,262,517.0,2108.0,1591.0,0.0,14250000.0,14250000.0
darnt001,Travis d'Arnaud,Toronto Blue Jays,BJAYS,1,4,3,7,2012,2016,4,18.37,4.87,-13.5,742,311,-431,2152,493,-1659,2154.0,2473.0,319.0,0.0,5229800.0,5229800.0
darrg101,George Darrow,Philadelphia Phillies,PHILS,1,2,1,3,1934,1935,1,0.0,1.54,1.54,0,70,70,0,62,62,0.0,500.0,500.0,0.0,0.0,0.0
darrm001,Mike Darr,Detroit Tigers,TIGRS,1,2,1,3,1997,1997,0,2.51,-0.37,-2.88,188,52,-136,612,129,-483,0.0,0.0,0.0,0.0,0.0,0.0
darvy001,Yu Darvish,Texas Rangers,RNGRS,1,1,3,4,2017,2017,0,0.52,0.02,-0.5,18,13,-5,20,37,17,149.0,0.0,-149.0,11000000.0,0.0,-11000000.0
darvy001,Yu Darvish,Chicago Cubs,CUBS,1,2,5,7,2020,2021,1,1.28,-0.94,-2.22,175,63,-112,411,44,-367,499.0,444.0,-55.0,22000000.0,5250000.0,-16750000.0
darwb101,Bobby Darwin,Los Angeles Dodgers,DOGRS,1,1,1,2,1971,1971,0,5.3,0.0,-5.3,490,0,-490,1998,0,-1998,0.0,0.0,0.0,9600.0,0.0,-9600.0
darwb101,Bobby Darwin,Minnesota Twins,TWINS,1,1,1,2,1975,1976,1,-0.02,1.75,1.77,80,87,7,282,327,45,0.0,0.0,0.0,0.0,0.0,0.0
darwb101,Bobby Darwin,Milwaukee Brewers,BREWRS,2,4,2,6,1976,1976,0,3.64,0.57,-3.07,542,69,-473,1808,219,-1589,335.0,0.0,-335.0,150000.0,0.0,-150000.0
darwb101,Bobby Darwin,Boston Red Sox,RSOX,1,1,1,2,1977,1977,0,-0.19,-0.27,-0.08,11,12,1,12,0,-12,0.0,38.0,38.0,0.0,0.0,0.0
darwd001,Danny Darwin,Texas Rangers,RNGRS,2,3,2,5,1985,1991,6,9.16,3.49,-5.67,280,372,92,750,977,227,1044.0,361.0,-683.0,431500.0,68000.0,-363500.0
darwd001,Danny Darwin,Milwaukee Brewers,BREWRS,1,1,2,3,1986,1991,5,12.22,4.82,-7.4,446,196,-250,220,0,-220,2307.0,2588.0,281.0,610000.0,0.0,-610000.0
darwd001,Danny Darwin,Pittsburgh Pirates,PIRATS,1,1,1,2,1996,2001,5,-0.94,2.3,3.24,30,397,367,12,11,-1,127.0,672.0,545.0,550000.0,0.0,-550000.0
darwd001,Danny Darwin,Chicago White Sox,WSOX,7,14,18,32,1997,2011,14,8.23,24.04,15.81,946,1419,473,129,1458,1329,2956.0,3428.0,472.0,22052500.0,11583333.0,-10469167.0
darwj001,Jeff Darwin,Seattle Mariners,MARNRS,3,4,4,8,1993,1995,2,2.56,0.14,-2.42,232,106,-126,671,357,-314,133.0,12.0,-121.0,900000.0,1100000.0,200000.0
darwj001,Jeff Darwin,Florida Marlins,MARLNS,1,2,1,3,1993,1994,1,-0.16,1.68,1.84,2,140,138,0,529,529,12.0,0.0,-12.0,0.0,0.0,0.0
darwj001,Jeff Darwin,Seattle Mariners,MARNRS,1,1,1,2,1995,1995,0,0.71,0.36,-0.35,38,33,-5,0,88,88,133.0,0.0,-133.0,0.0,200000.0,200000.0
daubj101,Jake Daubert,Brooklyn Dodgers,DOGRS,3,4,3,7,1919,1927,8,12.12,3.41,-8.71,877,824,-53,3785,3220,-565,0.0,0.0,0.0,17500.0,0.0,-17500.0
daugj001,Jack Daugherty,Montreal Expos,NATEX,2,3,2,5,1988,1992,4,1.14,-0.02,-1.16,385,218,-167,919,35,-884,0.0,350.0,350.0,0.0,0.0,0.0
daugj001,Jack Daugherty,Houston Astros,ASTROS,1,1,1,2,1993,1993,0,-0.37,0.0,0.37,46,0,-46,71,0,-71,0.0,0.0,0.0,0.0,0.0,0.0
dauld001,Darren Daulton,Philadelphia Phillies,PHILS,1,1,1,2,1997,1999,2,0.48,0.53,0.05,52,24,-28,152,81,-71,0.0,0.0,0.0,4825000.0,0.0,-4825000.0
davaj001,Jeff DaVanon,Oakland Athletics,ATLTCS,3,7,5,12,1999,2003,4,20.51,6.2,-14.31,1029,288,-741,2006,1023,-983,4166.0,874.0,-3292.0,3050000.0,3425000.0,375000.0
davaj101,Jerry DaVanon,San Diego Padres,PADRS,1,2,2,4,1969,1970,1,-0.17,0.16,0.33,66,87,21,122,263,141,0.0,0.0,0.0,7500.0,0.0,-7500.0
davaj101,Jerry DaVanon,St. Louis Cardinals,CARDS,1,1,1,2,1970,1972,2,0.63,1.29,0.66,38,162,124,94,7,-87,0.0,264.0,264.0,10000.0,0.0,-10000.0
davaj101,Jerry DaVanon,Baltimore Orioles,ORLS,1,1,1,2,1972,1972,0,-0.28,0.0,0.28,41,0,-41,52,0,-52,0.0,0.0,0.0,0.0,27000.0,27000.0
davaj101,Jerry DaVanon,California Angels,ANGELS,2,2,3,5,1973,1974,1,-0.01,0.0,0.01,245,0,-245,776,0,-776,0.0,0.0,0.0,0.0,0.0,0.0
davaj101,Jerry DaVanon,Houston Astros,ASTROS,5,9,7,16,1976,1985,9,14.67,9.46,-5.21,1469,1015,-454,4721,2946,-1775,118.0,0.0,-118.0,0.0,0.0,0.0
davav101,Vic Davalillo,Cleveland Indians,INDINS,1,1,1,2,1968,1969,1,3.22,-0.35,-3.57,126,57,-69,437,133,-304,0.0,0.0,0.0,0.0,0.0,0.0
davav101,Vic Davalillo,California Angels,ANGELS,1,1,1,2,1969,1969,0,0.58,-0.31,-0.89,176,37,-139,304,62,-242,0.0,0.0,0.0,0.0,11000.0,11000.0
davav101,Vic Davalillo,St. Louis Cardinals,CARDS,3,4,5,9,1971,1972,1,10.59,4.12,-6.47,503,282,-221,1140,1112,-28,1651.0,28.0,-1623.0,0.0,0.0,0.0
davay101,Yo-Yo Davalillo,Washington Senators,TWINS,1,4,4,8,1956,1956,0,0.0,0.0,0.0,0,0,0,0,0,0,0.0,0.0,0.0,0.0,0.0,0.0
davel101,Lum Davenport,Chicago White Sox,WSOX,1,4,1,5,1924,1924,0,0.0,-0.04,-0.04,0,6,6,0,5,5,0.0,0.0,0.0,0.0,0.0,0.0
davet001,Tom Davey,Toronto Blue Jays,BJAYS,3,5,3,8,1999,2002,3,6.14,2.49,-3.65,321,312,-9,1103,1201,98,104.0,25.0,-79.0,0.0,2500000.0,2500000.0
davet001,Tom Davey,Seattle Mariners,MARNRS,1,2,1,3,2000,2001,1,0.34,1.23,0.89,184,142,-42,130,469,339,215.0,0.0,-215.0,1850000.0,1750000.0,-100000.0
davia003,Austin Davis,Philadelphia Phillies,PHILS,1,1,1,2,2020,2020,0,-0.1,0.0,0.1,25,0,-25,0,0,0,40.0,0.0,-40.0,0.0,0.0,0.0
davia003,Austin Davis,Pittsburgh Pirates,PIRATS,1,1,1,2,2021,2021,0,-0.01,0.09,0.1,20,12,-8,1,42,41,50.0,0.0,-50.0,0.0,0.0,0.0
davib003,Ben Davis,San Diego Padres,PADRS,3,8,7,15,2001,2006,5,0.42,8.49,8.07,330,730,400,847,2213,1366,693.0,843.0,150.0,3727500.0,2445000.0,-1282500.0
davib003,Ben Davis,Seattle Mariners,MARNRS,11,20,22,42,2004,2015,11,19.53,35.16,15.63,1825,2443,618,3973,7974,4001,3326.0,2794.0,-532.0,27402500.0,19145000.0,-8257500.0
davib102,Bob Davis,Washington Senators,RNGRS,5,8,6,14,1960,1970,10,4.25,-0.08,-4.33,404,380,-24,701,1268,567,1913.0,6.0,-1907.0,0.0,8000.0,8000.0
davib105,Brock Davis,Chicago Cubs,CUBS,2,4,2,6,1971,1977,6,12.52,9.33,-3.19,493,821,328,508,3274,2766,3595.0,0.0,-3595.0,150000.0,45000.0,-105000.0
davib105,Brock Davis,Chicago Cubs,CUBS,1,2,1,3,1975,1976,1,5.2,-0.21,-5.41,136,50,-86,0,3,3,592.0,115.0,-477.0,0.0,0.0,0.0
davib106,Bill Davis,Cleveland Indians,INDINS,1,1,1,2,1968,1969,1,-0.28,0.3,0.58,31,72,41,66,242,176,0.0,0.0,0.0,0.0,0.0,0.0
davib106,Bill Davis,San Diego Padres,PADRS,1,2,2,4,1969,1970,1,-0.17,0.16,0.33,66,87,21,122,263,141,0.0,0.0,0.0,7500.0,0.0,-7500.0
davib106,Bill Davis,St. Louis Cardinals,CARDS,1,2,1,3,1969,1969,0,0.0,0.0,0.0,0,0,0,0,0,0,0.0,0.0,0.0,0.0,0.0,0.0
davib107,Bill Davidson,Chicago Cubs,CUBS,1,3,1,4,1910,1912,2,-2.31,2.43,4.74,377,121,-256,1406,145,-1261,0.0,1039.0,1039.0,0.0,0.0,0.0
davic001,Chili Davis,Anaheim Angels,ANGELS,1,1,2,3,1996,1997,1,2.4,-0.6,-3.0,140,2,-138,567,0,-567,0.0,14.0,14.0,3800000.0,1600000.0,-2200000.0
davic003,Chris Davis,Texas Rangers,RNGRS,1,2,1,3,2011,2012,1,15.4,1.58,-13.82,1387,61,-1326,4679,0,-4679,1230.0,162.0,-1068.0,442160.0,3000000.0,2557840.0
davic103,Curt Davis,Philadelphia Phillies,PHILS,1,2,2,4,1936,1939,3,4.25,4.0,-0.25,195,450,255,507,1597,1090,830.0,231.0,-599.0,0.0,0.0,0.0
davic103,Curt Davis,Chicago Cubs,CUBS,1,4,1,5,1938,1938,0,10.27,2.49,-7.78,576,26,-550,361,27,-334,2894.0,224.0,-2670.0,0.0,0.0,0.0
davic103,Curt Davis,St. Louis Cardinals,CARDS,1,2,5,7,1940,1942,2,22.71,2.24,-20.47,811,200,-611,2272,485,-1787,3020.0,487.0,-2533.0,0.0,0.0,0.0
david002,Doug Davis,Milwaukee Brewers,BREWRS,2,4,4,8,2006,2008,2,5.76,-0.61,-6.37,192,321,129,188,507,319,1641.0,616.0,-1025.0,6600000.0,5417000.0,-1183000.0
david101,Dick Davis,Milwaukee Brewers,BREWRS,1,1,1,2,1981,1982,1,0.64,-1.38,-2.02,73,44,-29,177,0,-177,0.0,658.0,658.0,0.0,0.0,0.0
david101,Dick Davis,Philadelphia Phillies,PHILS,2,2,2,4,1982,1983,1,0.12,-0.15,-0.27,4,45,41,12,86,74,0.0,0.0,0.0,160000.0,0.0,-160000.0
david101,Dick Davis,Toronto Blue Jays,BJAYS,1,1,1,2,1982,1982,0,-0.62,-1.26,-0.64,39,72,33,86,197,111,0.0,0.0,0.0,0.0,0.0,0.0
david102,Dixie Davis,Philadelphia Phillies,PHILS,4,9,10,19,1919,1929,10,27.15,17.61,-9.54,1789,754,-1035,5788,2055,-3733,4451.0,3446.0,-1005.0,8500.0,19850.0,11350.0
david102,Dixie Davis,Louisville,Louisville,1,1,2,3,1920,1920,0,13.94,0.0,-13.94,426,0,-426,476,0,-476,3715.0,0.0,-3715.0,0.0,0.0,0.0
davie001,Eric Davis,Cincinnati Reds,REDS,7,10,14,24,1991,2006,15,9.83,13.67,3.84,1375,1603,228,1854,3165,1311,1702.0,3067.0,1365.0,19601333.0,9770833.0,-9830500.0
davie001,Eric Davis,Los Angeles Dodgers,DOGRS,2,2,2,4,1993,1994,1,0.31,-0.01,-0.32,62,6,-56,227,0,-227,26.0,16.0,-10.0,2000000.0,0.0,-2000000.0
davie002,Erik Davis,San Diego Padres,PADRS,1,2,1,3,2011,2011,0,0.1,-0.13,-0.23,20,102,82,0,267,267,26.0,0.0,-26.0,0.0,0.0,0.0
davig001,Glenn Davis,Houston Astros,ASTROS,17,33,42,75,1991,2008,17,96.08,55.99,-40.09,5446,6963,1517,12673,18369,5696,12589.0,8412.0,-4177.0,34919000.0,14229000.0,-20690000.0
davig102,George Davis,Cleveland Spiders,CL4,1,1,1,2,1893,1894,1,44.6,3.16,-41.44,1100,169,-931,4807,778,-4029,0.0,0.0,0.0,0.0,0.0,0.0
davih101,Harry Davis,New York Giants,GIANTS,1,2,1,3,1896,1897,1,2.13,1.45,-0.68,213,63,-150,903,270,-633,0.0,0.0,0.0,0.0,0.0,0.0
davih103,Harry Davis,Toledo,Toledo,1,1,2,3,1936,1937,1,0.27,0.0,-0.27,120,0,-120,527,0,-527,0.0,0.0,0.0,0.0,5000.0,5000.0
davih103,Harry Davis,St.Louis Browns,ORLS,1,1,1,2,1937,1938,1,0.0,-0.24,-0.24,0,6,6,0,6,6,0.0,46.0,46.0,4500.0,0.0,-4500.0
davii001,Ike Davis,New York Mets,METS,2,3,3,6,2014,2020,6,0.95,0.19,-0.76,209,16,-193,397,34,-363,190.0,0.0,-190.0,0.0,2212000.0,2212000.0
davii102,Ike Davis,Chicago White Sox,WSOX,5,17,8,25,1928,1936,8,4.13,-0.01,-4.14,711,811,100,2521,3083,562,0.0,39.0,39.0,28700.0,39000.0,10300.0
davij001,Jody Davis,New York Mets,METS,3,3,4,7,1979,1983,4,-1.38,0.13,1.51,103,92,-11,175,59,-116,0.0,110.0,110.0,0.0,0.0,0.0
davij001,Jody Davis,Chicago Cubs,CUBS,1,1,2,3,1988,1990,2,-1.32,-1.22,0.1,92,28,-64,296,13,-283,0.0,123.0,123.0,1108333.0,65000.0,-1043333.0
davij002,Joel Davis,Chicago White Sox,WSOX,1,2,1,3,1989,1989,0,0.24,0.81,0.57,9,66,57,0,229,229,99.0,0.0,-99.0,0.0,0.0,0.0
davij003,John Davis,Kansas City Royals,ROYALS,2,5,3,8,1987,1989,2,6.71,1.86,-4.85,503,45,-458,494,0,-494,4503.0,794.0,-3709.0,62500.0,930000.0,867500.0
davij004,J.J. Davis,Pittsburgh Pirates,PIRATS,1,1,1,2,2004,2004,0,-0.39,0.0,0.39,14,0,-14,28,0,-28,0.0,0.0,0.0,300000.0,0.0,-300000.0
davij004,J.J. Davis,Washington Nationals,NATEX,1,3,1,4,2005,2005,0,-0.93,0.4,1.33,16,68,52,9,280,271,74.0,0.0,-74.0,674000.0,12500000.0,11826000.0
davij005,Jason Davis,Cleveland Indians,INDINS,1,1,1,2,2007,2007,0,-0.42,0.0,0.42,21,0,-21,0,0,0,77.0,0.0,-77.0,670000.0,0.0,-670000.0
davij006,J.D. Davis,Houston Astros,ASTROS,1,2,3,5,2019,2019,0,2.03,0.0,-2.03,269,0,-269,893,0,-893,0.0,0.0,0.0,0.0,0.0,0.0
davij008,Jaylin Davis,Minnesota Twins,TWINS,1,3,1,4,2019,2019,0,-0.71,-0.29,0.42,26,15,-11,68,0,-68,0.0,34.0,34.0,0.0,5000000.0,5000000.0
davij103,Jim Davis,Chicago Cubs,CUBS,5,10,9,19,1956,1965,9,7.39,7.94,0.55,637,1087,450,1408,195,-1213,1395.0,2758.0,1363.0,0.0,0.0,0.0
davij104,Jacke Davis,Philadelphia Phillies,PHILS,1,1,1,2,1962,1962,0,0.0,0.0,0.0,0,0,0,0,0,0,0.0,0.0,0.0,0.0,0.0,0.0
davij104,Jacke Davis,Los Angeles Angels,ANGELS,1,1,1,2,1963,1963,0,0.0,0.59,0.59,0,60,60,0,227,227,0.0,0.0,0.0,0.0,0.0,0.0
davij104,Jacke Davis,New York Mets,METS,1,2,1,3,1963,1964,1,0.0,0.75,0.75,0,47,47,0,167,167,0.0,0.0,0.0,0.0,0.0,0.0
davik001,Kane Davis,Cleveland Indians,INDINS,3,6,5,11,2000,2007,7,13.63,7.12,-6.51,820,378,-442,2478,197,-2281,718.0,1361.0,643.0,5247000.0,9550000.0,4303000.0
davik001,Kane Davis,Milwaukee Brewers,BREWRS,2,4,5,9,2001,2004,3,0.49,3.61,3.12,225,470,245,5,59,54,355.0,808.0,453.0,1700000.0,0.0,-1700000.0
davik001,Kane Davis,Colorado Rockies,ROCKS,1,1,1,2,2002,2002,0,-0.32,0.0,0.32,32,0,-32,0,0,0,42.0,0.0,-42.0,0.0,0.0,0.0
davik002,Kyle Davies,Atlanta Braves,BRAVES,1,1,1,2,2007,2007,0,2.27,-0.08,-2.35,104,18,-86,8,0,-8,1593.0,23.0,-1570.0,0.0,5000000.0,5000000.0
davik003,Khris Davis,Milwaukee Brewers,BREWRS,1,1,2,3,2016,2021,5,7.32,0.75,-6.57,637,43,-594,2601,99,-2502,0.0,0.0,0.0,0.0,0.0,0.0
davik003,Khris Davis,Oakland Athletics,ATLTCS,1,3,3,6,2021,2021,0,-0.26,0.18,0.44,104,178,74,346,635,289,0.0,0.0,0.0,0.0,0.0,0.0
davik101,Kiddo Davis,Philadelphia Phillies,PHILS,6,8,7,15,1932,1938,6,3.83,2.02,-1.81,878,681,-197,1633,2179,546,1889.0,1053.0,-836.0,0.0,0.0,0.0
davik101,Kiddo Davis,New York Giants,GIANTS,4,13,6,19,1934,1949,15,8.93,67.35,58.42,1284,2487,1203,4538,9914,5376,296.0,0.0,-296.0,0.0,10500.0,10500.0
davik101,Kiddo Davis,St. Louis Cardinals,CARDS,1,1,1,2,1934,1934,0,1.16,-0.69,-1.85,100,69,-31,424,216,-208,0.0,0.0,0.0,0.0,0.0,0.0
davik101,Kiddo Davis,Philadelphia Phillies,PHILS,2,2,2,4,1934,1938,4,3.63,3.37,-0.26,486,292,-194,589,597,8,1889.0,1053.0,-836.0,0.0,0.0,0.0
davim001,Mark Davis,Philadelphia Phillies,PHILS,2,5,3,8,1982,1988,6,12.97,14.82,1.85,911,983,72,587,531,-56,5303.0,1684.0,-3619.0,0.0,1330000.0,1330000.0
davim001,Mark Davis,San Francisco Giants,GIANTS,5,11,14,25,1987,1998,11,21.11,35.92,14.81,1313,2149,836,1417,3377,1960,4080.0,4148.0,68.0,9727778.0,6966667.0,-2761111.0
davim001,Mark Davis,Kansas City Royals,ROYALS,1,1,1,2,1992,1992,0,-0.44,-0.51,-0.07,28,19,-9,1,0,-1,50.0,134.0,84.0,3625000.0,1200000.0,-2425000.0
davim001,Mark Davis,Atlanta Braves,BRAVES,1,1,1,2,1993,1993,0,-0.41,0.0,0.41,50,0,-50,3,0,-3,94.0,0.0,-94.0,0.0,0.0,0.0
davim003,Mark Davidson,Minnesota Twins,TWINS,1,1,1,2,1989,1989,0,-0.51,0.0,0.51,175,0,-175,371,0,-371,0.0,0.0,0.0,0.0,0.0,0.0
davim004,Mark Davis,Chicago White Sox,WSOX,8,15,20,35,1989,2011,22,8.04,34.84,26.8,949,1768,819,131,1458,1327,2956.0,4642.0,1686.0,22052500.0,11583333.0,-10469167.0
davim005,Matt Davidson,Arizona Diamondbacks,DBACKS,2,2,3,5,2013,2019,6,5.03,0.01,-5.02,528,264,-264,941,37,-904,435.0,676.0,241.0,4875000.0,520000.0,-4355000.0
davir001,Ron Davis,Chicago Cubs,CUBS,1,1,1,2,1978,1979,1,5.87,-0.14,-6.01,147,93,-54,2,57,55,875.0,512.0,-363.0,0.0,165000.0,165000.0
davir001,Ron Davis,New York Yankees,YANKS,10,16,17,33,1982,1997,15,48.99,20.71,-28.28,2747,1421,-1326,5735,2836,-2899,7707.0,4016.0,-3691.0,4250000.0,2812500.0,-1437500.0
davir001,Ron Davis,Minnesota Twins,TWINS,2,3,4,7,1986,1990,4,-0.88,-0.16,0.72,76,144,68,2,101,99,157.0,373.0,216.0,725000.0,873333.0,148333.0
davir002,Russ Davis,New York Yankees,YANKS,2,4,5,9,1995,2001,6,0.27,21.71,21.44,470,1323,853,1674,4002,2328,590.0,1102.0,512.0,234000.0,3400000.0,3166000.0
davir003,Rajai Davis,Pittsburgh Pirates,PIRATS,1,2,1,3,2007,2008,1,0.22,-1.2,-1.42,63,32,-31,181,31,-150,0.0,253.0,253.0,0.0,10037283.0,10037283.0
davir003,Rajai Davis,Oakland Athletics,ATLTCS,3,3,4,7,2010,2013,3,1.06,1.29,0.23,369,113,-256,1185,361,-824,62.0,82.0,20.0,1350000.0,436400.0,-913600.0
davir003,Rajai Davis,Oakland Athletics,ATLTCS,1,1,1,2,2017,2017,0,-0.05,0.0,0.05,17,0,-17,38,0,-38,0.0,0.0,0.0,6000000.0,0.0,-6000000.0
davir004,Rookie Davis,New York Yankees,YANKS,4,8,7,15,2015,2020,5,-1.49,8.03,9.52,440,197,-243,1007,8,-999,290.0,1270.0,980.0,3936900.0,21050000.0,17113100.0
davir102,Ron Davis,Houston Astros,ASTROS,3,4,4,8,1968,1970,2,0.52,-0.91,-1.43,57,214,157,102,233,131,43.0,477.0,434.0,23500.0,59500.0,36000.0
davir102,Ron Davis,St. Louis Cardinals,CARDS,3,8,6,14,1968,1972,4,11.85,2.24,-9.61,1182,243,-939,1248,521,-727,1854.0,299.0,-1555.0,17500.0,24000.0,6500.0
davir102,Ron Davis,San Diego Padres,PADRS,3,4,4,8,1969,1971,2,-1.24,2.5,3.74,167,452,285,311,1178,867,100.0,445.0,345.0,0.0,0.0,0.0
davis001,Storm Davis,Baltimore Orioles,ORLS,3,3,4,7,1986,1994,8,2.67,10.31,7.64,375,899,524,1012,1698,686,188.0,2337.0,2149.0,1160000.0,920000.0,-240000.0
davis001,Storm Davis,San Diego Padres,PADRS,1,1,2,3,1987,1990,3,2.97,0.04,-2.93,88,202,114,0,145,145,1392.0,296.0,-1096.0,605000.0,73133.0,-531867.0
davis001,Storm Davis,Kansas City Royals,ROYALS,1,1,1,2,1991,1992,1,1.4,0.32,-1.08,48,32,-16,0,77,77,268.0,0.0,-268.0,0.0,650000.0,650000.0
davis002,Steve Davis,Cleveland Indians,INDINS,1,1,2,3,1989,1989,0,0.0,0.0,0.0,0,0,0,0,0,0,0.0,0.0,0.0,0.0,0.0,0.0
davis101,Spud Davis,St. Louis Cardinals,CARDS,2,4,5,9,1928,1936,8,28.36,11.55,-16.81,2032,988,-1044,7440,3573,-3867,0.0,0.0,0.0,0.0,15000.0,15000.0
davis101,Spud Davis,Philadelphia Phillies,PHILS,1,2,1,3,1933,1940,7,4.53,0.74,-3.79,321,311,-10,1140,949,-191,0.0,0.0,0.0,0.0,0.0,0.0
davis101,Spud Davis,Cincinnati Reds,REDS,1,3,1,4,1938,1948,10,2.9,43.86,40.96,235,653,418,553,968,415,703.0,7065.0,6362.0,0.0,0.0,0.0
davit004,Taylor Davis,Baltimore Orioles,ORLS,1,1,1,2,2021,2021,0,0.08,0.0,-0.08,2,0,-2,6,0,-6,0.0,0.0,0.0,0.0,0.0,0.0
davit102,Ted Davidson,Cincinnati Reds,REDS,3,5,6,11,1968,1977,9,4.56,11.78,7.22,256,1321,1065,307,585,278,1267.0,4200.0,2933.0,0.0,0.0,0.0
davit103,Tommy Davis,Los Angeles Dodgers,DOGRS,6,9,10,19,1966,1972,6,27.49,11.4,-16.09,1888,711,-1177,5026,2330,-2696,1193.0,6.0,-1187.0,136500.0,38000.0,-98500.0
davit103,Tommy Davis,New York Mets,METS,2,5,4,9,1967,1974,7,2.47,11.88,9.41,357,948,591,832,3426,2594,1066.0,0.0,-1066.0,89000.0,31000.0,-58000.0
davit103,Tommy Davis,Seattle Pilots,BREWRS,2,2,4,6,1969,1972,3,-0.5,-1.08,-0.58,86,286,200,322,855,533,0.0,0.0,0.0,87000.0,12000.0,-75000.0
davit103,Tommy Davis,Chicago Cubs,CUBS,2,2,2,4,1972,1972,0,3.61,-0.19,-3.8,704,17,-687,2601,56,-2545,7.0,0.0,-7.0,25000.0,0.0,-25000.0
daviw001,Wade Davis,Tampa Bay Devil Rays,RAYS,8,14,20,34,2012,2020,8,32.69,16.85,-15.84,1967,1086,-881,5025,2972,-2053,4433.0,3274.0,-1159.0,15365300.0,6506400.0,-8858900.0
daviw001,Wade Davis,Kansas City Royals,ROYALS,2,2,2,4,2016,2021,5,2.88,1.39,-1.49,170,395,225,242,1580,1338,176.0,0.0,-176.0,16050000.0,3666667.0,-12383333.0
daviw102,Willie Davis,Los Angeles Dodgers,DOGRS,2,2,3,5,1973,1978,5,3.51,5.9,2.39,209,756,547,663,703,40,128.0,1433.0,1305.0,235000.0,0.0,-235000.0
daviw102,Willie Davis,Montreal Expos,NATEX,2,4,5,9,1974,1986,12,17.33,12.97,-4.36,1044,975,-69,2808,1449,-1359,744.0,4288.0,3544.0,110000.0,14000.0,-96000.0
daviw102,Willie Davis,Texas Rangers,RNGRS,1,1,2,3,1975,1976,1,1.54,-0.79,-2.33,98,15,-83,376,2,-374,0.0,63.0,63.0,0.0,0.0,0.0
daviw102,Willie Davis,St. Louis Cardinals,CARDS,2,2,2,4,1975,1976,1,1.7,0.0,-1.7,141,0,-141,522,0,-522,0.0,0.0,0.0,0.0,0.0,0.0
daviz001,Zach Davies,Baltimore Orioles,ORLS,1,1,1,2,2015,2015,0,8.07,-0.72,-8.79,223,55,-168,218,238,20,1843.0,0.0,-1843.0,0.0,6237500.0,6237500.0
daviz001,Zach Davies,Milwaukee Brewers,BREWRS,1,2,3,5,2019,2019,0,7.39,0.0,-7.39,203,0,-203,779,0,-779,208.0,0.0,-208.0,2600000.0,1118900.0,-1481100.0
daviz001,Zach Davies,San Diego Padres,PADRS,1,5,2,7,2020,2020,0,-0.94,0.0,0.94,63,0,-63,44,0,-44,444.0,0.0,-444.0,5250000.0,22000000.0,16750000.0
dawkt001,Travis Dawkins,Los Angeles Dodgers,DOGRS,1,1,2,3,2003,2003,0,-0.04,-0.09,-0.05,3,2,-1,3,1,-2,0.0,9.0,9.0,0.0,0.0,0.0
dawkt001,Travis Dawkins,Kansas City Royals,ROYALS,1,1,1,2,2004,2004,0,0.0,-0.15,-0.15,0,14,14,0,16,16,0.0,0.0,0.0,0.0,0.0,0.0
dawkt001,Travis Dawkins,Philadelphia Phillies,PHILS,1,1,1,2,2008,2008,0,0.0,0.0,0.0,0,0,0,0,0,0,0.0,0.0,0.0,0.0,0.0,0.0
dawlb001,Bill Dawley,Cincinnati Reds,REDS,2,5,3,8,1983,1989,6,5.92,4.25,-1.67,542,577,35,401,2023,1622,1019.0,0.0,-1019.0,117500.0,620000.0,502500.0
dawlb001,Bill Dawley,Chicago White Sox,WSOX,10,19,23,42,1986,2011,25,68.95,44.22,-24.73,3148,2784,-364,8811,5639,-3172,3371.0,6620.0,3249.0,22245000.0,12851333.0,-9393667.0
day-b101,Bill Day,Philadelphia Phillies,PHILS,1,3,1,4,1890,1890,0,-0.87,0.47,1.34,43,31,-12,162,139,-23,150.0,0.0,-150.0,0.0,0.0,0.0
day-b102,Boots Day,St. Louis Cardinals,CARDS,1,1,1,2,1969,1970,1,-0.21,0.11,0.32,11,12,1,8,3,-5,0.0,24.0,24.0,0.0,0.0,0.0
day-b102,Boots Day,Chicago Cubs,CUBS,1,1,1,2,1970,1970,0,1.88,0.48,-1.4,449,66,-383,1274,215,-1059,0.0,0.0,0.0,0.0,0.0,0.0
day-c101,Pea Ridge Day,Brooklyn Dodgers,DOGRS,1,1,1,2,1932,1932,0,0.0,-0.36,-0.36,0,64,64,0,226,226,0.0,0.0,0.0,0.0,0.0,0.0
day-z001,Zach Day,New York Yankees,YANKS,5,9,7,16,2000,2012,12,11.39,22.07,10.68,570,1540,970,441,4696,4255,3809.0,682.0,-3127.0,14660923.0,19005000.0,4344077.0
day-z001,Zach Day,Cleveland Indians,INDINS,4,5,6,11,2001,2013,12,25.47,16.42,-9.05,1444,1195,-249,5183,2962,-2221,1044.0,843.0,-201.0,404400.0,534000.0,129600.0
day-z001,Zach Day,Washington Nationals,NATEX,1,3,1,4,2005,2005,0,-0.93,0.4,1.33,16,68,52,9,280,271,74.0,0.0,-74.0,674000.0,12500000.0,11826000.0
dayeb001,Brian Dayett,New York Yankees,YANKS,11,23,25,48,1984,1995,11,5.94,31.24,25.3,1908,3078,1170,4328,8691,4363,2758.0,1911.0,-847.0,3498873.0,4760000.0,1261127.0
daylk001,Ken Dayley,Atlanta Braves,BRAVES,2,4,2,6,1984,1992,8,2.53,5.32,2.79,820,917,97,385,3026,2641,1122.0,0.0,-1122.0,725000.0,0.0,-725000.0
daytg001,Grant Dayton,Miami Marlins,MARLNS,1,1,1,2,2015,2018,3,0.57,0.0,-0.57,103,4,-99,1,0,-1,150.0,12.0,-138.0,0.0,0.0,0.0
dealc101,Cot Deal,Boston Red Sox,RSOX,1,1,1,2,1949,1949,0,-1.31,0.0,1.31,72,0,-72,22,0,-22,218.0,0.0,-218.0,0.0,0.0,0.0
dealc102,Charlie Deal,Chicago Cubs,CUBS,2,8,5,13,1921,1926,5,29.39,11.6,-17.79,1120,351,-769,4097,694,-3403,1929.0,2961.0,1032.0,13500.0,18700.0,5200.0
deana001,Austin Dean,Miami Marlins,MARLNS,1,1,1,2,2020,2020,0,0.03,0.0,-0.03,25,0,-25,45,0,-45,0.0,0.0,0.0,0.0,0.0,0.0
deand102,Dizzy Dean,St. Louis Cardinals,CARDS,3,5,10,15,1938,1942,4,31.65,12.49,-19.16,1205,794,-411,2511,848,-1663,5245.0,3418.0,-1827.0,0.0,0.0,0.0
deanp101,Paul Dean,New York Giants,GIANTS,1,3,1,4,1941,1941,0,6.28,-0.7,-6.98,205,44,-161,186,32,-154,1502.0,319.0,-1183.0,0.0,0.0,0.0
deant101,Tommy Dean,Los Angeles Dodgers,DOGRS,1,2,1,3,1969,1970,1,-3.36,0.06,3.42,214,64,-150,569,4,-565,47.0,148.0,101.0,0.0,0.0,0.0
deanw101,Wayland Dean,Louisville,Louisville,1,1,1,2,1924,1924,0,-0.79,0.0,0.79,118,0,-118,96,0,-96,831.0,0.0,-831.0,0.0,0.0,0.0
deanw101,Wayland Dean,New York Giants,GIANTS,5,8,6,14,1925,1932,7,44.2,17.47,-26.73,1941,1197,-744,7676,4275,-3401,795.0,550.0,-245.0,27600.0,44000.0,16400.0
deaza001,Alejandro de Aza,Chicago White Sox,WSOX,1,1,2,3,2014,2014,0,0.28,0.0,-0.28,50,0,-50,201,0,-201,0.0,0.0,0.0,4250000.0,0.0,-4250000.0
deaza001,Alejandro de Aza,Baltimore Orioles,ORLS,1,2,1,3,2015,2015,0,1.11,0.0,-1.11,60,0,-60,178,0,-178,0.0,0.0,0.0,0.0,0.0,0.0
deaza001,Alejandro de Aza,Boston Red Sox,RSOX,1,1,1,2,2015,2015,0,-0.25,0.0,0.25,24,0,-24,75,0,-75,0.0,0.0,0.0,5000000.0,0.0,-5000000.0
debad101,Dennis DeBarr,Toronto Blue Jays,BJAYS,3,3,4,7,1978,1992,14,1.35,15.16,13.81,41,1283,1242,163,4027,3864,0.0,519.0,519.0,0.0,0.0,0.0
debad101,Dennis DeBarr,Cleveland Indians,INDINS,1,1,1,2,1978,1979,1,0.0,0.9,0.9,0,36,36,0,0,0,0.0,405.0,405.0,0.0,0.0,0.0
debeh101,Hank DeBerry,Brooklyn Dodgers,DOGRS,8,19,13,32,1931,1948,17,60.59,33.88,-26.71,3224,2883,-341,11104,10453,-651,2159.0,791.0,-1368.0,10000.0,10000.0,0.0
decaa101,Art Decatur,Brooklyn Dodgers,DOGRS,4,10,4,14,1925,1934,9,-0.65,8.73,9.38,212,888,676,179,3061,2882,1356.0,260.0,-1096.0,35250.0,17000.0,-18250.0
decaa101,Art Decatur,Philadelphia Phillies,PHILS,5,9,9,18,1928,1940,12,39.18,41.3,2.12,1904,2696,792,7415,9869,2454,0.0,0.0,0.0,21000.0,7500.0,-13500.0
decid001,Doug DeCinces,Baltimore Orioles,ORLS,1,2,1,3,1982,1983,1,18.92,1.8,-17.12,787,226,-561,3268,901,-2367,0.0,0.0,0.0,0.0,0.0,0.0
deckj001,Jaff Decker,San Diego Padres,PADRS,2,3,2,5,2013,2019,6,1.1,0.61,-0.49,248,107,-141,694,312,-382,3.0,0.0,-3.0,0.0,0.0,0.0
deckj101,Joe Decker,Chicago Cubs,CUBS,2,5,2,7,1972,1976,4,12.2,0.19,-12.01,299,239,-60,0,36,36,2874.0,554.0,-2320.0,72500.0,25000.0,-47500.0
deckm101,Marty Decker,Philadelphia Phillies,PHILS,1,4,2,6,1983,1984,1,4.33,2.1,-2.23,526,139,-387,92,339,247,1500.0,17.0,-1483.0,0.0,0.0,0.0
dedmj001,Jeff Dedmon,Atlanta Braves,BRAVES,1,1,1,2,1988,1988,0,0.04,0.0,-0.04,21,0,-21,0,0,0,101.0,0.0,-101.0,0.0,0.0,0.0
deerj101,John Deering,Detroit Tigers,TIGRS,1,1,1,2,1903,1903,0,0.23,-0.15,-0.38,18,1,-17,23,3,-20,180.0,0.0,-180.0,0.0,0.0,0.0
deerr001,Rob Deer,San Francisco Giants,GIANTS,1,1,2,3,1985,1985,0,6.86,0.0,-6.86,667,0,-667,2711,0,-2711,0.0,0.0,0.0,0.0,0.0,0.0
deesc101,Charlie Dees,San Francisco Giants,GIANTS,1,1,1,2,1963,1963,0,-0.82,0.0,0.82,98,0,-98,288,0,-288,0.0,0.0,0.0,0.0,0.0,0.0
defrj001,Justin De Fratus,Seattle Mariners,MARNRS,1,1,1,2,2016,2016,0,0.0,0.0,0.0,0,0,0,0,0,0,0.0,0.0,0.0,0.0,0.0,0.0
deicg001,Greg Deichmann,Oakland Athletics,ATLTCS,1,2,1,3,2021,2021,0,-0.36,1.44,1.8,14,29,15,31,0,-31,0.0,88.0,88.0,0.0,2250000.0,2250000.0
dejam101,Mike Dejan,Washington Senators,TWINS,1,1,2,3,1940,1940,0,-0.07,0.0,0.07,12,0,-12,19,0,-19,0.0,0.0,0.0,0.0,0.0,0.0
dejed001,David DeJesus,Kansas City Royals,ROYALS,2,3,4,7,2010,2015,5,2.28,-1.02,-3.3,251,29,-222,513,7,-506,252.0,223.0,-29.0,4700000.0,0.0,-4700000.0
dejed001,David DeJesus,Washington Nationals,NATEX,1,1,1,2,2013,2013,0,1.66,0.0,-1.66,200,0,-200,647,0,-647,0.0,0.0,0.0,0.0,0.0,0.0
dejed001,David DeJesus,Tampa Bay Devil Rays,RAYS,1,1,1,2,2015,2015,0,-0.65,0.0,0.65,30,0,-30,60,0,-60,0.0,0.0,0.0,0.0,0.0,0.0
dejei001,Ivan De Jesus,Los Angeles Dodgers,DOGRS,2,4,4,8,1977,1984,7,15.47,7.3,-8.17,1806,765,-1041,7323,1796,-5527,184.0,243.0,59.0,0.0,0.0,0.0
dejei001,Ivan De Jesus,Chicago Cubs,CUBS,1,1,2,3,1982,1996,14,2.92,68.77,65.85,463,2510,2047,1655,10525,8870,0.0,0.0,0.0,0.0,0.0,0.0
dejei001,Ivan De Jesus,Philadelphia Phillies,PHILS,1,2,1,3,1985,1986,1,-0.41,-0.15,0.26,159,118,-41,87,15,-72,193.0,313.0,120.0,0.0,0.0,0.0
dejei002,Ivan De Jesus,Boston Red Sox,RSOX,1,4,2,6,2012,2019,7,7.63,8.07,0.44,566,624,58,6,2223,2217,907.0,22.0,-885.0,521000.0,4100000.0,3579000.0
dejei002,Ivan De Jesus,Los Angeles Dodgers,DOGRS,5,22,14,36,2012,2021,9,4.41,31.13,26.72,1016,1541,525,2843,5562,2719,1152.0,835.0,-317.0,78709000.0,90253480.0,11544480.0
dejei002,Ivan De Jesus,Baltimore Orioles,ORLS,1,2,2,4,2014,2014,0,0.24,-0.08,-0.32,17,19,2,41,45,4,0.0,0.0,0.0,515000.0,0.0,-515000.0
dejej001,Jose De Jesus,Kansas City Royals,ROYALS,1,1,1,2,1990,1990,0,3.18,-0.71,-3.89,106,74,-32,114,114,0,935.0,0.0,-935.0,0.0,0.0,0.0
dejem001,Mike DeJean,New York Yankees,YANKS,1,1,1,2,1995,1999,4,3.76,1.56,-2.2,517,379,-138,13,1412,1399,884.0,0.0,-884.0,0.0,1850000.0,1850000.0
dejem001,Mike DeJean,Colorado Rockies,ROCKS,3,5,5,10,2001,2002,1,3.56,0.31,-3.25,524,189,-335,63,5,-58,907.0,301.0,-606.0,0.0,0.0,0.0
dejem001,Mike DeJean,Milwaukee Brewers,BREWRS,1,1,2,3,2003,2004,1,0.18,0.23,0.05,36,18,-18,0,0,0,54.0,28.0,-26.0,1700000.0,0.0,-1700000.0
dejem001,Mike DeJean,Baltimore Orioles,ORLS,1,1,1,2,2004,2004,0,0.3,-0.72,-1.02,88,23,-65,0,73,73,141.0,0.0,-141.0,1500000.0,800000.0,-700000.0
dejoc001,Chase De Jong,Toronto Blue Jays,BJAYS,1,2,1,3,2015,2015,0,0.08,0.0,-0.08,21,0,-21,15,0,-15,0.0,0.0,0.0,0.0,0.0,0.0
dejoc001,Chase De Jong,Los Angeles Dodgers,DOGRS,3,4,7,11,2017,2021,4,1.11,1.7,0.59,140,258,118,0,6,6,277.0,419.0,142.0,0.0,0.0,0.0
dejoc001,Chase De Jong,Seattle Mariners,MARNRS,1,2,2,4,2018,2018,0,0.01,-0.01,-0.02,6,28,22,0,0,0,56.0,44.0,-12.0,0.0,2150000.0,2150000.0
delaa101,Art Delaney,Boston Braves,BRAVES,2,4,3,7,1929,1938,9,1.82,35.74,33.92,75,1097,1022,255,4575,4320,0.0,229.0,229.0,27000.0,0.0,-27000.0
delaa101,Art Delaney,St. Louis Cardinals,CARDS,1,5,1,6,1924,1925,1,0.0,0.0,0.0,0,0,0,0,0,0,0.0,0.0,0.0,0.0,0.0,0.0
delab001,Bryan De La Cruz,Houston Astros,ASTROS,1,2,1,3,2021,2021,0,1.08,-0.33,-1.41,66,26,-40,219,0,-219,14.0,64.0,50.0,0.0,1900000.0,1900000.0
delad001,Dane de la Rosa,Tampa Bay Devil Rays,RAYS,1,1,1,2,2013,2016,3,1.24,0.17,-1.07,84,113,29,0,0,0,224.0,307.0,83.0,0.0,0.0,0.0
delae001,Eulogio de la Cruz,Detroit Tigers,TIGRS,2,8,3,11,2007,2010,3,-0.1,-1.19,-1.09,705,27,-678,1077,3,-1074,1506.0,303.0,-1203.0,12380000.0,13850000.0,1470000.0
delaf001,Francisco de la Rosa,Baltimore Orioles,ORLS,1,2,1,3,1992,1998,6,0.0,6.46,6.46,0,315,315,0,0,0,0.0,1327.0,1327.0,0.0,0.0,0.0
delaf101,Frank Delahanty,New York Yankees,YANKS,1,2,1,3,1907,1907,0,-0.75,-1.19,-0.44,53,24,-29,88,22,-66,288.0,180.0,-108.0,0.0,0.0,0.0
delaj001,Jorge de la Rosa,Boston Red Sox,RSOX,1,4,1,5,2003,2008,5,0.73,17.72,16.99,728,123,-605,51,11,-40,1381.0,2025.0,644.0,634000.0,10000000.0,9366000.0
delaj001,Jorge de la Rosa,Arizona Diamondbacks,DBACKS,1,6,3,9,2003,2005,2,15.82,-0.12,-15.94,1881,61,-1820,5048,104,-4944,2593.0,37.0,-2556.0,3548667.0,5425000.0,1876333.0
delaj001,Jorge de la Rosa,Milwaukee Brewers,BREWRS,1,1,1,2,2006,2007,1,0.15,2.81,2.66,39,146,107,5,521,516,536.0,0.0,-536.0,337000.0,2050000.0,1713000.0
delaj001,Jorge de la Rosa,Kansas City Royals,ROYALS,2,2,2,4,2008,2009,1,16.05,3.8,-12.25,529,125,-404,399,215,-184,3760.0,215.0,-3545.0,397000.0,5083333.0,4686333.0
delaj002,Jose de la Torre,Cleveland Indians,INDINS,1,1,1,2,2012,2012,0,-0.13,-0.07,0.06,7,43,36,0,123,123,34.0,0.0,-34.0,0.0,500000.0,500000.0
delaj103,Jim Delahanty,Boston Braves,BRAVES,3,5,7,12,1906,1911,5,21.78,13.27,-8.51,936,1115,179,3703,3822,119,0.0,1733.0,1733.0,0.0,0.0,0.0
delaj103,Jim Delahanty,Washington Senators,TWINS,1,1,2,3,1909,1916,7,7.92,6.2,-1.72,375,528,153,1583,1839,256,0.0,2.0,2.0,0.0,0.0,0.0
delam101,Miguel de la Hoz,Cleveland Indians,INDINS,1,1,1,2,1964,1968,4,0.66,1.17,0.51,304,484,180,660,1408,748,0.0,0.0,0.0,0.0,0.0,0.0
delam101,Miguel de la Hoz,Atlanta Braves,BRAVES,1,1,1,2,1969,1969,0,0.0,0.0,0.0,1,0,-1,1,0,-1,0.0,0.0,0.0,0.0,0.0,0.0
delar001,Roland DeLaMaza,Cleveland Indians,INDINS,1,1,1,2,1997,1997,0,0.01,0.19,0.18,1,23,22,0,96,96,6.0,0.0,-6.0,0.0,1950000.0,1950000.0
delar002,Rob Delaney,Baltimore Orioles,ORLS,1,1,1,2,2013,2013,0,0.0,0.02,0.02,0,9,9,0,24,24,0.0,0.0,0.0,0.0,0.0,0.0
delar003,Rubby de la Rosa,Los Angeles Dodgers,DOGRS,5,22,14,36,2012,2021,9,4.41,31.13,26.72,1016,1541,525,2843,5562,2719,1152.0,835.0,-317.0,78709000.0,90253480.0,11544480.0
delar003,Rubby de la Rosa,Boston Red Sox,RSOX,3,6,4,10,2014,2019,5,1.08,2.41,1.33,219,69,-150,105,2,-103,1466.0,676.0,-790.0,3666000.0,523500.0,-3142500.0
delas001,Steve Delabar,Seattle Mariners,MARNRS,3,3,3,6,2012,2017,5,0.53,0.24,-0.29,150,54,-96,0,135,135,429.0,187.0,-242.0,480700.0,485900.0,5200.0
delcm001,Manny Delcarmen,Boston Red Sox,RSOX,1,2,1,3,2010,2010,0,-0.13,0.0,0.13,18,0,-18,1,0,-1,25.0,0.0,-25.0,905000.0,0.0,-905000.0
delej001,Jose DeLeon,Pittsburgh Pirates,PIRATS,1,1,1,2,1986,1991,5,5.26,20.39,15.13,138,843,705,0,3485,3485,1290.0,0.0,-1290.0,1825000.0,115000.0,-1710000.0
delej001,Jose DeLeon,Chicago White Sox,WSOX,4,5,8,13,1988,1995,7,7.31,21.81,14.5,486,1116,630,375,3946,3571,3561.0,856.0,-2705.0,1847500.0,778000.0,-1069500.0
delej001,Jose DeLeon,Philadelphia Phillies,PHILS,1,1,1,2,1993,1993,0,1.58,-0.28,-1.86,92,34,-58,0,1,1,435.0,58.0,-377.0,275000.0,3416667.0,3141667.0
delej001,Jose DeLeon,Chicago White Sox,WSOX,1,1,1,2,1995,1995,0,-0.11,-0.11,0.0,14,9,-5,2,0,-2,25.0,29.0,4.0,705000.0,325000.0,-380000.0
delej003,Jose De Leon,Los Angeles Dodgers,DOGRS,2,4,2,6,2017,2018,1,0.72,1.62,0.9,74,236,162,205,820,615,229.0,0.0,-229.0,9000000.0,9000000.0,0.0
delej003,Jose De Leon,Tampa Bay Devil Rays,RAYS,1,1,1,2,2019,2019,0,-0.93,0.0,0.93,23,0,-23,5,0,-5,73.0,0.0,-73.0,558000.0,0.0,-558000.0
delel001,Luis DeLeon,St. Louis Cardinals,CARDS,1,3,3,6,1982,1992,10,19.37,59.81,40.44,1893,1695,-198,5833,6828,995,883.0,553.0,-330.0,0.0,0.0,0.0
delgb101,Bobby Del Greco,Pittsburgh Pirates,PIRATS,1,2,1,3,1956,1965,9,0.09,18.14,18.05,108,1409,1301,317,5853,5536,29.0,0.0,-29.0,0.0,10000.0,10000.0
delgb101,Bobby Del Greco,St. Louis Cardinals,CARDS,2,3,2,5,1957,1958,1,0.52,-0.27,-0.79,98,41,-57,124,86,-38,94.0,0.0,-94.0,0.0,0.0,0.0
delgb101,Bobby Del Greco,Philadelphia Phillies,PHILS,2,2,2,4,1961,1966,5,1.55,4.69,3.14,336,601,265,1049,1683,634,0.0,0.0,0.0,0.0,0.0,0.0
delgc001,Carlos Delgado,Florida Marlins,MARLNS,4,5,7,12,2005,2012,7,5.44,-2.44,-7.88,820,896,76,2563,1545,-1018,767.0,1030.0,263.0,7995000.0,2905000.0,-5090000.0
delgj001,Jesus Delgado,Boston Red Sox,RSOX,14,38,25,63,2005,2019,14,93.01,61.11,-31.9,5581,3052,-2529,12204,8864,-3340,8381.0,6378.0,-2003.0,13099733.0,30982000.0,17882267.0
delgp101,Puchy Delgado,Seattle Mariners,MARNRS,3,8,8,16,1979,1985,6,8.79,3.44,-5.35,489,639,150,632,1953,1321,2623.0,1017.0,-1606.0,175000.0,512500.0,337500.0
delgr001,Randall Delgado,Atlanta Braves,BRAVES,4,10,11,21,2013,2019,6,22.68,8.16,-14.52,2194,1203,-991,6430,4358,-2072,1394.0,147.0,-1247.0,14250000.0,0.0,-14250000.0
delgw001,Wilson Delgado,Seattle Mariners,MARNRS,1,2,1,3,1995,1997,2,9.08,-0.25,-9.33,394,28,-366,492,0,-492,2970.0,373.0,-2597.0,0.0,0.0,0.0
delgw001,Wilson Delgado,San Francisco Giants,GIANTS,1,1,1,2,2000,2000,0,-0.01,-0.24,-0.23,31,11,-20,51,13,-38,0.0,0.0,0.0,0.0,0.0,0.0
delgw001,Wilson Delgado,New York Yankees,YANKS,1,1,1,2,2000,2000,0,0.59,0.0,-0.59,47,0,-47,118,0,-118,0.0,0.0,0.0,213000.0,0.0,-213000.0
delgw001,Wilson Delgado,St. Louis Cardinals,CARDS,1,1,1,2,2004,2005,1,0.72,-1.41,-2.13,42,132,90,147,284,137,0.0,0.0,0.0,0.0,0.0,0.0
delke101,Eddie Delker,Philadelphia Phillies,PHILS,1,2,1,3,1933,1940,7,4.53,0.74,-3.79,321,311,-10,1140,949,-191,0.0,0.0,0.0,0.0,0.0,0.0
delld001,David Dellucci,Arizona Diamondbacks,DBACKS,1,3,2,5,2003,2003,0,-0.2,0.48,0.68,53,45,-8,58,183,125,91.0,0.0,-91.0,1200000.0,13000000.0,11800000.0
delld001,David Dellucci,Texas Rangers,RNGRS,1,1,2,3,2006,2008,2,0.74,-0.83,-1.57,132,42,-90,301,7,-294,0.0,525.0,525.0,0.0,0.0,0.0
delmn001,Nicky Delmonico,Baltimore Orioles,ORLS,1,1,1,2,2013,2013,0,0.0,0.01,0.01,0,29,29,0,0,0,0.0,66.0,66.0,0.0,0.0,0.0
deloa001,Abel de los Santos,Texas Rangers,RNGRS,1,2,1,3,2014,2015,1,0.0,-1.13,-1.13,4,18,14,0,0,0,5.0,129.0,124.0,0.0,3000000.0,3000000.0
deloe001,Enyel De Los Santos,Seattle Mariners,MARNRS,2,3,3,6,2015,2016,1,1.44,-0.13,-1.57,26,49,23,0,0,0,71.0,128.0,57.0,0.0,8000000.0,8000000.0
deloe001,Enyel De Los Santos,San Diego Padres,PADRS,1,1,1,2,2017,2018,1,-0.8,1.85,2.65,74,162,88,6,656,650,174.0,0.0,-174.0,0.0,4350000.0,4350000.0
delof001,Fautino de los Santos,Chicago White Sox,WSOX,2,5,4,9,2008,2011,3,24.92,-0.88,-25.8,1177,181,-996,4107,638,-3469,1718.0,20.0,-1698.0,3600000.0,1165000.0,-2435000.0
delof001,Fautino de los Santos,Oakland Athletics,ATLTCS,1,1,1,2,2012,2013,1,0.0,0.32,0.32,0,27,27,0,93,93,0.0,0.0,0.0,482500.0,700000.0,217500.0
delsj101,Jim Delsing,Chicago White Sox,WSOX,1,1,1,2,1948,1950,2,0.07,0.11,0.04,21,84,63,33,277,244,0.0,0.0,0.0,0.0,0.0,0.0
delsj101,Jim Delsing,New York Yankees,YANKS,2,8,4,12,1950,1954,4,21.38,0.72,-20.66,1235,437,-798,2252,180,-2072,6559.0,1785.0,-4774.0,29000.0,8500.0,-20500.0
delsj101,Jim Delsing,St.Louis Browns,ORLS,8,14,16,30,1952,1960,8,32.49,23.42,-9.07,2082,1835,-247,5453,4904,-549,5614.0,2626.0,-2988.0,41000.0,25800.0,-15200.0
delsj101,Jim Delsing,Detroit Tigers,TIGRS,1,2,3,5,1956,1957,1,0.97,-0.45,-1.42,230,140,-90,562,387,-175,0.0,0.0,0.0,0.0,11000.0,11000.0
delsj101,Jim Delsing,Detroit Tigers,TIGRS,2,5,4,9,1958,1960,2,-1.58,7.47,9.05,379,604,225,1361,2163,802,0.0,0.0,0.0,7000.0,9500.0,2500.0
delsj101,Jim Delsing,Washington Senators,TWINS,1,1,2,3,1959,1959,0,0.0,0.0,0.0,0,0,0,0,0,0,0.0,0.0,0.0,0.0,0.0,0.0
delur001,Rich DeLucia,St. Louis Cardinals,CARDS,6,11,12,23,1995,2004,9,7.92,19.88,11.96,1477,1521,44,4061,3047,-1014,1672.0,2465.0,793.0,14938333.0,17095281.0,2156948.0
delur001,Rich DeLucia,San Francisco Giants,GIANTS,1,1,1,2,1997,1997,0,2.02,0.0,-2.02,98,0,-98,0,0,0,342.0,0.0,-342.0,625000.0,0.0,-625000.0
demaa101,Al Demaree,New York Giants,GIANTS,1,3,1,4,1915,1915,0,8.83,1.16,-7.67,856,106,-750,2811,431,-2380,1477.0,0.0,-1477.0,0.0,0.0,0.0
demaa101,Al Demaree,Philadelphia Phillies,PHILS,1,1,2,3,1917,1917,0,2.22,-0.19,-2.41,48,56,8,45,40,-5,423.0,388.0,-35.0,0.0,0.0,0.0
demaa101,Al Demaree,Chicago Cubs,CUBS,2,2,2,4,1917,1919,2,5.43,2.39,-3.04,362,196,-166,1143,734,-409,667.0,0.0,-667.0,0.0,0.0,0.0
demab101,Billy DeMars,Philadelphia Athletics,ATLTCS,36,79,78,157,1949,1976,27,93.22,74.94,-18.28,10595,9460,-1135,25786,29262,3476,12563.0,7417.0,-5146.0,500300.0,639500.0,139200.0
demac001,Chris Demaria,Kansas City Royals,ROYALS,1,1,1,2,2005,2005,0,-0.18,0.0,0.18,20,0,-20,0,0,0,41.0,0.0,-41.0,0.0,0.0,0.0
demaf102,Frank Demaree,Chicago Cubs,CUBS,4,7,6,13,1938,1943,5,18.58,4.9,-13.68,1563,631,-932,5453,2299,-3154,405.0,0.0,-405.0,33000.0,21000.0,-12000.0
demaj101,Joe DeMaestri,Chicago White Sox,WSOX,2,6,4,10,1951,1963,12,1.43,25.02,23.59,363,1422,1059,910,5079,4169,614.0,0.0,-614.0,0.0,0.0,0.0
demaj101,Joe DeMaestri,St.Louis Browns,ORLS,1,2,2,4,1952,1954,2,-0.79,-0.8,-0.01,24,89,65,20,141,121,48.0,0.0,-48.0,19250.0,0.0,-19250.0
demaj101,Joe DeMaestri,Chicago White Sox,WSOX,4,11,8,19,1953,1961,8,18.88,11.66,-7.22,2482,1258,-1224,8241,3866,-4375,2246.0,488.0,-1758.0,62000.0,80000.0,18000.0
demaj101,Joe DeMaestri,Kansas City Athletics,ATLTCS,23,46,43,89,1959,1976,17,99.11,44.56,-54.55,8270,5153,-3117,21179,15408,-5771,8728.0,3756.0,-4972.0,440600.0,542000.0,101400.0
demed101,Don Demeter,Los Angeles Dodgers,DOGRS,2,3,3,6,1961,1962,1,7.87,-0.43,-8.3,525,100,-425,2040,21,-2019,0.0,267.0,267.0,6000.0,0.0,-6000.0
demed101,Don Demeter,Philadelphia Phillies,PHILS,5,10,12,22,1963,1979,16,31.38,66.18,34.8,2079,2296,217,6720,6242,-478,3363.0,10159.0,6796.0,74500.0,119800.0,45300.0
demed101,Don Demeter,Detroit Tigers,TIGRS,1,2,2,4,1966,1970,4,1.01,15.29,14.28,93,323,230,284,412,128,0.0,2887.0,2887.0,0.0,0.0,0.0
demed101,Don Demeter,Boston Red Sox,RSOX,1,2,1,3,1967,1968,1,7.67,2.77,-4.9,564,128,-436,2155,127,-2028,0.0,1094.0,1094.0,17000.0,24000.0,7000.0
demes001,Sam Demel,Oakland Athletics,ATLTCS,2,3,3,6,2010,2011,1,-1.42,0.36,1.78,153,120,-33,22,437,415,191.0,0.0,-191.0,3200000.0,3100000.0,-100000.0
demes101,Steve Demeter,Detroit Tigers,TIGRS,1,1,1,2,1960,1974,14,-0.16,51.66,51.82,4,2018,2014,5,7776,7771,0.0,0.0,0.0,0.0,0.0,0.0
demet001,Travis Demeritte,Texas Rangers,RNGRS,1,1,2,3,2016,2017,1,0.0,0.05,0.05,0,35,35,0,0,0,0.0,137.0,137.0,0.0,0.0,0.0
demet001,Travis Demeritte,Atlanta Braves,BRAVES,1,2,1,3,2019,2021,2,-1.28,0.82,2.1,67,117,50,219,0,-219,3.0,208.0,205.0,0.0,4000000.0,4000000.0
demmr101,Ray Demmitt,New York Yankees,YANKS,1,2,1,3,1909,1909,0,6.01,0.0,-6.01,373,0,-373,970,0,-970,1597.0,0.0,-1597.0,0.0,0.0,0.0
demog101,Gene DeMontreville,Washington Senators,WSN,2,4,6,10,1897,1900,3,18.96,3.72,-15.24,481,583,102,1837,2412,575,1122.0,0.0,-1122.0,0.0,0.0,0.0
demog101,Gene DeMontreville,Baltimore Orioles,BLN,1,1,1,2,1899,1899,0,1.39,0.0,-1.39,82,0,-82,346,0,-346,0.0,0.0,0.0,0.0,0.0,0.0
demog101,Gene DeMontreville,Chicago Cubs,CUBS,1,1,1,2,1899,1904,5,0.82,0.51,-0.31,60,59,-1,257,232,-25,0.0,0.0,0.0,0.0,0.0,0.0
demog101,Gene DeMontreville,Baltimore Orioles,BLN,1,2,1,3,1899,1906,7,-0.36,0.13,0.49,87,2,-85,281,8,-273,204.0,0.0,-204.0,0.0,0.0,0.0
dempr001,Rick Dempsey,Minnesota Twins,TWINS,2,2,2,4,1972,1980,8,1.08,2.89,1.81,159,539,380,367,1671,1304,0.0,0.0,0.0,9000.0,0.0,-9000.0
dempr001,Rick Dempsey,New York Yankees,YANKS,12,22,23,45,1976,1997,21,98.9,27.78,-71.12,5024,1689,-3335,9897,2906,-6991,18250.0,6192.0,-12058.0,4415000.0,2812500.0,-1602500.0
dempr002,Ryan Dempster,Texas Rangers,RNGRS,1,2,1,3,1996,1999,3,5.47,5.31,-0.16,331,108,-223,288,10,-278,2639.0,1801.0,-838.0,0.0,3550000.0,3550000.0
dempr002,Ryan Dempster,Florida Marlins,MARLNS,5,11,11,22,2002,2005,3,-4.59,11.03,15.62,421,1032,611,816,2465,1649,1364.0,1834.0,470.0,12425000.0,15962500.0,3537500.0
dempr002,Ryan Dempster,Chicago Cubs,CUBS,1,1,2,3,2012,2016,4,0.17,0.0,-0.17,12,0,-12,0,0,0,207.0,0.0,-207.0,14000000.0,0.0,-14000000.0
dendm001,Matt den Dekker,New York Mets,METS,1,1,1,2,2015,2018,3,0.77,2.89,2.12,74,425,351,149,3,-146,0.0,416.0,416.0,0.0,0.0,0.0
deneb101,Bill Denehy,New York Mets,METS,1,2,1,3,1967,1967,0,-0.14,0.0,0.14,6,0,-6,0,0,0,6.0,0.0,-6.0,8000.0,0.0,-8000.0
deneb101,Bill Denehy,Washington Senators,RNGRS,1,2,1,3,1969,1970,1,0.0,1.6,1.6,0,167,167,0,535,535,0.0,0.0,0.0,0.0,0.0,0.0
deneb101,Bill Denehy,New York Mets,METS,1,2,1,3,1971,1971,0,0.49,0.0,-0.49,124,0,-124,28,0,-28,416.0,0.0,-416.0,0.0,0.0,0.0
deneb101,Bill Denehy,Detroit Tigers,TIGRS,4,4,4,8,1971,1973,2,0.39,1.92,1.53,72,72,0,148,3,-145,36.0,356.0,320.0,0.0,0.0,0.0
denkt001,Travis Denker,Los Angeles Dodgers,DOGRS,1,1,1,2,2007,2008,1,0.11,-1.0,-1.11,24,128,104,42,142,100,0.0,0.0,0.0,0.0,900000.0,900000.0
dennd101,Don Dennis,St. Louis Cardinals,CARDS,1,2,2,4,1966,1967,1,2.36,-0.3,-2.66,603,24,-579,1918,71,-1847,0.0,0.0,0.0,9000.0,30000.0,21000.0
dennj001,John Denny,St. Louis Cardinals,CARDS,1,2,1,3,1979,1980,1,5.72,-0.43,-6.15,56,86,30,0,270,270,1178.0,0.0,-1178.0,0.0,0.0,0.0
dennj001,John Denny,Cleveland Indians,INDINS,2,3,5,8,1982,1988,6,18.1,2.33,-15.77,276,149,-127,246,0,-246,3118.0,1599.0,-1519.0,0.0,0.0,0.0
dennj001,John Denny,Philadelphia Phillies,PHILS,2,3,4,7,1985,1987,2,4.94,1.72,-3.22,271,272,1,922,426,-496,542.0,530.0,-12.0,1109333.0,1060833.0,-48500.0
denoc001,Chris Denorfia,Cincinnati Reds,REDS,1,1,2,3,2007,2008,1,0.33,-0.06,-0.39,33,44,11,73,0,-73,0.0,59.0,59.0,0.0,0.0,0.0
denoc001,Chris Denorfia,San Diego Padres,PADRS,6,7,11,18,2014,2021,7,7.75,2.2,-5.55,614,468,-146,1581,617,-964,1057.0,783.0,-274.0,3900000.0,17468125.0,13568125.0
dentb001,Bucky Dent,Chicago White Sox,WSOX,5,9,13,22,1977,1997,20,14.82,36.25,21.43,1260,2444,1184,3433,7568,4135,1605.0,4459.0,2854.0,790500.0,260000.0,-530500.0
dentb001,Bucky Dent,New York Yankees,YANKS,3,3,6,9,1982,1983,1,15.14,0.27,-14.87,1400,37,-1363,1541,144,-1397,1801.0,0.0,-1801.0,0.0,400000.0,400000.0
dents101,Sam Dente,Boston Red Sox,RSOX,2,5,3,8,1947,1955,8,0.52,24.8,24.28,500,919,419,1627,990,-637,67.0,3427.0,3360.0,0.0,15500.0,15500.0
dents101,Sam Dente,St.Louis Browns,ORLS,12,22,27,49,1948,1960,12,27.3,29.76,2.46,2866,3068,202,7448,7690,242,6528.0,6057.0,-471.0,55500.0,72800.0,17300.0
dents101,Sam Dente,Washington Senators,TWINS,18,31,34,65,1951,1963,12,44.58,4.58,-40.0,3103,4341,1238,10756,11476,720,1213.0,4683.0,3470.0,38500.0,14000.0,-24500.0
depaj002,Jorge de Paula,Colorado Rockies,ROCKS,1,1,1,2,2001,2001,0,0.44,-0.59,-1.03,10,14,4,0,0,0,81.0,22.0,-59.0,0.0,0.0,0.0
dernb001,Bob Dernier,Philadelphia Phillies,PHILS,3,6,4,10,1984,1986,2,8.36,-0.43,-8.79,1292,232,-1060,3847,16,-3831,227.0,557.0,330.0,0.0,0.0,0.0
derom001,Mark DeRosa,Chicago Cubs,CUBS,5,9,12,21,2008,2019,11,20.07,8.55,-11.52,907,1464,557,2034,410,-1624,3536.0,2836.0,-700.0,6250000.0,0.0,-6250000.0
derom001,Mark DeRosa,Cleveland Indians,INDINS,1,1,2,3,2009,2013,4,0.42,4.0,3.58,68,311,243,262,0,-262,0.0,883.0,883.0,5500000.0,0.0,-5500000.0
derrc101,Claud Derrick,Philadelphia Athletics,ATLTCS,2,5,3,8,1912,1916,4,0.94,11.21,10.27,71,847,776,237,3547,3310,0.0,0.0,0.0,0.0,0.0,0.0
derrc101,Claud Derrick,Detroit Tigers,TIGRS,1,1,1,2,1912,1912,0,0.22,0.0,-0.22,23,0,-23,73,0,-73,0.0,0.0,0.0,0.0,0.0,0.0
derrc101,Claud Derrick,Cincinnati Reds,REDS,1,1,1,2,1914,1916,2,-0.41,-2.49,-2.08,28,250,222,105,875,770,0.0,0.0,0.0,3300.0,0.0,-3300.0
derrm101,Mike Derrick,Pittsburgh Pirates,PIRATS,2,3,3,6,1967,1969,2,2.16,-0.09,-2.25,398,87,-311,1040,143,-897,429.0,0.0,-429.0,0.0,0.0,0.0
derrp101,Paul Derringer,St. Louis Cardinals,CARDS,2,4,7,11,1933,1941,8,35.44,3.4,-32.04,1483,791,-692,3153,2855,-298,8479.0,390.0,-8089.0,10000.0,10000.0,0.0
derrr101,Russ Derry,Philadelphia Athletics,ATLTCS,1,4,1,5,1946,1954,8,0.34,26.76,26.42,48,917,869,112,4210,4098,0.0,0.0,0.0,7000.0,0.0,-7000.0
desag101,Gene Desautels,Boston Red Sox,RSOX,4,12,11,23,1940,1956,16,20.74,30.94,10.2,2288,1730,-558,6966,4243,-2723,4828.0,6235.0,1407.0,124000.0,52122.0,-71878.0
desca001,Anthony DeSclafani,Toronto Blue Jays,BJAYS,3,15,11,26,2012,2018,6,24.75,21.38,-3.37,2099,1087,-1012,5739,3162,-2577,4668.0,4579.0,-89.0,8732900.0,43179800.0,34446900.0
desca001,Anthony DeSclafani,Miami Marlins,MARLNS,2,5,4,9,2014,2015,1,5.93,0.44,-5.49,229,31,-198,228,27,-201,1943.0,265.0,-1678.0,9400000.0,7250000.0,-2150000.0
deshd001,Delino DeShields,Montreal Expos,NATEX,4,8,9,17,1993,2006,13,63.97,29.14,-34.83,1073,1003,-70,2180,960,-1220,5870.0,7544.0,1674.0,9965000.0,6619000.0,-3346000.0
deshd002,Delino DeShields,Texas Rangers,RNGRS,1,2,2,4,2019,2020,1,2.79,0.06,-2.73,113,1,-112,120,0,-120,209.0,3.0,-206.0,1400000.0,17000000.0,15600000.0
deshj001,Jim Deshaies,New York Yankees,YANKS,4,8,5,13,1985,1989,4,16.4,-1.53,-17.93,1169,149,-1020,2749,144,-2605,4224.0,1295.0,-2929.0,1022000.0,1965000.0,943000.0
deshj001,Jim Deshaies,Minnesota Twins,TWINS,1,1,3,4,1993,1996,3,-0.08,0.11,0.19,10,5,-5,6,0,-6,51.0,80.0,29.0,700000.0,109000.0,-591000.0
deshj101,Jimmie DeShong,Philadelphia Athletics,ATLTCS,3,7,3,10,1932,1934,2,0.0,1.78,1.78,0,84,84,0,89,89,0.0,644.0,644.0,7600.0,0.0,-7600.0
deshj101,Jimmie DeShong,New York Yankees,YANKS,1,2,2,4,1936,1940,4,1.79,4.55,2.76,337,355,18,641,541,-100,1980.0,2260.0,280.0,0.0,0.0,0.0
desij001,John DeSilva,Detroit Tigers,TIGRS,1,1,1,2,1993,1994,1,-0.01,0.43,0.44,6,60,54,0,227,227,16.0,0.0,-16.0,0.0,2000000.0,2000000.0
desij001,John DeSilva,Los Angeles Dodgers,DOGRS,1,1,1,2,1994,1994,0,-0.12,0.0,0.12,2,0,-2,0,0,0,26.0,0.0,-26.0,0.0,0.0,0.0
despo001,Odrisamer Despaigne,San Diego Padres,PADRS,1,1,1,2,2016,2016,0,-0.22,0.0,0.22,19,0,-19,0,0,0,82.0,0.0,-82.0,0.0,0.0,0.0
desse001,Elmer Dessens,Cincinnati Reds,REDS,2,5,6,11,2002,2012,10,1.97,3.61,1.64,937,1076,139,2944,1747,-1197,922.0,809.0,-113.0,6375000.0,1352000.0,-5023000.0
desse001,Elmer Dessens,Arizona Diamondbacks,DBACKS,1,1,1,2,2004,2004,0,0.84,0.0,-0.84,117,0,-117,15,0,-15,325.0,0.0,-325.0,4000000.0,0.0,-4000000.0
desse001,Elmer Dessens,Kansas City Royals,ROYALS,1,1,4,5,2006,2007,1,0.09,-0.05,-0.14,38,40,2,1,5,4,69.0,613.0,544.0,1700000.0,8750000.0,7050000.0
desse001,Elmer Dessens,Los Angeles Dodgers,DOGRS,1,1,2,3,2007,2007,0,-0.51,-0.33,0.18,24,47,23,0,66,66,45.0,0.0,-45.0,0.0,0.0,0.0
desto001,Orestes Destrade,New York Yankees,YANKS,1,1,1,2,1988,1988,0,-0.23,-0.06,0.17,36,16,-20,53,0,-53,0.0,43.0,43.0,0.0,0.0,0.0
dethb101,Bob Detherage,Los Angeles Dodgers,DOGRS,1,3,1,4,1976,1981,5,0.46,19.38,18.92,71,542,471,226,2055,1829,0.0,0.0,0.0,0.0,0.0,0.0
dethb101,Bob Detherage,St. Louis Cardinals,CARDS,1,2,2,4,1976,1978,2,6.18,-0.3,-6.48,183,31,-152,702,19,-683,0.0,118.0,118.0,0.0,0.0,0.0
dethb101,Bob Detherage,Houston Astros,ASTROS,1,2,1,3,1977,1978,1,0.09,-0.34,-0.43,21,13,-8,7,21,14,0.0,0.0,0.0,0.0,0.0,0.0
detog101,George Detore,Toledo,Toledo,1,1,2,3,1933,1933,0,0.0,0.0,0.0,0,0,0,0,0,0,0.0,0.0,0.0,0.0,0.0,0.0
detog101,George Detore,Philadelphia Athletics,ATLTCS,1,2,1,3,1934,1934,0,0.0,0.0,0.0,0,0,0,0,0,0,0.0,0.0,0.0,0.0,0.0,0.0
dettj001,John Dettmer,Texas Rangers,RNGRS,2,2,2,4,1995,1995,0,0.0,-0.14,-0.14,0,37,37,0,73,73,0.0,12.0,12.0,155000.0,0.0,-155000.0
dettt101,Tom Dettore,Pittsburgh Pirates,PIRATS,1,2,1,3,1974,1975,1,-0.35,-0.31,0.04,112,84,-28,49,134,85,471.0,0.0,-471.0,0.0,0.0,0.0
detwr001,Ross Detwiler,Washington Nationals,NATEX,2,2,3,5,2014,2020,6,-1.11,0.0,1.11,40,4,-36,34,0,-34,129.0,5.0,-124.0,3000000.0,0.0,-3000000.0
devec001,Chris Devenski,Chicago White Sox,WSOX,1,3,2,5,2012,2012,0,4.38,0.83,-3.55,242,35,-207,1,0,-1,927.0,104.0,-823.0,0.0,0.0,0.0
devej001,Jose Devers,New York Yankees,YANKS,1,3,1,4,2017,2017,0,2.19,0.0,-2.19,342,0,-342,1369,0,-1369,8.0,0.0,-8.0,9857143.0,14500000.0,4642857.0
devem001,Mike Devereaux,Los Angeles Dodgers,DOGRS,1,1,1,2,1989,1991,2,12.98,8.5,-4.48,878,214,-664,3485,205,-3280,0.0,1800.0,1800.0,0.0,0.0,0.0
devem001,Mike Devereaux,Chicago White Sox,WSOX,1,1,1,2,1995,1995,0,0.4,0.0,-0.4,29,0,-29,57,0,-57,0.0,0.0,0.0,1350000.0,0.0,-1350000.0
devia101,Adrian Devine,Atlanta Braves,BRAVES,3,8,3,11,1976,1983,7,3.71,6.12,2.41,495,566,71,1015,2078,1063,923.0,87.0,-836.0,33500.0,0.0,-33500.0
devia101,Adrian Devine,Texas Rangers,RNGRS,4,9,7,16,1977,1988,11,9.87,29.07,19.2,738,2027,1289,1844,7192,5348,1774.0,2974.0,1200.0,330000.0,0.0,-330000.0
devia101,Adrian Devine,Atlanta Braves,BRAVES,2,3,5,8,1979,1981,2,1.23,1.75,0.52,177,210,33,304,347,43,541.0,927.0,386.0,150000.0,150000.0,0.0
devij001,Joey Devine,Atlanta Braves,BRAVES,2,3,2,5,2008,2008,0,1.55,1.01,-0.54,122,88,-34,170,345,175,206.0,0.0,-206.0,7000000.0,0.0,-7000000.0
devoa101,Al DeVormer,New York Yankees,YANKS,1,2,2,4,1923,1934,11,-0.1,9.14,9.24,74,571,497,223,688,465,0.0,4054.0,4054.0,0.0,0.0,0.0
devod001,Doug DeVore,Arizona Diamondbacks,DBACKS,1,1,2,3,2005,2005,0,0.0,-0.47,-0.47,0,13,13,0,0,0,0.0,24.0,24.0,0.0,1600000.0,1600000.0
devoj101,Josh Devore,New York Giants,GIANTS,1,4,1,5,1913,1913,0,44.86,-0.25,-45.11,1467,52,-1415,5586,39,-5547,1664.0,335.0,-1329.0,8100.0,3800.0,-4300.0
devoj101,Josh Devore,Philadelphia Phillies,PHILS,2,2,2,4,1914,1916,2,-0.55,-0.56,-0.01,51,83,32,152,333,181,0.0,0.0,0.0,0.0,0.0,0.0
dewib001,Blake DeWitt,Los Angeles Dodgers,DOGRS,2,4,4,8,2010,2013,3,0.08,2.91,2.83,324,264,-60,960,343,-617,0.0,1182.0,1182.0,410000.0,16002000.0,15592000.0
dewim001,Matt DeWitt,St. Louis Cardinals,CARDS,1,3,2,5,1999,2000,1,0.12,1.62,1.5,212,64,-148,357,72,-285,353.0,583.0,230.0,1025000.0,8600000.0,7575000.0
dewim001,Matt DeWitt,Toronto Blue Jays,BJAYS,2,3,5,8,2001,2001,0,1.34,-0.46,-1.8,17,81,64,2,117,115,302.0,78.0,-224.0,0.0,0.0,0.0
dewim001,Matt DeWitt,Chicago White Sox,WSOX,1,1,1,2,2001,2001,0,0.28,0.0,-0.28,16,0,-16,0,0,0,57.0,0.0,-57.0,0.0,0.0,0.0
diaza001,Alex Diaz,New York Mets,METS,1,2,2,4,1991,1991,0,-0.75,0.0,0.75,42,0,-42,88,0,-88,0.0,0.0,0.0,0.0,0.0,0.0
diaza001,Alex Diaz,Montreal Expos,NATEX,1,1,1,2,1991,1992,1,-0.85,0.0,0.85,133,0,-133,284,0,-284,0.0,0.0,0.0,0.0,0.0,0.0
diaza002,Argenis Diaz,Boston Red Sox,RSOX,3,4,4,8,2009,2010,1,0.8,1.92,1.12,204,165,-39,735,496,-239,0.0,3.0,3.0,0.0,9935000.0,9935000.0
diaza003,Aledmys Diaz,St. Louis Cardinals,CARDS,1,1,1,2,2017,2017,0,2.14,0.0,-2.14,130,0,-130,452,0,-452,0.0,0.0,0.0,2500000.0,0.0,-2500000.0
diaza003,Aledmys Diaz,Toronto Blue Jays,BJAYS,1,1,1,2,2018,2018,0,2.79,0.0,-2.79,170,0,-170,625,0,-625,0.0,0.0,0.0,2000000.0,0.0,-2000000.0
diazb001,Bo Diaz,Boston Red Sox,RSOX,2,6,3,9,1978,1987,9,14.86,20.93,6.07,699,715,16,1362,2220,858,3997.0,3996.0,-1.0,0.0,0.0,0.0
diazb001,Bo Diaz,Cleveland Indians,INDINS,1,1,3,4,1981,1983,2,5.91,2.75,-3.16,333,68,-265,1253,0,-1253,0.0,1236.0,1236.0,0.0,0.0,0.0
diazb001,Bo Diaz,Philadelphia Phillies,PHILS,4,7,8,15,1985,1988,3,7.67,0.31,-7.36,1238,246,-992,3588,287,-3301,737.0,444.0,-293.0,1255000.0,532500.0,-722500.0
diazc001,Carlos Diaz,Seattle Mariners,MARNRS,1,1,1,2,1981,1981,0,-0.3,-0.28,0.02,38,89,51,3,360,357,76.0,0.0,-76.0,0.0,0.0,0.0
diazc001,Carlos Diaz,Atlanta Braves,BRAVES,1,1,1,2,1982,1983,1,2.04,0.0,-2.04,116,6,-110,7,0,-7,261.0,11.0,-250.0,33500.0,0.0,-33500.0
diazc001,Carlos Diaz,New York Mets,METS,1,2,2,4,1983,1993,10,1.25,29.07,27.82,343,528,185,279,590,311,437.0,4754.0,4317.0,314167.0,0.0,-314167.0
diaze002,Einar Diaz,Cleveland Indians,INDINS,2,3,3,6,2002,2012,10,4.1,24.75,20.65,161,1080,919,366,4413,4047,970.0,8.0,-962.0,1601500.0,0.0,-1601500.0
diaze002,Einar Diaz,Texas Rangers,RNGRS,2,5,5,10,2004,2007,3,27.72,7.35,-20.37,1181,154,-1027,4083,5,-4078,1652.0,1074.0,-578.0,0.0,0.0,0.0
diaze003,Eddy Diaz,Milwaukee Brewers,BREWRS,1,1,1,2,1998,1998,0,0.0,-0.18,-0.18,0,2,2,0,0,0,0.0,1.0,1.0,0.0,0.0,0.0
diaze006,Edwin Diaz,Seattle Mariners,MARNRS,3,7,8,15,2018,2021,3,4.65,-0.82,-5.47,602,81,-521,857,184,-673,558.0,101.0,-457.0,34758065.0,21875000.0,-12883065.0
diazf001,Felix Diaz,San Francisco Giants,GIANTS,1,2,1,3,2002,2002,0,-0.46,1.76,2.22,19,46,27,1,205,204,148.0,0.0,-148.0,0.0,1025000.0,1025000.0
diazi001,Isan Diaz,Arizona Diamondbacks,DBACKS,2,7,4,11,2016,2019,3,30.63,10.0,-20.63,1052,220,-832,3757,754,-3003,1784.0,544.0,-1240.0,2600000.0,1044000.0,-1556000.0
diazi001,Isan Diaz,Milwaukee Brewers,BREWRS,1,4,1,5,2018,2018,0,-6.06,7.26,13.32,541,147,-394,1645,651,-994,270.0,0.0,-270.0,0.0,0.0,0.0
diazj002,Jose Diaz,Los Angeles Dodgers,DOGRS,1,3,2,5,2003,2003,0,0.4,0.21,-0.19,110,61,-49,377,246,-131,0.0,0.0,0.0,0.0,12166667.0,12166667.0
diazj002,Jose Diaz,New York Mets,METS,1,2,2,4,2004,2006,2,16.49,0.86,-15.63,150,111,-39,8,71,63,2502.0,670.0,-1832.0,0.0,325000.0,325000.0
diazj002,Jose Diaz,Texas Rangers,RNGRS,1,1,1,2,2006,2006,0,-0.17,-0.19,-0.02,4,26,22,0,88,88,20.0,0.0,-20.0,0.0,1350000.0,1350000.0
diazj003,Juan Diaz,Seattle Mariners,MARNRS,1,2,1,3,2010,2010,0,0.34,0.86,0.52,123,57,-66,406,238,-168,0.0,0.0,0.0,0.0,1500000.0,1500000.0
diazj006,Jairo Diaz,Anaheim Angels,ANGELS,2,2,3,5,2014,2015,1,0.21,-0.33,-0.54,286,38,-248,259,98,-161,305.0,0.0,-305.0,0.0,13501000.0,13501000.0
diazl001,Lewin Diaz,Minnesota Twins,TWINS,1,1,3,4,2019,2020,1,0.54,0.34,-0.2,54,55,1,169,0,-169,0.0,128.0,128.0,0.0,2500000.0,2500000.0
diazm001,Mike Diaz,Chicago Cubs,CUBS,4,10,8,18,1984,1987,3,1.78,8.04,6.26,606,1265,659,954,3508,2554,1010.0,823.0,-187.0,1753333.0,878000.0,-875333.0
diazm001,Mike Diaz,Philadelphia Phillies,PHILS,1,1,1,2,1985,1985,0,1.11,0.0,-1.11,247,0,-247,606,0,-606,0.0,0.0,0.0,0.0,0.0,0.0
diazm001,Mike Diaz,Pittsburgh Pirates,PIRATS,1,1,1,2,1988,1992,4,-0.59,4.39,4.98,40,398,358,158,1161,1003,0.0,0.0,0.0,172500.0,460000.0,287500.0
diazm002,Mario Diaz,Seattle Mariners,MARNRS,1,1,1,2,1990,1992,2,-0.07,0.0,0.07,16,0,-16,23,0,-23,0.0,0.0,0.0,0.0,0.0,0.0
diazm003,Matt Diaz,Kansas City Royals,ROYALS,1,1,1,2,2005,2005,0,4.7,0.0,-4.7,578,0,-578,1671,0,-1671,0.0,0.0,0.0,0.0,0.0,0.0
diazm003,Matt Diaz,Pittsburgh Pirates,PIRATS,1,1,1,2,2011,2011,0,-1.08,0.0,1.08,67,0,-67,155,0,-155,0.0,0.0,0.0,2125000.0,0.0,-2125000.0
diazm004,Miguel Diaz,Minnesota Twins,TWINS,1,1,1,2,2016,2017,1,-0.81,-0.14,0.67,142,11,-131,8,0,-8,326.0,54.0,-272.0,0.0,0.0,0.0
diazr001,Robinzon Diaz,Toronto Blue Jays,BJAYS,1,1,1,2,2008,2017,9,0.65,38.31,37.66,43,1235,1192,144,5272,5128,0.0,0.0,0.0,0.0,1800000.0,1800000.0
diazv001,Victor Diaz,Los Angeles Dodgers,DOGRS,1,3,2,5,2003,2003,0,0.4,0.21,-0.19,110,61,-49,377,246,-131,0.0,0.0,0.0,0.0,12166667.0,12166667.0
diazv001,Victor Diaz,New York Mets,METS,6,11,10,21,2006,2021,15,6.15,20.68,14.53,483,1142,659,1006,3198,2192,2473.0,2300.0,-173.0,18564800.0,3500000.0,-15064800.0
diazy001,Yandy Diaz,Cleveland Indians,INDINS,2,5,4,9,2018,2021,3,4.35,4.54,0.19,327,378,51,1228,1477,249,22.0,0.0,-22.0,18667000.0,0.0,-18667000.0
diazy002,Yennsy Diaz,Toronto Blue Jays,BJAYS,1,3,1,4,2021,2021,0,-0.51,2.02,2.53,63,30,-33,3,2,-1,137.0,452.0,315.0,0.0,0.0,0.0
dicka001,Alex Dickerson,Pittsburgh Pirates,PIRATS,2,2,3,5,2013,2015,2,-0.24,-0.25,-0.01,118,29,-89,314,41,-273,172.0,3.0,-169.0,0.0,0.0,0.0
dicka001,Alex Dickerson,San Diego Padres,PADRS,1,1,1,2,2019,2019,0,1.35,0.0,-1.35,219,0,-219,653,0,-653,0.0,0.0,0.0,0.0,0.0,0.0
dickc001,Chris Dickerson,Cincinnati Reds,REDS,1,1,1,2,2010,2010,0,-0.29,-0.1,0.19,25,13,-12,61,32,-29,0.0,0.0,0.0,415000.0,850000.0,435000.0
dickc001,Chris Dickerson,Milwaukee Brewers,BREWRS,1,1,1,2,2011,2011,0,0.49,0.18,-0.31,85,43,-42,72,2,-70,0.0,99.0,99.0,0.0,0.0,0.0
dickc001,Chris Dickerson,Pittsburgh Pirates,PIRATS,1,1,1,2,2014,2014,0,-0.04,0.0,0.04,41,0,-41,112,0,-112,0.0,0.0,0.0,0.0,0.0,0.0
dickc002,Corey Dickerson,Colorado Rockies,ROCKS,1,2,2,4,2016,2020,4,4.27,1.19,-3.08,307,448,141,1191,8,-1183,0.0,649.0,649.0,0.0,0.0,0.0
dickc002,Corey Dickerson,Tampa Bay Devil Rays,RAYS,1,1,3,4,2018,2018,0,4.09,0.0,-4.09,179,0,-179,675,0,-675,0.0,0.0,0.0,0.0,0.0,0.0
dickc002,Corey Dickerson,Pittsburgh Pirates,PIRATS,1,1,1,2,2019,2019,0,0.39,0.0,-0.39,34,0,-34,137,0,-137,0.0,0.0,0.0,8500000.0,0.0,-8500000.0
dickc002,Corey Dickerson,Miami Marlins,MARLNS,1,3,2,5,2021,2021,0,1.51,-1.03,-2.54,88,53,-35,140,134,-6,112.0,0.0,-112.0,9675000.0,100000.0,-9575000.0
dickj101,Jim Dickson,Houston Astros,ASTROS,2,4,2,6,1964,1966,2,0.87,1.76,0.89,66,278,212,152,894,742,15.0,0.0,-15.0,0.0,0.0,0.0
dickj102,Johnny Dickshot,Pittsburgh Pirates,PIRATS,1,3,1,4,1938,1941,3,0.0,-0.2,-0.2,0,90,90,0,209,209,0.0,0.0,0.0,0.0,0.0,0.0
dickl101,Leo Dickerman,Brooklyn Dodgers,DOGRS,1,1,1,2,1924,1924,0,1.56,3.16,1.6,94,42,-52,92,61,-31,751.0,454.0,-297.0,4000.0,0.0,-4000.0
dickm101,Murry Dickson,Pittsburgh Pirates,PIRATS,1,1,3,4,1954,1954,0,6.26,0.0,-6.26,158,0,-158,179,0,-179,1396.0,0.0,-1396.0,0.0,0.0,0.0
dickm101,Murry Dickson,Philadelphia Phillies,PHILS,4,7,7,14,1956,1968,12,28.54,33.07,4.53,1270,1974,704,1527,5948,4421,4802.0,2050.0,-2752.0,0.0,0.0,0.0
dickm101,Murry Dickson,Kansas City Athletics,ATLTCS,1,1,2,3,1958,1958,0,-0.64,0.0,0.64,12,0,-12,7,0,-7,61.0,0.0,-61.0,0.0,0.0,0.0
dickr001,R.A. Dickey,Minnesota Twins,TWINS,1,1,1,2,2008,2008,0,0.19,0.0,-0.19,34,0,-34,4,0,-4,337.0,0.0,-337.0,0.0,0.0,0.0
dickr001,R.A. Dickey,New York Mets,METS,5,10,9,19,2012,2021,9,5.89,21.61,15.72,446,1069,623,898,3007,2109,2473.0,2300.0,-173.0,18229800.0,3500000.0,-14729800.0
didib101,Bob Didier,Atlanta Braves,BRAVES,1,1,1,2,1973,1973,0,0.28,0.0,-0.28,7,0,-7,25,0,-25,0.0,0.0,0.0,0.0,0.0,0.0
didib101,Bob Didier,Boston Red Sox,RSOX,1,1,1,2,1974,1974,0,0.0,0.0,0.0,0,0,0,0,0,0,0.0,0.0,0.0,19000.0,0.0,-19000.0
diehp001,Phillip Diehl,New York Yankees,YANKS,2,2,3,5,2019,2021,2,-0.25,4.81,5.06,91,193,102,175,423,248,43.0,128.0,85.0,0.0,925000.0,925000.0
diekj001,Jake Diekman,Philadelphia Phillies,PHILS,3,8,8,16,2015,2021,6,15.67,15.69,0.02,537,994,457,893,2918,2025,2310.0,1839.0,-471.0,535500.0,0.0,-535500.0
diekj001,Jake Diekman,Texas Rangers,RNGRS,1,1,2,3,2018,2020,2,-0.87,-0.06,0.81,48,4,-44,0,0,0,43.0,17.0,-26.0,2712500.0,0.0,-2712500.0
diekj001,Jake Diekman,Kansas City Royals,ROYALS,1,1,2,3,2019,2019,0,1.78,0.0,-1.78,121,0,-121,1,0,-1,307.0,0.0,-307.0,2250000.0,0.0,-2250000.0
dierc101,Chuck Diering,St. Louis Cardinals,CARDS,1,2,1,3,1951,1951,0,0.42,0.0,-0.42,122,0,-122,75,0,-75,427.0,0.0,-427.0,25000.0,32500.0,7500.0
dierc101,Chuck Diering,New York Giants,GIANTS,1,4,1,5,1953,1957,4,0.0,2.61,2.61,0,252,252,0,49,49,0.0,709.0,709.0,0.0,0.0,0.0
dierl101,Larry Dierker,Houston Astros,ASTROS,5,9,7,16,1976,1985,9,14.67,9.46,-5.21,1469,1015,-454,4721,2946,-1775,118.0,0.0,-118.0,0.0,0.0,0.0
dietb101,Bill Dietrich,Portland,Portland,2,2,4,6,1932,1943,11,2.15,0.0,-2.15,315,0,-315,237,0,-237,1995.0,0.0,-1995.0,0.0,2500.0,2500.0
dietd001,Derek Dietrich,Tampa Bay Devil Rays,RAYS,4,8,9,17,2012,2020,8,5.31,13.57,8.26,749,1287,538,2527,4524,1997,283.0,217.0,-66.0,508800.0,3779600.0,3270800.0
dietd102,Dutch Dietz,Pittsburgh Pirates,PIRATS,3,7,5,12,1943,1950,7,25.55,9.13,-16.42,1198,585,-613,3347,932,-2415,3940.0,2301.0,-1639.0,0.0,0.0,0.0
difem001,Mike Difelice,Tampa Bay Devil Rays,RAYS,2,3,3,6,2001,2003,2,0.72,-0.23,-0.95,68,152,84,104,387,283,243.0,290.0,47.0,3750000.0,200000.0,-3550000.0
diggb001,Ben Diggins,Los Angeles Dodgers,DOGRS,1,2,2,4,2002,2003,1,-0.76,-0.63,0.13,70,35,-35,11,67,56,164.0,0.0,-164.0,0.0,1625000.0,1625000.0
dilaj101,Jack DiLauro,Detroit Tigers,TIGRS,1,1,1,2,1968,1968,0,1.13,0.0,-1.13,46,0,-46,12,0,-12,191.0,0.0,-191.0,0.0,0.0,0.0
dillb101,Bill Dillman,St. Louis Cardinals,CARDS,3,3,3,6,1970,1975,5,-0.22,-0.44,-0.22,36,35,-1,2,53,51,92.0,0.0,-92.0,0.0,0.0,0.0
dillb102,Bob Dillinger,St.Louis Browns,ORLS,1,2,5,7,1949,1951,2,2.11,-0.19,-2.3,207,217,10,887,812,-75,0.0,0.0,0.0,0.0,0.0,0.0
dillb102,Bob Dillinger,Chicago White Sox,WSOX,1,1,1,2,1952,1952,0,0.0,0.0,0.0,0,0,0,0,0,0,0.0,0.0,0.0,0.0,0.0,0.0
dilld101,Don Dillard,Cleveland Indians,INDINS,10,19,17,36,1962,1978,16,30.29,13.22,-17.07,2722,1767,-955,6203,6060,-143,3067.0,1183.0,-1884.0,115500.0,141500.0,26000.0
dilld101,Don Dillard,Atlanta Braves,BRAVES,2,3,3,6,1966,1966,0,0.0,0.0,0.0,0,0,0,0,0,0,0.0,0.0,0.0,0.0,0.0,0.0
dillg001,Gordon Dillard,Baltimore Orioles,ORLS,2,3,2,5,1988,1990,2,3.17,2.97,-0.2,157,238,81,279,1027,748,944.0,0.0,-944.0,1150000.0,1455000.0,305000.0
dillj001,Joe Dillon,Oakland Athletics,ATLTCS,1,1,1,2,2009,2009,0,0.16,1.07,0.91,15,129,114,35,587,552,0.0,0.0,0.0,0.0,0.0,0.0
dillp101,Pickles Dillhoefer,Chicago Cubs,CUBS,1,3,2,5,1917,1926,9,1.4,43.04,41.64,84,484,400,105,724,619,802.0,5642.0,4840.0,5000.0,12500.0,7500.0
dillp101,Pickles Dillhoefer,Philadelphia Phillies,PHILS,4,9,10,19,1919,1929,10,27.15,17.61,-9.54,1789,754,-1035,5788,2055,-3733,4451.0,3446.0,-1005.0,8500.0,19850.0,11350.0
dills101,Steve Dillard,Boston Red Sox,RSOX,1,1,3,4,1978,1978,0,-0.82,0.0,0.82,56,0,-56,143,0,-143,0.0,0.0,0.0,0.0,0.0,0.0
dills101,Steve Dillard,Detroit Tigers,TIGRS,2,3,4,7,1979,1980,1,0.12,0.0,-0.12,242,21,-221,584,43,-541,0.0,0.0,0.0,0.0,0.0,0.0
dilom001,Miguel Dilone,Pittsburgh Pirates,PIRATS,5,9,10,19,1978,1984,6,24.55,-1.47,-26.02,1160,294,-866,2724,444,-2280,3108.0,299.0,-2809.0,300000.0,0.0,-300000.0
dilom001,Miguel Dilone,Cleveland Indians,INDINS,1,1,1,2,1983,1983,0,-0.08,-0.19,-0.11,4,4,0,3,0,-3,0.0,35.0,35.0,225000.0,0.0,-225000.0
dilom001,Miguel Dilone,Chicago White Sox,WSOX,2,3,3,6,1983,1985,2,0.33,0.15,-0.18,77,5,-72,7,0,-7,121.0,16.0,-105.0,0.0,0.0,0.0
dimaj101,Joe DiMaggio,SanFrancisco,SanFrancisco,1,1,5,6,1934,1935,1,79.19,0.0,-79.19,1736,0,-1736,7672,0,-7672,0.0,0.0,0.0,0.0,2000.0,2000.0
dimav101,Vince DiMaggio,SanDiego,SanDiego,1,1,3,4,1936,1937,1,4.92,0.0,-4.92,282,0,-282,1150,0,-1150,0.0,0.0,0.0,0.0,0.0,0.0
dimav101,Vince DiMaggio,Boston Braves,BRAVES,6,18,10,28,1939,1952,13,22.0,33.53,11.53,1506,1625,119,5516,5420,-96,0.0,2449.0,2449.0,12500.0,0.0,-12500.0
dimav101,Vince DiMaggio,New York Yankees,YANKS,1,1,3,4,1939,1942,3,-0.21,-0.14,0.07,10,36,26,21,81,60,0.0,0.0,0.0,0.0,8750.0,8750.0
dimav101,Vince DiMaggio,Cincinnati Reds,REDS,2,2,2,4,1940,1940,0,14.03,1.36,-12.67,872,93,-779,3269,350,-2919,0.0,0.0,0.0,0.0,0.0,0.0
dimav101,Vince DiMaggio,Pittsburgh Pirates,PIRATS,2,2,2,4,1945,1946,1,2.29,2.69,0.4,133,135,2,517,71,-446,0.0,666.0,666.0,0.0,0.0,0.0
dimav101,Vince DiMaggio,Philadelphia Phillies,PHILS,2,2,2,4,1946,1948,2,-0.3,1.87,2.17,67,348,281,179,1271,1092,0.0,0.0,0.0,0.0,0.0,0.0
dimmm101,Mike Dimmel,Baltimore Orioles,ORLS,1,1,1,2,1979,1984,5,0.02,1.56,1.54,6,333,327,3,761,758,0.0,0.0,0.0,0.0,0.0,0.0
dinek101,Kerry Dineen,New York Yankees,YANKS,2,2,2,4,1977,1977,0,-0.28,0.0,0.28,74,0,-74,58,0,-58,0.0,0.0,0.0,0.0,40000.0,40000.0
dingc001,Craig Dingman,New York Yankees,YANKS,1,1,1,2,2001,2006,5,-0.59,0.44,1.03,14,10,-4,0,0,0,22.0,81.0,59.0,0.0,0.0,0.0
dinnb101,Bill Dinneen,Boston Red Sox,RSOX,1,1,2,3,1907,1907,0,3.72,-0.2,-3.92,136,4,-132,159,0,-159,1305.0,7.0,-1298.0,0.0,0.0,0.0
dipif001,Frank DiPino,Milwaukee Brewers,BREWRS,2,5,4,9,1982,1986,4,18.77,6.8,-11.97,1695,100,-1595,3977,0,-3977,2039.0,1974.0,-65.0,625000.0,1425000.0,800000.0
dipif001,Frank DiPino,Houston Astros,ASTROS,1,1,1,2,1986,1987,1,0.82,0.84,0.02,324,84,-240,15,169,154,631.0,0.0,-631.0,280000.0,490000.0,210000.0
diplm001,Marcos Diplan,Texas Rangers,RNGRS,1,3,2,5,2015,2015,0,4.24,4.26,0.02,471,35,-436,105,4,-101,683.0,553.0,-130.0,0.0,0.0,0.0
dipoj001,Jerry DiPoto,Cleveland Indians,INDINS,5,11,9,20,1994,2001,7,59.36,5.4,-53.96,3537,380,-3157,10591,1129,-9462,3110.0,195.0,-2915.0,7871666.0,7925000.0,53334.0
dipoj001,Jerry DiPoto,New York Mets,METS,1,1,1,2,1996,1998,2,5.63,1.87,-3.76,436,53,-383,18,63,45,802.0,479.0,-323.0,225000.0,440000.0,215000.0
distd101,Dutch Distel,St. Louis Cardinals,CARDS,1,4,1,5,1918,1918,0,0.0,0.57,0.57,0,80,80,0,312,312,0.0,0.0,0.0,0.0,0.0,0.0
ditma101,Art Ditmar,Kansas City Athletics,ATLTCS,38,80,81,161,1957,1976,19,137.3,59.64,-77.66,12943,8836,-4107,29783,24655,-5128,18720.0,9434.0,-9286.0,506100.0,626500.0,120400.0
ditma101,Art Ditmar,New York Yankees,YANKS,3,6,4,10,1961,1966,5,-0.26,3.2,3.46,405,420,15,1128,119,-1009,748.0,1424.0,676.0,84000.0,27500.0,-56500.0
dittj101,Jack Dittmer,Milwaukee Braves,BRAVES,3,8,5,13,1957,1961,4,-1.07,-0.69,0.38,297,102,-195,661,325,-336,138.0,0.0,-138.0,0.0,0.0,0.0
dittj101,Jack Dittmer,Detroit Tigers,TIGRS,1,1,1,2,1957,1958,1,0.0,0.0,0.0,0,0,0,0,0,0,0.0,0.0,0.0,0.0,0.0,0.0
dixob001,Brandon Dixon,Los Angeles Dodgers,DOGRS,3,7,6,13,2015,2019,4,7.85,6.19,-1.66,1100,293,-807,3346,616,-2730,1782.0,1084.0,-698.0,0.0,0.0,0.0
dixok001,Ken Dixon,Baltimore Orioles,ORLS,2,2,2,4,1987,1994,7,8.5,12.96,4.46,214,773,559,205,3122,2917,1800.0,214.0,-1586.0,155000.0,185000.0,30000.0
dixol101,Leo Dixon,StPaul,StPaul,7,9,17,26,1925,1935,10,6.06,0.0,-6.06,1070,0,-1070,3296,0,-3296,611.0,0.0,-611.0,0.0,45550.0,45550.0
dixol101,Leo Dixon,New York Giants,GIANTS,1,3,1,4,1920,1920,0,0.0,0.0,0.0,0,0,0,0,0,0,0.0,0.0,0.0,1800.0,0.0,-1800.0
dixos101,Sonny Dixon,Washington Senators,TWINS,2,2,2,4,1954,1955,1,-0.73,0.12,0.85,10,44,34,3,18,15,35.0,179.0,144.0,0.0,0.0,0.0
dixos101,Sonny Dixon,Chicago White Sox,WSOX,1,4,2,6,1954,1956,2,0.81,2.11,1.3,331,206,-125,724,121,-603,571.0,421.0,-150.0,8500.0,0.0,-8500.0
dixos101,Sonny Dixon,Kansas City Athletics,ATLTCS,1,2,2,4,1955,1956,1,-0.12,3.23,3.35,6,249,243,1,578,577,13.0,134.0,121.0,0.0,20000.0,20000.0
dixot101,Tom Dixon,New York Mets,METS,1,1,1,2,1983,1983,0,-0.19,0.0,0.19,8,0,-8,0,0,0,11.0,0.0,-11.0,0.0,0.0,0.0
dixot101,Tom Dixon,Montreal Expos,NATEX,1,1,1,2,1983,1984,1,0.0,-0.07,-0.07,0,5,5,0,5,5,0.0,0.0,0.0,0.0,0.0,0.0
dlugb001,Brent Dlugach,Detroit Tigers,TIGRS,1,1,1,2,2010,2011,1,0.0,0.0,0.0,0,0,0,0,0,0,0.0,0.0,0.0,0.0,0.0,0.0
doakb101,Bill Doak,St. Louis Cardinals,CARDS,1,1,1,2,1924,1924,0,4.95,2.82,-2.13,152,36,-116,144,45,-99,1187.0,359.0,-828.0,0.0,4000.0,4000.0
dobbd101,Dan Dobbek,Minnesota Twins,TWINS,1,1,1,2,1962,1969,7,0.0,-1.16,-1.16,0,407,407,0,897,897,0.0,0.0,0.0,0.0,0.0,0.0
dobsj101,Joe Dobson,Cleveland Indians,INDINS,2,4,5,9,1940,1945,5,20.77,6.72,-14.05,691,626,-65,1095,1460,365,4952.0,2948.0,-2004.0,22322.0,17000.0,-5322.0
dobsj101,Joe Dobson,Boston Red Sox,RSOX,3,9,8,17,1950,1956,6,14.02,9.79,-4.23,1662,1085,-577,5506,3192,-2314,1880.0,1611.0,-269.0,111000.0,40000.0,-71000.0
dobsp101,Pat Dobson,Detroit Tigers,TIGRS,1,2,1,3,1969,1973,4,3.09,4.22,1.13,408,176,-232,1366,140,-1226,753.0,1147.0,394.0,12000.0,0.0,-12000.0
dobsp101,Pat Dobson,San Diego Padres,PADRS,2,3,5,8,1970,1978,8,5.53,1.56,-3.97,208,961,753,208,2714,2506,1767.0,691.0,-1076.0,35500.0,42000.0,6500.0
dobsp101,Pat Dobson,Baltimore Orioles,ORLS,6,18,15,33,1972,1988,16,21.6,72.74,51.14,1757,3477,1720,3464,7736,4272,7768.0,11016.0,3248.0,691833.0,37000.0,-654833.0
dobsp101,Pat Dobson,Atlanta Braves,BRAVES,5,8,11,19,1973,1977,4,13.07,0.66,-12.41,518,456,-62,701,235,-466,2735.0,1060.0,-1675.0,58000.0,187000.0,129000.0
dobsp101,Pat Dobson,New York Yankees,YANKS,5,8,8,16,1975,1983,8,30.56,15.51,-15.05,1856,842,-1014,2195,2957,762,5679.0,0.0,-5679.0,79000.0,400000.0,321000.0
dobyl101,Larry Doby,Cleveland Indians,INDINS,11,18,18,36,1955,1968,13,111.88,34.63,-77.25,5110,3069,-2041,17444,11205,-6239,4502.0,562.0,-3940.0,52000.0,43000.0,-9000.0
dobyl101,Larry Doby,Chicago White Sox,WSOX,15,26,28,54,1957,1969,12,18.37,37.27,18.9,2207,3220,1013,3806,5515,1709,4631.0,7668.0,3037.0,148250.0,102500.0,-45750.0
dobyl101,Larry Doby,Baltimore Orioles,ORLS,3,4,5,9,1958,1960,2,14.22,11.82,-2.4,668,719,51,1551,2462,911,2254.0,614.0,-1640.0,0.0,0.0,0.0
dobyl101,Larry Doby,Cleveland Indians,INDINS,1,1,1,2,1959,1964,5,-0.62,11.39,12.01,18,835,817,64,3298,3234,0.0,0.0,0.0,0.0,0.0,0.0
doddt001,Tom Dodd,New York Yankees,YANKS,1,3,1,4,1982,1983,1,-0.79,-0.41,0.38,55,69,14,159,249,90,0.0,0.0,0.0,250000.0,800000.0,550000.0
doddt001,Tom Dodd,Toronto Blue Jays,BJAYS,3,7,7,14,1982,1997,15,19.48,55.53,36.05,1330,2691,1361,5190,10864,5674,360.0,453.0,93.0,3600000.0,2906667.0,-693333.0
dodgj101,John Dodge,Philadelphia Phillies,PHILS,1,1,1,2,1913,1913,0,0.1,2.9,2.8,94,88,-6,344,336,-8,0.0,0.0,0.0,1800.0,3500.0,1700.0
dohej101,John Doherty,California Angels,ANGELS,1,1,1,2,1977,1978,1,0.0,0.11,0.11,0,10,10,0,25,25,0.0,0.0,0.0,0.0,0.0,0.0
dohms001,Scott Dohmann,Colorado Rockies,ROCKS,2,3,3,6,2006,2007,1,0.87,-0.8,-1.67,160,227,67,478,3,-475,128.0,305.0,177.0,662000.0,1335500.0,673500.0
dolac101,Cozy Dolan,Chicago White Sox,WSOX,2,3,2,5,1903,1905,2,1.3,-0.02,-1.32,324,98,-226,1382,394,-988,0.0,0.0,0.0,0.0,0.0,0.0
dolac102,Cozy Dolan,Philadelphia Phillies,PHILS,1,2,2,4,1913,1917,4,0.05,0.62,0.57,35,329,294,151,1239,1088,0.0,147.0,147.0,2750.0,7800.0,5050.0
dolac102,Cozy Dolan,Pittsburgh Pirates,PIRATS,1,5,3,8,1913,1915,2,18.03,3.31,-14.72,1733,233,-1500,6155,938,-5217,795.0,0.0,-795.0,11400.0,13500.0,2100.0
domij001,Juan Dominguez,Texas Rangers,RNGRS,1,1,3,4,2006,2008,2,0.0,-0.39,-0.39,0,74,74,0,9,9,0.0,769.0,769.0,0.0,0.0,0.0
domij002,Jose Dominguez,Los Angeles Dodgers,DOGRS,1,2,2,4,2014,2018,4,0.23,0.98,0.75,5,298,293,0,4,4,17.0,353.0,336.0,501000.0,3000000.0,2499000.0
domim001,Matt Dominguez,Miami Marlins,MARLNS,1,2,1,3,2012,2012,0,1.76,-0.39,-2.15,340,81,-259,1309,338,-971,0.0,0.0,0.0,0.0,18500000.0,18500000.0
donaj001,Josh Donaldson,Chicago Cubs,CUBS,1,4,2,6,2008,2009,1,13.08,4.54,-8.54,545,124,-421,2047,74,-1973,213.0,718.0,505.0,0.0,6525000.0,6525000.0
donaj001,Josh Donaldson,Oakland Athletics,ATLTCS,3,3,7,10,2014,2021,7,20.44,7.94,-12.5,562,462,-100,2468,938,-1530,0.0,1747.0,1747.0,2425000.0,3766100.0,1341100.0
donaj001,Josh Donaldson,Toronto Blue Jays,BJAYS,1,2,1,3,2018,2018,0,0.4,0.0,-0.4,16,0,-16,60,0,-60,0.0,0.0,0.0,23000000.0,0.0,-23000000.0
donaj002,Jason Donald,Philadelphia Phillies,PHILS,3,6,6,12,2009,2015,6,27.43,-0.46,-27.89,716,374,-342,1539,630,-909,4038.0,442.0,-3596.0,1175000.0,6421400.0,5246400.0
donaj002,Jason Donald,Cleveland Indians,INDINS,4,8,11,19,2012,2019,7,9.51,23.51,14.0,376,937,561,1266,910,-356,399.0,4479.0,4080.0,22963900.0,10902500.0,-12061400.0
donaj101,John Donaldson,Oakland Athletics,ATLTCS,1,1,1,2,1969,1972,3,-1.0,0.07,1.07,95,60,-35,378,103,-275,0.0,0.0,0.0,14500.0,13000.0,-1500.0
donaj101,John Donaldson,Milwaukee Brewers,BREWRS,1,1,1,2,1970,1970,0,0.26,-0.21,-0.47,51,121,70,113,453,340,0.0,0.0,0.0,0.0,17000.0,17000.0
donaj101,John Donaldson,Oakland Athletics,ATLTCS,1,1,1,2,1971,1971,0,0.0,-0.15,-0.15,0,8,8,0,1,1,0.0,17.0,17.0,0.0,18200.0,18200.0
donaj101,John Donaldson,Detroit Tigers,TIGRS,1,1,1,2,1972,1972,0,0.0,0.0,0.0,0,0,0,0,0,0,0.0,0.0,0.0,0.0,0.0,0.0
donaj103,Jiggs Donahue,Chicago White Sox,WSOX,1,3,1,4,1909,1910,1,-0.91,1.19,2.1,140,48,-92,366,63,-303,237.0,502.0,265.0,2400.0,3500.0,1100.0
donar101,Red Donahue,St. Louis Cardinals,CARDS,2,4,7,11,1897,1899,2,17.28,9.65,-7.63,1436,631,-805,5066,2410,-2656,3837.0,1192.0,-2645.0,0.0,0.0,0.0
donar101,Red Donahue,St.Louis Browns,ORLS,1,1,1,2,1903,1903,0,4.62,0.28,-4.34,142,16,-126,222,24,-198,1669.0,183.0,-1486.0,0.0,0.0,0.0
donar101,Red Donahue,Cleveland Indians,INDINS,1,1,1,2,1905,1905,0,3.83,0.0,-3.83,57,0,-57,92,0,-92,723.0,0.0,-723.0,0.0,0.0,0.0
donas101,She Donahue,Philadelphia Phillies,PHILS,1,2,1,3,1905,1905,0,0.0,0.2,0.2,0,16,16,0,52,52,0.0,0.0,0.0,0.0,0.0,0.0
donlm101,Mike Donlin,Cincinnati Reds,REDS,3,5,4,9,1904,1910,6,32.35,12.28,-20.07,1177,389,-788,4679,862,-3817,9.0,2982.0,2973.0,3300.0,0.0,-3300.0
donlm101,Mike Donlin,Boston Braves,BRAVES,1,1,1,2,1912,1914,2,1.3,0.31,-0.99,77,145,68,274,680,406,0.0,0.0,0.0,0.0,0.0,0.0
donnb001,Brendan Donnelly,Anaheim Angels,ANGELS,1,1,1,2,2006,2007,1,0.55,0.0,-0.55,29,0,-29,0,0,0,62.0,0.0,-62.0,950000.0,0.0,-950000.0
donnc001,Chris Donnels,Arizona Diamondbacks,DBACKS,1,1,1,2,2003,2003,0,0.0,0.0,0.0,0,0,0,0,0,0,0.0,0.0,0.0,0.0,0.0,0.0
donnj101,Jim Donnelly,Baltimore Orioles,BLN,2,4,6,10,1896,1903,7,2.95,7.66,4.71,454,485,31,1885,2090,205,0.0,0.0,0.0,0.0,0.0,0.0
donnj101,Jim Donnelly,New York Giants,GIANTS,1,3,2,5,1897,1903,6,-0.53,7.63,8.16,24,437,413,105,1697,1592,0.0,0.0,0.0,0.0,0.0,0.0
donod101,Dick Donovan,Washington Senators,RNGRS,4,7,5,12,1961,1970,9,4.25,0.29,-3.96,404,337,-67,701,1154,453,1913.0,6.0,-1907.0,0.0,8000.0,8000.0
donoj103,Jim Donohue,St. Louis Cardinals,CARDS,1,2,1,3,1960,1960,0,0.0,-0.2,-0.2,0,32,32,0,32,32,0.0,0.0,0.0,0.0,0.0,0.0
donoj103,Jim Donohue,Detroit Tigers,TIGRS,1,1,1,2,1961,1961,0,1.6,-0.1,-1.7,100,6,-94,33,3,-30,374.0,36.0,-338.0,0.0,0.0,0.0
donoj103,Jim Donohue,Los Angeles Angels,ANGELS,2,2,2,4,1962,1966,4,0.28,3.36,3.08,44,277,233,4,244,240,109.0,1232.0,1123.0,16500.0,0.0,-16500.0
donop102,Pete Donohue,Cincinnati Reds,REDS,4,9,4,13,1930,1932,2,-0.65,6.36,7.01,300,397,97,801,1584,783,303.0,0.0,-303.0,27500.0,0.0,-27500.0
dooir101,Red Dooin,Philadelphia Phillies,PHILS,2,3,2,5,1915,1918,3,-0.57,3.71,4.28,32,454,422,123,1633,1510,0.0,338.0,338.0,0.0,0.0,0.0
doolm101,Mickey Doolin,Baltimore Terrapins,BLF,1,1,2,3,1915,1916,1,0.08,0.0,-0.08,24,0,-24,92,0,-92,0.0,0.0,0.0,0.0,0.0,0.0
dools001,Sean Doolittle,Oakland Athletics,ATLTCS,3,5,6,11,2017,2021,4,3.83,7.65,3.82,466,297,-169,88,313,225,792.0,885.0,93.0,0.0,563700.0,563700.0
dopsj001,John Dopson,Montreal Expos,NATEX,1,2,2,4,1988,1992,4,6.16,6.42,0.26,597,552,-45,1669,1976,307,1455.0,0.0,-1455.0,132500.0,525000.0,392500.0
dorab001,Bill Doran,Houston Astros,ASTROS,1,1,3,4,1990,1992,2,2.7,-0.24,-2.94,260,60,-200,933,65,-868,0.0,497.0,497.0,934000.0,104000.0,-830000.0
dorif101,Fritz Dorish,Chicago White Sox,WSOX,1,1,1,2,1955,1955,0,1.53,0.18,-1.35,96,32,-64,11,68,57,256.0,0.0,-256.0,0.0,0.0,0.0
dormc101,Charlie Dorman,Chicago White Sox,WSOX,1,1,1,2,1923,1923,0,0.0,0.08,0.08,0,23,23,0,75,75,0.0,0.0,0.0,1950.0,0.0,-1950.0
dorng101,Gus Dorner,Cleveland Indians,INDINS,1,2,1,3,1903,1919,16,0.0,38.48,38.48,0,1619,1619,0,6493,6493,0.0,0.0,0.0,0.0,0.0,0.0
dorng101,Gus Dorner,Cincinnati Reds,REDS,2,2,4,6,1906,1912,6,-4.64,3.06,7.7,324,62,-262,398,87,-311,3265.0,704.0,-2561.0,0.0,0.0,0.0
dorsb001,Brian Dorsett,Oakland Athletics,ATLTCS,1,2,1,3,1987,1987,0,-0.62,0.31,0.93,21,61,40,12,249,237,224.0,0.0,-224.0,0.0,630000.0,630000.0
dorsb001,Brian Dorsett,Cleveland Indians,INDINS,1,1,1,2,1988,1989,1,-0.14,0.0,0.14,7,0,-7,12,0,-12,0.0,0.0,0.0,0.0,0.0,0.0
dorsb001,Brian Dorsett,California Angels,ANGELS,1,1,1,2,1988,1988,0,-0.19,0.0,0.19,22,0,-22,60,0,-60,0.0,0.0,0.0,0.0,0.0,0.0
dorsb001,Brian Dorsett,San Diego Padres,PADRS,1,1,1,2,1991,1991,0,0.0,0.0,0.0,0,0,0,0,0,0,0.0,0.0,0.0,0.0,0.0,0.0
dorsj001,Jim Dorsey,California Angels,ANGELS,1,3,2,5,1981,1984,3,0.12,12.81,12.69,77,526,449,135,1947,1812,448.0,774.0,326.0,0.0,0.0,0.0
doteo001,Octavio Dotel,New York Mets,METS,1,3,2,5,1999,2000,1,10.81,6.86,-3.95,663,212,-451,364,706,342,1347.0,656.0,-691.0,687500.0,8625000.0,7937500.0
doteo001,Octavio Dotel,Houston Astros,ASTROS,1,3,1,4,2004,2004,0,1.22,4.49,3.27,62,90,28,0,399,399,198.0,0.0,-198.0,2800000.0,0.0,-2800000.0
doteo001,Octavio Dotel,Kansas City Royals,ROYALS,1,1,1,2,2007,2011,4,-0.08,2.27,2.35,18,104,86,0,8,8,23.0,1593.0,1570.0,5000000.0,0.0,-5000000.0
doteo001,Octavio Dotel,Pittsburgh Pirates,PIRATS,1,2,2,4,2010,2015,5,0.31,2.14,1.83,38,219,181,1,259,258,56.0,1307.0,1251.0,3250000.0,0.0,-3250000.0
doteo001,Octavio Dotel,Los Angeles Dodgers,DOGRS,1,1,1,2,2010,2010,0,-0.1,0.0,0.1,16,0,-16,0,0,0,16.0,0.0,-16.0,0.0,0.0,0.0
doteo001,Octavio Dotel,Toronto Blue Jays,BJAYS,1,4,4,8,2011,2014,3,0.4,6.43,6.03,344,416,72,89,1599,1510,547.0,15.0,-532.0,4329600.0,3193000.0,-1136600.0
dotsr001,Richard Dotson,California Angels,ANGELS,1,3,3,6,1977,1990,13,18.22,44.27,26.05,460,1735,1275,586,6912,6326,4818.0,1336.0,-3482.0,175000.0,50000.0,-125000.0
dotsr001,Richard Dotson,Chicago White Sox,WSOX,3,5,7,12,1987,1997,10,-1.68,12.63,14.31,132,1505,1373,105,4423,4318,928.0,727.0,-201.0,1340000.0,247000.0,-1093000.0
dottd101,Dutch Dotterer,Cincinnati Reds,REDS,1,1,1,2,1960,1960,0,0.0,0.0,0.0,0,0,0,0,0,0,0.0,0.0,0.0,0.0,0.0,0.0
doubf001,Felix Doubront,Boston Red Sox,RSOX,1,1,1,2,2014,2020,6,0.42,-0.14,-0.56,8,122,114,8,271,263,61.0,0.0,-61.0,586000.0,0.0,-586000.0
dougk101,Klondike Douglass,St. Louis Cardinals,CARDS,2,4,7,11,1897,1899,2,17.28,9.65,-7.63,1436,631,-805,5066,2410,-2656,3837.0,1192.0,-2645.0,0.0,0.0,0.0
dougl101,Larry Douglas,Pittsburgh Pirates,PIRATS,3,8,4,12,1916,1922,6,39.97,14.79,-25.18,1164,990,-174,2135,3762,1627,8893.0,711.0,-8182.0,9650.0,5000.0,-4650.0
dougp101,Phil Douglas,Chicago Cubs,CUBS,4,10,7,17,1919,1926,7,35.21,12.09,-23.12,1416,566,-850,4591,1420,-3171,3907.0,3229.0,-678.0,22006.0,27918.0,5912.0
dougp102,Patsy Dougherty,Boston Red Sox,RSOX,1,1,1,2,1904,1908,4,1.13,2.47,1.34,234,263,29,989,1019,30,0.0,0.0,0.0,0.0,0.0,0.0
dougw101,Whammy Douglas,Pittsburgh Pirates,PIRATS,9,16,18,34,1959,1973,14,-0.94,37.67,38.61,564,1623,1059,1204,4862,3658,386.0,2327.0,1941.0,17500.0,0.0,-17500.0
doumr001,Ryan Doumit,Minnesota Twins,TWINS,1,1,1,2,2013,2014,1,-0.66,0.0,0.66,100,0,-100,166,0,-166,0.0,0.0,0.0,3500000.0,0.0,-3500000.0
doutt101,Taylor Douthit,St. Louis Cardinals,CARDS,1,1,1,2,1931,1931,0,-0.27,-0.24,0.03,192,45,-147,798,169,-629,0.0,0.0,0.0,0.0,0.0,0.0
doutt101,Taylor Douthit,Chicago Cubs,CUBS,1,1,1,2,1933,1933,0,0.0,0.17,0.17,0,31,31,0,92,92,0.0,0.0,0.0,0.0,0.0,0.0
dowdk001,Kyle Dowdy,Detroit Tigers,TIGRS,1,2,1,3,2018,2018,0,0.14,0.0,-0.14,71,0,-71,281,0,-281,0.0,0.0,0.0,1750000.0,0.0,-1750000.0
dowdt101,Tommy Dowd,St. Louis Cardinals,CARDS,2,2,5,7,1897,1899,2,0.17,-2.08,-2.25,225,312,87,972,1336,364,0.0,0.0,0.0,0.0,0.0,0.0
dowdt101,Tommy Dowd,Philadelphia Phillies,PHILS,1,5,3,8,1897,1902,5,9.88,14.87,4.99,647,845,198,2475,2785,310,1192.0,3296.0,2104.0,0.0,0.0,0.0
dowld101,Dave Dowling,Chicago Cubs,CUBS,3,5,5,10,1968,1976,8,1.41,-2.65,-4.06,244,580,336,611,1135,524,48.0,653.0,605.0,0.0,0.0,0.0
downa101,Al Downing,New York Yankees,YANKS,25,54,46,100,1969,1997,28,86.02,77.5,-8.52,6209,4335,-1874,14644,8663,-5981,18574.0,11941.0,-6633.0,5675833.0,4786500.0,-889333.0
downa101,Al Downing,Oakland Athletics,ATLTCS,1,2,1,3,1970,1971,1,0.4,-0.79,-1.19,86,96,10,104,141,37,283.0,0.0,-283.0,62000.0,15000.0,-47000.0
downa101,Al Downing,Milwaukee Brewers,BREWRS,2,2,2,4,1971,1972,1,5.66,0.71,-4.95,389,170,-219,459,431,-28,2693.0,0.0,-2693.0,0.0,0.0,0.0
downb001,Brian Downing,Chicago White Sox,WSOX,8,12,15,27,1977,1997,20,45.63,32.75,-12.88,2200,2303,103,7990,6201,-1789,3475.0,5246.0,1771.0,1390000.0,422000.0,-968000.0
downk001,Kelly Downs,Philadelphia Phillies,PHILS,2,3,3,6,1984,1985,1,3.94,-0.28,-4.22,400,66,-334,337,103,-234,2374.0,85.0,-2289.0,0.0,0.0,0.0
downs001,Scott Downs,Chicago Cubs,CUBS,1,2,1,3,1998,2002,4,0.0,-0.23,-0.23,0,10,10,0,7,7,0.0,68.0,68.0,0.0,1300000.0,1300000.0
downs001,Scott Downs,Minnesota Twins,TWINS,2,3,3,6,1999,2006,7,2.68,7.1,4.42,288,208,-80,99,24,-75,1148.0,2925.0,1777.0,8250000.0,0.0,-8250000.0
downs001,Scott Downs,Chicago Cubs,CUBS,1,1,1,2,2000,2001,1,-1.2,2.57,3.77,27,114,87,25,431,406,207.0,0.0,-207.0,0.0,4000000.0,4000000.0
downs001,Scott Downs,Anaheim Angels,ANGELS,1,1,1,2,2013,2016,3,0.07,0.69,0.62,50,89,39,0,1,1,42.0,349.0,307.0,0.0,0.0,0.0
downt101,Tom Downey,Chicago Cubs,CUBS,1,2,1,3,1909,1909,0,2.39,-0.63,-3.02,347,20,-327,1320,55,-1265,0.0,0.0,0.0,0.0,0.0,0.0
doylb101,Brian Doyle,Texas Rangers,RNGRS,1,3,1,4,1977,1978,1,-0.74,-0.56,0.18,93,93,0,171,128,-43,0.0,0.0,0.0,0.0,0.0,0.0
doylc102,Carl Doyle,Philadelphia Athletics,ATLTCS,1,4,1,5,1937,1940,3,0.0,6.28,6.28,0,278,278,0,321,321,0.0,1514.0,1514.0,0.0,0.0,0.0
doylc102,Carl Doyle,Brooklyn Dodgers,DOGRS,1,5,2,7,1940,1946,6,2.24,22.24,20.0,200,770,570,485,2187,1702,487.0,3020.0,2533.0,0.0,0.0,0.0
doyld102,Denny Doyle,Philadelphia Phillies,PHILS,1,1,3,4,1973,1974,1,3.34,0.0,-3.34,155,59,-96,564,114,-450,0.0,0.0,0.0,40000.0,38500.0,-1500.0
doyld102,Denny Doyle,California Angels,ANGELS,1,1,2,3,1975,1976,1,2.26,0.0,-2.26,343,0,-343,1298,0,-1298,0.0,0.0,0.0,0.0,0.0,0.0
doylj103,Jack Doyle,New York Giants,GIANTS,1,1,2,3,1895,1901,6,6.54,3.48,-3.06,232,673,441,1038,2853,1815,0.0,0.0,0.0,0.0,0.0,0.0
doylj103,Jack Doyle,Baltimore Orioles,BLN,2,4,4,8,1897,1899,2,2.28,18.6,16.32,271,446,175,1095,1688,593,148.0,1122.0,974.0,0.0,0.0,0.0
doylj103,Jack Doyle,New York Giants,GIANTS,1,1,3,4,1901,1902,1,-0.18,1.46,1.64,75,273,198,299,1133,834,0.0,0.0,0.0,0.0,0.0,0.0
doylj107,Jim Doyle,Utica,Utica,1,1,1,2,1909,1909,0,-0.19,0.0,0.19,7,0,-7,15,0,-15,0.0,0.0,0.0,0.0,0.0,0.0
doylj107,Jim Doyle,Cincinnati Reds,REDS,1,2,1,3,1910,1910,0,0.0,-0.59,-0.59,0,21,21,0,69,69,0.0,0.0,0.0,0.0,0.0,0.0
doyll101,Larry Doyle,New York Giants,GIANTS,1,3,1,4,1916,1916,0,2.13,0.44,-1.69,153,40,-113,610,161,-449,0.0,0.0,0.0,7400.0,6500.0,-900.0
doyll101,Larry Doyle,Chicago Cubs,CUBS,1,3,1,4,1918,1918,0,1.89,7.03,5.14,176,71,-105,557,112,-445,0.0,807.0,807.0,0.0,0.0,0.0
doyll101,Larry Doyle,Boston Braves,BRAVES,2,3,3,6,1918,1921,3,20.68,4.26,-16.42,840,475,-365,2277,2024,-253,3450.0,0.0,-3450.0,0.0,4800.0,4800.0
doylp101,Paul Doyle,Houston Astros,ASTROS,2,3,2,5,1968,1970,2,0.43,-0.44,-0.87,270,122,-148,685,445,-240,117.0,0.0,-117.0,12000.0,69000.0,57000.0
dozib001,Brian Dozier,Minnesota Twins,TWINS,2,4,6,10,2018,2020,2,-0.18,1.88,2.06,171,61,-110,244,205,-39,170.0,200.0,30.0,9000000.0,9000000.0,0.0
dozid001,D.J. Dozier,New York Mets,METS,2,4,2,6,1992,1993,1,12.22,-0.41,-12.63,490,79,-411,1635,295,-1340,509.0,0.0,-509.0,2535000.0,4200000.0,1665000.0
dozit001,Tom Dozier,St. Louis Cardinals,CARDS,1,2,1,3,1983,1985,2,-0.15,0.1,0.25,4,16,12,0,0,0,19.0,30.0,11.0,0.0,0.0,0.0
drabd001,Doug Drabek,Chicago White Sox,WSOX,2,3,3,6,1984,1985,1,3.61,-0.06,-3.67,409,47,-362,1330,158,-1172,395.0,0.0,-395.0,0.0,700000.0,700000.0
drabd001,Doug Drabek,New York Yankees,YANKS,8,12,14,26,1986,1997,11,30.93,13.18,-17.75,1250,1055,-195,1880,1524,-356,6414.0,3621.0,-2793.0,3550000.0,2212500.0,-1337500.0
drabk001,Kyle Drabek,Philadelphia Phillies,PHILS,1,3,2,5,2009,2013,4,-0.14,16.2,16.34,41,202,161,2,264,262,517.0,2108.0,1591.0,0.0,14250000.0,14250000.0
drabm101,Moe Drabowsky,Chicago Cubs,CUBS,7,13,11,24,1961,1977,16,12.22,41.5,29.28,942,3000,2058,716,8425,7709,3637.0,5246.0,1609.0,122500.0,47500.0,-75000.0
drabm101,Moe Drabowsky,Kansas City Royals,ROYALS,1,1,1,2,1970,1970,0,-0.15,0.16,0.31,42,14,-28,6,48,42,100.0,0.0,-100.0,45000.0,12500.0,-32500.0
drabm101,Moe Drabowsky,Baltimore Orioles,ORLS,2,2,2,4,1970,1972,2,1.01,0.63,-0.38,203,38,-165,59,94,35,264.0,0.0,-264.0,0.0,37000.0,37000.0
dragd101,Dick Drago,Kansas City Royals,ROYALS,1,1,1,2,1973,1980,7,8.32,8.3,-0.02,211,249,38,1,0,-1,1642.0,2477.0,835.0,37500.0,65000.0,27500.0
dragd101,Dick Drago,Boston Red Sox,RSOX,2,2,4,6,1976,1977,1,-0.61,0.0,0.61,67,0,-67,25,0,-25,301.0,0.0,-301.0,0.0,0.0,0.0
dragd101,Dick Drago,California Angels,ANGELS,1,1,1,2,1977,1979,2,0.01,4.21,4.2,36,96,60,0,0,0,119.0,637.0,518.0,0.0,0.0,0.0
dragd101,Dick Drago,Boston Red Sox,RSOX,1,1,1,2,1981,1981,0,-0.69,0.0,0.69,39,0,-39,0,0,0,161.0,0.0,-161.0,0.0,0.0,0.0
drahb001,Brian Drahman,Milwaukee Brewers,BREWRS,1,1,1,2,1989,1989,0,0.65,-0.25,-0.9,38,7,-31,0,0,0,129.0,101.0,-28.0,0.0,590000.0,590000.0
drako001,Oliver Drake,Baltimore Orioles,ORLS,1,1,1,2,2017,2017,0,-0.08,0.0,0.08,141,0,-141,0,0,0,196.0,0.0,-196.0,0.0,0.0,0.0
drakt101,Tom Drake,Nashville,Nashville,1,2,1,3,1941,1941,0,-0.18,0.0,0.18,33,0,-33,24,0,-24,74.0,0.0,-74.0,0.0,0.0,0.0
dravd001,Dave Dravecky,Pittsburgh Pirates,PIRATS,1,1,1,2,1981,1981,0,11.89,0.0,-11.89,409,0,-409,304,0,-304,2701.0,0.0,-2701.0,0.0,0.0,0.0
dravd001,Dave Dravecky,San Diego Padres,PADRS,4,8,8,16,1987,1991,4,23.07,10.95,-12.12,1220,1067,-153,3009,1254,-1755,1633.0,2625.0,992.0,3883333.0,1525000.0,-2358333.0
dreeb101,Bill Dreesen,Boston Braves,BRAVES,4,6,5,11,1931,1938,7,5.87,8.49,2.62,599,1115,516,2168,4417,2249,0.0,0.0,0.0,0.0,0.0,0.0
dreic101,Clem Dreisewerd,Boston Red Sox,RSOX,2,5,3,8,1947,1955,8,0.52,24.8,24.28,500,919,419,1627,990,-637,67.0,3427.0,3360.0,0.0,15500.0,15500.0
dresc101,Chuck Dressen,StPaul,StPaul,1,1,1,2,1924,1924,0,8.47,0.0,-8.47,630,0,-630,2488,0,-2488,0.0,0.0,0.0,0.0,4500.0,4500.0
dresl101,Lee Dressen,SaltLakeCity,SaltLakeCity,1,1,2,3,1913,1913,0,-0.05,0.0,0.05,46,0,-46,118,0,-118,0.0,0.0,0.0,0.0,0.0,0.0
dresr001,Ryan Drese,Cleveland Indians,INDINS,2,3,3,6,2002,2012,10,4.1,24.75,20.65,161,1080,919,366,4413,4047,970.0,8.0,-962.0,1601500.0,0.0,-1601500.0
dresr101,Rob Dressler,San Francisco Giants,GIANTS,2,2,3,5,1978,1980,2,0.48,-0.42,-0.9,55,129,74,87,398,311,39.0,0.0,-39.0,0.0,0.0,0.0
drewf101,Frank Drews,Brooklyn Dodgers,DOGRS,1,1,2,3,1944,1951,7,0.22,0.92,0.7,95,99,4,335,257,-78,0.0,0.0,0.0,0.0,0.0,0.0
drewj001,J.D. Drew,St. Louis Cardinals,CARDS,2,3,5,8,2003,2021,18,10.7,51.54,40.84,366,1812,1446,926,2456,1530,134.0,9250.0,9116.0,7050000.0,1294000.0,-5756000.0
drews001,Stephen Drew,Arizona Diamondbacks,DBACKS,1,1,1,2,2012,2012,0,0.06,0.0,-0.06,39,0,-39,172,0,-172,0.0,0.0,0.0,0.0,0.0,0.0
drews001,Stephen Drew,Boston Red Sox,RSOX,2,4,3,7,2014,2015,1,-0.74,0.06,0.8,196,27,-169,628,66,-562,0.0,0.0,0.0,10100000.0,3515000.0,-6585000.0
drewt001,Tim Drew,Cleveland Indians,INDINS,10,19,27,46,2002,2021,19,63.04,99.19,36.15,2801,3478,677,9898,8220,-1678,3587.0,12440.0,8853.0,39810300.0,19652500.0,-20157800.0
dried001,Dan Driessen,Cincinnati Reds,REDS,4,7,6,13,1984,1988,4,14.57,5.9,-8.67,1034,276,-758,1158,371,-787,4251.0,1901.0,-2350.0,1777500.0,937500.0,-840000.0
dried001,Dan Driessen,Montreal Expos,NATEX,4,4,6,10,1985,1990,5,0.02,-2.18,-2.2,184,103,-81,337,103,-234,424.0,129.0,-295.0,0.0,752000.0,752000.0
drisj101,Jim Driscoll,Texas Rangers,RNGRS,1,2,1,3,1972,1975,3,0.39,2.11,1.72,55,66,11,69,0,-69,0.0,589.0,589.0,20000.0,0.0,-20000.0
dropw101,Walt Dropo,Boston Red Sox,RSOX,2,6,6,12,1952,1956,4,8.2,10.1,1.9,1335,867,-468,4777,3045,-1732,507.0,401.0,-106.0,80000.0,40000.0,-40000.0
dropw101,Walt Dropo,Detroit Tigers,TIGRS,6,11,11,22,1954,1964,10,2.44,17.09,14.65,689,625,-64,1873,996,-877,460.0,3101.0,2641.0,37500.0,0.0,-37500.0
dropw101,Walt Dropo,Cincinnati Reds,REDS,1,1,1,2,1959,1959,0,0.4,-0.13,-0.53,155,52,-103,398,89,-309,0.0,0.0,0.0,2000.0,0.0,-2000.0
druhc101,Carl Druhot,Cincinnati Reds,REDS,1,1,1,2,1906,1908,2,1.02,-0.02,-1.04,32,1,-31,57,1,-56,398.0,0.0,-398.0,0.0,0.0,0.0
druhc101,Carl Druhot,St. Louis Cardinals,CARDS,1,1,1,2,1907,1907,0,0.0,-0.73,-0.73,0,6,6,0,2,2,0.0,20.0,20.0,0.0,0.0,0.0
drumk101,Keith Drumright,Chicago Cubs,CUBS,1,1,1,2,1977,1977,0,-0.56,0.0,0.56,17,0,-17,59,0,-59,0.0,0.0,0.0,0.0,0.0,0.0
drumk101,Keith Drumright,Houston Astros,ASTROS,1,1,1,2,1979,1979,0,0.0,-0.01,-0.01,0,28,28,0,3,3,0.0,67.0,67.0,0.0,0.0,0.0
drumk101,Keith Drumright,Chicago Cubs,CUBS,2,3,2,5,1980,1982,2,1.71,0.0,-1.71,188,0,-188,646,0,-646,0.0,0.0,0.0,0.0,0.0,0.0
drumt001,Tim Drummond,Pittsburgh Pirates,PIRATS,2,3,3,6,1988,1988,0,13.41,0.21,-13.2,931,40,-891,3050,103,-2947,0.0,0.0,0.0,62500.0,0.0,-62500.0
drumt001,Tim Drummond,New York Mets,METS,1,5,1,6,1989,1991,2,34.39,9.58,-24.81,807,164,-643,0,204,204,6852.0,1699.0,-5153.0,378000.0,2766666.0,2388666.0
drurb001,Brandon Drury,Atlanta Braves,BRAVES,4,10,11,21,2013,2019,6,22.68,8.16,-14.52,2194,1203,-991,6430,4358,-2072,1394.0,147.0,-1247.0,14250000.0,0.0,-14250000.0
drurb001,Brandon Drury,Arizona Diamondbacks,DBACKS,1,4,2,6,2018,2019,1,-0.29,-0.4,-0.11,18,72,54,57,272,215,0.0,0.0,0.0,0.0,0.0,0.0
drurb001,Brandon Drury,New York Yankees,YANKS,1,2,1,3,2018,2020,2,-1.13,4.31,5.44,271,53,-218,932,4,-928,0.0,823.0,823.0,621900.0,13000000.0,12378100.0
dubim101,Monk Dubiel,Philadelphia Phillies,PHILS,1,2,2,4,1948,1954,6,13.76,7.72,-6.04,587,642,55,227,2516,2289,2431.0,597.0,-1834.0,0.0,16000.0,16000.0
dubim101,Monk Dubiel,Chicago Cubs,CUBS,1,1,1,2,1952,1952,0,0.0,0.0,0.0,0,0,0,0,0,0,0.0,0.0,0.0,0.0,0.0,0.0
dubob001,Brian Dubois,Baltimore Orioles,ORLS,1,1,1,2,1989,1989,0,0.82,-0.74,-1.56,18,33,15,0,111,111,283.0,0.0,-283.0,0.0,1483333.0,1483333.0
duboj001,Jason Dubois,Chicago Cubs,CUBS,3,4,3,7,2005,2012,7,-0.65,-0.26,0.39,39,149,110,125,101,-24,0.0,192.0,192.0,320000.0,8106200.0,7786200.0
dubom001,Mauricio Dubon,Boston Red Sox,RSOX,1,4,1,5,2016,2019,3,5.97,-0.24,-6.21,440,43,-397,1667,0,-1667,0.0,128.0,128.0,515000.0,513900.0,-1100.0
dubom001,Mauricio Dubon,Milwaukee Brewers,BREWRS,1,1,2,3,2019,2019,0,1.96,0.94,-1.02,156,80,-76,473,2,-471,0.0,121.0,121.0,0.0,1500000.0,1500000.0
duceb001,Rob Ducey,Toronto Blue Jays,BJAYS,1,2,1,3,1992,1993,1,0.36,1.7,1.34,277,77,-200,834,0,-834,0.0,311.0,311.0,725000.0,1805000.0,1080000.0
duceb001,Rob Ducey,Philadelphia Phillies,PHILS,1,1,1,2,2000,2000,0,-0.16,0.0,0.16,5,0,-5,15,0,-15,0.0,0.0,0.0,500000.0,0.0,-500000.0
duceb001,Rob Ducey,Toronto Blue Jays,BJAYS,1,1,1,2,2000,2000,0,-0.11,-0.22,-0.11,142,35,-107,217,116,-101,0.0,0.0,0.0,0.0,750000.0,750000.0
duchj001,Justin Duchscherer,Boston Red Sox,RSOX,2,2,2,4,2001,2006,5,-0.88,4.6,5.48,19,437,418,26,1551,1525,44.0,0.0,-44.0,1500000.0,3045000.0,1545000.0
duchj001,Justin Duchscherer,Texas Rangers,RNGRS,2,2,2,4,2002,2002,0,12.24,0.0,-12.24,669,0,-669,8,0,-8,1966.0,0.0,-1966.0,0.0,0.0,0.0
duckb001,Brandon Duckworth,Philadelphia Phillies,PHILS,1,3,1,4,2003,2005,2,-3.72,3.94,7.66,149,236,87,71,5,-66,766.0,378.0,-388.0,325000.0,8000000.0,7675000.0
duckj101,Jim Duckworth,Washington Senators,RNGRS,1,1,1,2,1966,1967,1,-0.83,0.26,1.09,16,97,81,2,370,368,36.0,0.0,-36.0,0.0,0.0,0.0
duckj101,Jim Duckworth,Kansas City Athletics,ATLTCS,1,1,1,2,1966,1968,2,-0.42,1.47,1.89,10,176,166,3,18,15,43.0,460.0,417.0,0.0,12000.0,12000.0
dudal001,Lucas Duda,New York Mets,METS,1,1,1,2,2017,2017,0,0.13,0.0,-0.13,52,0,-52,200,0,-200,0.0,0.0,0.0,7250000.0,0.0,-7250000.0
dudlc101,Clise Dudley,Brooklyn Dodgers,DOGRS,2,6,3,9,1930,1936,6,9.9,18.06,8.16,811,786,-25,1763,3200,1437,2519.0,0.0,-2519.0,18200.0,17000.0,-1200.0
duffd001,Danny Duffy,Kansas City Royals,ROYALS,1,2,1,3,2021,2021,0,0.0,0.0,0.0,0,0,0,0,0,0,0.0,0.0,0.0,15500000.0,0.0,-15500000.0
dufff101,Frank Duffy,Cincinnati Reds,REDS,4,5,7,12,1971,1988,17,3.96,42.07,38.11,701,1797,1096,2673,5857,3184,86.0,981.0,895.0,0.0,0.0,0.0
dufff101,Frank Duffy,San Francisco Giants,GIANTS,1,2,1,3,1971,1973,2,40.19,-0.73,-40.92,981,92,-889,2877,77,-2800,3392.0,613.0,-2779.0,84000.0,72000.0,-12000.0
dufff101,Frank Duffy,Cleveland Indians,INDINS,1,1,1,2,1978,1978,0,-0.74,0.15,0.89,70,6,-64,120,0,-120,0.0,28.0,28.0,0.0,0.0,0.0
duffj102,Jim Duffalo,San Francisco Giants,GIANTS,1,1,1,2,1965,1966,1,0.23,1.35,1.12,44,140,96,8,7,-1,133.0,191.0,58.0,0.0,0.0,0.0
duffm001,Matt Duff,St. Louis Cardinals,CARDS,1,1,1,2,2004,2004,0,0.0,3.28,3.28,0,145,145,0,606,606,0.0,0.0,0.0,0.0,0.0,0.0
duffm002,Matt Duffy,San Francisco Giants,GIANTS,2,5,3,8,2016,2017,1,1.48,0.39,-1.09,241,87,-154,809,81,-728,306.0,728.0,422.0,7000000.0,0.0,-7000000.0
dugag101,Gus Dugas,Pittsburgh Pirates,PIRATS,2,4,4,8,1932,1938,6,21.37,8.93,-12.44,671,581,-90,1015,1370,355,4458.0,2252.0,-2206.0,0.0,0.0,0.0
dugag101,Gus Dugas,Philadelphia Phillies,PHILS,2,4,2,6,1933,1934,1,0.0,-2.07,-2.07,0,73,73,0,272,272,0.0,0.0,0.0,0.0,0.0,0.0
dugaj101,Joe Dugan,Philadelphia Athletics,ATLTCS,3,5,5,10,1922,1930,8,8.5,19.12,10.62,610,716,106,1746,2392,646,1683.0,1623.0,-60.0,18500.0,17500.0,-1000.0
dugaj101,Joe Dugan,Washington Senators,TWINS,2,3,3,6,1922,1933,11,2.2,14.57,12.37,219,710,491,852,2665,1813,0.0,616.0,616.0,0.0,0.0,0.0
dugaj101,Joe Dugan,Boston Red Sox,RSOX,3,7,10,17,1922,1935,13,18.05,-3.44,-21.49,1736,754,-982,6924,2797,-4127,0.0,159.0,159.0,16300.0,15750.0,-550.0
dugeo101,Oscar Dugey,Boston Braves,BRAVES,1,3,1,4,1915,1917,2,5.22,6.66,1.44,653,350,-303,2277,1416,-861,0.0,0.0,0.0,0.0,0.0,0.0
duggr001,Robert Dugger,Seattle Mariners,MARNRS,1,3,2,5,2017,2020,3,-0.89,1.81,2.7,38,291,253,23,1091,1068,267.0,0.0,-267.0,0.0,7800000.0,7800000.0
dukee001,Elijah Dukes,Tampa Bay Devil Rays,RAYS,1,1,1,2,2007,2007,0,1.99,0.0,-1.99,188,0,-188,750,0,-750,0.0,0.0,0.0,380000.0,0.0,-380000.0
duket101,Tom Dukes,New York Yankees,YANKS,1,1,1,2,1965,1965,0,0.0,0.05,0.05,0,20,20,0,3,3,0.0,61.0,61.0,0.0,12000.0,12000.0
duket101,Tom Dukes,Atlanta Braves,BRAVES,1,3,3,6,1966,1970,4,-2.48,0.0,2.48,260,0,-260,50,0,-50,409.0,0.0,-409.0,0.0,0.0,0.0
duket101,Tom Dukes,San Diego Padres,PADRS,2,3,5,8,1970,1978,8,5.53,1.56,-3.97,208,961,753,208,2714,2506,1767.0,691.0,-1076.0,35500.0,42000.0,6500.0
duket101,Tom Dukes,Baltimore Orioles,ORLS,6,14,14,28,1972,1988,16,17.49,68.84,51.35,933,3480,2547,801,7469,6668,6554.0,11016.0,4462.0,558333.0,0.0,-558333.0
dukez001,Zach Duke,Pittsburgh Pirates,PIRATS,1,1,1,2,2010,2011,1,0.13,0.0,-0.13,41,0,-41,23,0,-23,230.0,0.0,-230.0,4300000.0,0.0,-4300000.0
dukez001,Zach Duke,Chicago White Sox,WSOX,1,1,1,2,2016,2019,3,1.15,-1.57,-2.72,107,96,-11,0,280,280,125.0,0.0,-125.0,0.0,0.0,0.0
dukez001,Zach Duke,Minnesota Twins,TWINS,1,2,2,4,2018,2019,1,-0.01,0.01,0.02,28,6,-22,0,0,0,44.0,56.0,12.0,2150000.0,0.0,-2150000.0
dulib101,Bob Duliba,St. Louis Cardinals,CARDS,1,1,1,2,1963,1963,0,-0.04,0.0,0.04,128,0,-128,7,0,-7,241.0,0.0,-241.0,0.0,0.0,0.0
dulib101,Bob Duliba,California Angels,ANGELS,1,1,1,2,1965,1965,0,0.53,0.0,-0.53,78,0,-78,8,0,-8,193.0,0.0,-193.0,0.0,0.0,0.0
dulib101,Bob Duliba,Boston Red Sox,RSOX,7,14,15,29,1966,1977,11,34.3,14.63,-19.67,1704,1106,-598,5095,2714,-2381,3875.0,3907.0,32.0,155000.0,163750.0,8750.0
dumap001,Phil Dumatrait,Boston Red Sox,RSOX,1,2,1,3,2003,2004,1,-1.4,0.92,2.32,12,55,43,6,0,-6,54.0,147.0,93.0,0.0,1600000.0,1600000.0
dumog101,George Dumont,Washington Senators,TWINS,3,5,4,9,1919,1933,14,-0.71,14.2,14.91,37,1313,1276,32,5773,5741,106.0,0.0,-106.0,34200.0,0.0,-34200.0
duncc002,Chris Duncan,St. Louis Cardinals,CARDS,1,1,1,2,2009,2010,1,0.0,0.64,0.64,0,51,51,0,170,170,0.0,0.0,0.0,825000.0,9250000.0,8425000.0
duncd101,Dave Duncan,Oakland Athletics,ATLTCS,1,2,2,4,1973,1975,2,10.02,2.05,-7.97,777,294,-483,3090,901,-2189,0.0,0.0,0.0,0.0,0.0,0.0
duncd101,Dave Duncan,Cleveland Indians,INDINS,3,4,5,9,1975,1983,8,1.76,7.83,6.07,284,560,276,867,1386,519,202.0,1484.0,1282.0,0.0,0.0,0.0
duncd101,Dave Duncan,Baltimore Orioles,ORLS,1,1,1,2,1976,1980,4,0.0,3.73,3.73,0,377,377,0,1155,1155,0.0,0.0,0.0,0.0,0.0,0.0
duncm001,Mariano Duncan,Los Angeles Dodgers,DOGRS,2,3,3,6,1989,1993,4,3.28,8.3,5.02,375,891,516,1244,2884,1640,269.0,0.0,-269.0,3370000.0,325000.0,-3045000.0
duncm001,Mariano Duncan,New York Yankees,YANKS,1,2,1,3,1997,1997,0,-0.08,0.0,0.08,39,0,-39,176,0,-176,0.0,0.0,0.0,870000.0,0.0,-870000.0
dunct101,Taylor Duncan,Atlanta Braves,BRAVES,11,19,24,43,1972,1986,14,30.99,9.46,-21.53,1998,2587,589,5259,6910,1651,4220.0,2478.0,-1742.0,95000.0,320500.0,225500.0
dungs101,Sam Dungan,Chicago Cubs,CUBS,1,1,1,2,1894,1894,0,0.13,1.25,1.12,8,40,32,37,107,70,0.0,385.0,385.0,0.0,0.0,0.0
dungs101,Sam Dungan,Chicago Cubs,CUBS,2,6,2,8,1900,1902,2,10.49,0.81,-9.68,648,153,-495,2353,607,-1746,0.0,0.0,0.0,0.0,0.0,0.0
dunkd101,Davy Dunkle,Chicago White Sox,WSOX,1,1,1,2,1903,1903,0,-0.88,1.48,2.36,53,86,33,69,383,314,548.0,0.0,-548.0,0.0,0.0,0.0
dunna001,Adam Dunn,Cincinnati Reds,REDS,1,2,3,5,2008,2010,2,-0.36,-0.17,0.19,44,138,94,187,113,-74,0.0,459.0,459.0,13000000.0,402000.0,-12598000.0
dunna001,Adam Dunn,Chicago White Sox,WSOX,1,2,1,3,2014,2014,0,-0.03,0.0,0.03,25,0,-25,76,0,-76,0.0,0.0,0.0,15000000.0,0.0,-15000000.0
dunnd001,Dane Dunning,Washington Nationals,NATEX,1,3,1,4,2016,2020,4,16.01,2.64,-13.37,233,310,77,19,1309,1290,3554.0,0.0,-3554.0,0.0,2750000.0,2750000.0
dunnd001,Dane Dunning,Chicago White Sox,WSOX,1,2,1,3,2020,2020,0,0.72,0.0,-0.72,29,0,-29,4,0,-4,353.0,0.0,-353.0,0.0,11333334.0,11333334.0
dunnj002,Justin Dunn,New York Mets,METS,1,5,3,8,2018,2018,0,-0.49,0.0,0.49,191,0,-191,565,0,-565,376.0,0.0,-376.0,16500000.0,12258065.0,-4241935.0
dunnm001,Mike Dunne,St. Louis Cardinals,CARDS,1,3,1,4,1987,1989,2,43.01,2.18,-40.83,1782,406,-1376,6646,1435,-5211,1043.0,0.0,-1043.0,0.0,0.0,0.0
dunnm001,Mike Dunne,Pittsburgh Pirates,PIRATS,1,3,2,5,1989,1989,0,-1.22,-1.21,0.01,20,71,51,0,253,253,300.0,0.0,-300.0,222500.0,215000.0,-7500.0
dunnm002,Michael Dunn,New York Yankees,YANKS,1,4,2,6,2009,2013,4,3.9,2.44,-1.46,585,309,-276,511,6,-505,625.0,1000.0,375.0,1800000.0,11927500.0,10127500.0
dunnm002,Michael Dunn,Atlanta Braves,BRAVES,1,2,1,3,2010,2014,4,6.58,3.15,-3.43,1022,499,-523,990,1984,994,984.0,0.0,-984.0,2225000.0,7800000.0,5575000.0
dunns002,Scott Dunn,Cincinnati Reds,REDS,1,1,1,2,2003,2005,2,0.0,5.59,5.59,0,260,260,0,1102,1102,0.0,0.0,0.0,0.0,345000.0,345000.0
dunns002,Scott Dunn,Chicago White Sox,WSOX,1,3,2,5,2003,2004,1,0.04,0.32,0.28,21,41,20,0,2,2,90.0,416.0,326.0,330000.0,1425000.0,1095000.0
dunns101,Steve Dunning,Cleveland Indians,INDINS,6,8,8,16,1973,1976,3,-3.1,-1.46,1.64,208,89,-119,203,44,-159,1382.0,1189.0,-193.0,89000.0,35000.0,-54000.0
dunns101,Steve Dunning,Texas Rangers,RNGRS,2,3,2,5,1975,1977,2,0.0,0.93,0.93,0,21,21,0,0,0,0.0,278.0,278.0,0.0,0.0,0.0
dunns101,Steve Dunning,Chicago White Sox,WSOX,2,5,5,10,1975,1978,3,1.08,-0.17,-1.25,421,278,-143,1261,1093,-168,18.0,0.0,-18.0,70000.0,0.0,-70000.0
dunns101,Steve Dunning,Montreal Expos,NATEX,3,6,6,12,1976,1983,7,4.1,3.12,-0.98,573,1002,429,1861,2648,787,25.0,308.0,283.0,0.0,0.0,0.0
dunns101,Steve Dunning,St. Louis Cardinals,CARDS,1,1,1,2,1977,1977,0,0.18,0.0,-0.18,6,0,-6,0,0,0,55.0,0.0,-55.0,0.0,0.0,0.0
dunnt001,Todd Dunn,Milwaukee Brewers,BREWRS,1,1,1,2,1999,2000,1,0.0,0.16,0.16,0,56,56,0,128,128,0.0,0.0,0.0,0.0,0.0,0.0
dunss001,Shawon Dunston,Cleveland Indians,INDINS,7,12,14,26,1998,2011,13,4.4,12.56,8.16,1064,1445,381,2423,3925,1502,442.0,1477.0,1035.0,9756200.0,3392500.0,-6363700.0
dunss001,Shawon Dunston,St. Louis Cardinals,CARDS,1,1,1,2,1999,2001,2,0.26,0.85,0.59,42,305,263,97,956,859,0.0,0.0,0.0,610000.0,0.0,-610000.0
dunwt001,Todd Dunwoody,Florida Marlins,MARLNS,1,1,1,2,1999,1999,0,-1.52,0.0,1.52,61,0,-61,195,0,-195,0.0,0.0,0.0,222000.0,0.0,-222000.0
durae001,Erubiel Durazo,Arizona Diamondbacks,DBACKS,2,2,3,5,2002,2004,2,5.68,1.54,-4.14,454,142,-312,1405,84,-1321,325.0,783.0,458.0,4375000.0,0.0,-4375000.0
durar001,Roberto Duran,Toronto Blue Jays,BJAYS,1,1,1,2,1996,1996,0,-0.1,0.0,0.1,32,0,-32,0,0,0,78.0,0.0,-78.0,0.0,0.0,0.0
durbk101,Blaine Durbin,Chicago Cubs,CUBS,1,2,1,3,1909,1909,0,2.39,-0.63,-3.02,347,20,-327,1320,55,-1265,0.0,0.0,0.0,0.0,0.0,0.0
durbk101,Blaine Durbin,Cincinnati Reds,REDS,1,1,2,3,1909,1910,1,0.0,0.92,0.92,1,124,123,0,278,278,0.0,0.0,0.0,0.0,0.0,0.0
durer101,Ryne Duren,Baltimore Orioles,ORLS,6,15,10,25,1956,1973,17,20.81,32.2,11.39,1684,2354,670,5686,7591,1905,973.0,480.0,-493.0,72000.0,40300.0,-31700.0
durer101,Ryne Duren,Kansas City Athletics,ATLTCS,50,107,110,217,1957,1976,19,243.41,144.18,-99.23,19841,14910,-4931,49436,46172,-3264,28049.0,12074.0,-15975.0,661100.0,839000.0,177900.0
durer101,Ryne Duren,New York Yankees,YANKS,1,3,2,5,1961,1962,1,3.35,0.73,-2.62,729,113,-616,2005,155,-1850,725.0,95.0,-630.0,0.0,0.0,0.0
durhd101,Don Durham,St. Louis Cardinals,CARDS,3,3,3,6,1973,1973,0,-1.09,0.0,1.09,16,0,-16,0,0,0,121.0,0.0,-121.0,0.0,6600.0,6600.0
durhe101,Ed Durham,Boston Red Sox,RSOX,5,12,11,23,1932,1940,8,26.52,36.5,9.98,1813,1321,-492,6379,4051,-2328,2979.0,4057.0,1078.0,56000.0,56600.0,600.0
durhl001,Leon Durham,St. Louis Cardinals,CARDS,1,3,1,4,1980,1984,4,14.5,6.0,-8.5,1050,498,-552,4046,39,-4007,0.0,1190.0,1190.0,0.0,700000.0,700000.0
durhl001,Leon Durham,Chicago Cubs,CUBS,1,1,2,3,1988,1989,1,-0.23,1.9,2.13,21,108,87,56,7,-49,0.0,221.0,221.0,1383333.0,132500.0,-1250833.0
durhr001,Ray Durham,Chicago White Sox,WSOX,1,2,1,3,2002,2005,3,1.21,0.09,-1.12,54,62,8,248,0,-248,0.0,239.0,239.0,6300000.0,0.0,-6300000.0
durhr001,Ray Durham,San Francisco Giants,GIANTS,1,1,2,3,2008,2011,3,0.68,0.19,-0.49,41,33,-8,122,16,-106,0.0,0.0,0.0,7500000.0,0.0,-7500000.0
durol101,Leo Durocher,Cincinnati Reds,REDS,4,7,8,15,1933,1943,10,2.09,48.62,46.53,936,2007,1071,3163,5265,2102,264.0,8479.0,8215.0,23000.0,0.0,-23000.0
durol101,Leo Durocher,St. Louis Cardinals,CARDS,1,1,4,5,1937,1941,4,1.05,2.09,1.04,345,108,-237,1195,269,-926,0.0,390.0,390.0,10000.0,10000.0,0.0
dursc101,Cedric Durst,St.Louis Browns,ORLS,4,6,5,11,1927,1935,8,9.57,7.29,-2.28,658,806,148,956,588,-368,3247.0,5119.0,1872.0,22500.0,15100.0,-7400.0
dursc101,Cedric Durst,New York Yankees,YANKS,1,2,1,3,1930,1946,16,-0.48,56.84,57.32,102,1057,955,330,1589,1259,0.0,9506.0,9506.0,6000.0,6750.0,750.0
dusae101,Erv Dusak,St. Louis Cardinals,CARDS,1,2,1,3,1951,1952,1,2.13,0.47,-1.66,381,51,-330,862,202,-660,20.0,0.0,-20.0,0.0,0.0,0.0
duvaa001,Adam Duvall,San Francisco Giants,GIANTS,1,2,1,3,2015,2015,0,6.27,0.49,-5.78,455,19,-436,1700,17,-1683,51.0,166.0,115.0,0.0,9775000.0,9775000.0
duvaa001,Adam Duvall,Cincinnati Reds,REDS,2,2,4,6,2018,2019,1,2.16,-0.13,-2.29,225,45,-180,613,43,-570,87.0,56.0,-31.0,645000.0,565000.0,-80000.0
duvaa001,Adam Duvall,Miami Marlins,MARLNS,1,1,1,2,2021,2021,0,1.19,-0.24,-1.43,55,42,-13,216,123,-93,0.0,0.0,0.0,0.0,0.0,0.0
dwyej001,Jim Dwyer,St. Louis Cardinals,CARDS,2,2,2,4,1975,1975,0,0.76,0.22,-0.54,232,27,-205,370,21,-349,0.0,0.0,0.0,0.0,0.0,0.0
dwyej001,Jim Dwyer,Montreal Expos,NATEX,1,2,2,4,1976,1978,2,-0.15,2.45,2.6,60,488,428,138,1259,1121,0.0,0.0,0.0,0.0,0.0,0.0
dwyej001,Jim Dwyer,New York Mets,METS,1,1,1,2,1976,1977,1,0.0,0.0,0.0,0,0,0,0,0,0,0.0,0.0,0.0,0.0,0.0,0.0
dwyej001,Jim Dwyer,St. Louis Cardinals,CARDS,1,1,1,2,1978,1980,2,-0.04,0.0,0.04,73,0,-73,208,0,-208,0.0,0.0,0.0,0.0,0.0,0.0
dwyej001,Jim Dwyer,Baltimore Orioles,ORLS,3,3,3,6,1988,1989,1,0.65,0.0,-0.65,177,0,-177,388,0,-388,72.0,0.0,-72.0,300000.0,0.0,-300000.0
dwyej001,Jim Dwyer,Minnesota Twins,TWINS,1,1,1,2,1989,1990,1,0.0,0.0,0.0,13,0,-13,11,0,-11,0.0,0.0,0.0,200000.0,0.0,-200000.0
dwyej001,Jim Dwyer,Montreal Expos,NATEX,1,1,1,2,1990,1990,0,-0.44,0.0,0.44,37,0,-37,75,0,-75,0.0,0.0,0.0,0.0,0.0,0.0
dybzj001,Jerry Dybzinski,Cleveland Indians,INDINS,20,26,32,58,1983,2020,37,32.15,125.61,93.46,3762,4140,378,11221,11952,731,4030.0,10939.0,6909.0,46229400.0,16426500.0,-29802900.0
dyckj101,Jim Dyck,Baltimore Orioles,ORLS,1,1,1,2,1954,1955,1,0.0,-0.81,-0.81,2,132,130,2,439,437,0.0,0.0,0.0,0.0,0.0,0.0
dye-j001,Jermaine Dye,Atlanta Braves,BRAVES,3,8,7,15,1997,2002,5,31.06,17.6,-13.46,2077,2024,-53,7209,4599,-2610,1427.0,898.0,-529.0,12520000.0,11751680.0,-768320.0
dye-j001,Jermaine Dye,Kansas City Royals,ROYALS,1,1,1,2,2001,2002,1,0.0,-2.28,-2.28,0,194,194,0,805,805,0.0,0.0,0.0,3800000.0,3550000.0,-250000.0
dye-j001,Jermaine Dye,Colorado Rockies,ROCKS,1,1,3,4,2001,2003,2,2.82,0.24,-2.58,394,89,-305,1663,292,-1371,0.0,28.0,28.0,0.0,201000.0,201000.0
dyerd101,Duffy Dyer,New York Mets,METS,2,2,2,4,1974,1976,2,3.09,-0.34,-3.43,385,82,-303,1370,216,-1154,0.0,0.0,0.0,0.0,0.0,0.0
dyerd101,Duffy Dyer,Montreal Expos,NATEX,2,2,2,4,1980,1982,2,-0.57,0.11,0.68,52,34,-18,132,69,-63,0.0,0.0,0.0,0.0,0.0,0.0
dykej101,Jimmy Dykes,Detroit Tigers,TIGRS,1,1,1,2,1960,1960,0,0.0,0.0,0.0,0,0,0,0,0,0,0.0,0.0,0.0,0.0,0.0,0.0
dyksa001,Allan Dykstra,San Diego Padres,PADRS,1,1,1,2,2011,2011,0,0.0,0.0,0.0,0,0,0,0,0,0,0.0,0.0,0.0,0.0,0.0,0.0
dyksl001,Lenny Dykstra,New York Mets,METS,13,21,23,44,1989,1999,10,42.74,12.21,-30.53,2762,1749,-1013,6221,1744,-4477,4175.0,4730.0,555.0,13614666.0,12979167.0,-635499.0
dysoj001,Jarrod Dyson,Kansas City Royals,ROYALS,1,1,1,2,2017,2018,1,2.72,1.04,-1.68,111,9,-102,390,0,-390,0.0,136.0,136.0,0.0,0.0,0.0
dysoj001,Jarrod Dyson,Pittsburgh Pirates,PIRATS,1,1,1,2,2020,2020,0,-0.08,0.0,0.08,11,0,-11,11,0,-11,0.0,0.0,0.0,2000000.0,0.0,-2000000.0
dysos001,Sam Dyson,Miami Marlins,MARLNS,1,1,2,3,2015,2018,3,2.95,-0.63,-3.58,128,108,-20,0,185,185,355.0,9.0,-346.0,507500.0,0.0,-507500.0
dysos001,Sam Dyson,Texas Rangers,RNGRS,1,2,1,3,2017,2017,0,2.87,0.0,-2.87,313,0,-313,0,0,0,478.0,0.0,-478.0,0.0,0.0,0.0
dysos001,Sam Dyson,San Francisco Giants,GIANTS,1,1,3,4,2019,2019,0,-0.29,-0.51,-0.22,15,17,2,0,47,47,34.0,0.0,-34.0,5000000.0,0.0,-5000000.0
earla101,Arnold Earley,Boston Red Sox,RSOX,1,3,2,5,1965,1968,3,0.78,1.64,0.86,187,156,-31,154,15,-139,353.0,393.0,40.0,12500.0,15000.0,2500.0
earla101,Arnold Earley,Atlanta Braves,BRAVES,2,4,3,7,1966,1966,0,-0.17,-0.08,0.09,59,17,-42,34,18,-16,53.0,0.0,-53.0,0.0,0.0,0.0
earla101,Arnold Earley,Chicago Cubs,CUBS,1,1,1,2,1967,1967,0,-0.22,0.0,0.22,4,0,-4,0,0,0,4.0,0.0,-4.0,0.0,0.0,0.0
earlj101,Jake Early,Washington Senators,TWINS,1,1,1,2,1946,1946,0,1.42,0.0,-1.42,87,0,-87,268,0,-268,0.0,0.0,0.0,0.0,6500.0,6500.0
earng101,George Earnshaw,Baltimore,Baltimore,1,1,2,3,1928,1928,0,17.91,0.0,-17.91,438,0,-438,562,0,-562,4060.0,0.0,-4060.0,0.0,6000.0,6000.0
earng101,George Earnshaw,Philadelphia Athletics,ATLTCS,1,2,2,4,1933,1935,2,3.62,0.35,-3.27,76,161,85,105,502,397,735.0,0.0,-735.0,7500.0,8000.0,500.0
earng101,George Earnshaw,Brooklyn Dodgers,DOGRS,5,10,7,17,1936,1947,11,-0.88,35.78,36.66,116,1457,1341,57,5839,5782,553.0,123.0,-430.0,0.0,0.0,0.0
easld001,Damion Easley,California Angels,ANGELS,1,1,1,2,1996,1996,0,17.79,-0.3,-18.09,841,15,-826,3512,0,-3512,0.0,72.0,72.0,305000.0,200000.0,-105000.0
easll001,Logan Easley,New York Yankees,YANKS,8,12,14,26,1986,1997,11,30.93,13.18,-17.75,1250,1055,-195,1880,1524,-356,6414.0,3621.0,-2793.0,3550000.0,2212500.0,-1337500.0
easlm001,Mike Easler,Houston Astros,ASTROS,2,3,2,5,1975,1978,3,0.55,-0.53,-1.08,312,183,-129,705,518,-187,441.0,66.0,-375.0,0.0,0.0,0.0
easlm001,Mike Easler,St. Louis Cardinals,CARDS,1,1,1,2,1976,1976,0,-0.35,0.0,0.35,21,0,-21,59,0,-59,0.0,0.0,0.0,0.0,0.0,0.0
easlm001,Mike Easler,California Angels,ANGELS,1,1,1,2,1977,1977,0,7.88,0.0,-7.88,549,0,-549,1829,0,-1829,0.0,0.0,0.0,0.0,0.0,0.0
easlm001,Mike Easler,Boston Red Sox,RSOX,1,1,3,4,1979,1979,0,7.58,0.0,-7.58,539,0,-539,1810,0,-1810,0.0,0.0,0.0,0.0,0.0,0.0
easlm001,Mike Easler,Pittsburgh Pirates,PIRATS,4,9,9,18,1983,1992,9,33.21,24.1,-9.11,1132,1554,422,2374,1634,-740,5314.0,7695.0,2381.0,1030000.0,405000.0,-625000.0
easlm001,Mike Easler,Boston Red Sox,RSOX,2,2,2,4,1986,1987,1,1.83,2.07,0.24,231,268,37,788,1096,308,0.0,0.0,0.0,0.0,0.0,0.0
easlm001,Mike Easler,New York Yankees,YANKS,2,3,3,6,1986,1989,3,-1.2,3.08,4.28,102,129,27,211,183,-28,200.0,783.0,583.0,658333.0,277500.0,-380833.0
easlm001,Mike Easler,Philadelphia Phillies,PHILS,4,6,6,12,1987,1989,2,-2.64,0.15,2.79,234,140,-94,689,302,-387,0.0,49.0,49.0,1095000.0,62500.0,-1032500.0
eastc101,Carl East,Minneapolis,Minneapolis,1,1,1,2,1924,1932,8,0.09,0.0,-0.09,2,0,-2,8,0,-8,0.0,0.0,0.0,0.0,0.0,0.0
eastc101,Carl East,LittleRock,LittleRock,2,3,7,10,1915,1916,1,0.33,0.0,-0.33,131,0,-131,145,0,-145,73.0,0.0,-73.0,0.0,4200.0,4200.0
eastj001,Jamie Easterly,Milwaukee Brewers,BREWRS,1,3,2,5,1983,1987,4,7.32,0.25,-7.07,394,574,180,437,1374,937,1362.0,450.0,-912.0,600000.0,885000.0,285000.0
eastp101,Paul Easterling,Philadelphia Athletics,ATLTCS,2,4,2,6,1938,1947,9,0.0,6.93,6.93,0,1140,1140,0,4751,4751,0.0,0.0,0.0,12000.0,13500.0,1500.0
eastr101,Rawly Eastwick,Cincinnati Reds,REDS,2,2,2,4,1977,1984,7,1.53,-0.48,-2.01,271,67,-204,32,42,10,635.0,371.0,-264.0,23200.0,0.0,-23200.0
eastr101,Rawly Eastwick,New York Yankees,YANKS,2,2,3,5,1978,1980,2,-1.22,-0.23,0.99,221,59,-162,235,123,-112,369.0,0.0,-369.0,220000.0,0.0,-220000.0
eastr102,Roy Easterwood,Chicago Cubs,CUBS,1,1,1,2,1948,1948,0,0.0,0.0,0.0,0,0,0,0,0,0,0.0,0.0,0.0,0.0,0.0,0.0
eatoa001,Adam Eaton,Philadelphia Phillies,PHILS,3,6,5,11,1999,2003,4,6.55,1.13,-5.42,362,281,-81,360,99,-261,2958.0,1114.0,-1844.0,6615000.0,10757500.0,4142500.0
eatoa001,Adam Eaton,San Diego Padres,PADRS,9,21,20,41,2006,2021,15,51.12,29.32,-21.8,2292,1830,-462,7839,5012,-2827,1512.0,4191.0,2679.0,15535200.0,5157500.0,-10377700.0
eatoa002,Adam Eaton,Arizona Diamondbacks,DBACKS,2,4,7,11,2013,2018,5,18.83,2.34,-16.49,681,392,-289,2515,1311,-1204,400.0,119.0,-281.0,491000.0,2100000.0,1609000.0
eatoa002,Adam Eaton,Chicago White Sox,WSOX,2,3,4,7,2016,2020,4,3.36,0.15,-3.21,339,7,-332,1313,0,-1313,353.0,102.0,-251.0,2750000.0,11333334.0,8583334.0
eatoc101,Craig Eaton,Kansas City Royals,ROYALS,3,5,4,9,1980,1986,6,14.42,8.44,-5.98,1272,909,-363,3936,3256,-680,0.0,0.0,0.0,0.0,250000.0,250000.0
eaveg001,Gary Eave,Atlanta Braves,BRAVES,1,2,1,3,1990,1990,0,0.04,-1.77,-1.81,8,140,132,0,577,577,90.0,0.0,-90.0,0.0,0.0,0.0
eaveg001,Gary Eave,Seattle Mariners,MARNRS,1,1,1,2,1990,1993,3,0.0,0.74,0.74,0,152,152,0,0,0,0.0,749.0,749.0,0.0,100000.0,100000.0
eavev101,Vallie Eaves,Chicago Cubs,CUBS,1,1,1,2,1943,1943,0,0.0,0.36,0.36,0,64,64,0,136,136,0.0,0.0,0.0,0.0,0.0,0.0
eberd001,Derrin Ebert,Chicago Cubs,CUBS,1,1,1,2,2003,2003,0,0.0,0.0,0.0,0,0,0,0,0,0,0.0,0.0,0.0,0.0,0.0,0.0
eckec101,Charlie Eckert,Philadelphia Athletics,ATLTCS,2,4,2,6,1922,1930,8,-0.04,11.94,11.98,62,781,719,204,2980,2776,0.0,0.0,0.0,7800.0,10000.0,2200.0
ecked001,Dennis Eckersley,Cleveland Indians,INDINS,8,14,20,34,1978,2004,26,62.43,62.22,-0.21,2207,3046,839,7220,10248,3028,6797.0,6915.0,118.0,1767500.0,1412500.0,-355000.0
ecked001,Dennis Eckersley,Boston Red Sox,RSOX,1,2,1,3,1984,1987,3,10.18,-0.52,-10.7,204,504,300,312,2176,1864,1592.0,0.0,-1592.0,0.0,0.0,0.0
ecked001,Dennis Eckersley,Chicago Cubs,CUBS,1,2,3,5,1987,1987,0,15.94,0.0,-15.94,542,0,-542,0,0,0,1911.0,0.0,-1911.0,0.0,0.0,0.0
ecked001,Dennis Eckersley,Oakland Athletics,ATLTCS,1,1,1,2,1996,1997,1,0.59,-0.62,-1.21,237,12,-225,1,0,-1,339.0,60.0,-279.0,0.0,0.0,0.0
eckee001,Eric Eckenstahler,Detroit Tigers,TIGRS,1,2,1,3,2004,2004,0,0.0,0.0,0.0,0,0,0,0,0,0,0.0,0.0,0.0,0.0,0.0,0.0
eckho101,Ox Eckhardt,Brooklyn Dodgers,DOGRS,2,7,3,10,1936,1944,8,1.9,2.87,0.97,125,593,468,330,2189,1859,390.0,0.0,-390.0,10000.0,10000.0,0.0
ecksd001,David Eckstein,Toronto Blue Jays,BJAYS,1,1,1,2,2008,2012,4,-0.14,-0.21,-0.07,18,19,1,73,0,-73,0.0,54.0,54.0,4500000.0,0.0,-4500000.0
eddyc001,Chris Eddy,Kansas City Royals,ROYALS,1,1,1,2,1996,1996,0,0.0,0.0,0.0,0,0,0,0,0,0,0.0,0.0,0.0,0.0,130000.0,130000.0
eddyd101,Don Eddy,Chicago White Sox,WSOX,1,2,1,3,1972,1973,1,0.0,-0.08,-0.08,0,74,74,0,295,295,0.0,0.0,0.0,0.0,0.0,0.0
edelj101,Joe Edelen,St. Louis Cardinals,CARDS,3,4,4,8,1981,1985,4,-1.12,3.43,4.55,245,527,282,21,118,97,992.0,934.0,-58.0,450000.0,0.0,-450000.0
edenm101,Mike Eden,San Francisco Giants,GIANTS,2,5,3,8,1976,1983,7,-0.82,27.35,28.17,287,1701,1414,1089,6469,5380,0.0,0.0,0.0,0.0,0.0,0.0
edent001,Tom Edens,Kansas City Royals,ROYALS,1,1,1,2,1984,1984,0,-0.19,-0.3,-0.11,4,9,5,3,14,11,24.0,0.0,-24.0,0.0,0.0,0.0
edent001,Tom Edens,New York Mets,METS,13,21,23,44,1989,1999,10,42.74,12.21,-30.53,2762,1749,-1013,6221,1744,-4477,4175.0,4730.0,555.0,13614666.0,12979167.0,-635499.0
edent001,Tom Edens,Florida Marlins,MARLNS,3,4,4,8,1992,1996,4,2.95,5.1,2.15,559,217,-342,22,182,160,1105.0,1519.0,414.0,0.0,0.0,0.0
edent001,Tom Edens,Houston Astros,ASTROS,1,1,1,2,1994,1995,1,0.14,0.12,-0.02,6,101,95,0,172,172,12.0,0.0,-12.0,475000.0,1375000.0,900000.0
edgeb102,Butch Edge,Atlanta Braves,BRAVES,1,1,1,2,1981,1981,0,0.0,0.0,0.0,0,0,0,0,0,0,0.0,0.0,0.0,0.0,0.0,0.0
edgeb102,Butch Edge,Chicago White Sox,WSOX,2,3,3,6,1982,1987,5,4.43,7.04,2.61,422,580,158,1527,1402,-125,154.0,667.0,513.0,0.0,0.0,0.0
edmoj001,Jim Edmonds,Anaheim Angels,ANGELS,2,2,3,5,2000,2006,6,38.49,19.72,-18.77,1121,1048,-73,4373,3794,-579,132.0,383.0,251.0,4000000.0,5066667.0,1066667.0
edmoj001,Jim Edmonds,St. Louis Cardinals,CARDS,3,4,5,9,2007,2019,12,8.35,13.42,5.07,974,1243,269,2950,3660,710,577.0,194.0,-383.0,13224540.0,0.0,-13224540.0
edmoj001,Jim Edmonds,Milwaukee Brewers,BREWRS,2,2,2,4,2010,2011,1,0.39,-0.11,-0.5,98,68,-30,104,63,-41,0.0,99.0,99.0,850000.0,415000.0,-435000.0
edwab101,Bruce Edwards,Brooklyn Dodgers,DOGRS,3,6,7,13,1951,1958,7,4.28,2.12,-2.16,1667,685,-982,5534,2062,-3472,435.0,267.0,-168.0,50000.0,61500.0,11500.0
edwac001,Carl Edwards,Texas Rangers,RNGRS,1,4,1,5,2013,2013,0,4.33,-0.09,-4.42,1129,13,-1116,283,0,-283,1426.0,253.0,-1173.0,0.0,0.0,0.0
edwac001,Carl Edwards,Chicago Cubs,CUBS,1,1,1,2,2019,2019,0,-0.23,0.21,0.44,4,28,24,0,0,0,5.0,30.0,25.0,1500000.0,0.0,-1500000.0
edwad101,Dave Edwards,Minnesota Twins,TWINS,1,1,1,2,1980,1980,0,-0.7,0.0,0.7,129,0,-129,181,0,-181,0.0,0.0,0.0,0.0,0.0,0.0
edwad102,Doc Edwards,Cleveland Indians,INDINS,3,6,7,13,1963,1970,7,12.89,19.01,6.12,824,1350,526,1390,4230,2840,3166.0,784.0,-2382.0,51000.0,0.0,-51000.0
edwad102,Doc Edwards,Kansas City Athletics,ATLTCS,11,24,17,41,1965,1976,11,26.47,18.12,-8.35,4341,1975,-2366,9113,5030,-4083,5181.0,2140.0,-3041.0,368100.0,463000.0,94900.0
edwad102,Doc Edwards,New York Yankees,YANKS,1,1,1,2,1966,1967,1,0.0,0.17,0.17,0,86,86,0,184,184,0.0,0.0,0.0,0.0,0.0,0.0
edwad102,Doc Edwards,Cleveland Indians,INDINS,2,4,4,8,1967,1969,2,1.58,2.6,1.02,217,267,50,702,761,59,0.0,0.0,0.0,0.0,0.0,0.0
edwah101,Hank Edwards,Chicago Cubs,CUBS,5,9,8,17,1950,1961,11,9.53,14.09,4.56,932,1704,772,1551,6601,5050,802.0,0.0,-802.0,17500.0,0.0,-17500.0
edwah101,Hank Edwards,Cincinnati Reds,REDS,1,1,1,2,1952,1955,3,-0.02,0.91,0.93,8,94,86,18,38,20,0.0,396.0,396.0,0.0,0.0,0.0
edwah101,Hank Edwards,Chicago White Sox,WSOX,5,13,10,23,1952,1961,9,17.5,10.87,-6.63,3154,1282,-1872,10106,3886,-6220,2246.0,536.0,-1710.0,62000.0,99250.0,37250.0
edwaj001,Jon Edwards,Texas Rangers,RNGRS,1,2,1,3,2015,2015,0,0.11,-0.05,-0.16,22,37,15,0,82,82,32.0,0.0,-32.0,508500.0,4250000.0,3741500.0
edwaj101,Johnny Edwards,Cincinnati Reds,REDS,2,2,3,5,1968,1973,5,0.72,-0.31,-1.03,158,137,-21,466,367,-99,0.0,0.0,0.0,0.0,0.0,0.0
edwaj101,Johnny Edwards,St. Louis Cardinals,CARDS,3,4,4,8,1968,1971,3,5.4,-0.19,-5.59,715,29,-686,2340,38,-2302,0.0,0.0,0.0,0.0,0.0,0.0
edwam101,Mike Edwards,Pittsburgh Pirates,PIRATS,5,9,10,19,1978,1984,6,24.55,-1.47,-26.02,1160,294,-866,2724,444,-2280,3108.0,299.0,-2809.0,300000.0,0.0,-300000.0
efliz001,Zach Eflin,San Diego Padres,PADRS,2,5,4,9,2014,2016,2,8.85,0.65,-8.2,684,254,-430,2593,1079,-1514,26.0,0.0,-26.0,1293600.0,21000000.0,19706400.0
efliz001,Zach Eflin,Los Angeles Dodgers,DOGRS,1,2,2,4,2014,2015,1,6.34,0.44,-5.9,200,144,-56,184,563,379,1751.0,0.0,-1751.0,0.0,11000000.0,11000000.0
eganb101,Ben Egan,Philadelphia Athletics,ATLTCS,2,5,3,8,1913,1916,3,0.94,10.04,9.1,71,783,712,237,3271,3034,0.0,0.0,0.0,0.0,0.0,0.0
eganb101,Ben Egan,Boston Red Sox,RSOX,23,51,62,113,1914,1937,23,210.47,131.21,-79.26,10024,6525,-3499,28339,20821,-7518,29017.0,15462.0,-13555.0,136800.0,133950.0,-2850.0
egand101,Dick Egan,Detroit Tigers,TIGRS,1,1,2,3,1965,1965,0,0.0,0.0,0.0,0,0,0,0,0,0,0.0,0.0,0.0,0.0,0.0,0.0
egand101,Dick Egan,California Angels,ANGELS,2,3,2,5,1966,1966,0,-0.66,0.75,1.41,48,38,-10,5,6,1,150.0,129.0,-21.0,8500.0,17000.0,8500.0
egant101,Tom Egan,California Angels,ANGELS,8,17,17,34,1970,1976,6,13.31,15.37,2.06,1179,1226,47,3267,3750,483,2333.0,345.0,-1988.0,137100.0,240300.0,103200.0
eganw101,Wish Egan,St. Louis Cardinals,CARDS,1,2,1,3,1906,1907,1,0.0,-0.14,-0.14,0,22,22,0,79,79,0.0,0.0,0.0,0.0,0.0,0.0
ege-c001,Cody Ege,Texas Rangers,RNGRS,2,4,2,6,2015,2017,2,2.24,2.95,0.71,421,128,-293,185,0,-185,487.0,355.0,-132.0,0.0,507500.0,507500.0
ehmkh101,Howard Ehmke,Detroit Tigers,TIGRS,2,6,3,9,1922,1928,6,20.71,4.6,-16.11,377,336,-41,782,333,-449,2967.0,2739.0,-228.0,8000.0,13500.0,5500.0
ehmkh101,Howard Ehmke,Boston Red Sox,RSOX,3,7,7,14,1926,1928,2,8.68,3.68,-5.0,175,373,198,208,792,584,1623.0,1683.0,60.0,28750.0,10500.0,-18250.0
ehrer101,Red Ehret,Pittsburgh Pirates,PIRATS,4,10,8,18,1895,1910,15,26.22,58.36,32.14,1335,2331,996,4583,8981,4398,3859.0,4337.0,478.0,0.0,0.0,0.0
ehrer101,Red Ehret,St. Louis Cardinals,CARDS,5,8,13,21,1895,1899,4,45.5,0.55,-44.95,2073,759,-1314,7733,2872,-4861,1422.0,668.0,-754.0,0.0,1500.0,1500.0
ehrer101,Red Ehret,Cincinnati Reds,REDS,2,5,2,7,1898,1898,0,7.73,2.21,-5.52,627,66,-561,2681,105,-2576,267.0,786.0,519.0,0.0,0.0,0.0
ehrhr101,Rube Ehrhardt,Brooklyn Dodgers,DOGRS,1,2,1,3,1929,1933,4,1.02,-0.43,-1.45,222,187,-35,631,496,-135,148.0,0.0,-148.0,0.0,0.0,0.0
eibnb001,Brett Eibner,Kansas City Royals,ROYALS,1,1,1,2,2016,2018,2,-0.79,-0.67,0.12,44,31,-13,123,46,-77,0.0,0.0,0.0,0.0,0.0,0.0
eibnb001,Brett Eibner,Oakland Athletics,ATLTCS,1,1,1,2,2017,2017,0,-0.35,0.0,0.35,17,0,-17,36,0,-36,0.0,0.0,0.0,0.0,0.0,0.0
eichj001,Juan Eichelberger,San Diego Padres,PADRS,1,2,1,3,1982,1984,2,-0.69,2.23,2.92,165,129,-36,273,116,-157,402.0,1000.0,598.0,0.0,0.0,0.0
eichm001,Mark Eichhorn,California Angels,ANGELS,1,1,2,3,1992,1995,3,1.7,0.36,-1.34,77,277,200,0,834,834,311.0,0.0,-311.0,1805000.0,725000.0,-1080000.0
eickj001,Jerad Eickhoff,Texas Rangers,RNGRS,5,14,16,30,2015,2021,6,11.03,13.28,2.25,790,293,-497,1664,16,-1648,2536.0,2164.0,-372.0,3762500.0,1106250.0,-2656250.0
eilad001,Dave Eiland,Cleveland Indians,INDINS,1,1,2,3,1993,1993,0,0.0,0.0,0.0,0,0,0,0,0,0,0.0,0.0,0.0,0.0,0.0,0.0
eiscj001,Joey Eischen,Texas Rangers,RNGRS,1,3,1,4,1991,1991,0,2.41,-0.71,-3.12,510,12,-498,30,0,-30,668.0,186.0,-482.0,0.0,1500000.0,1500000.0
eiscj001,Joey Eischen,Montreal Expos,NATEX,3,4,4,8,1995,2000,5,2.32,1.96,-0.36,552,545,-7,1710,1297,-413,362.0,850.0,488.0,2625000.0,373000.0,-2252000.0
eiscj001,Joey Eischen,Los Angeles Dodgers,DOGRS,1,2,1,3,1996,1996,0,0.39,0.36,-0.03,64,43,-21,0,121,121,244.0,0.0,-244.0,305000.0,2000000.0,1695000.0
eiscj001,Joey Eischen,Detroit Tigers,TIGRS,2,3,3,6,1996,1998,2,2.15,3.3,1.15,155,83,-72,547,163,-384,0.0,525.0,525.0,600000.0,1071500.0,471500.0
eiscj001,Joey Eischen,San Diego Padres,PADRS,1,1,1,2,1997,1997,0,-0.06,0.0,0.06,2,0,-2,1,0,-1,4.0,0.0,-4.0,0.0,0.0,0.0
eiseh101,Harry Eisenstat,Detroit Tigers,TIGRS,1,2,1,3,1939,1941,2,4.92,0.45,-4.47,206,151,-55,69,490,421,771.0,0.0,-771.0,0.0,0.0,0.0
eisej001,Jim Eisenreich,Florida Marlins,MARLNS,15,33,38,71,1998,2019,21,116.45,94.42,-22.03,4698,5470,772,15425,16217,792,10496.0,10160.0,-336.0,68580667.0,35694968.0,-32885699.0
elars001,Scott Elarton,Houston Astros,ASTROS,1,1,2,3,2001,2001,0,-2.27,0.82,3.09,45,8,-37,39,12,-27,348.0,86.0,-262.0,400000.0,6850000.0,6450000.0
elbek101,Kid Elberfeld,Detroit Tigers,TIGRS,2,5,4,9,1903,1911,8,19.09,16.8,-2.29,667,893,226,2757,3796,1039,0.0,39.0,39.0,0.0,0.0,0.0
elded001,Dave Elder,Texas Rangers,RNGRS,1,1,1,2,2001,2002,1,0.13,-0.54,-0.67,19,36,17,0,0,0,76.0,73.0,-3.0,0.0,0.0,0.0
eldrc001,Cal Eldred,Milwaukee Brewers,BREWRS,1,2,2,4,2000,2000,0,18.62,-2.6,-21.22,696,55,-641,2756,47,-2709,354.0,437.0,83.0,0.0,0.0,0.0
elial101,Lee Elia,Philadelphia Phillies,PHILS,1,2,2,4,1964,1966,2,0.7,1.42,0.72,243,96,-147,836,60,-776,0.0,543.0,543.0,6000.0,26500.0,20500.0
elial101,Lee Elia,Chicago Cubs,CUBS,1,1,1,2,1969,1969,0,0.0,-0.33,-0.33,0,44,44,0,49,49,0.0,0.0,0.0,0.0,18000.0,18000.0
eliar001,Roenis Elias,Seattle Mariners,MARNRS,2,3,3,6,2015,2018,3,-0.47,2.16,2.63,84,70,-14,9,13,4,729.0,1001.0,272.0,0.0,3666000.0,3666000.0
eliar001,Roenis Elias,Boston Red Sox,RSOX,1,1,1,2,2018,2018,0,1.06,0.0,-1.06,71,0,-71,2,0,-2,294.0,0.0,-294.0,0.0,0.0,0.0
eliar001,Roenis Elias,Seattle Mariners,MARNRS,1,2,3,5,2019,2020,1,-0.26,0.45,0.71,55,27,-28,1,0,-1,72.0,60.0,-12.0,2210000.0,0.0,-2210000.0
ellar101,Roy Ellam,Indianapolis,Indianapolis,1,1,1,2,1918,1918,0,-0.09,0.0,0.09,26,0,-26,105,0,-105,0.0,0.0,0.0,0.0,0.0,0.0
ellef101,Frank Ellerbe,Washington Senators,TWINS,1,1,1,2,1921,1921,0,-0.22,-0.7,-0.48,235,59,-176,999,195,-804,0.0,0.0,0.0,4000.0,4200.0,200.0
elles001,Seth Elledge,Seattle Mariners,MARNRS,1,1,1,2,2018,2020,2,-0.06,1.02,1.08,35,29,-6,2,0,-2,70.0,85.0,15.0,0.0,554600.0,554600.0
ellia001,A.J. Ellis,Los Angeles Dodgers,DOGRS,3,5,4,9,2016,2017,1,0.14,0.23,0.09,78,14,-64,181,40,-141,47.0,0.0,-47.0,8500000.0,532900.0,-7967100.0
ellib102,Babe Ellison,Detroit Tigers,TIGRS,1,1,1,2,1920,1925,5,0.0,0.72,0.72,0,299,299,0,192,192,0.0,1487.0,1487.0,0.0,0.0,0.0
ellib103,Bob Elliott,Pittsburgh Pirates,PIRATS,1,2,4,6,1946,1949,3,25.05,-0.22,-25.27,770,168,-602,3219,87,-3132,0.0,478.0,478.0,0.0,0.0,0.0
ellib103,Bob Elliott,Boston Braves,BRAVES,2,2,3,5,1952,1952,0,0.63,-0.49,-1.12,142,78,-64,320,9,-311,118.0,210.0,92.0,0.0,0.0,0.0
ellib103,Bob Elliott,St.Louis Browns,ORLS,16,39,39,78,1953,1988,35,62.78,132.67,69.89,3897,7526,3629,7249,20942,13693,16132.0,14151.0,-1981.0,815833.0,138400.0,-677433.0
ellib104,Bruce Ellingsen,Los Angeles Dodgers,DOGRS,2,2,2,4,1974,1989,15,1.59,34.0,32.41,516,1066,550,2026,4107,2081,126.0,200.0,74.0,1720000.0,1100000.0,-620000.0
ellic001,Chris Ellis,Anaheim Angels,ANGELS,1,4,2,6,2015,2020,5,2.92,20.49,17.57,366,607,241,466,2409,1943,1135.0,0.0,-1135.0,8500000.0,3000000.0,-5500000.0
ellic001,Chris Ellis,Atlanta Braves,BRAVES,2,6,2,8,2016,2017,1,2.2,1.46,-0.74,256,33,-223,58,35,-23,887.0,339.0,-548.0,13307500.0,11500000.0,-1807500.0
ellic101,Claude Elliott,New York Giants,GIANTS,5,12,7,19,1906,1921,15,45.64,34.49,-11.15,2445,1674,-771,8369,5360,-3009,1733.0,3268.0,1535.0,6400.0,5200.0,-1200.0
ellid001,Donnie Elliott,Philadelphia Phillies,PHILS,1,1,1,2,1992,1994,2,0.0,1.78,1.78,0,118,118,0,116,116,0.0,909.0,909.0,0.0,109000.0,109000.0
ellid001,Donnie Elliott,Atlanta Braves,BRAVES,1,3,1,4,1993,1997,4,-0.25,11.08,11.33,189,636,447,337,2705,2368,105.0,0.0,-105.0,0.0,4300000.0,4300000.0
ellid101,Dock Ellis,Pittsburgh Pirates,PIRATS,6,13,12,25,1975,1988,13,109.3,32.91,-76.39,4660,1733,-2927,17124,6632,-10492,6130.0,687.0,-5443.0,807000.0,0.0,-807000.0
ellid101,Dock Ellis,New York Yankees,YANKS,1,3,1,4,1977,1977,0,-3.76,2.42,6.18,344,31,-313,885,0,-885,78.0,651.0,573.0,0.0,100000.0,100000.0
ellid101,Dock Ellis,Texas Rangers,RNGRS,1,1,2,3,1979,1979,0,-1.27,0.0,1.27,34,0,-34,28,0,-28,255.0,0.0,-255.0,0.0,0.0,0.0
ellig102,Glenn Elliott,Boston Braves,BRAVES,3,11,3,14,1950,1960,10,8.19,21.05,12.86,794,939,145,1824,3291,1467,2135.0,2034.0,-101.0,0.0,42000.0,42000.0
ellij001,Jason Ellison,San Francisco Giants,GIANTS,1,1,1,2,2007,2007,0,-0.24,-0.12,0.12,63,4,-59,48,3,-45,0.0,26.0,26.0,0.0,0.0,0.0
ellij101,John Ellis,New York Yankees,YANKS,5,8,9,17,1972,1987,15,9.09,48.73,39.64,1757,1810,53,5603,6602,999,883.0,1959.0,1076.0,246600.0,963000.0,716400.0
ellij101,John Ellis,Cleveland Indians,INDINS,2,2,3,5,1975,1984,9,-1.14,5.9,7.04,334,687,353,942,2159,1217,0.0,317.0,317.0,0.0,0.0,0.0
ellij102,Jim Ellis,Chicago Cubs,CUBS,2,3,3,6,1968,1974,6,-0.08,14.65,14.73,111,1174,1063,205,2396,2191,0.0,1177.0,1177.0,0.0,36500.0,36500.0
ellij102,Jim Ellis,Los Angeles Dodgers,DOGRS,1,1,1,2,1968,1968,0,0.22,0.0,-0.22,4,0,-4,1,0,-1,16.0,0.0,-16.0,0.0,0.0,0.0
ellij102,Jim Ellis,St. Louis Cardinals,CARDS,1,2,3,5,1970,1972,2,0.0,0.71,0.71,0,95,95,0,203,203,0.0,0.0,0.0,17500.0,12000.0,-5500.0
ellij103,Jumbo Elliott,Brooklyn Dodgers,DOGRS,2,6,3,9,1930,1936,6,9.9,18.06,8.16,811,786,-25,1763,3200,1437,2519.0,0.0,-2519.0,18200.0,17000.0,-1200.0
ellil101,Larry Elliot,New York Mets,METS,1,2,1,3,1967,1969,2,0.0,5.12,5.12,0,279,279,0,963,963,0.0,0.0,0.0,0.0,25000.0,25000.0
ellim001,Mark Ellis,Kansas City Royals,ROYALS,2,3,5,8,2001,2008,7,28.96,3.25,-25.71,1295,867,-428,5271,2850,-2421,0.0,359.0,359.0,0.0,0.0,0.0
ellim001,Mark Ellis,Oakland Athletics,ATLTCS,1,1,2,3,2011,2013,2,1.57,-0.29,-1.86,70,3,-67,286,0,-286,0.0,15.0,15.0,6000000.0,0.0,-6000000.0
ellir001,Robert Ellis,Chicago White Sox,WSOX,1,1,1,2,1996,1996,0,0.23,-0.03,-0.26,3,31,28,0,102,102,15.0,0.0,-15.0,0.0,0.0,0.0
ellir001,Robert Ellis,Cleveland Indians,INDINS,1,1,1,2,2004,2004,0,0.0,0.0,0.0,0,0,0,0,0,0,0.0,0.0,0.0,0.0,0.0,0.0
ellir102,Rube Ellis,Cincinnati Reds,REDS,4,11,8,19,1909,1914,5,44.03,9.97,-34.06,2926,905,-2021,11991,3124,-8867,753.0,872.0,119.0,0.0,0.0,0.0
ellis101,Sammy Ellis,Cincinnati Reds,REDS,1,1,2,3,1967,1969,2,-1.33,-0.19,1.14,84,70,-14,53,8,-45,492.0,163.0,-329.0,26500.0,20000.0,-6500.0
ellis101,Sammy Ellis,California Angels,ANGELS,2,2,3,5,1969,1971,2,-0.28,1.28,1.56,144,213,69,353,599,246,88.0,0.0,-88.0,0.0,0.0,0.0
ellis101,Sammy Ellis,Chicago White Sox,WSOX,1,1,1,2,1969,1969,0,0.0,-1.06,-1.06,0,16,16,0,0,0,0.0,37.0,37.0,27500.0,19000.0,-8500.0
ellsd101,Dick Ellsworth,Chicago Cubs,CUBS,2,2,5,7,1966,1969,3,9.7,0.67,-9.03,376,60,-316,446,59,-387,3653.0,458.0,-3195.0,17500.0,0.0,-17500.0
ellsd101,Dick Ellsworth,Philadelphia Phillies,PHILS,2,3,3,6,1967,1974,7,0.86,0.9,0.04,97,392,295,157,1287,1130,624.0,0.0,-624.0,32000.0,15000.0,-17000.0
ellsd101,Dick Ellsworth,Boston Red Sox,RSOX,3,6,6,12,1969,1973,4,5.38,12.96,7.58,1093,699,-394,2374,1115,-1259,1155.0,3166.0,2011.0,26500.0,34500.0,8000.0
elshr101,Roy Elsh,Chicago White Sox,WSOX,4,12,5,17,1926,1936,10,0.81,1.51,0.7,234,542,308,748,1962,1214,0.0,39.0,39.0,19600.0,12500.0,-7100.0
elstd101,Don Elston,Chicago Cubs,CUBS,5,9,9,18,1955,1964,9,9.43,6.83,-2.6,1051,943,-108,3111,3013,-98,133.0,368.0,235.0,0.0,0.0,0.0
elstd101,Don Elston,Brooklyn Dodgers,DOGRS,1,1,2,3,1957,1961,4,9.65,-0.13,-9.78,894,10,-884,138,1,-137,2255.0,23.0,-2232.0,0.0,0.0,0.0
ely-b101,Bones Ely,St. Louis Cardinals,CARDS,4,6,12,18,1896,1899,3,25.49,14.57,-10.92,2211,1134,-1077,8166,3896,-4270,4212.0,3935.0,-277.0,0.0,0.0,0.0
ely-j001,John Ely,Chicago White Sox,WSOX,1,2,1,3,2009,2011,2,-1.22,-0.64,0.58,67,318,251,36,1445,1409,372.0,0.0,-372.0,0.0,10000000.0,10000000.0
ely-j001,John Ely,Los Angeles Dodgers,DOGRS,2,2,3,5,2012,2013,1,0.0,-0.1,-0.1,0,21,21,0,53,53,0.0,0.0,0.0,0.0,0.0,0.0
emaub001,Brad Emaus,Toronto Blue Jays,BJAYS,1,1,2,3,2011,2011,0,0.0,0.0,0.0,0,0,0,0,0,0,0.0,0.0,0.0,0.0,0.0,0.0
embra001,Alan Embree,Cleveland Indians,INDINS,14,19,23,42,1997,2020,23,33.89,80.62,46.73,2990,2655,-335,9123,6094,-3029,3747.0,9391.0,5644.0,44554400.0,15489000.0,-29065400.0
embra001,Alan Embree,Atlanta Braves,BRAVES,1,1,1,2,1998,1999,1,0.18,0.56,0.38,70,137,67,1,0,-1,105.0,202.0,97.0,575000.0,700000.0,125000.0
embra001,Alan Embree,Arizona Diamondbacks,DBACKS,2,2,2,4,1998,2000,2,0.32,-0.45,-0.77,300,22,-278,1,28,27,416.0,0.0,-416.0,200000.0,210000.0,10000.0
embra001,Alan Embree,San Francisco Giants,GIANTS,1,2,1,3,2001,2001,0,-0.03,0.0,0.03,39,0,-39,0,0,0,102.0,0.0,-102.0,2400000.0,0.0,-2400000.0
embra001,Alan Embree,San Diego Padres,PADRS,1,2,2,4,2002,2006,4,1.41,0.0,-1.41,227,0,-227,0,0,0,535.0,0.0,-535.0,500000.0,0.0,-500000.0
embrr101,Red Embree,Cleveland Indians,INDINS,2,3,2,5,1947,1952,5,0.44,-0.63,-1.07,236,272,36,640,835,195,230.0,0.0,-230.0,0.0,16500.0,16500.0
embrr101,Red Embree,New York Yankees,YANKS,2,7,3,10,1948,1954,6,24.48,2.06,-22.42,970,341,-629,1730,188,-1542,4702.0,1746.0,-2956.0,11500.0,10000.0,-1500.0
encaa001,Angelo Encarnacion,Pittsburgh Pirates,PIRATS,2,3,3,6,1997,1998,1,-0.39,-0.19,0.2,43,160,117,68,469,401,0.0,0.0,0.0,0.0,0.0,0.0
encaa001,Angelo Encarnacion,San Diego Padres,PADRS,1,1,1,2,1997,1999,2,-0.06,0.0,0.06,11,0,-11,17,0,-17,0.0,0.0,0.0,0.0,0.0,0.0
encae001,Edwin Encarnacion,Texas Rangers,RNGRS,1,2,1,3,2001,2003,2,2.17,-0.72,-2.89,634,36,-598,2326,2,-2324,0.0,598.0,598.0,300000.0,250000.0,-50000.0
encae001,Edwin Encarnacion,Cincinnati Reds,REDS,1,3,1,4,2009,2012,3,24.68,7.61,-17.07,1033,330,-703,4205,1298,-2907,160.0,0.0,-160.0,2425000.0,11625000.0,9200000.0
encae001,Edwin Encarnacion,Cleveland Indians,INDINS,2,5,4,9,2018,2021,3,2.01,4.54,2.53,137,378,241,491,1477,986,0.0,0.0,0.0,18667000.0,0.0,-18667000.0
encae001,Edwin Encarnacion,Seattle Mariners,MARNRS,1,2,1,3,2019,2019,0,0.67,0.0,-0.67,44,0,-44,197,0,-197,0.0,0.0,0.0,0.0,0.0,0.0
encaj001,Juan Encarnacion,Detroit Tigers,TIGRS,1,2,1,3,2001,2006,5,1.7,6.8,5.1,135,487,352,357,1976,1619,97.0,0.0,-97.0,4400000.0,3500000.0,-900000.0
encaj001,Juan Encarnacion,Cincinnati Reds,REDS,1,3,1,4,2002,2003,1,1.48,-2.8,-4.28,415,76,-339,1688,70,-1618,0.0,613.0,613.0,2400000.0,2475000.0,75000.0
encaj001,Juan Encarnacion,Florida Marlins,MARLNS,1,1,1,2,2003,2005,2,-0.06,0.0,0.06,86,0,-86,350,0,-350,0.0,0.0,0.0,3450000.0,0.0,-3450000.0
encaj001,Juan Encarnacion,Los Angeles Dodgers,DOGRS,2,6,5,11,2004,2008,4,2.71,12.71,10.0,623,499,-124,1632,1049,-583,321.0,2036.0,1715.0,9106667.0,11835000.0,2728333.0
encam001,Mario Encarnacion,Oakland Athletics,ATLTCS,1,3,1,4,2001,2004,3,0.03,2.82,2.79,154,394,240,507,1663,1156,28.0,0.0,-28.0,201000.0,0.0,-201000.0
enges001,Steve Engel,Chicago Cubs,CUBS,1,2,1,3,1986,1988,2,5.63,1.35,-4.28,521,292,-229,2104,758,-1346,0.0,0.0,0.0,0.0,0.0,0.0
englc101,Charlie English,Chicago White Sox,WSOX,1,2,1,3,1933,1933,0,0.0,0.0,0.0,0,0,0,0,0,0,0.0,0.0,0.0,6000.0,0.0,-6000.0
englc101,Charlie English,Galveston,Galveston,1,2,1,3,1934,1934,0,0.0,0.0,0.0,0,0,0,0,0,0,0.0,0.0,0.0,0.0,0.0,0.0
engld001,Dave Engle,California Angels,ANGELS,1,4,1,5,1979,1985,6,6.38,17.39,11.01,810,834,24,2648,3570,922,1590.0,0.0,-1590.0,0.0,0.0,0.0
engld001,Dave Engle,Minnesota Twins,TWINS,1,1,2,3,1986,1986,0,-0.07,-0.75,-0.68,35,19,-16,93,38,-55,0.0,0.0,0.0,0.0,0.0,0.0
englg101,Gil English,New York Giants,GIANTS,2,3,2,5,1933,1937,4,3.13,0.5,-2.63,166,211,45,157,299,142,1053.0,322.0,-731.0,0.0,0.0,0.0
englg101,Gil English,Boston Braves,BRAVES,6,18,10,28,1938,1952,14,22.0,33.53,11.53,1506,1625,119,5516,5420,-96,0.0,2449.0,2449.0,12500.0,0.0,-12500.0
englw101,Woody English,Chicago Cubs,CUBS,1,2,1,3,1936,1938,2,-0.75,0.91,1.66,248,78,-170,579,238,-341,469.0,0.0,-469.0,0.0,0.0,0.0
ennid101,Del Ennis,Philadelphia Phillies,PHILS,2,4,3,7,1956,1958,2,-2.41,0.14,2.55,379,229,-150,1019,841,-178,226.0,0.0,-226.0,0.0,0.0,0.0
ennid101,Del Ennis,St. Louis Cardinals,CARDS,2,5,5,10,1958,1963,5,8.1,2.95,-5.15,969,458,-511,3320,993,-2327,89.0,111.0,22.0,0.0,0.0,0.0
ennid101,Del Ennis,Cincinnati Reds,REDS,1,1,2,3,1959,1961,2,-0.82,0.02,0.84,26,10,-16,100,1,-99,0.0,22.0,22.0,0.0,10500.0,10500.0
ennsd001,Dietrich Enns,New York Yankees,YANKS,1,2,1,3,2017,2017,0,0.02,-0.11,-0.13,48,9,-39,2,2,0,203.0,112.0,-91.0,0.0,0.0,0.0
enrib001,Barry Enright,Arizona Diamondbacks,DBACKS,1,1,1,2,2012,2012,0,-0.92,0.0,0.92,7,0,-7,0,0,0,36.0,0.0,-36.0,0.0,0.0,0.0
ens-m101,Mutz Ens,Chicago White Sox,WSOX,1,5,1,6,1913,1928,15,0.0,32.48,32.48,0,1734,1734,0,6165,6165,0.0,0.0,0.0,0.0,0.0,0.0
eovan001,Nathan Eovaldi,Los Angeles Dodgers,DOGRS,1,2,2,4,2012,2014,2,2.73,9.76,7.03,137,350,213,121,1120,999,1127.0,40.0,-1087.0,0.0,1500000.0,1500000.0
eovan001,Nathan Eovaldi,Miami Marlins,MARLNS,2,4,7,11,2014,2019,5,6.27,8.73,2.46,210,736,526,177,1879,1702,1889.0,737.0,-1152.0,7867000.0,11541425.0,3674425.0
eovan001,Nathan Eovaldi,Tampa Bay Devil Rays,RAYS,1,1,1,2,2018,2018,0,6.72,0.26,-6.46,80,13,-67,8,2,-6,1057.0,133.0,-924.0,2000000.0,0.0,-2000000.0
eppea101,Al Epperly,Boston Braves,BRAVES,4,14,5,19,1949,1960,11,7.36,21.56,14.2,1117,1270,153,2487,5255,2768,2162.0,0.0,-2162.0,6600.0,46800.0,40200.0
epstm101,Mike Epstein,Baltimore Orioles,ORLS,6,16,17,33,1967,1988,21,25.3,73.67,48.37,1834,3826,1992,3308,6892,3584,7606.0,13824.0,6218.0,733333.0,8400.0,-724933.0
epstm101,Mike Epstein,Washington Senators,RNGRS,14,27,28,55,1971,1986,15,67.34,36.98,-30.36,3624,2178,-1446,6695,5553,-1142,11858.0,4713.0,-7145.0,245000.0,416400.0,171400.0
epstm101,Mike Epstein,Oakland Athletics,ATLTCS,3,5,3,8,1972,1976,4,2.06,2.63,0.57,1252,324,-928,3174,1015,-2159,720.0,264.0,-456.0,133800.0,213000.0,79200.0
epstm101,Mike Epstein,Texas Rangers,RNGRS,7,19,12,31,1973,1988,15,43.57,39.21,-4.36,2413,2544,131,8647,8625,-22,2773.0,4668.0,1895.0,457000.0,165000.0,-292000.0
erarg101,Greg Erardi,Milwaukee Brewers,BREWRS,1,1,1,2,1973,1973,0,0.0,0.0,0.0,0,0,0,0,0,0,0.0,0.0,0.0,0.0,0.0,0.0
eraue101,Eddie Erautt,Cincinnati Reds,REDS,2,2,3,5,1953,1960,7,0.4,11.83,11.43,116,584,468,24,388,364,287.0,3371.0,3084.0,0.0,0.0,0.0
eraue101,Eddie Erautt,St. Louis Cardinals,CARDS,1,3,1,4,1954,1954,0,0.0,-0.06,-0.06,0,66,66,0,271,271,0.0,0.0,0.0,0.0,0.0,0.0
erauj101,Joe Erautt,Chicago White Sox,WSOX,1,1,1,2,1951,1951,0,0.0,-0.88,-0.88,0,34,34,0,99,99,0.0,0.0,0.0,0.0,0.0,0.0
erdot001,Todd Erdos,Arizona Diamondbacks,DBACKS,2,3,2,5,1998,2004,6,-0.53,1.16,1.69,349,725,376,906,2569,1663,102.0,0.0,-102.0,750000.0,500000.0,-250000.0
erice101,Eric Erickson,Detroit Tigers,TIGRS,1,1,1,2,1919,1919,0,2.21,1.79,-0.42,242,48,-194,265,27,-238,2068.0,280.0,-1788.0,0.0,3000.0,3000.0
erich101,Hank Erickson,Louisville,Louisville,1,1,2,3,1934,1934,0,0.0,0.0,0.0,0,0,0,0,0,0,0.0,0.0,0.0,0.0,0.0,0.0
erich102,Hal Erickson,Cleveland Indians,INDINS,1,1,1,2,1952,1953,1,-0.15,0.0,0.15,36,0,-36,4,0,-4,97.0,0.0,-97.0,0.0,0.0,0.0
ericr101,Roger Erickson,Minnesota Twins,TWINS,4,5,7,12,1982,1986,4,11.35,2.12,-9.23,555,275,-280,2031,106,-1925,297.0,1461.0,1164.0,620000.0,0.0,-620000.0
ericr101,Roger Erickson,New York Yankees,YANKS,1,2,2,4,1983,1986,3,1.05,0.96,-0.09,566,53,-513,2201,0,-2201,0.0,233.0,233.0,180000.0,0.0,-180000.0
erics001,Scott Erickson,Minnesota Twins,TWINS,1,1,2,3,1995,1997,2,13.23,-1.6,-14.83,211,28,-183,27,0,-27,3863.0,231.0,-3632.0,1862500.0,109000.0,-1753500.0
erics001,Scott Erickson,New York Mets,METS,1,1,1,2,2004,2004,0,0.2,0.0,-0.2,4,0,-4,0,0,0,57.0,0.0,-57.0,700000.0,0.0,-700000.0
erlir001,Robbie Erlin,Texas Rangers,RNGRS,1,2,1,3,2011,2012,1,-0.83,1.99,2.82,224,92,-132,92,0,-92,1056.0,234.0,-822.0,0.0,2535000.0,2535000.0
esasn001,Nick Esasky,Cincinnati Reds,REDS,2,3,4,7,1988,1991,3,5.15,-2.88,-8.03,374,383,9,948,1386,438,486.0,0.0,-486.0,1340000.0,220000.0,-1120000.0
escan101,Nino Escalera,Cincinnati Reds,REDS,2,4,3,7,1958,1960,2,3.11,-0.2,-3.31,276,20,-256,63,2,-61,598.0,41.0,-557.0,0.0,0.0,0.0
escas001,Sergio Escalona,Philadelphia Phillies,PHILS,1,1,1,2,2011,2011,0,0.45,0.0,-0.45,95,0,-95,0,0,0,83.0,0.0,-83.0,0.0,0.0,0.0
escoa001,Angel Escobar,San Francisco Giants,GIANTS,1,1,1,2,1988,1988,0,0.0,0.0,0.0,0,0,0,0,0,0,0.0,0.0,0.0,0.0,0.0,0.0
escoa002,Alex Escobar,New York Mets,METS,3,9,8,17,2001,2008,7,12.43,-0.5,-12.93,1334,336,-998,2309,1012,-1297,1613.0,327.0,-1286.0,8000000.0,8077500.0,77500.0
escoa002,Alex Escobar,Chicago White Sox,WSOX,1,1,1,2,2005,2009,4,0.37,0.79,0.42,33,129,96,99,430,331,0.0,0.0,0.0,0.0,0.0,0.0
escoa003,Alcides Escobar,Milwaukee Brewers,BREWRS,8,16,16,32,2010,2020,10,33.31,23.99,-9.32,2772,1309,-1463,10420,3997,-6423,777.0,2948.0,2171.0,20405500.0,10550000.0,-9855500.0
escoe001,Eduardo Escobar,Chicago White Sox,WSOX,1,2,1,3,2012,2012,0,5.04,0.22,-4.82,686,12,-674,2423,0,-2423,173.0,170.0,-3.0,480000.0,5500000.0,5020000.0
escoe001,Eduardo Escobar,Minnesota Twins,TWINS,1,1,3,4,2018,2018,0,5.55,0.0,-5.55,364,0,-364,1544,0,-1544,0.0,0.0,0.0,4850000.0,0.0,-4850000.0
escoe001,Eduardo Escobar,Arizona Diamondbacks,DBACKS,1,1,2,3,2021,2021,0,0.3,0.0,-0.3,48,0,-48,199,0,-199,0.0,0.0,0.0,7666667.0,0.0,-7666667.0
escoe002,Edwin Escobar,San Francisco Giants,GIANTS,1,2,2,4,2014,2016,2,2.1,2.59,0.49,267,120,-147,1,96,95,779.0,924.0,145.0,0.0,0.0,0.0
escoe002,Edwin Escobar,Texas Rangers,RNGRS,1,1,1,2,2010,2010,0,0.0,0.0,0.0,0,0,0,0,0,0,0.0,0.0,0.0,0.0,0.0,0.0
escoj001,Jose Escobar,Toronto Blue Jays,BJAYS,2,4,2,6,1985,1985,0,1.41,-1.31,-2.72,202,123,-79,317,361,44,109.0,0.0,-109.0,185000.0,750000.0,565000.0
escoy001,Yunel Escobar,Atlanta Braves,BRAVES,2,5,5,10,2010,2015,5,10.05,1.22,-8.83,679,438,-241,1672,1292,-380,1064.0,60.0,-1004.0,1260000.0,10000000.0,8740000.0
escoy001,Yunel Escobar,Toronto Blue Jays,BJAYS,3,15,11,26,2012,2018,6,24.75,21.38,-3.37,2099,1087,-1012,5739,3162,-2577,4668.0,4579.0,-89.0,8732900.0,43179800.0,34446900.0
escoy001,Yunel Escobar,Miami Marlins,MARLNS,1,1,1,2,2012,2018,6,3.12,4.17,1.05,290,608,318,1107,2132,1025,0.0,0.0,0.0,0.0,0.0,0.0
escoy001,Yunel Escobar,Tampa Bay Devil Rays,RAYS,3,7,8,15,2015,2020,5,1.14,10.45,9.31,141,997,856,395,3417,3022,283.0,217.0,-66.0,508800.0,3779600.0,3270800.0
escoy001,Yunel Escobar,Oakland Athletics,ATLTCS,3,4,3,7,2015,2018,3,2.32,0.73,-1.59,200,47,-153,592,0,-592,97.0,159.0,62.0,8300001.0,0.0,-8300001.0
escoy001,Yunel Escobar,Washington Nationals,NATEX,1,2,2,4,2015,2019,4,1.55,-0.45,-2.0,221,66,-155,948,0,-948,0.0,84.0,84.0,5000000.0,0.0,-5000000.0
eshet001,Tom Eshelman,Houston Astros,ASTROS,2,8,3,11,2015,2020,5,7.89,4.62,-3.27,397,276,-121,183,0,-183,2153.0,753.0,-1400.0,5115800.0,5819000.0,703200.0
eshet001,Tom Eshelman,Philadelphia Phillies,PHILS,1,1,1,2,2019,2019,0,0.08,0.0,-0.08,34,0,-34,3,0,-3,295.0,0.0,-295.0,0.0,0.0,0.0
espia001,Alvaro Espinoza,Cleveland Indians,INDINS,5,12,10,22,1996,2001,5,73.82,8.63,-65.19,4077,457,-3620,13151,1605,-11546,1815.0,172.0,-1643.0,13083332.0,17360000.0,4276668.0
espid001,Danny Espinosa,Washington Nationals,NATEX,2,2,4,6,2016,2021,5,0.18,-0.03,-0.21,109,104,-5,255,6,-249,93.0,215.0,122.0,2875000.0,0.0,-2875000.0
espin101,Nino Espinosa,New York Mets,METS,3,4,5,9,1979,1982,3,4.44,-0.21,-4.65,406,349,-57,1033,867,-166,1086.0,501.0,-585.0,200000.0,0.0,-200000.0
espis001,Santiago Espinal,Boston Red Sox,RSOX,1,1,2,3,2018,2019,1,2.77,0.48,-2.29,120,79,-41,312,264,-48,6.0,0.0,-6.0,0.0,0.0,0.0
espyc001,Cecil Espy,Chicago White Sox,WSOX,1,2,1,3,1982,1986,4,0.16,7.02,6.86,20,523,503,12,1875,1863,0.0,0.0,0.0,0.0,0.0,0.0
espyc001,Cecil Espy,Los Angeles Dodgers,DOGRS,1,3,1,4,1985,1987,2,13.58,2.02,-11.56,1414,166,-1248,4553,618,-3935,0.0,0.0,0.0,0.0,975500.0,975500.0
essec101,Chuck Essegian,Philadelphia Phillies,PHILS,3,3,3,6,1958,1967,9,-2.49,2.9,5.39,310,762,452,923,1927,1004,0.0,0.0,0.0,20000.0,46200.0,26200.0
essec101,Chuck Essegian,St. Louis Cardinals,CARDS,17,32,26,58,1959,1972,13,32.69,16.32,-16.37,3575,2596,-979,8857,7912,-945,2795.0,1167.0,-1628.0,42500.0,24000.0,-18500.0
essec101,Chuck Essegian,Baltimore Orioles,ORLS,2,3,3,6,1961,1968,7,0.91,10.3,9.39,413,715,302,408,702,294,1330.0,1894.0,564.0,21750.0,0.0,-21750.0
essec101,Chuck Essegian,Cleveland Indians,INDINS,1,1,1,2,1963,1963,0,-1.47,-0.76,0.71,101,78,-23,254,21,-233,0.0,264.0,264.0,0.0,0.0,0.0
essij001,Jim Essian,Atlanta Braves,BRAVES,1,2,1,3,1975,1978,3,4.99,0.0,-4.99,219,0,-219,667,0,-667,0.0,0.0,0.0,0.0,0.0,0.0
essij001,Jim Essian,Philadelphia Phillies,PHILS,9,22,16,38,1975,1999,24,25.13,40.88,15.75,3277,4153,876,11430,11792,362,522.0,1259.0,737.0,2950000.0,165000.0,-2785000.0
essij001,Jim Essian,Chicago White Sox,WSOX,1,2,1,3,1978,1979,1,6.89,-0.37,-7.26,401,28,-373,1175,0,-1175,453.0,189.0,-264.0,0.0,0.0,0.0
essij001,Jim Essian,Chicago White Sox,WSOX,6,11,9,20,1981,1994,13,14.41,9.4,-5.01,691,899,208,1049,2235,1186,4103.0,4503.0,400.0,1513333.0,147500.0,-1365833.0
essij001,Jim Essian,Seattle Mariners,MARNRS,1,1,1,2,1983,1983,0,0.09,0.0,-0.09,48,0,-48,112,0,-112,0.0,0.0,0.0,0.0,0.0,0.0
essij001,Jim Essian,Cleveland Indians,INDINS,4,5,5,10,1983,1991,8,-1.49,1.08,2.57,295,262,-33,344,266,-78,443.0,1475.0,1032.0,250000.0,500000.0,250000.0
estab001,Bobby Estalella,Philadelphia Phillies,PHILS,2,2,2,4,1999,2001,2,2.6,1.2,-1.4,159,168,9,468,14,-454,132.0,378.0,246.0,910000.0,215000.0,-695000.0
estab001,Bobby Estalella,San Francisco Giants,GIANTS,1,2,1,3,2001,2001,0,-0.01,-0.14,-0.13,3,54,51,6,3,-3,0.0,103.0,103.0,310000.0,350000.0,40000.0
estab101,Bobby Estalella,St.Louis Browns,ORLS,1,1,1,2,1941,1941,0,2.84,0.39,-2.45,133,9,-124,517,36,-481,0.0,0.0,0.0,3500.0,5000.0,1500.0
estab101,Bobby Estalella,Washington Senators,TWINS,1,3,1,4,1943,1943,0,7.97,3.2,-4.77,391,117,-274,1546,505,-1041,0.0,0.0,0.0,0.0,0.0,0.0
estab101,Bobby Estalella,Washington Senators,TWINS,2,7,2,9,1940,1943,3,7.97,0.58,-7.39,391,342,-49,1546,1354,-192,0.0,0.0,0.0,0.0,0.0,0.0
estes001,Shawn Estes,Seattle Mariners,MARNRS,1,2,1,3,1995,1997,2,9.08,-0.25,-9.33,394,28,-366,492,0,-492,2970.0,373.0,-2597.0,0.0,0.0,0.0
estes001,Shawn Estes,San Francisco Giants,GIANTS,2,3,3,6,2001,2002,1,1.82,5.08,3.26,158,272,114,416,1026,610,398.0,0.0,-398.0,4725000.0,975000.0,-3750000.0
estes001,Shawn Estes,New York Mets,METS,1,2,4,6,2002,2003,1,-0.7,0.31,1.01,12,159,147,10,345,335,84.0,18.0,-66.0,6200000.0,233000.0,-5967000.0
estog101,George Estock,Philadelphia Phillies,PHILS,1,2,1,3,1946,1946,0,0.0,-0.34,-0.34,0,6,6,0,20,20,0.0,0.0,0.0,0.0,0.0,0.0
estrf101,Frank Estrada,New York Mets,METS,1,4,1,5,1971,1973,2,45.16,0.14,-45.02,957,146,-811,2120,526,-1594,6672.0,0.0,-6672.0,45950.0,80000.0,34050.0
estrf101,Frank Estrada,California Angels,ANGELS,1,1,1,2,1972,1972,0,0.0,0.25,0.25,0,14,14,0,0,0,0.0,33.0,33.0,0.0,0.0,0.0
estrf101,Frank Estrada,Baltimore Orioles,ORLS,5,13,13,26,1972,1988,16,17.24,68.84,51.6,919,3480,2561,801,7469,6668,6521.0,11016.0,4495.0,558333.0,0.0,-558333.0
estrj001,Johnny Estrada,Philadelphia Phillies,PHILS,1,1,1,2,2002,2004,2,2.07,2.65,0.58,255,118,-137,939,132,-807,0.0,1089.0,1089.0,0.0,3900000.0,3900000.0
estrj001,Johnny Estrada,Atlanta Braves,BRAVES,3,3,4,7,2005,2009,4,0.07,1.31,1.24,257,330,73,619,191,-428,113.0,864.0,751.0,1385000.0,0.0,-1385000.0
estrj001,Johnny Estrada,Arizona Diamondbacks,DBACKS,7,17,19,36,2006,2018,12,24.81,35.93,11.12,1150,1382,232,1829,2226,397,7355.0,7967.0,612.0,18358000.0,18990000.0,632000.0
estrj001,Johnny Estrada,Milwaukee Brewers,BREWRS,1,1,1,2,2007,2008,1,0.0,0.21,0.21,0,115,115,0,0,0,0.0,171.0,171.0,3400000.0,1800000.0,-1600000.0
estrl001,Leo Estrella,New York Mets,METS,1,1,1,2,1998,1998,0,0.02,-0.32,-0.34,2,52,50,0,229,229,14.0,0.0,-14.0,0.0,0.0,0.0
estrl001,Leo Estrella,Toronto Blue Jays,BJAYS,1,2,1,3,2000,2002,2,0.0,0.91,0.91,0,36,36,0,6,6,0.0,543.0,543.0,0.0,1400000.0,1400000.0
estrl001,Leo Estrella,Milwaukee Brewers,BREWRS,1,2,2,4,2004,2010,6,-0.79,2.11,2.9,88,447,359,5,72,67,156.0,1275.0,1119.0,0.0,0.0,0.0
estrm001,Marco Estrada,Milwaukee Brewers,BREWRS,2,2,4,6,2014,2015,1,9.8,3.6,-6.2,257,149,-108,446,572,126,2060.0,0.0,-2060.0,10825000.0,7000000.0,-3825000.0
etchb101,Buck Etchison,Boston Braves,BRAVES,2,4,3,7,1944,1948,4,-0.05,3.33,3.38,48,389,341,105,1497,1392,0.0,0.0,0.0,0.0,0.0,0.0
etheb101,Bobby Etheridge,San Francisco Giants,GIANTS,1,3,1,4,1969,1969,0,1.07,0.0,-1.07,369,0,-369,821,0,-821,333.0,0.0,-333.0,0.0,0.0,0.0
etheb101,Bobby Etheridge,St. Louis Cardinals,CARDS,1,1,1,2,1971,1971,0,0.0,0.0,0.0,0,0,0,0,0,0,0.0,0.0,0.0,0.0,0.0,0.0
ethes001,Seth Etherton,Anaheim Angels,ANGELS,2,2,2,4,2000,2003,3,-0.49,-0.61,-0.12,14,26,12,10,0,-10,90.0,218.0,128.0,200000.0,0.0,-200000.0
ethia001,Andre Ethier,Oakland Athletics,ATLTCS,2,3,3,6,2005,2009,4,23.37,1.53,-21.84,1497,237,-1260,5594,589,-5005,0.0,230.0,230.0,4000000.0,2830000.0,-1170000.0
etten101,Nick Etten,Philadelphia Phillies,PHILS,1,1,3,4,1943,1955,12,11.41,0.0,-11.41,568,0,-568,2373,0,-2373,0.0,0.0,0.0,0.0,0.0,0.0
evanb103,Bill Evans,Chicago White Sox,WSOX,1,1,2,3,1950,1950,0,0.07,0.0,-0.07,18,0,-18,4,0,-4,46.0,0.0,-46.0,0.0,0.0,0.0
evanc101,Chick Evans,Hartford,Hartford,1,1,1,2,1909,1909,0,-1.01,0.0,1.01,34,0,-34,19,0,-19,156.0,0.0,-156.0,0.0,0.0,0.0
evand001,Darrell Evans,Atlanta Braves,BRAVES,5,7,13,20,1976,1983,7,20.68,4.17,-16.51,1646,914,-732,6239,1922,-4317,541.0,2701.0,2160.0,480000.0,150000.0,-330000.0
evanj101,Joe Evans,Cleveland Indians,INDINS,1,1,1,2,1923,1923,0,-0.16,3.1,3.26,106,126,20,421,479,58,0.0,0.0,0.0,0.0,0.0,0.0
evanr101,Red Evans,Boston Red Sox,RSOX,1,2,3,5,1939,1947,8,0.0,1.66,1.66,0,64,64,0,50,50,0.0,452.0,452.0,0.0,0.0,0.0
evanr101,Red Evans,Brooklyn Dodgers,DOGRS,1,3,1,4,1939,1958,19,0.0,68.5,68.5,0,2166,2166,0,9470,9470,0.0,0.0,0.0,3000.0,0.0,-3000.0
evant002,Terry Evans,St. Louis Cardinals,CARDS,1,1,2,3,2006,2006,0,0.02,-0.08,-0.1,20,32,12,21,35,14,0.0,250.0,250.0,0.0,8325000.0,8325000.0
eveld001,Dana Eveland,Milwaukee Brewers,BREWRS,2,4,4,8,2006,2008,2,5.76,-0.61,-6.37,192,321,129,188,507,319,1641.0,616.0,-1025.0,6600000.0,5417000.0,-1183000.0
eveld001,Dana Eveland,Arizona Diamondbacks,DBACKS,6,14,16,30,2007,2018,11,24.99,30.17,5.18,855,1190,335,1319,2038,719,6760.0,6326.0,-434.0,14741000.0,15790000.0,1049000.0
eveld001,Dana Eveland,Toronto Blue Jays,BJAYS,1,1,1,2,2010,2010,0,-0.24,0.0,0.24,4,0,-4,1,0,-1,29.0,0.0,-29.0,419500.0,0.0,-419500.0
eveld001,Dana Eveland,Los Angeles Dodgers,DOGRS,1,1,2,3,2011,2011,0,0.14,0.0,-0.14,16,0,-16,0,0,0,97.0,0.0,-97.0,0.0,0.0,0.0
evera001,Adam Everett,Boston Red Sox,RSOX,2,3,2,5,1999,2002,3,14.08,6.19,-7.89,828,255,-573,3105,1011,-2094,0.0,174.0,174.0,7333333.0,9500000.0,2166667.0
everb001,Bryan Eversgerd,St. Louis Cardinals,CARDS,2,4,4,8,1995,1998,3,0.65,-1.89,-2.54,140,207,67,86,512,426,308.0,331.0,23.0,4525000.0,0.0,-4525000.0
everb001,Bryan Eversgerd,Montreal Expos,NATEX,1,2,3,5,1996,1999,3,2.1,0.16,-1.94,199,370,171,822,693,-129,0.0,483.0,483.0,0.0,0.0,0.0
everb001,Bryan Eversgerd,Boston Red Sox,RSOX,1,1,1,2,1996,1997,1,-0.38,0.72,1.1,4,40,36,0,115,115,4.0,0.0,-4.0,0.0,0.0,0.0
everb101,Bill Everitt,Chicago Cubs,CUBS,2,6,2,8,1900,1902,2,10.49,0.81,-9.68,648,153,-495,2353,607,-1746,0.0,0.0,0.0,0.0,0.0,0.0
everc001,Carl Everett,Florida Marlins,MARLNS,5,10,9,19,1994,2005,11,16.62,29.02,12.4,1306,1575,269,3448,4935,1487,3020.0,1719.0,-1301.0,6848000.0,9062500.0,2214500.0
everc001,Carl Everett,New York Mets,METS,2,2,2,4,1997,1998,1,9.61,-0.25,-9.86,320,126,-194,1058,184,-874,114.0,81.0,-33.0,704000.0,1187500.0,483500.0
everc001,Carl Everett,Houston Astros,ASTROS,1,1,2,3,1999,2007,8,5.72,12.38,6.66,239,649,410,1010,2374,1364,0.0,0.0,0.0,2500000.0,0.0,-2500000.0
everc001,Carl Everett,Boston Red Sox,RSOX,1,1,1,2,2001,2002,1,1.7,0.47,-1.23,179,16,-163,731,1,-730,0.0,174.0,174.0,7333333.0,7000000.0,-333333.0
everc001,Carl Everett,Texas Rangers,RNGRS,2,2,4,6,2003,2012,9,3.3,12.83,9.53,309,596,287,1005,849,-156,152.0,1248.0,1096.0,9150000.0,0.0,-9150000.0
everc001,Carl Everett,Montreal Expos,NATEX,6,12,11,23,2004,2013,9,5.06,12.16,7.1,1610,2141,531,3085,4119,1034,1054.0,2237.0,1183.0,10653000.0,5360000.0,-5293000.0
everh101,Hoot Evers,Detroit Tigers,TIGRS,18,41,43,84,1952,1964,12,49.33,53.4,4.07,4601,4657,56,11266,12496,1230,8483.0,9258.0,775.0,157700.0,102900.0,-54800.0
everh101,Hoot Evers,Baltimore Orioles,ORLS,1,1,1,2,1955,1957,2,-0.08,4.69,4.77,42,162,120,71,146,75,0.0,1239.0,1239.0,0.0,0.0,0.0
everh101,Hoot Evers,Cleveland Indians,INDINS,2,3,2,5,1956,1960,4,0.41,0.01,-0.4,48,37,-11,138,74,-64,0.0,27.0,27.0,0.0,0.0,0.0
everj102,Johnny Evers,Chicago Cubs,CUBS,1,1,2,3,1914,1915,1,7.06,1.39,-5.67,318,134,-184,1353,540,-813,0.0,0.0,0.0,0.0,0.0,0.0
everl101,Leon Everitt,Los Angeles Dodgers,DOGRS,1,2,1,3,1969,1970,1,-3.36,0.06,3.42,214,64,-150,569,4,-565,47.0,148.0,101.0,0.0,0.0,0.0
ewinb101,Buck Ewing,New York Giants,GIANTS,1,1,1,2,1893,1902,9,3.16,44.67,41.51,169,1096,927,778,4791,4013,0.0,0.0,0.0,0.0,0.0,0.0
ewinb102,Bob Ewing,Cincinnati Reds,REDS,4,11,9,20,1910,1914,4,53.01,6.59,-46.42,3186,799,-2387,12273,2663,-9610,3029.0,990.0,-2039.0,0.0,0.0,0.0
eyres001,Scott Eyre,Texas Rangers,RNGRS,1,1,1,2,1994,1995,1,-0.39,-0.52,-0.13,82,102,20,5,252,247,635.0,0.0,-635.0,0.0,0.0,0.0
eyres001,Scott Eyre,Chicago White Sox,WSOX,2,4,3,7,2000,2004,4,0.83,1.08,0.25,92,158,66,0,3,3,327.0,1239.0,912.0,580000.0,1425000.0,845000.0
eyres001,Scott Eyre,Chicago Cubs,CUBS,1,1,1,2,2008,2011,3,1.69,-0.64,-2.33,121,14,-107,0,0,0,133.0,24.0,-109.0,3800000.0,0.0,-3800000.0
ezzeh101,Homer Ezzell,St.Louis Browns,ORLS,2,5,2,7,1924,1928,4,0.51,-0.58,-1.09,148,221,73,508,688,180,0.0,0.0,0.0,0.0,0.0,0.0
ezzeh101,Homer Ezzell,Boston Red Sox,RSOX,1,2,1,3,1925,1927,2,0.0,1.87,1.87,0,185,185,0,714,714,0.0,0.0,0.0,7200.0,7000.0,-200.0
ezzeh101,Homer Ezzell,Detroit Tigers,TIGRS,3,7,6,13,1925,1934,9,25.64,16.48,-9.16,1182,968,-214,3618,3598,-20,3712.0,0.0,-3712.0,12500.0,10000.0,-2500.0
fabrj001,Jorge Fabregas,Anaheim Angels,ANGELS,1,2,2,4,1997,1998,1,1.16,1.24,0.08,151,175,24,342,727,385,178.0,0.0,-178.0,1092000.0,2847500.0,1755500.0
fabrj001,Jorge Fabregas,Arizona Diamondbacks,DBACKS,6,17,15,32,1998,2008,10,43.09,23.72,-19.37,2989,1020,-1969,6928,1129,-5799,9149.0,3551.0,-5598.0,27973667.0,16759000.0,-11214667.0
fabrj001,Jorge Fabregas,New York Mets,METS,1,1,1,2,1998,1999,1,0.41,0.0,-0.41,82,0,-82,260,0,-260,0.0,0.0,0.0,0.0,170000.0,170000.0
fabrj001,Jorge Fabregas,Anaheim Angels,ANGELS,1,3,2,5,2002,2002,0,-0.5,0.27,0.77,52,39,-13,74,76,2,47.0,0.0,-47.0,500000.0,2750000.0,2250000.0
faett101,Tony Faeth,Cleveland Indians,INDINS,1,3,1,4,1920,1922,2,0.0,4.21,4.21,0,138,138,0,140,140,0.0,1087.0,1087.0,0.0,0.0,0.0
faheb101,Bill Fahey,Texas Rangers,RNGRS,2,7,7,14,1978,1985,7,13.84,11.07,-2.77,1150,730,-420,2985,2621,-364,918.0,0.0,-918.0,475000.0,608333.0,133333.0
fainf101,Ferris Fain,Philadelphia Athletics,ATLTCS,51,119,130,249,1953,1976,23,220.72,117.73,-102.99,17901,16276,-1625,45475,48056,2581,21193.0,17462.0,-3731.0,561100.0,842400.0,281300.0
fainf101,Ferris Fain,Chicago White Sox,WSOX,3,8,6,14,1954,1961,7,23.22,8.09,-15.13,1221,1065,-156,3572,3021,-551,2246.0,488.0,-1758.0,62000.0,80000.0,18000.0
fairj102,Jim Fairey,Los Angeles Dodgers,DOGRS,1,2,2,4,1973,1973,0,0.0,0.0,0.0,0,0,0,0,0,0,0.0,0.0,0.0,0.0,0.0,0.0
fairp001,Peter Fairbanks,Texas Rangers,RNGRS,1,1,1,2,2019,2019,0,0.13,0.71,0.58,94,33,-61,0,135,135,245.0,0.0,-245.0,0.0,0.0,0.0
fairr101,Ron Fairly,Los Angeles Dodgers,DOGRS,1,2,2,4,1969,1979,10,17.55,18.66,1.11,718,1264,546,2642,4042,1400,0.0,0.0,0.0,0.0,0.0,0.0
fairr101,Ron Fairly,Montreal Expos,NATEX,2,2,3,5,1974,1978,4,1.8,0.0,-1.8,180,0,-180,415,0,-415,0.0,0.0,0.0,0.0,0.0,0.0
fairr101,Ron Fairly,Oakland Athletics,ATLTCS,1,1,2,3,1977,1977,0,2.36,0.0,-2.36,132,0,-132,528,0,-528,0.0,0.0,0.0,0.0,0.0,0.0
fairr101,Ron Fairly,Toronto Blue Jays,BJAYS,1,1,2,3,1977,1977,0,-0.31,0.0,0.31,91,0,-91,268,0,-268,0.0,0.0,0.0,0.0,0.0,0.0
fairs001,Stuart Fairchild,Cincinnati Reds,REDS,1,2,2,4,2020,2020,0,0.09,0.33,0.24,136,6,-130,368,0,-368,0.0,23.0,23.0,0.0,4100000.0,4100000.0
fajah001,Hector Fajardo,Pittsburgh Pirates,PIRATS,2,3,2,5,1991,1992,1,2.39,2.58,0.19,362,141,-221,1290,483,-807,354.0,265.0,-89.0,2600000.0,3400000.0,800000.0
fajah001,Hector Fajardo,Texas Rangers,RNGRS,1,1,1,2,1995,1996,1,0.0,-0.09,-0.09,0,79,79,0,171,171,0.0,0.0,0.0,0.0,165000.0,165000.0
falcp001,Pete Falcone,San Francisco Giants,GIANTS,4,4,4,8,1975,1980,5,8.84,-2.74,-11.58,1201,362,-839,3011,889,-2122,2820.0,416.0,-2404.0,0.0,0.0,0.0
falcp001,Pete Falcone,St. Louis Cardinals,CARDS,10,27,20,47,1978,1992,14,88.69,102.12,13.43,7023,4414,-2609,21036,14662,-6374,8355.0,3102.0,-5253.0,1533333.0,576667.0,-956666.0
falkb101,Bibb Falk,Chicago White Sox,WSOX,1,1,1,2,1929,1929,0,4.02,-0.57,-4.59,286,43,-243,886,100,-786,0.0,0.0,0.0,0.0,0.0,0.0
falkc101,Cy Falkenberg,Indianapolis,Indianapolis,1,1,2,3,1917,1917,0,-1.12,0.0,1.12,30,0,-30,29,0,-29,242.0,0.0,-242.0,0.0,0.0,0.0
falts001,Steve Falteisek,Cleveland Indians,INDINS,1,1,1,2,2000,2003,3,0.0,0.0,0.0,0,0,0,0,0,0,0.0,0.0,0.0,0.0,0.0,0.0
famij001,Jeurys Familia,New York Mets,METS,4,6,6,12,2018,2021,3,0.27,-1.18,-1.45,70,57,-13,112,54,-58,101.0,38.0,-63.0,8496765.0,0.0,-8496765.0
fanof101,Frank Fanovich,Philadelphia Athletics,ATLTCS,1,2,1,3,1953,1954,1,1.98,0.0,-1.98,78,0,-78,84,0,-84,699.0,0.0,-699.0,7500.0,13500.0,6000.0
fanzc101,Carmen Fanzone,Boston Red Sox,RSOX,2,3,2,5,1970,1973,3,-0.16,0.69,0.85,416,99,-317,970,175,-795,0.0,0.0,0.0,0.0,0.0,0.0
farij001,Jacob Faria,Tampa Bay Devil Rays,RAYS,1,1,1,2,2019,2019,0,-0.56,0.24,0.8,18,37,19,0,107,107,26.0,0.0,-26.0,0.0,637500.0,637500.0
farip001,Paul Faries,San Diego Padres,PADRS,1,1,1,2,1992,1992,0,-0.11,0.0,0.11,15,0,-15,39,0,-39,0.0,0.0,0.0,122500.0,0.0,-122500.0
farlb101,Bob Farley,San Francisco Giants,GIANTS,1,4,2,6,1961,1964,3,7.93,4.13,-3.8,685,341,-344,242,140,-102,2569.0,1260.0,-1309.0,0.0,0.0,0.0
farlb101,Bob Farley,Chicago White Sox,WSOX,1,1,1,2,1962,1964,2,-0.53,1.73,2.26,36,142,106,65,409,344,0.0,0.0,0.0,0.0,0.0,0.0
farme101,Ed Farmer,Cleveland Indians,INDINS,1,1,2,3,1973,1973,0,0.01,0.34,0.33,24,29,5,0,0,0,135.0,373.0,238.0,0.0,27500.0,27500.0
farme101,Ed Farmer,Detroit Tigers,TIGRS,1,2,1,3,1974,1975,1,0.0,-0.06,-0.06,0,74,74,0,215,215,0.0,0.0,0.0,0.0,0.0,0.0
farme101,Ed Farmer,Philadelphia Phillies,PHILS,1,1,1,2,1974,1974,0,0.64,0.0,-0.64,3,0,-3,0,0,0,33.0,0.0,-33.0,22500.0,0.0,-22500.0
farme101,Ed Farmer,Milwaukee Brewers,BREWRS,1,3,1,4,1978,1982,4,-0.15,-1.81,-1.66,16,109,93,7,0,-7,99.0,822.0,723.0,0.0,0.0,0.0
farme101,Ed Farmer,Texas Rangers,RNGRS,2,3,4,7,1979,1979,0,4.47,0.48,-3.99,245,63,-182,304,166,-138,701.0,0.0,-701.0,35000.0,0.0,-35000.0
farmj101,Jack Farmer,Louisville,Louisville,1,1,1,2,1916,1916,0,0.16,0.0,-0.16,55,0,-55,181,0,-181,0.0,0.0,0.0,0.0,2125.0,2125.0
farmk001,Kyle Farmer,Los Angeles Dodgers,DOGRS,3,12,8,20,2018,2021,3,5.8,8.33,2.53,663,133,-530,2223,501,-1722,299.0,229.0,-70.0,36964000.0,68503480.0,31539480.0
farnk001,Kyle Farnsworth,Chicago Cubs,CUBS,2,3,4,7,2005,2007,2,-0.78,-0.48,0.3,158,253,95,155,60,-95,276.0,414.0,138.0,0.0,3000000.0,3000000.0
farnk001,Kyle Farnsworth,Detroit Tigers,TIGRS,2,2,3,5,2005,2010,5,1.05,3.3,2.25,154,202,48,1,7,6,323.0,1262.0,939.0,1975000.0,318500.0,-1656500.0
farnk001,Kyle Farnsworth,New York Yankees,YANKS,1,1,1,2,2008,2008,0,-0.51,-0.8,-0.29,16,33,17,0,101,101,48.0,0.0,-48.0,5916666.0,12379883.0,6463217.0
farnk001,Kyle Farnsworth,Kansas City Royals,ROYALS,1,2,3,5,2010,2016,6,-0.01,2.01,2.02,93,319,226,139,204,65,60.0,734.0,674.0,7250000.0,415000.0,-6835000.0
farqd001,Danny Farquhar,Toronto Blue Jays,BJAYS,1,2,1,3,2010,2013,3,-0.15,1.6,1.75,9,345,336,0,1185,1185,44.0,0.0,-44.0,0.0,1350000.0,1350000.0
farqd001,Danny Farquhar,Oakland Athletics,ATLTCS,2,2,2,4,2011,2013,2,-0.54,1.44,1.98,24,104,80,0,361,361,62.0,38.0,-24.0,0.0,436400.0,436400.0
farqd001,Danny Farquhar,New York Yankees,YANKS,1,2,1,3,2012,2014,2,0.38,3.31,2.93,163,360,197,0,1180,1180,533.0,0.0,-533.0,0.0,17000000.0,17000000.0
farqd001,Danny Farquhar,Seattle Mariners,MARNRS,4,7,6,13,2015,2017,2,9.3,3.09,-6.21,1092,200,-892,3957,584,-3373,347.0,283.0,-64.0,10679600.0,5022800.0,-5656800.0
farrd101,Doc Farrell,New York Giants,GIANTS,2,4,4,8,1927,1930,3,-1.4,7.13,8.53,721,460,-261,1415,1177,-238,3501.0,2253.0,-1248.0,8500.0,35000.0,26500.0
farrd101,Doc Farrell,Boston Braves,BRAVES,6,10,8,18,1929,1938,9,9.08,21.19,12.11,804,2028,1224,2499,7932,5433,1075.0,89.0,-986.0,23000.0,3600.0,-19400.0
farrd101,Doc Farrell,New York Giants,GIANTS,1,2,1,3,1930,1930,0,1.35,-0.6,-1.95,115,121,6,352,457,105,0.0,0.0,0.0,0.0,0.0,0.0
farrd101,Doc Farrell,New York Yankees,YANKS,1,5,1,6,1934,1934,0,0.0,0.0,0.0,0,0,0,0,0,0,0.0,0.0,0.0,2000.0,0.0,-2000.0
farrd102,Duke Farrell,Pittsburgh Pirates,PIRATS,1,2,1,3,1893,1898,5,8.69,24.59,15.9,343,431,88,1384,752,-632,0.0,4984.0,4984.0,0.0,0.0,0.0
farrd102,Duke Farrell,Washington Senators,WSN,1,2,3,5,1894,1894,0,30.33,-0.6,-30.93,706,32,-674,1804,50,-1754,5250.0,309.0,-4941.0,0.0,0.0,0.0
farrd102,Duke Farrell,New York Giants,GIANTS,1,3,1,4,1896,1896,0,5.07,2.79,-2.28,227,49,-178,829,211,-618,60.0,0.0,-60.0,0.0,0.0,0.0
farrd102,Duke Farrell,Washington Senators,WSN,1,2,4,6,1899,1905,6,9.84,0.67,-9.17,735,113,-622,2984,291,-2693,0.0,635.0,635.0,0.0,0.0,0.0
farrj001,John Farrell,Cleveland Indians,INDINS,1,1,1,2,1996,1996,0,-0.37,0.0,0.37,2,0,-2,0,0,0,19.0,0.0,-19.0,0.0,0.0,0.0
farrj001,John Farrell,Toronto Blue Jays,BJAYS,2,4,2,6,2012,2014,2,11.57,-0.01,-11.58,944,66,-878,3396,7,-3389,0.0,475.0,475.0,0.0,1681000.0,1681000.0
farrs001,Steve Farr,Pittsburgh Pirates,PIRATS,1,1,1,2,1983,1983,0,0.94,0.0,-0.94,50,0,-50,0,0,0,394.0,0.0,-394.0,0.0,0.0,0.0
farrs001,Steve Farr,Cleveland Indians,INDINS,1,2,1,3,1994,1994,0,-0.23,-0.01,0.22,19,13,-6,0,0,0,165.0,38.0,-127.0,1850000.0,2975000.0,1125000.0
farrt101,Turk Farrell,Philadelphia Phillies,PHILS,7,14,15,29,1961,1979,18,36.73,77.38,40.65,2596,3152,556,7221,9470,2249,6229.0,10159.0,3930.0,74500.0,159800.0,85300.0
fasas001,Sal Fasano,Kansas City Royals,ROYALS,1,2,1,3,2001,2003,2,-0.28,-0.5,-0.22,31,265,234,74,964,890,19.0,0.0,-19.0,320000.0,2150000.0,1830000.0
fasas001,Sal Fasano,Milwaukee Brewers,BREWRS,1,2,3,5,2002,2004,2,0.27,-0.5,-0.77,39,52,13,76,74,-2,0.0,47.0,47.0,2750000.0,500000.0,-2250000.0
fasas001,Sal Fasano,Philadelphia Phillies,PHILS,1,1,1,2,2006,2006,0,-0.27,0.0,0.27,28,0,-28,57,0,-57,0.0,0.0,0.0,425000.0,0.0,-425000.0
fassj001,Jeff Fassero,Montreal Expos,NATEX,3,6,6,12,1996,2006,10,7.51,7.37,-0.14,330,796,466,781,2734,1953,1820.0,309.0,-1511.0,7545000.0,7500000.0,-45000.0
fassj001,Jeff Fassero,Seattle Mariners,MARNRS,1,1,1,2,1999,1999,0,0.0,0.0,0.0,7,0,-7,0,0,0,52.0,0.0,-52.0,5016667.0,0.0,-5016667.0
fassj001,Jeff Fassero,Chicago Cubs,CUBS,1,1,2,3,2002,2003,1,-0.52,0.0,0.52,153,0,-153,10,0,-10,287.0,0.0,-287.0,2800000.0,0.0,-2800000.0
faula001,Andrew Faulkner,Texas Rangers,RNGRS,1,1,1,2,2017,2017,0,0.0,0.0,0.0,0,0,0,0,0,0,0.0,0.0,0.0,0.0,0.0,0.0
fausb101,Buck Fausett,Galveston,Galveston,1,2,1,3,1934,1934,0,0.0,0.0,0.0,0,0,0,0,0,0,0.0,0.0,0.0,0.0,0.0,0.0
fazie101,Ernie Fazio,Houston Astros,ASTROS,3,4,3,7,1965,1969,4,-0.71,1.07,1.78,88,138,50,90,443,353,49.0,55.0,6.0,0.0,0.0,0.0
featt001,Taylor Featherston,Anaheim Angels,ANGELS,1,1,1,2,2016,2016,0,-0.27,0.0,0.27,19,0,-19,28,0,-28,0.0,0.0,0.0,0.0,0.0,0.0
fedet001,Tim Federowicz,Boston Red Sox,RSOX,1,4,2,6,2011,2012,1,0.34,0.23,-0.11,124,8,-116,300,0,-300,273.0,114.0,-159.0,0.0,0.0,0.0
fedet001,Tim Federowicz,Los Angeles Dodgers,DOGRS,4,10,8,18,2014,2021,7,6.08,11.37,5.29,476,899,423,1306,2454,1148,1807.0,359.0,-1448.0,21000000.0,12293600.0,-8706400.0
fedet001,Tim Federowicz,Cleveland Indians,INDINS,1,1,1,2,2019,2019,0,-0.46,0.0,0.46,30,0,-30,83,0,-83,3.0,0.0,-3.0,0.0,0.0,0.0
feldm001,Mike Felder,Seattle Mariners,MARNRS,1,2,1,3,1993,1994,1,17.17,-0.83,-18.0,486,79,-407,529,288,-241,3414.0,0.0,-3414.0,959000.0,350000.0,-609000.0
felds001,Scott Feldman,Chicago Cubs,CUBS,1,2,3,5,2013,2019,6,0.8,28.4,27.6,86,1050,964,220,287,67,272.0,3528.0,3256.0,0.0,0.0,0.0
felds001,Scott Feldman,Houston Astros,ASTROS,1,1,1,2,2016,2016,0,-0.56,0.0,0.56,14,0,-14,0,0,0,45.0,0.0,-45.0,0.0,0.0,0.0
felig101,Gus Felix,Boston Braves,BRAVES,8,16,14,30,1925,1938,13,15.59,19.03,3.44,1577,2611,1034,4396,9724,5328,4040.0,1364.0,-2676.0,46800.0,27600.0,-19200.0
felig101,Gus Felix,Brooklyn Dodgers,DOGRS,1,2,1,3,1927,1927,0,0.0,0.0,0.0,0,0,0,0,0,0,0.0,0.0,0.0,12000.0,0.0,-12000.0
felij001,Junior Felix,Toronto Blue Jays,BJAYS,1,3,3,6,1990,1995,5,3.61,21.84,18.23,424,669,245,1598,2979,1381,0.0,79.0,79.0,255000.0,990000.0,735000.0
felim001,Michael Feliz,Houston Astros,ASTROS,1,4,1,5,2018,2019,1,3.26,12.09,8.83,813,71,-742,1676,16,-1660,1316.0,1238.0,-78.0,0.0,0.0,0.0
felin001,Neftali Feliz,Atlanta Braves,BRAVES,3,7,5,12,2007,2009,2,51.72,9.48,-42.24,2314,404,-1910,8153,1445,-6708,2789.0,84.0,-2705.0,15385000.0,11700000.0,-3685000.0
felip001,Pedro Feliz,Houston Astros,ASTROS,5,12,11,23,2010,2019,9,16.82,11.27,-5.55,1278,372,-906,2484,343,-2141,4222.0,1988.0,-2234.0,12835000.0,6555000.0,-6280000.0
felip002,Pedro Feliciano,Cincinnati Reds,REDS,1,4,2,6,2002,2002,0,6.19,-0.7,-6.89,1101,12,-1089,365,10,-355,1151.0,84.0,-1067.0,233000.0,6200000.0,5967000.0
felsh101,Happy Felsch,Milwaukee,Milwaukee,1,1,2,3,1914,1915,1,19.42,0.0,-19.42,749,0,-749,3134,0,-3134,0.0,0.0,0.0,0.0,0.0,0.0
fenwb101,Bobby Fenwick,Houston Astros,ASTROS,2,3,4,7,1972,1977,5,-0.92,-3.42,-2.5,71,191,120,200,517,317,0.0,0.0,0.0,0.0,0.0,0.0
fenwb101,Bobby Fenwick,Chicago Cubs,CUBS,13,24,24,48,1973,1990,17,18.74,18.43,-0.31,3099,2396,-703,8125,5700,-2425,1137.0,4804.0,3667.0,1020000.0,140000.0,-880000.0
ferga101,Alex Ferguson,Boston Red Sox,RSOX,1,2,2,4,1925,1925,0,-1.49,-0.59,0.9,98,12,-86,146,10,-136,166.0,84.0,-82.0,14000.0,4000.0,-10000.0
fergg101,Cecil Ferguson,Louisville,Louisville,1,1,1,2,1905,1906,1,0.11,0.0,-0.11,74,0,-74,37,0,-37,353.0,0.0,-353.0,0.0,0.0,0.0
fergg101,Cecil Ferguson,New York Giants,GIANTS,4,11,6,17,1907,1921,14,45.64,34.38,-11.26,2445,1600,-845,8369,5323,-3046,1733.0,2915.0,1182.0,6400.0,5200.0,-1200.0
fergg101,Cecil Ferguson,Boston Braves,BRAVES,1,1,1,2,1911,1911,0,0.0,0.74,0.74,0,39,39,0,168,168,0.0,0.0,0.0,0.0,0.0,0.0
fergj101,Joe Ferguson,Los Angeles Dodgers,DOGRS,1,3,1,4,1976,1981,5,0.46,19.38,18.92,71,542,471,226,2055,1829,0.0,0.0,0.0,0.0,0.0,0.0
fergj101,Joe Ferguson,St. Louis Cardinals,CARDS,1,2,2,4,1976,1978,2,6.18,-0.3,-6.48,183,31,-152,702,19,-683,0.0,118.0,118.0,0.0,0.0,0.0
fergj101,Joe Ferguson,Houston Astros,ASTROS,3,5,4,9,1978,1985,7,14.88,3.62,-11.26,1417,819,-598,4695,2223,-2472,0.0,0.0,0.0,0.0,0.0,0.0
fermf001,Felix Fermin,Pittsburgh Pirates,PIRATS,2,4,5,9,1989,2000,11,14.38,27.85,13.47,1120,1409,289,4205,5288,1083,0.0,260.0,260.0,7200000.0,120000.0,-7080000.0
fermf001,Felix Fermin,Cleveland Indians,INDINS,1,3,1,4,1993,2004,11,-0.2,30.23,30.43,237,1478,1241,811,6542,5731,0.0,0.0,0.0,1117500.0,1112500.0,-5000.0
fermr001,Ramon Fermin,Oakland Athletics,ATLTCS,1,2,1,3,1996,1996,0,-0.36,-1.09,-0.73,14,73,59,40,263,223,0.0,0.0,0.0,0.0,0.0,0.0
fernc102,Chico Fernandez,Brooklyn Dodgers,DOGRS,4,7,10,17,1957,1968,11,6.9,5.9,-1.0,1472,995,-477,2872,985,-1887,1656.0,2078.0,422.0,122000.0,73000.0,-49000.0
fernc102,Chico Fernandez,Philadelphia Phillies,PHILS,1,2,3,5,1959,1962,3,0.43,-1.4,-1.83,456,279,-177,1595,804,-791,81.0,0.0,-81.0,9000.0,0.0,-9000.0
fernc102,Chico Fernandez,Detroit Tigers,TIGRS,3,4,4,8,1963,1967,4,5.69,-0.02,-5.71,445,329,-116,1466,94,-1372,122.0,751.0,629.0,29000.0,0.0,-29000.0
fernc102,Chico Fernandez,New York Mets,METS,4,8,5,13,1964,1970,6,3.02,7.06,4.04,629,598,-31,1532,2197,665,1019.0,0.0,-1019.0,88000.0,95000.0,7000.0
fernc102,Chico Fernandez,Milwaukee Braves,BRAVES,1,1,2,3,1963,1963,0,-1.36,0.0,1.36,58,0,-58,157,0,-157,0.0,0.0,0.0,0.0,0.0,0.0
ferne101,Ed Fernandes,Portland,Portland,1,1,2,3,1940,1940,0,-0.29,0.0,0.29,28,0,-28,41,0,-41,0.0,0.0,0.0,0.0,0.0,0.0
fernf101,Frank Fernandez,New York Yankees,YANKS,25,54,46,100,1969,1997,28,86.02,77.5,-8.52,6209,4335,-1874,14644,8663,-5981,18574.0,11941.0,-6633.0,5675833.0,4786500.0,-889333.0
fernf101,Frank Fernandez,Oakland Athletics,ATLTCS,5,12,6,18,1971,1976,5,13.14,12.72,-0.42,2868,1140,-1728,6939,2992,-3947,2263.0,1076.0,-1187.0,223600.0,363000.0,139400.0
fernf101,Frank Fernandez,Oakland Athletics,ATLTCS,1,1,1,2,1971,1972,1,0.91,-0.2,-1.11,20,28,8,61,38,-23,0.0,0.0,0.0,20000.0,0.0,-20000.0
fernn101,Nanny Fernandez,Boston Braves,BRAVES,1,2,1,3,1948,1950,2,-0.55,1.6,2.15,55,137,82,158,356,198,0.0,0.0,0.0,0.0,0.0,0.0
fernn101,Nanny Fernandez,Brooklyn Dodgers,DOGRS,1,1,2,3,1949,1949,0,0.39,0.0,-0.39,65,0,-65,218,0,-218,0.0,0.0,0.0,0.0,0.0,0.0
ferns001,Sid Fernandez,Los Angeles Dodgers,DOGRS,1,2,2,4,1983,1986,3,29.07,1.25,-27.82,528,343,-185,590,279,-311,4754.0,437.0,-4317.0,0.0,314167.0,314167.0
fernt001,Tony Fernandez,Toronto Blue Jays,BJAYS,1,2,2,4,1990,1997,7,12.72,30.74,18.02,688,1742,1054,2938,7599,4661,0.0,0.0,0.0,2950000.0,2256667.0,-693333.0
fernt001,Tony Fernandez,San Diego Padres,PADRS,3,5,7,12,1992,1998,6,1.84,1.85,0.01,597,293,-304,1664,174,-1490,1084.0,1146.0,62.0,2100000.0,235000.0,-1865000.0
fernt001,Tony Fernandez,New York Mets,METS,1,1,1,2,1993,1993,0,9.11,-0.58,-9.69,422,31,-391,1579,91,-1488,0.0,0.0,0.0,2300000.0,2100000.0,-200000.0
ferra101,Al Ferrara,San Diego Padres,PADRS,1,1,1,2,1971,1971,0,0.06,-0.52,-0.58,32,52,20,37,68,31,0.0,0.0,0.0,0.0,0.0,0.0
ferrc101,Cy Ferry,Buffalo,Buffalo,1,2,4,6,1903,1904,1,16.79,0.0,-16.79,801,0,-801,3453,0,-3453,39.0,0.0,-39.0,0.0,0.0,0.0
ferrd102,Don Ferrarese,Chicago White Sox,WSOX,29,56,55,111,1954,1971,17,64.71,122.48,57.77,7633,8254,621,20626,20005,-621,7158.0,13512.0,6354.0,248750.0,225500.0,-23250.0
ferrd102,Don Ferrarese,Baltimore Orioles,ORLS,3,4,5,9,1958,1960,2,14.22,11.82,-2.4,668,719,51,1551,2462,911,2254.0,614.0,-1640.0,0.0,0.0,0.0
ferrd102,Don Ferrarese,Cleveland Indians,INDINS,6,11,11,22,1959,1968,9,95.02,18.27,-76.75,3674,1436,-2238,12659,5344,-7315,4502.0,50.0,-4452.0,0.0,32000.0,32000.0
ferrd102,Don Ferrarese,Philadelphia Phillies,PHILS,1,1,2,3,1962,1964,2,1.5,-0.14,-1.64,76,44,-32,5,11,6,170.0,137.0,-33.0,0.0,0.0,0.0
ferrd102,Don Ferrarese,St. Louis Cardinals,CARDS,2,2,2,4,1963,1964,1,1.09,0.0,-1.09,128,0,-128,23,0,-23,329.0,0.0,-329.0,0.0,0.0,0.0
ferrh101,Hobe Ferris,New York Yankees,YANKS,3,6,6,12,1907,1911,4,37.76,7.87,-29.89,2601,491,-2110,10473,2011,-8462,0.0,0.0,0.0,0.0,0.0,0.0
ferrj101,Jack Ferry,Pittsburgh Pirates,PIRATS,1,2,1,3,1913,1915,2,0.0,3.36,3.36,0,200,200,0,183,183,0.0,1648.0,1648.0,2400.0,0.0,-2400.0
ferrm101,Mike Ferraro,Seattle Pilots,BREWRS,3,5,5,10,1969,1971,2,-0.36,0.51,0.87,44,202,158,5,21,16,119.0,376.0,257.0,17500.0,26500.0,9000.0
ferrm101,Mike Ferraro,Baltimore Orioles,ORLS,2,3,3,6,1971,1973,2,-0.61,-0.01,0.6,124,47,-77,406,80,-326,0.0,0.0,0.0,0.0,18000.0,18000.0
ferrm101,Mike Ferraro,Milwaukee Brewers,BREWRS,1,1,1,2,1973,1973,0,0.0,-0.16,-0.16,0,2,2,0,0,0,0.0,22.0,22.0,0.0,0.0,0.0
ferrr101,Rick Ferrell,St.Louis Browns,ORLS,2,3,3,6,1933,1935,2,12.74,1.35,-11.39,735,162,-573,2638,528,-2110,489.0,0.0,-489.0,13500.0,10850.0,-2650.0
ferrr101,Rick Ferrell,Boston Red Sox,RSOX,3,7,5,12,1937,1940,3,25.02,12.69,-12.33,1633,702,-931,5994,2554,-3440,2353.0,1424.0,-929.0,33500.0,42500.0,9000.0
ferrr101,Rick Ferrell,Washington Senators,TWINS,1,1,1,2,1941,1941,0,0.7,-0.89,-1.59,273,35,-238,934,22,-912,0.0,199.0,199.0,8500.0,9000.0,500.0
ferrr101,Rick Ferrell,St.Louis Browns,ORLS,1,1,2,3,1944,1944,0,4.02,0.0,-4.02,227,0,-227,837,0,-837,0.0,0.0,0.0,0.0,0.0,0.0
ferrs101,Sergio Ferrer,Minnesota Twins,TWINS,1,1,1,2,1975,1976,1,0.0,0.0,0.0,0,0,0,0,0,0,0.0,0.0,0.0,0.0,0.0,0.0
ferrs101,Sergio Ferrer,Philadelphia Phillies,PHILS,1,1,1,2,1977,1977,0,0.0,0.0,0.0,0,0,0,0,0,0,0.0,0.0,0.0,0.0,0.0,0.0
ferrs101,Sergio Ferrer,New York Yankees,YANKS,1,1,1,2,1977,1977,0,-0.3,0.0,0.3,69,0,-69,49,0,-49,0.0,0.0,0.0,0.0,40000.0,40000.0
ferrt001,Tony Ferreira,Kansas City Royals,ROYALS,3,4,5,9,1986,1991,5,5.13,6.75,1.62,160,884,724,182,2792,2610,1537.0,256.0,-1281.0,900000.0,580000.0,-320000.0
ferrt101,Tom Ferrick,Washington Senators,TWINS,19,34,35,69,1948,1963,15,46.33,1.08,-45.25,3341,4737,1396,11069,13056,1987,1598.0,4683.0,3085.0,53500.0,14000.0,-39500.0
ferrt101,Tom Ferrick,St.Louis Browns,ORLS,11,21,24,45,1950,1960,10,30.8,26.53,-4.27,2470,2935,465,5868,7663,1795,6528.0,5672.0,-856.0,55500.0,57800.0,2300.0
ferrt101,Tom Ferrick,New York Yankees,YANKS,1,3,1,4,1951,1954,3,18.48,1.84,-16.64,407,209,-198,444,108,-336,3513.0,1042.0,-2471.0,11500.0,0.0,-11500.0
ferrw101,Wes Ferrell,Cleveland Indians,INDINS,3,6,5,11,1934,1940,6,24.33,10.74,-13.59,727,766,39,1921,2878,957,2729.0,210.0,-2519.0,10500.0,14250.0,3750.0
ferrw101,Wes Ferrell,Boston Red Sox,RSOX,3,7,5,12,1937,1940,3,25.02,12.69,-12.33,1633,702,-931,5994,2554,-3440,2353.0,1424.0,-929.0,33500.0,42500.0,9000.0
fettl101,Lou Fette,StPaul,StPaul,1,1,2,3,1936,1936,0,7.87,0.0,-7.87,215,0,-215,255,0,-255,2064.0,0.0,-2064.0,0.0,0.0,0.0
fettm001,Mike Fetters,California Angels,ANGELS,1,2,1,3,1991,1993,2,7.27,-1.33,-8.6,302,68,-234,0,0,0,1003.0,307.0,-696.0,120000.0,2833333.0,2713333.0
fettm001,Mike Fetters,Milwaukee Brewers,BREWRS,2,5,3,8,1997,2001,4,0.99,0.01,-0.98,271,614,343,839,2349,1510,81.0,415.0,334.0,6930000.0,4850000.0,-2080000.0
fettm001,Mike Fetters,Cleveland Indians,INDINS,3,4,4,8,1997,2003,6,0.37,6.29,5.92,252,231,-21,2,1,-1,442.0,849.0,407.0,4300000.0,2060000.0,-2240000.0
fettm001,Mike Fetters,Los Angeles Dodgers,DOGRS,2,5,2,7,2001,2004,3,0.21,-0.68,-0.89,194,255,61,4,12,8,974.0,483.0,-491.0,4975000.0,6000000.0,1025000.0
fettm001,Mike Fetters,Pittsburgh Pirates,PIRATS,1,1,1,2,2002,2003,1,-1.29,-0.54,0.75,112,18,-94,0,0,0,130.0,25.0,-105.0,2275000.0,0.0,-2275000.0
fewsc101,Chick Fewster,New York Yankees,YANKS,2,7,3,10,1922,1928,6,-3.56,9.12,12.68,367,900,533,1242,3603,2361,159.0,0.0,-159.0,15750.0,13000.0,-2750.0
fewsc101,Chick Fewster,Boston Red Sox,RSOX,2,5,5,10,1924,1925,1,9.31,0.12,-9.19,860,387,-473,3360,1555,-1805,0.0,0.0,0.0,3300.0,0.0,-3300.0
feyej001,Jonathon Feyereisen,Cleveland Indians,INDINS,1,4,1,5,2016,2018,2,0.85,4.57,3.72,262,129,-133,807,2,-805,102.0,377.0,275.0,0.0,0.0,0.0
feyej001,Jonathon Feyereisen,New York Yankees,YANKS,1,1,1,2,2019,2019,0,0.3,0.0,-0.3,47,0,-47,0,0,0,86.0,0.0,-86.0,0.0,0.0,0.0
feyej001,Jonathon Feyereisen,Milwaukee Brewers,BREWRS,2,4,3,7,2021,2021,0,2.75,4.04,1.29,94,185,91,3,588,585,385.0,59.0,-326.0,0.0,0.0,0.0
fialn101,Neil Fiala,St. Louis Cardinals,CARDS,3,4,4,8,1981,1985,4,-1.12,3.43,4.55,245,527,282,21,118,97,992.0,934.0,-58.0,450000.0,0.0,-450000.0
fielb001,Bruce Fields,Detroit Tigers,TIGRS,1,1,1,2,1987,1988,1,-0.08,0.0,0.08,42,0,-42,76,0,-76,0.0,0.0,0.0,0.0,0.0,0.0
fielc001,Cecil Fielder,Kansas City Royals,ROYALS,1,1,1,2,1983,1984,1,0.26,0.46,0.2,220,113,-107,558,284,-274,0.0,3.0,3.0,0.0,0.0,0.0
fielc001,Cecil Fielder,Detroit Tigers,TIGRS,2,2,4,6,1996,1997,1,1.0,-0.38,-1.38,176,46,-130,749,180,-569,0.0,0.0,0.0,9237500.0,6200000.0,-3037500.0
fielj001,Josh Fields,Chicago White Sox,WSOX,5,8,8,16,2009,2016,7,-0.62,-1.54,-0.92,448,360,-88,1240,736,-504,233.0,625.0,392.0,14311000.0,7075000.0,-7236000.0
fielj002,Josh Fields,Seattle Mariners,MARNRS,3,4,4,8,2011,2013,2,0.23,-0.5,-0.73,8,119,111,0,404,404,114.0,0.0,-114.0,1000000.0,1300000.0,300000.0
fielj002,Josh Fields,Houston Astros,ASTROS,1,1,1,2,2016,2016,0,1.94,0.0,-1.94,245,0,-245,1,0,-1,352.0,0.0,-352.0,900000.0,0.0,-900000.0
fielp001,Prince Fielder,Detroit Tigers,TIGRS,2,3,3,6,2013,2017,4,2.62,17.41,14.79,380,607,227,1632,2693,1061,0.0,0.0,0.0,34000000.0,13000000.0,-21000000.0
fierm001,Michael Fiers,Milwaukee Brewers,BREWRS,3,6,7,13,2015,2020,5,-0.06,8.37,8.43,453,778,325,1232,2675,1443,1628.0,6.0,-1622.0,1084900.0,0.0,-1084900.0
fierm001,Michael Fiers,Detroit Tigers,TIGRS,1,1,2,3,2018,2018,0,4.25,0.0,-4.25,56,0,-56,0,0,0,918.0,0.0,-918.0,6000000.0,0.0,-6000000.0
fifed101,Danny Fife,Detroit Tigers,TIGRS,2,4,2,6,1973,1975,2,3.13,3.41,0.28,58,109,51,0,215,215,1038.0,609.0,-429.0,0.0,0.0,0.0
fifes001,Stephen Fife,Boston Red Sox,RSOX,1,4,2,6,2011,2012,1,0.34,0.23,-0.11,124,8,-116,300,0,-300,273.0,114.0,-159.0,0.0,0.0,0.0
figgc001,Chone Figgins,Colorado Rockies,ROCKS,1,1,1,2,2001,2001,0,22.36,-0.35,-22.71,936,12,-924,4075,19,-4056,0.0,0.0,0.0,0.0,0.0,0.0
figuc001,Cole Figueroa,San Diego Padres,PADRS,1,4,1,5,2010,2012,2,1.36,-1.01,-2.37,435,168,-267,53,716,663,1270.0,0.0,-1270.0,401300.0,4000000.0,3598700.0
figue101,Ed Figueroa,San Francisco Giants,GIANTS,1,1,2,3,1973,1973,0,6.67,0.0,-6.67,58,0,-58,0,0,0,1050.0,0.0,-1050.0,0.0,0.0,0.0
figue101,Ed Figueroa,California Angels,ANGELS,2,5,4,9,1975,1990,15,42.88,51.46,8.58,1084,1992,908,2703,8018,5315,7553.0,1336.0,-6217.0,175000.0,50000.0,-125000.0
figuj101,Jesus Figueroa,Chicago Cubs,CUBS,1,3,2,5,1980,1980,0,-0.93,0.0,0.93,72,0,-72,267,0,-267,0.0,0.0,0.0,0.0,0.0,0.0
figul001,Luis Figueroa,New York Mets,METS,1,4,3,7,2002,2005,3,2.12,1.12,-1.0,505,185,-320,25,27,2,939.0,263.0,-676.0,300000.0,355000.0,55000.0
figun001,Nelson Figueroa,New York Mets,METS,4,6,6,12,1998,1999,1,13.09,0.3,-12.79,1229,42,-1187,4418,40,-4378,991.0,86.0,-905.0,5050000.0,4845000.0,-205000.0
figun001,Nelson Figueroa,Arizona Diamondbacks,DBACKS,5,14,12,26,2000,2008,8,42.79,24.27,-18.52,2947,854,-2093,6888,689,-6199,9063.0,3504.0,-5559.0,23673667.0,11709000.0,-11964667.0
filet001,Tom Filer,New York Yankees,YANKS,1,2,1,3,1981,1983,2,-0.25,-0.42,-0.17,16,57,41,13,187,174,122.0,0.0,-122.0,0.0,0.0,0.0
filld101,Dana Fillingim,Indianapolis,Indianapolis,1,1,2,3,1918,1918,0,6.61,0.0,-6.61,377,0,-377,384,0,-384,3083.0,0.0,-3083.0,0.0,0.0,0.0
filld101,Dana Fillingim,Beaumont,Beaumont,1,2,1,3,1924,1924,0,-0.96,0.0,0.96,36,0,-36,13,0,-13,104.0,0.0,-104.0,0.0,0.0,0.0
fillh001,Heath Fillmyer,Oakland Athletics,ATLTCS,1,2,3,5,2018,2019,1,0.62,1.28,0.66,62,124,62,5,0,-5,390.0,254.0,-136.0,0.0,0.0,0.0
filsp001,Pete Filson,New York Yankees,YANKS,4,8,8,16,1982,1992,10,8.27,12.89,4.62,1161,565,-596,2474,1712,-762,2564.0,669.0,-1895.0,913333.0,1045000.0,131667.0
filsp001,Pete Filson,Minnesota Twins,TWINS,1,1,1,2,1986,1986,0,-0.13,0.0,0.13,3,0,-3,0,0,0,35.0,0.0,-35.0,0.0,0.0,0.0
filsp001,Pete Filson,Chicago White Sox,WSOX,6,11,12,23,1987,1997,10,68.61,10.72,-57.89,2705,1926,-779,10284,5529,-4755,1119.0,1575.0,456.0,1600000.0,247000.0,-1353000.0
fimpj001,Jack Fimple,Cleveland Indians,INDINS,17,30,35,65,1981,2001,20,116.55,78.96,-37.59,6988,5496,-1492,21431,20127,-1304,7765.0,4126.0,-3639.0,20493332.0,19210000.0,-1283332.0
fincb101,Bill Fincher,LittleRock,LittleRock,2,3,7,10,1915,1916,1,0.33,0.0,-0.33,131,0,-131,145,0,-145,73.0,0.0,-73.0,0.0,4200.0,4200.0
finet101,Tommy Fine,Boston Red Sox,RSOX,1,3,1,4,1947,1947,0,0.0,0.0,0.0,0,0,0,0,0,0,0.0,0.0,0.0,6000.0,0.0,-6000.0
fingr001,Rollie Fingers,San Diego Padres,PADRS,11,20,24,44,1980,1993,13,78.65,50.21,-28.44,3246,4423,1177,10088,11380,1292,4862.0,3507.0,-1355.0,3006667.0,3395633.0,388966.0
fingr001,Rollie Fingers,St. Louis Cardinals,CARDS,6,17,11,28,1980,1992,12,64.49,98.46,33.97,5600,3789,-1811,17434,13612,-3822,5735.0,2617.0,-3118.0,1533333.0,0.0,-1533333.0
finij101,Jim Finigan,New York Yankees,YANKS,16,45,38,83,1953,1970,17,48.62,78.17,29.55,7017,4726,-2291,22732,11340,-11392,3607.0,11554.0,7947.0,313000.0,125500.0,-187500.0
finij101,Jim Finigan,Kansas City Athletics,ATLTCS,40,86,88,174,1956,1976,20,134.11,73.29,-60.82,13270,9412,-3858,30102,25264,-4838,19786.0,12575.0,-7211.0,506100.0,652200.0,146100.0
finij101,Jim Finigan,Detroit Tigers,TIGRS,3,5,5,10,1958,1961,3,2.6,0.25,-2.35,222,502,280,114,1399,1285,733.0,40.0,-693.0,0.0,0.0,0.0
finij101,Jim Finigan,San Francisco Giants,GIANTS,1,1,2,3,1958,1958,0,-0.15,0.0,0.15,48,0,-48,130,0,-130,0.0,0.0,0.0,0.0,0.0,0.0
finlc001,Chuck Finley,Cleveland Indians,INDINS,3,5,8,13,2002,2011,9,6.54,15.23,8.69,561,1074,513,1946,3677,1731,285.0,785.0,500.0,9861948.0,0.0,-9861948.0
finls001,Steve Finley,Baltimore Orioles,ORLS,1,3,1,4,1991,1993,2,24.17,0.73,-23.44,904,185,-719,2612,764,-1848,2435.0,0.0,-2435.0,0.0,0.0,0.0
finls001,Steve Finley,Houston Astros,ASTROS,14,30,36,66,1994,2008,14,59.26,31.82,-27.44,4671,6059,1388,11202,15757,4555,6620.0,5977.0,-643.0,31714000.0,14229000.0,-17485000.0
finls001,Steve Finley,Arizona Diamondbacks,DBACKS,1,2,3,5,2004,2008,4,1.02,-0.45,-1.47,105,67,-38,363,129,-234,0.0,19.0,19.0,7800000.0,0.0,-7800000.0
finls001,Steve Finley,Anaheim Angels,ANGELS,1,1,1,2,2005,2006,1,1.13,-0.63,-1.76,139,18,-121,481,52,-429,0.0,0.0,0.0,6000000.0,7500000.0,1500000.0
finnb001,Brandon Finnegan,Kansas City Royals,ROYALS,1,3,2,5,2015,2015,0,-1.23,0.27,1.5,231,13,-218,147,0,-147,1419.0,244.0,-1175.0,0.0,10000000.0,10000000.0
finnh102,Happy Finneran,New York Yankees,YANKS,5,14,8,22,1919,1946,27,28.58,90.66,62.08,995,2697,1702,1312,4980,3668,7730.0,17113.0,9383.0,42500.0,38450.0,-4050.0
finnh102,Happy Finneran,Baltimore Terrapins,BLF,1,1,1,2,1914,1914,0,1.87,0.0,-1.87,129,0,-129,138,0,-138,1172.0,0.0,-1172.0,0.0,0.0,0.0
finnn101,Neal Finn,Brooklyn Dodgers,DOGRS,6,13,10,23,1932,1948,16,22.8,18.44,-4.36,1723,1313,-410,5249,4047,-1202,2633.0,2535.0,-98.0,0.0,0.0,0.0
fiorm101,Mike Fiore,Kansas City Royals,ROYALS,2,2,2,4,1970,1971,1,-0.54,-0.26,0.28,134,74,-60,256,197,-59,0.0,0.0,0.0,17000.0,44000.0,27000.0
fiorm101,Mike Fiore,Boston Red Sox,RSOX,1,1,1,2,1972,1972,0,-0.15,-0.78,-0.63,17,45,28,13,84,71,0.0,0.0,0.0,0.0,0.0,0.0
fiorm101,Mike Fiore,St. Louis Cardinals,CARDS,1,2,1,3,1972,1972,0,0.0,0.0,0.0,7,0,-7,7,0,-7,0.0,0.0,0.0,24000.0,0.0,-24000.0
fires001,Steve Fireovid,San Diego Padres,PADRS,4,7,8,15,1983,1992,9,0.01,11.95,11.94,244,925,681,351,1136,785,610.0,1770.0,1160.0,375000.0,2175000.0,1800000.0
fiscb101,Bill Fischer,Chicago White Sox,WSOX,3,10,4,14,1951,1953,2,2.36,0.32,-2.04,404,226,-178,236,372,136,2232.0,741.0,-1491.0,0.0,0.0,0.0
fiscb101,Bill Fischer,Chicago White Sox,WSOX,14,22,25,47,1958,1969,11,14.88,32.86,17.98,2012,2738,726,3483,4385,902,3780.0,6927.0,3147.0,112250.0,102500.0,-9750.0
fiscb101,Bill Fischer,Washington Senators,TWINS,1,1,1,2,1960,1961,1,0.73,-0.15,-0.88,92,28,-64,23,5,-18,304.0,72.0,-232.0,0.0,0.0,0.0
fiscb101,Bill Fischer,Detroit Tigers,TIGRS,1,2,2,4,1961,1961,0,2.6,-0.03,-2.63,199,50,-149,85,51,-34,733.0,40.0,-693.0,0.0,0.0,0.0
fiscc101,Carl Fischer,Washington Senators,TWINS,4,5,4,9,1932,1937,5,9.38,12.91,3.53,664,338,-326,592,470,-122,4696.0,3368.0,-1328.0,13000.0,4500.0,-8500.0
fiscc101,Carl Fischer,St.Louis Browns,ORLS,1,1,1,2,1932,1935,3,0.34,1.79,1.45,58,222,164,45,161,116,368.0,1375.0,1007.0,0.0,0.0,0.0
fiscc101,Carl Fischer,Washington Senators,TWINS,2,3,2,5,1932,1937,5,6.78,12.58,5.8,394,270,-124,393,428,35,3029.0,2990.0,-39.0,6500.0,0.0,-6500.0
fisch101,Hank Fischer,Atlanta Braves,BRAVES,1,1,1,2,1966,1966,0,-0.77,-1.28,-0.51,22,18,-4,11,8,-3,114.0,89.0,-25.0,17000.0,0.0,-17000.0
fisch101,Hank Fischer,Cincinnati Reds,REDS,1,1,3,4,1966,1966,0,0.24,0.0,-0.24,30,0,-30,18,0,-18,173.0,0.0,-173.0,0.0,18500.0,18500.0
fiscj001,Jeff Fischer,Montreal Expos,NATEX,1,1,1,2,1989,1992,3,-0.18,0.98,1.16,4,87,83,0,234,234,10.0,0.0,-10.0,0.0,0.0,0.0
fiscm001,Mike Fischlin,New York Yankees,YANKS,2,4,2,6,1977,1979,2,-0.57,3.2,3.77,493,187,-306,951,449,-502,300.0,202.0,-98.0,0.0,0.0,0.0
fiscm001,Mike Fischlin,Houston Astros,ASTROS,1,1,2,3,1981,1981,0,0.93,0.0,-0.93,387,0,-387,855,0,-855,0.0,0.0,0.0,0.0,0.0,0.0
fiscm001,Mike Fischlin,Cleveland Indians,INDINS,1,1,1,2,1985,1988,3,-0.63,0.0,0.63,71,0,-71,116,0,-116,0.0,0.0,0.0,190000.0,0.0,-190000.0
fiscw101,William Fischer,Chicago Cubs,CUBS,2,5,2,7,1916,1918,2,4.43,7.54,3.11,398,188,-210,1271,487,-784,0.0,807.0,807.0,4000.0,5500.0,1500.0
fishb001,Brian Fisher,Atlanta Braves,BRAVES,2,4,2,6,1984,1986,2,2.56,-0.7,-3.26,185,172,-13,242,460,218,585.0,0.0,-585.0,0.0,675000.0,675000.0
fishb001,Brian Fisher,New York Yankees,YANKS,8,12,14,26,1986,1997,11,30.93,13.18,-17.75,1250,1055,-195,1880,1524,-356,6414.0,3621.0,-2793.0,3550000.0,2212500.0,-1337500.0
fishc103,Chauncey Fisher,Cincinnati Reds,REDS,1,3,1,4,1896,1906,10,0.1,7.82,7.72,152,1229,1077,519,5155,4636,447.0,0.0,-447.0,0.0,0.0,0.0
fishd001,Derek Fisher,Houston Astros,ASTROS,3,5,5,10,2019,2021,2,0.6,-1.15,-1.75,122,50,-72,365,0,-365,14.0,185.0,171.0,0.0,6700000.0,6700000.0
fishd001,Derek Fisher,Toronto Blue Jays,BJAYS,1,1,2,3,2021,2021,0,0.02,0.0,-0.02,4,0,-4,8,0,-8,0.0,0.0,0.0,0.0,0.0,0.0
fishe102,Eddie Fisher,San Francisco Giants,GIANTS,1,4,2,6,1961,1964,3,7.93,4.13,-3.8,685,341,-344,242,140,-102,2569.0,1260.0,-1309.0,0.0,0.0,0.0
fishe102,Eddie Fisher,Chicago White Sox,WSOX,3,3,5,8,1966,1968,2,3.09,3.97,0.88,451,321,-130,592,529,-63,702.0,507.0,-195.0,31250.0,52000.0,20750.0
fishe102,Eddie Fisher,Baltimore Orioles,ORLS,5,11,8,19,1967,1973,6,0.02,-1.5,-1.52,551,253,-298,598,477,-121,1557.0,66.0,-1491.0,38500.0,36600.0,-1900.0
fishe102,Eddie Fisher,Cleveland Indians,INDINS,2,2,2,4,1968,1969,1,1.36,0.1,-1.26,454,40,-414,65,2,-63,1319.0,92.0,-1227.0,57000.0,27500.0,-29500.0
fishe102,Eddie Fisher,California Angels,ANGELS,3,3,4,7,1972,1973,1,0.84,0.81,-0.03,311,114,-197,800,359,-441,399.0,0.0,-399.0,0.0,0.0,0.0
fishj001,John Fishel,Houston Astros,ASTROS,1,3,1,4,1989,1989,0,0.0,-0.25,-0.25,0,40,40,0,31,31,0.0,290.0,290.0,0.0,0.0,0.0
fishj101,Jack Fisher,Baltimore Orioles,ORLS,11,25,25,50,1962,1988,26,22.28,92.11,69.83,2229,4677,2448,3893,9050,5157,9525.0,13707.0,4182.0,725833.0,57000.0,-668833.0
fishj101,Jack Fisher,New York Mets,METS,2,5,4,9,1967,1974,7,2.47,11.88,9.41,357,948,591,832,3426,2594,1066.0,0.0,-1066.0,89000.0,31000.0,-58000.0
fishj101,Jack Fisher,Chicago White Sox,WSOX,7,15,13,28,1968,1979,11,24.79,25.81,1.02,2354,1829,-525,5159,6145,986,6592.0,2166.0,-4426.0,181950.0,284600.0,102650.0
fishj101,Jack Fisher,Cincinnati Reds,REDS,1,1,2,3,1970,1970,0,0.0,0.0,0.0,0,0,0,0,0,0,0.0,0.0,0.0,0.0,0.0,0.0
fishs101,Showboat Fisher,Washington Senators,TWINS,1,1,1,2,1924,1924,0,0.0,0.09,0.09,0,2,2,0,8,8,0.0,0.0,0.0,0.0,0.0,0.0
fishs101,Showboat Fisher,New York Giants,GIANTS,1,2,1,3,1930,1930,0,1.35,-0.6,-1.95,115,121,6,352,457,105,0.0,0.0,0.0,0.0,0.0,0.0
fishs101,Showboat Fisher,St. Louis Cardinals,CARDS,1,1,1,2,1932,1932,0,-0.2,0.0,0.2,18,0,-18,24,0,-24,0.0,0.0,0.0,0.0,4000.0,4000.0
fisht101,Tom Fisher,Baltimore Orioles,ORLS,3,6,5,11,1969,1973,4,0.65,-0.01,-0.66,284,47,-237,424,80,-344,279.0,0.0,-279.0,0.0,18000.0,18000.0
fisht103,Bob Fisher,Newark,Newark,1,2,2,4,1912,1912,0,-0.4,0.0,0.4,214,0,-214,788,0,-788,0.0,0.0,0.0,0.0,4200.0,4200.0
fistd001,Doug Fister,Seattle Mariners,MARNRS,1,2,4,6,2011,2016,5,9.61,3.11,-6.5,89,386,297,9,432,423,1381.0,727.0,-654.0,858500.0,418000.0,-440500.0
fistd001,Doug Fister,Detroit Tigers,TIGRS,6,8,9,17,2013,2021,8,15.02,0.6,-14.42,865,612,-253,879,652,-227,3688.0,1450.0,-2238.0,16515000.0,7501250.0,-9013750.0
fitza101,Al Fitzmorris,Toronto Blue Jays,BJAYS,2,2,5,7,1976,1982,6,7.38,0.73,-6.65,1001,234,-767,3318,766,-2552,442.0,249.0,-193.0,0.0,22500.0,22500.0
fitze101,Ed FitzGerald,Washington Senators,TWINS,1,1,2,3,1959,1962,3,0.95,-2.61,-3.56,49,330,281,143,541,398,0.0,528.0,528.0,0.0,0.0,0.0
fitze101,Ed FitzGerald,Sacramento,Sacramento,1,1,2,3,1947,1947,0,-0.99,0.0,0.99,295,0,-295,686,0,-686,0.0,0.0,0.0,0.0,0.0,0.0
fitzf101,Freddie Fitzsimmons,New York Giants,GIANTS,2,4,2,6,1937,1940,3,11.39,3.66,-7.73,220,153,-67,272,527,255,2128.0,105.0,-2023.0,0.0,0.0,0.0
fitzf101,Freddie Fitzsimmons,Indianapolis,Indianapolis,1,1,2,3,1925,1926,1,24.43,0.0,-24.43,806,0,-806,991,0,-991,7537.0,0.0,-7537.0,0.0,4500.0,4500.0
fitzh101,Howard Fitzgerald,WichitaFalls,WichitaFalls,1,1,3,4,1926,1926,0,-0.79,0.0,0.79,31,0,-31,103,0,-103,0.0,0.0,0.0,0.0,7100.0,7100.0
fitzm001,Mike Fitzgerald,New York Mets,METS,1,4,1,5,1984,1989,5,17.64,11.38,-6.26,1847,600,-1247,5919,2448,-3471,1489.0,0.0,-1489.0,356000.0,0.0,-356000.0
fitzm102,Justin Fitzgerald,New York Yankees,YANKS,1,3,1,4,1911,1911,0,0.0,0.0,0.0,0,0,0,0,0,0,0.0,0.0,0.0,0.0,0.0,0.0
fitzs101,Shaun Fitzmaurice,Pittsburgh Pirates,PIRATS,1,1,1,2,1969,1970,1,0.0,-0.12,-0.12,0,10,10,0,17,17,0.0,0.0,0.0,0.0,0.0,0.0
flacm101,Max Flack,Chicago Cubs,CUBS,1,1,1,2,1922,1931,9,0.33,6.65,6.32,340,856,516,1364,3009,1645,0.0,0.0,0.0,0.0,4000.0,4000.0
flagi101,Ira Flagstead,Detroit Tigers,TIGRS,1,1,1,2,1923,1923,0,14.79,0.0,-14.79,789,0,-789,3399,0,-3399,0.0,0.0,0.0,5000.0,0.0,-5000.0
flagw101,Wally Flager,Cincinnati Reds,REDS,1,1,1,2,1945,1946,1,0.35,1.86,1.51,49,48,-1,187,55,-132,0.0,473.0,473.0,0.0,0.0,0.0
flahj001,John Flaherty,Boston Red Sox,RSOX,1,1,1,2,1994,1995,1,-0.35,0.07,0.42,193,60,-133,594,158,-436,0.0,0.0,0.0,0.0,0.0,0.0
flahj001,John Flaherty,Detroit Tigers,TIGRS,6,14,17,31,1996,2010,14,12.92,23.75,10.83,4861,1561,-3300,12744,2643,-10101,4562.0,6757.0,2195.0,12079000.0,5630000.0,-6449000.0
flahj001,John Flaherty,San Diego Padres,PADRS,3,4,6,10,1997,2006,9,-1.64,18.57,20.21,633,1149,516,2378,3615,1237,0.0,1106.0,1106.0,10525000.0,15000000.0,4475000.0
flahp101,Patsy Flaherty,Pittsburgh Pirates,PIRATS,1,3,1,4,1901,1901,0,0.0,-0.42,-0.42,0,14,14,0,21,21,0.0,133.0,133.0,0.0,0.0,0.0
flahp101,Patsy Flaherty,Pittsburgh Pirates,PIRATS,1,3,1,4,1906,1910,4,14.38,6.11,-8.27,866,332,-534,3143,1286,-1857,1417.0,0.0,-1417.0,0.0,0.0,0.0
flanj101,John Flannery,California Angels,ANGELS,1,3,1,4,1977,1979,2,0.12,1.23,1.11,29,53,24,3,0,-3,151.0,726.0,575.0,0.0,70000.0,70000.0
flanm001,Mike Flanagan,Baltimore Orioles,ORLS,2,2,3,5,1987,1992,5,14.47,-0.96,-15.43,424,50,-374,0,0,0,3299.0,808.0,-2491.0,625000.0,0.0,-625000.0
flemd001,Dave Fleming,Seattle Mariners,MARNRS,1,1,1,2,1995,1996,1,0.36,-0.46,-0.82,9,7,-2,0,0,0,96.0,63.0,-33.0,750000.0,0.0,-750000.0
fleml101,Les Fleming,Detroit Tigers,TIGRS,1,1,3,4,1940,1946,6,0.0,0.0,0.0,0,0,0,0,0,0,0.0,0.0,0.0,0.0,0.0,0.0
fleml101,Les Fleming,Cleveland Indians,INDINS,1,1,1,2,1947,1948,1,0.08,0.0,-0.08,24,0,-24,38,0,-38,0.0,0.0,0.0,0.0,0.0,0.0
fleml101,Les Fleming,Chicago Cubs,CUBS,1,2,4,6,1954,1955,1,0.0,0.0,0.0,0,0,0,0,0,0,0.0,0.0,0.0,0.0,0.0,0.0
fleta001,Aaron Fletcher,Washington Nationals,NATEX,1,3,2,5,2019,2020,1,0.05,-0.26,-0.31,39,55,16,0,1,1,84.0,72.0,-12.0,0.0,2210000.0,2210000.0
fleta101,Art Fletcher,New York Giants,GIANTS,3,6,4,10,1920,1927,7,19.5,24.64,5.14,1124,966,-158,4554,3993,-561,0.0,87.0,87.0,25500.0,18875.0,-6625.0
fletd001,Darrin Fletcher,Los Angeles Dodgers,DOGRS,3,4,3,7,1990,1993,3,0.33,0.79,0.46,142,182,40,165,513,348,763.0,96.0,-667.0,340000.0,120000.0,-220000.0
fletd001,Darrin Fletcher,Philadelphia Phillies,PHILS,1,2,1,3,1991,1992,1,3.4,-0.7,-4.1,643,88,-555,2169,2,-2167,0.0,163.0,163.0,0.0,875000.0,875000.0
flete101,Elbie Fletcher,Boston Braves,BRAVES,1,1,2,3,1939,1940,1,26.17,-0.07,-26.24,916,2,-914,3819,3,-3816,0.0,0.0,0.0,6000.0,0.0,-6000.0
flete101,Elbie Fletcher,Pittsburgh Pirates,PIRATS,1,1,1,2,1947,1954,7,0.0,0.08,0.08,0,24,24,0,38,38,0.0,0.0,0.0,0.0,0.0,0.0
flets001,Scott Fletcher,Chicago Cubs,CUBS,3,6,6,12,1983,1990,7,9.95,11.91,1.96,748,630,-118,2292,307,-1985,429.0,3028.0,2599.0,890000.0,85000.0,-805000.0
flets001,Scott Fletcher,Chicago White Sox,WSOX,2,6,5,11,1985,1991,6,14.64,2.56,-12.08,1223,446,-777,4038,1366,-2672,817.0,277.0,-540.0,640000.0,879873.0,239873.0
flets001,Scott Fletcher,Texas Rangers,RNGRS,3,5,6,11,1989,1992,3,24.82,3.73,-21.09,1170,237,-933,3620,767,-2853,3192.0,327.0,-2865.0,2411539.0,192500.0,-2219039.0
fletv101,Van Fletcher,Seattle,Seattle,1,1,2,3,1954,1954,0,-0.18,0.0,0.18,18,0,-18,1,0,-1,36.0,0.0,-36.0,0.0,0.0,0.0
flicl101,Lew Flick,Philadelphia Athletics,ATLTCS,1,5,1,6,1944,1946,2,0.0,1.19,1.19,0,162,162,0,669,669,0.0,0.0,0.0,3000.0,0.0,-3000.0
flinj101,John Flinn,Baltimore Orioles,ORLS,1,1,1,2,1979,1985,6,-0.16,4.14,4.3,20,441,421,0,1068,1068,111.0,0.0,-111.0,0.0,0.0,0.0
flooc101,Curt Flood,Cincinnati Reds,REDS,3,6,6,12,1957,1960,3,46.58,-0.35,-46.93,2142,12,-2130,7009,0,-7009,805.0,19.0,-786.0,0.0,0.0,0.0
flooc101,Curt Flood,St. Louis Cardinals,CARDS,26,53,46,99,1969,1994,25,115.3,156.23,40.93,11163,7909,-3254,30164,26894,-3270,12224.0,4453.0,-7771.0,3323333.0,942667.0,-2380666.0
flooc101,Curt Flood,Philadelphia Phillies,PHILS,1,2,3,5,1970,1977,7,1.17,0.0,-1.17,48,0,-48,40,0,-40,179.0,0.0,-179.0,0.0,13500.0,13500.0
florb001,Bryce Florie,San Diego Padres,PADRS,4,10,10,20,1996,2006,10,7.75,31.03,23.28,1053,1823,770,3065,7183,4118,514.0,4.0,-510.0,9096680.0,13525000.0,4428320.0
florb001,Bryce Florie,Milwaukee Brewers,BREWRS,5,6,9,15,1997,2006,9,5.19,3.94,-1.25,464,930,466,104,158,54,934.0,1869.0,935.0,5057000.0,4915000.0,-142000.0
florb001,Bryce Florie,Detroit Tigers,TIGRS,2,2,2,4,1999,2009,10,-2.59,5.58,8.17,83,168,85,11,25,14,378.0,2722.0,2344.0,4250000.0,0.0,-4250000.0
flord002,Dylan Floro,Cincinnati Reds,REDS,1,3,2,5,2018,2018,0,1.09,0.0,-1.09,176,0,-176,2,0,-2,299.0,0.0,-299.0,0.0,0.0,0.0
flord002,Dylan Floro,Los Angeles Dodgers,DOGRS,1,1,2,3,2021,2021,0,1.46,0.61,-0.85,133,82,-51,0,4,4,192.0,120.0,-72.0,0.0,0.0,0.0
florg101,Gil Flores,California Angels,ANGELS,1,1,1,2,1978,1978,0,-0.14,0.0,0.14,81,0,-81,139,0,-139,0.0,0.0,0.0,0.0,0.0,0.0
florj001,Jose Flores,Philadelphia Phillies,PHILS,1,1,1,2,1999,1999,0,0.0,-0.52,-0.52,0,32,32,0,72,72,0.0,0.0,0.0,0.0,0.0,0.0
florj001,Jose Flores,Milwaukee Brewers,BREWRS,2,4,5,9,2001,2004,3,0.49,3.61,3.12,225,470,245,5,59,54,355.0,808.0,453.0,1700000.0,0.0,-1700000.0
florj001,Jose Flores,Oakland Athletics,ATLTCS,1,1,1,2,2002,2002,0,0.0,0.0,0.0,0,0,0,0,0,0,0.0,0.0,0.0,0.0,0.0,0.0
flork001,Kevin Flora,California Angels,ANGELS,1,2,1,3,1995,1995,0,-0.59,-0.19,0.4,154,11,-143,102,18,-84,370.0,0.0,-370.0,250000.0,250000.0,0.0
flork001,Kevin Flora,California Angels,ANGELS,1,1,1,2,1996,1996,0,0.0,0.0,0.0,0,0,0,0,0,0,0.0,0.0,0.0,0.0,0.0,0.0
flork002,Kendry Flores,San Francisco Giants,GIANTS,1,2,1,3,2014,2015,1,0.08,-0.84,-0.92,15,49,34,2,138,136,47.0,0.0,-47.0,0.0,1100000.0,1100000.0
florr001,Randy Flores,New York Yankees,YANKS,1,2,1,3,2001,2001,0,-0.24,0.36,0.6,75,15,-60,0,55,55,195.0,0.0,-195.0,0.0,3150000.0,3150000.0
florr003,Ramon Flores,New York Yankees,YANKS,1,2,1,3,2015,2016,1,-0.41,-0.02,0.39,5,51,46,0,127,127,14.0,0.0,-14.0,0.0,2600000.0,2600000.0
florr003,Ramon Flores,Seattle Mariners,MARNRS,2,2,2,4,2015,2016,1,-1.57,-0.48,1.09,168,33,-135,462,77,-385,3.0,3.0,0.0,512000.0,0.0,-512000.0
flowb101,Ben Flowers,Detroit Tigers,TIGRS,2,3,3,6,1955,1956,1,0.07,0.0,-0.07,14,0,-14,13,0,-13,117.0,0.0,-117.0,0.0,0.0,0.0
flowb101,Ben Flowers,St. Louis Cardinals,CARDS,1,3,2,5,1956,1958,2,5.63,6.28,0.65,262,246,-16,209,231,22,1575.0,1837.0,262.0,0.0,0.0,0.0
flowb101,Ben Flowers,Philadelphia Phillies,PHILS,2,8,4,12,1957,1962,5,1.07,-3.22,-4.29,707,621,-86,1985,2063,78,115.0,0.0,-115.0,9000.0,0.0,-9000.0
flowb101,Ben Flowers,Brooklyn Dodgers,DOGRS,1,1,1,2,1957,1958,1,0.0,0.0,0.0,0,0,0,0,0,0,0.0,0.0,0.0,0.0,0.0,0.0
flowj101,Jake Flowers,St. Louis Cardinals,CARDS,1,1,1,2,1927,1927,0,1.57,-1.16,-2.73,405,36,-369,1391,37,-1354,0.0,282.0,282.0,0.0,7500.0,7500.0
flowj101,Jake Flowers,St. Louis Cardinals,CARDS,1,2,2,4,1933,1934,1,-0.46,1.18,1.64,199,133,-66,354,117,-237,902.0,474.0,-428.0,0.0,0.0,0.0
flowt001,Tyler Flowers,Atlanta Braves,BRAVES,5,12,14,26,2008,2014,6,17.06,9.0,-8.06,2364,1258,-1106,2896,3420,524,3035.0,1593.0,-1442.0,26080000.0,24455000.0,-1625000.0
floyb101,Bobby Floyd,Baltimore Orioles,ORLS,3,3,3,6,1970,1972,2,0.9,0.48,-0.42,370,80,-290,415,100,-315,264.0,100.0,-164.0,12500.0,82000.0,69500.0
floyc001,Cliff Floyd,Montreal Expos,NATEX,2,3,4,7,1997,2003,6,22.05,5.37,-16.68,1335,746,-589,2646,1263,-1383,1408.0,2772.0,1364.0,3988333.0,750000.0,-3238333.0
floyc001,Cliff Floyd,Florida Marlins,MARLNS,2,6,6,12,2002,2005,3,-0.85,8.29,9.14,199,741,542,190,1520,1330,741.0,1719.0,978.0,6500000.0,9062500.0,2562500.0
floyc001,Cliff Floyd,Montreal Expos,NATEX,1,1,2,3,2002,2005,3,1.55,0.77,-0.78,47,122,75,190,49,-141,0.0,598.0,598.0,0.0,0.0,0.0
floyg001,Gavin Floyd,Philadelphia Phillies,PHILS,1,2,1,3,2006,2007,1,16.18,-0.17,-16.35,196,21,-175,20,22,2,3223.0,174.0,-3049.0,330000.0,9000000.0,8670000.0
flynb001,Brian Flynn,Detroit Tigers,TIGRS,1,3,2,5,2012,2017,5,-1.8,11.54,13.34,208,344,136,437,741,304,809.0,2395.0,1586.0,1175000.0,8000000.0,6825000.0
flynb001,Brian Flynn,Miami Marlins,MARLNS,1,2,1,3,2014,2015,1,1.69,0.0,-1.69,103,0,-103,1,0,-1,488.0,0.0,-488.0,0.0,1475000.0,1475000.0
flync102,Carney Flynn,New York Giants,GIANTS,1,3,1,4,1896,1896,0,5.07,2.79,-2.28,227,49,-178,829,211,-618,60.0,0.0,-60.0,0.0,0.0,0.0
flynd001,Doug Flynn,Cincinnati Reds,REDS,3,6,5,11,1977,1990,13,13.19,18.54,5.35,1751,636,-1115,5361,1105,-4256,2918.0,3754.0,836.0,450000.0,287500.0,-162500.0
flynd001,Doug Flynn,New York Mets,METS,2,5,2,7,1981,1986,5,-0.02,4.68,4.7,485,655,170,913,2610,1697,596.0,0.0,-596.0,170000.0,163000.0,-7000.0
foggj001,Josh Fogg,Chicago White Sox,WSOX,1,3,2,5,2001,2002,1,9.76,-1.6,-11.36,587,29,-558,520,5,-515,4516.0,401.0,-4115.0,300000.0,1933333.0,1633333.0
foilh101,Hank Foiles,Cleveland Indians,INDINS,19,29,31,60,1956,1984,28,66.93,53.91,-13.02,5439,5565,126,15838,18340,2502,4436.0,3464.0,-972.0,307350.0,510600.0,203250.0
foilh101,Hank Foiles,Pittsburgh Pirates,PIRATS,1,3,1,4,1959,1961,2,-1.03,1.61,2.64,207,144,-63,561,494,-67,547.0,0.0,-547.0,0.0,16500.0,16500.0
foilh101,Hank Foiles,Kansas City Athletics,ATLTCS,2,3,2,5,1960,1960,0,0.0,-0.84,-0.84,0,59,59,0,186,186,0.0,0.0,0.0,0.0,0.0,0.0
foilh101,Hank Foiles,Pittsburgh Pirates,PIRATS,1,1,1,2,1960,1960,0,0.37,0.0,-0.37,24,0,-24,76,0,-76,0.0,0.0,0.0,0.0,0.0,0.0
foilh101,Hank Foiles,Cleveland Indians,INDINS,1,1,2,3,1960,1960,0,0.09,-0.21,-0.3,26,42,16,61,127,66,0.0,0.0,0.0,0.0,0.0,0.0
folet001,Tom Foley,Cincinnati Reds,REDS,1,3,2,5,1985,1989,4,0.22,4.93,4.71,144,460,316,269,1695,1426,243.0,0.0,-243.0,117500.0,620000.0,502500.0
folet001,Tom Foley,Philadelphia Phillies,PHILS,2,4,4,8,1986,1987,1,2.35,0.09,-2.26,749,102,-647,1893,18,-1875,306.0,201.0,-105.0,635000.0,415000.0,-220000.0
folit001,Tim Foli,New York Mets,METS,2,5,3,8,1972,1979,7,27.3,7.07,-20.23,2407,595,-1812,9387,2358,-7029,284.0,578.0,294.0,110000.0,95000.0,-15000.0
folit001,Tim Foli,Montreal Expos,NATEX,2,3,2,5,1977,1985,8,-0.58,9.5,10.08,142,932,790,516,3359,2843,0.0,0.0,0.0,95000.0,90000.0,-5000.0
folit001,Tim Foli,New York Mets,METS,2,3,3,6,1979,1981,2,2.69,-0.73,-3.42,413,378,-35,1617,1583,-34,0.0,0.0,0.0,195000.0,0.0,-195000.0
folit001,Tim Foli,Pittsburgh Pirates,PIRATS,4,9,9,18,1981,1992,11,28.99,20.86,-8.13,1059,1613,554,1954,1843,-111,5314.0,7059.0,1745.0,1030000.0,180000.0,-850000.0
folit001,Tim Foli,California Angels,ANGELS,1,1,2,3,1983,1983,0,-0.39,0.0,0.39,61,0,-61,172,0,-172,0.0,0.0,0.0,0.0,0.0,0.0
folit001,Tim Foli,New York Yankees,YANKS,3,7,5,12,1984,1989,5,23.0,1.52,-21.48,1607,253,-1354,6240,680,-5560,0.0,0.0,0.0,2062000.0,670000.0,-1392000.0
folkr101,Rich Folkers,New York Mets,METS,1,4,4,8,1971,1975,4,1.94,1.36,-0.58,244,340,96,49,280,231,763.0,880.0,117.0,0.0,0.0,0.0
folkr101,Rich Folkers,St. Louis Cardinals,CARDS,4,7,5,12,1974,1976,2,2.63,1.37,-1.26,416,126,-290,619,461,-158,1142.0,0.0,-1142.0,0.0,0.0,0.0
folkr101,Rich Folkers,Milwaukee Brewers,BREWRS,1,2,1,3,1977,1986,9,2.06,21.52,19.46,58,1149,1091,0,4658,4658,821.0,0.0,-821.0,45000.0,60000.0,15000.0
foltm001,Mike Foltynewicz,Houston Astros,ASTROS,2,4,3,7,2015,2018,3,4.87,5.33,0.46,316,563,247,420,1880,1460,2027.0,215.0,-1812.0,0.0,0.0,0.0
fondd101,Dee Fondy,Brooklyn Dodgers,DOGRS,1,2,2,4,1950,1951,1,4.4,0.0,-4.4,849,35,-814,3484,35,-3449,0.0,0.0,0.0,0.0,0.0,0.0
fondd101,Dee Fondy,Chicago Cubs,CUBS,4,7,6,13,1957,1961,4,9.53,8.89,-0.64,897,921,24,1516,3331,1815,802.0,0.0,-802.0,17500.0,0.0,-17500.0
fondd101,Dee Fondy,Pittsburgh Pirates,PIRATS,2,2,3,5,1957,1959,2,-0.1,0.64,0.74,201,169,-32,449,473,24,0.0,0.0,0.0,0.0,52500.0,52500.0
fonsl101,Lew Fonseca,Cleveland Indians,INDINS,1,1,1,2,1931,1935,4,0.72,8.34,7.62,163,522,359,614,2094,1480,3.0,0.0,-3.0,10000.0,11500.0,1500.0
fontj001,Joe Fontenot,San Francisco Giants,GIANTS,1,3,1,4,1997,2004,7,-0.78,10.35,11.13,14,712,698,11,6,-5,128.0,1135.0,1007.0,0.0,3080000.0,3080000.0
fontm001,Mike Fontenot,Baltimore Orioles,ORLS,1,3,2,5,2005,2005,0,4.2,-1.01,-5.21,574,102,-472,1675,424,-1251,0.0,0.0,0.0,0.0,0.0,0.0
fontm001,Mike Fontenot,Chicago Cubs,CUBS,1,1,1,2,2010,2010,0,0.38,0.0,-0.38,113,0,-113,328,0,-328,0.0,0.0,0.0,1000000.0,0.0,-1000000.0
fontr001,Ray Fontenot,Texas Rangers,RNGRS,1,4,4,8,1979,1985,6,12.8,8.35,-4.45,488,521,33,1323,2076,753,918.0,0.0,-918.0,475000.0,133333.0,-341667.0
fontr001,Ray Fontenot,New York Yankees,YANKS,11,23,25,48,1984,1995,11,5.94,31.24,25.3,1908,3078,1170,4328,8691,4363,2758.0,1911.0,-847.0,3498873.0,4760000.0,1261127.0
fontr001,Ray Fontenot,Chicago Cubs,CUBS,1,3,2,5,1986,1987,1,-0.8,-0.88,-0.08,87,76,-11,1,2,1,373.0,157.0,-216.0,873333.0,725000.0,-148333.0
fontw001,Wilmer Font,Los Angeles Dodgers,DOGRS,1,1,1,2,2018,2018,0,-0.3,0.0,0.3,4,0,-4,0,0,0,20.0,0.0,-20.0,0.0,0.0,0.0
fontw001,Wilmer Font,Oakland Athletics,ATLTCS,1,1,1,2,2018,2018,0,0.96,0.0,-0.96,21,0,-21,0,0,0,123.0,0.0,-123.0,0.0,0.0,0.0
fontw001,Wilmer Font,Tampa Bay Devil Rays,RAYS,1,1,1,2,2019,2019,0,0.31,0.0,-0.31,29,0,-29,4,0,-4,93.0,0.0,-93.0,560400.0,0.0,-560400.0
fonvc001,Chad Fonville,Los Angeles Dodgers,DOGRS,1,1,1,2,1997,1997,0,-0.06,0.61,0.67,9,26,17,11,85,74,0.0,0.0,0.0,240000.0,1325000.0,1085000.0
foorj101,Jim Foor,Detroit Tigers,TIGRS,2,5,2,7,1972,1975,3,-0.09,-0.55,-0.46,97,196,99,191,508,317,4.0,0.0,-4.0,88300.0,80000.0,-8300.0
foorj101,Jim Foor,Pittsburgh Pirates,PIRATS,4,4,4,8,1974,1983,9,-0.85,6.88,7.73,131,845,714,293,2739,2446,92.0,0.0,-92.0,0.0,0.0,0.0
footb101,Barry Foote,Montreal Expos,NATEX,1,2,2,4,1977,1979,2,-0.51,-1.74,-1.23,63,126,63,93,101,8,11.0,753.0,742.0,0.0,0.0,0.0
footb101,Barry Foote,Philadelphia Phillies,PHILS,7,17,13,30,1979,1999,20,25.6,38.01,12.41,2807,3562,755,9986,9588,-398,522.0,1259.0,737.0,2950000.0,165000.0,-2785000.0
footb101,Barry Foote,Chicago Cubs,CUBS,1,1,2,3,1981,1984,3,-0.42,-0.25,0.17,57,16,-41,187,13,-174,0.0,122.0,122.0,0.0,0.0,0.0
foppj001,Jesse Foppert,San Francisco Giants,GIANTS,1,2,1,3,2005,2009,4,0.09,12.27,12.18,42,666,624,119,2799,2680,0.0,0.0,0.0,715000.0,3750000.0,3035000.0
fordb001,Brook Fordyce,Cincinnati Reds,REDS,3,7,4,11,1999,2013,14,21.42,15.9,-5.52,841,1440,599,3176,3953,777,381.0,721.0,340.0,8282695.0,396000.0,-7886695.0
fordb001,Brook Fordyce,Chicago White Sox,WSOX,1,4,2,6,2000,2001,1,0.13,0.48,0.35,312,100,-212,1036,320,-716,0.0,0.0,0.0,675000.0,6600000.0,5925000.0
fordb002,Ben Ford,Arizona Diamondbacks,DBACKS,1,2,2,4,1999,2000,1,-0.22,0.28,0.5,4,102,98,0,2,2,33.0,165.0,132.0,0.0,0.0,0.0
fordb002,Ben Ford,New York Yankees,YANKS,5,7,6,13,2000,2007,7,-0.77,1.65,2.42,50,219,169,84,143,59,190.0,789.0,599.0,6000000.0,7500000.0,1500000.0
fordc001,Curt Ford,St. Louis Cardinals,CARDS,1,2,1,3,1988,1992,4,-1.2,10.67,11.87,295,514,219,652,1641,989,0.0,0.0,0.0,340000.0,240000.0,-100000.0
fordd001,Dan Ford,Oakland Athletics,ATLTCS,1,2,1,3,1974,1974,0,6.81,0.02,-6.79,570,73,-497,2213,113,-2100,0.0,0.0,0.0,0.0,0.0,0.0
fordd001,Dan Ford,Minnesota Twins,TWINS,2,2,3,5,1978,1982,4,4.65,1.22,-3.43,335,538,203,1390,1811,421,0.0,0.0,0.0,260000.0,0.0,-260000.0
fordd001,Dan Ford,California Angels,ANGELS,1,1,2,3,1982,1987,5,1.16,18.92,17.76,279,787,508,1083,3268,2185,0.0,0.0,0.0,0.0,0.0,0.0
fordd002,Darren Ford,Milwaukee Brewers,BREWRS,1,2,1,3,2008,2008,0,0.19,0.68,0.49,33,41,8,16,122,106,0.0,0.0,0.0,0.0,7500000.0,7500000.0
fordh101,Hod Ford,Boston Braves,BRAVES,2,3,2,5,1923,1926,3,-0.57,0.9,1.47,238,272,34,860,1042,182,0.0,0.0,0.0,6000.0,0.0,-6000.0
fordh101,Hod Ford,Brooklyn Dodgers,DOGRS,3,9,3,12,1926,1934,8,0.53,8.67,8.14,100,822,722,99,3036,2937,677.0,0.0,-677.0,30000.0,12000.0,-18000.0
fordl001,Lew Ford,Boston Red Sox,RSOX,1,1,1,2,2000,2000,0,8.34,-0.35,-8.69,494,8,-486,1716,0,-1716,0.0,20.0,20.0,0.0,825000.0,825000.0
fordm002,Mike Ford,New York Yankees,YANKS,1,1,2,3,2021,2021,0,0.0,0.0,0.0,0,0,0,0,0,0,0.0,0.0,0.0,0.0,0.0,0.0
fordt102,Ted Ford,Cleveland Indians,INDINS,4,7,5,12,1972,1974,2,5.19,0.53,-4.66,551,289,-262,1523,884,-639,0.0,0.0,0.0,19750.0,160000.0,140250.0
fordt102,Ted Ford,Texas Rangers,RNGRS,3,5,3,8,1973,1977,4,-2.28,-0.02,2.26,64,49,-15,44,0,-44,759.0,568.0,-191.0,0.0,21000.0,21000.0
fordt102,Ted Ford,Cleveland Indians,INDINS,2,2,2,4,1974,1974,0,-0.2,0.0,0.2,3,0,-3,0,0,0,17.0,0.0,-17.0,0.0,0.0,0.0
fornm101,Mike Fornieles,Washington Senators,TWINS,1,1,1,2,1952,1958,6,1.73,6.58,4.85,175,395,220,100,355,255,891.0,2953.0,2062.0,0.0,10000.0,10000.0
fornm101,Mike Fornieles,Chicago White Sox,WSOX,2,5,3,8,1956,1961,5,20.82,6.19,-14.63,1000,561,-439,2990,1443,-1547,2136.0,479.0,-1657.0,62000.0,42500.0,-19500.0
fornm101,Mike Fornieles,Baltimore Orioles,ORLS,18,36,37,73,1957,1988,31,45.47,111.49,66.02,3981,5938,1957,6752,12269,5517,14551.0,16106.0,1555.0,725833.0,113000.0,-612833.0
forsb001,Bob Forsch,St. Louis Cardinals,CARDS,1,1,1,2,1988,1990,2,-2.33,-1.07,1.26,86,166,80,38,290,252,408.0,0.0,-408.0,400000.0,575000.0,175000.0
forsk001,Ken Forsch,Houston Astros,ASTROS,1,1,1,2,1981,1987,6,7.98,16.04,8.06,100,566,466,0,2013,2013,1901.0,0.0,-1901.0,0.0,0.0,0.0
forsl001,Logan Forsythe,San Diego Padres,PADRS,5,10,9,19,2014,2019,5,13.64,2.43,-11.21,896,526,-370,1526,1044,-482,2446.0,524.0,-1922.0,2925000.0,2005000.0,-920000.0
forsl001,Logan Forsythe,Tampa Bay Devil Rays,RAYS,2,2,2,4,2017,2019,2,0.58,-0.14,-0.72,212,5,-207,655,0,-655,73.0,20.0,-53.0,558000.0,0.0,-558000.0
forsl001,Logan Forsythe,Los Angeles Dodgers,DOGRS,1,3,1,4,2018,2018,0,0.86,0.11,-0.75,69,47,-22,205,170,-35,209.0,0.0,-209.0,9000000.0,9000000.0,0.0
forst001,Terry Forster,Chicago White Sox,WSOX,2,5,3,8,1976,1978,2,7.3,2.34,-4.96,434,159,-275,257,599,342,2388.0,97.0,-2291.0,0.0,0.0,0.0
fortb001,Bartolome Fortunato,Tampa Bay Devil Rays,RAYS,9,12,17,29,2004,2020,16,1.53,40.6,39.07,1161,1574,413,1626,3513,1887,2118.0,4281.0,2163.0,9958000.0,505000.0,-9453000.0
fortt001,Tim Fortugno,Seattle Mariners,MARNRS,5,8,8,16,1987,1993,6,24.41,5.5,-18.91,1467,818,-649,2406,1901,-505,2994.0,1198.0,-1796.0,7690000.0,6424900.0,-1265100.0
fortt001,Tim Fortugno,Chicago White Sox,WSOX,6,9,10,19,1995,2008,13,-3.17,23.46,26.63,359,1502,1143,866,3855,2989,1206.0,2082.0,876.0,3255000.0,346500.0,-2908500.0
fosnj101,Jerry Fosnow,Minnesota Twins,TWINS,1,1,1,2,1967,1967,0,0.0,0.0,0.0,0,0,0,0,0,0,0.0,0.0,0.0,0.0,0.0,0.0
fossc001,Casey Fossum,Boston Red Sox,RSOX,1,4,1,5,2003,2008,5,0.73,17.72,16.99,728,123,-605,51,11,-40,1381.0,2025.0,644.0,634000.0,10000000.0,9366000.0
fossc001,Casey Fossum,Arizona Diamondbacks,DBACKS,2,3,4,7,2005,2005,0,-1.0,-1.33,-0.33,113,64,-49,18,245,227,1106.0,0.0,-1106.0,4000000.0,0.0,-4000000.0
fossl101,Larry Foss,New York Mets,METS,5,10,6,16,1963,1970,7,3.02,5.7,2.68,629,656,27,1532,2354,822,1019.0,0.0,-1019.0,88000.0,95000.0,7000.0
fossr101,Ray Fosse,Cleveland Indians,INDINS,17,27,38,65,1973,2004,31,72.79,82.35,9.56,3663,4830,1167,11714,16047,4333,6999.0,8996.0,1997.0,1767500.0,1412500.0,-355000.0
fossr101,Ray Fosse,Cleveland Indians,INDINS,3,3,4,7,1977,1979,2,-0.25,-1.05,-0.8,53,14,-39,36,0,-36,273.0,138.0,-135.0,75000.0,0.0,-75000.0
fosta101,Alan Foster,Los Angeles Dodgers,DOGRS,1,2,1,3,1970,1972,2,4.26,1.8,-2.46,259,141,-118,136,432,296,1602.0,0.0,-1602.0,10000.0,26000.0,16000.0
fosta101,Alan Foster,Cleveland Indians,INDINS,8,13,14,27,1971,1984,13,47.87,7.93,-39.94,2666,2447,-219,9920,8254,-1666,38.0,317.0,279.0,169250.0,286600.0,117350.0
fosta101,Alan Foster,St. Louis Cardinals,CARDS,4,7,5,12,1974,1976,2,2.63,1.37,-1.26,416,126,-290,619,461,-158,1142.0,0.0,-1142.0,0.0,0.0,0.0
foste103,Eddie Foster,Washington Senators,TWINS,3,6,5,11,1919,1926,7,13.31,20.32,7.01,1029,562,-467,3656,1370,-2286,534.0,3052.0,2518.0,16400.0,11500.0,-4900.0
foste103,Eddie Foster,Rochester,Rochester,2,4,5,9,1911,1913,2,29.68,0.0,-29.68,1807,0,-1807,7810,0,-7810,0.0,0.0,0.0,0.0,0.0,0.0
fostg001,George Foster,San Francisco Giants,GIANTS,2,3,3,6,1971,1973,2,79.67,-1.11,-80.78,2234,113,-2121,7887,106,-7781,3392.0,613.0,-2779.0,84000.0,72000.0,-12000.0
fostg001,George Foster,Cincinnati Reds,REDS,3,3,6,9,1982,1988,6,4.34,2.59,-1.75,680,544,-136,2644,847,-1797,86.0,981.0,895.0,0.0,0.0,0.0
fostj001,John Foster,Atlanta Braves,BRAVES,3,7,4,11,2002,2005,3,48.76,10.76,-38.0,1789,404,-1385,2230,926,-1304,9304.0,204.0,-9100.0,4218000.0,5500000.0,1282000.0
fostk001,Kevin Foster,Montreal Expos,NATEX,1,2,2,4,1992,1993,1,-0.6,-0.77,-0.17,3,95,92,0,242,242,7.0,0.0,-7.0,0.0,0.0,0.0
fostk001,Kevin Foster,Seattle Mariners,MARNRS,1,1,1,2,1993,1993,0,-0.42,0.35,0.77,4,14,10,2,0,-2,20.0,59.0,39.0,0.0,125000.0,125000.0
fostk001,Kevin Foster,Philadelphia Phillies,PHILS,2,2,2,4,1994,1994,0,3.18,-0.16,-3.34,187,37,-150,193,30,-163,1464.0,253.0,-1211.0,0.0,300000.0,300000.0
fostk002,Kris Foster,Montreal Expos,NATEX,1,1,1,2,1995,1995,0,0.0,0.0,0.0,0,0,0,0,0,0,0.0,0.0,0.0,0.0,0.0,0.0
fostk002,Kris Foster,Los Angeles Dodgers,DOGRS,1,2,1,3,2001,2002,1,1.42,-0.47,-1.89,279,38,-241,871,0,-871,30.0,70.0,40.0,0.0,2333333.0,2333333.0
fostl101,Leo Foster,Atlanta Braves,BRAVES,1,1,1,2,1975,1980,5,-0.05,-0.77,-0.72,60,267,207,148,635,487,0.0,0.0,0.0,0.0,0.0,0.0
fostl101,Leo Foster,New York Mets,METS,1,1,1,2,1978,1978,0,0.0,0.0,0.0,0,0,0,0,0,0,0.0,0.0,0.0,0.0,0.0,0.0
fostr101,Roy Foster,Milwaukee Brewers,BREWRS,1,3,2,5,1970,1971,1,1.89,-2.52,-4.41,337,186,-151,1153,421,-732,0.0,0.0,0.0,0.0,0.0,0.0
fostr101,Roy Foster,Cleveland Indians,INDINS,6,11,10,21,1971,1978,7,26.06,8.28,-17.78,1542,586,-956,3690,1786,-1904,2427.0,1183.0,-1244.0,83000.0,120000.0,37000.0
fostr101,Roy Foster,Texas Rangers,RNGRS,4,7,4,11,1972,1977,5,0.46,2.24,1.78,334,178,-156,834,481,-353,759.0,568.0,-191.0,0.0,21000.0,21000.0
fostr103,Rube Foster,Boston Red Sox,RSOX,1,1,1,2,1918,1918,0,0.0,2.46,2.46,0,115,115,0,504,504,0.0,0.0,0.0,0.0,0.0,0.0
fothb101,Bob Fothergill,Chicago White Sox,WSOX,2,7,3,10,1932,1936,4,0.81,-0.11,-0.92,234,49,-185,748,93,-655,0.0,39.0,39.0,8600.0,12500.0,3900.0
foucs101,Steve Foucault,Texas Rangers,RNGRS,2,3,3,6,1977,1978,1,2.75,1.73,-1.02,156,216,60,186,786,600,932.0,0.0,-932.0,0.0,105000.0,105000.0
foulk001,Keith Foulke,San Francisco Giants,GIANTS,1,6,3,9,1997,1999,2,21.4,-0.07,-21.47,1008,161,-847,1122,94,-1028,2523.0,875.0,-1648.0,0.0,9757500.0,9757500.0
foulk001,Keith Foulke,Chicago White Sox,WSOX,4,7,9,16,2002,2011,9,3.51,0.6,-2.91,386,338,-48,35,47,12,766.0,905.0,139.0,11095000.0,2433333.0,-8661667.0
fourj101,Jack Fournier,St. Louis Cardinals,CARDS,1,1,2,3,1923,1925,2,18.82,0.02,-18.8,519,141,-378,2176,488,-1688,0.0,0.0,0.0,0.0,0.0,0.0
fowla101,Art Fowler,Cincinnati Reds,REDS,1,4,1,5,1958,1960,2,0.85,9.64,8.79,265,190,-75,151,233,82,590.0,1314.0,724.0,14000.0,30000.0,16000.0
fowld001,Dexter Fowler,Colorado Rockies,ROCKS,1,2,2,4,2013,2017,4,1.79,-0.75,-2.54,116,493,377,505,787,282,0.0,843.0,843.0,4250000.0,491700.0,-3758300.0
fowld001,Dexter Fowler,Houston Astros,ASTROS,2,2,3,5,2015,2016,1,6.42,4.27,-2.15,281,241,-40,1241,865,-376,0.0,53.0,53.0,0.0,0.0,0.0
fowld001,Dexter Fowler,St. Louis Cardinals,CARDS,1,1,1,2,2021,2021,0,-0.18,0.0,0.18,7,0,-7,21,0,-21,0.0,0.0,0.0,0.0,0.0,0.0
fowld002,Dustin Fowler,New York Yankees,YANKS,4,8,7,15,2017,2021,4,10.37,1.61,-8.76,335,144,-191,733,363,-370,1504.0,587.0,-917.0,0.0,3575000.0,3575000.0
fowlj101,Jesse Fowler,St. Louis Cardinals,CARDS,1,5,1,6,1924,1925,1,0.0,0.0,0.0,0,0,0,0,0,0,0.0,0.0,0.0,0.0,0.0,0.0
fox-a001,Andy Fox,New York Yankees,YANKS,1,1,2,3,1998,2000,2,1.58,0.19,-1.39,269,23,-246,974,1,-973,0.0,102.0,102.0,0.0,0.0,0.0
fox-a001,Andy Fox,Arizona Diamondbacks,DBACKS,1,1,1,2,2000,2004,4,-0.72,-0.42,0.3,326,456,130,905,1595,690,0.0,0.0,0.0,750000.0,500000.0,-250000.0
fox-c001,Chad Fox,Cincinnati Reds,REDS,2,3,2,5,1996,1997,1,0.1,0.89,0.79,322,92,-230,303,211,-92,259.0,0.0,-259.0,175000.0,0.0,-175000.0
fox-c001,Chad Fox,Atlanta Braves,BRAVES,1,1,1,2,1997,1999,2,2.1,4.09,1.99,242,272,30,8,756,748,405.0,0.0,-405.0,150000.0,700000.0,550000.0
fox-h101,Howie Fox,Cincinnati Reds,REDS,8,16,22,38,1951,1965,14,82.9,22.04,-60.86,4576,2061,-2515,14654,4760,-9894,2749.0,1025.0,-1724.0,63000.0,63000.0,0.0
fox-j001,Jake Fox,Chicago Cubs,CUBS,1,2,3,5,2009,2010,1,-0.2,-0.27,-0.07,39,14,-25,106,0,-106,0.0,28.0,28.0,2601500.0,400000.0,-2201500.0
fox-j001,Jake Fox,Oakland Athletics,ATLTCS,1,1,1,2,2010,2010,0,-0.09,0.02,0.11,65,11,-54,172,0,-172,0.0,38.0,38.0,405000.0,0.0,-405000.0
fox-n101,Nellie Fox,Philadelphia Athletics,ATLTCS,1,1,1,2,1949,1952,3,47.44,2.72,-44.72,2115,159,-1956,9493,556,-8937,0.0,0.0,0.0,0.0,0.0,0.0
fox-n101,Nellie Fox,Chicago White Sox,WSOX,6,8,9,17,1963,1976,13,-0.96,0.85,1.81,821,928,107,1588,1829,241,489.0,1217.0,728.0,27000.0,17000.0,-10000.0
fox-p101,George Fox,Pittsburgh Pirates,PIRATS,4,11,16,27,1899,1914,15,23.91,73.99,50.08,1271,3182,1911,4723,12859,8136,1693.0,797.0,-896.0,5000.0,11750.0,6750.0
fox-t101,Terry Fox,Milwaukee Braves,BRAVES,1,4,2,6,1960,1966,6,17.87,5.81,-12.06,1212,765,-447,3111,2935,-176,1033.0,0.0,-1033.0,0.0,0.0,0.0
foxeb101,Bill Foxen,Philadelphia Phillies,PHILS,1,1,1,2,1910,1920,10,-0.13,19.94,20.07,10,1311,1301,7,5308,5301,53.0,0.0,-53.0,0.0,0.0,0.0
foxxj101,Jimmie Foxx,Philadelphia Athletics,ATLTCS,1,2,3,5,1935,1936,1,40.03,-0.08,-40.11,1089,70,-1019,4170,77,-4093,1354.0,649.0,-705.0,5500.0,7000.0,1500.0
foy-j101,Joe Foy,Kansas City Royals,ROYALS,3,7,7,14,1969,1983,14,4.64,75.25,70.61,681,3547,2866,1069,13423,12354,1583.0,2330.0,747.0,59500.0,38500.0,-21000.0
foytp101,Paul Foytack,Detroit Tigers,TIGRS,2,5,3,8,1963,1967,4,-0.97,-0.32,0.65,448,297,-151,1059,675,-384,218.0,314.0,96.0,32800.0,33000.0,200.0
fraik101,Ken Frailing,Chicago White Sox,WSOX,1,4,1,5,1973,1973,0,6.5,0.0,-6.5,800,0,-800,1477,0,-1477,2061.0,0.0,-2061.0,32700.0,110000.0,77300.0
fralj001,Jake Fraley,Tampa Bay Devil Rays,RAYS,2,3,5,8,2018,2021,3,0.34,0.28,-0.06,245,235,-10,948,604,-344,0.0,88.0,88.0,0.0,4125000.0,4125000.0
franb001,Ben Francisco,Cleveland Indians,INDINS,6,12,19,31,2009,2021,12,33.76,50.43,16.67,987,1821,834,2686,3190,504,3042.0,8206.0,5164.0,29385300.0,10902500.0,-18482800.0
franb001,Ben Francisco,Philadelphia Phillies,PHILS,1,1,1,2,2011,2011,0,-0.13,0.0,0.13,27,0,-27,54,0,-54,0.0,0.0,0.0,1175000.0,0.0,-1175000.0
franb001,Ben Francisco,Toronto Blue Jays,BJAYS,4,12,6,18,2012,2016,4,10.83,2.99,-7.84,1068,309,-759,3494,605,-2889,904.0,1431.0,527.0,11237500.0,12316000.0,1078500.0
franb001,Ben Francisco,Houston Astros,ASTROS,1,1,1,2,2012,2012,0,-0.14,0.0,0.14,24,0,-24,63,0,-63,0.0,0.0,0.0,0.0,0.0,0.0
frane001,Enderson Franco,Tampa Bay Devil Rays,RAYS,1,1,1,2,2015,2015,0,0.0,0.0,0.0,0,0,0,0,0,0,0.0,0.0,0.0,0.0,0.0,0.0
frane101,Earl Francis,Pittsburgh Pirates,PIRATS,6,10,11,21,1964,1973,9,-1.2,0.41,1.61,81,41,-40,182,35,-147,16.0,36.0,20.0,17500.0,0.0,-17500.0
franf001,Frank Francisco,Boston Red Sox,RSOX,1,2,1,3,2002,2003,1,-0.26,-0.75,-0.49,4,24,20,0,0,0,11.0,67.0,56.0,0.0,1200000.0,1200000.0
franf001,Frank Francisco,Chicago White Sox,WSOX,1,3,1,4,2003,2003,0,5.54,2.04,-3.5,375,73,-302,0,289,289,1248.0,0.0,-1248.0,0.0,9150000.0,9150000.0
franf001,Frank Francisco,Texas Rangers,RNGRS,1,1,1,2,2011,2012,1,1.11,7.29,6.18,58,221,163,0,849,849,152.0,0.0,-152.0,0.0,0.0,0.0
franf101,Fred Frankhouse,St. Louis Cardinals,CARDS,3,4,5,9,1930,1932,2,17.17,7.22,-9.95,980,103,-877,1735,151,-1584,4684.0,1094.0,-3590.0,38000.0,33000.0,-5000.0
franf101,Fred Frankhouse,Boston Braves,BRAVES,9,23,15,38,1936,1952,16,28.65,83.49,54.84,2053,3727,1674,6696,14179,7483,1839.0,2467.0,628.0,20000.0,0.0,-20000.0
franf101,Fred Frankhouse,Brooklyn Dodgers,DOGRS,1,1,1,2,1938,1939,1,0.42,0.0,-0.42,46,0,-46,8,0,-8,114.0,0.0,-114.0,0.0,0.0,0.0
franj001,John Franco,Los Angeles Dodgers,DOGRS,1,2,1,3,1983,1984,1,12.91,-0.97,-13.88,786,117,-669,22,124,102,1584.0,0.0,-1584.0,0.0,0.0,0.0
franj001,John Franco,Cincinnati Reds,REDS,9,13,18,31,1989,2006,17,19.53,23.14,3.61,2921,2149,-772,1877,4164,2287,4092.0,3999.0,-93.0,22668833.0,10745833.0,-11923000.0
franj002,Julio Franco,Philadelphia Phillies,PHILS,5,11,8,19,1982,1999,17,22.81,28.42,5.61,2142,1948,-194,7615,5685,-1930,390.0,1257.0,867.0,2950000.0,165000.0,-2785000.0
franj002,Julio Franco,Cleveland Indians,INDINS,2,2,4,6,1988,1992,4,22.13,7.66,-14.47,821,782,-39,3317,3096,-221,0.0,0.0,0.0,1350000.0,1330000.0,-20000.0
franj003,Jeff Francis,Oakland Athletics,ATLTCS,1,2,1,3,2014,2014,0,-0.03,0.0,0.03,2,0,-2,0,0,0,5.0,0.0,-5.0,0.0,0.0,0.0
franj004,Jeff Francoeur,Atlanta Braves,BRAVES,1,1,1,2,2009,2009,0,2.7,0.95,-1.75,199,44,-155,755,144,-611,0.0,0.0,0.0,3375000.0,2800000.0,-575000.0
franj004,Jeff Francoeur,New York Mets,METS,1,2,1,3,2010,2010,0,0.25,-0.15,-0.4,15,22,7,56,33,-23,0.0,0.0,0.0,5000000.0,402000.0,-4598000.0
franj004,Jeff Francoeur,Atlanta Braves,BRAVES,1,2,2,4,2016,2018,2,-0.25,0.0,0.25,26,0,-26,55,0,-55,0.0,0.0,0.0,0.0,0.0,0.0
franj005,Juan Francisco,Cincinnati Reds,REDS,1,1,1,2,2012,2016,4,0.47,0.73,0.26,128,453,325,320,1,-319,0.0,727.0,727.0,0.0,0.0,0.0
franj005,Juan Francisco,Atlanta Braves,BRAVES,1,1,1,2,2013,2013,0,-0.74,0.0,0.74,89,0,-89,270,0,-270,0.0,0.0,0.0,496250.0,0.0,-496250.0
franm001,Matt Franco,Chicago Cubs,CUBS,1,1,1,2,1996,1996,0,-0.56,0.0,0.56,454,0,-454,715,0,-715,4.0,0.0,-4.0,0.0,0.0,0.0
franm002,Micah Franklin,Cincinnati Reds,REDS,1,1,1,2,1994,1996,2,0.0,0.64,0.64,0,49,49,0,119,119,0.0,0.0,0.0,0.0,250000.0,250000.0
franm002,Micah Franklin,Detroit Tigers,TIGRS,1,2,2,4,1996,1996,0,0.33,-0.3,-0.63,17,16,-1,37,0,-37,0.0,71.0,71.0,0.0,180000.0,180000.0
franm003,Mike Frank,Cincinnati Reds,REDS,3,5,7,12,2000,2013,13,-0.66,18.6,19.26,193,851,658,524,1522,998,274.0,5192.0,4918.0,4750000.0,0.0,-4750000.0
frann001,Nick Franklin,Seattle Mariners,MARNRS,2,3,2,5,2014,2015,1,-0.74,1.5,2.24,145,161,16,417,684,267,3.0,0.0,-3.0,8210200.0,0.0,-8210200.0
frann001,Nick Franklin,Milwaukee Brewers,BREWRS,1,1,1,2,2017,2017,0,0.02,0.0,-0.02,13,0,-13,30,0,-30,0.0,0.0,0.0,0.0,0.0,0.0
franr001,Ryan Franklin,Philadelphia Phillies,PHILS,1,2,1,3,2006,2006,0,0.14,0.0,-0.14,40,0,-40,2,0,-2,73.0,0.0,-73.0,2600000.0,0.0,-2600000.0
franr101,Ray Francis,Washington Senators,TWINS,2,4,2,6,1922,1927,5,-0.61,-0.04,0.57,70,4,-66,21,5,-16,238.0,0.0,-238.0,2800.0,0.0,-2800.0
franr101,Ray Francis,Atlanta,Atlanta,1,1,1,2,1924,1924,0,-0.03,0.0,0.03,8,0,-8,0,0,0,15.0,0.0,-15.0,0.0,0.0,0.0
franr101,Ray Francis,New York Yankees,YANKS,1,2,2,4,1925,1925,0,-0.59,-1.49,-0.9,12,98,86,10,146,136,84.0,166.0,82.0,4000.0,14000.0,10000.0
frant002,Ty France,San Diego Padres,PADRS,1,4,3,7,2020,2021,1,5.43,0.42,-5.01,353,36,-317,1365,75,-1290,2.0,42.0,40.0,0.0,0.0,0.0
frant101,Tito Francona,Baltimore Orioles,ORLS,17,35,36,71,1957,1988,31,40.74,110.41,69.67,3408,5865,2457,6586,11971,5385,12624.0,16106.0,3482.0,725833.0,113000.0,-612833.0
frant101,Tito Francona,Chicago White Sox,WSOX,14,22,25,47,1958,1969,11,14.88,32.86,17.98,2012,2738,726,3483,4385,902,3780.0,6927.0,3147.0,112250.0,102500.0,-9750.0
frant101,Tito Francona,Detroit Tigers,TIGRS,1,1,1,2,1959,1959,0,11.39,-0.62,-12.01,835,18,-817,3298,64,-3234,0.0,0.0,0.0,0.0,0.0,0.0
frant101,Tito Francona,Oakland Athletics,ATLTCS,1,2,1,3,1970,1971,1,0.4,-0.79,-1.19,86,96,10,104,141,37,283.0,0.0,-283.0,62000.0,15000.0,-47000.0
franw001,Wayne Franklin,Houston Astros,ASTROS,1,2,2,4,2002,2002,0,3.17,0.71,-2.46,341,21,-320,1022,77,-945,656.0,0.0,-656.0,0.0,5000000.0,5000000.0
franw001,Wayne Franklin,Milwaukee Brewers,BREWRS,1,2,2,4,2004,2010,6,-0.79,2.11,2.9,88,447,359,5,72,67,156.0,1275.0,1119.0,0.0,0.0,0.0
frarc001,Caleb Frare,New York Yankees,YANKS,1,1,1,2,2018,2018,0,-0.07,0.0,0.07,16,0,-16,0,0,0,29.0,0.0,-29.0,0.0,0.0,0.0
frasc101,Chick Fraser,Philadelphia Phillies,PHILS,1,2,1,3,1904,1904,0,3.87,0.0,-3.87,209,0,-209,665,0,-665,1001.0,0.0,-1001.0,0.0,0.0,0.0
frasc101,Chick Fraser,Boston Braves,BRAVES,1,1,1,2,1906,1909,3,3.06,-3.49,-6.55,62,226,164,87,289,202,704.0,2354.0,1650.0,0.0,0.0,0.0
frasc101,Chick Fraser,Cincinnati Reds,REDS,1,1,3,4,1906,1912,6,-1.15,0.0,1.15,98,0,-98,109,0,-109,911.0,0.0,-911.0,0.0,0.0,0.0
frasj001,John Frascatore,St. Louis Cardinals,CARDS,1,1,1,2,1999,1999,0,0.25,-0.56,-0.81,51,6,-45,0,1,1,99.0,19.0,-80.0,0.0,0.0,0.0
frasj001,John Frascatore,Arizona Diamondbacks,DBACKS,1,2,1,3,1999,2000,1,6.98,0.84,-6.14,434,187,-247,1364,1,-1363,379.0,185.0,-194.0,720000.0,1500000.0,780000.0
frasj002,Jason Frasor,Detroit Tigers,TIGRS,1,2,1,3,2002,2003,1,0.0,-0.66,-0.66,0,40,40,0,131,131,0.0,0.0,0.0,0.0,225000.0,225000.0
frasj002,Jason Frasor,Los Angeles Dodgers,DOGRS,1,1,1,2,2004,2006,2,6.54,4.3,-2.24,539,191,-348,0,721,721,1514.0,0.0,-1514.0,0.0,0.0,0.0
frasj002,Jason Frasor,Toronto Blue Jays,BJAYS,2,6,6,12,2011,2014,3,-0.73,6.64,7.37,396,443,47,89,1646,1557,842.0,15.0,-827.0,7829600.0,16693000.0,8863400.0
frasj002,Jason Frasor,Chicago White Sox,WSOX,2,2,3,5,2012,2016,4,0.35,-0.18,-0.53,54,100,46,0,0,0,131.0,330.0,199.0,0.0,0.0,0.0
frasj002,Jason Frasor,Texas Rangers,RNGRS,2,2,2,4,2014,2015,1,0.87,-0.59,-1.46,85,38,-47,2,0,-2,187.0,100.0,-87.0,1750000.0,0.0,-1750000.0
frasv101,Vic Frazier,Chicago White Sox,WSOX,1,1,1,2,1933,1936,3,-1.98,-0.72,1.26,56,164,108,52,74,22,381.0,631.0,250.0,0.0,3900.0,3900.0
frasw001,Willie Fraser,California Angels,ANGELS,2,4,5,9,1990,1993,3,21.39,3.93,-17.46,688,442,-246,3033,1668,-1365,79.0,0.0,-79.0,1180000.0,3888333.0,2708333.0
fraza001,Adam Frazier,Pittsburgh Pirates,PIRATS,1,2,3,5,2021,2021,0,0.98,0.0,-0.98,57,0,-57,211,0,-211,0.0,0.0,0.0,4300000.0,0.0,-4300000.0
frazc001,Clint Frazier,Cleveland Indians,INDINS,1,4,1,5,2016,2018,2,0.85,4.57,3.72,262,129,-133,807,2,-805,102.0,377.0,275.0,0.0,0.0,0.0
frazg001,George Frazier,Milwaukee Brewers,BREWRS,2,2,2,4,1977,1981,4,3.1,0.61,-2.49,576,235,-341,1265,738,-527,232.0,3.0,-229.0,0.0,0.0,0.0
frazg001,George Frazier,St. Louis Cardinals,CARDS,1,1,1,2,1981,1984,3,4.42,-0.35,-4.77,140,30,-110,0,17,17,764.0,0.0,-764.0,0.0,0.0,0.0
frazg001,George Frazier,New York Yankees,YANKS,3,5,5,10,1984,1985,1,4.69,0.8,-3.89,612,147,-465,1490,453,-1037,133.0,0.0,-133.0,435000.0,0.0,-435000.0
frazg001,George Frazier,Cleveland Indians,INDINS,13,23,29,52,1984,2001,17,109.74,66.95,-42.79,6226,4765,-1461,18678,17797,-881,7708.0,2241.0,-5467.0,19613332.0,19125000.0,-488332.0
frazg001,George Frazier,Chicago Cubs,CUBS,1,3,2,5,1986,1987,1,-0.8,-0.88,-0.08,87,76,-11,1,2,1,373.0,157.0,-216.0,873333.0,725000.0,-148333.0
frazj001,Jeff Frazier,Detroit Tigers,TIGRS,1,1,1,2,2007,2008,1,0.0,0.37,0.37,0,15,15,0,0,0,0.0,80.0,80.0,0.0,0.0,0.0
frazj101,Joe Frazier,Cleveland Indians,INDINS,1,4,2,6,1947,1949,2,3.17,0.88,-2.29,606,121,-485,1943,303,-1640,368.0,217.0,-151.0,0.0,20000.0,20000.0
frazj101,Joe Frazier,OklahomaCity,OklahomaCity,1,1,2,3,1953,1953,0,0.63,0.0,-0.63,153,0,-153,205,0,-205,0.0,0.0,0.0,0.0,0.0,0.0
frazj101,Joe Frazier,St. Louis Cardinals,CARDS,2,3,2,5,1956,1957,1,0.94,-0.25,-1.19,322,29,-293,645,20,-625,0.0,0.0,0.0,0.0,0.0,0.0
frazj101,Joe Frazier,Baltimore Orioles,ORLS,1,2,3,5,1959,1959,0,0.0,0.0,0.0,0,0,0,0,0,0,0.0,0.0,0.0,0.0,0.0,0.0
frazl001,Lou Frazier,Houston Astros,ASTROS,1,1,1,2,1990,1990,0,0.0,0.0,0.0,0,0,0,0,0,0,0.0,0.0,0.0,0.0,0.0,0.0
frazl001,Lou Frazier,Montreal Expos,NATEX,1,1,1,2,1995,1995,0,-0.09,0.0,0.09,79,0,-79,171,0,-171,0.0,0.0,0.0,165000.0,0.0,-165000.0
frazt001,Todd Frazier,Cincinnati Reds,REDS,1,1,3,4,2015,2020,5,5.25,2.19,-3.06,239,951,712,1001,3322,2321,0.0,8.0,8.0,4500000.0,0.0,-4500000.0
frazt001,Todd Frazier,Chicago White Sox,WSOX,2,4,5,9,2017,2017,0,4.16,0.5,-3.66,327,12,-315,241,0,-241,693.0,30.0,-663.0,12535000.0,6150000.0,-6385000.0
frazt001,Todd Frazier,Texas Rangers,RNGRS,1,1,1,2,2020,2020,0,0.14,0.0,-0.14,15,0,-15,51,0,-51,3.0,0.0,-3.0,3500000.0,0.0,-3500000.0
fredj101,Johnny Frederick,Brooklyn Dodgers,DOGRS,2,6,2,8,1934,1938,4,0.05,1.5,1.45,177,398,221,491,1389,898,0.0,3.0,3.0,0.0,0.0,0.0
freed001,David Freese,San Diego Padres,PADRS,1,1,1,2,2007,2008,1,6.71,-0.96,-7.67,466,26,-440,1755,103,-1652,0.0,0.0,0.0,0.0,9562540.0,9562540.0
freed001,David Freese,St. Louis Cardinals,CARDS,2,3,4,7,2013,2019,6,9.31,6.71,-2.6,948,777,-171,2847,1905,-942,577.0,194.0,-383.0,3662000.0,0.0,-3662000.0
freed001,David Freese,Pittsburgh Pirates,PIRATS,1,1,1,2,2018,2018,0,2.07,0.0,-2.07,98,0,-98,233,0,-233,0.0,0.0,0.0,4250000.0,0.0,-4250000.0
freeg101,George Freese,Chicago Cubs,CUBS,7,18,16,34,1953,1965,12,5.64,21.93,16.29,1405,1825,420,3839,2173,-1666,1451.0,4951.0,3500.0,82000.0,75000.0,-7000.0
freeg101,George Freese,Portland,Portland,1,1,1,2,1960,1960,0,0.0,0.0,0.0,0,0,0,0,0,0,0.0,0.0,0.0,0.0,0.0,0.0
freeg102,Gene Freese,Pittsburgh Pirates,PIRATS,2,3,3,6,1958,1972,14,-0.99,11.73,12.72,187,1201,1014,644,3448,2804,6.0,0.0,-6.0,0.0,0.0,0.0
freeg102,Gene Freese,St. Louis Cardinals,CARDS,1,1,1,2,1958,1958,0,1.94,0.0,-1.94,132,0,-132,457,0,-457,0.0,0.0,0.0,0.0,0.0,0.0
freeg102,Gene Freese,Philadelphia Phillies,PHILS,5,9,9,18,1959,1984,25,31.72,53.95,22.23,1846,3261,1415,6839,7928,1089,0.0,2963.0,2963.0,0.0,123000.0,123000.0
freeg102,Gene Freese,Chicago White Sox,WSOX,2,2,3,5,1960,1978,18,1.62,65.42,63.8,375,1414,1039,930,803,-127,426.0,11173.0,10747.0,26000.0,0.0,-26000.0
freeg102,Gene Freese,Chicago White Sox,WSOX,1,1,2,3,1966,1966,0,-0.43,0.0,0.43,21,0,-21,38,0,-38,0.0,0.0,0.0,20000.0,0.0,-20000.0
freeh101,Hersh Freeman,Cincinnati Reds,REDS,1,1,1,2,1958,1958,0,-0.72,-0.14,0.58,18,22,4,1,1,0,39.0,35.0,-4.0,0.0,0.0,0.0
freeh102,Harvey Freeman,Philadelphia Athletics,ATLTCS,1,3,1,4,1922,1925,3,0.0,-0.89,-0.89,0,157,157,0,354,354,0.0,0.0,0.0,2500.0,0.0,-2500.0
freej104,Jimmy Freeman,Atlanta Braves,BRAVES,1,1,2,3,1975,1976,1,0.0,-1.98,-1.98,0,172,172,0,632,632,0.0,0.0,0.0,0.0,0.0,0.0
freej104,Jimmy Freeman,Baltimore Orioles,ORLS,4,12,12,24,1976,1988,12,17.24,67.8,50.56,919,3227,2308,801,6729,5928,6521.0,11016.0,4495.0,558333.0,0.0,-558333.0
freel001,LaVel Freeman,Milwaukee Brewers,BREWRS,1,2,2,4,1989,1990,1,0.0,0.0,0.0,0,0,0,0,0,0,0.0,0.0,0.0,0.0,0.0,0.0
freem001,Marvin Freeman,Philadelphia Phillies,PHILS,1,1,1,2,1990,1991,1,1.35,1.77,0.42,244,204,-40,13,4,-9,455.0,433.0,-22.0,0.0,215000.0,215000.0
freem101,Mark Freeman,New York Yankees,YANKS,1,1,1,2,1959,1959,0,-0.22,0.0,0.22,6,0,-6,0,0,0,11.0,0.0,-11.0,0.0,0.0,0.0
freem101,Mark Freeman,New York Yankees,YANKS,1,1,1,2,1960,1960,0,-0.85,0.0,0.85,60,0,-60,22,0,-22,230.0,0.0,-230.0,0.0,0.0,0.0
freer001,Ryan Freel,Cincinnati Reds,REDS,1,3,2,5,2008,2011,3,-0.23,1.51,1.74,26,269,243,51,1011,960,0.0,0.0,0.0,3000000.0,7500000.0,4500000.0
freer001,Ryan Freel,Baltimore Orioles,ORLS,1,1,1,2,2009,2009,0,-0.31,0.0,0.31,14,0,-14,32,0,-32,0.0,0.0,0.0,4000000.0,800000.0,-3200000.0
freer101,Roger Freed,Baltimore Orioles,ORLS,5,13,15,28,1970,1988,18,17.18,72.92,55.74,1110,3497,2387,1358,6757,5399,6521.0,12016.0,5495.0,558333.0,0.0,-558333.0
freer101,Roger Freed,Philadelphia Phillies,PHILS,3,6,6,12,1972,1984,12,30.16,12.61,-17.55,1404,1289,-115,5310,1182,-4128,0.0,2166.0,2166.0,0.0,123000.0,123000.0
freer101,Roger Freed,Cleveland Indians,INDINS,2,2,2,4,1973,1975,2,0.09,-0.13,-0.22,6,6,0,7,18,11,0.0,0.0,0.0,0.0,0.0,0.0
fregj101,Jim Fregosi,California Angels,ANGELS,5,9,10,19,1971,1990,19,42.96,103.54,60.58,1234,3021,1787,3229,10138,6909,7556.0,9091.0,1535.0,255000.0,95950.0,-159050.0
fregj101,Jim Fregosi,Texas Rangers,RNGRS,2,2,2,4,1977,1978,1,0.69,-0.24,-0.93,85,20,-65,185,52,-133,0.0,0.0,0.0,0.0,0.0,0.0
freid001,David Freitas,Washington Nationals,NATEX,2,2,3,5,2012,2021,9,0.33,-0.07,-0.4,15,133,118,35,445,410,0.0,34.0,34.0,0.0,0.0,0.0
freid001,David Freitas,Oakland Athletics,ATLTCS,1,2,1,3,2013,2014,1,-0.03,-1.33,-1.3,3,41,38,13,1,-12,0.0,121.0,121.0,0.0,6500000.0,6500000.0
freid001,David Freitas,Seattle Mariners,MARNRS,1,1,1,2,2019,2019,0,0.0,0.0,0.0,16,0,-16,16,0,-16,0.0,0.0,0.0,558500.0,0.0,-558500.0
freid101,Dave Freisleben,San Diego Padres,PADRS,1,1,1,2,1978,1978,0,-1.03,0.0,1.03,12,0,-12,0,0,0,133.0,0.0,-133.0,0.0,0.0,0.0
freid101,Dave Freisleben,Cleveland Indians,INDINS,1,1,1,2,1978,1979,1,-0.32,0.0,0.32,42,0,-42,0,0,0,273.0,0.0,-273.0,0.0,0.0,0.0
freih101,Howard Freigau,St. Louis Cardinals,CARDS,2,3,2,5,1925,1928,3,5.63,8.11,2.48,980,417,-563,3189,1539,-1650,0.0,0.0,0.0,30500.0,21000.0,-9500.0
frein001,Nate Freiman,Atlanta Braves,BRAVES,1,1,1,2,2016,2016,0,0.0,0.0,0.0,0,0,0,0,0,0,0.0,0.0,0.0,0.0,0.0,0.0
freit101,Tony Freitas,Sacramento,Sacramento,1,1,2,3,1932,1933,1,1.78,0.0,-1.78,84,0,-84,89,0,-89,644.0,0.0,-644.0,0.0,0.0,0.0
freit101,Tony Freitas,Philadelphia Athletics,ATLTCS,2,5,2,7,1933,1934,1,0.0,0.0,0.0,0,0,0,0,0,0,0.0,0.0,0.0,7600.0,0.0,-7600.0
freit101,Tony Freitas,StPaul,StPaul,1,1,3,4,1934,1934,0,1.84,0.0,-1.84,131,0,-131,110,0,-110,910.0,0.0,-910.0,0.0,3000.0,3000.0
frenl001,Lucas French,Detroit Tigers,TIGRS,1,2,1,3,2009,2009,0,-0.44,-0.68,-0.24,25,8,-17,1,0,-1,377.0,129.0,-248.0,0.0,9850000.0,9850000.0
frenl101,Larry French,Pittsburgh Pirates,PIRATS,1,2,3,5,1934,1938,4,22.26,3.72,-18.54,634,346,-288,941,358,-583,4458.0,2252.0,-2206.0,0.0,0.0,0.0
frenw101,Walt French,Philadelphia Athletics,ATLTCS,1,4,2,6,1929,1936,7,0.0,5.27,5.27,0,394,394,0,395,395,0.0,2946.0,2946.0,7500.0,0.0,-7500.0
freyb101,Benny Frey,Cincinnati Reds,REDS,1,3,1,4,1932,1932,0,-0.61,2.05,2.66,32,83,51,78,279,201,9.0,0.0,-9.0,0.0,0.0,0.0
freyj801,Jim Frey,St. Louis Cardinals,CARDS,2,7,3,10,1960,1963,3,1.56,-0.35,-1.91,364,164,-200,1157,310,-847,0.0,0.0,0.0,0.0,0.0,0.0
freyl101,Lonny Frey,Brooklyn Dodgers,DOGRS,2,5,3,8,1936,1944,8,2.72,0.36,-2.36,227,591,364,615,1769,1154,390.0,469.0,79.0,10000.0,10000.0,0.0
freyl101,Lonny Frey,Nashville,Nashville,1,1,2,3,1932,1932,0,8.79,0.0,-8.79,438,0,-438,1901,0,-1901,0.0,0.0,0.0,0.0,0.0,0.0
freys001,Steve Frey,New York Yankees,YANKS,1,3,2,5,1987,1989,2,0.13,-0.61,-0.74,44,148,104,95,521,426,0.0,0.0,0.0,0.0,250000.0,250000.0
freys001,Steve Frey,New York Mets,METS,1,1,2,3,1989,1990,1,-0.1,0.25,0.35,204,91,-113,4,144,140,350.0,0.0,-350.0,0.0,0.0,0.0
friac001,Carlos Frias,Los Angeles Dodgers,DOGRS,1,1,1,2,2017,2017,0,0.0,0.0,0.0,0,0,0,0,0,0,0.0,0.0,0.0,0.0,0.0,0.0
friah001,Hanley Frias,Arizona Diamondbacks,DBACKS,2,7,4,11,2001,2005,4,15.82,1.29,-14.53,1881,201,-1680,5048,559,-4489,2593.0,37.0,-2556.0,3548667.0,5425000.0,1876333.0
friah001,Hanley Frias,Minnesota Twins,TWINS,1,1,1,2,2001,2001,0,0.0,0.0,0.0,0,0,0,0,0,0,0.0,0.0,0.0,0.0,305000.0,305000.0
friap101,Pepe Frias,Montreal Expos,NATEX,1,1,1,2,1979,1979,0,-0.93,0.0,0.93,140,0,-140,510,0,-510,0.0,0.0,0.0,0.0,0.0,0.0
friap101,Pepe Frias,Atlanta Braves,BRAVES,2,3,5,8,1979,1981,2,1.23,1.75,0.52,177,210,33,304,347,43,541.0,927.0,386.0,150000.0,150000.0,0.0
friap101,Pepe Frias,Texas Rangers,RNGRS,1,1,2,3,1980,1981,1,-0.19,-0.26,-0.07,39,4,-35,48,0,-48,0.0,17.0,17.0,0.0,0.0,0.0
fricm101,Marion Fricano,Kansas City Athletics,ATLTCS,41,88,89,177,1955,1976,21,134.11,72.93,-61.18,13270,9521,-3749,30102,25294,-4808,19786.0,12958.0,-6828.0,506100.0,652200.0,146100.0
fridj101,Jim Fridley,Baltimore Orioles,ORLS,15,37,36,73,1954,1988,34,52.13,133.41,81.28,3638,7388,3750,6759,20843,14084,14284.0,13293.0,-991.0,815833.0,128400.0,-687433.0
fridj101,Jim Fridley,New York Yankees,YANKS,1,1,1,2,1957,1957,0,0.0,0.0,0.0,0,0,0,0,0,0,0.0,0.0,0.0,0.0,0.0,0.0
frieb102,Bob Friend,Pittsburgh Pirates,PIRATS,1,1,2,3,1965,1967,2,-0.56,1.61,2.17,24,206,182,14,30,16,134.0,547.0,413.0,37500.0,11000.0,-26500.0
fried101,Danny Friend,Chicago Cubs,CUBS,1,2,2,4,1898,1901,3,0.0,6.83,6.83,0,327,327,0,1338,1338,0.0,0.0,0.0,0.0,0.0,0.0
friee001,Ernesto Frieri,San Diego Padres,PADRS,1,1,2,3,2012,2016,4,1.06,0.89,-0.17,173,616,443,0,1673,1673,462.0,93.0,-369.0,489100.0,481000.0,-8100.0
friee001,Ernesto Frieri,Anaheim Angels,ANGELS,1,1,1,2,2014,2014,0,-0.62,0.1,0.72,28,41,13,0,0,0,32.0,101.0,69.0,0.0,0.0,0.0
friem001,Max Fried,San Diego Padres,PADRS,1,4,2,6,2014,2016,2,14.14,4.21,-9.93,618,150,-468,1586,620,-966,1341.0,0.0,-1341.0,0.0,14250000.0,14250000.0
frieo101,Owen Friend,St.Louis Browns,ORLS,23,54,54,108,1952,1988,36,77.35,153.48,76.13,5159,9163,4004,10679,26116,15437,18423.0,15654.0,-2769.0,825833.0,138400.0,-687433.0
frieo101,Owen Friend,Detroit Tigers,TIGRS,3,7,7,14,1953,1959,6,19.59,21.85,2.26,1560,1406,-154,4177,3381,-796,3244.0,3436.0,192.0,42000.0,15900.0,-26100.0
frisd101,Danny Frisella,New York Mets,METS,2,3,3,6,1972,1976,4,-0.45,1.09,1.54,209,111,-98,45,100,55,600.0,846.0,246.0,0.0,0.0,0.0
frisd101,Danny Frisella,Atlanta Braves,BRAVES,1,1,1,2,1974,1978,4,1.66,-1.41,-3.07,130,249,119,5,523,518,293.0,0.0,-293.0,0.0,42000.0,42000.0
frisd101,Danny Frisella,San Diego Padres,PADRS,1,1,2,3,1976,1977,1,0.16,-1.24,-1.4,36,38,2,1,5,4,68.0,97.0,29.0,0.0,0.0,0.0
frisd101,Danny Frisella,St. Louis Cardinals,CARDS,8,11,12,23,1976,1992,16,19.3,16.76,-2.54,1487,1395,-92,2974,3195,221,3536.0,4921.0,1385.0,1943333.0,497500.0,-1445833.0
frisf101,Frankie Frisch,New York Giants,GIANTS,4,6,5,11,1926,1932,6,44.88,18.94,-25.94,1758,1119,-639,7309,4215,-3094,99.0,0.0,-99.0,24000.0,37000.0,13000.0
frobd001,Doug Frobel,Montreal Expos,NATEX,1,1,2,3,1986,1986,0,0.0,0.0,0.0,0,0,0,0,0,0,0.0,0.0,0.0,0.0,0.0,0.0
frocs101,Sam Frock,Pittsburgh Pirates,PIRATS,1,2,1,3,1910,1910,0,-1.88,1.0,2.88,213,60,-153,568,54,-514,814.0,458.0,-356.0,0.0,0.0,0.0
froma101,Art Fromme,St. Louis Cardinals,CARDS,2,5,2,7,1908,1912,4,24.55,10.02,-14.53,1473,290,-1183,4275,993,-3282,4114.0,10.0,-4104.0,0.0,0.0,0.0
froma101,Art Fromme,Cincinnati Reds,REDS,2,2,7,9,1913,1925,12,7.71,48.29,40.58,556,1870,1314,1859,7404,5545,786.0,1664.0,878.0,14391.0,23308.0,8917.0
frosd101,Dave Frost,Chicago White Sox,WSOX,8,12,15,27,1977,1997,20,45.63,32.75,-12.88,2200,2303,103,7990,6201,-1789,3475.0,5246.0,1771.0,1390000.0,422000.0,-968000.0
frute001,Emiliano Fruto,Seattle Mariners,MARNRS,1,2,2,4,2006,2008,2,-0.42,0.87,1.29,24,232,208,61,955,894,0.0,0.0,0.0,328500.0,7000000.0,6671500.0
frute001,Emiliano Fruto,Washington Nationals,NATEX,2,2,3,5,2007,2009,2,-0.13,-0.35,-0.22,13,101,88,26,351,325,0.0,0.0,0.0,0.0,1875000.0,1875000.0
fry-p001,Paul Fry,Seattle Mariners,MARNRS,1,1,1,2,2017,2017,0,0.58,0.0,-0.58,180,0,-180,0,0,0,493.0,0.0,-493.0,0.0,0.0,0.0
fryee001,Eric Fryer,Milwaukee Brewers,BREWRS,1,1,1,2,2009,2011,2,0.0,0.0,0.0,0,0,0,0,0,0,0.0,0.0,0.0,0.0,0.0,0.0
fryee001,Eric Fryer,New York Yankees,YANKS,1,2,2,4,2009,2009,0,-0.08,0.01,0.09,52,39,-13,126,98,-28,0.0,0.0,0.0,0.0,1500000.0,1500000.0
fryej001,Jeff Frye,Boston Red Sox,RSOX,2,5,5,10,2000,2002,2,0.87,1.83,0.96,125,248,123,134,537,403,371.0,782.0,411.0,3375000.0,6575000.0,3200000.0
frymt001,Travis Fryman,Detroit Tigers,TIGRS,3,3,5,8,1997,2000,3,-0.25,1.14,1.39,11,331,320,14,816,802,0.0,872.0,872.0,6775000.0,200000.0,-6575000.0
frymt001,Travis Fryman,Arizona Diamondbacks,DBACKS,1,3,1,4,1997,2003,6,6.04,8.29,2.25,656,595,-61,2425,2462,37,172.0,0.0,-172.0,0.0,7150000.0,7150000.0
frymw101,Woodie Fryman,Pittsburgh Pirates,PIRATS,2,5,4,9,1967,1973,6,15.42,-1.44,-16.86,860,110,-750,2406,119,-2287,2691.0,948.0,-1743.0,75000.0,45000.0,-30000.0
frymw101,Woodie Fryman,Detroit Tigers,TIGRS,2,5,5,10,1974,1979,5,11.88,5.51,-6.37,1025,344,-681,672,906,234,4024.0,1490.0,-2534.0,69500.0,39500.0,-30000.0
frymw101,Woodie Fryman,Montreal Expos,NATEX,2,3,3,6,1976,1979,3,-2.11,6.75,8.86,198,572,374,45,1769,1724,656.0,260.0,-396.0,0.0,0.0,0.0
frymw101,Woodie Fryman,Cincinnati Reds,REDS,1,2,1,3,1977,1981,4,2.78,3.66,0.88,288,112,-176,68,126,58,1033.0,1005.0,-28.0,85000.0,0.0,-85000.0
frymw101,Woodie Fryman,Chicago Cubs,CUBS,2,3,2,5,1978,1979,1,5.84,0.14,-5.7,1248,90,-1158,2530,176,-2354,1045.0,0.0,-1045.0,0.0,0.0,0.0
fuenb001,Brian Fuentes,Seattle Mariners,MARNRS,3,7,6,13,2001,2008,7,8.61,1.58,-7.03,1096,337,-759,200,984,784,2142.0,123.0,-2019.0,1587500.0,4850000.0,3262500.0
fuenb001,Brian Fuentes,Anaheim Angels,ANGELS,1,1,1,2,2010,2010,0,0.64,0.0,-0.64,9,0,-9,0,0,0,29.0,0.0,-29.0,9000000.0,0.0,-9000000.0
fuenm001,Mike Fuentes,Montreal Expos,NATEX,1,1,1,2,1986,1987,1,0.0,-0.06,-0.06,0,7,7,0,3,3,0.0,0.0,0.0,0.0,0.0,0.0
fuenr001,Reymond Fuentes,Boston Red Sox,RSOX,8,26,15,41,2010,2019,9,35.43,29.06,-6.37,2876,1721,-1155,5076,5808,732,4841.0,1908.0,-2933.0,4708000.0,21460000.0,16752000.0
fuenr001,Reymond Fuentes,San Diego Padres,PADRS,1,1,1,2,2014,2014,0,-0.23,0.0,0.23,13,0,-13,44,0,-44,0.0,0.0,0.0,0.0,0.0,0.0
fuent101,Tito Fuentes,San Francisco Giants,GIANTS,10,13,17,30,1974,1998,24,12.0,28.62,16.62,1215,2851,1636,2939,9682,6743,2410.0,443.0,-1967.0,7402778.0,4466667.0,-2936111.0
fuhro101,Ollie Fuhrman,Philadelphia Athletics,ATLTCS,1,3,1,4,1922,1925,3,0.0,-0.89,-0.89,0,157,157,0,354,354,0.0,0.0,0.0,2500.0,0.0,-2500.0
fuhro102,Oscar Fuhr,Boston Red Sox,RSOX,1,1,1,2,1924,1924,0,0.0,-0.83,-0.83,0,8,8,0,3,3,0.0,21.0,21.0,3600.0,0.0,-3600.0
fuhro102,Oscar Fuhr,Chicago Cubs,CUBS,1,1,1,2,1921,1921,0,0.0,0.0,0.0,0,0,0,0,0,0,0.0,0.0,0.0,2833.0,0.0,-2833.0
fukuk001,Kosuke Fukudome,Chicago Cubs,CUBS,1,2,2,4,2011,2011,0,-0.5,0.0,0.5,59,0,-59,258,0,-258,0.0,0.0,0.0,14500000.0,0.0,-14500000.0
fulds001,Sam Fuld,Chicago Cubs,CUBS,4,8,9,17,2011,2019,8,18.8,9.35,-9.45,836,1392,556,1720,408,-1312,3536.0,2716.0,-820.0,1500000.0,0.0,-1500000.0
fulds001,Sam Fuld,Minnesota Twins,TWINS,1,1,1,2,2014,2016,2,1.8,0.26,-1.54,180,51,-129,532,4,-528,0.0,659.0,659.0,0.0,510000.0,510000.0
fullb001,Brad Fullmer,Montreal Expos,NATEX,3,7,7,14,2000,2004,4,51.36,-3.19,-54.55,1602,668,-934,5820,1530,-4290,4264.0,874.0,-3390.0,4000000.0,4925000.0,925000.0
fullb001,Brad Fullmer,Toronto Blue Jays,BJAYS,1,1,1,2,2002,2002,0,4.23,-0.5,-4.73,193,2,-191,714,0,-714,0.0,25.0,25.0,0.0,0.0,0.0
fullc101,Chick Fullis,New York Giants,GIANTS,6,16,9,25,1932,1949,17,9.38,67.57,58.19,1463,2679,1216,5350,10428,5078,296.0,142.0,-154.0,0.0,10500.0,10500.0
fullc101,Chick Fullis,Philadelphia Phillies,PHILS,3,3,3,6,1934,1938,4,2.72,4.53,1.81,602,392,-210,901,1021,120,1889.0,1053.0,-836.0,0.0,0.0,0.0
fullc102,Curt Fullerton,New York Yankees,YANKS,1,4,1,5,1926,1937,11,0.0,46.39,46.39,0,1659,1659,0,7068,7068,0.0,0.0,0.0,0.0,0.0,0.0
fullf101,Frank Fuller,SanAntonio,SanAntonio,2,6,2,8,1922,1923,1,9.54,0.0,-9.54,1176,0,-1176,4721,0,-4721,0.0,0.0,0.0,0.0,2700.0,2700.0
fullf101,Frank Fuller,SanAntonio,SanAntonio,1,5,1,6,1923,1923,0,9.54,0.0,-9.54,1176,0,-1176,4721,0,-4721,0.0,0.0,0.0,0.0,0.0,0.0
fullj102,Jim Fuller,Houston Astros,ASTROS,1,1,1,2,1978,1978,0,0.0,0.0,0.0,0,0,0,0,0,0,0.0,0.0,0.0,0.0,0.0,0.0
fulmm001,Michael Fulmer,New York Mets,METS,1,2,1,3,2015,2020,5,10.66,7.65,-3.01,148,316,168,14,1304,1290,1660.0,0.0,-1660.0,0.0,10500000.0,10500000.0
fulta001,Aaron Fultz,San Francisco Giants,GIANTS,1,3,1,4,1993,1993,0,0.3,-0.08,-0.38,64,10,-54,0,6,6,230.0,51.0,-179.0,109000.0,700000.0,591000.0
fultd101,Dave Fultz,New York Yankees,YANKS,4,7,7,14,1906,1911,5,37.76,9.34,-28.42,2601,727,-1874,10473,2947,-7526,0.0,0.0,0.0,0.0,0.0,0.0
funkf101,Frank Funk,Cleveland Indians,INDINS,10,19,17,36,1962,1978,16,30.29,13.22,-17.07,2722,1767,-955,6203,6060,-143,3067.0,1183.0,-1884.0,115500.0,141500.0,26000.0
funkl101,Liz Funk,Louisville,Louisville,1,1,1,2,1932,1932,0,0.91,0.0,-0.91,132,0,-132,505,0,-505,0.0,0.0,0.0,0.0,5500.0,5500.0
funkl101,Liz Funk,Chicago White Sox,WSOX,1,3,1,4,1934,1936,2,0.0,-0.14,-0.14,0,10,10,0,2,2,0.0,39.0,39.0,0.0,0.0,0.0
furbc001,Charlie Furbush,Detroit Tigers,TIGRS,7,12,11,23,2011,2021,10,17.56,10.21,-7.35,1262,701,-561,1311,661,-650,4444.0,2831.0,-1613.0,16933000.0,8359750.0,-8573250.0
furcr001,Rafael Furcal,Los Angeles Dodgers,DOGRS,2,3,3,6,2011,2015,4,2.05,-0.64,-2.69,171,24,-147,748,43,-705,0.0,0.0,0.0,13490500.0,0.0,-13490500.0
furmj001,J.J. Furmaniak,San Diego Padres,PADRS,2,2,2,4,2005,2006,1,2.49,0.15,-2.34,267,11,-256,847,19,-828,0.0,0.0,0.0,0.0,338500.0,338500.0
fussc001,Chris Fussell,Baltimore Orioles,ORLS,3,3,4,7,1999,2005,6,1.41,6.11,4.7,354,704,350,1064,2573,1509,673.0,181.0,-492.0,4250000.0,1000000.0,-3250000.0
fussf101,Fred Fussell,WichitaFalls,WichitaFalls,1,1,2,3,1927,1928,1,0.75,0.0,-0.75,98,0,-98,78,0,-78,598.0,0.0,-598.0,0.0,3500.0,3500.0
fussl101,Les Fusselman,St. Louis Cardinals,CARDS,3,5,3,8,1953,1957,4,0.94,0.38,-0.56,322,182,-140,645,225,-420,0.0,0.0,0.0,0.0,0.0,0.0
fyhrm001,Mike Fyhrie,Anaheim Angels,ANGELS,1,2,1,3,2001,2002,1,0.08,-0.18,-0.26,30,74,44,2,159,157,45.0,0.0,-45.0,0.0,0.0,0.0
fyhrm001,Mike Fyhrie,Chicago Cubs,CUBS,1,1,1,2,2001,2001,0,0.75,0.0,-0.75,20,0,-20,0,0,0,161.0,0.0,-161.0,240000.0,0.0,-240000.0
fyhrm001,Mike Fyhrie,Philadelphia Phillies,PHILS,1,1,1,2,2003,2003,0,0.0,0.0,0.0,0,0,0,0,0,0,0.0,0.0,0.0,0.0,0.0,0.0
fyhrm001,Mike Fyhrie,Cleveland Indians,INDINS,1,1,1,2,2003,2003,0,0.0,0.0,0.0,0,0,0,0,0,0,0.0,0.0,0.0,0.0,0.0,0.0
gabbk001,Kason Gabbard,Boston Red Sox,RSOX,1,3,2,5,2007,2007,0,10.71,-0.24,-10.95,871,20,-851,3012,0,-3012,292.0,56.0,-236.0,0.0,6000000.0,6000000.0
gablf101,Frank Gabler,New York Giants,GIANTS,5,13,8,21,1937,1954,17,2.85,10.95,8.1,238,996,758,838,3422,2584,229.0,172.0,-57.0,6000.0,12000.0,6000.0
gablk101,Ken Gables,Pittsburgh Pirates,PIRATS,1,5,1,6,1947,1947,0,0.0,0.0,0.0,0,0,0,0,0,0,0.0,0.0,0.0,5000.0,0.0,-5000.0
gabrl101,Len Gabrielson,New York Yankees,YANKS,1,1,2,3,1939,1939,0,0.06,0.0,-0.06,5,0,-5,20,0,-20,0.0,0.0,0.0,0.0,0.0,0.0
gabrl102,Len Gabrielson,Milwaukee Braves,BRAVES,1,1,2,3,1964,1965,1,-0.3,-0.03,0.27,117,9,-108,348,17,-331,0.0,0.0,0.0,0.0,0.0,0.0
gabrl102,Len Gabrielson,Chicago Cubs,CUBS,3,4,6,10,1965,1968,3,-0.02,-1.61,-1.59,244,333,89,648,438,-210,220.0,627.0,407.0,0.0,33000.0,33000.0
gabrl102,Len Gabrielson,San Francisco Giants,GIANTS,1,1,1,2,1966,1967,1,-0.18,-0.01,0.17,11,46,35,14,72,58,0.0,0.0,0.0,0.0,30000.0,30000.0
gabrl102,Len Gabrielson,California Angels,ANGELS,1,1,1,2,1967,1967,0,2.09,0.13,-1.96,324,49,-275,838,89,-749,0.0,0.0,0.0,16000.0,10000.0,-6000.0
gaglp101,Phil Gagliano,St. Louis Cardinals,CARDS,3,3,3,6,1970,1971,1,5.17,-0.31,-5.48,364,69,-295,86,36,-50,700.0,324.0,-376.0,25000.0,0.0,-25000.0
gaglp101,Phil Gagliano,Chicago Cubs,CUBS,1,1,1,2,1970,1974,4,0.69,-0.63,-1.32,99,227,128,175,661,486,0.0,0.0,0.0,0.0,0.0,0.0
gaglp101,Phil Gagliano,Boston Red Sox,RSOX,1,2,1,3,1973,1973,0,0.47,0.0,-0.47,189,0,-189,309,0,-309,0.0,0.0,0.0,0.0,0.0,0.0
gagnc101,Chick Gagnon,Detroit Tigers,TIGRS,1,1,1,2,1922,1925,3,-0.04,-0.61,-0.57,4,70,66,5,21,16,0.0,238.0,238.0,0.0,0.0,0.0
gagnc101,Chick Gagnon,Washington Senators,TWINS,1,3,1,4,1924,1927,3,0.0,0.0,0.0,0,0,0,0,0,0,0.0,0.0,0.0,2800.0,0.0,-2800.0
gagnd001,Drew Gagnon,Milwaukee Brewers,BREWRS,1,2,1,3,2016,2018,2,1.97,-1.05,-3.02,216,84,-132,761,259,-502,0.0,0.0,0.0,1125000.0,0.0,-1125000.0
gagne001,Eric Gagne,Texas Rangers,RNGRS,1,2,3,5,2007,2014,7,-0.24,10.71,10.95,20,871,851,0,3012,3012,56.0,292.0,236.0,6000000.0,0.0,-6000000.0
gagng001,Greg Gagne,New York Yankees,YANKS,10,16,17,33,1982,1997,15,48.99,20.71,-28.28,2747,1421,-1326,5735,2836,-2899,7707.0,4016.0,-3691.0,4250000.0,2812500.0,-1437500.0
gainj001,Jay Gainer,San Diego Padres,PADRS,2,2,3,5,1993,1993,0,0.25,0.0,-0.25,53,0,-53,57,0,-57,141.0,0.0,-141.0,0.0,0.0,0.0
gainj101,Joe Gaines,Cincinnati Reds,REDS,1,1,2,3,1962,1962,0,0.64,0.0,-0.64,82,0,-82,176,0,-176,0.0,0.0,0.0,0.0,0.0,0.0
gainj101,Joe Gaines,Baltimore Orioles,ORLS,1,1,2,3,1964,1966,2,0.15,0.0,-0.15,200,0,-200,614,0,-614,0.0,0.0,0.0,8500.0,0.0,-8500.0
gaked001,Dan Gakeler,Boston Red Sox,RSOX,1,2,2,4,1988,1993,5,6.42,6.16,-0.26,552,597,45,1976,1669,-307,0.0,1455.0,1455.0,525000.0,132500.0,-392500.0
galaa001,Andres Galarraga,Montreal Expos,NATEX,3,4,7,11,1991,1999,8,1.01,9.86,8.85,330,668,338,1208,996,-212,331.0,2236.0,1905.0,0.0,155000.0,155000.0
galaa001,Andres Galarraga,Texas Rangers,RNGRS,2,2,4,6,2001,2006,5,1.1,1.58,0.48,255,103,-152,775,31,-744,0.0,323.0,323.0,6000000.0,0.0,-6000000.0
galaa002,Armando Galarraga,Washington Nationals,NATEX,1,3,1,4,2005,2006,1,0.68,6.08,5.4,217,159,-58,754,728,-26,26.0,0.0,-26.0,3395000.0,7500000.0,4105000.0
galaa002,Armando Galarraga,Texas Rangers,RNGRS,1,1,1,2,2008,2008,0,4.58,0.0,-4.58,89,0,-89,12,0,-12,1400.0,0.0,-1400.0,0.0,0.0,0.0
galaa002,Armando Galarraga,Detroit Tigers,TIGRS,1,1,2,3,2011,2011,0,-1.5,0.0,1.5,16,0,-16,16,0,-16,128.0,0.0,-128.0,0.0,0.0,0.0
galaa002,Armando Galarraga,Cincinnati Reds,REDS,1,1,1,2,2013,2013,0,0.0,0.0,0.0,0,0,0,0,0,0,0.0,0.0,0.0,0.0,0.0,0.0
galaa101,Augie Galan,Chicago Cubs,CUBS,1,1,2,3,1941,1946,5,22.35,0.0,-22.35,627,0,-627,2568,0,-2568,0.0,0.0,0.0,0.0,0.0,0.0
galaa101,Augie Galan,Brooklyn Dodgers,DOGRS,1,1,1,2,1946,1948,2,4.66,0.0,-4.66,178,0,-178,598,0,-598,0.0,0.0,0.0,0.0,0.0,0.0
galaa101,Augie Galan,SanFrancisco,SanFrancisco,1,1,7,8,1933,1934,1,18.34,0.0,-18.34,903,0,-903,3781,0,-3781,0.0,0.0,0.0,0.0,0.0,0.0
galed101,Denny Galehouse,Cleveland Indians,INDINS,2,3,2,5,1938,1940,2,3.73,5.73,2.0,238,292,54,340,1286,946,1666.0,0.0,-1666.0,21500.0,12500.0,-9000.0
galer001,Rich Gale,Kansas City Royals,ROYALS,1,2,1,3,1981,1983,2,7.18,1.45,-5.73,329,160,-169,289,613,324,2571.0,0.0,-2571.0,0.0,0.0,0.0
galer001,Rich Gale,San Francisco Giants,GIANTS,2,2,2,4,1983,1984,1,-1.01,-0.37,0.64,100,25,-75,86,35,-51,269.0,0.0,-269.0,0.0,0.0,0.0
galla101,Al Gallagher,San Francisco Giants,GIANTS,1,1,1,2,1973,1973,0,0.85,-0.22,-1.07,110,12,-98,352,23,-329,0.0,0.0,0.0,0.0,0.0,0.0
gallb101,Bob Gallagher,Houston Astros,ASTROS,1,1,1,2,1974,1977,3,-0.2,-0.02,0.18,33,249,216,16,457,441,0.0,0.0,0.0,0.0,0.0,0.0
gallb101,Bob Gallagher,New York Mets,METS,2,3,2,5,1976,1976,0,0.0,-0.35,-0.35,0,64,64,0,74,74,0.0,0.0,0.0,0.0,0.0,0.0
gallb103,Bert Gallia,KansasCity,KansasCity,3,4,7,11,1912,1915,3,56.9,0.0,-56.9,1282,0,-1282,2403,0,-2403,9207.0,0.0,-9207.0,0.0,5700.0,5700.0
gallb103,Bert Gallia,Washington Senators,TWINS,1,2,2,4,1917,1919,2,0.15,3.97,3.82,110,243,133,129,1072,943,1048.0,0.0,-1048.0,3200.0,9000.0,5800.0
gallc101,Chick Galloway,Philadelphia Athletics,ATLTCS,2,4,2,6,1927,1930,3,0.0,0.9,0.9,0,133,133,0,244,244,0.0,407.0,407.0,8000.0,0.0,-8000.0
gallc101,Chick Galloway,St.Louis Browns,ORLS,22,44,51,95,1927,1952,25,139.77,131.99,-7.78,6854,9855,3001,22708,32907,10199,12609.0,15510.0,2901.0,213500.0,207450.0,-6050.0
gallc101,Chick Galloway,Milwaukee,Milwaukee,1,1,2,3,1927,1929,2,0.0,0.0,0.0,0,0,0,0,0,0,0.0,0.0,0.0,0.0,5000.0,5000.0
galld001,Dave Gallagher,Cleveland Indians,INDINS,1,1,1,2,1987,1988,1,0.0,-0.01,-0.01,0,20,20,0,0,0,0.0,106.0,106.0,0.0,0.0,0.0
galld001,Dave Gallagher,Baltimore Orioles,ORLS,1,1,2,3,1990,1990,0,1.51,0.0,-1.51,101,0,-101,324,0,-324,0.0,0.0,0.0,0.0,0.0,0.0
galld001,Dave Gallagher,California Angels,ANGELS,1,1,1,2,1991,1992,1,0.89,-1.31,-2.2,197,82,-115,434,320,-114,0.0,0.0,0.0,357500.0,2316666.0,1959166.0
galld001,Dave Gallagher,New York Mets,METS,1,1,1,2,1993,1994,1,-0.1,0.01,0.11,89,42,-47,177,47,-130,0.0,394.0,394.0,500000.0,1025000.0,525000.0
galld001,Dave Gallagher,Philadelphia Phillies,PHILS,1,1,2,3,1995,1996,1,-0.19,-0.59,-0.4,11,154,143,18,102,84,0.0,370.0,370.0,250000.0,250000.0,0.0
gallg001,Giovanny Gallegos,New York Yankees,YANKS,1,2,2,4,2018,2018,0,3.47,1.31,-2.16,336,39,-297,5,148,143,562.0,0.0,-562.0,825000.0,0.0,-825000.0
gallj002,Joey Gallo,Texas Rangers,RNGRS,1,3,4,7,2021,2021,0,0.78,-0.87,-1.65,82,6,-76,228,0,-228,57.0,70.0,13.0,8700000.0,0.0,-8700000.0
gallj103,Joe Gallagher,New York Yankees,YANKS,2,2,3,5,1939,1939,0,-0.88,0.0,0.88,249,0,-249,934,0,-934,0.0,0.0,0.0,3000.0,12500.0,9500.0
gallj103,Joe Gallagher,St.Louis Browns,ORLS,2,3,3,6,1940,1947,7,0.67,12.2,11.53,155,603,448,409,1958,1549,122.0,1025.0,903.0,12500.0,12250.0,-250.0
gallp101,Phil Gallivan,Chicago White Sox,WSOX,1,3,1,4,1934,1934,0,0.0,0.0,0.0,0,0,0,0,0,0,0.0,0.0,0.0,2700.0,0.0,-2700.0
galls001,Sean Gallagher,Chicago Cubs,CUBS,1,4,2,6,2008,2009,1,13.08,4.54,-8.54,545,124,-421,2047,74,-1973,213.0,718.0,505.0,0.0,6525000.0,6525000.0
galls001,Sean Gallagher,Oakland Athletics,ATLTCS,2,5,3,8,2009,2016,7,1.67,5.28,3.61,416,684,268,588,2314,1726,340.0,0.0,-340.0,410000.0,1250000.0,840000.0
gallw102,William Gallagher,Wilmington,Wilmington,1,1,2,3,1896,1904,8,0.46,0.0,-0.46,14,0,-14,61,0,-61,0.0,0.0,0.0,0.0,0.0,0.0
gally001,Yovani Gallardo,Milwaukee Brewers,BREWRS,3,4,5,9,2015,2020,5,4.62,2.83,-1.79,140,575,435,85,394,309,909.0,683.0,-226.0,5125000.0,0.0,-5125000.0
gally001,Yovani Gallardo,Baltimore Orioles,ORLS,1,2,1,3,2017,2017,0,-0.25,0.55,0.8,29,111,82,2,373,371,392.0,0.0,-392.0,0.0,0.0,0.0
gallz001,Zac Gallen,St. Louis Cardinals,CARDS,1,4,1,5,2017,2019,2,8.96,4.59,-4.37,386,278,-108,632,1177,545,1696.0,0.0,-1696.0,0.0,3500000.0,3500000.0
gallz001,Zac Gallen,Miami Marlins,MARLNS,1,1,1,2,2019,2019,0,6.02,0.0,-6.02,73,0,-73,55,0,-55,711.0,0.0,-711.0,0.0,0.0,0.0
galvb001,Balvino Galvez,Los Angeles Dodgers,DOGRS,1,1,1,2,1987,1987,0,0.0,0.2,0.2,0,7,7,0,6,6,0.0,0.0,0.0,0.0,0.0,0.0
galvb001,Balvino Galvez,Detroit Tigers,TIGRS,1,1,1,2,1988,1988,0,0.0,0.01,0.01,0,6,6,0,6,6,0.0,0.0,0.0,0.0,0.0,0.0
galvb001,Balvino Galvez,Minnesota Twins,TWINS,1,1,1,2,1989,1989,0,0.0,-0.69,-0.69,0,11,11,0,0,0,0.0,52.0,52.0,0.0,0.0,0.0
galvf001,Freddy Galvis,Philadelphia Phillies,PHILS,1,1,1,2,2017,2021,4,1.85,-0.8,-2.65,162,74,-88,656,6,-650,0.0,174.0,174.0,4350000.0,0.0,-4350000.0
galvf001,Freddy Galvis,Baltimore Orioles,ORLS,1,1,1,2,2021,2021,0,0.32,0.0,-0.32,32,0,-32,120,0,-120,0.0,0.0,0.0,1500000.0,0.0,-1500000.0
galvj103,Pud Galvin,Pittsburgh Pirates,PIRATS,2,2,2,4,1892,1897,5,2.06,5.48,3.42,99,115,16,342,185,-157,276.0,1232.0,956.0,0.0,0.0,0.0
gambe001,Eddie Gamboa,Tampa Bay Devil Rays,RAYS,1,1,1,2,2017,2017,0,0.0,0.0,0.0,0,0,0,0,0,0,0.0,0.0,0.0,0.0,0.0,0.0
gambo001,Oscar Gamble,Chicago Cubs,CUBS,2,3,3,6,1969,1974,5,1.23,0.0,-1.23,677,440,-237,1258,890,-368,797.0,392.0,-405.0,0.0,0.0,0.0
gambo001,Oscar Gamble,Philadelphia Phillies,PHILS,3,6,6,12,1972,1984,12,30.16,12.61,-17.55,1404,1289,-115,5310,1182,-4128,0.0,2166.0,2166.0,0.0,123000.0,123000.0
gambo001,Oscar Gamble,Cleveland Indians,INDINS,1,1,1,2,1975,1978,3,11.27,0.86,-10.41,540,68,-472,1707,0,-1707,0.0,1052.0,1052.0,0.0,79000.0,79000.0
gambo001,Oscar Gamble,New York Yankees,YANKS,4,7,7,14,1977,1983,6,29.7,12.76,-16.94,1788,732,-1056,2195,2573,378,4627.0,0.0,-4627.0,0.0,400000.0,400000.0
gambo001,Oscar Gamble,San Diego Padres,PADRS,5,12,10,22,1978,1989,11,40.51,8.43,-32.08,3264,1226,-2038,10982,3533,-7449,2009.0,1127.0,-882.0,475000.0,0.0,-475000.0
gambo001,Oscar Gamble,Texas Rangers,RNGRS,1,4,4,8,1979,1985,6,12.8,8.35,-4.45,488,521,33,1323,2076,753,918.0,0.0,-918.0,475000.0,133333.0,-341667.0
gameb001,Ben Gamel,New York Yankees,YANKS,2,3,4,7,2016,2018,2,1.26,0.93,-0.33,272,25,-247,909,114,-795,0.0,0.0,0.0,0.0,14750000.0,14750000.0
gameb001,Ben Gamel,Seattle Mariners,MARNRS,1,2,1,3,2018,2019,1,0.26,0.49,0.23,174,121,-53,483,507,24,0.0,0.0,0.0,0.0,572400.0,572400.0
gandc101,Chick Gandil,Montreal,Montreal,1,1,3,4,1912,1912,0,13.55,0.0,-13.55,546,0,-546,2246,0,-2246,0.0,0.0,0.0,0.0,0.0,0.0
gantj002,John Gant,New York Mets,METS,1,2,2,4,2015,2015,0,-0.77,0.79,1.56,50,93,43,21,281,260,224.0,0.0,-224.0,0.0,8000000.0,8000000.0
gantj002,John Gant,Atlanta Braves,BRAVES,2,6,2,8,2016,2017,1,2.2,1.46,-0.74,256,33,-223,58,35,-23,887.0,339.0,-548.0,13307500.0,11500000.0,-1807500.0
gantj002,John Gant,St. Louis Cardinals,CARDS,1,2,2,4,2021,2021,0,-0.36,0.27,0.63,16,21,5,0,15,15,101.0,162.0,61.0,2100000.0,8000000.0,5900000.0
gantr001,Ron Gant,St. Louis Cardinals,CARDS,1,3,2,5,1998,1999,1,3.97,-0.62,-4.59,475,133,-342,1012,3,-1009,549.0,220.0,-329.0,8470000.0,2385000.0,-6085000.0
gantr001,Ron Gant,Philadelphia Phillies,PHILS,1,1,1,2,2000,2000,0,0.73,0.56,-0.17,34,16,-18,103,17,-86,0.0,132.0,132.0,5066667.0,4000000.0,-1066667.0
gantr001,Ron Gant,Colorado Rockies,ROCKS,3,6,5,11,2001,2002,1,2.95,-0.58,-3.53,384,252,-132,1433,925,-508,0.0,3.0,3.0,2800000.0,1890000.0,-910000.0
ganzj101,John Ganzel,KansasCity,KansasCity,2,2,5,7,1900,1908,8,0.85,0.0,-0.85,100,0,-100,387,0,-387,0.0,0.0,0.0,0.0,0.0,0.0
ganzj101,John Ganzel,Chicago Cubs,CUBS,1,3,1,4,1901,1902,1,10.49,-0.18,-10.67,648,75,-573,2353,299,-2054,0.0,0.0,0.0,0.0,0.0,0.0
garaj101,Joe Garagiola,St. Louis Cardinals,CARDS,3,10,5,15,1951,1954,3,10.75,2.71,-8.04,1144,382,-762,2713,1234,-1479,1601.0,388.0,-1213.0,41500.0,63500.0,22000.0
garaj101,Joe Garagiola,Pittsburgh Pirates,PIRATS,7,12,15,27,1953,1962,9,9.43,3.47,-5.96,1075,1271,196,3095,3842,747,1449.0,56.0,-1393.0,86000.0,33500.0,-52500.0
garav001,Victor Garate,Los Angeles Dodgers,DOGRS,1,2,1,3,2009,2010,1,-0.17,0.65,0.82,8,106,98,0,268,268,6.0,0.0,-6.0,0.0,1900000.0,1900000.0
garba101,Alex Garbowski,Seattle,Seattle,1,2,1,3,1954,1954,0,0.0,0.0,0.0,0,0,0,0,0,0,0.0,0.0,0.0,0.0,0.0,0.0
garbb001,Barbaro Garbey,Detroit Tigers,TIGRS,1,1,1,2,1985,1986,1,0.0,1.38,1.38,0,124,124,0,476,476,0.0,0.0,0.0,0.0,700000.0,700000.0
garbg001,Gene Garber,Pittsburgh Pirates,PIRATS,1,1,1,2,1972,1980,8,1.51,17.06,15.55,109,434,325,0,496,496,683.0,3953.0,3270.0,0.0,0.0,0.0
garbg001,Gene Garber,Philadelphia Phillies,PHILS,5,9,8,17,1978,1989,11,32.41,16.82,-15.59,3161,1285,-1876,3775,3516,-259,6504.0,2945.0,-3559.0,1629900.0,815000.0,-814900.0
garbg001,Gene Garber,Atlanta Braves,BRAVES,1,1,1,2,1987,1987,0,0.69,0.0,-0.69,39,1,-38,0,1,1,141.0,0.0,-141.0,786667.0,0.0,-786667.0
garca001,Amaury Garcia,Florida Marlins,MARLNS,1,1,1,2,2000,2000,0,0.0,0.0,0.0,0,0,0,0,0,0,0.0,0.0,0.0,0.0,0.0,0.0
garca002,Anderson Garcia,New York Yankees,YANKS,2,4,2,6,2003,2003,0,0.35,0.36,0.01,27,33,6,0,0,0,75.0,81.0,6.0,300000.0,10920833.0,10620833.0
garca003,Avisail Garcia,Detroit Tigers,TIGRS,1,2,1,3,2013,2018,5,6.35,7.04,0.69,585,558,-27,2358,2068,-290,0.0,0.0,0.0,0.0,0.0,0.0
garca006,Aramis Garcia,Texas Rangers,RNGRS,1,3,3,6,2021,2021,0,0.18,-0.26,-0.44,178,104,-74,635,346,-289,0.0,0.0,0.0,0.0,0.0,0.0
garcc001,Carlos Garcia,Pittsburgh Pirates,PIRATS,3,5,8,13,1996,2007,11,2.44,5.98,3.54,539,1682,1143,911,3950,3039,615.0,1633.0,1018.0,9245000.0,3600000.0,-5645000.0
garcc101,Chico Garcia,Baltimore Orioles,ORLS,18,36,37,73,1954,1988,34,40.74,115.91,75.17,3408,6089,2681,6586,12182,5596,12624.0,17798.0,5174.0,725833.0,113000.0,-612833.0
garcd001,Damaso Garcia,New York Yankees,YANKS,13,23,23,46,1979,1997,18,40.16,16.71,-23.45,2656,1808,-848,6433,3520,-2913,8337.0,5150.0,-3187.0,4715000.0,3012500.0,-1702500.0
garcd001,Damaso Garcia,Toronto Blue Jays,BJAYS,1,2,1,3,1987,1987,0,-0.66,0.0,0.66,21,0,-21,64,0,-64,0.0,0.0,0.0,0.0,0.0,0.0
garce001,Edgar Garcia,Philadelphia Phillies,PHILS,1,1,1,2,2020,2020,0,-0.28,0.0,0.28,4,0,-4,0,0,0,10.0,0.0,-10.0,0.0,0.0,0.0
garcf001,Freddy Garcia,Pittsburgh Pirates,PIRATS,1,1,1,2,1999,1999,0,0.11,0.0,-0.11,2,0,-2,3,0,-3,0.0,0.0,0.0,265000.0,0.0,-265000.0
garcf001,Freddy Garcia,Atlanta Braves,BRAVES,1,1,1,2,2000,2000,0,0.0,0.0,0.0,0,0,0,0,0,0,0.0,0.0,0.0,0.0,0.0,0.0
garcf002,Freddy Garcia,Houston Astros,ASTROS,1,3,1,4,1998,1998,0,33.49,3.98,-29.51,809,22,-787,1941,35,-1906,4960.0,253.0,-4707.0,170000.0,6000000.0,5830000.0
garcf002,Freddy Garcia,Seattle Mariners,MARNRS,11,20,22,42,2004,2015,11,19.53,35.16,15.63,1825,2443,618,3973,7974,4001,3326.0,2794.0,-532.0,27402500.0,19145000.0,-8257500.0
garcf002,Freddy Garcia,Chicago White Sox,WSOX,3,6,6,12,2006,2013,7,24.75,15.54,-9.21,1198,365,-833,4129,658,-3471,1892.0,3148.0,1256.0,12600000.0,1495000.0,-11105000.0
garcg001,Guillermo Garcia,Cincinnati Reds,REDS,1,1,1,2,1998,1998,0,-0.03,0.0,0.03,4,0,-4,4,0,-4,0.0,0.0,0.0,0.0,0.0,0.0
garch001,Harvey Garcia,Boston Red Sox,RSOX,14,38,25,63,2005,2019,14,93.01,61.11,-31.9,5581,3052,-2529,12204,8864,-3340,8381.0,6378.0,-2003.0,13099733.0,30982000.0,17882267.0
garch001,Harvey Garcia,Pittsburgh Pirates,PIRATS,1,2,1,3,2009,2010,1,0.0,-0.88,-0.88,0,234,234,0,595,595,0.0,0.0,0.0,0.0,0.0,0.0
garcj001,Jesse Garcia,Baltimore Orioles,ORLS,1,1,1,2,2000,2000,0,-0.88,0.0,0.88,124,0,-124,195,0,-195,0.0,0.0,0.0,201000.0,0.0,-201000.0
garcj004,Jaime Garcia,St. Louis Cardinals,CARDS,2,3,5,8,2016,2021,5,1.1,2.38,1.28,49,276,227,35,73,38,440.0,1029.0,589.0,13600000.0,8507500.0,-5092500.0
garcj004,Jaime Garcia,Atlanta Braves,BRAVES,1,3,1,4,2017,2017,0,0.09,0.0,-0.09,1,0,-1,0,0,0,20.0,0.0,-20.0,12800000.0,0.0,-12800000.0
garcj004,Jaime Garcia,Minnesota Twins,TWINS,1,1,2,3,2017,2020,3,-0.11,0.02,0.13,9,48,39,2,2,0,112.0,203.0,91.0,0.0,0.0,0.0
garck001,Kiko Garcia,Baltimore Orioles,ORLS,1,1,2,3,1981,1981,0,0.83,0.0,-0.83,82,0,-82,230,0,-230,0.0,0.0,0.0,0.0,0.0,0.0
garck002,Karim Garcia,Arizona Diamondbacks,DBACKS,1,1,1,2,1998,2006,8,0.12,30.02,29.9,104,1194,1090,327,5246,4919,0.0,0.0,0.0,187500.0,2000000.0,1812500.0
garck002,Karim Garcia,New York Mets,METS,1,1,1,2,2004,2005,1,-0.72,0.3,1.02,23,88,65,73,0,-73,0.0,141.0,141.0,800000.0,1500000.0,700000.0
garcl001,Leo Garcia,Chicago White Sox,WSOX,1,2,1,3,1982,1984,2,-0.41,-0.13,0.28,101,14,-87,177,0,-177,0.0,86.0,86.0,0.0,0.0,0.0
garcl004,Leury Garcia,Texas Rangers,RNGRS,1,1,1,2,2013,2014,1,5.21,1.24,-3.97,581,178,-403,2030,718,-1312,6.0,0.0,-6.0,490000.0,0.0,-490000.0
garcl005,Luis Garcia,Los Angeles Dodgers,DOGRS,1,2,1,3,2009,2010,1,-0.17,0.65,0.82,8,106,98,0,268,268,6.0,0.0,-6.0,0.0,1900000.0,1900000.0
garcl005,Luis Garcia,Philadelphia Phillies,PHILS,1,1,1,2,2018,2020,2,0.16,1.13,0.97,69,137,68,0,0,0,186.0,196.0,10.0,1200000.0,1050000.0,-150000.0
garcm001,Miguel Garcia,California Angels,ANGELS,1,2,1,3,1987,1990,3,-0.7,4.86,5.56,26,422,396,1,1802,1801,56.0,0.0,-56.0,0.0,807000.0,807000.0
garcn001,Nomar Garciaparra,Boston Red Sox,RSOX,2,4,3,7,2004,2005,1,6.28,1.43,-4.85,500,107,-393,1716,367,-1349,0.0,0.0,0.0,11500000.0,0.0,-11500000.0
garcp101,Pedro Garcia,Milwaukee Brewers,BREWRS,1,1,1,2,1976,1977,1,-1.04,-0.89,0.15,77,59,-18,245,130,-115,0.0,0.0,0.0,0.0,0.0,0.0
garcr004,Rosman Garcia,New York Yankees,YANKS,1,2,1,3,2001,2001,0,-0.24,0.36,0.6,75,15,-60,0,55,55,195.0,0.0,-195.0,0.0,3150000.0,3150000.0
garcy001,Yimi Garcia,Miami Marlins,MARLNS,1,1,2,3,2021,2021,0,-0.33,1.08,1.41,26,66,40,0,219,219,64.0,14.0,-50.0,1900000.0,0.0,-1900000.0
gardb101,Billy Gardner,Baltimore Orioles,ORLS,5,12,9,21,1960,1973,13,20.1,30.87,10.77,1792,1902,110,6348,6382,34,845.0,306.0,-539.0,72000.0,40300.0,-31700.0
gardb101,Billy Gardner,Minnesota Twins,TWINS,1,1,1,2,1961,1962,1,-0.04,0.5,0.54,45,32,-13,110,3,-107,0.0,80.0,80.0,0.0,0.0,0.0
gardb101,Billy Gardner,New York Yankees,YANKS,1,1,2,3,1962,1962,0,-0.22,0.0,0.22,89,0,-89,301,0,-301,0.0,0.0,0.0,0.0,0.0,0.0
gardg102,Gid Gardner,Indianapolis Hoosiers,IN3,1,2,1,3,1887,1890,3,0.0,0.0,0.0,0,0,0,0,0,0,0.0,0.0,0.0,0.0,0.0,0.0
gardg102,Gid Gardner,Washington Senators,WS8,1,1,2,3,1888,1901,13,0.08,0.0,-0.08,1,0,-1,3,0,-3,0.0,0.0,0.0,0.0,0.0,0.0
gardj001,Jeff Gardner,New York Mets,METS,1,1,1,2,1991,1991,0,-0.75,0.0,0.75,155,0,-155,472,0,-472,0.0,0.0,0.0,0.0,130000.0,130000.0
gardl101,Larry Gardner,Boston Red Sox,RSOX,8,19,22,41,1918,1935,17,51.77,23.6,-28.17,3792,2718,-1074,15081,10291,-4790,0.0,1203.0,1203.0,45050.0,29350.0,-15700.0
gardl101,Larry Gardner,Philadelphia Athletics,ATLTCS,2,5,4,9,1919,1920,1,39.26,1.89,-37.37,2383,166,-2217,9666,676,-8990,678.0,0.0,-678.0,2400.0,0.0,-2400.0
gardm001,Mark Gardner,Montreal Expos,NATEX,2,3,3,6,1992,1996,4,-0.47,0.96,1.43,26,525,499,0,267,267,304.0,701.0,397.0,625000.0,705000.0,80000.0
gardm002,Mike Gardiner,Seattle Mariners,MARNRS,1,1,1,2,1991,1991,0,0.38,1.25,0.87,50,58,8,0,0,0,782.0,144.0,-638.0,0.0,0.0,0.0
gardm002,Mike Gardiner,Boston Red Sox,RSOX,1,2,1,3,1992,1993,1,-0.63,-0.29,0.34,48,73,25,5,239,234,114.0,0.0,-114.0,177000.0,2600000.0,2423000.0
gardr001,Ron Gardenhire,New York Mets,METS,1,1,1,2,1986,1987,1,0.0,0.0,0.0,0,0,0,0,0,0,0.0,0.0,0.0,0.0,0.0,0.0
gardr101,Rob Gardner,New York Mets,METS,1,2,1,3,1967,1967,0,0.17,0.17,0.0,56,30,-26,61,24,-37,95.0,212.0,117.0,0.0,0.0,0.0
gardr101,Rob Gardner,Chicago Cubs,CUBS,1,1,1,2,1968,1968,0,-0.19,-0.55,-0.36,10,18,8,0,1,1,8.0,40.0,32.0,0.0,0.0,0.0
gardr101,Rob Gardner,Cleveland Indians,INDINS,1,1,1,2,1969,1969,0,-0.16,0.0,0.16,46,0,-46,36,0,-36,322.0,0.0,-322.0,0.0,0.0,0.0
gardr101,Rob Gardner,New York Yankees,YANKS,1,2,1,3,1971,1973,2,0.33,1.03,0.7,63,344,281,8,1145,1137,181.0,0.0,-181.0,0.0,0.0,0.0
gardr101,Rob Gardner,New York Yankees,YANKS,1,2,1,3,1972,1973,1,-1.68,1.39,3.07,150,123,-27,306,538,232,22.0,0.0,-22.0,35500.0,100000.0,64500.0
gardr101,Rob Gardner,Oakland Athletics,ATLTCS,2,5,2,7,1971,1972,1,-0.2,0.7,0.9,128,78,-50,155,190,35,313.0,0.0,-313.0,33250.0,36000.0,2750.0
gardw001,Wes Gardner,New York Mets,METS,6,12,11,23,1985,1994,9,8.23,9.35,1.12,636,686,50,644,1209,565,3320.0,3063.0,-257.0,4116666.0,2989167.0,-1127499.0
gardw001,Wes Gardner,Boston Red Sox,RSOX,1,1,2,3,1990,1990,0,-0.74,0.0,0.74,28,0,-28,2,0,-2,61.0,0.0,-61.0,360000.0,0.0,-360000.0
garib101,Bob Garibaldi,San Francisco Giants,GIANTS,2,2,2,4,1970,1987,17,4.8,13.07,8.27,298,1198,900,1060,343,-717,0.0,2611.0,2611.0,0.0,0.0,0.0
garib101,Bob Garibaldi,Kansas City Royals,ROYALS,1,1,1,2,1971,1971,0,0.0,0.0,0.0,0,0,0,0,0,0,0.0,0.0,0.0,0.0,0.0,0.0
garkr001,Ryan Garko,Cleveland Indians,INDINS,1,1,1,2,2009,2014,5,-0.79,0.05,0.84,40,24,-16,127,0,-127,0.0,83.0,83.0,446100.0,0.0,-446100.0
garlj001,Jon Garland,Chicago Cubs,CUBS,1,1,1,2,1998,2000,2,18.56,0.2,-18.36,261,114,-147,25,2,-23,4286.0,182.0,-4104.0,0.0,300000.0,300000.0
garlj001,Jon Garland,Chicago White Sox,WSOX,1,1,1,2,2007,2008,1,0.8,2.56,1.76,33,161,128,3,730,727,590.0,0.0,-590.0,10000000.0,8500000.0,-1500000.0
garlj001,Jon Garland,Arizona Diamondbacks,DBACKS,1,1,1,2,2009,2011,2,0.31,-1.3,-1.61,29,81,52,29,201,172,271.0,0.0,-271.0,6250000.0,400000.0,-5850000.0
garlk001,Kyle Garlick,Los Angeles Dodgers,DOGRS,1,1,1,2,2020,2020,0,-0.39,0.0,0.39,12,0,-12,23,0,-23,0.0,0.0,0.0,0.0,0.0,0.0
garmm101,Mike Garman,Boston Red Sox,RSOX,1,3,3,6,1973,1978,5,14.84,4.69,-10.15,678,283,-395,435,79,-356,3953.0,2795.0,-1158.0,53000.0,42000.0,-11000.0
garmm101,Mike Garman,St. Louis Cardinals,CARDS,2,3,2,5,1975,1977,2,-2.23,0.7,2.93,320,204,-116,745,727,-18,229.0,0.0,-229.0,0.0,0.0,0.0
garmm101,Mike Garman,Chicago Cubs,CUBS,6,9,14,23,1977,1996,19,23.01,95.54,72.53,2449,4520,2071,6237,18161,11924,2336.0,1723.0,-613.0,0.0,0.0,0.0
garmm101,Mike Garman,Los Angeles Dodgers,DOGRS,1,1,2,3,1978,1978,0,-1.34,-0.05,1.29,94,2,-92,5,0,-5,184.0,6.0,-178.0,0.0,0.0,0.0
garnp001,Phil Garner,Oakland Athletics,ATLTCS,5,10,14,24,1977,1991,14,17.32,67.59,50.27,1802,3570,1768,5305,11715,6410,956.0,6372.0,5416.0,0.0,440000.0,440000.0
garnp001,Phil Garner,Pittsburgh Pirates,PIRATS,4,4,8,12,1981,1988,7,17.32,18.67,1.35,1180,996,-184,4623,3865,-758,16.0,149.0,133.0,807000.0,0.0,-807000.0
garnp001,Phil Garner,Houston Astros,ASTROS,1,1,1,2,1987,1987,0,-0.39,0.0,0.39,70,0,-70,151,0,-151,0.0,0.0,0.0,450000.0,0.0,-450000.0
garra101,Adrian Garrett,New York Mets,METS,1,2,1,3,1964,1966,2,-0.08,0.23,0.31,4,346,342,3,1225,1222,0.0,0.0,0.0,14000.0,0.0,-14000.0
garra101,Adrian Garrett,Chicago Cubs,CUBS,1,1,1,2,1971,1971,0,-0.2,1.0,1.2,28,17,-11,38,58,20,0.0,0.0,0.0,0.0,20000.0,20000.0
garrf101,Ford Garrison,Boston Red Sox,RSOX,2,2,2,4,1944,1950,6,1.57,5.48,3.91,261,623,362,911,2379,1468,0.0,0.0,0.0,5000.0,6000.0,1000.0
garrg101,Gil Garrido,San Francisco Giants,GIANTS,1,1,2,3,1966,1967,1,0.76,0.0,-0.76,320,0,-320,927,0,-927,0.0,0.0,0.0,0.0,0.0,0.0
garrg101,Gil Garrido,Atlanta Braves,BRAVES,2,2,2,4,1973,1980,7,0.0,-0.36,-0.36,3,145,142,3,282,279,0.0,0.0,0.0,0.0,0.0,0.0
garrg102,Greg Garrett,California Angels,ANGELS,1,1,1,2,1970,1972,2,0.38,-0.3,-0.68,4,26,22,3,5,2,26.0,91.0,65.0,0.0,57500.0,57500.0
garrr101,Ralph Garr,Atlanta Braves,BRAVES,6,12,8,20,1975,1987,12,13.66,24.44,10.78,1298,1964,666,3286,2845,-441,3707.0,4072.0,365.0,999667.0,0.0,-999667.0
garrs002,Steve Garrison,Milwaukee Brewers,BREWRS,1,3,1,4,2007,2007,0,2.56,0.04,-2.52,559,54,-505,1,1,0,595.0,76.0,-519.0,0.0,2150000.0,2150000.0
garrw101,Wayne Garrett,New York Mets,METS,3,4,4,8,1976,1978,2,2.45,0.15,-2.3,488,71,-417,1259,171,-1088,0.0,0.0,0.0,0.0,0.0,0.0
gartr001,Ryan Garton,Tampa Bay Devil Rays,RAYS,3,4,5,9,2017,2018,1,1.01,2.33,1.32,315,140,-175,740,560,-180,268.0,0.0,-268.0,0.0,0.0,0.0
garvn101,Ned Garvin,Chicago Cubs,CUBS,1,3,1,4,1901,1902,1,10.49,-0.18,-10.67,648,75,-573,2353,299,-2054,0.0,0.0,0.0,0.0,0.0,0.0
garvn101,Ned Garvin,Philadelphia Phillies,PHILS,1,2,1,3,1896,1896,0,0.0,0.46,0.46,0,14,14,0,61,61,0.0,0.0,0.0,0.0,0.0,0.0
garvn101,Ned Garvin,St.Louis Browns,ORLS,1,1,1,2,1902,1906,4,3.2,4.95,1.75,46,343,297,62,1204,1142,526.0,3.0,-523.0,0.0,0.0,0.0
garvn102,Ned Garver,St.Louis Browns,ORLS,8,14,16,30,1952,1960,8,32.49,23.42,-9.07,2082,1835,-247,5453,4904,-549,5614.0,2626.0,-2988.0,41000.0,25800.0,-15200.0
garvn102,Ned Garver,Detroit Tigers,TIGRS,4,10,9,19,1956,1961,5,13.15,0.77,-12.38,602,579,-23,394,1616,1222,3228.0,40.0,-3188.0,13200.0,0.0,-13200.0
garzm001,Matt Garza,Minnesota Twins,TWINS,3,6,7,13,2007,2015,8,34.0,-0.38,-34.38,1580,849,-731,6027,3046,-2981,1777.0,138.0,-1639.0,12330000.0,1726100.0,-10603900.0
garzm001,Matt Garza,Tampa Bay Devil Rays,RAYS,3,5,10,15,2011,2018,7,7.14,19.57,12.43,511,809,298,692,1746,1054,1779.0,3357.0,1578.0,0.0,556500.0,556500.0
garzm001,Matt Garza,Chicago Cubs,CUBS,2,2,5,7,2013,2019,6,-0.32,4.54,4.86,17,1157,1140,0,283,283,258.0,1456.0,1198.0,1500000.0,0.0,-1500000.0
gaspr101,Rod Gaspar,New York Mets,METS,2,2,2,4,1970,1971,1,-0.25,-0.75,-0.5,99,128,29,49,377,328,155.0,39.0,-116.0,0.0,0.0,0.0
gassc101,Charlie Gassaway,Philadelphia Athletics,ATLTCS,2,7,2,9,1945,1954,9,0.34,26.52,26.18,48,961,913,112,4308,4196,0.0,0.0,0.0,15000.0,0.0,-15000.0
gassd001,Dave Gassner,Toronto Blue Jays,BJAYS,1,2,1,3,2003,2011,8,4.68,-0.21,-4.89,335,62,-273,1523,225,-1298,23.0,0.0,-23.0,6200000.0,325000.0,-5875000.0
gasta101,Alex Gaston,StPaul,StPaul,1,2,2,4,1928,1929,1,0.83,0.0,-0.83,329,0,-329,1236,0,-1236,0.0,0.0,0.0,0.0,3000.0,3000.0
gasta101,Alex Gaston,Boston Red Sox,RSOX,1,4,2,6,1926,1926,0,0.0,0.0,0.0,0,0,0,0,0,0,0.0,0.0,0.0,15750.0,0.0,-15750.0
gasta101,Alex Gaston,Toledo,Toledo,1,1,2,3,1925,1927,2,-0.91,0.0,0.91,153,0,-153,464,0,-464,0.0,0.0,0.0,0.0,6000.0,6000.0
gasta101,Alex Gaston,New York Giants,GIANTS,1,2,1,3,1924,1924,0,0.0,0.0,0.0,0,0,0,0,0,0,0.0,0.0,0.0,0.0,0.0,0.0
gastc101,Cito Gaston,San Diego Padres,PADRS,2,2,3,5,1974,1977,3,-1.25,0.42,1.67,285,168,-117,524,10,-514,68.0,390.0,322.0,42000.0,0.0,-42000.0
gastm101,Milt Gaston,St.Louis Browns,ORLS,3,4,4,8,1927,1935,8,11.48,6.16,-5.32,387,744,357,418,523,105,3166.0,4550.0,1384.0,22500.0,15100.0,-7400.0
gastm101,Milt Gaston,Washington Senators,TWINS,1,5,1,6,1928,1941,13,14.54,41.49,26.95,801,1492,691,1696,6460,4764,3390.0,0.0,-3390.0,20500.0,6000.0,-14500.0
gastm101,Milt Gaston,Boston Red Sox,RSOX,5,11,8,19,1931,1940,9,26.55,40.35,13.8,1900,1273,-627,6427,3463,-2964,4146.0,5460.0,1314.0,52000.0,51000.0,-1000.0
gastm101,Milt Gaston,New York Yankees,YANKS,1,3,1,4,1924,1924,0,7.92,0.0,-7.92,312,0,-312,382,0,-382,2741.0,0.0,-2741.0,16500.0,15000.0,-1500.0
gatej101,Joe Gates,Kansas City Royals,ROYALS,1,1,1,2,1978,1978,0,0.07,0.0,-0.07,24,0,-24,48,0,-48,0.0,0.0,0.0,0.0,0.0,0.0
gathj001,Joey Gathright,Tampa Bay Devil Rays,RAYS,1,2,1,3,2006,2012,6,0.65,3.83,3.18,266,274,8,855,7,-848,0.0,991.0,991.0,337200.0,0.0,-337200.0
gathj001,Joey Gathright,Chicago Cubs,CUBS,1,1,1,2,2009,2009,0,0.0,-0.31,-0.31,0,14,14,0,32,32,0.0,0.0,0.0,800000.0,4000000.0,3200000.0
gatte001,Evan Gattis,Atlanta Braves,BRAVES,1,2,3,5,2015,2020,5,5.33,4.65,-0.68,563,307,-256,1880,420,-1460,215.0,2002.0,1787.0,0.0,0.0,0.0
gaubj001,John Gaub,Cleveland Indians,INDINS,2,4,3,7,2008,2013,5,-0.38,5.27,5.65,140,382,242,264,314,50,120.0,883.0,763.0,5500000.0,4750000.0,-750000.0
gaudc001,Chad Gaudin,Tampa Bay Devil Rays,RAYS,1,1,1,2,2004,2006,2,-0.87,0.04,0.91,5,13,8,0,33,33,39.0,0.0,-39.0,302500.0,302000.0,-500.0
gaudc001,Chad Gaudin,Toronto Blue Jays,BJAYS,1,1,1,2,2005,2005,0,2.39,0.0,-2.39,139,0,-139,5,0,-5,1030.0,0.0,-1030.0,0.0,0.0,0.0
gaudc001,Chad Gaudin,Oakland Athletics,ATLTCS,12,17,20,37,2008,2021,13,30.54,32.16,1.62,1528,2032,504,3830,6153,2323,1492.0,2561.0,1069.0,13440000.0,8216100.0,-5223900.0
gausk001,Kevin Gausman,Baltimore Orioles,ORLS,1,2,5,7,2018,2021,3,0.72,-0.48,-1.2,86,45,-41,50,0,-50,484.0,143.0,-341.0,5600000.0,0.0,-5600000.0
gavis001,Sam Gaviglio,St. Louis Cardinals,CARDS,1,1,1,2,2014,2015,1,0.24,0.0,-0.24,14,0,-14,5,0,-5,187.0,0.0,-187.0,0.0,0.0,0.0
gavis001,Sam Gaviglio,Kansas City Royals,ROYALS,1,1,1,2,2018,2018,0,1.36,0.0,-1.36,86,0,-86,3,0,-3,667.0,0.0,-667.0,0.0,0.0,0.0
gearb101,Bob Geary,Philadelphia Athletics,ATLTCS,1,3,1,4,1919,1921,2,0.0,-1.44,-1.44,0,50,50,0,86,86,0.0,133.0,133.0,0.0,0.0,0.0
gearc001,Cory Gearrin,San Francisco Giants,GIANTS,1,3,1,4,2018,2018,0,0.75,0.0,-0.75,24,0,-24,0,0,0,64.0,0.0,-64.0,1675000.0,0.0,-1675000.0
gearc001,Cory Gearrin,Texas Rangers,RNGRS,1,1,2,3,2018,2018,0,-0.06,0.0,0.06,6,0,-6,0,0,0,18.0,0.0,-18.0,0.0,0.0,0.0
gearg001,Geoff Geary,Philadelphia Phillies,PHILS,1,3,2,5,2007,2011,4,12.75,0.63,-12.12,681,613,-68,2271,356,-1915,252.0,579.0,327.0,1217500.0,5350000.0,4132500.0
gearg101,Gary Gearhart,New York Giants,GIANTS,1,3,1,4,1948,1955,7,0.0,5.49,5.49,0,517,517,0,1993,1993,0.0,0.0,0.0,0.0,0.0,0.0
gedej101,Joe Gedeon,New York Yankees,YANKS,5,14,12,26,1918,1931,13,64.97,61.9,-3.07,2396,2093,-303,7435,5797,-1638,6303.0,6917.0,614.0,44500.0,41500.0,-3000.0
geigg101,Gary Geiger,Cleveland Indians,INDINS,3,4,5,9,1958,1965,7,9.07,15.07,6.0,1121,727,-394,4065,1984,-2081,0.0,1913.0,1913.0,0.0,0.0,0.0
geisd001,Dave Geisel,Chicago Cubs,CUBS,2,4,2,6,1982,1982,0,0.45,0.93,0.48,103,128,25,0,477,477,404.0,0.0,-404.0,0.0,0.0,0.0
geisv101,Vern Geishert,California Angels,ANGELS,3,6,7,13,1969,1974,5,8.36,4.59,-3.77,1680,510,-1170,1673,1948,275,4531.0,88.0,-4443.0,15000.0,105000.0,90000.0
geisv101,Vern Geishert,Cincinnati Reds,REDS,4,5,7,12,1971,1988,17,3.96,42.07,38.11,701,1797,1096,2673,5857,3184,86.0,981.0,895.0,0.0,0.0,0.0
gelnj101,John Gelnar,Kansas City Royals,ROYALS,2,4,2,6,1969,1977,8,11.49,4.04,-7.45,1298,779,-519,3743,2778,-965,624.0,554.0,-70.0,65000.0,48000.0,-17000.0
gelnj101,John Gelnar,Milwaukee Brewers,BREWRS,1,2,1,3,1971,1971,0,0.0,-0.75,-0.75,0,42,42,0,3,3,0.0,97.0,97.0,17500.0,26500.0,9000.0
gelts001,Steve Geltz,Anaheim Angels,ANGELS,1,1,1,2,2013,2014,1,0.17,1.24,1.07,113,84,-29,0,0,0,307.0,224.0,-83.0,0.0,0.0,0.0
genej101,Joe Genewich,Boston Braves,BRAVES,1,1,4,5,1928,1937,9,0.54,12.56,12.02,137,725,588,122,671,549,913.0,4679.0,3766.0,7000.0,21900.0,14900.0
genns001,Scooter Gennett,Cincinnati Reds,REDS,1,2,1,3,2019,2019,0,-0.06,0.0,0.06,21,0,-21,67,0,-67,0.0,0.0,0.0,9775000.0,0.0,-9775000.0
gentc001,Craig Gentry,Texas Rangers,RNGRS,2,4,3,7,2013,2015,2,1.42,-3.21,-4.63,125,105,-20,314,281,-33,19.0,129.0,110.0,1001100.0,3000000.0,1998900.0
gentg101,Gary Gentry,New York Mets,METS,2,3,3,6,1972,1976,4,-0.45,1.09,1.54,209,111,-98,45,100,55,600.0,846.0,246.0,0.0,0.0,0.0
gentj101,Jim Gentile,Los Angeles Dodgers,DOGRS,3,4,7,11,1959,1962,3,14.42,0.0,-14.42,618,0,-618,2360,0,-2360,0.0,0.0,0.0,0.0,0.0,0.0
gentj101,Jim Gentile,Baltimore Orioles,ORLS,8,20,19,39,1963,1988,25,27.92,106.79,78.87,1879,4526,2647,2628,11260,8632,8511.0,12795.0,4284.0,787833.0,104900.0,-682933.0
gentj101,Jim Gentile,Kansas City Athletics,ATLTCS,1,1,2,3,1965,1965,0,0.98,-0.25,-1.23,130,26,-104,439,0,-439,0.0,46.0,46.0,0.0,0.0,0.0
gentj101,Jim Gentile,Houston Astros,ASTROS,2,2,2,4,1966,1969,3,-0.53,0.09,0.62,33,8,-25,52,4,-48,0.0,55.0,55.0,0.0,0.0,0.0
georg101,Greek George,Cleveland Indians,INDINS,1,1,2,3,1938,1938,0,-0.15,0.0,0.15,7,0,-7,20,0,-20,0.0,0.0,0.0,0.0,0.0,0.0
georg101,Greek George,Brooklyn Dodgers,DOGRS,1,1,2,3,1940,1940,0,-0.62,0.0,0.62,35,0,-35,67,0,-67,0.0,0.0,0.0,0.0,0.0,0.0
georl101,Lefty George,St.Louis Browns,ORLS,1,1,1,2,1912,1914,2,-0.67,1.15,1.82,22,205,183,14,743,729,133.0,0.0,-133.0,0.0,0.0,0.0
gerab101,Ben Geraghty,Brooklyn Dodgers,DOGRS,1,2,1,3,1937,1941,4,0.0,0.0,0.0,0,0,0,0,0,0,0.0,0.0,0.0,0.0,0.0,0.0
gerab101,Ben Geraghty,Boston Braves,BRAVES,1,2,1,3,1945,1945,0,0.0,2.8,2.8,0,68,68,0,69,69,0.0,561.0,561.0,0.0,0.0,0.0
gerad101,Dave Gerard,Chicago Cubs,CUBS,6,9,11,20,1963,1968,5,-0.05,-1.18,-1.13,253,592,339,665,1006,341,220.0,727.0,507.0,0.0,33000.0,33000.0
gerad101,Dave Gerard,Houston Astros,ASTROS,1,1,1,2,1964,1965,1,0.0,0.0,0.0,0,0,0,0,0,0,0.0,0.0,0.0,0.0,0.0,0.0
gerbw101,Wally Gerber,St.Louis Browns,ORLS,1,1,1,2,1928,1928,0,-0.55,0.17,0.72,165,52,-113,447,23,-424,0.0,216.0,216.0,8000.0,3600.0,-4400.0
gereb001,Bob Geren,San Diego Padres,PADRS,11,20,24,44,1980,1993,13,78.65,50.21,-28.44,3246,4423,1177,10088,11380,1292,4862.0,3507.0,-1355.0,3006667.0,3395633.0,388966.0
gerha101,Al Gerheauser,Philadelphia Phillies,PHILS,3,3,3,6,1945,1948,3,2.39,4.16,1.77,202,481,279,250,1788,1538,666.0,0.0,-666.0,0.0,0.0,0.0
gerha101,Al Gerheauser,Pittsburgh Pirates,PIRATS,1,1,1,2,1946,1946,0,0.0,0.0,0.0,0,0,0,0,0,0,0.0,0.0,0.0,0.0,0.0,0.0
gerhk001,Ken Gerhart,Baltimore Orioles,ORLS,1,1,1,2,1989,1989,0,0.0,-0.06,-0.06,0,9,9,0,13,13,0.0,0.0,0.0,0.0,0.0,0.0
gerks101,Steve Gerkin,Philadelphia Athletics,ATLTCS,1,2,1,3,1945,1945,0,0.0,0.0,0.0,0,0,0,0,0,0,0.0,0.0,0.0,17200.0,0.0,-17200.0
gerlj101,Johnny Gerlach,Chicago White Sox,WSOX,2,3,2,5,1940,1946,6,-0.96,-2.59,-1.63,232,359,127,719,1342,623,0.0,0.0,0.0,6000.0,3600.0,-2400.0
germd001,Domingo German,Miami Marlins,MARLNS,2,4,7,11,2014,2019,5,6.27,8.73,2.46,210,736,526,177,1879,1702,1889.0,737.0,-1152.0,7867000.0,11541425.0,3674425.0
germe001,Esteban German,Texas Rangers,RNGRS,2,2,3,5,2005,2006,1,2.6,-0.01,-2.61,367,4,-363,981,0,-981,106.0,25.0,-81.0,327000.0,0.0,-327000.0
germf001,Franklyn German,Oakland Athletics,ATLTCS,6,8,9,17,2002,2009,7,16.13,13.6,-2.53,956,906,-50,1909,3247,1338,5469.0,605.0,-4864.0,947000.0,0.0,-947000.0
germj001,Justin Germano,San Diego Padres,PADRS,1,2,1,3,2005,2005,0,-0.01,0.54,0.55,4,58,54,3,241,238,20.0,0.0,-20.0,0.0,2150000.0,2150000.0
germj001,Justin Germano,Cincinnati Reds,REDS,1,1,1,2,2006,2007,1,0.0,0.06,0.06,0,54,54,0,0,0,0.0,51.0,51.0,0.0,2500000.0,2500000.0
germj001,Justin Germano,Texas Rangers,RNGRS,1,1,1,2,2014,2014,0,0.0,0.0,0.0,0,0,0,0,0,0,0.0,0.0,0.0,0.0,0.0,0.0
gernd101,Dick Gernert,Boston Red Sox,RSOX,4,8,6,14,1959,1966,7,-0.67,0.47,1.14,177,638,461,406,1416,1010,0.0,681.0,681.0,18500.0,0.0,-18500.0
gernd101,Dick Gernert,Detroit Tigers,TIGRS,1,1,1,2,1961,1961,0,0.25,0.0,-0.25,40,0,-40,72,0,-72,0.0,0.0,0.0,0.0,0.0,0.0
geroc101,Cesar Geronimo,Houston Astros,ASTROS,8,15,14,29,1971,1989,18,76.39,55.08,-21.31,4763,4769,6,15346,14810,-536,3810.0,5622.0,1812.0,705000.0,416000.0,-289000.0
geroc101,Cesar Geronimo,Cincinnati Reds,REDS,1,1,1,2,1981,1982,1,0.76,0.03,-0.73,150,55,-95,355,60,-295,0.0,0.0,0.0,0.0,0.0,0.0
geruj001,Jody Gerut,Colorado Rockies,ROCKS,1,2,1,3,2001,2001,0,4.57,-0.85,-5.42,461,44,-417,1773,90,-1683,0.0,0.0,0.0,0.0,230000.0,230000.0
geruj001,Jody Gerut,Cleveland Indians,INDINS,1,1,1,2,2005,2006,1,-0.05,-0.12,-0.07,11,14,3,16,50,34,0.0,0.0,0.0,356200.0,320000.0,-36200.0
geruj001,Jody Gerut,Chicago Cubs,CUBS,2,3,2,5,2005,2012,7,-0.53,-0.21,0.32,25,138,113,75,85,10,0.0,192.0,192.0,0.0,7750000.0,7750000.0
geruj001,Jody Gerut,San Diego Padres,PADRS,1,1,1,2,2009,2010,1,0.07,5.13,5.06,117,236,119,251,790,539,0.0,0.0,0.0,1775000.0,0.0,-1775000.0
gessd101,Doc Gessler,Brooklyn Dodgers,DOGRS,1,1,1,2,1906,1906,0,0.09,-0.02,-0.11,34,4,-30,95,2,-93,0.0,20.0,20.0,0.0,0.0,0.0
gessd101,Doc Gessler,Chicago Cubs,CUBS,1,3,1,4,1907,1907,0,0.0,-0.01,-0.01,0,44,44,0,51,51,0.0,415.0,415.0,0.0,0.0,0.0
gessd101,Doc Gessler,Boston Red Sox,RSOX,1,1,1,2,1909,1911,2,5.78,2.19,-3.59,290,56,-234,1206,66,-1140,0.0,550.0,550.0,0.0,0.0,0.0
getta101,Al Gettel,New York Yankees,YANKS,1,3,1,4,1943,1947,4,0.0,11.41,11.41,0,568,568,0,2373,2373,0.0,0.0,0.0,0.0,0.0,0.0
getta101,Al Gettel,New York Yankees,YANKS,3,10,5,15,1946,1954,8,30.84,1.34,-29.5,1405,374,-1031,2470,260,-2210,6379.0,1746.0,-4633.0,11500.0,10000.0,-1500.0
getta101,Al Gettel,Cleveland Indians,INDINS,2,3,2,5,1948,1955,7,0.72,3.02,2.3,315,566,251,926,1749,823,633.0,0.0,-633.0,0.0,0.0,0.0
getta101,Al Gettel,Oakland,Oakland,1,3,5,8,1950,1951,1,-0.44,0.0,0.44,186,0,-186,308,0,-308,172.0,0.0,-172.0,0.0,0.0,0.0
getzc001,Chris Getz,Chicago White Sox,WSOX,5,8,8,16,2009,2016,7,-0.62,-1.54,-0.92,448,360,-88,1240,736,-504,233.0,625.0,392.0,14311000.0,7075000.0,-7236000.0
getzg101,Gus Getz,Pittsburgh Pirates,PIRATS,1,1,1,2,1918,1918,0,0.0,-0.09,-0.09,0,26,26,0,105,105,0.0,0.0,0.0,0.0,0.0,0.0
giamj002,Jeremy Giambi,Kansas City Royals,ROYALS,1,1,1,2,2000,2000,0,1.75,-0.19,-1.94,270,6,-264,932,0,-932,0.0,50.0,50.0,0.0,0.0,0.0
giamj002,Jeremy Giambi,Oakland Athletics,ATLTCS,1,1,1,2,2002,2002,0,1.85,1.84,-0.01,82,89,7,211,211,0,0.0,0.0,0.0,1065000.0,500000.0,-565000.0
giamj002,Jeremy Giambi,Philadelphia Phillies,PHILS,2,3,3,6,2002,2004,2,0.19,-0.25,-0.44,115,65,-50,243,3,-240,206.0,112.0,-94.0,0.0,500000.0,500000.0
gianj101,Joe Giannini,Boston Red Sox,RSOX,10,29,25,54,1911,1935,24,51.77,27.79,-23.98,3792,3076,-716,15081,11324,-3757,0.0,1203.0,1203.0,45050.0,29350.0,-15700.0
giarj101,Joe Giard,St.Louis Browns,ORLS,4,6,5,11,1927,1935,8,9.57,7.29,-2.28,658,806,148,956,588,-368,3247.0,5119.0,1872.0,22500.0,15100.0,-7400.0
giarj101,Joe Giard,Toledo,Toledo,1,1,4,5,1924,1928,4,-0.8,0.0,0.8,104,0,-104,93,0,-93,752.0,0.0,-752.0,0.0,8100.0,8100.0
giavj001,Johnny Giavotella,Kansas City Royals,ROYALS,1,1,1,2,2014,2015,1,1.39,0.0,-1.39,228,0,-228,869,0,-869,0.0,0.0,0.0,508575.0,0.0,-508575.0
gibai001,Ian Gibaut,Tampa Bay Devil Rays,RAYS,1,1,1,2,2019,2019,0,-0.05,0.0,0.05,23,0,-23,0,0,0,74.0,0.0,-74.0,0.0,0.0,0.0
gibbj001,John Gibbons,New York Mets,METS,1,1,1,2,1988,1990,2,0.0,0.03,0.03,0,4,4,0,7,7,0.0,0.0,0.0,0.0,0.0,0.0
gibbj102,Joe Gibbon,Pittsburgh Pirates,PIRATS,5,8,9,17,1965,1978,13,5.88,26.82,20.94,656,1597,941,1421,5058,3637,1342.0,1651.0,309.0,94500.0,49000.0,-45500.0
gibbj102,Joe Gibbon,San Francisco Giants,GIANTS,1,1,1,2,1969,1969,0,0.85,-0.01,-0.86,152,14,-138,10,0,-10,277.0,33.0,-244.0,0.0,0.0,0.0
gibsk001,Kirk Gibson,Kansas City Royals,ROYALS,1,1,1,2,1992,1992,0,0.19,0.15,-0.04,16,31,15,60,0,-60,0.0,123.0,123.0,0.0,0.0,0.0
gibsk002,Kyle Gibson,Texas Rangers,RNGRS,1,4,3,7,2021,2021,0,0.8,-1.21,-2.01,74,9,-65,29,0,-29,300.0,64.0,-236.0,9766666.0,0.0,-9766666.0
gibsp001,Paul Gibson,Detroit Tigers,TIGRS,1,2,2,4,1992,1992,0,-0.71,-1.21,-0.5,102,101,-1,8,364,356,212.0,0.0,-212.0,0.0,0.0,0.0
gibss101,Sam Gibson,New York Giants,GIANTS,1,2,1,3,1932,1934,2,0.0,-0.01,-0.01,0,16,16,0,12,12,0.0,110.0,110.0,0.0,0.0,0.0
gibss101,Sam Gibson,Chicago Cubs,CUBS,2,8,3,11,1933,1946,13,22.35,18.34,-4.01,627,903,276,2568,3781,1213,0.0,0.0,0.0,0.0,0.0,0.0
gibss101,Sam Gibson,Detroit Tigers,TIGRS,2,5,3,8,1928,1933,5,12.96,10.92,-2.04,710,561,-149,2975,2358,-617,0.0,0.0,0.0,21000.0,7000.0,-14000.0
gideb001,Brett Gideon,Pittsburgh Pirates,PIRATS,2,2,2,4,1989,1992,3,0.27,2.24,1.97,41,250,209,0,169,169,140.0,1086.0,946.0,0.0,0.0,0.0
gidej101,Jim Gideon,Texas Rangers,RNGRS,5,14,9,23,1976,1988,12,43.04,39.52,-3.52,2266,2145,-121,8188,7408,-780,2609.0,4285.0,1676.0,330000.0,165000.0,-165000.0
gielp101,Paul Giel,Minnesota Twins,TWINS,1,3,1,4,1961,1963,2,-0.34,-0.87,-0.53,41,239,198,137,577,440,5.0,0.0,-5.0,0.0,0.0,0.0
giesd001,Dan Giese,Boston Red Sox,RSOX,1,2,2,4,2002,2005,3,0.0,1.41,1.41,0,227,227,0,0,0,0.0,535.0,535.0,0.0,500000.0,500000.0
giggb101,Bob Giggie,Milwaukee Braves,BRAVES,2,2,2,4,1960,1962,2,-0.67,-0.66,0.01,72,44,-28,28,11,-17,299.0,164.0,-135.0,0.0,0.0,0.0
gigon101,Norm Gigon,Philadelphia Phillies,PHILS,1,1,1,2,1966,1968,2,-0.27,-0.17,0.1,34,34,0,77,66,-11,0.0,0.0,0.0,0.0,0.0,0.0
gil-b001,Benji Gil,Texas Rangers,RNGRS,1,1,2,3,1997,1999,2,0.0,0.48,0.48,0,32,32,0,0,0,0.0,174.0,174.0,200000.0,157500.0,-42500.0
gil-g001,Geronimo Gil,Los Angeles Dodgers,DOGRS,1,2,1,3,2001,2002,1,1.42,-0.47,-1.89,279,38,-241,871,0,-871,30.0,70.0,40.0,0.0,2333333.0,2333333.0
gil-g101,Gus Gil,Cleveland Indians,INDINS,1,1,2,3,1968,1968,0,-0.7,0.0,0.7,170,0,-170,431,0,-431,0.0,0.0,0.0,0.0,0.0,0.0
gil-j001,Jerry Gil,Arizona Diamondbacks,DBACKS,1,1,1,2,2006,2006,0,0.0,0.0,0.0,1,0,-1,0,0,0,0.0,0.0,0.0,0.0,0.0,0.0
gil-l001,Luis Gil,Minnesota Twins,TWINS,1,1,1,2,2018,2018,0,0.75,1.65,0.9,6,91,85,0,309,309,88.0,0.0,-88.0,0.0,0.0,0.0
gilbb101,Bill Gilbreth,California Angels,ANGELS,1,1,1,2,1974,1974,0,0.0,0.0,0.0,0,0,0,0,0,0,0.0,0.0,0.0,0.0,0.0,0.0
gilbc101,Charlie Gilbert,Brooklyn Dodgers,DOGRS,2,4,2,6,1941,1946,5,1.09,12.92,11.83,261,488,227,749,2125,1376,0.0,0.0,0.0,20000.0,0.0,-20000.0
gilbm001,Mark Gilbert,Chicago Cubs,CUBS,2,2,2,4,1979,1983,4,0.0,2.97,2.97,0,245,245,0,65,65,0.0,842.0,842.0,0.0,0.0,0.0
gilbs001,Shawn Gilbert,New York Mets,METS,1,1,1,2,1998,1998,0,0.03,-0.39,-0.42,4,26,22,2,33,31,0.0,0.0,0.0,0.0,0.0,0.0
gilbt001,Tyler Gilbert,Philadelphia Phillies,PHILS,1,1,1,2,2020,2021,1,0.0,-0.39,-0.39,0,12,12,0,23,23,0.0,0.0,0.0,0.0,0.0,0.0
gilbw101,Wally Gilbert,Brooklyn Dodgers,DOGRS,7,17,12,29,1932,1948,16,60.59,33.44,-27.15,3224,2810,-414,11104,10257,-847,2159.0,791.0,-1368.0,10000.0,10000.0,0.0
gileb002,Brian Giles,Cleveland Indians,INDINS,2,2,2,4,1998,2002,4,28.83,2.94,-25.89,948,217,-731,3114,1,-3113,471.0,463.0,-8.0,1800000.0,245000.0,-1555000.0
gileb002,Brian Giles,Pittsburgh Pirates,PIRATS,6,8,15,23,2003,2016,13,29.08,28.07,-1.01,1674,2962,1288,4994,8086,3092,2134.0,4751.0,2617.0,29494833.0,1123425.0,-28371408.0
gilek001,Ken Giles,Philadelphia Phillies,PHILS,2,3,6,9,2015,2021,6,1.74,5.44,3.7,212,305,93,3,183,180,772.0,1899.0,1127.0,519000.0,515800.0,-3200.0
gilek001,Ken Giles,Houston Astros,ASTROS,1,3,1,4,2018,2020,2,2.45,2.96,0.51,92,98,6,0,0,0,254.0,276.0,22.0,4600000.0,5300000.0,700000.0
gilhf101,Frank Gilhooley,New York Yankees,YANKS,5,19,8,27,1918,1928,10,9.22,7.55,-1.67,1051,1233,182,2808,4705,1897,3476.0,418.0,-3058.0,39950.0,18400.0,-21550.0
gilkb001,Bernard Gilkey,St. Louis Cardinals,CARDS,2,4,4,8,1996,1997,1,9.87,1.27,-8.6,636,73,-563,1576,226,-1350,1161.0,50.0,-1111.0,395000.0,7150000.0,6755000.0
gilkb001,Bernard Gilkey,New York Mets,METS,4,6,6,12,1998,1999,1,13.09,0.3,-12.79,1229,42,-1187,4418,40,-4378,991.0,86.0,-905.0,5050000.0,4845000.0,-205000.0
gillc001,Conor Gillaspie,San Francisco Giants,GIANTS,1,1,1,2,2013,2013,0,2.35,0.0,-2.35,322,0,-322,1143,0,-1143,0.0,0.0,0.0,0.0,0.0,0.0
gillc002,Cole Gillespie,Milwaukee Brewers,BREWRS,1,2,1,3,2009,2009,0,-0.62,2.01,2.63,50,66,16,120,297,177,0.0,0.0,0.0,0.0,3500000.0,3500000.0
gillc102,Carden Gillenwater,Washington Senators,TWINS,2,2,3,5,1948,1950,2,2.98,1.13,-1.85,263,176,-87,929,658,-271,0.0,0.0,0.0,0.0,0.0,0.0
gillg102,Grant Gillis,Washington Senators,TWINS,1,5,1,6,1928,1941,13,14.54,41.49,26.95,801,1492,691,1696,6460,4764,3390.0,0.0,-3390.0,20500.0,6000.0,-14500.0
gillg103,George Gill,Detroit Tigers,TIGRS,3,9,7,16,1939,1948,9,19.29,21.11,1.82,2183,1686,-497,6579,6030,-549,3951.0,2317.0,-1634.0,44300.0,54500.0,10200.0
gillj105,Johnny Gill,Chicago Cubs,CUBS,2,7,2,9,1936,1947,11,6.07,33.87,27.8,546,772,226,1567,1415,-152,1708.0,5741.0,4033.0,9500.0,8000.0,-1500.0
gilms001,Sean Gilmartin,Atlanta Braves,BRAVES,1,1,1,2,2013,2014,1,0.0,-0.66,-0.66,0,100,100,0,166,166,0.0,0.0,0.0,0.0,3500000.0,3500000.0
gilsh101,Hal Gilson,Chicago Cubs,CUBS,2,3,2,5,1965,1966,1,2.3,1.05,-1.25,454,82,-372,65,4,-61,1253.0,197.0,-1056.0,0.0,0.0,0.0
gilsh101,Hal Gilson,St. Louis Cardinals,CARDS,4,10,7,17,1968,1972,4,10.58,2.29,-8.29,1246,276,-970,1450,608,-842,1865.0,299.0,-1566.0,32500.0,24000.0,-8500.0
gimea001,Andres Gimenez,New York Mets,METS,1,4,2,6,2021,2021,0,2.78,2.19,-0.59,209,149,-60,798,543,-255,0.0,161.0,161.0,0.0,0.0,0.0
gimec001,Chris Gimenez,Texas Rangers,RNGRS,1,1,1,2,2014,2014,0,-0.86,0.0,0.86,77,0,-77,165,0,-165,9.0,0.0,-9.0,510000.0,0.0,-510000.0
gimec001,Chris Gimenez,Chicago Cubs,CUBS,1,2,1,3,2018,2018,0,-0.01,0.0,0.01,14,0,-14,34,0,-34,3.0,0.0,-3.0,0.0,0.0,0.0
ginsj101,Joe Ginsberg,Detroit Tigers,TIGRS,3,7,7,14,1953,1959,6,19.59,21.85,2.26,1560,1406,-154,4177,3381,-796,3244.0,3436.0,192.0,42000.0,15900.0,-26100.0
ginsj101,Joe Ginsberg,Kansas City Athletics,ATLTCS,6,8,9,17,1956,1963,7,11.56,-1.9,-13.46,1347,971,-376,1827,2604,777,2603.0,1481.0,-1122.0,28000.0,12500.0,-15500.0
gintk001,Keith Ginter,Houston Astros,ASTROS,1,2,2,4,2002,2002,0,3.17,0.71,-2.46,341,21,-320,1022,77,-945,656.0,0.0,-656.0,0.0,5000000.0,5000000.0
gintk001,Keith Ginter,Milwaukee Brewers,BREWRS,2,3,6,9,2004,2008,4,12.1,2.05,-10.05,906,440,-466,3591,512,-3079,0.0,421.0,421.0,8883333.0,7270260.0,-1613073.0
gintm001,Matt Ginter,Chicago White Sox,WSOX,1,1,1,2,2004,2005,1,0.76,-1.32,-2.08,28,179,151,19,517,498,208.0,0.0,-208.0,0.0,0.0,0.0
gintm001,Matt Ginter,New York Mets,METS,1,1,1,2,2005,2005,0,-0.39,0.0,0.39,14,0,-14,0,0,0,105.0,0.0,-105.0,0.0,0.0,0.0
gioll001,Lucas Giolito,Washington Nationals,NATEX,1,3,1,4,2016,2020,4,16.01,2.64,-13.37,233,310,77,19,1309,1290,3554.0,0.0,-3554.0,0.0,2750000.0,2750000.0
giona101,Al Gionfriddo,Pittsburgh Pirates,PIRATS,26,51,64,115,1947,1973,26,53.52,64.51,10.99,4885,5814,929,13312,15757,2445,8388.0,7117.0,-1271.0,216500.0,126000.0,-90500.0
giraj001,Joe Girardi,Colorado Rockies,ROCKS,4,6,6,12,1995,2002,7,5.12,3.09,-2.03,903,626,-277,1475,18,-1457,907.0,1070.0,163.0,1850000.0,0.0,-1850000.0
giult101,Tony Giuliani,Brooklyn Dodgers,DOGRS,4,8,8,16,1941,1958,17,4.28,10.97,6.69,1667,1086,-581,5534,2416,-3118,435.0,3148.0,2713.0,50000.0,61500.0,11500.0
giult101,Tony Giuliani,Washington Senators,TWINS,1,2,1,3,1944,1947,3,0.0,4.02,4.02,0,227,227,0,837,837,0.0,0.0,0.0,0.0,0.0,0.0
giusd101,Dave Giusti,Houston Astros,ASTROS,2,5,3,8,1968,1968,0,1.27,0.0,-1.27,405,0,-405,1102,0,-1102,299.0,0.0,-299.0,0.0,0.0,0.0
giusd101,Dave Giusti,San Diego Padres,PADRS,5,6,10,16,1968,1972,4,-0.42,6.04,6.46,285,800,515,635,2318,1683,399.0,445.0,46.0,0.0,0.0,0.0
giusd101,Dave Giusti,St. Louis Cardinals,CARDS,2,4,5,9,1969,1972,3,8.31,1.34,-6.97,834,199,-635,108,492,384,1854.0,0.0,-1854.0,17500.0,24000.0,6500.0
giusd101,Dave Giusti,Pittsburgh Pirates,PIRATS,5,10,11,21,1977,1988,11,53.71,31.99,-21.72,2929,1675,-1254,9660,6568,-3092,5429.0,149.0,-5280.0,807000.0,0.0,-807000.0
giveb001,Brian Givens,New York Mets,METS,1,1,1,2,1990,1990,0,0.0,-0.07,-0.07,0,16,16,0,23,23,0.0,0.0,0.0,0.0,0.0,0.0
givem001,Mychal Givens,Baltimore Orioles,ORLS,1,1,3,4,2020,2020,0,0.91,0.0,-0.91,72,0,-72,0,0,0,117.0,0.0,-117.0,3225000.0,0.0,-3225000.0
givem001,Mychal Givens,Colorado Rockies,ROCKS,1,1,2,3,2021,2021,0,0.31,0.0,-0.31,46,0,-46,0,0,0,64.0,0.0,-64.0,4050000.0,0.0,-4050000.0
gladd001,Dan Gladden,San Francisco Giants,GIANTS,1,2,3,5,1987,1994,7,5.69,0.91,-4.78,646,306,-340,2698,81,-2617,6.0,1068.0,1062.0,0.0,0.0,0.0
gladf101,Fred Glade,St.Louis Browns,ORLS,1,3,3,6,1907,1907,0,6.22,0.0,-6.22,491,0,-491,1891,0,-1891,92.0,0.0,-92.0,0.0,0.0,0.0
gladf102,Fred Gladding,Detroit Tigers,TIGRS,1,2,1,3,1967,1968,1,1.07,1.09,0.02,466,67,-399,26,185,159,791.0,0.0,-791.0,18000.0,57500.0,39500.0
gland001,Doug Glanville,Chicago Cubs,CUBS,1,1,1,2,1997,1999,2,8.7,2.76,-5.94,840,298,-542,3425,1190,-2235,0.0,0.0,0.0,155000.0,1850000.0,1695000.0
gland001,Doug Glanville,Texas Rangers,RNGRS,1,1,2,3,2003,2003,0,-0.37,0.0,0.37,28,0,-28,55,0,-55,0.0,0.0,0.0,1000000.0,0.0,-1000000.0
glasj101,Jack Glasscock,St. Louis Cardinals,CARDS,2,2,3,5,1893,1895,2,2.73,-0.72,-3.45,266,276,10,1209,1267,58,0.0,0.0,0.0,0.0,0.0,0.0
glast001,Tyler Glasnow,Pittsburgh Pirates,PIRATS,1,3,1,4,2018,2020,2,12.58,1.43,-11.15,379,64,-315,1364,58,-1306,825.0,516.0,-309.0,556500.0,0.0,-556500.0
glast101,Tom Glass,Philadelphia Athletics,ATLTCS,1,4,1,5,1925,1925,0,0.0,0.15,0.15,0,133,133,0,522,522,0.0,0.0,0.0,4850.0,0.0,-4850.0
glaut001,Troy Glaus,Arizona Diamondbacks,DBACKS,1,2,2,4,2005,2008,3,6.92,12.54,5.62,335,469,134,1091,1778,687,155.0,619.0,464.0,9000000.0,5115000.0,-3885000.0
glaut001,Troy Glaus,Toronto Blue Jays,BJAYS,4,8,10,18,2008,2014,6,11.09,15.81,4.72,891,818,-73,2056,3028,972,842.0,175.0,-667.0,19454600.0,19118000.0,-336600.0
glazw101,Whitey Glazner,Pittsburgh Pirates,PIRATS,1,3,2,5,1923,1926,3,3.4,4.98,1.58,247,281,34,625,924,299,954.0,681.0,-273.0,4200.0,5500.0,1300.0
gleab101,Billy Gleason,Pittsburgh Pirates,PIRATS,1,2,1,3,1917,1917,0,0.0,-0.95,-0.95,0,109,109,0,437,437,0.0,0.0,0.0,1200.0,0.0,-1200.0
gleab101,Billy Gleason,St.Louis Browns,ORLS,1,6,1,7,1921,1921,0,0.0,0.0,0.0,0,0,0,0,0,0,0.0,0.0,0.0,6600.0,0.0,-6600.0
gleab102,Bill Gleason,St.Louis Cardinals,CARDS,1,2,4,6,1887,1897,10,9.58,4.43,-5.15,488,169,-319,2210,668,-1542,3.0,0.0,-3.0,0.0,0.0,0.0
gleaj001,Jerry Gleaton,Texas Rangers,RNGRS,4,10,10,20,1980,1987,7,9.35,8.94,-0.41,686,425,-261,1581,631,-950,2721.0,2684.0,-37.0,817500.0,331000.0,-486500.0
gleaj001,Jerry Gleaton,Seattle Mariners,MARNRS,1,2,1,3,1984,1985,1,2.78,0.75,-2.03,163,36,-127,1,0,-1,1149.0,444.0,-705.0,0.0,200000.0,200000.0
gleaj001,Jerry Gleaton,Kansas City Royals,ROYALS,1,1,1,2,1990,1990,0,2.28,0.0,-2.28,104,0,-104,0,0,0,474.0,0.0,-474.0,0.0,0.0,0.0
gleak101,Kid Gleason,Baltimore Orioles,BLN,3,6,5,11,1895,1899,4,5.76,25.14,19.38,944,678,-266,3948,2726,-1222,148.0,1122.0,974.0,0.0,0.0,0.0
gleak101,Kid Gleason,Detroit Tigers,TIGRS,1,1,1,2,1903,1903,0,0.0,-0.14,-0.14,0,93,93,0,376,376,0.0,0.0,0.0,0.0,0.0,0.0
gleej101,Jim Gleeson,Chicago Cubs,CUBS,1,2,1,3,1940,1940,0,0.59,0.0,-0.59,137,0,-137,458,0,-458,0.0,0.0,0.0,0.0,9500.0,9500.0
gleej101,Jim Gleeson,Cincinnati Reds,REDS,1,1,1,2,1942,1942,0,0.0,0.11,0.11,0,131,131,0,576,576,0.0,0.0,0.0,0.0,0.0,0.0
gleej101,Jim Gleeson,St. Louis Cardinals,CARDS,4,11,7,18,1946,1954,8,10.75,4.84,-5.91,1144,525,-619,2713,1686,-1027,1601.0,388.0,-1213.0,41500.0,63500.0,22000.0
glenj101,Joe Glenn,New York Yankees,YANKS,2,3,3,6,1938,1944,6,-0.13,2.92,3.05,384,138,-246,1290,241,-1049,3.0,438.0,435.0,17000.0,6000.0,-11000.0
glenj103,John Glenn,Los Angeles Dodgers,DOGRS,1,1,2,3,1960,1960,0,-0.2,0.0,0.2,32,0,-32,32,0,-32,0.0,0.0,0.0,0.0,0.0,0.0
gloar001,Ross Gload,Florida Marlins,MARLNS,1,2,1,3,2000,2000,0,-0.32,-0.12,0.2,18,36,18,35,123,88,0.0,0.0,0.0,0.0,4600000.0,4600000.0
gloar001,Ross Gload,Colorado Rockies,ROCKS,1,3,3,6,2002,2002,0,0.0,0.1,0.1,0,193,193,0,708,708,0.0,3.0,3.0,0.0,0.0,0.0
gloar001,Ross Gload,Colorado Rockies,ROCKS,1,1,1,2,2003,2003,0,-0.65,0.0,0.65,215,0,-215,471,0,-471,0.0,0.0,0.0,0.0,0.0,0.0
gloar001,Ross Gload,Chicago White Sox,WSOX,1,1,1,2,2006,2008,2,0.28,-0.38,-0.66,224,20,-204,764,0,-764,0.0,42.0,42.0,350000.0,346500.0,-3500.0
gloar001,Ross Gload,Kansas City Royals,ROYALS,1,2,1,3,2009,2009,0,0.5,0.0,-0.5,126,0,-126,259,0,-259,3.0,0.0,-3.0,0.0,0.0,0.0
glosa101,Al Glossop,New York Giants,GIANTS,1,2,1,3,1940,1945,5,4.14,-0.49,-4.63,264,88,-176,377,324,-53,1753.0,0.0,-1753.0,0.0,0.0,0.0
glosa101,Al Glossop,Philadelphia Phillies,PHILS,2,3,3,6,1943,1943,0,0.73,1.46,0.73,404,136,-268,1520,565,-955,0.0,0.0,0.0,0.0,0.0,0.0
glovg001,Gary Glover,Toronto Blue Jays,BJAYS,1,1,1,2,2000,2002,2,0.76,0.79,0.03,117,71,-46,1,0,-1,823.0,237.0,-586.0,0.0,250000.0,250000.0
glovg001,Gary Glover,Chicago White Sox,WSOX,1,3,2,5,2003,2004,1,0.04,0.32,0.28,21,41,20,0,2,2,90.0,416.0,326.0,330000.0,1425000.0,1095000.0
glynb101,Bill Glynn,Sacramento,Sacramento,1,1,2,3,1952,1952,0,0.42,0.0,-0.42,302,0,-302,758,0,-758,0.0,0.0,0.0,0.0,0.0,0.0
glynb101,Bill Glynn,Philadelphia Phillies,PHILS,1,1,1,2,1951,1951,0,0.0,0.0,0.0,0,0,0,0,0,0,0.0,0.0,0.0,0.0,0.0,0.0
glyne001,Ed Glynn,Detroit Tigers,TIGRS,1,1,1,2,1979,1979,0,1.0,0.0,-1.0,168,0,-168,12,0,-12,337.0,0.0,-337.0,0.0,0.0,0.0
glyne001,Ed Glynn,New York Mets,METS,2,4,2,6,1981,1987,6,3.46,-0.12,-3.58,161,72,-89,111,61,-50,1165.0,505.0,-660.0,0.0,0.0,0.0
godbd101,Danny Godby,Cincinnati Reds,REDS,1,1,1,2,1971,1971,0,-0.15,0.0,0.15,13,0,-13,17,0,-17,0.0,0.0,0.0,0.0,0.0,0.0
godbd101,Danny Godby,St. Louis Cardinals,CARDS,1,1,1,2,1975,1975,0,0.0,-0.29,-0.29,0,22,22,0,36,36,0.0,0.0,0.0,0.0,0.0,0.0
godfg001,Graham Godfrey,Toronto Blue Jays,BJAYS,1,2,1,3,2007,2009,2,-0.44,9.81,10.25,11,289,278,2,1272,1270,138.0,0.0,-138.0,0.0,1550000.0,1550000.0
godfg001,Graham Godfrey,Oakland Athletics,ATLTCS,1,1,1,2,2012,2012,0,0.0,0.0,0.0,0,0,0,0,0,0,0.0,0.0,0.0,480000.0,0.0,-480000.0
godlz001,Zack Godley,Chicago Cubs,CUBS,2,4,2,6,2014,2017,3,0.75,1.66,0.91,266,245,-21,270,799,529,1562.0,7.0,-1555.0,14000000.0,10000000.0,-4000000.0
godwt001,Tyrell Godwin,Toronto Blue Jays,BJAYS,1,1,1,2,2005,2005,0,0.0,0.0,0.0,3,0,-3,3,0,-3,0.0,0.0,0.0,0.0,0.0,0.0
goebe101,Ed Goebel,Washington Senators,TWINS,1,3,2,5,1923,1930,7,1.13,22.03,20.9,449,1009,560,1547,3473,1926,0.0,543.0,543.0,0.0,0.0,0.0
goebe101,Ed Goebel,Boston Red Sox,RSOX,1,1,1,2,1923,1929,6,0.0,14.79,14.79,0,789,789,0,3399,3399,0.0,0.0,0.0,0.0,5000.0,5000.0
goebj001,Jake Goebbert,Houston Astros,ASTROS,2,2,2,4,2013,2013,0,-0.03,0.12,0.15,4,45,41,0,0,0,46.0,105.0,59.0,0.0,0.0,0.0
goebj001,Jake Goebbert,Oakland Athletics,ATLTCS,1,2,1,3,2014,2014,0,-0.14,0.59,0.73,51,21,-30,115,56,-59,0.0,0.0,0.0,0.0,988000.0,988000.0
goffj001,Jerry Goff,Seattle Mariners,MARNRS,1,1,1,2,1990,1990,0,-0.62,0.0,0.62,55,0,-55,144,0,-144,0.0,0.0,0.0,0.0,0.0,0.0
goggc101,Chuck Goggin,Los Angeles Dodgers,DOGRS,1,3,1,4,1969,1969,0,0.16,0.15,-0.01,6,18,12,9,21,12,0.0,169.0,169.0,0.0,75000.0,75000.0
goggc101,Chuck Goggin,Atlanta Braves,BRAVES,1,1,1,2,1974,1978,4,0.02,-0.68,-0.7,2,299,297,1,1000,999,0.0,0.0,0.0,0.0,0.0,0.0
gogob101,Bill Gogolewski,Texas Rangers,RNGRS,1,1,1,2,1974,1976,2,-0.02,2.16,2.18,5,105,100,0,0,0,41.0,1501.0,1460.0,0.0,0.0,0.0
gohal001,Luiz Gohara,Seattle Mariners,MARNRS,2,5,3,8,2017,2017,0,6.57,-0.14,-6.71,362,9,-353,845,0,-845,1646.0,23.0,-1623.0,0.0,0.0,0.0
gohrg001,Greg Gohr,Detroit Tigers,TIGRS,1,1,1,2,1996,2003,7,-0.3,17.79,18.09,15,841,826,0,3512,3512,72.0,0.0,-72.0,200000.0,305000.0,105000.0
goldg101,Gordon Goldsberry,Chicago White Sox,WSOX,2,6,4,10,1951,1963,12,1.43,25.02,23.59,363,1422,1059,910,5079,4169,614.0,0.0,-614.0,0.0,0.0,0.0
goldg101,Gordon Goldsberry,Seattle,Seattle,1,1,1,2,1953,1954,1,0.0,0.0,0.0,0,0,0,0,0,0,0.0,0.0,0.0,0.0,0.0,0.0
goldj102,Jim Golden,Philadelphia Phillies,PHILS,1,3,1,4,1958,1958,0,-0.86,0.0,0.86,137,0,-137,129,0,-129,226.0,0.0,-226.0,0.0,0.0,0.0
goldj102,Jim Golden,Houston Astros,ASTROS,1,3,1,4,1963,1964,1,0.82,1.37,0.55,136,133,-3,10,502,492,336.0,0.0,-336.0,0.0,0.0,0.0
goldp001,Paul Goldschmidt,Arizona Diamondbacks,DBACKS,1,1,4,5,2018,2018,0,10.75,0.0,-10.75,377,0,-377,1592,0,-1592,0.0,0.0,0.0,11100000.0,550800.0,-10549200.0
golsg001,Greg Golson,Philadelphia Phillies,PHILS,2,2,2,4,2008,2014,6,-0.05,1.98,2.03,16,500,484,31,1370,1339,0.0,0.0,0.0,1587500.0,0.0,-1587500.0
golsg001,Greg Golson,Texas Rangers,RNGRS,1,1,2,3,2010,2010,0,-0.32,0.0,0.32,33,0,-33,35,0,-35,0.0,0.0,0.0,0.0,0.0,0.0
golvw101,Walt Golvin,Mobile,Mobile,1,1,1,2,1921,1924,3,-0.05,0.0,0.05,2,0,-2,2,0,-2,0.0,0.0,0.0,0.0,2833.0,2833.0
gomba001,Austin Gomber,St. Louis Cardinals,CARDS,1,5,1,6,2021,2021,0,0.69,4.14,3.45,45,157,112,42,653,611,346.0,0.0,-346.0,0.0,0.0,0.0
gomeb001,Brandon Gomes,San Diego Padres,PADRS,1,4,1,5,2010,2012,2,1.36,-1.01,-2.37,435,168,-267,53,716,663,1270.0,0.0,-1270.0,401300.0,4000000.0,3598700.0
gomec001,Chris Gomez,Detroit Tigers,TIGRS,6,14,17,31,1996,2010,14,12.92,23.75,10.83,4861,1561,-3300,12744,2643,-10101,4562.0,6757.0,2195.0,12079000.0,5630000.0,-6449000.0
gomec002,Carlos Gomez,New York Mets,METS,1,4,1,5,2008,2013,5,2.31,15.63,13.32,305,210,-95,963,247,-716,66.0,2151.0,2085.0,0.0,0.0,0.0
gomec002,Carlos Gomez,Minnesota Twins,TWINS,2,3,3,6,2009,2011,2,34.66,0.71,-33.95,1586,128,-1458,6212,375,-5837,0.0,74.0,74.0,6987500.0,4650000.0,-2337500.0
gomec002,Carlos Gomez,Milwaukee Brewers,BREWRS,3,6,7,13,2015,2020,5,-0.06,8.37,8.43,453,778,325,1232,2675,1443,1628.0,6.0,-1622.0,1084900.0,0.0,-1084900.0
gomej001,Jonny Gomes,Cincinnati Reds,REDS,1,2,2,4,2011,2011,0,-0.17,0.0,0.17,43,0,-43,107,0,-107,0.0,0.0,0.0,1750000.0,0.0,-1750000.0
gomej001,Jonny Gomes,Boston Red Sox,RSOX,2,6,3,9,2014,2019,5,10.72,10.88,0.16,412,221,-191,504,237,-267,1024.0,2892.0,1868.0,15500000.0,8500000.0,-7000000.0
gomej001,Jonny Gomes,Atlanta Braves,BRAVES,1,2,1,3,2015,2015,0,-0.44,0.0,0.44,12,0,-12,34,0,-34,0.0,0.0,0.0,4000000.0,0.0,-4000000.0
gomej002,Jeanmar Gomez,Cleveland Indians,INDINS,1,1,1,2,2013,2013,0,0.72,0.0,-0.72,150,0,-150,15,0,-15,428.0,0.0,-428.0,0.0,0.0,0.0
gomel101,Luis Gomez,Toronto Blue Jays,BJAYS,2,3,4,7,1979,1985,6,4.77,5.46,0.69,1218,673,-545,3925,1647,-2278,3.0,1160.0,1157.0,0.0,0.0,0.0
gomep001,Pat Gomez,Chicago Cubs,CUBS,2,3,2,5,1989,1995,6,0.08,5.77,5.69,44,681,637,53,415,362,52.0,994.0,942.0,2665333.0,271000.0,-2394333.0
gomep001,Pat Gomez,Atlanta Braves,BRAVES,3,4,3,7,1992,1999,7,0.31,0.4,0.09,48,230,182,82,473,391,451.0,0.0,-451.0,3294833.0,185000.0,-3109833.0
gomep001,Pat Gomez,Texas Rangers,RNGRS,1,1,1,2,1992,1993,1,0.01,0.0,-0.01,55,0,-55,5,0,-5,95.0,0.0,-95.0,0.0,0.0,0.0
gomer101,Ruben Gomez,San Francisco Giants,GIANTS,1,2,1,3,1958,1965,7,-2.23,13.08,15.31,168,471,303,186,541,355,408.0,4217.0,3809.0,0.0,0.0,0.0
gomer101,Ruben Gomez,Cleveland Indians,INDINS,1,1,3,4,1962,1962,0,-0.13,-0.08,0.05,12,2,-10,6,0,-6,58.0,4.0,-54.0,0.0,0.0,0.0
gomew001,Wayne Gomes,Philadelphia Phillies,PHILS,1,1,1,2,2001,2002,1,-0.56,-0.27,0.29,26,33,7,0,47,47,45.0,0.0,-45.0,925000.0,425000.0,-500000.0
gomey001,Yan Gomes,Toronto Blue Jays,BJAYS,1,2,1,3,2012,2014,2,11.57,-0.01,-11.58,944,66,-878,3396,7,-3389,0.0,475.0,475.0,0.0,481000.0,481000.0
gomey001,Yan Gomes,Cleveland Indians,INDINS,1,1,3,4,2018,2020,2,4.3,0.15,-4.15,190,11,-179,712,0,-712,0.0,140.0,140.0,6033333.0,0.0,-6033333.0
gomey001,Yan Gomes,Washington Nationals,NATEX,1,3,3,6,2021,2021,0,-0.1,0.0,0.1,88,0,-88,339,0,-339,0.0,0.0,0.0,7000000.0,0.0,-7000000.0
gondj101,Jesse Gonder,New York Yankees,YANKS,1,1,1,2,1961,1963,2,0.32,0.19,-0.13,35,150,115,37,15,-22,0.0,314.0,314.0,0.0,0.0,0.0
gondj101,Jesse Gonder,Cincinnati Reds,REDS,2,2,3,5,1963,1964,1,1.97,-1.44,-3.41,230,52,-178,635,108,-527,0.0,0.0,0.0,0.0,0.0,0.0
gondj101,Jesse Gonder,New York Mets,METS,2,3,3,6,1965,1970,5,1.3,1.09,-0.21,219,338,119,292,479,187,516.0,1427.0,911.0,0.0,26000.0,26000.0
gondj101,Jesse Gonder,Cincinnati Reds,REDS,1,3,2,5,1960,1960,0,3.11,0.0,-3.11,276,0,-276,63,0,-63,598.0,0.0,-598.0,0.0,0.0,0.0
gonza001,Alex Gonzalez,Toronto Blue Jays,BJAYS,1,1,2,3,2001,2002,1,1.3,0.37,-0.93,331,55,-276,1304,0,-1304,0.0,157.0,157.0,4250000.0,1150000.0,-3100000.0
gonza001,Alex Gonzalez,Chicago Cubs,CUBS,2,8,4,12,2004,2009,5,11.71,9.74,-1.97,643,537,-106,2292,1477,-815,256.0,718.0,462.0,5750000.0,6525000.0,775000.0
gonza002,Alex Gonzalez,Cincinnati Reds,REDS,1,2,1,3,2009,2015,6,0.3,1.65,1.35,44,96,52,159,270,111,0.0,0.0,0.0,5375000.0,0.0,-5375000.0
gonza002,Alex Gonzalez,Toronto Blue Jays,BJAYS,4,18,13,31,2010,2018,8,25.98,29.42,3.44,2444,1447,-997,6892,4630,-2262,4668.0,4909.0,241.0,11482900.0,44024800.0,32541900.0
gonza002,Alex Gonzalez,Baltimore Orioles,ORLS,1,1,1,2,2014,2015,1,-0.53,-0.68,-0.15,9,20,11,32,74,42,0.0,0.0,0.0,0.0,0.0,0.0
gonza003,Adrian Gonzalez,Florida Marlins,MARLNS,1,3,1,4,2003,2003,0,-0.88,2.14,3.02,60,66,6,206,2,-204,10.0,115.0,105.0,0.0,4500000.0,4500000.0
gonza003,Adrian Gonzalez,Texas Rangers,RNGRS,1,3,3,6,2006,2007,1,28.55,3.75,-24.8,1126,114,-1012,3924,0,-3924,1652.0,471.0,-1181.0,0.0,0.0,0.0
gonza003,Adrian Gonzalez,San Diego Padres,PADRS,8,18,17,35,2010,2021,11,47.37,0.77,-46.6,2178,704,-1474,7839,1088,-6751,1041.0,2539.0,1498.0,15535200.0,5157500.0,-10377700.0
gonza003,Adrian Gonzalez,Boston Red Sox,RSOX,7,22,14,36,2012,2019,7,37.54,19.18,-18.36,2738,1439,-1299,4768,4566,-202,4720.0,1908.0,-2812.0,4708000.0,16585000.0,11877000.0
gonza003,Adrian Gonzalez,Los Angeles Dodgers,DOGRS,4,17,9,26,2017,2021,4,6.07,9.48,3.41,927,279,-648,2727,1007,-1720,545.0,229.0,-316.0,71371000.0,90253480.0,18882480.0
gonza005,Alberto Gonzalez,Arizona Diamondbacks,DBACKS,1,4,2,6,2007,2008,1,-0.71,4.28,4.99,171,78,-93,110,78,-32,366.0,722.0,356.0,0.0,0.0,0.0
gonza005,Alberto Gonzalez,New York Yankees,YANKS,2,4,3,7,2008,2012,4,-0.45,11.97,12.42,264,599,335,618,2501,1883,20.0,3.0,-17.0,1165000.0,3600000.0,2435000.0
gonza005,Alberto Gonzalez,Washington Nationals,NATEX,1,1,2,3,2011,2016,5,-0.13,0.1,0.23,102,20,-82,267,0,-267,0.0,26.0,26.0,0.0,0.0,0.0
gonzc001,Carlos Gonzalez,Arizona Diamondbacks,DBACKS,6,14,16,30,2007,2018,11,24.99,30.17,5.18,855,1190,335,1319,2038,719,6760.0,6326.0,-434.0,14741000.0,15790000.0,1049000.0
gonzc001,Carlos Gonzalez,Oakland Athletics,ATLTCS,6,8,8,16,2008,2014,6,50.06,1.09,-48.97,2622,167,-2455,9256,628,-8628,794.0,101.0,-693.0,16800000.0,9919000.0,-6881000.0
gonzd001,Denny Gonzalez,Pittsburgh Pirates,PIRATS,2,4,5,9,1988,2000,12,14.38,27.85,13.47,1120,1409,289,4205,5288,1083,0.0,260.0,260.0,7267500.0,187500.0,-7080000.0
gonzd002,Dicky Gonzalez,New York Mets,METS,1,4,3,7,2002,2005,3,2.12,1.12,-1.0,505,185,-320,25,27,2,939.0,263.0,-676.0,300000.0,355000.0,55000.0
gonzd101,Dan Gonzales,Detroit Tigers,TIGRS,1,2,3,5,1980,1980,0,0.0,0.0,0.0,0,0,0,0,0,0,0.0,0.0,0.0,0.0,0.0,0.0
gonze004,Erik Gonzalez,Cleveland Indians,INDINS,2,5,3,8,2018,2021,3,0.47,1.8,1.33,203,170,-33,650,509,-141,11.0,0.0,-11.0,547800.0,0.0,-547800.0
gonzf101,Fernando Gonzalez,Pittsburgh Pirates,PIRATS,3,4,6,10,1973,1978,5,0.57,-0.14,-0.71,111,383,272,173,830,657,645.0,0.0,-645.0,94500.0,49000.0,-45500.0
gonzg003,Gio Gonzalez,Chicago White Sox,WSOX,2,5,3,8,2005,2009,4,5.6,12.08,6.48,287,529,242,1146,2165,1019,0.0,0.0,0.0,15000000.0,13166667.0,-1833333.0
gonzg003,Gio Gonzalez,Philadelphia Phillies,PHILS,1,2,1,3,2006,2007,1,16.18,-0.17,-16.35,196,21,-175,20,22,2,3223.0,174.0,-3049.0,330000.0,9000000.0,8670000.0
gonzg003,Gio Gonzalez,Chicago White Sox,WSOX,2,5,4,9,2008,2011,3,24.92,-0.88,-25.8,1177,181,-996,4107,638,-3469,1718.0,20.0,-1698.0,3600000.0,1165000.0,-2435000.0
gonzg003,Gio Gonzalez,Oakland Athletics,ATLTCS,13,26,22,48,2011,2019,8,41.81,19.43,-22.38,2657,1492,-1165,5603,3820,-1783,7622.0,2917.0,-4705.0,9735001.0,4800000.0,-4935001.0
gonzg003,Gio Gonzalez,Washington Nationals,NATEX,1,2,2,4,2018,2018,0,2.42,0.0,-2.42,47,0,-47,36,0,-36,338.0,0.0,-338.0,12000000.0,0.0,-12000000.0
gonzj001,Jose Gonzalez,Los Angeles Dodgers,DOGRS,1,1,1,2,1991,1995,4,-0.17,0.19,0.36,16,417,401,23,736,713,0.0,0.0,0.0,0.0,0.0,0.0
gonzj002,Juan Gonzalez,Texas Rangers,RNGRS,3,10,10,20,1999,2013,14,7.41,32.82,25.41,760,2098,1338,1243,6477,5234,821.0,1323.0,502.0,18360260.0,14087500.0,-4272760.0
gonzj003,Geremi Gonzalez,New York Mets,METS,1,1,1,2,2006,2006,0,-0.65,0.0,0.65,40,0,-40,5,0,-5,126.0,0.0,-126.0,0.0,0.0,0.0
gonzj101,Julio Gonzalez,Chicago Cubs,CUBS,10,18,20,38,1976,1990,14,19.28,13.33,-5.95,2985,1542,-1443,7849,3350,-4499,1072.0,3217.0,2145.0,890000.0,85000.0,-805000.0
gonzl001,Luis Gonzalez,Houston Astros,ASTROS,2,4,2,6,1995,1996,1,9.88,0.54,-9.34,757,136,-621,2742,446,-2296,0.0,0.0,0.0,3390000.0,1875000.0,-1515000.0
gonzl001,Luis Gonzalez,Detroit Tigers,TIGRS,1,1,1,2,1998,2000,2,30.02,0.12,-29.9,1194,104,-1090,5246,327,-4919,0.0,0.0,0.0,2000000.0,187500.0,-1812500.0
gonzl003,Lariel Gonzalez,Colorado Rockies,ROCKS,1,2,1,3,2000,2001,1,0.11,1.15,1.04,43,56,13,4,64,60,116.0,502.0,386.0,0.0,0.0,0.0
gonzm001,Mike Gonzalez,Pittsburgh Pirates,PIRATS,7,13,14,27,2003,2013,10,4.43,39.52,35.09,675,2405,1730,958,7168,6210,1221.0,934.0,-287.0,15866667.0,309500.0,-15557167.0
gonzm001,Mike Gonzalez,Boston Red Sox,RSOX,2,7,4,11,2003,2008,5,19.22,18.0,-1.22,1732,200,-1532,2840,14,-2826,1848.0,2423.0,575.0,634000.0,10500000.0,9866000.0
gonzm001,Mike Gonzalez,Pittsburgh Pirates,PIRATS,2,3,4,7,2007,2013,6,1.29,2.54,1.25,298,397,99,105,1590,1485,375.0,0.0,-375.0,7050000.0,0.0,-7050000.0
gonzm001,Mike Gonzalez,Baltimore Orioles,ORLS,3,5,5,10,2011,2019,8,26.48,4.9,-21.58,1123,609,-514,389,1879,1490,3814.0,575.0,-3239.0,6514000.0,7316000.0,802000.0
gonzm002,Marwin Gonzalez,Boston Red Sox,RSOX,1,1,1,2,2011,2011,0,11.7,0.0,-11.7,809,0,-809,2742,0,-2742,0.0,0.0,0.0,0.0,0.0,0.0
gonzm003,Miguel Gonzalez,Chicago White Sox,WSOX,1,1,1,2,2017,2017,0,-0.03,0.0,0.03,6,0,-6,1,0,-1,67.0,0.0,-67.0,5900000.0,0.0,-5900000.0
gonzm005,Marco Gonzales,St. Louis Cardinals,CARDS,1,1,1,2,2017,2017,0,9.86,0.0,-9.86,115,0,-115,15,0,-15,1858.0,0.0,-1858.0,0.0,0.0,0.0
gonzm007,Merandy Gonzalez,New York Mets,METS,1,2,1,3,2017,2018,1,-0.15,-0.36,-0.21,15,96,81,4,0,-4,66.0,116.0,50.0,0.0,6550000.0,6550000.0
gonzm101,Mike Gonzalez,Cincinnati Reds,REDS,1,1,1,2,1915,1915,0,8.22,0.25,-7.97,566,119,-447,1748,365,-1383,0.0,0.0,0.0,0.0,0.0,0.0
gonzm101,Mike Gonzalez,New York Giants,GIANTS,1,3,1,4,1921,1926,5,3.43,7.56,4.13,403,420,17,1818,1780,-38,0.0,0.0,0.0,15208.0,10591.0,-4617.0
gonzm101,Mike Gonzalez,Brooklyn Dodgers,DOGRS,1,1,1,2,1924,1924,0,1.66,-2.72,-4.38,174,142,-32,547,607,60,0.0,0.0,0.0,0.0,0.0,0.0
gonzm101,Mike Gonzalez,St. Louis Cardinals,CARDS,2,3,2,5,1925,1928,3,5.63,8.11,2.48,980,417,-563,3189,1539,-1650,0.0,0.0,0.0,30500.0,21000.0,-9500.0
gonzp101,Pedro Gonzalez,New York Yankees,YANKS,2,5,2,7,1965,1968,3,1.54,0.06,-1.48,306,250,-56,1014,421,-593,0.0,678.0,678.0,10500.0,7500.0,-3000.0
gonzr001,Rene Gonzales,Montreal Expos,NATEX,1,1,2,3,1986,1993,7,1.13,28.91,27.78,267,498,231,631,650,19,0.0,4827.0,4827.0,0.0,630458.0,630458.0
gonzr001,Rene Gonzales,Baltimore Orioles,ORLS,1,1,1,2,1991,1991,0,0.1,0.0,-0.1,71,0,-71,141,0,-141,0.0,0.0,0.0,0.0,0.0,0.0
gonzr002,Raul Gonzalez,Cincinnati Reds,REDS,1,4,2,6,2002,2002,0,6.19,-0.7,-6.89,1101,12,-1089,365,10,-355,1151.0,84.0,-1067.0,233000.0,6200000.0,5967000.0
gonzs001,Severino Gonzalez,Philadelphia Phillies,PHILS,1,1,1,2,2017,2017,0,0.0,0.0,0.0,0,0,0,0,0,0,0.0,0.0,0.0,0.0,0.0,0.0
gonzt101,Tony Gonzalez,Cincinnati Reds,REDS,1,2,3,5,1960,1963,3,24.2,5.52,-18.68,1274,332,-942,4678,994,-3684,0.0,0.0,0.0,0.0,0.0,0.0
gonzt101,Tony Gonzalez,San Diego Padres,PADRS,2,2,4,6,1969,1971,2,2.26,-0.76,-3.02,212,104,-108,844,298,-546,0.0,0.0,0.0,0.0,0.0,0.0
gonzw001,Wiki Gonzalez,San Diego Padres,PADRS,1,4,3,7,2004,2004,0,0.63,-0.51,-1.14,139,46,-93,232,85,-147,39.0,43.0,4.0,0.0,0.0,0.0
goocj101,Johnny Gooch,Pittsburgh Pirates,PIRATS,1,2,1,3,1928,1933,5,-0.02,-0.43,-0.41,98,192,94,214,667,453,0.0,0.0,0.0,16000.0,7500.0,-8500.0
goocj101,Johnny Gooch,Brooklyn Dodgers,DOGRS,1,2,1,3,1929,1933,4,1.02,-0.43,-1.45,222,187,-35,631,496,-135,148.0,0.0,-148.0,0.0,0.0,0.0
goocj101,Johnny Gooch,Cincinnati Reds,REDS,1,1,1,2,1932,1945,13,0.0,0.0,0.0,0,0,0,0,0,0,0.0,0.0,0.0,0.0,0.0,0.0
goodb001,Brian Goodwin,Washington Nationals,NATEX,1,1,1,2,2018,2018,0,0.13,0.0,-0.13,27,0,-27,101,0,-101,0.0,0.0,0.0,553900.0,0.0,-553900.0
goodb001,Brian Goodwin,Anaheim Angels,ANGELS,1,1,2,3,2020,2020,0,-0.49,0.0,0.49,20,0,-20,55,0,-55,0.0,0.0,0.0,2200000.0,0.0,-2200000.0
goodb101,Billy Goodman,Boston Red Sox,RSOX,1,1,1,2,1957,1963,6,1.08,4.73,3.65,73,573,500,298,166,-132,0.0,1927.0,1927.0,0.0,0.0,0.0
goodb101,Billy Goodman,Baltimore Orioles,ORLS,17,35,36,71,1957,1988,31,40.74,110.41,69.67,3408,5865,2457,6586,11971,5385,12624.0,16106.0,3482.0,725833.0,113000.0,-612833.0
goodc001,Curtis Goodwin,Baltimore Orioles,ORLS,1,2,1,3,1995,1996,1,-0.58,2.88,3.46,134,34,-100,453,0,-453,0.0,673.0,673.0,109000.0,0.0,-109000.0
goodc001,Curtis Goodwin,Cincinnati Reds,REDS,1,1,1,2,1997,1998,1,-0.37,-0.26,0.11,119,20,-99,186,1,-185,0.0,51.0,51.0,0.0,0.0,0.0
goodd101,Danny Goodwin,California Angels,ANGELS,2,3,3,6,1978,1987,9,2.69,22.79,20.1,795,1091,296,2836,4554,1718,0.0,0.0,0.0,0.0,60000.0,60000.0
goode101,Ed Goodson,San Francisco Giants,GIANTS,3,6,4,10,1975,1983,8,-1.45,26.84,28.29,334,1745,1411,1169,6518,5349,0.0,0.0,0.0,0.0,0.0,0.0
goode101,Ed Goodson,Atlanta Braves,BRAVES,2,4,5,9,1975,1984,9,23.22,0.43,-22.79,1629,1492,-137,5388,5061,-327,292.0,128.0,-164.0,0.0,135000.0,135000.0
goodm102,Marv Goodwin,Milwaukee,Milwaukee,1,1,5,6,1917,1926,9,0.0,0.0,0.0,191,0,-191,147,0,-147,1261.0,0.0,-1261.0,0.0,9800.0,9800.0
goodn001,Nick Goody,New York Yankees,YANKS,1,1,1,2,2016,2017,1,0.97,0.0,-0.97,113,0,-113,0,0,0,321.0,0.0,-321.0,0.0,0.0,0.0
goodt001,Tom Goodwin,Kansas City Royals,ROYALS,1,1,1,2,1997,1998,1,3.01,2.36,-0.65,316,201,-115,1298,845,-453,0.0,0.0,0.0,1050000.0,4800000.0,3750000.0
goodt001,Tom Goodwin,Colorado Rockies,ROCKS,3,5,7,12,2000,2003,3,-0.66,4.31,4.97,252,283,31,727,878,151,127.0,0.0,-127.0,7066667.0,3300000.0,-3766667.0
goodw101,Wilbur Good,Cleveland Indians,INDINS,1,1,1,2,1909,1909,0,0.0,0.0,0.0,0,0,0,0,0,0,0.0,0.0,0.0,0.0,0.0,0.0
goodw101,Wilbur Good,Boston Braves,BRAVES,2,5,6,11,1911,1914,3,3.16,-2.55,-5.71,559,378,-181,1829,1028,-801,21.0,614.0,593.0,0.0,6000.0,6000.0
goosg101,Greg Goossen,New York Mets,METS,4,7,5,12,1969,1977,8,1.61,9.34,7.73,228,850,622,453,1628,1175,89.0,1792.0,1703.0,0.0,150000.0,150000.0
goosg101,Greg Goossen,Washington Senators,RNGRS,8,16,13,29,1970,1982,12,21.36,8.18,-13.18,1080,728,-352,2708,1819,-889,4391.0,989.0,-3402.0,326500.0,280000.0,-46500.0
gorbg101,Glen Gorbous,Cincinnati Reds,REDS,5,10,14,24,1955,1965,10,64.57,18.03,-46.54,3586,1613,-1973,11340,3264,-8076,2563.0,1025.0,-1538.0,13500.0,15500.0,2000.0
gorbg101,Glen Gorbous,Philadelphia Phillies,PHILS,1,1,1,2,1957,1957,0,0.0,-0.12,-0.12,0,57,57,0,87,87,0.0,0.0,0.0,0.0,0.0,0.0
gordd001,Don Gordon,Toronto Blue Jays,BJAYS,1,2,1,3,1987,1987,0,-0.44,-0.32,0.12,59,3,-56,0,0,0,297.0,36.0,-261.0,71500.0,0.0,-71500.0
gordd002,Dee Gordon,Los Angeles Dodgers,DOGRS,4,7,8,15,2014,2020,6,27.35,10.53,-16.82,1361,1127,-234,4322,2916,-1406,2273.0,350.0,-1923.0,21765000.0,9877000.0,-11888000.0
gordd002,Dee Gordon,Miami Marlins,MARLNS,1,2,3,5,2017,2020,3,1.81,-1.14,-2.95,291,18,-273,1091,11,-1080,0.0,135.0,135.0,7800000.0,0.0,-7800000.0
gordj101,Joe Gordon,New York Yankees,YANKS,1,1,1,2,1946,1946,0,19.02,0.0,-19.02,566,0,-566,2321,0,-2321,0.0,0.0,0.0,0.0,0.0,0.0
gordj101,Joe Gordon,Cleveland Indians,INDINS,1,1,1,2,1960,1960,0,0.0,0.0,0.0,0,0,0,0,0,0,0.0,0.0,0.0,0.0,0.0,0.0
gords101,Sid Gordon,New York Giants,GIANTS,14,31,27,58,1949,1968,19,59.86,70.44,10.58,4286,4168,-118,14522,10114,-4408,1384.0,8678.0,7294.0,127500.0,134500.0,7000.0
gords101,Sid Gordon,Milwaukee Braves,BRAVES,2,10,2,12,1953,1960,7,8.19,12.74,4.55,794,729,-65,1824,3040,1216,2135.0,0.0,-2135.0,0.0,42000.0,42000.0
gordt001,Tom Gordon,Chicago Cubs,CUBS,3,4,7,11,2002,2010,8,2.77,22.6,19.83,164,924,760,492,4021,3529,57.0,0.0,-57.0,16355000.0,4250000.0,-12105000.0
gormt001,Tom Gorman,Montreal Expos,NATEX,1,1,1,2,1982,1982,0,0.26,-0.73,-0.99,196,40,-156,16,104,88,507.0,0.0,-507.0,0.0,366667.0,366667.0
gormt001,Tom Gorman,San Diego Padres,PADRS,1,1,1,2,1987,1987,0,0.0,0.0,0.0,0,0,0,0,0,0,0.0,0.0,0.0,0.0,0.0,0.0
goryj101,Johnny Goryl,Chicago Cubs,CUBS,1,4,1,5,1960,1961,1,14.78,2.04,-12.74,914,260,-654,121,914,793,2300.0,0.0,-2300.0,0.0,0.0,0.0
gorzt001,Tom Gorzelanny,Pittsburgh Pirates,PIRATS,1,2,3,5,2009,2018,9,0.73,13.21,12.48,310,883,573,59,3032,2973,863.0,188.0,-675.0,2300000.0,405000.0,-1895000.0
gorzt001,Tom Gorzelanny,Chicago Cubs,CUBS,1,1,3,4,2011,2013,2,1.64,0.0,-1.64,148,0,-148,40,0,-40,531.0,0.0,-531.0,0.0,0.0,0.0
gosea001,Anthony Gose,Philadelphia Phillies,PHILS,1,3,1,4,2010,2011,1,1.12,5.11,3.99,320,74,-246,775,83,-692,998.0,665.0,-333.0,470000.0,15000000.0,14530000.0
gosea001,Anthony Gose,Houston Astros,ASTROS,1,1,1,2,2010,2014,4,1.55,-0.15,-1.7,202,311,109,616,1077,461,0.0,0.0,0.0,0.0,0.0,0.0
gosea001,Anthony Gose,Toronto Blue Jays,BJAYS,1,1,1,2,2014,2019,5,0.44,5.83,5.39,170,316,146,636,1246,610,0.0,0.0,0.0,0.0,0.0,0.0
gosgj101,Jim Gosger,Boston Red Sox,RSOX,2,6,4,10,1966,1969,3,1.66,1.54,-0.12,432,533,101,910,683,-227,275.0,859.0,584.0,24500.0,15000.0,-9500.0
gosgj101,Jim Gosger,Seattle Pilots,BREWRS,1,1,2,3,1969,1970,1,-1.74,2.1,3.84,74,73,-1,155,216,61,0.0,0.0,0.0,0.0,0.0,0.0
gosgj101,Jim Gosger,New York Mets,METS,3,5,4,9,1969,1977,8,-0.49,9.42,9.91,155,840,685,237,1612,1375,89.0,1792.0,1703.0,0.0,150000.0,150000.0
gosgj101,Jim Gosger,Montreal Expos,NATEX,2,2,5,7,1971,1975,4,-1.66,-0.13,1.53,64,1,-63,139,4,-135,0.0,0.0,0.0,0.0,0.0,0.0
goslg101,Goose Goslin,Washington Senators,TWINS,4,7,7,14,1930,1940,10,17.13,37.56,20.43,839,1747,908,2673,5418,2745,2260.0,5469.0,3209.0,22000.0,38500.0,16500.0
goslg101,Goose Goslin,St.Louis Browns,ORLS,20,38,48,86,1932,1952,20,96.01,96.11,0.1,5218,8686,3468,17109,27646,10537,8613.0,15510.0,6897.0,185500.0,179450.0,-6050.0
goslg101,Goose Goslin,Washington Senators,TWINS,1,1,1,2,1933,1933,0,9.25,0.0,-9.25,524,0,-524,2216,0,-2216,0.0,0.0,0.0,11000.0,7000.0,-4000.0
gossh101,Howie Goss,Pittsburgh Pirates,PIRATS,1,2,1,3,1963,1968,5,0.36,6.61,6.25,133,642,509,448,1858,1410,0.0,0.0,0.0,0.0,0.0,0.0
gossp001,Phil Gosselin,Atlanta Braves,BRAVES,4,8,13,21,2015,2020,5,5.94,-1.29,-7.23,734,465,-269,1003,1320,317,1642.0,246.0,-1396.0,24907500.0,34929500.0,10022000.0
gossp001,Phil Gosselin,Arizona Diamondbacks,DBACKS,1,1,1,2,2017,2017,0,-0.58,0.0,0.58,28,0,-28,42,0,-42,0.0,0.0,0.0,0.0,0.0,0.0
gossr001,Rich Gossage,Chicago White Sox,WSOX,2,5,3,8,1976,1978,2,7.3,2.34,-4.96,434,159,-275,257,599,342,2388.0,97.0,-2291.0,0.0,0.0,0.0
gossr001,Rich Gossage,San Diego Padres,PADRS,12,25,27,52,1988,2006,18,9.51,50.24,40.73,3517,4748,1231,11279,16194,4915,1092.0,2149.0,1057.0,16040833.0,24134000.0,8093167.0
gotaj101,Julio Gotay,St. Louis Cardinals,CARDS,12,25,21,46,1962,1972,10,34.37,14.04,-20.33,3456,1142,-2314,8634,3489,-5145,3590.0,703.0,-2887.0,32500.0,24000.0,-8500.0
gotaj101,Julio Gotay,Pittsburgh Pirates,PIRATS,1,1,1,2,1965,1965,0,0.72,0.0,-0.72,40,0,-40,82,0,-82,0.0,0.0,0.0,0.0,0.0,0.0
gotaj101,Julio Gotay,California Angels,ANGELS,3,4,3,7,1966,1968,2,0.31,0.22,-0.09,412,95,-317,701,230,-471,443.0,0.0,-443.0,0.0,0.0,0.0
gotar001,Ruben Gotay,Kansas City Royals,ROYALS,2,2,2,4,2006,2007,1,-0.08,0.13,0.21,286,22,-264,989,67,-922,0.0,0.0,0.0,0.0,0.0,0.0
gottj001,Jim Gott,Toronto Blue Jays,BJAYS,1,3,1,4,1985,1987,2,0.9,0.56,-0.34,130,92,-38,70,0,-70,652.0,301.0,-351.0,0.0,0.0,0.0
gottt001,Trevor Gott,San Diego Padres,PADRS,3,5,8,13,2014,2019,5,2.1,2.53,0.43,243,302,59,4,1043,1039,1186.0,40.0,-1146.0,9925000.0,505000.0,-9420000.0
gottt001,Trevor Gott,Anaheim Angels,ANGELS,1,2,2,4,2015,2017,2,-0.45,1.55,2.0,66,221,155,0,948,948,84.0,0.0,-84.0,0.0,5000000.0,5000000.0
goult101,Ted Goulait,Indianapolis,Indianapolis,1,1,2,3,1912,1921,9,0.0,0.0,0.0,0,0,0,0,0,0,0.0,0.0,0.0,0.0,0.0,0.0
gowdh101,Hank Gowdy,New York Giants,GIANTS,3,6,3,9,1911,1921,10,34.55,14.86,-19.69,1629,779,-850,5823,2071,-3752,0.0,2915.0,2915.0,6400.0,5200.0,-1200.0
gowdh101,Hank Gowdy,Boston Braves,BRAVES,9,18,16,34,1923,1938,15,22.25,29.52,7.27,1842,2916,1074,4975,10263,5288,4661.0,3399.0,-1262.0,56400.0,40100.0,-16300.0
gozzm001,Mauro Gozzo,New York Mets,METS,11,23,20,43,1987,2005,18,11.67,39.4,27.73,1493,3560,2067,1978,7962,5984,3113.0,6312.0,3199.0,27998333.0,20210666.0,-7787667.0
gozzm001,Mauro Gozzo,Toronto Blue Jays,BJAYS,1,3,1,4,1990,1990,0,-0.34,0.18,0.52,4,3,-1,0,0,0,23.0,47.0,24.0,102500.0,775000.0,672500.0
grabb101,Billy Grabarkewitz,Los Angeles Dodgers,DOGRS,1,5,2,7,1972,1976,4,16.6,19.03,2.43,596,356,-240,1923,542,-1381,1810.0,2591.0,781.0,251500.0,115000.0,-136500.0
grabb101,Billy Grabarkewitz,California Angels,ANGELS,2,4,3,7,1973,1976,3,2.26,3.34,1.08,402,155,-247,1412,564,-848,0.0,0.0,0.0,38500.0,40000.0,1500.0
grabj002,John Grabow,Pittsburgh Pirates,PIRATS,1,2,3,5,2009,2018,9,0.73,13.21,12.48,310,883,573,59,3032,2973,863.0,188.0,-675.0,2300000.0,405000.0,-1895000.0
grabj101,Johnny Grabowski,Minneapolis,Minneapolis,1,2,2,4,1924,1930,6,-1.39,0.0,1.39,129,0,-129,265,0,-265,183.0,0.0,-183.0,0.0,9100.0,9100.0
grabj101,Johnny Grabowski,Chicago White Sox,WSOX,1,2,1,3,1927,1928,1,-0.49,2.12,2.61,240,145,-95,730,550,-180,0.0,0.0,0.0,0.0,0.0,0.0
grabj101,Johnny Grabowski,New York Yankees,YANKS,1,3,1,4,1929,1930,1,0.0,0.05,0.05,0,45,45,0,121,121,0.0,0.0,0.0,15000.0,0.0,-15000.0
grace101,Earl Grace,Chicago Cubs,CUBS,3,9,4,13,1931,1941,10,6.49,28.82,22.33,1048,1022,-26,2697,2403,-294,2473.0,4458.0,1985.0,0.0,0.0,0.0
grace101,Earl Grace,Pittsburgh Pirates,PIRATS,2,5,2,7,1935,1941,6,11.48,3.57,-7.91,470,432,-38,813,1543,730,2406.0,0.0,-2406.0,0.0,0.0,0.0
grace101,Earl Grace,Philadelphia Phillies,PHILS,1,1,1,2,1937,1937,0,0.0,0.0,0.0,0,0,0,0,0,0,0.0,0.0,0.0,0.0,0.0,0.0
gracj101,Joe Grace,St.Louis Browns,ORLS,1,2,1,3,1946,1947,1,1.06,5.22,4.16,159,227,68,625,935,310,8.0,0.0,-8.0,3000.0,0.0,-3000.0
gracm101,Mike Grace,Cincinnati Reds,REDS,1,2,2,4,1981,1981,0,0.0,0.0,0.0,0,0,0,0,0,0,0.0,0.0,0.0,0.0,0.0,0.0
gradm101,Mike Grady,Philadelphia Phillies,PHILS,1,2,1,3,1897,1902,5,5.09,11.56,6.47,465,423,-42,1577,1709,132,668.0,0.0,-668.0,0.0,0.0,0.0
gradm101,Mike Grady,St. Louis Cardinals,CARDS,2,4,5,9,1897,1899,2,11.69,1.81,-9.88,688,269,-419,2803,1136,-1667,0.0,0.0,0.0,0.0,0.0,0.0
grafm101,Milt Graff,New York Yankees,YANKS,6,15,13,28,1957,1970,13,5.72,32.98,27.26,1633,2423,790,4235,5558,1323,2553.0,4978.0,2425.0,115500.0,43000.0,-72500.0
graft001,Tony Graffanino,Tampa Bay Devil Rays,RAYS,1,1,1,2,2000,2002,2,5.66,5.72,0.06,291,98,-193,881,13,-868,0.0,1416.0,1416.0,270000.0,206000.0,-64000.0
graft001,Tony Graffanino,Kansas City Royals,ROYALS,1,1,2,3,2005,2006,1,1.26,-0.16,-1.42,51,53,2,200,167,-33,0.0,0.0,0.0,1100000.0,0.0,-1100000.0
graft001,Tony Graffanino,Kansas City Royals,ROYALS,3,3,3,6,2006,2009,3,18.86,3.95,-14.91,675,164,-511,920,220,-700,3760.0,751.0,-3009.0,2447000.0,5420333.0,2973333.0
grahd101,Dan Graham,Minnesota Twins,TWINS,1,1,1,2,1979,1979,0,1.1,0.0,-1.1,141,0,-141,442,0,-442,0.0,0.0,0.0,0.0,0.0,0.0
grahj101,Jack Graham,New York Yankees,YANKS,1,1,1,2,1940,1940,0,-0.05,0.0,0.05,2,0,-2,5,0,-5,0.0,0.0,0.0,0.0,0.0,0.0
grahj101,Jack Graham,New York Giants,GIANTS,1,4,1,5,1947,1953,6,0.0,-0.83,-0.83,0,19,19,0,46,46,0.0,19.0,19.0,0.0,0.0,0.0
grahp101,Peaches Graham,Boston Braves,BRAVES,2,5,6,11,1911,1914,3,3.16,-2.55,-5.71,559,378,-181,1829,1028,-801,21.0,614.0,593.0,0.0,6000.0,6000.0
grahp101,Peaches Graham,Chicago Cubs,CUBS,1,1,2,3,1912,1912,0,-0.4,-0.17,0.23,24,26,2,67,61,-6,0.0,0.0,0.0,0.0,0.0,0.0
grahw101,Wayne Graham,Philadelphia Phillies,PHILS,1,3,1,4,1964,1965,1,-0.3,1.17,1.47,100,74,-26,65,237,172,326.0,0.0,-326.0,0.0,0.0,0.0
grahw101,Wayne Graham,New York Mets,METS,1,3,1,4,1966,1966,0,-0.11,-0.09,0.02,10,31,21,19,96,77,0.0,0.0,0.0,0.0,0.0,0.0
grama101,Alex Grammas,Cincinnati Reds,REDS,1,1,2,3,1953,1954,1,6.2,0.0,-6.2,619,0,-619,1722,0,-1722,0.0,0.0,0.0,0.0,0.0,0.0
grama101,Alex Grammas,St. Louis Cardinals,CARDS,2,3,2,5,1956,1957,1,0.94,-0.25,-1.19,322,29,-293,645,20,-625,0.0,0.0,0.0,0.0,0.0,0.0
grama101,Alex Grammas,Cincinnati Reds,REDS,3,5,8,13,1958,1966,8,5.3,5.9,0.6,751,639,-112,1876,2223,347,111.0,126.0,15.0,0.0,10500.0,10500.0
grama101,Alex Grammas,St. Louis Cardinals,CARDS,1,2,2,4,1962,1963,1,2.09,-0.45,-2.54,348,91,-257,1098,139,-959,0.0,0.0,0.0,0.0,0.0,0.0
granc001,Curtis Granderson,Detroit Tigers,TIGRS,4,7,9,16,2009,2021,12,18.59,52.84,34.25,720,1430,710,2838,3032,194,284.0,6457.0,6173.0,35445000.0,912000.0,-34533000.0
granc001,Curtis Granderson,New York Mets,METS,1,2,1,3,2017,2020,3,-0.24,-0.54,-0.3,36,86,50,132,1,-131,0.0,143.0,143.0,15000000.0,0.0,-15000000.0
granc001,Curtis Granderson,Toronto Blue Jays,BJAYS,1,1,1,2,2018,2018,0,0.28,0.0,-0.28,19,0,-19,54,0,-54,0.0,0.0,0.0,5000000.0,0.0,-5000000.0
grane101,Eddie Grant,Philadelphia Phillies,PHILS,12,24,28,52,1910,1931,21,100.95,91.27,-9.68,4848,5202,354,15981,18765,2784,10753.0,6282.0,-4471.0,25000.0,31850.0,6850.0
grang102,George Grantham,Chicago Cubs,CUBS,1,3,3,6,1924,1926,2,29.39,2.01,-27.38,1120,155,-965,4097,410,-3687,1929.0,802.0,-1127.0,13500.0,18700.0,5200.0
grang102,George Grantham,Cincinnati Reds,REDS,4,6,7,13,1933,1937,4,22.87,0.4,-22.47,943,284,-659,2307,797,-1510,2379.0,341.0,-2038.0,0.0,0.0,0.0
granj001,Jeff Granger,Kansas City Royals,ROYALS,1,4,2,6,1996,1997,1,2.49,5.44,2.95,410,153,-257,728,660,-68,275.0,0.0,-275.0,120000.0,7200000.0,7080000.0
granj101,Mudcat Grant,Cleveland Indians,INDINS,7,10,9,19,1964,1972,8,11.01,5.1,-5.91,1417,786,-631,1596,1203,-393,5496.0,913.0,-4583.0,36500.0,76500.0,40000.0
granj101,Mudcat Grant,Minnesota Twins,TWINS,3,7,7,14,1967,1971,4,19.69,11.71,-7.98,1089,1188,99,3536,1015,-2521,872.0,2508.0,1636.0,193000.0,192000.0,-1000.0
granj101,Mudcat Grant,Montreal Expos,NATEX,3,3,3,6,1969,1974,5,1.62,13.7,12.08,161,581,420,33,2179,2146,462.0,402.0,-60.0,37000.0,0.0,-37000.0
granj101,Mudcat Grant,Oakland Athletics,ATLTCS,1,1,1,2,1970,1970,0,0.61,0.0,-0.61,100,0,-100,11,0,-11,261.0,0.0,-261.0,37000.0,0.0,-37000.0
granm001,Mark Grant,San Francisco Giants,GIANTS,5,11,14,25,1987,1998,11,21.11,35.92,14.81,1313,2149,836,1417,3377,1960,4080.0,4148.0,68.0,9727778.0,6966667.0,-2761111.0
granm001,Mark Grant,San Diego Padres,PADRS,1,1,1,2,1990,1991,1,0.02,-0.08,-0.1,66,44,-22,6,25,19,157.0,224.0,67.0,400000.0,135000.0,-265000.0
granm001,Mark Grant,Houston Astros,ASTROS,1,1,1,2,1993,1993,0,-0.99,0.0,0.99,28,0,-28,0,0,0,43.0,0.0,-43.0,0.0,0.0,0.0
grant101,Tom Grant,Chicago Cubs,CUBS,1,1,1,2,1985,1985,0,0.0,-0.09,-0.09,0,18,18,0,0,0,0.0,38.0,38.0,0.0,0.0,0.0
granw101,Wayne Granger,St. Louis Cardinals,CARDS,4,7,5,12,1968,1971,3,20.24,2.27,-17.97,1458,401,-1057,4171,1565,-2606,1006.0,0.0,-1006.0,87500.0,15000.0,-72500.0
granw101,Wayne Granger,Cincinnati Reds,REDS,2,2,2,4,1971,1977,6,-1.75,0.51,2.26,205,287,82,16,65,49,465.0,882.0,417.0,40000.0,16000.0,-24000.0
granw101,Wayne Granger,Minnesota Twins,TWINS,1,1,2,3,1972,1977,5,-1.23,17.25,18.48,66,662,596,4,2764,2760,140.0,0.0,-140.0,42500.0,0.0,-42500.0
granw101,Wayne Granger,St. Louis Cardinals,CARDS,3,3,4,7,1973,1977,4,3.74,-0.38,-4.12,213,52,-161,136,5,-131,1249.0,111.0,-1138.0,47500.0,0.0,-47500.0
grany001,Yasmani Grandal,Cincinnati Reds,REDS,2,5,3,8,2011,2020,9,8.75,14.41,5.66,882,376,-506,2596,411,-2185,1389.0,3437.0,2048.0,9475000.0,460700.0,-9014300.0
grany001,Yasmani Grandal,San Diego Padres,PADRS,2,5,4,9,2014,2016,2,8.85,0.65,-8.2,684,254,-430,2593,1079,-1514,26.0,0.0,-26.0,1293600.0,21000000.0,19706400.0
granz001,Zack Granite,Minnesota Twins,TWINS,1,1,2,3,2019,2019,0,0.0,0.0,0.0,0,0,0,0,0,0,0.0,0.0,0.0,0.0,0.0,0.0
grasm101,Mickey Grasso,Washington Senators,TWINS,1,1,1,2,1954,1955,1,0.08,0.59,0.51,4,54,50,8,193,185,0.0,0.0,0.0,0.0,0.0,0.0
gratb001,Beiker Graterol,Toronto Blue Jays,BJAYS,1,1,1,2,1998,1999,1,-0.26,-0.11,0.15,1,1,0,0,0,0,12.0,3.0,-9.0,0.0,0.0,0.0
gratb002,Brusdar Graterol,Minnesota Twins,TWINS,1,3,3,6,2020,2020,0,-0.29,1.55,1.84,124,11,-113,74,0,-74,170.0,200.0,30.0,0.0,0.0,0.0
gratj001,Juan Graterol,Toronto Blue Jays,BJAYS,1,1,1,2,2017,2017,0,0.13,0.0,-0.13,49,0,-49,88,0,-88,0.0,0.0,0.0,0.0,0.0,0.0
gravd001,Danny Graves,Cleveland Indians,INDINS,1,4,2,6,1997,1998,1,5.24,-0.51,-5.75,1014,98,-916,190,187,-3,2567.0,112.0,-2455.0,0.0,4300000.0,4300000.0
gravk001,Kendall Graveman,Toronto Blue Jays,BJAYS,2,6,2,8,2014,2018,4,6.54,19.48,12.94,350,462,112,887,2066,1179,1411.0,0.0,-1411.0,23516100.0,500000.0,-23016100.0
gravk001,Kendall Graveman,Seattle Mariners,MARNRS,1,2,2,4,2021,2021,0,0.78,1.64,0.86,33,83,50,0,253,253,87.0,54.0,-33.0,3500000.0,4000000.0,500000.0
grayd101,Dolly Gray,Washington Senators,TWINS,5,11,10,21,1911,1926,15,13.21,49.63,36.42,1111,2437,1326,3734,9513,5779,894.0,3052.0,2158.0,21400.0,11500.0,-9900.0
grayd102,Dick Gray,Los Angeles Dodgers,DOGRS,2,4,4,8,1959,1961,2,0.06,0.34,0.28,45,76,31,67,138,71,0.0,0.0,0.0,0.0,10000.0,10000.0
grayd102,Dick Gray,St. Louis Cardinals,CARDS,16,30,25,55,1960,1972,12,32.35,16.26,-16.09,3499,2551,-948,8719,7845,-874,2795.0,1167.0,-1628.0,32500.0,24000.0,-8500.0
grayg101,Gary Gray,Texas Rangers,RNGRS,1,3,2,5,1980,1980,0,-0.55,-1.43,-0.88,28,119,91,57,205,148,0.0,0.0,0.0,0.0,0.0,0.0
grayj001,Jeff Gray,Philadelphia Phillies,PHILS,2,3,4,7,1985,1987,2,4.94,1.72,-3.22,271,272,1,922,426,-496,542.0,530.0,-12.0,1109333.0,1060833.0,-48500.0
grayj001,Jeff Gray,Cincinnati Reds,REDS,2,3,3,6,1989,1992,3,2.39,2.59,0.2,42,287,245,0,823,823,597.0,63.0,-534.0,500000.0,675000.0,175000.0
grayj002,Jeff Gray,Oakland Athletics,ATLTCS,3,6,5,11,2009,2013,4,-0.36,1.6,1.96,79,247,168,172,718,546,28.0,38.0,10.0,805000.0,2601500.0,1796500.0
grayj004,Josiah Gray,Cincinnati Reds,REDS,2,6,6,12,2018,2020,2,0.33,2.24,1.91,53,294,241,210,761,551,24.0,499.0,475.0,30700000.0,49964000.0,19264000.0
grayj004,Josiah Gray,Los Angeles Dodgers,DOGRS,1,4,2,6,2021,2021,0,0.24,4.89,4.65,47,74,27,110,252,142,188.0,205.0,17.0,0.0,47503480.0,47503480.0
grayj101,Johnny Gray,New York Yankees,YANKS,16,45,38,83,1953,1970,17,48.62,78.17,29.55,7017,4726,-2291,22732,11340,-11392,3607.0,11554.0,7947.0,313000.0,125500.0,-187500.0
grays001,Sonny Gray,Oakland Athletics,ATLTCS,2,3,4,7,2017,2021,4,1.1,-0.97,-2.07,121,69,-52,123,203,80,587.0,0.0,-587.0,3575000.0,0.0,-3575000.0
grays001,Sonny Gray,New York Yankees,YANKS,3,5,5,10,2019,2021,2,10.03,0.33,-9.7,238,102,-136,526,361,-165,1135.0,0.0,-1135.0,0.0,0.0,0.0
grays102,Sam Gray,Philadelphia Athletics,ATLTCS,1,1,1,2,1927,1935,8,15.15,12.57,-2.58,476,820,344,478,3078,2600,3927.0,0.0,-3927.0,7500.0,8000.0,500.0
grayt101,Ted Gray,Detroit Tigers,TIGRS,6,11,11,22,1954,1964,10,2.44,17.09,14.65,689,625,-64,1873,996,-877,460.0,3101.0,2641.0,37500.0,0.0,-37500.0
grbae101,Eli Grba,Boston Red Sox,RSOX,1,2,1,3,1957,1957,0,-2.46,0.0,2.46,96,0,-96,53,0,-53,393.0,0.0,-393.0,0.0,0.0,0.0
greab101,Bill Greason,OklahomaCity,OklahomaCity,1,1,3,4,1953,1953,0,-0.45,0.0,0.45,6,0,-6,1,0,-1,12.0,0.0,-12.0,0.0,0.0,0.0
greea101,Al Greene,Detroit Tigers,TIGRS,1,2,1,3,1980,1981,1,1.37,0.54,-0.83,153,67,-86,89,195,106,831.0,0.0,-831.0,0.0,0.0,0.0
greec001,Chris Green,Pittsburgh Pirates,PIRATS,1,1,1,2,1986,1986,0,0.0,0.0,0.0,0,0,0,0,0,0,0.0,0.0,0.0,0.0,0.0,0.0
greec003,Chad Green,Detroit Tigers,TIGRS,2,4,4,8,2015,2017,2,11.2,2.36,-8.84,625,142,-483,120,106,-14,2199.0,297.0,-1902.0,4700000.0,556000.0,-4144000.0
greec004,Conner Greene,Toronto Blue Jays,BJAYS,1,2,1,3,2018,2018,0,-0.49,2.45,2.94,137,124,-13,0,462,462,194.0,0.0,-194.0,0.0,0.0,0.0
greed001,David Green,Milwaukee Brewers,BREWRS,2,5,6,11,1980,1986,6,6.59,20.26,13.67,970,997,27,2159,3010,851,2112.0,2376.0,264.0,0.0,0.0,0.0
greed001,David Green,St. Louis Cardinals,CARDS,1,4,1,5,1985,1987,2,10.04,9.7,-0.34,1204,322,-882,3785,1371,-2414,620.0,0.0,-620.0,0.0,0.0,0.0
greed001,David Green,San Francisco Giants,GIANTS,1,1,1,2,1985,1985,0,0.0,0.0,0.0,0,0,0,0,0,0,0.0,0.0,0.0,275000.0,0.0,-275000.0
greeg002,Grant Green,Oakland Athletics,ATLTCS,1,1,1,2,2013,2014,1,-0.66,-0.57,0.09,104,177,73,284,631,347,0.0,0.0,0.0,0.0,0.0,0.0
greeg101,Gene Green,St. Louis Cardinals,CARDS,2,3,4,7,1959,1962,3,0.6,1.14,0.54,42,87,45,78,232,154,0.0,0.0,0.0,0.0,0.0,0.0
greeg101,Gene Green,Washington Senators,RNGRS,4,7,5,12,1961,1970,9,4.25,0.29,-3.96,404,337,-67,701,1154,453,1913.0,6.0,-1907.0,0.0,8000.0,8000.0
greeg101,Gene Green,Cleveland Indians,INDINS,1,1,1,2,1963,1963,0,-0.27,0.12,0.39,15,4,-11,32,10,-22,0.0,0.0,0.0,0.0,0.0,0.0
greej102,Jim Greengrass,New York Yankees,YANKS,1,5,1,6,1952,1955,3,5.35,0.52,-4.83,390,26,-364,1419,10,-1409,46.0,107.0,61.0,0.0,13500.0,13500.0
greej102,Jim Greengrass,Cincinnati Reds,REDS,5,10,14,24,1955,1965,10,64.57,18.03,-46.54,3586,1613,-1973,11340,3264,-8076,2563.0,1025.0,-1538.0,13500.0,15500.0,2000.0
greek001,Kenny Greer,New York Yankees,YANKS,1,1,1,2,1993,1993,0,0.09,0.21,0.12,2,3,1,0,0,0,3.0,59.0,56.0,0.0,1500000.0,1500000.0
greek002,Khalil Greene,San Diego Padres,PADRS,4,6,8,14,2008,2017,9,1.65,6.5,4.85,532,1193,661,1084,541,-543,521.0,1678.0,1157.0,16394700.0,4718500.0,-11676200.0
greek101,Kent Greenfield,New York Giants,GIANTS,2,4,4,8,1927,1930,3,-1.4,7.13,8.53,721,460,-261,1415,1177,-238,3501.0,2253.0,-1248.0,8500.0,35000.0,26500.0
greek101,Kent Greenfield,Portsmouth,Portsmouth,1,2,1,3,1923,1923,0,2.21,0.0,-2.21,334,0,-334,792,0,-792,1269.0,0.0,-1269.0,0.0,0.0,0.0
greel101,Lenny Green,Baltimore Orioles,ORLS,1,1,1,2,1959,1960,1,6.84,0.08,-6.76,700,128,-572,2356,253,-2103,0.0,0.0,0.0,0.0,0.0,0.0
greel101,Lenny Green,Minnesota Twins,TWINS,1,2,2,4,1964,1966,2,-1.17,-1.3,-0.13,231,246,15,550,644,94,0.0,0.0,0.0,15000.0,0.0,-15000.0
green001,Nick Green,Atlanta Braves,BRAVES,2,2,2,4,2005,2006,1,0.02,3.13,3.11,166,137,-29,424,63,-361,92.0,664.0,572.0,2200000.0,0.0,-2200000.0
green001,Nick Green,Baltimore Orioles,ORLS,1,2,1,3,2011,2012,1,0.0,0.4,0.4,0,16,16,0,0,0,0.0,42.0,42.0,0.0,0.0,0.0
green002,Nick Greenwood,San Diego Padres,PADRS,1,2,1,3,2010,2011,1,-0.23,-0.64,-0.41,39,160,121,6,664,658,108.0,0.0,-108.0,0.0,5450000.0,5450000.0
green101,Nelson Greene,Brooklyn Dodgers,DOGRS,1,2,1,3,1924,1924,0,0.0,-1.0,-1.0,0,22,22,0,8,8,0.0,76.0,76.0,2100.0,0.0,-2100.0
green101,Nelson Greene,Brooklyn Dodgers,DOGRS,2,4,2,6,1925,1931,6,-1.16,1.81,2.97,36,399,363,37,1222,1185,282.0,591.0,309.0,7500.0,0.0,-7500.0
greep101,Paddy Greene,New York Yankees,YANKS,1,1,1,2,1903,1903,0,-0.15,0.23,0.38,1,18,17,3,23,20,0.0,180.0,180.0,0.0,0.0,0.0
greep102,Pumpsie Green,Boston Red Sox,RSOX,2,4,2,6,1962,1966,4,1.63,7.14,5.51,379,407,28,759,1449,690,1141.0,0.0,-1141.0,0.0,0.0,0.0
greer002,Rick Greene,Detroit Tigers,TIGRS,3,5,3,8,1997,2009,12,-1.75,6.44,8.19,380,244,-136,75,32,-43,652.0,3275.0,2623.0,4485000.0,215000.0,-4270000.0
grees001,Shawn Green,Toronto Blue Jays,BJAYS,2,3,3,6,1999,2003,4,23.05,6.03,-17.02,967,477,-490,4167,1414,-2753,0.0,331.0,331.0,14125000.0,9375000.0,-4750000.0
grees001,Shawn Green,Los Angeles Dodgers,DOGRS,2,4,7,11,2005,2007,2,2.23,0.73,-1.5,859,205,-654,2999,398,-2601,426.0,593.0,167.0,682000.0,4200000.0,3518000.0
grees001,Shawn Green,Arizona Diamondbacks,DBACKS,1,2,1,3,2006,2009,3,0.23,0.0,-0.23,164,0,-164,617,0,-617,0.0,0.0,0.0,10213898.0,0.0,-10213898.0
grees004,Sean Green,Colorado Rockies,ROCKS,1,1,1,2,2004,2005,1,0.62,0.0,-0.62,171,0,-171,1,0,-1,537.0,0.0,-537.0,0.0,302500.0,302500.0
grees004,Sean Green,Seattle Mariners,MARNRS,8,16,16,32,2008,2015,7,0.83,32.43,31.6,1230,1763,533,2304,5784,3480,1045.0,2794.0,1749.0,18727500.0,18500000.0,-227500.0
grees005,Shane Greene,New York Yankees,YANKS,1,1,1,2,2014,2019,5,1.37,15.06,13.69,259,660,401,7,2658,2651,939.0,0.0,-939.0,0.0,0.0,0.0
grees005,Shane Greene,Detroit Tigers,TIGRS,1,1,2,3,2019,2021,2,0.82,-1.28,-2.1,117,67,-50,0,219,219,208.0,3.0,-205.0,4000000.0,0.0,-4000000.0
greet001,Tommy Greene,Atlanta Braves,BRAVES,3,4,5,9,1990,1991,1,7.07,0.22,-6.85,460,126,-334,1122,43,-1079,1808.0,218.0,-1590.0,2100000.0,1400000.0,-700000.0
greet004,Tyler Greene,Atlanta Braves,BRAVES,1,1,1,2,2014,2014,0,0.0,0.0,0.0,0,0,0,0,0,0,0.0,0.0,0.0,0.0,0.0,0.0
greew001,Willie Greene,Pittsburgh Pirates,PIRATS,1,3,1,4,1990,1994,4,13.0,10.16,-2.84,782,221,-561,2388,261,-2127,274.0,2055.0,1781.0,200000.0,860000.0,660000.0
greew001,Willie Greene,Montreal Expos,NATEX,2,4,4,8,1991,2001,10,7.84,6.46,-1.38,825,557,-268,1993,412,-1581,539.0,721.0,182.0,287500.0,0.0,-287500.0
greew001,Willie Greene,Cincinnati Reds,REDS,4,5,7,12,1998,2006,8,1.72,4.6,2.88,743,525,-218,1103,1018,-85,650.0,1259.0,609.0,12068333.0,8583333.0,-3485000.0
gregd001,Didi Gregorius,Cincinnati Reds,REDS,1,2,3,5,2012,2013,1,2.65,4.63,1.98,183,154,-29,703,712,9,0.0,0.0,0.0,527500.0,0.0,-527500.0
gregd001,Didi Gregorius,Arizona Diamondbacks,DBACKS,2,3,3,6,2014,2021,7,21.95,8.64,-13.31,699,318,-381,2663,315,-2348,642.0,2399.0,1757.0,9936500.0,0.0,-9936500.0
gregd101,Dave Gregg,Toledo,Toledo,1,1,1,2,1913,1913,0,-0.14,0.0,0.14,2,0,-2,0,0,0,3.0,0.0,-3.0,0.0,2400.0,2400.0
gregh102,Hal Gregg,Brooklyn Dodgers,DOGRS,3,7,9,16,1947,1954,7,6.69,26.56,19.87,628,1156,528,1259,3340,2081,1417.0,3832.0,2415.0,38000.0,0.0,-38000.0
gregh102,Hal Gregg,Oakland,Oakland,1,1,2,3,1952,1956,4,-0.43,0.0,0.43,34,0,-34,8,0,-8,109.0,0.0,-109.0,0.0,7000.0,7000.0
gregk001,Kevin Gregg,Anaheim Angels,ANGELS,1,1,1,2,2006,2007,1,2.03,0.06,-1.97,308,4,-304,3,0,-3,485.0,13.0,-472.0,0.0,327000.0,327000.0
gregk001,Kevin Gregg,Florida Marlins,MARLNS,1,1,1,2,2008,2013,5,0.59,0.05,-0.54,262,49,-213,0,2,2,392.0,87.0,-305.0,2500000.0,0.0,-2500000.0
gregl001,Luke Gregerson,St. Louis Cardinals,CARDS,1,2,1,3,2009,2009,0,4.04,-0.85,-4.89,717,77,-640,3,193,190,1041.0,0.0,-1041.0,0.0,0.0,0.0
gregl001,Luke Gregerson,San Diego Padres,PADRS,3,5,6,11,2013,2017,4,2.5,2.46,-0.04,455,476,21,891,538,-353,521.0,637.0,116.0,11894700.0,4718500.0,-7176200.0
gregl101,Lee Gregory,St. Louis Cardinals,CARDS,1,1,1,2,1964,1964,0,0.17,0.0,-0.17,30,0,-30,16,0,-16,54.0,0.0,-54.0,0.0,0.0,0.0
gregt001,Tommy Gregg,Pittsburgh Pirates,PIRATS,2,2,3,5,1988,1989,1,0.52,-0.99,-1.51,423,44,-379,879,104,-775,0.0,11.0,11.0,725000.0,725000.0,0.0
gregt002,Tom Gregorio,Anaheim Angels,ANGELS,1,1,1,2,2005,2005,0,0.0,0.0,0.0,0,0,0,0,0,0,0.0,0.0,0.0,0.0,0.0,0.0
gregv101,Vean Gregg,Cleveland Indians,INDINS,3,5,6,11,1914,1922,8,0.11,10.79,10.68,102,505,403,66,456,390,663.0,3001.0,2338.0,0.0,0.0,0.0
gregv101,Vean Gregg,Boston Red Sox,RSOX,22,48,61,109,1917,1937,20,205.66,131.1,-74.56,9653,6423,-3230,27902,20755,-7147,27230.0,14799.0,-12431.0,136800.0,133950.0,-2850.0
greib101,Bill Greif,Houston Astros,ASTROS,7,14,10,24,1971,1989,18,9.86,19.8,9.94,2403,1970,-433,5583,4832,-751,5444.0,4390.0,-1054.0,22500.0,16500.0,-6000.0
greib101,Bill Greif,San Diego Padres,PADRS,1,1,1,2,1976,1977,1,-0.24,-0.42,-0.18,94,80,-14,6,127,121,164.0,0.0,-164.0,0.0,0.0,0.0
greib101,Bill Greif,St. Louis Cardinals,CARDS,7,10,11,21,1976,1992,16,18.25,16.78,-1.47,1455,1377,-78,2974,3172,198,3388.0,4921.0,1533.0,1943333.0,497500.0,-1445833.0
greiz001,Zack Greinke,Kansas City Royals,ROYALS,4,9,9,18,2010,2021,11,13.5,49.72,36.22,866,2766,1900,2084,9673,7589,3154.0,2429.0,-725.0,26600000.0,13058267.0,-13541733.0
greiz001,Zack Greinke,Milwaukee Brewers,BREWRS,7,12,13,25,2012,2020,8,1.1,20.23,19.13,785,1060,275,2514,3316,802,669.0,2064.0,1395.0,20000000.0,0.0,-20000000.0
greiz001,Zack Greinke,Arizona Diamondbacks,DBACKS,1,2,4,6,2019,2019,0,3.35,-0.09,-3.44,54,41,-13,4,157,153,902.0,0.0,-902.0,34500000.0,0.0,-34500000.0
greyb101,Bill Gray,Cincinnati Reds,REDS,1,5,3,8,1897,1900,3,8.1,12.35,4.25,718,395,-323,2747,1335,-1412,936.0,1747.0,811.0,0.0,0.0,0.0
greyb101,Bill Gray,Pittsburgh Pirates,PIRATS,2,5,2,7,1898,1910,12,14.38,28.41,14.03,866,1321,455,3143,5735,2592,1417.0,0.0,-1417.0,0.0,0.0,0.0
gricr001,Randal Grichuk,Anaheim Angels,ANGELS,2,3,3,6,2013,2016,3,6.81,4.69,-2.12,768,456,-312,1907,981,-926,187.0,536.0,349.0,0.0,3662000.0,3662000.0
gricr001,Randal Grichuk,St. Louis Cardinals,CARDS,1,1,2,3,2018,2019,1,4.32,-0.49,-4.81,479,137,-342,1866,0,-1866,0.0,194.0,194.0,0.0,0.0,0.0
grieb001,Ben Grieve,Oakland Athletics,ATLTCS,3,5,7,12,2001,2013,12,5.33,35.82,30.49,448,1285,837,1697,5045,3348,578.0,1155.0,577.0,8550000.0,0.0,-8550000.0
grieb001,Ben Grieve,Milwaukee Brewers,BREWRS,1,1,2,3,2004,2006,2,0.08,0.0,-0.08,38,0,-38,44,0,-44,0.0,0.0,0.0,700000.0,300000.0,-400000.0
griet101,Tom Grieve,Texas Rangers,RNGRS,4,9,7,16,1977,1988,11,6.15,29.07,22.92,381,2027,1646,1490,7192,5702,0.0,2974.0,2974.0,330000.0,0.0,-330000.0
griet101,Tom Grieve,New York Mets,METS,1,2,1,3,1978,1982,4,0.21,5.06,4.85,63,290,227,20,185,165,77.0,1823.0,1746.0,0.0,0.0,0.0
grifa001,Alfredo Griffin,Cleveland Indians,INDINS,6,12,11,23,1978,2004,26,33.86,55.28,21.42,2512,2636,124,9309,9198,-111,2682.0,4270.0,1588.0,1767500.0,1412500.0,-355000.0
grifa001,Alfredo Griffin,Toronto Blue Jays,BJAYS,1,3,1,4,1984,1987,3,7.47,0.63,-6.84,580,109,-471,2252,0,-2252,0.0,317.0,317.0,650000.0,0.0,-650000.0
grifa001,Alfredo Griffin,Oakland Athletics,ATLTCS,1,4,2,6,1987,1994,7,8.57,10.76,2.19,979,216,-763,1815,1,-1814,1096.0,3814.0,2718.0,1137653.0,1187500.0,49847.0
grifb101,Bert Griffith,Brooklyn Dodgers,DOGRS,4,10,4,14,1923,1934,11,0.38,8.57,8.19,106,828,722,108,3039,2931,677.0,26.0,-651.0,36000.0,12000.0,-24000.0
grifb101,Bert Griffith,Washington Senators,TWINS,1,3,1,4,1924,1927,3,0.0,0.0,0.0,0,0,0,0,0,0,0.0,0.0,0.0,2800.0,0.0,-2800.0
grifd101,Doug Griffin,California Angels,ANGELS,3,6,8,14,1970,1974,4,2.03,2.21,0.18,1109,432,-677,3640,1513,-2127,261.0,88.0,-173.0,44000.0,159000.0,115000.0
grifd102,Derrell Griffith,Los Angeles Dodgers,DOGRS,6,9,10,19,1966,1972,6,27.49,11.4,-16.09,1888,711,-1177,5026,2330,-2696,1193.0,6.0,-1187.0,136500.0,38000.0,-98500.0
grifd102,Derrell Griffith,New York Mets,METS,3,4,4,8,1967,1970,3,-1.49,0.23,1.72,346,159,-187,991,489,-502,0.0,0.0,0.0,55000.0,20000.0,-35000.0
grifd102,Derrell Griffith,Houston Astros,ASTROS,1,2,2,4,1967,1972,5,0.31,-3.37,-3.68,194,234,40,17,135,118,428.0,1228.0,800.0,0.0,0.0,0.0
grifh101,Hank Griffin,Chicago Cubs,CUBS,3,6,7,13,1911,1916,5,-3.91,1.45,5.36,376,507,131,960,1665,705,899.0,27.0,-872.0,4500.0,0.0,-4500.0
grifi101,Ivy Griffin,Philadelphia Athletics,ATLTCS,1,5,1,6,1922,1929,7,0.0,12.22,12.22,0,592,592,0,2318,2318,0.0,0.0,0.0,0.0,0.0,0.0
grifj001,Jeremy Griffiths,New York Mets,METS,1,2,1,3,2004,2004,0,-0.5,0.91,1.41,53,86,33,2,359,357,109.0,0.0,-109.0,3933333.0,12500000.0,8566667.0
grifj002,John-Ford Griffin,New York Yankees,YANKS,2,7,2,9,2002,2005,3,6.71,3.6,-3.11,546,85,-461,184,2,-182,2652.0,1328.0,-1324.0,4387150.0,15714286.0,11327136.0
grifj002,John-Ford Griffin,Oakland Athletics,ATLTCS,3,3,3,6,2003,2009,6,0.84,3.82,2.98,64,236,172,194,804,610,0.0,0.0,0.0,410000.0,0.0,-410000.0
grifk001,Ken Griffey,Cincinnati Reds,REDS,2,4,4,8,1981,1989,8,6.72,5.28,-1.44,695,466,-229,2438,1697,-741,243.0,30.0,-213.0,817500.0,620000.0,-197500.0
grifk001,Ken Griffey,New York Yankees,YANKS,1,2,2,4,1986,1988,2,1.46,3.1,1.64,271,317,46,976,1061,85,0.0,0.0,0.0,1050000.0,750000.0,-300000.0
grifk002,Ken Griffey Jr.,Seattle Mariners,MARNRS,17,30,34,64,2000,2015,15,51.65,63.75,12.1,4345,3730,-615,13706,12979,-727,4049.0,3175.0,-874.0,33352500.0,21921000.0,-11431500.0
grifk002,Ken Griffey Jr.,Cincinnati Reds,REDS,1,2,2,4,2008,2013,5,0.44,3.05,2.61,41,495,454,150,49,-101,0.0,721.0,721.0,8282695.0,396000.0,-7886695.0
grifm001,Mike Griffin,Texas Rangers,RNGRS,8,18,14,32,1978,1986,8,37.88,13.97,-23.91,1966,931,-1035,3128,2213,-915,8593.0,2102.0,-6491.0,0.0,250000.0,250000.0
grifm001,Mike Griffin,New York Yankees,YANKS,1,3,1,4,1981,1983,2,0.87,1.55,0.68,126,12,-114,98,0,-98,955.0,212.0,-743.0,0.0,0.0,0.0
grifm001,Mike Griffin,Chicago Cubs,CUBS,1,1,1,2,1982,1982,0,0.0,-0.55,-0.55,0,48,48,0,50,50,0.0,0.0,0.0,0.0,0.0,0.0
grifm001,Mike Griffin,Montreal Expos,NATEX,2,2,2,4,1982,1983,1,0.04,0.0,-0.04,14,0,-14,1,0,-1,31.0,0.0,-31.0,0.0,0.0,0.0
grifp101,Pug Griffin,Philadelphia Athletics,ATLTCS,2,7,4,11,1917,1920,3,0.98,1.52,0.54,143,229,86,582,916,334,0.0,0.0,0.0,2400.0,0.0,-2400.0
grift101,Tom Griffin,San Francisco Giants,GIANTS,1,1,1,2,1981,1981,0,-0.96,0.0,0.96,12,0,-12,9,0,-9,67.0,0.0,-67.0,0.0,0.0,0.0
grift102,Tommy Griffith,Cincinnati Reds,REDS,1,1,1,2,1919,1919,0,3.75,1.68,-2.07,724,140,-584,2836,613,-2223,0.0,0.0,0.0,0.0,0.0,0.0
grift102,Tommy Griffith,Brooklyn Dodgers,DOGRS,2,3,2,5,1925,1927,2,0.17,-0.34,-0.51,76,100,24,262,384,122,0.0,0.0,0.0,17500.0,0.0,-17500.0
griga101,Art Griggs,St.Louis Browns,ORLS,1,1,1,2,1910,1919,9,2.06,-0.66,-2.72,116,82,-34,397,292,-105,0.0,0.0,0.0,0.0,0.0,0.0
grilg101,Guido Grilli,Boston Red Sox,RSOX,2,6,4,10,1966,1969,3,1.66,1.54,-0.12,432,533,101,910,683,-227,275.0,859.0,584.0,24500.0,15000.0,-9500.0
grilj001,Jason Grilli,San Francisco Giants,GIANTS,2,5,3,8,1999,2005,6,17.71,7.22,-10.49,680,557,-123,659,309,-350,4495.0,2909.0,-1586.0,0.0,1875000.0,1875000.0
grilj001,Jason Grilli,Detroit Tigers,TIGRS,1,1,1,2,2008,2008,0,1.2,0.0,-1.2,141,0,-141,6,0,-6,242.0,0.0,-242.0,420000.0,0.0,-420000.0
grilj001,Jason Grilli,Pittsburgh Pirates,PIRATS,1,1,1,2,2014,2014,0,0.1,-0.62,-0.72,41,28,-13,0,0,0,101.0,32.0,-69.0,0.0,0.0,0.0
grilj001,Jason Grilli,Atlanta Braves,BRAVES,1,2,1,3,2016,2016,0,0.03,0.0,-0.03,78,0,-78,0,0,0,188.0,0.0,-188.0,0.0,0.0,0.0
grilj001,Jason Grilli,Toronto Blue Jays,BJAYS,1,2,1,3,2017,2017,0,-0.02,0.0,0.02,22,0,-22,0,0,0,58.0,0.0,-58.0,0.0,0.0,0.0
grimb101,Burleigh Grimes,Pittsburgh Pirates,PIRATS,2,4,3,7,1918,1922,4,39.97,14.96,-25.01,1164,899,-265,2135,3669,1534,8893.0,0.0,-8893.0,4200.0,5000.0,800.0
grimb101,Burleigh Grimes,Brooklyn Dodgers,DOGRS,1,1,1,2,1927,1929,2,2.81,-0.59,-3.4,78,149,71,106,431,325,779.0,0.0,-779.0,0.0,0.0,0.0
grimb101,Burleigh Grimes,New York Giants,GIANTS,1,1,1,2,1928,1928,0,12.49,0.02,-12.47,178,44,-134,244,42,-202,1772.0,358.0,-1414.0,0.0,0.0,0.0
grimb101,Burleigh Grimes,Pittsburgh Pirates,PIRATS,1,1,2,3,1930,1930,0,-1.31,-0.46,0.85,22,18,-4,19,2,-17,147.0,56.0,-91.0,0.0,0.0,0.0
grimb101,Burleigh Grimes,Boston Braves,BRAVES,10,24,17,41,1930,1952,22,35.57,94.87,59.3,2172,4248,2076,6853,14670,7817,2997.0,6404.0,3407.0,20000.0,18000.0,-2000.0
grimb101,Burleigh Grimes,St. Louis Cardinals,CARDS,2,2,4,6,1931,1932,1,5.37,0.0,-5.37,413,0,-413,1236,0,-1236,633.0,0.0,-633.0,20000.0,33000.0,13000.0
grimb101,Burleigh Grimes,Birmingham,Birmingham,1,1,4,5,1916,1922,6,12.32,0.0,-12.32,269,0,-269,337,0,-337,2483.0,0.0,-2483.0,0.0,5450.0,5450.0
grimb102,Bob Grim,New York Yankees,YANKS,1,2,2,4,1958,1960,2,2.31,-2.84,-5.15,242,240,-2,336,102,-234,756.0,1048.0,292.0,12500.0,0.0,-12500.0
grimb102,Bob Grim,Kansas City Athletics,ATLTCS,1,1,1,2,1960,1960,0,-0.36,1.48,1.84,6,40,34,0,3,3,7.0,62.0,55.0,0.0,0.0,0.0
grimc101,Charlie Grimm,Pittsburgh Pirates,PIRATS,4,6,7,13,1924,1932,8,11.08,42.87,31.79,1606,1347,-259,6101,4357,-1744,1307.0,3847.0,2540.0,22300.0,13500.0,-8800.0
grime101,Ed Grimes,St.Louis Browns,ORLS,2,4,3,7,1932,1938,6,5.05,3.68,-1.37,140,456,316,175,291,116,1317.0,2656.0,1339.0,9500.0,3300.0,-6200.0
grimj001,Jason Grimsley,Philadelphia Phillies,PHILS,4,4,8,12,1992,2006,14,30.94,46.36,15.42,397,1304,907,351,2404,2053,4627.0,8300.0,3673.0,11600000.0,6125000.0,-5475000.0
grimj001,Jason Grimsley,Cleveland Indians,INDINS,1,2,1,3,1996,1997,1,1.47,1.07,-0.4,162,18,-144,0,0,0,907.0,298.0,-609.0,0.0,0.0,0.0
grimj001,Jason Grimsley,Milwaukee Brewers,BREWRS,1,1,1,2,1997,1998,1,4.34,0.0,-4.34,264,0,-264,0,0,0,760.0,0.0,-760.0,0.0,0.0,0.0
grimj001,Jason Grimsley,Kansas City Royals,ROYALS,2,3,3,6,2004,2009,5,-1.41,0.68,2.09,292,164,-128,3,478,475,480.0,366.0,-114.0,2335500.0,662000.0,-1673500.0
grimj002,Justin Grimm,Texas Rangers,RNGRS,1,4,1,5,2013,2013,0,4.33,-0.09,-4.42,1129,13,-1116,283,0,-283,1426.0,253.0,-1173.0,0.0,0.0,0.0
grimm101,Moose Grimshaw,Boston Red Sox,RSOX,10,27,24,51,1907,1935,28,51.77,27.79,-23.98,3792,3187,-605,15081,11693,-3388,0.0,1203.0,1203.0,48850.0,29350.0,-19500.0
grimo101,Oscar Grimes,Cleveland Indians,INDINS,5,7,7,14,1942,1948,6,26.71,21.32,-5.39,1251,1052,-199,4956,4042,-914,0.0,0.0,0.0,29000.0,37900.0,8900.0
grimr101,Ross Grimsley,Cincinnati Reds,REDS,2,3,4,7,1973,1977,4,7.62,0.16,-7.46,351,195,-156,338,503,165,2723.0,0.0,-2723.0,29000.0,40000.0,11000.0
grimr101,Ross Grimsley,Montreal Expos,NATEX,1,1,1,2,1980,1980,0,-1.41,0.0,1.41,14,0,-14,0,0,0,224.0,0.0,-224.0,229167.0,0.0,-229167.0
grisl101,Lee Grissom,Cincinnati Reds,REDS,3,3,3,6,1940,1948,8,0.07,11.26,11.19,117,558,441,142,748,606,213.0,1829.0,1616.0,0.0,0.0,0.0
grisl101,Lee Grissom,Brooklyn Dodgers,DOGRS,2,2,3,5,1941,1947,6,1.33,-0.05,-1.38,58,57,-1,40,29,-11,394.0,140.0,-254.0,0.0,0.0,0.0
grism001,Marquis Grissom,Montreal Expos,NATEX,5,6,8,14,1995,2000,5,7.84,1.6,-6.24,980,825,-155,3324,2152,-1172,362.0,850.0,488.0,2625000.0,373000.0,-2252000.0
grism001,Marquis Grissom,Atlanta Braves,BRAVES,2,3,3,6,1997,1999,2,12.97,6.11,-6.86,700,430,-270,2648,565,-2083,105.0,396.0,291.0,575000.0,700000.0,125000.0
grism001,Marquis Grissom,Cleveland Indians,INDINS,5,7,8,15,1997,2003,6,-0.44,6.0,6.44,740,264,-476,1919,1,-1918,857.0,949.0,92.0,9150000.0,8990000.0,-160000.0
grism001,Marquis Grissom,Milwaukee Brewers,BREWRS,1,2,1,3,2001,2001,0,1.1,0.82,-0.28,246,126,-120,839,432,-407,0.0,0.0,0.0,0.0,0.0,0.0
grism101,Marv Grissom,Detroit Tigers,TIGRS,1,2,1,3,1951,1951,0,0.0,-0.4,-0.4,0,12,12,0,2,2,0.0,32.0,32.0,0.0,0.0,0.0
grism101,Marv Grissom,Seattle,Seattle,1,2,4,6,1951,1954,3,0.74,0.0,-0.74,138,0,-138,86,0,-86,741.0,0.0,-741.0,0.0,0.0,0.0
grism101,Marv Grissom,Chicago White Sox,WSOX,1,3,1,4,1953,1953,0,1.18,-0.21,-1.39,202,44,-158,118,143,25,1116.0,0.0,-1116.0,0.0,0.0,0.0
grism101,Marv Grissom,San Francisco Giants,GIANTS,2,4,4,8,1958,1961,3,20.2,2.2,-18.0,530,255,-275,497,641,144,4103.0,59.0,-4044.0,0.0,0.0,0.0
grist001,Trent Grisham,Milwaukee Brewers,BREWRS,1,2,3,5,2019,2019,0,7.39,0.0,-7.39,203,0,-203,779,0,-779,208.0,0.0,-208.0,2600000.0,1118900.0,-1481100.0
groad101,Dick Groat,Pittsburgh Pirates,PIRATS,4,6,6,12,1962,1968,6,15.1,3.94,-11.16,878,326,-552,2528,282,-2246,1540.0,2303.0,763.0,46000.0,24500.0,-21500.0
groad101,Dick Groat,St. Louis Cardinals,CARDS,11,23,19,42,1965,1972,7,31.6,1.61,-29.99,3237,670,-2567,8420,1434,-6986,1865.0,703.0,-1162.0,32500.0,24000.0,-8500.0
grobc101,Connie Grob,Milwaukee Braves,BRAVES,1,3,1,4,1962,1963,1,3.88,-0.09,-3.97,176,64,-112,179,177,-2,1524.0,0.0,-1524.0,0.0,0.0,0.0
grohh101,Heinie Groh,New York Giants,GIANTS,1,4,1,5,1913,1913,0,44.86,-0.25,-45.11,1467,52,-1415,5586,39,-5547,1664.0,335.0,-1329.0,8100.0,3800.0,-4300.0
grohh101,Heinie Groh,Cincinnati Reds,REDS,1,1,3,4,1921,1925,4,7.56,3.43,-4.13,420,403,-17,1780,1818,38,0.0,0.0,0.0,10591.0,15208.0,4617.0
groms101,Steve Gromek,Cleveland Indians,INDINS,4,8,7,15,1953,1960,7,29.6,3.08,-26.52,1527,466,-1061,3515,525,-2990,4632.0,1595.0,-3037.0,15900.0,10000.0,-5900.0
groob001,Buddy Groom,Detroit Tigers,TIGRS,4,6,4,10,1995,2009,14,-2.11,6.35,8.46,408,430,22,75,32,-43,697.0,3649.0,2952.0,4675000.0,324000.0,-4351000.0
grosd101,Don Gross,Cincinnati Reds,REDS,2,2,3,5,1957,1966,9,-2.01,22.27,24.28,196,568,372,66,607,541,713.0,4957.0,4244.0,0.0,0.0,0.0
grosg001,Greg Gross,Houston Astros,ASTROS,1,1,1,2,1976,1981,5,0.43,-1.49,-1.92,239,296,57,670,901,231,0.0,0.0,0.0,0.0,0.0,0.0
grosg001,Greg Gross,Chicago Cubs,CUBS,9,17,19,36,1979,1990,11,20.77,12.9,-7.87,2689,1303,-1386,6948,2680,-4268,1072.0,3217.0,2145.0,890000.0,85000.0,-805000.0
grosg002,Gabe Gross,Toronto Blue Jays,BJAYS,1,3,2,5,2005,2010,5,4.16,12.24,8.08,549,739,190,828,2857,2029,2736.0,120.0,-2616.0,627000.0,446000.0,-181000.0
grosg002,Gabe Gross,Milwaukee Brewers,BREWRS,1,1,1,2,2008,2012,4,2.02,-0.11,-2.13,242,6,-236,671,0,-671,0.0,12.0,12.0,414000.0,0.0,-414000.0
grosk001,Kevin Gross,Philadelphia Phillies,PHILS,2,4,4,8,1988,1996,8,2.03,7.62,5.59,231,685,454,173,1139,966,1239.0,2303.0,1064.0,1200000.0,2350000.0,1150000.0
grosk002,Kip Gross,New York Mets,METS,1,2,2,4,1989,2004,15,4.69,11.0,6.31,316,1372,1056,62,15,-47,932.0,2108.0,1176.0,300000.0,1067500.0,767500.0
grosk002,Kip Gross,Cincinnati Reds,REDS,7,10,14,24,1991,2006,15,9.83,13.67,3.84,1375,1603,228,1854,3165,1311,1702.0,3067.0,1365.0,19601333.0,9770833.0,-9830500.0
grosr001,Robbie Grossman,Pittsburgh Pirates,PIRATS,1,3,1,4,2012,2014,2,1.62,0.18,-1.44,191,63,-128,764,59,-705,17.0,493.0,476.0,0.0,0.0,0.0
grost101,Turkey Gross,SanAntonio,SanAntonio,1,1,1,2,1924,1924,0,-0.26,0.0,0.26,9,0,-9,34,0,-34,0.0,0.0,0.0,0.0,3300.0,3300.0
grost101,Turkey Gross,SanAntonio,SanAntonio,1,5,1,6,1923,1923,0,9.54,0.0,-9.54,1176,0,-1176,4721,0,-4721,0.0,0.0,0.0,0.0,0.0,0.0
grosw001,Wayne Gross,Oakland Athletics,ATLTCS,2,2,3,5,1983,1984,1,4.95,0.0,-4.95,346,0,-346,690,0,-690,276.0,0.0,-276.0,0.0,0.0,0.0
grote101,Ernest Groth,Cleveland Indians,INDINS,1,2,1,3,1948,1949,1,0.65,0.86,0.21,84,50,-34,82,13,-69,618.0,186.0,-432.0,0.0,10000.0,10000.0
grote101,Ernest Groth,New York Yankees,YANKS,1,3,1,4,1949,1949,0,0.0,0.1,0.1,0,28,28,0,3,3,0.0,80.0,80.0,0.0,0.0,0.0
grotj001,Jeff Grotewold,Philadelphia Phillies,PHILS,1,1,1,2,1993,1993,0,0.0,0.0,0.0,0,0,0,0,0,0,0.0,0.0,0.0,0.0,0.0,0.0
grotj101,Jerry Grote,Houston Astros,ASTROS,1,1,2,3,1965,1965,0,15.65,0.0,-15.65,1235,0,-1235,4335,0,-4335,0.0,0.0,0.0,0.0,0.0,0.0
grotj101,Jerry Grote,New York Mets,METS,2,3,3,6,1977,1983,6,-0.2,0.72,0.92,61,17,-44,115,53,-62,0.0,0.0,0.0,0.0,0.0,0.0
grotj102,Johnny Groth,Detroit Tigers,TIGRS,13,25,26,51,1952,1968,16,25.92,52.07,26.15,2610,3104,494,6934,6097,-837,4331.0,10073.0,5742.0,79500.0,15900.0,-63600.0
grotj102,Johnny Groth,Baltimore Orioles,ORLS,6,12,12,24,1954,1960,6,16.12,9.55,-6.57,902,1031,129,2238,2995,757,2291.0,1208.0,-1083.0,10000.0,0.0,-10000.0
grotj102,Johnny Groth,Chicago White Sox,WSOX,17,31,30,61,1955,1969,14,22.96,44.36,21.4,3375,3578,203,7415,6981,-434,5139.0,7668.0,2529.0,156750.0,157500.0,750.0
grotm001,Matt Grott,Oakland Athletics,ATLTCS,1,2,1,3,1991,1995,4,0.0,3.31,3.31,0,127,127,0,1,1,0.0,2170.0,2170.0,0.0,0.0,0.0
grovl101,Lefty Grove,Philadelphia Athletics,ATLTCS,1,3,3,6,1933,1936,3,51.32,1.87,-49.45,848,361,-487,1283,1356,73,5977.0,119.0,-5858.0,31000.0,8500.0,-22500.0
grovr101,Roy Grover,Philadelphia Athletics,ATLTCS,1,1,1,2,1919,1919,0,-0.87,-0.24,0.63,24,8,-16,84,6,-78,0.0,36.0,36.0,2400.0,0.0,-2400.0
grubf101,Frank Grube,Chicago White Sox,WSOX,4,9,4,13,1936,1950,14,-0.26,3.15,3.41,394,894,500,1460,3508,2048,0.0,0.0,0.0,20900.0,0.0,-20900.0
grubf101,Frank Grube,Chicago White Sox,WSOX,1,1,1,2,1933,1945,12,-0.22,-1.6,-1.38,86,147,61,245,473,228,0.0,0.0,0.0,6500.0,0.0,-6500.0
grubj001,Johnny Grubb,San Diego Padres,PADRS,2,4,2,6,1976,1981,5,20.22,7.28,-12.94,1143,413,-730,4572,857,-3715,0.0,1243.0,1243.0,0.0,0.0,0.0
grubj001,Johnny Grubb,Cleveland Indians,INDINS,1,1,2,3,1978,1978,0,1.95,0.0,-1.95,403,0,-403,1279,0,-1279,0.0,0.0,0.0,0.0,0.0,0.0
grubj001,Johnny Grubb,Texas Rangers,RNGRS,1,1,1,2,1983,1984,1,4.64,1.06,-3.58,361,51,-310,939,0,-939,0.0,259.0,259.0,0.0,0.0,0.0
grubk001,Kelly Gruber,Toronto Blue Jays,BJAYS,1,2,1,3,1992,1993,1,0.32,-0.45,-0.77,18,19,1,70,54,-16,0.0,0.0,0.0,3633333.0,190000.0,-3443333.0
grudm001,Mark Grudzielanek,Montreal Expos,NATEX,3,8,7,15,1998,2004,6,7.97,-4.29,-12.26,909,664,-245,2909,2173,-736,1579.0,285.0,-1294.0,2150000.0,265000.0,-1885000.0
grudm001,Mark Grudzielanek,Los Angeles Dodgers,DOGRS,1,2,2,4,2002,2004,2,2.3,-0.13,-2.43,316,32,-284,1174,68,-1106,0.0,0.0,0.0,11875000.0,6500000.0,-5375000.0
grybk001,Kevin Gryboski,Seattle Mariners,MARNRS,1,1,1,2,2002,2002,0,1.23,0.0,-1.23,430,0,-430,1,0,-1,504.0,0.0,-504.0,0.0,0.0,0.0
grybk001,Kevin Gryboski,Atlanta Braves,BRAVES,1,1,1,2,2005,2005,0,-0.94,0.0,0.94,11,0,-11,0,0,0,29.0,0.0,-29.0,877500.0,0.0,-877500.0
grzej101,Joe Grzenda,Minnesota Twins,TWINS,1,2,1,3,1970,1971,1,0.8,0.53,-0.27,190,173,-17,21,478,457,465.0,0.0,-465.0,0.0,0.0,0.0
grzej101,Joe Grzenda,Texas Rangers,RNGRS,12,24,22,46,1971,1986,15,54.58,25.98,-28.6,2920,1745,-1175,5733,4720,-1013,9904.0,4163.0,-5741.0,229000.0,387000.0,158000.0
guanc001,Cecilio Guante,Pittsburgh Pirates,PIRATS,1,3,3,6,1986,1992,6,5.61,20.46,14.85,202,598,396,2,649,647,1758.0,5213.0,3455.0,1030000.0,180000.0,-850000.0
guanc001,Cecilio Guante,New York Yankees,YANKS,1,1,1,2,1988,1989,1,0.31,-0.46,-0.77,58,47,-11,0,0,0,221.0,241.0,20.0,380000.0,157500.0,-222500.0
guare001,Eddie Guardado,Seattle Mariners,MARNRS,1,2,1,3,2006,2008,2,0.23,-0.22,-0.45,60,3,-57,0,0,0,83.0,15.0,-68.0,6250000.0,0.0,-6250000.0
guare001,Eddie Guardado,Texas Rangers,RNGRS,1,1,1,2,2008,2012,4,-0.22,0.04,0.26,9,5,-4,0,0,0,21.0,24.0,3.0,2000000.0,0.0,-2000000.0
gubac001,Creighton Gubanich,Milwaukee Brewers,BREWRS,1,1,1,2,1997,1997,0,0.0,-1.29,-1.29,0,84,84,0,154,154,0.0,0.0,0.0,0.0,0.0,0.0
gubac001,Creighton Gubanich,Oakland Athletics,ATLTCS,1,1,1,2,1997,1997,0,0.0,0.0,0.0,0,0,0,0,0,0,0.0,0.0,0.0,0.0,0.0,0.0
gubim001,Mark Gubicza,Kansas City Royals,ROYALS,1,2,1,3,1996,1997,1,-0.59,2.4,2.99,5,140,135,0,567,567,24.0,0.0,-24.0,1600000.0,3800000.0,2200000.0
gudam101,Marv Gudat,Chicago Cubs,CUBS,2,7,2,9,1933,1938,5,10.27,0.77,-9.5,576,293,-283,361,754,393,2894.0,224.0,-2670.0,0.0,0.0,0.0
guerd001,Deolis Guerra,New York Mets,METS,1,4,1,5,2008,2013,5,2.31,15.63,13.32,305,210,-95,963,247,-716,66.0,2151.0,2085.0,0.0,0.0,0.0
guerg001,Gabriel Guerrero,Seattle Mariners,MARNRS,3,7,4,11,2015,2017,2,4.57,3.33,-1.24,655,244,-411,2424,508,-1916,92.0,403.0,311.0,9532900.0,9014000.0,-518900.0
guerj004,Javy Guerra,Boston Red Sox,RSOX,1,4,1,5,2015,2018,3,5.44,6.73,1.29,670,203,-467,2136,0,-2136,153.0,553.0,400.0,0.0,9000000.0,9000000.0
guerm001,Matt Guerrier,Chicago White Sox,WSOX,4,5,5,10,2002,2011,9,1.48,8.44,6.96,460,809,349,101,2004,1903,823.0,777.0,-46.0,4000000.0,11500000.0,7500000.0
guerm001,Matt Guerrier,Los Angeles Dodgers,DOGRS,1,1,2,3,2013,2013,0,0.34,0.26,-0.08,29,41,12,0,1,1,38.0,64.0,26.0,0.0,0.0,0.0
guerm101,Mario Guerrero,New York Yankees,YANKS,23,51,43,94,1972,1997,25,84.01,74.64,-9.37,6091,4059,-2032,14328,7586,-6742,18451.0,11941.0,-6510.0,5628333.0,4757500.0,-870833.0
guerm101,Mario Guerrero,Boston Red Sox,RSOX,1,1,1,2,1975,1978,3,0.21,1.45,1.24,64,110,46,200,1,-199,0.0,606.0,606.0,0.0,0.0,0.0
guerm101,Mario Guerrero,St. Louis Cardinals,CARDS,2,2,4,6,1976,1976,0,0.18,0.0,-0.18,169,0,-169,540,0,-540,0.0,0.0,0.0,0.0,0.0,0.0
guerm101,Mario Guerrero,San Francisco Giants,GIANTS,4,14,8,22,1978,1992,14,8.18,23.62,15.44,767,1277,510,1656,1600,-56,2714.0,7759.0,5045.0,0.0,0.0,0.0
guerm102,Mike Guerra,Boston Red Sox,RSOX,1,1,2,3,1951,1951,0,-1.31,0.0,1.31,72,0,-72,231,0,-231,0.0,0.0,0.0,0.0,0.0,0.0
guerp001,Pedro Guerrero,Cleveland Indians,INDINS,1,1,1,2,1974,1974,0,32.72,-0.11,-32.83,1036,16,-1020,4089,0,-4089,0.0,126.0,126.0,0.0,0.0,0.0
guerp001,Pedro Guerrero,Los Angeles Dodgers,DOGRS,1,1,1,2,1988,1989,1,1.7,1.28,-0.42,500,30,-470,2026,18,-2008,0.0,200.0,200.0,1720000.0,1100000.0,-620000.0
guert001,Tayron Guerrero,San Diego Padres,PADRS,4,12,9,21,2016,2021,5,1.39,-0.63,-2.02,553,209,-344,911,376,-535,973.0,576.0,-397.0,10660200.0,4650000.0,-6010200.0
guerw001,Wilton Guerrero,Los Angeles Dodgers,DOGRS,4,8,8,16,1998,2006,8,3.75,12.46,8.71,1576,982,-594,3524,3610,86,1585.0,233.0,-1352.0,12365000.0,8350000.0,-4015000.0
guerw001,Wilton Guerrero,Cincinnati Reds,REDS,1,3,1,4,2002,2003,1,1.48,-2.8,-4.28,415,76,-339,1688,70,-1618,0.0,613.0,613.0,2400000.0,2475000.0,75000.0
guerw001,Wilton Guerrero,Florida Marlins,MARLNS,2,6,6,12,2002,2005,3,-0.85,8.29,9.14,199,741,542,190,1520,1330,741.0,1719.0,978.0,6500000.0,9062500.0,2562500.0
guetl001,Lee Guetterman,Seattle Mariners,MARNRS,4,7,6,13,1987,1995,8,7.57,0.25,-7.32,518,728,210,671,2089,1418,1950.0,271.0,-1679.0,982500.0,1100000.0,117500.0
guetl001,Lee Guetterman,New York Yankees,YANKS,1,1,1,2,1992,1992,0,-0.93,0.06,0.99,86,23,-63,2,0,-2,130.0,83.0,-47.0,1600000.0,2266667.0,666667.0
guiea001,Aaron Guiel,Anaheim Angels,ANGELS,1,1,1,2,1997,1997,0,0.0,-0.06,-0.06,0,11,11,0,17,17,0.0,0.0,0.0,0.0,0.0,0.0
guilc001,Carlos Guillen,Houston Astros,ASTROS,1,3,1,4,1998,1998,0,33.49,3.98,-29.51,809,22,-787,1941,35,-1906,4960.0,253.0,-4707.0,170000.0,6000000.0,5830000.0
guilc001,Carlos Guillen,Seattle Mariners,MARNRS,1,1,2,3,2004,2005,1,18.63,-0.28,-18.91,817,27,-790,3384,58,-3326,0.0,0.0,0.0,0.0,0.0,0.0
guilj001,Jose Guillen,Pittsburgh Pirates,PIRATS,1,2,2,4,1999,2007,8,1.13,-1.06,-2.19,216,241,25,680,708,28,91.0,0.0,-91.0,375000.0,0.0,-375000.0
guilj001,Jose Guillen,Cincinnati Reds,REDS,1,1,3,4,2003,2010,7,0.2,14.51,14.31,45,509,464,186,479,293,0.0,4166.0,4166.0,0.0,0.0,0.0
guilj001,Jose Guillen,Anaheim Angels,ANGELS,3,4,5,9,2004,2013,9,2.39,19.69,17.3,417,1562,1145,1612,5804,4192,0.0,0.0,0.0,2200000.0,312000.0,-1888000.0
guilj001,Jose Guillen,Kansas City Royals,ROYALS,1,1,2,3,2010,2010,0,-0.57,0.0,0.57,42,0,-42,139,0,-139,0.0,0.0,0.0,12000000.0,0.0,-12000000.0
guilo001,Ozzie Guillen,San Diego Padres,PADRS,2,6,4,10,1984,1989,5,23.33,0.76,-22.57,2084,146,-1938,6812,127,-6685,1933.0,1127.0,-806.0,0.0,0.0,0.0
guilo001,Ozzie Guillen,Chicago White Sox,WSOX,1,2,2,4,2011,2013,2,0.0,0.17,0.17,0,2,2,0,0,0,0.0,8.0,8.0,0.0,0.0,0.0
guilp001,Preston Guilmet,Cleveland Indians,INDINS,1,1,1,2,2014,2014,0,-0.1,0.0,0.1,11,0,-11,0,0,0,31.0,0.0,-31.0,0.0,0.0,0.0
guilt001,Taylor Guilbeau,Washington Nationals,NATEX,1,3,2,5,2019,2020,1,0.05,-0.26,-0.31,39,55,16,0,1,1,84.0,72.0,-12.0,0.0,2210000.0,2210000.0
guldb001,Brad Gulden,Los Angeles Dodgers,DOGRS,1,1,1,2,1979,1980,1,-0.06,0.31,0.37,42,195,153,108,491,383,0.0,0.0,0.0,0.0,0.0,0.0
guldb001,Brad Gulden,New York Yankees,YANKS,6,11,11,22,1980,1992,12,8.07,13.87,5.8,1174,646,-528,2497,1931,-566,2564.0,669.0,-1895.0,913333.0,1045000.0,131667.0
guldb001,Brad Gulden,Seattle Mariners,MARNRS,1,2,2,4,1981,1986,5,0.72,-0.08,-0.8,106,8,-98,281,16,-265,0.0,0.0,0.0,0.0,0.0,0.0
guldb001,Brad Gulden,New York Yankees,YANKS,1,1,1,2,1982,1982,0,-0.12,-0.07,0.05,5,4,-1,7,11,4,0.0,0.0,0.0,0.0,0.0,0.0
gullb001,Bill Gullickson,Montreal Expos,NATEX,6,9,12,21,1985,1996,11,4.45,9.14,4.69,274,1231,957,297,636,339,2341.0,2913.0,572.0,1325000.0,1125000.0,-200000.0
gullb001,Bill Gullickson,Cincinnati Reds,REDS,2,2,2,4,1987,1988,1,4.86,-0.21,-5.07,228,38,-190,252,39,-213,2143.0,317.0,-1826.0,1357500.0,237500.0,-1120000.0
gullt101,Ted Gullic,Milwaukee,Milwaukee,1,2,3,5,1932,1932,0,3.6,0.0,-3.6,514,0,-514,595,0,-595,2467.0,0.0,-2467.0,0.0,3000.0,3000.0
gumba101,Ad Gumbert,Chicago Cubs,CUBS,1,1,1,2,1893,1893,0,1.89,-0.11,-2.0,128,14,-114,228,28,-200,1301.0,168.0,-1133.0,0.0,0.0,0.0
gumba101,Ad Gumbert,Pittsburgh Pirates,PIRATS,1,1,1,2,1895,1898,3,1.4,-0.52,-1.92,77,19,-58,117,67,-50,795.0,0.0,-795.0,0.0,0.0,0.0
gumbh101,Harry Gumbert,New York Giants,GIANTS,1,3,1,4,1941,1941,0,6.28,-0.7,-6.98,205,44,-161,186,32,-154,1502.0,319.0,-1183.0,0.0,0.0,0.0
gumpd001,Dave Gumpert,Chicago Cubs,CUBS,1,2,1,3,1987,1988,1,-0.74,0.52,1.26,103,85,-18,176,227,51,58.0,0.0,-58.0,0.0,0.0,0.0
gumpr101,Randy Gumpert,Chicago White Sox,WSOX,26,50,43,93,1951,1969,18,84.01,61.56,-22.45,6907,5207,-1700,17328,11506,-5822,13187.0,9922.0,-3265.0,288750.0,292500.0,3750.0
gumpr101,Randy Gumpert,Boston Red Sox,RSOX,1,2,1,3,1952,1955,3,3.27,3.29,0.02,146,168,22,161,116,-45,1293.0,1085.0,-208.0,12000.0,0.0,-12000.0
gural001,Larry Gura,Chicago Cubs,CUBS,1,1,1,2,1973,1974,1,0.0,-0.03,-0.03,0,26,26,0,4,4,0.0,59.0,59.0,15000.0,30000.0,15000.0
gural001,Larry Gura,Texas Rangers,RNGRS,1,2,1,3,1974,1975,1,2.91,-0.38,-3.29,34,39,5,0,118,118,622.0,0.0,-622.0,0.0,50000.0,50000.0
gural001,Larry Gura,New York Yankees,YANKS,1,1,1,2,1976,1978,2,18.75,0.86,-17.89,312,74,-238,0,205,205,5104.0,0.0,-5104.0,0.0,0.0,0.0
gusht001,Taylor Gushue,Pittsburgh Pirates,PIRATS,1,1,1,2,2016,2018,2,0.0,0.02,0.02,0,22,22,0,34,34,0.0,0.0,0.0,0.0,0.0,0.0
gustf101,Frankie Gustine,Pittsburgh Pirates,PIRATS,22,40,53,93,1948,1973,25,26.59,60.08,33.49,3582,5165,1583,9869,14610,4741,4211.0,5429.0,1218.0,216500.0,108500.0,-108000.0
gustf101,Frankie Gustine,Philadelphia Athletics,ATLTCS,36,79,78,157,1949,1976,27,93.22,74.94,-18.28,10595,9460,-1135,25786,29262,3476,12563.0,7417.0,-5146.0,500300.0,639500.0,139200.0
gustj001,Jandel Gustave,Pittsburgh Pirates,PIRATS,1,2,1,3,2021,2021,0,0.06,0.0,-0.06,26,0,-26,2,0,-2,55.0,0.0,-55.0,0.0,0.0,0.0
guthj001,Jeremy Guthrie,Baltimore Orioles,ORLS,2,3,4,7,2012,2013,1,-0.36,3.87,4.23,65,90,25,30,11,-19,304.0,1015.0,711.0,3600000.0,6000000.0,2400000.0
guthj001,Jeremy Guthrie,Colorado Rockies,ROCKS,1,1,1,2,2012,2012,0,3.59,-0.39,-3.98,116,6,-110,17,3,-14,1961.0,34.0,-1927.0,8200000.0,5600000.0,-2600000.0
guthm001,Mark Guthrie,Minnesota Twins,TWINS,2,3,5,8,1995,2000,5,1.39,-0.49,-1.88,429,829,400,30,2713,2683,819.0,618.0,-201.0,4612500.0,218000.0,-4394500.0
guthm001,Mark Guthrie,Boston Red Sox,RSOX,1,2,1,3,1999,2001,2,0.54,2.66,2.12,201,119,-82,36,1,-35,221.0,406.0,185.0,1600000.0,5500000.0,3900000.0
guthm001,Mark Guthrie,Chicago Cubs,CUBS,2,3,2,5,2000,2000,0,0.66,-0.95,-1.61,78,72,-6,134,158,24,96.0,0.0,-96.0,1600000.0,2000000.0,400000.0
guthm001,Mark Guthrie,Tampa Bay Devil Rays,RAYS,1,2,1,3,2000,2003,3,1.0,0.98,-0.02,34,198,164,0,846,846,251.0,0.0,-251.0,1000000.0,0.0,-1000000.0
guthm001,Mark Guthrie,Oakland Athletics,ATLTCS,1,2,1,3,2001,2001,0,0.66,0.0,-0.66,175,0,-175,14,0,-14,284.0,0.0,-284.0,1800000.0,0.0,-1800000.0
gutic101,Cesar Gutierrez,San Francisco Giants,GIANTS,1,1,1,2,1969,1972,3,-1.81,3.65,5.46,190,358,168,548,34,-514,0.0,789.0,789.0,9000.0,0.0,-9000.0
gutif001,Franklin Gutierrez,Los Angeles Dodgers,DOGRS,2,4,2,6,2004,2017,13,6.58,25.96,19.38,465,1671,1206,1473,6338,4865,30.0,0.0,-30.0,2830000.0,0.0,-2830000.0
gutif001,Franklin Gutierrez,Cleveland Indians,INDINS,1,1,2,3,2008,2013,5,12.81,6.75,-6.06,635,534,-101,2388,752,-1636,0.0,813.0,813.0,404400.0,0.0,-404400.0
gutij001,Jackie Gutierrez,Boston Red Sox,RSOX,1,1,1,2,1985,1986,1,-1.8,0.3,2.1,64,27,-37,153,0,-153,0.0,191.0,191.0,130000.0,581250.0,451250.0
gutij002,Juan Gutierrez,Houston Astros,ASTROS,1,3,1,4,2007,2009,2,-1.01,2.95,3.96,701,243,-458,203,1,-202,929.0,378.0,-551.0,856000.0,2000000.0,1144000.0
gutik001,Kelvin Gutierrez,Washington Nationals,NATEX,1,3,1,4,2018,2018,0,-0.73,0.15,0.88,62,41,-21,233,0,-233,0.0,56.0,56.0,0.0,0.0,0.0
gutir001,Ricky Gutierrez,Baltimore Orioles,ORLS,1,2,1,3,1992,1992,0,-1.14,-0.08,1.06,223,5,-218,809,0,-809,0.0,99.0,99.0,0.0,2041667.0,2041667.0
gutir001,Ricky Gutierrez,San Diego Padres,PADRS,6,15,16,31,1994,2006,12,12.56,40.19,27.63,2713,3390,677,9058,12055,2997,712.0,1324.0,612.0,13007500.0,22494000.0,9486500.0
guyeb001,Brandon Guyer,Chicago Cubs,CUBS,4,8,9,17,2011,2019,8,18.8,9.35,-9.45,836,1392,556,1720,408,-1312,3536.0,2716.0,-820.0,1500000.0,0.0,-1500000.0
guyeb001,Brandon Guyer,Tampa Bay Devil Rays,RAYS,1,1,2,3,2016,2016,0,0.9,0.0,-0.9,212,0,-212,509,0,-509,3.0,0.0,-3.0,0.0,0.0,0.0
guzmc001,Cristian Guzman,New York Yankees,YANKS,1,5,1,6,1998,2001,3,22.8,7.48,-15.32,1163,539,-624,4014,2478,-1536,2978.0,0.0,-2978.0,0.0,0.0,0.0
guzmc001,Cristian Guzman,Washington Nationals,NATEX,2,2,3,5,2010,2018,8,1.08,17.02,15.94,55,353,298,84,317,233,331.0,2805.0,2474.0,14475000.0,0.0,-14475000.0
guzme001,Edwards Guzman,San Francisco Giants,GIANTS,1,3,2,5,2003,2005,2,18.34,1.53,-16.81,443,337,-106,636,24,-612,3951.0,670.0,-3281.0,0.0,0.0,0.0
guzmf001,Freddy Guzman,San Diego Padres,PADRS,1,2,2,4,2006,2006,0,0.07,0.0,-0.07,17,0,-17,15,0,-15,0.0,0.0,0.0,0.0,0.0,0.0
guzmf001,Freddy Guzman,Texas Rangers,RNGRS,1,1,1,2,2007,2008,1,0.0,0.38,0.38,0,41,41,0,117,117,0.0,0.0,0.0,0.0,0.0,0.0
guzmj003,Juan Guzman,Los Angeles Dodgers,DOGRS,1,1,1,2,1987,1994,7,20.96,5.92,-15.04,196,518,322,2,1271,1269,3647.0,0.0,-3647.0,0.0,0.0,0.0
guzmj003,Juan Guzman,Toronto Blue Jays,BJAYS,1,1,2,3,1998,2000,2,2.8,-0.52,-3.32,34,9,-25,6,0,-6,566.0,31.0,-535.0,5000000.0,0.0,-5000000.0
guzmj003,Juan Guzman,Baltimore Orioles,ORLS,1,2,2,4,1999,2005,6,0.88,7.79,6.91,24,427,403,30,2,-28,232.0,1138.0,906.0,5250000.0,0.0,-5250000.0
guzmj004,Joel Guzman,Los Angeles Dodgers,DOGRS,1,2,1,3,2006,2006,0,-0.26,-0.96,-0.7,16,49,33,39,164,125,0.0,0.0,0.0,0.0,4950000.0,4950000.0
guzmj005,Jesus Guzman,San Diego Padres,PADRS,1,1,1,2,2013,2014,1,-0.74,0.0,0.74,69,0,-69,184,0,-184,0.0,0.0,0.0,503200.0,0.0,-503200.0
guzmj006,Jorge Guzman,Houston Astros,ASTROS,1,2,2,4,2016,2018,2,-0.24,1.81,2.05,33,160,127,0,615,615,114.0,0.0,-114.0,0.0,17000000.0,17000000.0
guzmj006,Jorge Guzman,New York Yankees,YANKS,1,3,1,4,2017,2017,0,2.19,0.0,-2.19,342,0,-342,1369,0,-1369,8.0,0.0,-8.0,9857143.0,14500000.0,4642857.0
guzms101,Santiago Guzman,St. Louis Cardinals,CARDS,1,1,1,2,1972,1972,0,0.0,0.08,0.08,0,33,33,0,5,5,0.0,104.0,104.0,0.0,0.0,0.0
gwosd001,Doug Gwosdz,New York Mets,METS,2,2,2,4,1986,1987,1,0.0,-0.25,-0.25,0,10,10,0,5,5,0.0,65.0,65.0,0.0,0.0,0.0
gwync001,Chris Gwynn,Los Angeles Dodgers,DOGRS,1,2,1,3,1991,1992,1,0.26,-0.93,-1.19,137,121,-16,406,313,-93,0.0,0.0,0.0,260000.0,0.0,-260000.0
gwynt002,Tony Gwynn,Milwaukee Brewers,BREWRS,1,1,1,2,2009,2010,1,5.13,0.07,-5.06,236,117,-119,790,251,-539,0.0,0.0,0.0,0.0,1775000.0,1775000.0
gyorj001,Jedd Gyorko,San Diego Padres,PADRS,1,2,1,3,2015,2016,1,6.31,1.2,-5.11,418,90,-328,1383,374,-1009,4.0,0.0,-4.0,2000000.0,4125000.0,2125000.0
gyorj001,Jedd Gyorko,St. Louis Cardinals,CARDS,1,2,2,4,2019,2019,0,-0.4,0.0,0.4,24,0,-24,39,0,-39,0.0,0.0,0.0,13000000.0,0.0,-13000000.0
gysed101,Dick Gyselman,Mission,Mission,1,2,2,4,1932,1933,1,-0.29,0.0,0.29,86,0,-86,205,0,-205,0.0,0.0,0.0,0.0,0.0,0.0
gysed101,Dick Gyselman,Boston Braves,BRAVES,2,5,2,7,1934,1940,6,0.0,6.69,6.69,0,395,395,0,958,958,0.0,2031.0,2031.0,0.0,0.0,0.0
haasb102,Bert Haas,Brooklyn Dodgers,DOGRS,1,5,2,7,1940,1946,6,2.24,22.24,20.0,200,770,570,485,2187,1702,487.0,3020.0,2533.0,0.0,0.0,0.0
haasb102,Bert Haas,Cincinnati Reds,REDS,1,1,1,2,1947,1947,0,0.76,0.0,-0.76,97,0,-97,372,0,-372,0.0,0.0,0.0,0.0,0.0,0.0
haasb102,Bert Haas,New York Giants,GIANTS,1,5,3,8,1950,1954,4,0.0,-0.44,-0.44,0,186,186,0,308,308,0.0,172.0,172.0,0.0,0.0,0.0
haase101,Eddie Haas,Chicago Cubs,CUBS,11,20,17,37,1957,1977,20,15.71,44.12,28.41,1386,3941,2555,1236,10815,9579,4659.0,6233.0,1574.0,122500.0,58000.0,-64500.0
haasm001,Moose Haas,Milwaukee Brewers,BREWRS,2,3,6,9,1986,1992,6,3.87,3.54,-0.33,253,225,-28,659,688,29,339.0,293.0,-46.0,150000.0,200000.0,50000.0
habyj001,John Habyan,Baltimore Orioles,ORLS,1,1,1,2,1989,1990,1,4.31,0.29,-4.02,165,45,-120,0,155,155,641.0,0.0,-641.0,0.0,90000.0,90000.0
habyj001,John Habyan,New York Yankees,YANKS,2,2,2,4,1993,1997,4,0.97,1.35,0.38,56,84,28,0,0,0,141.0,388.0,247.0,600000.0,0.0,-600000.0
habyj001,John Habyan,St. Louis Cardinals,CARDS,2,4,4,8,1995,1997,2,0.15,-1.34,-1.49,453,272,-181,688,552,-136,283.0,68.0,-215.0,5542500.0,2250000.0,-3292500.0
hacke001,Eric Hacker,New York Yankees,YANKS,1,1,1,2,2009,2011,2,-0.02,0.17,0.19,6,2,-4,0,0,0,9.0,13.0,4.0,0.0,0.0,0.0
hackl001,Luther Hackman,Colorado Rockies,ROCKS,13,23,24,47,1999,2003,4,20.8,11.07,-9.73,2188,1626,-562,1402,1034,-368,5980.0,2442.0,-3538.0,24071314.0,14545000.0,-9526314.0
hackl001,Luther Hackman,St. Louis Cardinals,CARDS,1,2,1,3,2002,2003,1,-1.26,0.08,1.34,128,65,-63,2,78,76,230.0,608.0,378.0,245000.0,1100000.0,855000.0
hackr101,Rich Hacker,New York Mets,METS,7,11,11,22,1971,1984,13,10.8,20.91,10.11,1517,1503,-14,1460,5043,3583,2280.0,196.0,-2084.0,90000.0,0.0,-90000.0
hackw102,Warren Hacker,Chicago Cubs,CUBS,2,5,4,9,1956,1958,2,7.54,-1.1,-8.64,773,105,-668,2296,34,-2262,130.0,197.0,67.0,0.0,0.0,0.0
haddh101,Harvey Haddix,St. Louis Cardinals,CARDS,1,3,2,5,1956,1958,2,5.63,6.28,0.65,262,246,-16,209,231,22,1575.0,1837.0,262.0,0.0,0.0,0.0
haddh101,Harvey Haddix,Philadelphia Phillies,PHILS,2,4,3,7,1957,1968,11,9.25,26.83,17.58,407,1550,1143,1073,5702,4629,552.0,0.0,-552.0,0.0,0.0,0.0
haddh101,Harvey Haddix,Cincinnati Reds,REDS,4,7,11,18,1959,1965,6,63.65,9.6,-54.05,3136,1073,-2063,9911,1717,-8194,2563.0,935.0,-1628.0,0.0,0.0,0.0
haddh101,Harvey Haddix,Pittsburgh Pirates,PIRATS,1,1,2,3,1963,1963,0,0.5,0.0,-0.5,146,0,-146,23,0,-23,370.0,0.0,-370.0,0.0,0.0,0.0
hadej001,Josh Hader,Baltimore Orioles,ORLS,1,3,1,4,2013,2015,2,0.01,0.61,0.6,109,65,-44,333,11,-322,0.0,847.0,847.0,0.0,0.0,0.0
hadej001,Josh Hader,Houston Astros,ASTROS,1,4,3,7,2015,2017,2,18.89,0.28,-18.61,984,198,-786,1471,487,-984,1823.0,1153.0,-670.0,0.0,512500.0,512500.0
hadlb101,Bump Hadley,Washington Senators,TWINS,4,9,7,16,1931,1936,5,40.86,14.39,-26.47,2483,840,-1643,9607,2965,-6642,2547.0,1249.0,-1298.0,62500.0,54200.0,-8300.0
hadlb101,Bump Hadley,Chicago White Sox,WSOX,2,3,2,5,1932,1940,8,17.91,-0.15,-18.06,925,353,-572,3007,1416,-1591,2296.0,0.0,-2296.0,17600.0,12000.0,-5600.0
hadlb101,Bump Hadley,St.Louis Browns,ORLS,1,1,2,3,1935,1935,0,1.5,0.0,-1.5,70,0,-70,94,0,-94,691.0,0.0,-691.0,0.0,0.0,0.0
hadlb101,Bump Hadley,Washington Senators,TWINS,1,2,2,4,1936,1939,3,4.55,1.79,-2.76,355,337,-18,541,641,100,2260.0,1980.0,-280.0,0.0,0.0,0.0
hadlk101,Kent Hadley,Detroit Tigers,TIGRS,4,12,12,24,1957,1964,7,6.47,14.38,7.91,1197,947,-250,3186,1303,-1883,1459.0,3692.0,2233.0,20000.0,9000.0,-11000.0
hadlk101,Kent Hadley,Kansas City Athletics,ATLTCS,23,46,43,89,1959,1976,17,99.11,44.56,-54.55,8270,5153,-3117,21179,15408,-5771,8728.0,3756.0,-4972.0,440600.0,542000.0,101400.0
haefm101,Mickey Haefner,Minneapolis,Minneapolis,1,1,2,3,1943,1943,0,16.6,0.0,-16.6,431,0,-431,473,0,-473,3875.0,0.0,-3875.0,0.0,0.0,0.0
haefm101,Mickey Haefner,Boston Braves,BRAVES,1,3,1,4,1950,1955,5,0.0,4.71,4.71,0,200,200,0,221,221,0.0,1757.0,1757.0,0.0,0.0,0.0
hafeb101,Bud Hafey,Chicago White Sox,WSOX,2,2,2,4,1935,1947,12,-0.37,31.03,31.4,97,563,466,329,753,424,0.0,5864.0,5864.0,2400.0,3000.0,600.0
hafeb101,Bud Hafey,Pittsburgh Pirates,PIRATS,4,7,4,11,1937,1946,9,3.24,18.29,15.05,164,1051,887,641,3703,3062,0.0,666.0,666.0,0.0,0.0,0.0
hafeb101,Bud Hafey,Pittsburgh Pirates,PIRATS,1,1,3,4,1939,1948,9,-0.1,0.0,0.1,6,0,-6,14,0,-14,0.0,0.0,0.0,0.0,0.0,0.0
hafec101,Chick Hafey,St. Louis Cardinals,CARDS,1,1,3,4,1932,1932,0,9.46,-0.61,-10.07,471,32,-439,1837,78,-1759,0.0,9.0,9.0,0.0,0.0,0.0
hafnt001,Travis Hafner,Texas Rangers,RNGRS,3,7,7,14,2002,2007,5,52.47,11.45,-41.02,2261,315,-1946,8496,371,-8125,1660.0,2044.0,384.0,0.0,1294000.0,1294000.0
hagan001,Nick Hagadone,Boston Red Sox,RSOX,1,3,1,4,2009,2010,1,7.47,4.91,-2.56,325,183,-142,19,775,756,3215.0,0.0,-3215.0,415500.0,5900000.0,5484500.0
haggs001,Sam Haggerty,Cleveland Indians,INDINS,1,2,1,3,2019,2019,0,-0.48,-0.04,0.44,31,61,30,11,174,163,92.0,6.0,-86.0,0.0,0.0,0.0
haguj101,Joe Hague,St. Louis Cardinals,CARDS,11,16,17,33,1972,1978,6,44.3,11.43,-32.87,2021,766,-1255,6191,2476,-3715,2099.0,259.0,-1840.0,96000.0,140000.0,44000.0
hahnd102,Don Hahn,Montreal Expos,NATEX,2,2,3,5,1971,1971,0,-1.24,1.84,3.08,470,106,-364,1252,285,-967,0.0,0.0,0.0,0.0,16000.0,16000.0
hahnd102,Don Hahn,New York Mets,METS,6,9,10,19,1974,1984,10,10.05,22.43,12.38,1462,1185,-277,1334,4141,2807,2280.0,196.0,-2084.0,90000.0,0.0,-90000.0
hahnj001,Jesse Hahn,Tampa Bay Devil Rays,RAYS,6,8,11,19,2014,2020,6,-0.42,14.29,14.71,628,826,198,687,1868,1181,884.0,1581.0,697.0,2158000.0,100000.0,-2058000.0
hahnj001,Jesse Hahn,San Diego Padres,PADRS,2,3,4,7,2014,2019,5,-0.29,3.01,3.3,62,274,212,4,1017,1013,698.0,16.0,-682.0,2925000.0,505000.0,-2420000.0
hahnj001,Jesse Hahn,Oakland Athletics,ATLTCS,1,2,3,5,2018,2019,1,0.62,1.28,0.66,62,124,62,5,0,-5,390.0,254.0,-136.0,0.0,0.0,0.0
haidh101,Hal Haid,Boston Braves,BRAVES,4,6,5,11,1931,1938,7,5.87,8.49,2.62,599,1115,516,2168,4417,2249,0.0,0.0,0.0,0.0,0.0,0.0
haidh101,Hal Haid,Chicago White Sox,WSOX,1,2,1,3,1933,1933,0,0.0,0.0,0.0,0,0,0,0,0,0,0.0,0.0,0.0,4500.0,0.0,-4500.0
haidh101,Hal Haid,St.Louis Browns,ORLS,2,7,2,9,1921,1921,0,0.0,0.0,0.0,0,0,0,0,0,0,0.0,0.0,0.0,6600.0,0.0,-6600.0
hairj002,Jerry Hairston,Baltimore Orioles,ORLS,1,3,2,5,2005,2005,0,4.2,-1.01,-5.21,574,102,-472,1675,424,-1251,0.0,0.0,0.0,0.0,0.0,0.0
hairj002,Jerry Hairston,Chicago Cubs,CUBS,2,3,3,6,2006,2006,0,-0.33,0.09,0.42,152,67,-85,338,197,-141,0.0,0.0,0.0,2300000.0,10472409.0,8172409.0
hairj002,Jerry Hairston,Cincinnati Reds,REDS,1,1,1,2,2009,2009,0,0.6,0.0,-0.6,45,0,-45,93,0,-93,0.0,0.0,0.0,2000000.0,0.0,-2000000.0
hairj002,Jerry Hairston,Washington Nationals,NATEX,1,1,1,2,2011,2011,0,0.99,0.0,-0.99,45,0,-45,138,0,-138,0.0,0.0,0.0,2000000.0,0.0,-2000000.0
hairs001,Scott Hairston,Arizona Diamondbacks,DBACKS,1,1,1,2,2007,2010,3,6.82,-0.04,-6.86,303,151,-152,1009,5,-1004,0.0,275.0,275.0,389000.0,0.0,-389000.0
hairs001,Scott Hairston,San Diego Padres,PADRS,8,20,16,36,2009,2021,12,21.56,18.07,-3.49,1943,1571,-372,3964,4257,293,2638.0,702.0,-1936.0,11240300.0,815000.0,-10425300.0
hairs001,Scott Hairston,Oakland Athletics,ATLTCS,1,2,2,4,2010,2016,6,1.29,5.52,4.23,209,624,415,584,2066,1482,0.0,0.0,0.0,0.0,0.0,0.0
hairs001,Scott Hairston,Chicago Cubs,CUBS,2,4,4,8,2013,2015,2,-0.95,0.17,1.12,94,21,-73,149,23,-126,0.0,175.0,175.0,0.0,10000000.0,10000000.0
hajed001,Dave Hajek,Detroit Tigers,TIGRS,1,1,1,2,1997,1997,0,0.0,0.0,0.0,0,0,0,0,0,0,0.0,0.0,0.0,0.0,0.0,0.0
halaj001,John Halama,Houston Astros,ASTROS,1,3,1,4,1998,1998,0,33.49,3.98,-29.51,809,22,-787,1941,35,-1906,4960.0,253.0,-4707.0,170000.0,6000000.0,5830000.0
halec001,Chip Hale,Anaheim Angels,ANGELS,1,1,1,2,1998,1998,0,0.0,0.19,0.19,0,77,77,0,162,162,0.0,0.0,0.0,0.0,0.0,0.0
haled001,David Hale,Atlanta Braves,BRAVES,5,11,10,21,2015,2017,2,22.57,1.32,-21.25,930,130,-800,2591,403,-2188,1128.0,339.0,-789.0,16307500.0,20000000.0,3692500.0
haled001,David Hale,New York Yankees,YANKS,1,1,1,2,2020,2020,0,0.07,0.0,-0.07,39,0,-39,0,0,0,113.0,0.0,-113.0,0.0,0.0,0.0
halej001,Justin Haley,San Diego Padres,PADRS,1,1,1,2,2016,2021,5,-0.14,-0.81,-0.67,11,142,131,0,8,8,54.0,326.0,272.0,0.0,0.0,0.0
halej101,John Hale,Cincinnati Reds,REDS,1,2,2,4,1981,1981,0,0.0,0.0,0.0,0,0,0,0,0,0,0.0,0.0,0.0,0.0,0.0,0.0
haleo101,Odell Hale,Cleveland Indians,INDINS,2,4,5,9,1940,1945,5,20.77,6.72,-14.05,691,626,-65,1095,1460,365,4952.0,2948.0,-2004.0,22322.0,17000.0,-5322.0
haler101,Raymond Haley,Boston Red Sox,RSOX,1,1,1,2,1916,1916,0,1.11,0.01,-1.1,75,14,-61,221,23,-198,0.0,0.0,0.0,0.0,0.0,0.0
hales101,Sammy Hale,Detroit Tigers,TIGRS,1,9,2,11,1921,1941,20,0.0,3.03,3.03,0,202,202,0,144,144,0.0,1168.0,1168.0,3000.0,0.0,-3000.0
hales101,Sammy Hale,Philadelphia Athletics,ATLTCS,1,2,1,3,1929,1930,1,-0.04,-0.56,-0.52,62,45,-17,204,116,-88,0.0,0.0,0.0,6000.0,10000.0,4000.0
hales101,Sammy Hale,Portland,Portland,1,1,2,3,1922,1922,0,12.5,0.0,-12.5,736,0,-736,2864,0,-2864,0.0,0.0,0.0,0.0,1800.0,1800.0
hallb001,Bill Hall,Milwaukee Brewers,BREWRS,1,1,1,2,2009,2009,0,-0.06,0.0,0.06,34,0,-34,131,0,-131,0.0,0.0,0.0,6925000.0,0.0,-6925000.0
hallb001,Bill Hall,Seattle Mariners,MARNRS,1,2,1,3,2010,2010,0,1.78,-0.77,-2.55,120,125,5,382,457,75,3.0,0.0,-3.0,0.0,0.0,0.0
hallb101,Bill Hallman,Philadelphia Phillies,PHILS,2,8,4,12,1897,1902,5,7.8,14.46,6.66,959,936,-23,3811,3203,-608,1192.0,3296.0,2104.0,0.0,0.0,0.0
hallb101,Bill Hallman,St. Louis Cardinals,CARDS,1,1,2,3,1897,1897,0,0.58,0.0,-0.58,134,0,-134,554,0,-554,0.0,0.0,0.0,0.0,0.0,0.0
hallb103,Bob Hall,Seattle,Seattle,1,1,3,4,1948,1948,0,-0.21,0.0,0.21,104,0,-104,35,0,-35,376.0,0.0,-376.0,0.0,0.0,0.0
hallc001,Cody Hall,San Francisco Giants,GIANTS,1,1,1,2,2016,2016,0,0.0,0.0,0.0,0,0,0,0,0,0,0.0,0.0,0.0,0.0,0.0,0.0
hallc103,Charley Hall,StPaul,StPaul,1,2,3,5,1909,1910,1,12.24,0.0,-12.24,441,0,-441,478,0,-478,3240.0,0.0,-3240.0,0.0,0.0,0.0
hallc103,Charley Hall,St. Louis Cardinals,CARDS,1,2,1,3,1916,1916,0,0.0,0.0,0.0,0,0,0,0,0,0,0.0,0.0,0.0,3700.0,0.0,-3700.0
halld001,Drew Hall,Chicago Cubs,CUBS,6,8,15,23,1988,1995,7,50.51,3.13,-47.38,2529,1449,-1080,6791,543,-6248,2650.0,3110.0,460.0,1193000.0,707500.0,-485500.0
halld001,Drew Hall,Texas Rangers,RNGRS,1,1,1,2,1990,1994,4,-0.89,3.93,4.82,84,410,326,5,1191,1186,175.0,0.0,-175.0,0.0,0.0,0.0
halld002,Darren Hall,Los Angeles Dodgers,DOGRS,1,1,1,2,1999,1999,0,0.0,0.0,0.0,0,0,0,0,0,0,0.0,0.0,0.0,0.0,0.0,0.0
halld101,Dick Hall,Pittsburgh Pirates,PIRATS,1,3,1,4,1959,1961,2,-1.03,1.61,2.64,207,144,-63,561,494,-67,547.0,0.0,-547.0,0.0,16500.0,16500.0
halld101,Dick Hall,Kansas City Athletics,ATLTCS,2,3,3,6,1961,1963,2,10.64,-2.14,-12.78,963,354,-609,748,642,-106,2603.0,934.0,-1669.0,0.0,0.0,0.0
halld101,Dick Hall,Baltimore Orioles,ORLS,1,1,1,2,1966,1968,2,1.58,0.06,-1.52,160,38,-122,20,6,-14,396.0,95.0,-301.0,21750.0,0.0,-21750.0
hallj001,Joe Hall,St. Louis Cardinals,CARDS,1,1,1,2,1991,1991,0,0.3,0.0,-0.3,17,0,-17,31,0,-31,0.0,0.0,0.0,0.0,0.0,0.0
hallj105,Jack Hallett,Chicago White Sox,WSOX,1,2,1,3,1941,1946,5,0.52,12.57,12.05,116,628,512,494,2724,2230,0.0,0.0,0.0,13900.0,12500.0,-1400.0
hallj105,Jack Hallett,Toronto,Toronto,1,2,1,3,1942,1942,0,4.35,0.0,-4.35,338,0,-338,630,0,-630,555.0,0.0,-555.0,0.0,0.0,0.0
hallj107,Jimmie Hall,Minnesota Twins,TWINS,3,8,6,14,1966,1971,5,25.4,14.58,-10.82,1429,584,-845,4690,560,-4130,873.0,2844.0,1971.0,153000.0,115000.0,-38000.0
hallj107,Jimmie Hall,California Angels,ANGELS,2,2,2,4,1968,1969,1,0.23,2.91,2.68,233,163,-70,437,499,62,0.0,0.0,0.0,0.0,11000.0,11000.0
hallj107,Jimmie Hall,New York Yankees,YANKS,2,3,4,7,1969,1979,10,0.0,-0.25,-0.25,88,212,124,189,457,268,0.0,0.0,0.0,0.0,0.0,0.0
hallm001,Mel Hall,Chicago Cubs,CUBS,4,14,9,23,1984,1991,7,18.76,21.66,2.9,1968,1112,-856,6227,902,-5325,1933.0,5322.0,3389.0,1746666.0,2928000.0,1181334.0
hallm001,Mel Hall,Cleveland Indians,INDINS,5,6,11,17,1989,1996,7,15.75,7.61,-8.14,1320,715,-605,4279,2175,-2104,1452.0,1275.0,-177.0,3575000.0,1765000.0,-1810000.0
hallm002,Matt Hall,Detroit Tigers,TIGRS,1,1,1,2,2020,2020,0,-0.9,0.0,0.9,4,0,-4,0,0,0,26.0,0.0,-26.0,0.0,0.0,0.0
hallr001,Roy Halladay,Toronto Blue Jays,BJAYS,5,9,9,18,2009,2019,10,34.02,12.11,-21.91,1451,870,-581,4210,2357,-1853,4262.0,2990.0,-1272.0,14250000.0,5229800.0,-9020200.0
hallt001,Toby Hall,Tampa Bay Devil Rays,RAYS,1,3,3,6,2006,2012,6,-0.07,1.99,2.06,130,586,456,113,1881,1768,593.0,426.0,-167.0,4200000.0,682000.0,-3518000.0
hallt101,Tom Hall,Minnesota Twins,TWINS,2,2,3,5,1971,1977,6,-0.72,16.38,17.1,353,788,435,69,2774,2705,1022.0,269.0,-753.0,58500.0,40000.0,-18500.0
hallt101,Tom Hall,Cincinnati Reds,REDS,1,1,1,2,1975,1977,2,-0.88,0.0,0.88,79,0,-79,6,0,-6,196.0,0.0,-196.0,0.0,0.0,0.0
hallt101,Tom Hall,New York Mets,METS,1,1,2,3,1976,1976,0,-0.55,0.0,0.55,39,0,-39,0,0,0,114.0,0.0,-114.0,0.0,0.0,0.0
hallt102,Tom Haller,San Francisco Giants,GIANTS,3,4,4,8,1968,1971,3,22.81,9.1,-13.71,984,429,-555,3778,1737,-2041,0.0,0.0,0.0,16000.0,23000.0,7000.0
hallt102,Tom Haller,Los Angeles Dodgers,DOGRS,1,1,2,3,1971,1972,1,0.18,0.0,-0.18,59,0,-59,139,0,-139,0.0,0.0,0.0,55000.0,0.0,-55000.0
halsb001,Brad Halsey,New York Yankees,YANKS,5,14,10,24,2005,2012,7,13.28,19.25,5.97,1549,974,-575,2912,2867,-45,5079.0,1808.0,-3271.0,1556425.0,9100000.0,7543575.0
halsb001,Brad Halsey,Arizona Diamondbacks,DBACKS,1,1,1,2,2006,2008,2,0.44,3.52,3.08,54,276,222,0,28,28,283.0,622.0,339.0,0.0,0.0,0.0
halts001,Shane Halter,Kansas City Royals,ROYALS,1,1,1,2,1999,1999,0,0.0,0.0,0.0,7,0,-7,0,0,0,0.0,0.0,0.0,0.0,0.0,0.0
hambm001,Mark Hamburger,Minnesota Twins,TWINS,1,1,1,2,2008,2008,0,0.04,-0.22,-0.26,5,9,4,0,0,0,24.0,21.0,-3.0,0.0,2000000.0,2000000.0
hamec001,Cole Hamels,Philadelphia Phillies,PHILS,3,8,8,16,2015,2021,6,15.67,15.69,0.02,537,994,457,893,2918,2025,2310.0,1839.0,-471.0,535500.0,0.0,-535500.0
hamec001,Cole Hamels,Texas Rangers,RNGRS,3,7,11,18,2018,2021,3,5.6,-0.52,-6.12,74,38,-36,71,0,-71,654.0,134.0,-520.0,1050000.0,570750.0,-479250.0
hamib001,Billy Hamilton,San Francisco Giants,GIANTS,1,1,1,2,2020,2020,0,-0.14,0.0,0.14,17,0,-17,25,0,-25,0.0,0.0,0.0,0.0,0.0,0.0
hamib101,Billy Hamilton,Philadelphia Phillies,PHILS,1,1,1,2,1895,1895,0,23.74,0.0,-23.74,690,0,-690,3208,0,-3208,0.0,0.0,0.0,0.0,0.0,0.0
hamid001,Darryl Hamilton,San Francisco Giants,GIANTS,1,3,1,4,1998,2000,2,0.87,8.82,7.95,148,284,136,604,1104,500,12.0,0.0,-12.0,2750000.0,4900000.0,2150000.0
hamid001,Darryl Hamilton,Colorado Rockies,ROCKS,2,3,4,7,1999,2000,1,0.73,-0.11,-0.84,211,33,-178,561,29,-532,40.0,37.0,-3.0,4663333.0,3750000.0,-913333.0
hamid101,Dave Hamilton,Oakland Athletics,ATLTCS,2,3,3,6,1975,1977,2,29.94,3.7,-26.24,1323,136,-1187,3295,237,-3058,1993.0,795.0,-1198.0,0.0,0.0,0.0
hamid101,Dave Hamilton,Chicago White Sox,WSOX,1,3,1,4,1977,1978,1,1.03,-0.14,-1.17,221,8,-213,205,0,-205,1727.0,34.0,-1693.0,0.0,0.0,0.0
hamij002,Joey Hamilton,San Diego Padres,PADRS,3,3,6,9,1998,2002,4,12.29,7.38,-4.91,248,543,295,226,597,371,2558.0,2031.0,-527.0,8333333.0,9887500.0,1554167.0
hamij003,Josh Hamilton,Cincinnati Reds,REDS,3,6,5,11,2007,2020,13,31.75,18.42,-13.33,1579,739,-840,5592,559,-5033,1389.0,4964.0,3575.0,9855000.0,460700.0,-9394300.0
hamij003,Josh Hamilton,Anaheim Angels,ANGELS,1,2,1,3,2015,2015,0,0.46,0.0,-0.46,50,0,-50,182,0,-182,0.0,0.0,0.0,0.0,0.0,0.0
hamij101,Jack Hamilton,Philadelphia Phillies,PHILS,5,10,12,22,1963,1979,16,31.38,66.18,34.8,2079,2296,217,6720,6242,-478,3363.0,10159.0,6796.0,74500.0,119800.0,45300.0
hamij101,Jack Hamilton,New York Mets,METS,1,1,1,2,1967,1967,0,0.87,-0.32,-1.19,94,8,-86,47,2,-45,472.0,25.0,-447.0,14000.0,10000.0,-4000.0
hamij101,Jack Hamilton,California Angels,ANGELS,4,4,5,9,1968,1973,5,0.94,3.23,2.29,351,552,201,802,424,-378,491.0,1282.0,791.0,0.0,38000.0,38000.0
hamij101,Jack Hamilton,Cleveland Indians,INDINS,1,1,1,2,1969,1969,0,-1.06,0.0,1.06,16,0,-16,0,0,0,37.0,0.0,-37.0,19000.0,27500.0,8500.0
hamis101,Steve Hamilton,Cleveland Indians,INDINS,1,2,1,3,1962,1962,0,3.15,-0.76,-3.91,294,75,-219,163,225,62,1590.0,0.0,-1590.0,0.0,0.0,0.0
hamis101,Steve Hamilton,Washington Senators,RNGRS,2,2,2,4,1963,1966,3,9.24,1.33,-7.91,642,449,-193,98,1511,1413,1507.0,133.0,-1374.0,0.0,0.0,0.0
hamis101,Steve Hamilton,Chicago White Sox,WSOX,4,6,5,11,1971,1979,8,21.77,19.92,-1.85,843,603,-240,1640,2128,488,4181.0,189.0,-3992.0,258750.0,125000.0,-133750.0
hamit101,Tom Hamilton,Philadelphia Athletics,ATLTCS,46,109,116,225,1953,1976,23,189.08,109.39,-79.69,16486,13560,-2926,40867,38903,-1964,20759.0,16429.0,-4330.0,546100.0,754900.0,208800.0
hamlk101,Ken Hamlin,Pittsburgh Pirates,PIRATS,1,3,1,4,1959,1961,2,-1.03,1.61,2.64,207,144,-63,561,494,-67,547.0,0.0,-547.0,0.0,16500.0,16500.0
hamlk101,Ken Hamlin,Washington Senators,RNGRS,1,1,1,2,1960,1962,2,-0.15,-1.16,-1.01,42,118,76,105,393,288,0.0,0.0,0.0,0.0,0.0,0.0
hamlk101,Ken Hamlin,Los Angeles Angels,ANGELS,5,8,7,15,1961,1968,7,-0.68,8.55,9.23,319,809,490,434,2503,2069,443.0,1270.0,827.0,44000.0,0.0,-44000.0
hamll101,Luke Hamlin,Brooklyn Dodgers,DOGRS,1,4,1,5,1941,1948,7,4.25,10.42,6.17,798,406,-392,2943,1540,-1403,336.0,0.0,-336.0,0.0,0.0,0.0
hamll101,Luke Hamlin,Pittsburgh Pirates,PIRATS,1,1,1,2,1943,1943,0,1.16,0.0,-1.16,58,0,-58,69,0,-69,570.0,0.0,-570.0,0.0,3000.0,3000.0
hamll101,Luke Hamlin,Philadelphia Athletics,ATLTCS,39,85,81,166,1944,1976,32,92.78,71.7,-21.08,10628,9764,-864,25815,30019,4204,12609.0,8252.0,-4357.0,507800.0,639500.0,131700.0
hamma001,Atlee Hammaker,Kansas City Royals,ROYALS,3,7,5,12,1982,1990,8,15.6,24.69,9.09,1105,393,-712,1343,512,-831,5715.0,4650.0,-1065.0,1318000.0,662500.0,-655500.0
hammc001,Chris Hammond,Cincinnati Reds,REDS,8,10,13,23,1993,2013,20,5.83,28.57,22.74,788,1780,992,1301,3221,1920,2189.0,5879.0,3690.0,600000.0,0.0,-600000.0
hammc001,Chris Hammond,New York Yankees,YANKS,3,5,4,9,2003,2006,3,3.3,1.29,-2.01,348,72,-276,33,112,79,842.0,426.0,-416.0,5800000.0,5650000.0,-150000.0
hammj001,Jeffrey Hammonds,Baltimore Orioles,ORLS,1,1,1,2,1998,1998,0,2.64,-0.02,-2.66,149,24,-125,396,53,-343,0.0,0.0,0.0,1333333.0,1750000.0,416667.0
hammj001,Jeffrey Hammonds,Cincinnati Reds,REDS,3,4,6,10,1999,2006,7,1.74,1.96,0.22,719,376,-343,1050,622,-428,650.0,1259.0,609.0,10318333.0,7250000.0,-3068333.0
hammj002,Jason Hammel,Tampa Bay Devil Rays,RAYS,1,1,1,2,2009,2010,1,3.79,0.0,-3.79,189,0,-189,184,0,-184,1574.0,0.0,-1574.0,0.0,0.0,0.0
hammj002,Jason Hammel,Colorado Rockies,ROCKS,2,3,2,5,2012,2012,0,6.7,-1.0,-7.7,199,47,-152,28,33,5,2842.0,306.0,-2536.0,8200000.0,5600000.0,-2600000.0
hammj002,Jason Hammel,Chicago Cubs,CUBS,3,8,6,14,2014,2019,5,16.29,18.03,1.74,803,963,160,2607,3455,848,941.0,121.0,-820.0,0.0,0.0,0.0
hammj003,JD Hammer,Colorado Rockies,ROCKS,1,3,1,4,2017,2017,0,0.33,0.69,0.36,79,53,-26,2,0,-2,117.0,66.0,-51.0,0.0,6500000.0,6500000.0
hammr001,Robby Hammock,Colorado Rockies,ROCKS,1,1,1,2,2010,2010,0,0.0,0.0,0.0,0,0,0,0,0,0,0.0,0.0,0.0,0.0,0.0,0.0
hamng102,Granny Hamner,Philadelphia Phillies,PHILS,1,1,1,2,1959,1959,0,-0.35,1.07,1.42,27,62,35,69,17,-52,0.0,219.0,219.0,0.0,0.0,0.0
hampi101,Ike Hampton,New York Mets,METS,1,1,1,2,1975,1976,1,0.39,1.5,1.11,109,122,13,147,4,-143,0.0,270.0,270.0,0.0,0.0,0.0
hampm001,Mike Hampton,Seattle Mariners,MARNRS,1,2,1,3,1993,1994,1,17.17,-0.83,-18.0,486,79,-407,529,288,-241,3414.0,0.0,-3414.0,959000.0,350000.0,-609000.0
hampm001,Mike Hampton,Houston Astros,ASTROS,4,9,8,17,1999,2008,9,8.59,17.4,8.81,484,1965,1481,1331,4299,2968,1469.0,1829.0,360.0,15440000.0,6237500.0,-9202500.0
hampm001,Mike Hampton,Colorado Rockies,ROCKS,4,7,10,17,2002,2007,5,7.86,3.55,-4.31,711,790,79,2863,2114,-749,329.0,1166.0,837.0,25103543.0,13751000.0,-11352543.0
hampm001,Mike Hampton,Florida Marlins,MARLNS,1,2,2,4,2002,2005,3,5.9,0.15,-5.75,176,66,-110,203,3,-200,1529.0,126.0,-1403.0,0.0,200000.0,200000.0
hamut001,Tim Hamulack,New York Mets,METS,1,2,2,4,2006,2009,3,-1.08,1.54,2.62,102,224,122,21,3,-18,303.0,341.0,38.0,0.0,0.0,0.0
hancg001,Garry Hancock,Cleveland Indians,INDINS,1,1,1,2,1977,1977,0,-1.51,0.0,1.51,121,0,-121,268,0,-268,0.0,0.0,0.0,0.0,0.0,0.0
hancg001,Garry Hancock,Boston Red Sox,RSOX,1,3,2,5,1982,1986,4,26.9,1.92,-24.98,1356,609,-747,5373,2373,-3000,4.0,0.0,-4.0,440000.0,0.0,-440000.0
hancj001,Josh Hancock,Boston Red Sox,RSOX,1,1,1,2,2002,2003,1,-0.22,-0.27,-0.05,12,50,38,2,156,154,36.0,0.0,-36.0,0.0,0.0,0.0
hancj001,Josh Hancock,Philadelphia Phillies,PHILS,1,2,2,4,2004,2004,0,0.46,-0.03,-0.49,65,53,-12,87,1,-86,206.0,76.0,-130.0,0.0,500000.0,500000.0
hancj002,Justin Hancock,San Diego Padres,PADRS,1,1,1,2,2017,2018,1,0.32,0.03,-0.29,20,161,141,2,298,296,37.0,0.0,-37.0,0.0,0.0,0.0
hancl001,Lee Hancock,Seattle Mariners,MARNRS,1,1,1,2,1990,1990,0,-0.19,-0.11,0.08,48,5,-43,0,0,0,97.0,13.0,-84.0,0.0,0.0,0.0
hancr001,Ryan Hancock,Anaheim Angels,ANGELS,1,3,1,4,1997,1997,0,-0.12,-0.13,-0.01,86,32,-54,233,144,-89,0.0,0.0,0.0,0.0,3045000.0,3045000.0
handb001,Brad Hand,San Diego Padres,PADRS,2,6,2,8,2018,2020,2,4.43,0.25,-4.18,334,116,-218,277,344,67,823.0,0.0,-823.0,0.0,7600000.0,7600000.0
handb001,Brad Hand,Washington Nationals,NATEX,1,1,1,2,2021,2021,0,-0.62,0.89,1.51,12,35,23,0,90,90,26.0,0.0,-26.0,10500000.0,0.0,-10500000.0
handb101,Bill Hands,San Francisco Giants,GIANTS,2,3,3,6,1965,1968,3,45.93,0.43,-45.5,1983,248,-1735,4122,39,-4083,6327.0,677.0,-5650.0,0.0,0.0,0.0
handb101,Bill Hands,Chicago Cubs,CUBS,2,5,2,7,1972,1976,4,12.2,0.19,-12.01,299,239,-60,0,36,36,2874.0,554.0,-2320.0,72500.0,25000.0,-47500.0
handb101,Bill Hands,Texas Rangers,RNGRS,1,1,1,2,1976,1976,0,0.0,0.0,0.0,0,0,0,0,0,0,0.0,0.0,0.0,0.0,0.0,0.0
handr101,Rich Hand,Cleveland Indians,INDINS,6,11,10,21,1971,1978,7,26.06,8.28,-17.78,1542,586,-956,3690,1786,-1904,2427.0,1183.0,-1244.0,83000.0,120000.0,37000.0
handr101,Rich Hand,Texas Rangers,RNGRS,7,19,12,31,1973,1988,15,43.57,39.21,-4.36,2413,2544,131,8647,8625,-22,2773.0,4668.0,1895.0,457000.0,165000.0,-292000.0
handr101,Rich Hand,California Angels,ANGELS,1,1,1,2,1974,1975,1,0.0,1.0,1.0,0,11,11,0,0,0,0.0,62.0,62.0,0.0,26000.0,26000.0
hanec001,Chris Haney,Montreal Expos,NATEX,4,6,7,13,1992,1999,7,12.1,6.46,-5.64,755,737,-18,1155,1582,427,2451.0,419.0,-2032.0,1303000.0,340000.0,-963000.0
hanef101,Fred Haney,Detroit Tigers,TIGRS,5,10,10,20,1925,1934,9,27.51,16.34,-11.17,1367,979,-388,4332,3617,-715,3712.0,0.0,-3712.0,19500.0,17200.0,-2300.0
hanef101,Fred Haney,Chicago Cubs,CUBS,1,2,1,3,1927,1927,0,0.0,0.14,0.14,0,13,13,0,31,31,0.0,0.0,0.0,0.0,0.0,0.0
haneh101,Harry Hanebrink,Milwaukee Braves,BRAVES,2,4,4,8,1959,1964,5,9.25,-0.88,-10.13,355,69,-286,908,184,-724,1090.0,0.0,-1090.0,0.0,0.0,0.0
hanel101,Larry Haney,Seattle Pilots,BREWRS,2,2,2,4,1969,1970,1,0.17,-1.21,-1.38,324,216,-108,569,831,262,0.0,0.0,0.0,13000.0,31500.0,18500.0
hanet001,Todd Haney,Seattle Mariners,MARNRS,1,1,1,2,1991,1991,0,0.0,0.0,0.0,0,0,0,0,0,0,0.0,0.0,0.0,0.0,0.0,0.0
hanhe001,Eric Hanhold,Milwaukee Brewers,BREWRS,1,1,2,3,2017,2017,0,-0.06,0.43,0.49,6,38,32,0,149,149,7.0,0.0,-7.0,0.0,17200000.0,17200000.0
hanim001,Mitch Haniger,Milwaukee Brewers,BREWRS,3,5,5,10,2014,2019,5,6.43,9.84,3.41,307,369,62,1146,703,-443,285.0,1843.0,1558.0,8837500.0,5968900.0,-2868600.0
hanim001,Mitch Haniger,Arizona Diamondbacks,DBACKS,1,3,2,5,2016,2019,3,21.55,3.22,-18.33,745,61,-684,3265,58,-3207,14.0,514.0,500.0,2600000.0,1044000.0,-1556000.0
hanir001,Ryan Hanigan,Cincinnati Reds,REDS,1,1,1,2,2013,2015,2,1.37,-0.83,-2.2,84,25,-59,263,19,-244,0.0,175.0,175.0,2050000.0,0.0,-2050000.0
hanir001,Ryan Hanigan,Tampa Bay Devil Rays,RAYS,4,8,12,20,2014,2020,6,10.52,4.14,-6.38,1388,617,-771,4818,2218,-2600,195.0,136.0,-59.0,3254200.0,506400.0,-2747800.0
hanir001,Ryan Hanigan,San Diego Padres,PADRS,1,1,1,2,2014,2015,1,-0.09,-0.81,-0.72,89,83,-6,314,270,-44,0.0,0.0,0.0,0.0,540000.0,540000.0
hanng101,Gerry Hannahs,Montreal Expos,NATEX,1,2,1,3,1978,1979,1,0.0,-1.34,-1.34,10,94,84,4,5,1,54.0,184.0,130.0,0.0,0.0,0.0
hannj001,Jack Hannahan,Detroit Tigers,TIGRS,1,1,1,2,2007,2008,1,3.82,0.0,-3.82,236,0,-236,804,0,-804,0.0,0.0,0.0,0.0,0.0,0.0
hannj001,Jack Hannahan,Oakland Athletics,ATLTCS,1,1,1,2,2009,2009,0,0.6,0.0,-0.6,51,0,-51,167,0,-167,0.0,0.0,0.0,410000.0,0.0,-410000.0
hannj102,Jim Hannan,Washington Senators,RNGRS,6,10,11,21,1970,1976,6,30.0,-0.41,-30.41,2790,834,-1956,8622,1724,-6898,5481.0,1612.0,-3869.0,75900.0,317100.0,241200.0
hannj102,Jim Hannan,Detroit Tigers,TIGRS,1,1,2,3,1971,1971,0,-0.75,0.0,0.75,42,0,-42,3,0,-3,97.0,0.0,-97.0,26500.0,17500.0,-9000.0
hannt101,Truck Hannah,New York Yankees,YANKS,3,12,4,16,1921,1928,7,-3.56,9.03,12.59,367,917,550,1242,3654,2412,159.0,0.0,-159.0,15750.0,13000.0,-2750.0
hanrj001,Joel Hanrahan,Washington Nationals,NATEX,2,3,4,7,2009,2012,3,9.27,5.6,-3.67,881,663,-218,1403,793,-610,688.0,605.0,-83.0,872000.0,820000.0,-52000.0
hanrj001,Joel Hanrahan,Pittsburgh Pirates,PIRATS,3,5,7,12,2012,2020,8,8.64,9.38,0.74,750,717,-33,2244,6,-2238,477.0,1130.0,653.0,4100000.0,1721000.0,-2379000.0
hansa001,Alen Hanson,San Francisco Giants,GIANTS,1,3,1,4,2019,2019,0,-0.38,0.77,1.15,80,156,76,48,628,580,182.0,0.0,-182.0,0.0,0.0,0.0
hansa101,Andy Hansen,Philadelphia Phillies,PHILS,5,10,8,18,1954,1968,14,28.54,39.33,10.79,1270,2132,862,1527,6127,4600,4802.0,3446.0,-1356.0,0.0,0.0,0.0
hansc001,Craig Hansen,Boston Red Sox,RSOX,1,3,1,4,2008,2009,1,-1.7,7.17,8.87,237,200,-37,628,849,221,66.0,0.0,-66.0,18929923.0,6000000.0,-12929923.0
hansd001,Dave Hansen,San Diego Padres,PADRS,1,4,3,7,2004,2004,0,0.63,-0.51,-1.14,139,46,-93,232,85,-147,39.0,43.0,4.0,0.0,0.0,0.0
hansd001,Dave Hansen,Seattle Mariners,MARNRS,1,1,1,2,2004,2008,4,-0.59,0.86,1.45,29,25,-4,31,0,-31,0.0,84.0,84.0,750000.0,0.0,-750000.0
hanse001,Erik Hanson,Seattle Mariners,MARNRS,2,3,3,6,1993,2005,12,5.9,13.17,7.27,829,1554,725,2754,4500,1746,566.0,1101.0,535.0,1250000.0,221000.0,-1029000.0
hansg001,Greg Hansell,Boston Red Sox,RSOX,1,3,1,4,1990,1991,1,0.0,0.54,0.54,0,52,52,0,179,179,0.0,0.0,0.0,0.0,1100000.0,1100000.0
hansg001,Greg Hansell,New York Mets,METS,3,4,3,7,1990,1994,4,2.55,1.07,-1.48,331,342,11,618,888,270,1125.0,394.0,-731.0,4116666.0,2749167.0,-1367499.0
hansg001,Greg Hansell,Los Angeles Dodgers,DOGRS,1,4,2,6,1995,1998,3,-0.49,1.39,1.88,829,429,-400,2713,30,-2683,618.0,819.0,201.0,218000.0,4410000.0,4192000.0
hansg001,Greg Hansell,Oakland Athletics,ATLTCS,1,2,1,3,1998,1999,1,0.37,0.52,0.15,66,159,93,229,474,245,0.0,0.0,0.0,450000.0,725000.0,275000.0
hansr102,Ron Hansen,Baltimore Orioles,ORLS,4,10,7,17,1963,1973,10,64.06,37.52,-26.54,3307,1677,-1630,9685,6745,-2940,2176.0,306.0,-1870.0,108500.0,40300.0,-68200.0
hansr102,Ron Hansen,Chicago White Sox,WSOX,4,7,7,14,1968,1971,3,11.44,1.3,-10.14,1683,516,-1167,5097,1341,-3756,666.0,366.0,-300.0,31000.0,33000.0,2000.0
hansr102,Ron Hansen,Washington Senators,RNGRS,1,1,1,2,1968,1972,4,0.33,1.36,1.03,125,414,289,306,1147,841,0.0,0.0,0.0,33000.0,15500.0,-17500.0
hanss101,Snipe Hansen,Philadelphia Phillies,PHILS,2,2,4,6,1935,1938,3,0.0,-1.17,-1.17,0,336,336,0,1082,1082,0.0,256.0,256.0,0.0,0.0,0.0
hanst001,Tommy Hanson,Atlanta Braves,BRAVES,4,7,7,14,2012,2021,9,5.79,12.35,6.56,251,1095,844,658,2525,1867,667.0,1556.0,889.0,7060000.0,1529000.0,-5531000.0
happj001,J.A. Happ,Philadelphia Phillies,PHILS,1,3,1,4,2010,2011,1,1.12,5.11,3.99,320,74,-246,775,83,-692,998.0,665.0,-333.0,470000.0,15000000.0,14530000.0
happj001,J.A. Happ,Houston Astros,ASTROS,4,10,10,20,2012,2019,7,17.22,11.07,-6.15,1238,246,-992,2359,341,-2018,4222.0,1816.0,-2406.0,8335000.0,6555000.0,-1780000.0
happj001,J.A. Happ,Toronto Blue Jays,BJAYS,1,1,1,2,2014,2016,2,0.7,1.3,0.6,22,149,127,2,594,592,326.0,0.0,-326.0,5200000.0,2300000.0,-2900000.0
happj001,J.A. Happ,Seattle Mariners,MARNRS,1,1,1,2,2015,2016,1,2.39,-0.02,-2.41,22,1,-21,25,0,-25,190.0,14.0,-176.0,6700000.0,0.0,-6700000.0
happj001,J.A. Happ,Toronto Blue Jays,BJAYS,1,1,2,3,2018,2020,2,4.31,-1.13,-5.44,53,271,218,4,932,928,823.0,0.0,-823.0,13000000.0,621900.0,-12378100.0
happj001,J.A. Happ,Minnesota Twins,TWINS,1,2,2,4,2021,2021,0,0.27,-0.36,-0.63,21,16,-5,15,0,-15,162.0,101.0,-61.0,8000000.0,2100000.0,-5900000.0
haraa001,Aaron Harang,Texas Rangers,RNGRS,2,3,3,6,2000,2005,5,0.93,1.27,0.34,41,153,112,59,334,275,326.0,195.0,-131.0,3150000.0,3050000.0,-100000.0
haraa001,Aaron Harang,Oakland Athletics,ATLTCS,1,3,1,4,2003,2003,0,14.51,0.2,-14.31,509,45,-464,479,186,-293,4166.0,0.0,-4166.0,0.0,0.0,0.0
haraa001,Aaron Harang,Los Angeles Dodgers,DOGRS,1,2,1,3,2013,2013,0,0.0,0.19,0.19,0,17,17,0,55,55,0.0,0.0,0.0,0.0,0.0,0.0
haraa001,Aaron Harang,Colorado Rockies,ROCKS,1,2,1,3,2013,2013,0,-0.94,0.0,0.94,24,0,-24,4,0,-4,361.0,0.0,-361.0,0.0,0.0,0.0
hardc101,Carroll Hardy,Cleveland Indians,INDINS,1,2,2,4,1960,1960,0,-2.2,-1.2,1.0,772,87,-685,2350,176,-2174,0.0,122.0,122.0,0.0,0.0,0.0
hardc101,Carroll Hardy,Boston Red Sox,RSOX,1,1,1,2,1962,1964,2,-0.97,0.32,1.29,61,140,79,215,229,14,0.0,0.0,0.0,0.0,0.0,0.0
hardc101,Carroll Hardy,Houston Astros,ASTROS,1,1,1,2,1965,1965,0,0.23,0.0,-0.23,11,0,-11,9,0,-9,0.0,0.0,0.0,0.0,0.0,0.0
hardj002,Jason Hardtke,Cleveland Indians,INDINS,4,5,4,9,1992,1994,2,0.28,1.85,1.57,412,216,-196,1134,642,-492,15.0,40.0,25.0,325000.0,975500.0,650500.0
hardj003,J.J. Hardy,Milwaukee Brewers,BREWRS,4,7,8,15,2009,2020,11,1.27,27.3,26.03,554,1475,921,1607,5251,3644,1628.0,6.0,-1622.0,5734900.0,437500.0,-5297400.0
hardj003,J.J. Hardy,Minnesota Twins,TWINS,1,2,2,4,2010,2011,1,15.73,-0.62,-16.35,889,27,-862,3636,0,-3636,0.0,74.0,74.0,6550000.0,0.0,-6550000.0
hardj101,Jim Hardin,Baltimore Orioles,ORLS,2,2,2,4,1971,1972,1,-0.56,0.0,0.56,24,0,-24,4,0,-4,85.0,0.0,-85.0,27000.0,13000.0,-14000.0
hardl101,Larry Hardy,San Diego Padres,PADRS,1,2,1,3,1975,1977,2,-0.91,4.82,5.73,30,191,161,2,745,743,65.0,0.0,-65.0,0.0,0.0,0.0
hardr001,Rich Harden,Oakland Athletics,ATLTCS,12,17,20,37,2008,2021,13,30.54,32.16,1.62,1528,2032,504,3830,6153,2323,1492.0,2561.0,1069.0,13440000.0,8216100.0,-5223900.0
hardr101,Red Hardy,New York Giants,GIANTS,1,2,1,3,1951,1951,0,0.0,0.0,0.0,0,13,13,0,13,13,0.0,0.0,0.0,0.0,0.0,0.0
hared001,Dan Haren,St. Louis Cardinals,CARDS,1,3,1,4,2004,2008,4,22.03,0.48,-21.55,848,107,-741,2102,105,-1997,2465.0,933.0,-1532.0,305000.0,4450000.0,4145000.0
hared001,Dan Haren,Oakland Athletics,ATLTCS,15,28,26,54,2007,2018,11,108.14,27.37,-80.77,6020,2116,-3904,18233,6199,-12034,5643.0,3558.0,-2085.0,32617500.0,22402333.0,-10215167.0
hared001,Dan Haren,Arizona Diamondbacks,DBACKS,4,7,13,20,2010,2018,8,13.03,15.69,2.66,400,914,514,450,1808,1358,3432.0,4474.0,1042.0,14741000.0,9940000.0,-4801000.0
hared001,Dan Haren,Los Angeles Dodgers,DOGRS,4,7,8,15,2014,2020,6,27.35,10.53,-16.82,1361,1127,-234,4322,2916,-1406,2273.0,350.0,-1923.0,21765000.0,9877000.0,-11888000.0
hared001,Dan Haren,Miami Marlins,MARLNS,1,2,2,4,2015,2016,1,0.17,0.0,-0.17,21,0,-21,23,0,-23,175.0,0.0,-175.0,10000000.0,0.0,-10000000.0
harga001,Alan Hargesheimer,San Francisco Giants,GIANTS,1,1,1,2,1982,1982,0,-0.12,0.0,0.12,10,0,-10,0,0,0,12.0,0.0,-12.0,0.0,0.0,0.0
harga001,Alan Hargesheimer,Chicago Cubs,CUBS,1,1,2,3,1984,1985,1,-0.09,-0.02,0.07,5,22,17,0,15,15,39.0,132.0,93.0,0.0,0.0,0.0
hargb101,Bubbles Hargrave,Cincinnati Reds,REDS,1,1,1,2,1928,1928,0,0.0,0.0,0.0,0,0,0,0,0,0,0.0,0.0,0.0,10000.0,0.0,-10000.0
hargb101,Bubbles Hargrave,StPaul,StPaul,1,1,3,4,1929,1930,1,0.05,0.0,-0.05,45,0,-45,121,0,-121,0.0,0.0,0.0,0.0,15000.0,15000.0
hargc101,Charlie Hargreaves,Brooklyn Dodgers,DOGRS,2,3,3,6,1928,1933,5,0.59,-0.45,-1.04,414,285,-129,1298,710,-588,148.0,0.0,-148.0,7500.0,16000.0,8500.0
hargc101,Charlie Hargreaves,New York Yankees,YANKS,3,7,3,10,1933,1948,15,-3.37,1.52,4.89,613,291,-322,2436,971,-1465,0.0,0.0,0.0,9000.0,3000.0,-6000.0
hargm001,Mike Hargrove,Texas Rangers,RNGRS,2,7,7,14,1978,1985,7,13.84,11.07,-2.77,1150,730,-420,2985,2621,-364,918.0,0.0,-918.0,475000.0,608333.0,133333.0
hargm001,Mike Hargrove,San Diego Padres,PADRS,1,1,1,2,1979,1980,1,13.96,0.22,-13.74,888,144,-744,3538,375,-3163,0.0,0.0,0.0,0.0,0.0,0.0
hargp101,Pinky Hargrave,Washington Senators,TWINS,1,3,1,4,1924,1927,3,0.0,0.0,0.0,0,0,0,0,0,0,0.0,0.0,0.0,2800.0,0.0,-2800.0
hargp101,Pinky Hargrave,Washington Senators,TWINS,1,2,1,3,1925,1926,1,2.26,0.7,-1.56,163,72,-91,505,162,-343,46.0,0.0,-46.0,3200.0,0.0,-3200.0
hargp101,Pinky Hargrave,St.Louis Browns,ORLS,25,52,60,112,1927,1952,25,169.13,172.17,3.04,8392,11292,2900,28367,37730,9363,13765.0,19339.0,5574.0,243500.0,227450.0,-16050.0
hargp101,Pinky Hargrave,Washington Senators,TWINS,1,5,1,6,1931,1939,8,0.0,8.51,8.51,0,385,385,0,407,407,0.0,3095.0,3095.0,6500.0,0.0,-6500.0
hargs101,Steve Hargan,Cleveland Indians,INDINS,1,1,1,2,1973,1975,2,1.63,-0.02,-1.65,111,5,-106,0,0,0,1538.0,41.0,-1497.0,0.0,0.0,0.0
hargs101,Steve Hargan,Toronto Blue Jays,BJAYS,1,3,1,4,1977,1980,3,-0.59,9.29,9.88,97,516,419,181,2168,1987,37.0,0.0,-37.0,0.0,0.0,0.0
harkt101,Tim Harkness,Philadelphia Phillies,PHILS,2,8,4,12,1957,1962,5,1.07,-3.22,-4.29,707,621,-86,1985,2063,78,115.0,0.0,-115.0,9000.0,0.0,-9000.0
harkt101,Tim Harkness,Los Angeles Dodgers,DOGRS,2,5,3,8,1962,1968,6,8.72,5.17,-3.55,1130,752,-378,1613,597,-1016,1656.0,2078.0,422.0,122000.0,73000.0,-49000.0
harkt101,Tim Harkness,New York Mets,METS,2,4,2,6,1964,1966,2,-0.11,0.72,0.83,10,206,196,19,669,650,0.0,0.0,0.0,0.0,0.0,0.0
harld101,Dick Harley,Philadelphia Phillies,PHILS,2,8,4,12,1897,1902,5,7.8,14.46,6.66,959,936,-23,3811,3203,-608,1192.0,3296.0,2104.0,0.0,0.0,0.0
harld101,Dick Harley,Chicago Cubs,CUBS,2,9,2,11,1903,1913,10,5.14,24.13,18.99,814,1109,295,3290,4566,1276,0.0,1329.0,1329.0,0.0,0.0,0.0
harll101,Larry Harlow,Baltimore Orioles,ORLS,3,3,4,7,1979,1984,5,1.23,-0.24,-1.47,586,68,-518,1414,121,-1293,0.0,0.0,0.0,0.0,0.0,0.0
harmb101,Bob Harmon,St. Louis Cardinals,CARDS,1,3,5,8,1913,1920,7,9.94,10.5,0.56,493,813,320,1225,2891,1666,2306.0,795.0,-1511.0,13500.0,11400.0,-2100.0
harmc101,Chuck Harmon,Cincinnati Reds,REDS,4,6,10,16,1956,1966,10,5.05,6.96,1.91,780,904,124,1896,2781,885,111.0,126.0,15.0,0.0,10500.0,10500.0
harmc101,Chuck Harmon,St. Louis Cardinals,CARDS,1,1,1,2,1957,1957,0,-0.12,0.0,0.12,57,0,-57,87,0,-87,0.0,0.0,0.0,0.0,0.0,0.0
harnp001,Pete Harnisch,Baltimore Orioles,ORLS,1,3,1,4,1991,1993,2,24.17,0.73,-23.44,904,185,-719,2612,764,-1848,2435.0,0.0,-2435.0,0.0,0.0,0.0
harnp001,Pete Harnisch,Houston Astros,ASTROS,1,1,2,3,1994,1995,1,-0.19,0.0,0.19,111,0,-111,113,0,-113,991.0,0.0,-991.0,3205000.0,0.0,-3205000.0
harnp001,Pete Harnisch,New York Mets,METS,1,1,1,2,1997,1997,0,0.02,0.0,-0.02,4,0,-4,0,0,0,42.0,0.0,-42.0,3213400.0,0.0,-3213400.0
harpb001,Brian Harper,California Angels,ANGELS,2,2,3,5,1981,1983,2,-0.1,-0.06,0.04,188,238,50,464,877,413,0.0,0.0,0.0,0.0,0.0,0.0
harpb001,Brian Harper,Pittsburgh Pirates,PIRATS,3,8,8,16,1984,1992,8,29.05,20.57,-8.48,821,1486,665,1077,1551,474,5314.0,7059.0,1745.0,1030000.0,180000.0,-850000.0
harpg101,George Harper,Cincinnati Reds,REDS,1,1,1,2,1924,1931,7,6.55,18.82,12.27,297,953,656,1221,3945,2724,0.0,0.0,0.0,5000.0,4500.0,-500.0
harpg101,George Harper,Philadelphia Phillies,PHILS,6,14,12,26,1927,1941,14,22.91,29.99,7.08,1578,2406,828,6069,6892,823,324.0,5521.0,5197.0,17000.0,18200.0,1200.0
harpg101,George Harper,New York Giants,GIANTS,4,12,7,19,1928,1949,21,17.78,57.5,39.72,1402,2923,1521,4027,10802,6775,2269.0,40.0,-2229.0,10500.0,25000.0,14500.0
harpg101,George Harper,Boston Braves,BRAVES,2,4,3,7,1929,1938,9,1.82,35.74,33.92,75,1097,1022,255,4575,4320,0.0,229.0,229.0,27000.0,0.0,-27000.0
harph101,Harry Harper,Washington Senators,TWINS,3,6,5,11,1919,1926,7,13.31,20.32,7.01,1029,562,-467,3656,1370,-2286,534.0,3052.0,2518.0,16400.0,11500.0,-4900.0
harph101,Harry Harper,Boston Red Sox,RSOX,11,21,24,45,1920,1937,17,85.68,51.32,-34.36,3377,2671,-706,8411,9094,683,11819.0,4939.0,-6880.0,73300.0,46200.0,-27100.0
harpj102,Jack Harper,Chicago Cubs,CUBS,1,3,1,4,1906,1907,1,-0.07,-0.01,0.06,10,44,34,15,51,36,108.0,415.0,307.0,0.0,0.0,0.0
harpr001,Ryne Harper,Atlanta Braves,BRAVES,1,1,1,2,2015,2018,3,0.0,0.33,0.33,0,212,212,0,0,0,0.0,303.0,303.0,0.0,0.0,0.0
harpr001,Ryne Harper,Minnesota Twins,TWINS,1,1,1,2,2020,2020,0,-0.01,0.0,0.01,89,0,-89,2,0,-2,178.0,0.0,-178.0,0.0,0.0,0.0
harpt001,Terry Harper,Atlanta Braves,BRAVES,3,4,4,8,1987,1993,6,1.55,1.95,0.4,257,575,318,99,38,-61,607.0,1203.0,596.0,215000.0,0.0,-215000.0
harpt001,Terry Harper,Detroit Tigers,TIGRS,1,1,2,3,1987,1987,0,-0.14,0.0,0.14,36,0,-36,73,0,-73,0.0,0.0,0.0,425000.0,0.0,-425000.0
harpt101,Tommy Harper,Cincinnati Reds,REDS,2,2,4,6,1967,1971,4,1.65,-0.91,-2.56,152,386,234,285,403,118,170.0,1181.0,1011.0,25000.0,62000.0,37000.0
harpt101,Tommy Harper,Milwaukee Brewers,BREWRS,9,23,22,45,1971,1984,13,35.91,84.88,48.97,2475,4171,1696,6161,14852,8691,10247.0,5331.0,-4916.0,466901.0,45000.0,-421901.0
harpt101,Tommy Harper,Boston Red Sox,RSOX,1,1,1,2,1974,1976,2,0.24,-0.35,-0.59,89,95,6,332,199,-133,0.0,0.0,0.0,90000.0,0.0,-90000.0
harrb001,Brendan Harris,Chicago Cubs,CUBS,2,8,4,12,2004,2009,5,11.71,9.74,-1.97,643,537,-106,2292,1477,-815,256.0,718.0,462.0,5750000.0,6525000.0,775000.0
harrb001,Brendan Harris,Washington Nationals,NATEX,1,5,3,8,2006,2009,3,-0.61,0.43,1.04,705,795,90,181,2860,2679,809.0,139.0,-670.0,1352000.0,4550000.0,3198000.0
harrb001,Brendan Harris,Tampa Bay Devil Rays,RAYS,6,10,18,28,2007,2018,11,7.31,39.77,32.46,1554,1744,190,4454,3404,-1050,1936.0,6404.0,4468.0,6476100.0,1362800.0,-5113300.0
harrb001,Brendan Harris,Minnesota Twins,TWINS,1,2,2,4,2010,2011,1,15.73,-0.62,-16.35,889,27,-862,3636,0,-3636,0.0,74.0,74.0,6550000.0,0.0,-6550000.0
harrb101,Bud Harrelson,New York Mets,METS,1,1,2,3,1978,1978,0,0.97,0.0,-0.97,124,0,-124,214,0,-214,0.0,0.0,0.0,0.0,0.0,0.0
harrb102,Bill Harrington,Kansas City Athletics,ATLTCS,40,86,88,174,1956,1976,20,134.11,73.29,-60.82,13270,9412,-3858,30102,25264,-4838,19786.0,12575.0,-7211.0,506100.0,652200.0,146100.0
harrb103,Billy Harrell,St. Louis Cardinals,CARDS,2,7,3,10,1960,1963,3,1.56,-0.35,-1.91,364,164,-200,1157,310,-847,0.0,0.0,0.0,0.0,0.0,0.0
harrb104,Bubba Harris,Philadelphia Athletics,ATLTCS,1,1,2,3,1951,1951,0,0.0,0.0,0.0,4,0,-4,0,0,0,12.0,0.0,-12.0,0.0,0.0,0.0
harrb105,Bill Harris,Buffalo,Buffalo,1,1,1,2,1938,1938,0,1.52,0.0,-1.52,26,0,-26,31,0,-31,241.0,0.0,-241.0,0.0,0.0,0.0
harrb106,Bucky Harris,Buffalo,Buffalo,1,1,2,3,1919,1919,0,16.16,0.0,-16.16,1252,0,-1252,5536,0,-5536,0.0,0.0,0.0,0.0,4200.0,4200.0
harrb106,Bucky Harris,Washington Senators,TWINS,1,1,1,2,1928,1933,5,-0.15,0.0,0.15,11,0,-11,23,0,-23,0.0,0.0,0.0,30000.0,0.0,-30000.0
harrb107,Buddy Harris,Houston Astros,ASTROS,2,3,3,6,1972,1973,1,0.39,0.74,0.35,34,93,59,92,236,144,0.0,0.0,0.0,0.0,0.0,0.0
harrb109,Bob Harris,Detroit Tigers,TIGRS,3,9,7,16,1939,1948,9,19.29,21.11,1.82,2183,1686,-497,6579,6030,-549,3951.0,2317.0,-1634.0,44300.0,54500.0,10200.0
harrb109,Bob Harris,St.Louis Browns,ORLS,3,4,5,9,1942,1952,10,5.24,7.57,2.33,522,583,61,1337,761,-576,901.0,2542.0,1641.0,21000.0,7000.0,-14000.0
harrb110,Bill Harrelson,California Angels,ANGELS,1,2,1,3,1970,1970,0,0.0,0.0,0.0,0,0,0,0,0,0,0.0,0.0,0.0,0.0,0.0,0.0
harrc101,Chuck Harrison,Houston Astros,ASTROS,9,17,16,33,1967,1989,22,77.09,75.22,-1.87,5400,5677,277,17448,17542,94,3810.0,7694.0,3884.0,705000.0,416000.0,-289000.0
harrd101,Dave Harris,Chicago White Sox,WSOX,1,1,1,2,1930,1930,0,5.84,-0.32,-6.16,410,85,-325,1185,299,-886,0.0,0.0,0.0,5000.0,4500.0,-500.0
harrd101,Dave Harris,Washington Senators,TWINS,2,4,3,7,1934,1939,5,1.0,0.43,-0.57,49,132,83,167,445,278,0.0,0.0,0.0,6000.0,0.0,-6000.0
harre101,Earl Harrist,Chicago White Sox,WSOX,1,1,1,2,1948,1950,2,0.33,-1.13,-1.46,46,140,94,18,85,67,182.0,708.0,526.0,0.0,0.0,0.0
harre101,Earl Harrist,Detroit Tigers,TIGRS,1,2,1,3,1954,1954,0,0.0,0.0,0.0,0,0,0,0,0,0,0.0,0.0,0.0,0.0,0.0,0.0
harrg001,Greg Harris,New York Mets,METS,1,3,1,4,1982,1986,4,1.8,4.68,2.88,378,655,277,630,2610,1980,505.0,0.0,-505.0,0.0,0.0,0.0
harrg001,Greg Harris,Montreal Expos,NATEX,2,2,2,4,1984,1987,3,2.5,-0.67,-3.17,656,120,-536,1884,244,-1640,110.0,0.0,-110.0,0.0,0.0,0.0
harrg002,Greg Harris,San Diego Padres,PADRS,18,35,38,73,1993,2021,28,53.28,80.99,27.71,3600,5089,1489,12022,13376,1354,2601.0,11891.0,9290.0,37678200.0,21960000.0,-15718200.0
harrg003,Gene Harris,Montreal Expos,NATEX,2,4,3,7,1989,1990,1,45.42,4.9,-40.52,412,48,-364,8,66,58,7430.0,530.0,-6900.0,138000.0,1350000.0,1212000.0
harrg003,Gene Harris,Seattle Mariners,MARNRS,1,1,1,2,1992,1992,0,0.92,0.0,-0.92,173,0,-173,5,0,-5,279.0,0.0,-279.0,130000.0,0.0,-130000.0
harrg003,Gene Harris,San Diego Padres,PADRS,8,15,17,32,1994,2006,12,5.41,22.13,16.72,988,2162,1174,2783,7186,4403,251.0,238.0,-13.0,12344680.0,13645000.0,1300320.0
harrg003,Gene Harris,Philadelphia Phillies,PHILS,1,1,1,2,1995,1995,0,0.05,0.25,0.2,3,63,60,0,247,247,12.0,0.0,-12.0,0.0,600000.0,600000.0
harrg101,Gail Harris,San Francisco Giants,GIANTS,2,3,4,7,1958,1958,0,0.51,0.0,-0.51,435,23,-412,1397,29,-1368,0.0,0.0,0.0,0.0,0.0,0.0
harrg101,Gail Harris,Detroit Tigers,TIGRS,1,1,1,2,1960,1960,0,0.0,-0.38,-0.38,0,65,65,0,81,81,0.0,0.0,0.0,0.0,0.0,0.0
harrj002,Josh Harrison,Chicago Cubs,CUBS,2,4,5,9,2009,2013,4,14.85,0.73,-14.12,1031,310,-721,3072,59,-3013,719.0,863.0,144.0,405000.0,2300000.0,1895000.0
harrj002,Josh Harrison,Washington Nationals,NATEX,1,3,3,6,2021,2021,0,-0.1,0.0,0.1,88,0,-88,339,0,-339,0.0,0.0,0.0,7000000.0,0.0,-7000000.0
harrj101,John Harris,California Angels,ANGELS,1,1,1,2,1983,1983,0,0.0,-0.21,-0.21,0,26,26,0,65,65,0.0,0.0,0.0,0.0,0.0,0.0
harrj103,Joe Harris,Cleveland Indians,INDINS,1,3,1,4,1921,1923,2,18.85,0.33,-18.52,768,142,-626,3109,582,-2527,0.0,0.0,0.0,10000.0,5000.0,-5000.0
harrj103,Joe Harris,Boston Red Sox,RSOX,2,5,4,9,1925,1926,1,5.81,1.68,-4.13,192,272,80,672,587,-85,0.0,1044.0,1044.0,23750.0,3600.0,-20150.0
harrj103,Joe Harris,Pittsburgh Pirates,PIRATS,1,2,1,3,1928,1933,5,-0.02,-0.43,-0.41,98,192,94,214,667,453,0.0,0.0,0.0,16000.0,7500.0,-8500.0
harrk101,Ken Harrelson,Kansas City Athletics,ATLTCS,2,2,2,4,1966,1968,2,-0.16,0.64,0.8,107,192,85,373,20,-353,43.0,496.0,453.0,0.0,12000.0,12000.0
harrk101,Ken Harrelson,Boston Red Sox,RSOX,3,6,6,12,1969,1973,4,5.38,12.96,7.58,1093,699,-394,2374,1115,-1259,1155.0,3166.0,2011.0,26500.0,34500.0,8000.0
harrl001,Lenny Harris,Cincinnati Reds,REDS,2,4,4,8,1989,1997,8,8.78,16.08,7.3,969,1208,239,2884,4618,1734,1277.0,269.0,-1008.0,325000.0,870000.0,545000.0
harrl001,Lenny Harris,Cincinnati Reds,REDS,3,3,4,7,1998,2001,3,-0.51,0.6,1.11,324,163,-161,485,4,-481,157.0,294.0,137.0,2075000.0,5699000.0,3624000.0
harrl001,Lenny Harris,Colorado Rockies,ROCKS,1,1,1,2,1999,1999,0,-0.85,0.0,0.85,55,0,-55,121,0,-121,0.0,0.0,0.0,1125000.0,0.0,-1125000.0
harrl001,Lenny Harris,Arizona Diamondbacks,DBACKS,1,1,1,2,2000,2000,0,-0.02,0.0,0.02,186,0,-186,300,0,-300,0.0,0.0,0.0,1100000.0,0.0,-1100000.0
harrl001,Lenny Harris,New York Mets,METS,11,24,26,50,2002,2021,19,23.92,23.68,-0.24,974,1702,728,1624,4506,2882,6006.0,3554.0,-2452.0,30731467.0,4325000.0,-26406467.0
harrl002,Lucas Harrell,Houston Astros,ASTROS,1,1,1,2,2014,2014,0,0.0,0.0,0.0,0,0,0,0,0,0,0.0,0.0,0.0,509700.0,0.0,-509700.0
harrl002,Lucas Harrell,Atlanta Braves,BRAVES,2,4,2,6,2016,2021,5,-1.23,0.82,2.05,102,117,15,219,0,-219,140.0,208.0,68.0,0.0,4000000.0,4000000.0
harrl101,Lum Harris,Atlanta,Atlanta,1,1,1,2,1940,1941,1,4.15,0.0,-4.15,296,0,-296,290,0,-290,2441.0,0.0,-2441.0,0.0,3000.0,3000.0
harrl101,Lum Harris,Philadelphia Athletics,ATLTCS,38,83,80,163,1947,1976,29,92.78,73.92,-18.86,10628,9649,-979,25815,29918,4103,12609.0,7417.0,-5192.0,507800.0,639500.0,131700.0
harrl101,Lum Harris,Detroit Tigers,TIGRS,1,3,1,4,1949,1950,1,0.0,0.0,0.0,0,0,0,0,0,0,0.0,0.0,0.0,0.0,0.0,0.0
harrm001,Matt Harrison,Atlanta Braves,BRAVES,3,7,5,12,2007,2009,2,51.72,9.48,-42.24,2314,404,-1910,8153,1445,-6708,2789.0,84.0,-2705.0,15385000.0,11700000.0,-3685000.0
harrm001,Matt Harrison,Texas Rangers,RNGRS,5,14,16,30,2015,2021,6,11.03,13.28,2.25,790,293,-497,1664,16,-1648,2536.0,2164.0,-372.0,3762500.0,1106250.0,-2656250.0
harrm003,Monte Harrison,Milwaukee Brewers,BREWRS,1,4,1,5,2018,2018,0,-6.06,7.26,13.32,541,147,-394,1645,651,-994,270.0,0.0,-270.0,0.0,0.0,0.0
harrm101,Mickey Harris,Boston Red Sox,RSOX,2,4,2,6,1949,1955,6,5.69,3.6,-2.09,738,340,-398,1644,197,-1447,2239.0,1844.0,-395.0,22000.0,0.0,-22000.0
harrp001,Pep Harris,Cleveland Indians,INDINS,1,2,1,3,1996,1997,1,1.47,1.07,-0.4,162,18,-144,0,0,0,907.0,298.0,-609.0,0.0,0.0,0.0
harrr102,Roric Harrison,Houston Astros,ASTROS,1,2,1,3,1969,1970,1,0.39,-0.47,-0.86,18,90,72,1,24,23,43.0,312.0,269.0,23500.0,22000.0,-1500.0
harrr102,Roric Harrison,Milwaukee Brewers,BREWRS,1,2,1,3,1971,1972,1,2.12,-1.77,-3.89,78,65,-13,19,18,-1,282.0,203.0,-79.0,0.0,0.0,0.0
harrr102,Roric Harrison,Baltimore Orioles,ORLS,6,18,15,33,1972,1988,16,21.6,72.74,51.14,1757,3477,1720,3464,7736,4272,7768.0,11016.0,3248.0,691833.0,37000.0,-654833.0
harrr102,Roric Harrison,Atlanta Braves,BRAVES,2,2,3,5,1975,1976,1,-0.16,-2.92,-2.76,27,78,51,0,142,142,462.0,168.0,-294.0,0.0,0.0,0.0
harrr102,Roric Harrison,Cleveland Indians,INDINS,1,1,1,2,1976,1976,0,0.0,0.27,0.27,0,3,3,0,0,0,0.0,21.0,21.0,0.0,0.0,0.0
harrr103,Ray Harrell,Chicago Cubs,CUBS,1,3,1,4,1939,1947,8,6.07,34.45,28.38,546,585,39,1567,751,-816,1708.0,5741.0,4033.0,9500.0,8000.0,-1500.0
harrr103,Ray Harrell,Pittsburgh Pirates,PIRATS,1,2,1,3,1940,1941,1,0.0,-0.29,-0.29,0,28,28,0,41,41,0.0,0.0,0.0,0.0,0.0,0.0
harrs101,Slim Harriss,Philadelphia Athletics,ATLTCS,1,3,1,4,1926,1930,4,3.68,8.68,5.0,373,175,-198,792,208,-584,1683.0,1623.0,-60.0,10500.0,10000.0,-500.0
harrs101,Slim Harriss,Boston Red Sox,RSOX,1,2,2,4,1928,1928,0,0.0,0.0,0.0,0,0,0,0,0,0,0.0,0.0,0.0,3000.0,0.0,-3000.0
harrs102,Spence Harris,Boston Red Sox,RSOX,1,4,1,5,1937,1937,0,0.0,0.0,0.0,0,0,0,0,0,0,0.0,0.0,0.0,3000.0,0.0,-3000.0
harrt001,Toby Harrah,Texas Rangers,RNGRS,4,7,6,13,1978,1996,18,32.3,48.6,16.3,1736,1710,-26,7101,5718,-1383,1191.0,1995.0,804.0,15083333.0,7550000.0,-7533333.0
harrt001,Toby Harrah,Cleveland Indians,INDINS,14,25,32,57,1984,2001,17,110.22,66.9,-43.32,6314,5064,-1250,18977,18204,-773,7708.0,2374.0,-5334.0,19613332.0,19125000.0,-488332.0
harrt001,Toby Harrah,New York Yankees,YANKS,2,2,3,5,1985,1985,0,4.74,0.32,-4.42,313,59,-254,1083,154,-929,0.0,0.0,0.0,435000.0,0.0,-435000.0
harrv101,Vic Harris,Oakland Athletics,ATLTCS,2,4,3,7,1972,1975,3,-3.14,2.17,5.31,448,341,-107,1329,643,-686,48.0,183.0,135.0,42500.0,0.0,-42500.0
harrv101,Vic Harris,Texas Rangers,RNGRS,10,21,18,39,1973,1986,13,53.55,28.53,-25.02,2537,1434,-1103,5090,3729,-1361,9799.0,4115.0,-5684.0,214000.0,360000.0,146000.0
harrv101,Vic Harris,Chicago Cubs,CUBS,1,1,1,2,1975,1981,6,-0.62,-1.28,-0.66,97,433,336,282,869,587,0.0,0.0,0.0,0.0,0.0,0.0
harrv101,Vic Harris,St. Louis Cardinals,CARDS,17,40,34,74,1976,1994,18,91.08,139.58,48.5,8485,6698,-1787,23608,22939,-669,10540.0,4019.0,-6521.0,3088333.0,809167.0,-2279166.0
harrw001,Willie Harris,Baltimore Orioles,ORLS,1,1,1,2,2002,2002,0,1.61,1.84,0.23,313,136,-177,938,502,-436,0.0,0.0,0.0,0.0,0.0,0.0
harsj101,Jack Harshman,SanDiego,SanDiego,1,1,4,5,1947,1947,0,-0.83,0.0,0.83,19,0,-19,46,0,-46,19.0,0.0,-19.0,0.0,0.0,0.0
harsj101,Jack Harshman,Chicago White Sox,WSOX,15,26,28,54,1957,1969,12,18.37,37.27,18.9,2207,3220,1013,3806,5515,1709,4631.0,7668.0,3037.0,148250.0,102500.0,-45750.0
harsj101,Jack Harshman,Baltimore Orioles,ORLS,12,26,26,52,1959,1988,29,22.0,95.75,73.75,2246,4931,2685,3904,9135,5231,9599.0,14641.0,5042.0,725833.0,57000.0,-668833.0
hartb102,Bruce Hartford,Cleveland Indians,INDINS,1,2,1,3,1914,1914,0,0.0,0.0,0.0,0,1,1,0,1,1,0.0,0.0,0.0,0.0,0.0,0.0
hartb106,Bill Hart,Pittsburgh Pirates,PIRATS,1,3,1,4,1896,1901,5,1.66,8.07,6.41,433,743,310,1375,3049,1674,1892.0,0.0,-1892.0,0.0,0.0,0.0
hartb106,Bill Hart,St. Louis Cardinals,CARDS,1,1,2,3,1897,1899,2,0.14,3.26,3.12,32,70,38,51,111,60,375.0,851.0,476.0,0.0,0.0,0.0
hartb106,Bill Hart,Pittsburgh Pirates,PIRATS,2,5,2,7,1898,1910,12,14.38,28.41,14.03,866,1321,455,3143,5735,2592,1417.0,0.0,-1417.0,0.0,0.0,0.0
hartc102,Clint Hartung,Cincinnati Reds,REDS,1,2,1,3,1955,1955,0,0.0,0.0,0.0,0,21,21,0,20,20,0.0,0.0,0.0,0.0,0.0,0.0
hartc105,Chuck Hartenstein,Chicago Cubs,CUBS,1,2,1,3,1969,1969,0,0.26,0.0,-0.26,146,6,-140,17,6,-11,358.0,0.0,-358.0,0.0,0.0,0.0
hartc105,Chuck Hartenstein,Chicago White Sox,WSOX,4,8,5,13,1973,1982,9,34.62,31.7,-2.92,1501,1126,-375,4901,3877,-1024,2522.0,1033.0,-1489.0,0.0,600000.0,600000.0
hartf101,Fred Hartman,Milwaukee,Milwaukee,1,1,1,2,1897,1897,0,0.55,0.0,-0.55,239,0,-239,1002,0,-1002,0.0,0.0,0.0,0.0,0.0,0.0
hartf101,Fred Hartman,St. Louis Cardinals,CARDS,2,4,5,9,1897,1899,2,11.69,1.81,-9.88,688,269,-419,2803,1136,-1667,0.0,0.0,0.0,0.0,0.0,0.0
hartf101,Fred Hartman,St. Louis Cardinals,CARDS,3,4,3,7,1903,1907,4,1.71,1.38,-0.33,85,483,398,334,1895,1561,0.0,0.0,0.0,0.0,0.0,0.0
hartg102,Grover Hartley,New York Giants,GIANTS,2,4,2,6,1913,1921,8,15.0,8.81,-6.19,695,474,-221,2854,907,-1947,0.0,2915.0,2915.0,6400.0,5200.0,-1200.0
hartj001,Jeff Hartsock,Los Angeles Dodgers,DOGRS,1,1,1,2,1991,1991,0,-0.23,0.83,1.06,8,22,14,2,1,-1,28.0,25.0,-3.0,0.0,205000.0,205000.0
hartj002,Jason Hart,Oakland Athletics,ATLTCS,7,12,11,23,2002,2009,7,21.2,14.17,-7.03,1375,998,-377,3394,3388,-6,5508.0,716.0,-4792.0,947000.0,0.0,-947000.0
hartk001,Kevin Hart,Baltimore Orioles,ORLS,1,1,1,2,2006,2008,2,0.76,-0.84,-1.6,72,110,38,14,222,208,199.0,0.0,-199.0,0.0,327500.0,327500.0
hartk001,Kevin Hart,Chicago Cubs,CUBS,2,4,5,9,2009,2013,4,14.85,0.73,-14.12,1031,310,-721,3072,59,-3013,719.0,863.0,144.0,405000.0,2300000.0,1895000.0
hartm001,Mike Hart,Minnesota Twins,TWINS,1,1,3,4,1986,1986,0,-0.57,0.0,0.57,34,0,-34,85,0,-85,0.0,0.0,0.0,0.0,0.0,0.0
hartm002,Mike Hartley,Los Angeles Dodgers,DOGRS,1,2,1,3,1991,1994,3,-0.35,1.49,1.84,185,369,184,139,10,-129,244.0,706.0,462.0,165000.0,2000000.0,1835000.0
hartm002,Mike Hartley,Philadelphia Phillies,PHILS,1,1,1,2,1992,1996,4,1.22,3.78,2.56,53,244,191,0,60,60,243.0,755.0,512.0,225000.0,0.0,-225000.0
hartm101,Mike Hart,Montreal Expos,NATEX,1,1,1,2,1978,1980,2,-0.11,-0.43,-0.32,5,40,35,5,78,73,0.0,0.0,0.0,0.0,0.0,0.0
hartp001,Paul Hartzell,California Angels,ANGELS,1,4,1,5,1979,1985,6,6.38,17.39,11.01,810,834,24,2648,3570,922,1590.0,0.0,-1590.0,0.0,0.0,0.0
hartr101,Roy Hartsfield,Milwaukee Braves,BRAVES,1,2,1,3,1953,1959,6,0.0,4.62,4.62,0,658,658,0,2087,2087,0.0,0.0,0.0,0.0,0.0,0.0
hartr102,Roy Hartzell,St.Louis Browns,ORLS,1,2,2,4,1911,1912,1,7.07,8.48,1.41,699,364,-335,2814,1518,-1296,0.0,0.0,0.0,0.0,0.0,0.0
harvc001,Chad Harville,Oakland Athletics,ATLTCS,2,3,3,6,2004,2007,3,-1.58,3.41,4.99,249,72,-177,8,1,-7,402.0,916.0,514.0,307000.0,0.0,-307000.0
harvj001,Joe Harvey,New York Yankees,YANKS,1,1,1,2,2019,2019,0,0.17,0.0,-0.17,22,0,-22,0,0,0,34.0,0.0,-34.0,555000.0,0.0,-555000.0
harvm001,Matt Harvey,New York Mets,METS,1,1,2,3,2018,2019,1,0.95,0.75,-0.2,48,66,18,50,229,179,384.0,0.0,-384.0,0.0,0.0,0.0
haseb001,Bill Haselman,Boston Red Sox,RSOX,4,7,7,14,1997,2000,3,8.97,2.55,-6.42,585,374,-211,1634,946,-688,1253.0,139.0,-1114.0,5063500.0,700000.0,-4363500.0
haseb001,Bill Haselman,Detroit Tigers,TIGRS,1,6,3,9,1999,2004,5,20.76,4.31,-16.45,1380,309,-1071,3548,496,-3052,1196.0,551.0,-645.0,1937500.0,9240000.0,7302500.0
hashh101,Herb Hash,Minneapolis,Minneapolis,1,3,2,5,1939,1940,1,2.73,0.0,-2.73,141,0,-141,95,0,-95,836.0,0.0,-836.0,0.0,0.0,0.0
haslm101,Mickey Haslin,Philadelphia Phillies,PHILS,1,1,1,2,1936,1939,3,0.24,4.19,3.95,36,388,352,109,1425,1316,0.0,0.0,0.0,0.0,0.0,0.0
haslm101,Mickey Haslin,Boston Braves,BRAVES,1,1,1,2,1936,1938,2,0.95,-0.24,-1.19,58,73,15,162,214,52,0.0,0.0,0.0,0.0,0.0,0.0
haslm101,Mickey Haslin,New York Giants,GIANTS,2,4,2,6,1938,1945,7,4.14,-1.16,-5.3,264,152,-112,377,366,-11,1753.0,409.0,-1344.0,0.0,0.0,0.0
hassb101,Buddy Hassett,New York Yankees,YANKS,1,1,3,4,1936,1936,0,5.02,0.0,-5.02,408,0,-408,1654,0,-1654,0.0,0.0,0.0,0.0,0.0,0.0
hassb101,Buddy Hassett,Brooklyn Dodgers,DOGRS,1,2,2,4,1938,1940,2,2.67,-0.72,-3.39,454,199,-255,1715,406,-1309,0.0,317.0,317.0,0.0,0.0,0.0
hassb101,Buddy Hassett,Boston Braves,BRAVES,1,2,1,3,1941,1952,11,1.7,36.09,34.39,132,1289,1157,581,5523,4942,0.0,0.0,0.0,7500.0,0.0,-7500.0
hassg101,Gene Hasson,Philadelphia Athletics,ATLTCS,2,4,2,6,1938,1947,9,0.0,6.93,6.93,0,1140,1140,0,4751,4751,0.0,0.0,0.0,12000.0,13500.0,1500.0
hassj101,Joe Hassler,Philadelphia Athletics,ATLTCS,2,6,3,9,1929,1936,7,0.0,5.31,5.31,0,419,419,0,458,458,0.0,2946.0,2946.0,7500.0,0.0,-7500.0
hassj101,Joe Hassler,Philadelphia Athletics,ATLTCS,1,1,2,3,1927,1930,3,0.0,0.16,0.16,0,12,12,0,22,22,0.0,0.0,0.0,0.0,0.0,0.0
hassj101,Joe Hassler,Toledo,Toledo,1,1,1,2,1928,1928,0,-0.42,0.0,0.42,32,0,-32,44,0,-44,0.0,0.0,0.0,0.0,0.0,0.0
hassr001,Ron Hassey,Cleveland Indians,INDINS,13,23,29,52,1984,2001,17,109.74,66.95,-42.79,6226,4765,-1461,18678,17797,-881,7708.0,2241.0,-5467.0,19613332.0,19125000.0,-488332.0
hassr001,Ron Hassey,Chicago Cubs,CUBS,2,7,4,11,1984,1987,3,2.88,0.38,-2.5,447,379,-68,818,354,-464,766.0,789.0,23.0,873333.0,878000.0,4667.0
hassr001,Ron Hassey,New York Yankees,YANKS,6,14,14,28,1985,1995,10,3.51,16.99,13.48,797,1920,1123,2241,6176,3935,1174.0,66.0,-1108.0,945873.0,1202500.0,256627.0
hassr001,Ron Hassey,Chicago White Sox,WSOX,4,8,9,17,1986,1996,10,8.12,26.46,18.34,1204,1239,35,3582,5184,1602,266.0,488.0,222.0,4896500.0,2055555.0,-2840945.0
hassr001,Ron Hassey,New York Yankees,YANKS,2,5,4,9,1986,1992,6,1.11,3.87,2.76,606,1169,563,1878,3720,1842,0.0,0.0,0.0,400873.0,475000.0,74127.0
hastb101,Bob Hasty,Philadelphia Athletics,ATLTCS,3,9,5,14,1924,1935,11,15.67,38.22,22.55,391,1328,937,1453,5363,3910,735.0,0.0,-735.0,39667.0,10400.0,-29267.0
hatcb001,Billy Hatcher,Chicago Cubs,CUBS,1,2,1,3,1985,1988,3,5.63,1.35,-4.28,521,292,-229,2104,758,-1346,0.0,0.0,0.0,0.0,0.0,0.0
hatcb001,Billy Hatcher,Houston Astros,ASTROS,1,1,1,2,1989,1990,1,-0.02,0.38,0.4,27,146,119,87,508,421,0.0,0.0,0.0,0.0,750000.0,750000.0
hatcb001,Billy Hatcher,Pittsburgh Pirates,PIRATS,2,2,3,5,1990,1993,3,0.84,0.05,-0.79,335,16,-319,1156,5,-1151,0.0,18.0,18.0,0.0,0.0,0.0
hatcb001,Billy Hatcher,Cincinnati Reds,REDS,1,1,1,2,1992,1992,0,-1.13,-0.45,0.68,255,32,-223,1085,15,-1070,0.0,139.0,139.0,1600000.0,525000.0,-1075000.0
hatcb001,Billy Hatcher,Boston Red Sox,RSOX,2,3,3,6,1994,1995,1,-0.06,-1.0,-0.94,145,86,-59,216,248,32,628.0,0.0,-628.0,885000.0,660000.0,-225000.0
hatcc001,Chris Hatcher,Chicago Cubs,CUBS,1,3,2,5,2000,2000,0,0.0,0.0,0.0,0,0,0,0,0,0,0.0,0.0,0.0,0.0,0.0,0.0
hatcc002,Chris Hatcher,Miami Marlins,MARLNS,3,8,9,17,2014,2020,6,14.59,9.27,-5.32,1600,441,-1159,4137,1747,-2390,525.0,522.0,-3.0,17800000.0,10515000.0,-7285000.0
hatcc002,Chris Hatcher,Los Angeles Dodgers,DOGRS,1,1,1,2,2017,2017,0,0.17,0.0,-0.17,61,0,-61,0,0,0,178.0,0.0,-178.0,1250000.0,0.0,-1250000.0
hatcm001,Mickey Hatcher,Los Angeles Dodgers,DOGRS,1,3,1,4,1981,1987,6,3.72,8.48,4.76,672,868,196,2514,2981,467,0.0,0.0,0.0,0.0,0.0,0.0
hatct001,Thomas Hatch,Chicago Cubs,CUBS,1,1,2,3,2019,2019,0,0.53,0.37,-0.16,20,48,28,0,0,0,107.0,51.0,-56.0,0.0,2500000.0,2500000.0
hatff101,Fred Hatfield,Boston Red Sox,RSOX,2,6,6,12,1952,1956,4,8.2,10.1,1.9,1335,867,-468,4777,3045,-1732,507.0,401.0,-106.0,80000.0,40000.0,-40000.0
hatff101,Fred Hatfield,Detroit Tigers,TIGRS,1,2,3,5,1956,1957,1,0.97,-0.45,-1.42,230,140,-90,562,387,-175,0.0,0.0,0.0,0.0,11000.0,11000.0
hatff101,Fred Hatfield,Chicago White Sox,WSOX,9,15,19,34,1957,1971,14,41.54,76.26,34.72,3085,4270,1185,10587,11970,1383,740.0,5807.0,5067.0,72500.0,48000.0,-24500.0
hatff101,Fred Hatfield,Cleveland Indians,INDINS,1,1,1,2,1958,1958,0,-0.03,-0.16,-0.13,3,26,23,1,5,4,0.0,83.0,83.0,0.0,0.0,0.0
hatff101,Fred Hatfield,Cleveland Indians,INDINS,1,2,1,3,1959,1960,1,0.0,0.68,0.68,0,77,77,0,270,270,0.0,0.0,0.0,0.0,10000.0,10000.0
hatff101,Fred Hatfield,Los Angeles Dodgers,DOGRS,1,3,2,5,1959,1959,0,0.0,0.0,0.0,0,0,0,0,0,0,0.0,0.0,0.0,0.0,0.0,0.0
hathh001,Hilly Hathaway,California Angels,ANGELS,1,1,1,2,1994,1994,0,0.0,-0.84,-0.84,0,74,74,0,235,235,0.0,0.0,0.0,0.0,0.0,0.0
hattg101,Grady Hatton,Cincinnati Reds,REDS,1,1,1,2,1954,1954,0,-0.03,0.0,0.03,13,1,-12,36,1,-35,0.0,0.0,0.0,0.0,0.0,0.0
hattg101,Grady Hatton,Chicago White Sox,WSOX,3,7,4,11,1954,1961,7,23.88,9.56,-14.32,1230,781,-449,3826,2299,-1527,2136.0,479.0,-1657.0,62000.0,82500.0,20500.0
hattj001,John Hattig,Boston Red Sox,RSOX,1,1,1,2,2004,2004,0,0.29,-0.09,-0.38,13,19,6,29,0,-29,0.0,81.0,81.0,0.0,1700000.0,1700000.0
hattj101,Joe Hatten,Minneapolis,Minneapolis,1,1,2,3,1941,1942,1,8.85,0.0,-8.85,401,0,-401,354,0,-354,2881.0,0.0,-2881.0,0.0,0.0,0.0
hattj101,Joe Hatten,Brooklyn Dodgers,DOGRS,3,6,7,13,1951,1958,7,4.28,2.12,-2.16,1667,685,-982,5534,2062,-3472,435.0,267.0,-168.0,50000.0,61500.0,11500.0
hatts001,Scott Hatteberg,Boston Red Sox,RSOX,1,1,1,2,2001,2001,0,0.0,0.0,0.0,0,0,0,0,0,0,0.0,0.0,0.0,1050000.0,0.0,-1050000.0
hausc101,Clem Hausmann,Boston Red Sox,RSOX,1,2,1,3,1945,1945,0,0.0,0.0,0.0,0,0,0,0,0,0,0.0,0.0,0.0,5000.0,0.0,-5000.0
hausj101,Joe Hauser,Milwaukee,Milwaukee,2,2,10,12,1921,1938,17,18.15,0.0,-18.15,1442,0,-1442,4922,0,-4922,0.0,0.0,0.0,0.0,8500.0,8500.0
haust101,Tom Hausman,New York Mets,METS,2,3,3,6,1982,1993,11,1.25,31.11,29.86,349,644,295,279,597,318,448.0,5015.0,4567.0,314167.0,33500.0,-280667.0
haveb001,Brad Havens,California Angels,ANGELS,1,4,1,5,1979,1985,6,6.38,17.39,11.01,810,834,24,2648,3570,922,1590.0,0.0,-1590.0,0.0,0.0,0.0
haveb001,Brad Havens,Minnesota Twins,TWINS,1,1,1,2,1985,1985,0,-0.24,-0.21,0.03,54,6,-48,0,0,0,256.0,47.0,-209.0,0.0,0.0,0.0
haveb001,Brad Havens,Baltimore Orioles,ORLS,1,2,1,3,1987,1988,1,3.02,0.79,-2.23,473,97,-376,1461,0,-1461,135.0,334.0,199.0,300000.0,731250.0,431250.0
hawer101,Roy Hawes,Detroit Tigers,TIGRS,1,1,1,2,1957,1958,1,0.0,0.98,0.98,0,90,90,0,24,24,0.0,224.0,224.0,0.0,0.0,0.0
hawer101,Roy Hawes,Washington Senators,TWINS,1,4,4,8,1956,1956,0,0.0,0.0,0.0,0,0,0,0,0,0,0.0,0.0,0.0,0.0,0.0,0.0
hawkb001,Blake Hawksworth,St. Louis Cardinals,CARDS,1,1,1,2,2010,2011,1,-0.37,0.34,0.71,96,132,36,1,483,482,159.0,0.0,-159.0,402000.0,0.0,-402000.0
hawkc101,Chicken Hawks,Nashville,Nashville,1,1,2,3,1924,1924,0,0.51,0.0,-0.51,105,0,-105,366,0,-366,0.0,0.0,0.0,0.0,3000.0,3000.0
hawkl001,LaTroy Hawkins,Chicago Cubs,CUBS,2,4,3,7,2005,2009,4,0.0,1.94,1.94,117,297,180,0,42,42,209.0,704.0,495.0,4500000.0,736000.0,-3764000.0
hawkl001,LaTroy Hawkins,San Francisco Giants,GIANTS,1,1,1,2,2005,2008,3,0.59,0.71,0.12,63,279,216,0,1,1,181.0,293.0,112.0,0.0,2500000.0,2500000.0
hawkl001,LaTroy Hawkins,New York Yankees,YANKS,2,3,3,6,2008,2010,2,2.94,1.48,-1.46,175,24,-151,0,0,0,253.0,78.0,-175.0,3750000.0,10500000.0,6750000.0
hawkl001,LaTroy Hawkins,Colorado Rockies,ROCKS,4,6,8,14,2015,2020,5,9.83,-2.06,-11.89,514,266,-248,1003,284,-719,1008.0,871.0,-137.0,0.0,0.0,0.0
hawlp101,Pink Hawley,St. Louis Cardinals,CARDS,6,9,15,24,1895,1899,4,67.35,0.04,-67.31,2365,833,-1532,8232,2977,-5255,4823.0,1363.0,-3460.0,0.0,1500.0,1500.0
hawlp101,Pink Hawley,Pittsburgh Pirates,PIRATS,3,8,7,15,1897,1910,13,26.73,36.51,9.78,1261,2039,778,4478,8482,4004,3164.0,936.0,-2228.0,0.0,0.0,0.0
haydh101,Hal Haydel,Houston Astros,ASTROS,3,7,4,11,1963,1965,2,1.38,1.37,-0.01,248,133,-115,214,502,288,382.0,0.0,-382.0,0.0,0.0,0.0
haydj101,Jack Hayden,Baltimore,Baltimore,1,1,4,5,1903,1906,3,0.0,0.0,0.0,0,0,0,0,0,0,0.0,0.0,0.0,0.0,0.0,0.0
hayec001,Charlie Hayes,San Francisco Giants,GIANTS,2,4,4,8,1989,1995,6,14.97,0.18,-14.79,1080,283,-797,2467,146,-2321,4215.0,391.0,-3824.0,1545000.0,1450000.0,-95000.0
hayec001,Charlie Hayes,Philadelphia Phillies,PHILS,1,1,1,2,1992,1992,0,3.09,-0.07,-3.16,262,2,-260,1016,0,-1016,0.0,6.0,6.0,0.0,0.0,0.0
hayec001,Charlie Hayes,Pittsburgh Pirates,PIRATS,1,1,1,2,1996,1996,0,0.9,0.0,-0.9,120,0,-120,467,0,-467,0.0,0.0,0.0,1750000.0,0.0,-1750000.0
hayec001,Charlie Hayes,New York Yankees,YANKS,2,3,3,6,1997,1999,2,8.82,0.0,-8.82,626,0,-626,2195,0,-2195,0.0,0.0,0.0,1700000.0,0.0,-1700000.0
hayef101,Frankie Hayes,Philadelphia Athletics,ATLTCS,2,3,3,6,1942,1946,4,-0.7,0.29,0.99,792,169,-623,2462,494,-1968,0.0,234.0,234.0,13000.0,17500.0,4500.0
hayef101,Frankie Hayes,St.Louis Browns,ORLS,2,2,4,6,1944,1952,8,4.95,8.46,3.51,353,439,86,843,281,-562,667.0,2542.0,1875.0,10500.0,0.0,-10500.0
hayef101,Frankie Hayes,Philadelphia Athletics,ATLTCS,3,3,3,6,1945,1953,8,1.6,6.02,4.42,277,750,473,954,2818,1864,0.0,0.0,0.0,24000.0,0.0,-24000.0
hayef101,Frankie Hayes,Cleveland Indians,INDINS,1,1,1,2,1946,1946,0,-0.41,-0.14,0.27,53,14,-39,211,38,-173,0.0,0.0,0.0,13000.0,4800.0,-8200.0
hayej101,Jackie Hayes,Washington Senators,TWINS,4,9,7,16,1931,1936,5,40.86,14.39,-26.47,2483,840,-1643,9607,2965,-6642,2547.0,1249.0,-1298.0,62500.0,54200.0,-8300.0
hayev001,Von Hayes,Cleveland Indians,INDINS,5,5,12,17,1982,1992,10,49.35,26.03,-23.32,2218,2372,154,8457,9243,786,405.0,0.0,-405.0,1725000.0,1705000.0,-20000.0
hayev001,Von Hayes,Philadelphia Phillies,PHILS,4,6,7,13,1991,1999,8,0.82,1.21,0.39,368,740,372,652,697,45,390.0,1257.0,867.0,2575000.0,165000.0,-2410000.0
haynj001,Jimmy Haynes,Baltimore Orioles,ORLS,1,2,1,3,1997,1997,0,2.08,0.05,-2.03,82,83,1,11,349,338,1229.0,0.0,-1229.0,0.0,3300000.0,3300000.0
haynj001,Jimmy Haynes,Oakland Athletics,ATLTCS,4,9,8,17,1999,2003,4,22.72,5.28,-17.44,1629,224,-1405,3170,219,-2951,6649.0,541.0,-6108.0,2713333.0,5053333.0,2340000.0
haynj101,Joe Haynes,Chicago White Sox,WSOX,8,10,11,21,1948,1976,28,1.76,48.29,46.53,980,3110,2130,2144,11541,9397,489.0,1217.0,728.0,27000.0,17000.0,-10000.0
haynj101,Joe Haynes,Cleveland Indians,INDINS,14,26,24,50,1948,1968,20,162.56,72.5,-90.06,7462,3103,-4359,23911,8852,-15059,13186.0,8500.0,-4686.0,30900.0,42000.0,11100.0
haynn001,Nathan Haynes,Oakland Athletics,ATLTCS,3,7,5,12,1999,2003,4,20.51,6.2,-14.31,1029,288,-741,2006,1023,-983,4166.0,874.0,-3292.0,3050000.0,3425000.0,375000.0
haywr001,Ray Hayward,San Diego Padres,PADRS,12,25,27,52,1988,2006,18,9.51,50.24,40.73,3517,4748,1231,11279,16194,4915,1092.0,2149.0,1057.0,16040833.0,24134000.0,8093167.0
haywr001,Ray Hayward,Chicago Cubs,CUBS,1,1,2,3,1988,1988,0,-0.74,-0.02,0.72,12,2,-10,0,5,5,188.0,0.0,-188.0,0.0,0.0,0.0
haywr101,Ray Hayworth,Brooklyn Dodgers,DOGRS,1,1,1,2,1939,1940,1,-0.08,0.6,0.68,5,35,30,14,135,121,0.0,0.0,0.0,6000.0,8000.0,2000.0
hazej001,Jeremy Hazelbaker,Boston Red Sox,RSOX,1,2,1,3,2013,2013,0,0.0,0.0,0.0,0,0,0,0,0,0,0.0,0.0,0.0,0.0,490500.0,490500.0
hazlb101,Bob Hazle,Cincinnati Reds,REDS,4,7,9,16,1956,1966,10,6.9,8.42,1.52,812,960,148,2097,3305,1208,111.0,126.0,15.0,0.0,10500.0,10500.0
headc001,Chase Headley,San Diego Padres,PADRS,3,5,5,10,2014,2020,6,7.54,6.82,-0.72,685,468,-217,2663,1808,-855,19.0,30.0,11.0,0.0,100000.0,100000.0
headc001,Chase Headley,New York Yankees,YANKS,2,4,2,6,2017,2018,1,-1.8,0.0,1.8,81,0,-81,124,0,-124,219.0,0.0,-219.0,13550625.0,0.0,-13550625.0
headl001,Louis Head,Tampa Bay Devil Rays,RAYS,1,1,1,2,2021,2021,0,0.0,0.0,0.0,0,0,0,0,0,0,0.0,0.0,0.0,0.0,0.0,0.0
heale101,Egyptian Healy,Indianapolis Hoosiers,IN3,1,1,1,2,1889,1889,0,0.0,0.0,0.0,0,0,0,0,0,0,0.0,0.0,0.0,0.0,0.0,0.0
healf102,Fran Healy,Kansas City Royals,ROYALS,2,2,2,4,1970,1971,1,0.76,0.0,-0.76,92,0,-92,221,0,-221,0.0,0.0,0.0,0.0,0.0,0.0
healf102,Fran Healy,San Francisco Giants,GIANTS,1,1,1,2,1973,1987,14,4.8,12.31,7.51,298,1106,808,1060,122,-938,0.0,2611.0,2611.0,0.0,0.0,0.0
healf102,Fran Healy,Kansas City Royals,ROYALS,1,1,1,2,1976,1985,9,0.86,18.75,17.89,74,312,238,205,0,-205,0.0,5104.0,5104.0,0.0,0.0,0.0
healr001,Ryon Healy,Oakland Athletics,ATLTCS,3,5,5,10,2017,2019,2,3.09,0.09,-3.0,444,198,-246,1326,518,-808,210.0,186.0,-24.0,4685000.0,0.0,-4685000.0
heana001,Andrew Heaney,Miami Marlins,MARLNS,3,8,9,17,2014,2020,6,14.59,9.27,-5.32,1600,441,-1159,4137,1747,-2390,525.0,522.0,-3.0,17800000.0,10515000.0,-7285000.0
heana001,Andrew Heaney,Los Angeles Dodgers,DOGRS,2,2,3,5,2014,2017,3,7.35,2.19,-5.16,147,263,116,173,1038,865,1708.0,0.0,-1708.0,10000000.0,9877000.0,-123000.0
heana001,Andrew Heaney,Anaheim Angels,ANGELS,1,2,2,4,2021,2021,0,-0.59,-0.41,0.18,14,7,-7,1,0,-1,107.0,56.0,-51.0,6750000.0,0.0,-6750000.0
heare001,Ed Hearn,New York Mets,METS,11,23,20,43,1987,2005,18,11.67,39.4,27.73,1493,3560,2067,1978,7962,5984,3113.0,6312.0,3199.0,27998333.0,20210666.0,-7787667.0
hearh101,Hughie Hearne,Brooklyn Dodgers,DOGRS,1,4,1,5,1903,1908,5,0.0,0.0,0.0,0,0,0,0,0,0,0.0,0.0,0.0,0.0,0.0,0.0
hearj101,Jay Heard,Baltimore Orioles,ORLS,1,1,1,2,1954,1955,1,0.0,-0.58,-0.58,0,8,8,0,0,0,0.0,12.0,12.0,0.0,0.0,0.0
hearj102,Jim Hearn,New York Giants,GIANTS,11,19,17,36,1956,1972,16,36.88,23.67,-13.21,2797,2062,-735,6356,1997,-4359,3610.0,7650.0,4040.0,50000.0,108000.0,58000.0
heart001,Taylor Hearn,Washington Nationals,NATEX,1,2,1,3,2016,2016,0,7.25,1.19,-6.06,436,60,-376,3,0,-3,698.0,89.0,-609.0,0.0,0.0,0.0
heart001,Taylor Hearn,Pittsburgh Pirates,PIRATS,1,2,1,3,2018,2020,2,-0.62,1.6,2.22,66,95,29,21,0,-21,366.0,141.0,-225.0,0.0,1200000.0,1200000.0
heatb101,Bill Heath,Philadelphia Phillies,PHILS,2,4,2,6,1964,1966,2,4.55,-0.7,-5.25,451,79,-372,428,37,-391,3416.0,375.0,-3041.0,5400.0,15000.0,9600.0
heatb101,Bill Heath,Chicago White Sox,WSOX,1,2,3,5,1965,1967,2,2.05,-0.33,-2.38,164,74,-90,481,40,-441,0.0,379.0,379.0,13000.0,0.0,-13000.0
heatc101,Cliff Heathcote,St. Louis Cardinals,CARDS,1,1,1,2,1922,1922,0,6.65,0.18,-6.47,856,66,-790,3009,302,-2707,0.0,0.0,0.0,4000.0,0.0,-4000.0
heatj101,Jeff Heath,Cleveland Indians,INDINS,2,2,2,4,1945,1947,2,0.39,-0.84,-1.23,84,132,48,292,533,241,0.0,48.0,48.0,0.0,13500.0,13500.0
heatj101,Jeff Heath,Washington Senators,TWINS,1,1,2,3,1946,1947,1,5.22,1.06,-4.16,227,159,-68,935,625,-310,0.0,8.0,8.0,0.0,3000.0,3000.0
heatm001,Mike Heath,New York Yankees,YANKS,22,49,42,91,1978,1997,19,81.62,59.61,-22.01,5721,3574,-2147,13100,7561,-5539,18451.0,9704.0,-8747.0,5628333.0,4757500.0,-870833.0
heatm001,Mike Heath,Texas Rangers,RNGRS,3,7,3,10,1979,1986,7,15.39,12.85,-2.54,1067,529,-538,2903,1715,-1188,4307.0,1244.0,-3063.0,0.0,250000.0,250000.0
heatm001,Mike Heath,Oakland Athletics,ATLTCS,1,2,1,3,1985,1987,2,-1.98,1.12,3.1,136,41,-95,273,0,-273,468.0,648.0,180.0,425000.0,1030000.0,605000.0
heatm001,Mike Heath,St. Louis Cardinals,CARDS,2,2,3,5,1986,1992,6,16.8,0.23,-16.57,623,339,-284,1685,693,-992,1669.0,1412.0,-257.0,688333.0,72500.0,-615833.0
heatm002,Mike Heathcott,Chicago Cubs,CUBS,1,3,2,5,2000,2000,0,0.0,0.0,0.0,0,0,0,0,0,0,0.0,0.0,0.0,0.0,0.0,0.0
heatm101,Mickey Heath,Hollywood,Hollywood,1,1,3,4,1930,1930,0,-0.4,0.0,0.4,46,0,-46,187,0,-187,0.0,0.0,0.0,0.0,5500.0,5500.0
heatm101,Mickey Heath,Cincinnati Reds,REDS,2,4,2,6,1931,1932,1,-0.61,6.01,6.62,32,314,282,78,1300,1222,9.0,0.0,-9.0,0.0,0.0,0.0
heatn001,Neal Heaton,Cleveland Indians,INDINS,1,1,1,2,1986,1986,0,1.85,-0.96,-2.81,21,13,-8,0,0,0,373.0,152.0,-221.0,310000.0,385000.0,75000.0
heatn001,Neal Heaton,Minnesota Twins,TWINS,2,7,4,11,1987,1989,2,2.19,3.46,1.27,550,289,-261,1650,183,-1467,872.0,1114.0,242.0,103500.0,900000.0,796500.0
heatn001,Neal Heaton,Montreal Expos,NATEX,1,1,1,2,1989,1989,0,2.05,0.17,-1.88,234,8,-226,109,0,-109,1086.0,14.0,-1072.0,0.0,0.0,0.0
heatn001,Neal Heaton,Pittsburgh Pirates,PIRATS,1,1,1,2,1992,1992,0,0.15,0.19,0.04,31,16,-15,0,60,60,123.0,0.0,-123.0,0.0,0.0,0.0
heatn002,Nick Heath,Kansas City Royals,ROYALS,1,1,1,2,2021,2021,0,-0.35,0.0,0.35,20,0,-20,39,0,-39,0.0,0.0,0.0,0.0,0.0,0.0
heavd101,Dave Heaverlo,San Francisco Giants,GIANTS,4,14,8,22,1978,1992,14,8.18,23.62,15.44,767,1277,510,1656,1600,-56,2714.0,7759.0,5045.0,0.0,0.0,0.0
hebew101,Wally Hebert,St.Louis Browns,ORLS,14,27,34,61,1933,1952,19,55.71,57.94,2.23,2756,6888,4132,8050,21355,13305,6789.0,12669.0,5880.0,138000.0,130100.0,-7900.0
hebnr001,Richie Hebner,Philadelphia Phillies,PHILS,1,2,1,3,1979,1981,2,1.99,1.3,-0.69,173,122,-51,601,132,-469,0.0,1086.0,1086.0,0.0,0.0,0.0
hebnr001,Richie Hebner,New York Mets,METS,1,1,2,3,1979,1980,1,3.18,-0.2,-3.38,250,94,-156,851,216,-635,0.0,0.0,0.0,200000.0,0.0,-200000.0
hecha001,Adeiny Hechavarria,Toronto Blue Jays,BJAYS,3,15,11,26,2012,2018,6,24.75,21.38,-3.37,2099,1087,-1012,5739,3162,-2577,4668.0,4579.0,-89.0,8732900.0,43179800.0,34446900.0
hecha001,Adeiny Hechavarria,Miami Marlins,MARLNS,1,1,2,3,2017,2018,1,0.91,0.0,-0.91,138,8,-130,518,18,-500,0.0,0.0,0.0,0.0,0.0,0.0
hecha001,Adeiny Hechavarria,Tampa Bay Devil Rays,RAYS,1,2,1,3,2018,2018,0,0.0,0.0,0.0,15,0,-15,47,0,-47,0.0,0.0,0.0,5900000.0,0.0,-5900000.0
hedga001,Austin Hedges,San Diego Padres,PADRS,2,7,4,11,2020,2021,1,3.34,0.62,-2.72,311,5,-306,892,4,-888,493.0,57.0,-436.0,3000000.0,4100000.0,1100000.0
hedlm101,Mike Hedlund,Kansas City Royals,ROYALS,3,5,4,9,1972,1978,6,2.68,1.57,-1.11,438,256,-182,817,556,-261,955.0,645.0,-310.0,76000.0,79000.0,3000.0
hedlm101,Mike Hedlund,Cleveland Indians,INDINS,1,1,1,2,1974,1974,0,0.0,0.0,0.0,0,0,0,0,0,0,0.0,0.0,0.0,0.0,0.0,0.0
hedlm101,Mike Hedlund,Chicago White Sox,WSOX,3,5,4,9,1974,1979,5,12.32,6.24,-6.08,561,692,131,1607,2532,925,1417.0,174.0,-1243.0,0.0,114500.0,114500.0
heepd001,Danny Heep,Houston Astros,ASTROS,1,1,1,2,1982,1982,0,0.98,0.0,-0.98,395,0,-395,1054,0,-1054,0.0,0.0,0.0,0.0,0.0,0.0
heepd001,Danny Heep,Chicago White Sox,WSOX,1,1,1,2,1991,1991,0,0.14,0.0,-0.14,14,0,-14,13,0,-13,0.0,0.0,0.0,0.0,0.0,0.0
heffb001,Bert Heffernan,Milwaukee Brewers,BREWRS,1,1,1,2,1990,1992,2,0.0,0.9,0.9,0,81,81,0,0,0,0.0,356.0,356.0,0.0,0.0,0.0
heffd101,Don Heffner,New York Yankees,YANKS,2,3,2,5,1938,1948,10,-3.37,0.64,4.01,613,130,-483,2436,385,-2051,0.0,0.0,0.0,9000.0,3000.0,-6000.0
heffd101,Don Heffner,Philadelphia Athletics,ATLTCS,1,2,1,3,1943,1946,3,0.19,0.0,-0.19,648,0,-648,1982,0,-1982,0.0,0.0,0.0,6000.0,7000.0,1000.0
heffd101,Don Heffner,Baltimore,Baltimore,1,1,4,5,1933,1946,13,0.88,0.0,-0.88,161,0,-161,586,0,-586,0.0,0.0,0.0,0.0,0.0,0.0
hegaj101,Jim Hegan,Cleveland Indians,INDINS,7,13,11,24,1958,1965,7,29.75,2.89,-26.86,2675,596,-2079,5199,1979,-3220,7620.0,347.0,-7273.0,7500.0,10500.0,3000.0
hegaj101,Jim Hegan,Detroit Tigers,TIGRS,1,1,2,3,1958,1958,0,-0.11,0.0,0.11,50,0,-50,120,0,-120,0.0,0.0,0.0,0.0,0.0,0.0
heidj101,Jack Heidemann,Cleveland Indians,INDINS,17,27,38,65,1973,2004,31,72.79,82.35,9.56,3663,4830,1167,11714,16047,4333,6999.0,8996.0,1997.0,1767500.0,1412500.0,-355000.0
heidj101,Jack Heidemann,Cleveland Indians,INDINS,3,4,4,8,1974,1978,4,1.56,-1.53,-3.09,268,236,-32,879,466,-413,0.0,442.0,442.0,0.0,0.0,0.0
heidj101,Jack Heidemann,St. Louis Cardinals,CARDS,4,5,5,10,1974,1977,3,-1.77,-0.4,1.37,404,34,-370,964,23,-941,66.0,23.0,-43.0,0.0,0.0,0.0
heidj101,Jack Heidemann,New York Mets,METS,1,1,1,2,1976,1976,0,-1.01,0.0,1.01,74,0,-74,165,0,-165,0.0,0.0,0.0,0.0,0.0,0.0
heila001,Aaron Heilman,New York Mets,METS,1,7,3,10,2008,2010,2,8.89,-1.25,-10.14,554,358,-196,1346,179,-1167,2162.0,325.0,-1837.0,3398000.0,4805000.0,1407000.0
heila001,Aaron Heilman,Seattle Mariners,MARNRS,3,7,5,12,2009,2011,2,0.86,0.54,-0.32,585,308,-277,1427,724,-703,217.0,686.0,469.0,5822500.0,10600000.0,4777500.0
heila001,Aaron Heilman,Chicago Cubs,CUBS,1,1,2,3,2009,2012,3,-1.17,-0.04,1.13,197,79,-118,2,2,0,322.0,122.0,-200.0,1625000.0,0.0,-1625000.0
heimf101,Fred Heimach,Philadelphia Athletics,ATLTCS,1,3,1,4,1926,1930,4,3.68,8.68,5.0,373,175,-198,792,208,-584,1683.0,1623.0,-60.0,10500.0,10000.0,-500.0
heimf101,Fred Heimach,StPaul,StPaul,1,1,1,2,1928,1928,0,1.04,0.0,-1.04,102,0,-102,86,0,-86,608.0,0.0,-608.0,0.0,0.0,0.0
heimf101,Fred Heimach,Boston Red Sox,RSOX,1,4,2,6,1926,1926,0,0.0,0.0,0.0,0,0,0,0,0,0,0.0,0.0,0.0,15750.0,0.0,-15750.0
heimf101,Fred Heimach,Toledo,Toledo,1,1,2,3,1930,1930,0,0.99,0.0,-0.99,185,0,-185,141,0,-141,1021.0,0.0,-1021.0,0.0,0.0,0.0
heimj001,Jonah Heim,Baltimore Orioles,ORLS,1,1,1,2,2016,2016,0,0.0,-0.03,-0.03,0,25,25,0,70,70,0.0,0.0,0.0,0.0,0.0,0.0
heimj001,Jonah Heim,Tampa Bay Devil Rays,RAYS,1,1,1,2,2017,2017,0,0.07,0.0,-0.07,13,0,-13,41,0,-41,0.0,0.0,0.0,0.0,535000.0,535000.0
heimj001,Jonah Heim,Oakland Athletics,ATLTCS,1,3,3,6,2021,2021,0,-0.26,0.18,0.44,104,178,74,346,635,289,0.0,0.0,0.0,0.0,0.0,0.0
heinb101,Bud Heine,New York Giants,GIANTS,1,5,1,6,1922,1924,2,0.0,-0.65,-0.65,0,89,89,0,166,166,0.0,0.0,0.0,4200.0,0.0,-4200.0
heins001,Scott Heineman,Texas Rangers,RNGRS,1,1,1,2,2020,2020,0,-0.23,0.0,0.23,19,0,-19,34,0,-34,0.0,0.0,0.0,0.0,0.0,0.0
heint101,Tom Heintzelman,St. Louis Cardinals,CARDS,4,4,6,10,1974,1976,2,1.99,0.21,-1.78,308,64,-244,580,200,-380,606.0,0.0,-606.0,0.0,0.0,0.0
heisa101,Al Heist,Milwaukee Braves,BRAVES,2,2,4,6,1960,1960,0,2.1,0.0,-2.1,160,0,-160,497,0,-497,0.0,0.0,0.0,0.0,0.0,0.0
heisb101,Bob Heise,New York Mets,METS,3,5,4,9,1969,1977,8,-0.49,9.42,9.91,155,840,685,237,1612,1375,89.0,1792.0,1703.0,0.0,150000.0,150000.0
heisb101,Bob Heise,San Francisco Giants,GIANTS,1,1,1,2,1971,1971,0,1.33,-0.19,-1.52,212,9,-203,598,24,-574,0.0,0.0,0.0,0.0,13000.0,13000.0
heisb101,Bob Heise,Milwaukee Brewers,BREWRS,3,5,3,8,1973,1976,3,3.54,3.53,-0.01,545,209,-336,1815,221,-1594,335.0,641.0,306.0,150000.0,34000.0,-116000.0
heisb101,Bob Heise,St. Louis Cardinals,CARDS,2,2,2,4,1974,1976,2,0.01,-0.08,-0.09,68,33,-35,182,74,-108,0.0,0.0,0.0,0.0,12500.0,12500.0
heisb101,Bob Heise,California Angels,ANGELS,1,1,1,2,1974,1975,1,-0.35,0.24,0.59,95,89,-6,199,332,133,0.0,0.0,0.0,0.0,90000.0,90000.0
heisc001,Chris Heisey,Cincinnati Reds,REDS,1,1,1,2,2014,2015,1,0.21,0.0,-0.21,33,0,-33,72,0,-72,0.0,0.0,0.0,1760000.0,0.0,-1760000.0
heisc001,Chris Heisey,Toronto Blue Jays,BJAYS,1,1,1,2,2015,2015,0,0.21,0.0,-0.21,33,0,-33,72,0,-72,0.0,0.0,0.0,0.0,0.0,0.0
heisr001,Rick Heiserman,Cleveland Indians,INDINS,1,3,1,4,1995,1995,0,-1.28,1.44,2.72,177,12,-165,474,0,-474,13.0,224.0,211.0,0.0,4525000.0,4525000.0
heldw101,Woodie Held,New York Yankees,YANKS,3,9,7,16,1957,1962,5,10.27,3.25,-7.02,1508,714,-794,3698,610,-3088,2854.0,1762.0,-1092.0,12500.0,12500.0,0.0
heldw101,Woodie Held,Kansas City Athletics,ATLTCS,24,48,46,94,1958,1976,18,124.94,48.67,-76.27,9659,5527,-4132,26702,16658,-10044,8728.0,3973.0,-4755.0,440600.0,542000.0,101400.0
heldw101,Woodie Held,Cleveland Indians,INDINS,11,17,17,34,1964,1984,20,50.19,18.25,-31.94,3277,3447,170,11873,12142,269,38.0,317.0,279.0,210250.0,385600.0,175350.0
heldw101,Woodie Held,Washington Senators,RNGRS,1,1,1,2,1965,1969,4,0.38,-0.18,-0.56,82,15,-67,145,24,-121,0.0,0.0,0.0,20000.0,15000.0,-5000.0
heldw101,Woodie Held,Baltimore Orioles,ORLS,8,20,19,39,1967,1988,21,20.35,76.06,55.71,1913,3669,1756,3701,7796,4095,7971.0,11741.0,3770.0,691833.0,37000.0,-654833.0
heldw101,Woodie Held,California Angels,ANGELS,1,1,1,2,1968,1968,0,-1.02,-0.3,0.72,96,4,-92,141,11,-130,0.0,0.0,0.0,0.0,0.0,0.0
helfe001,Eric Helfand,Florida Marlins,MARLNS,1,2,1,3,1992,1993,1,-0.34,1.48,1.82,54,158,104,120,591,471,11.0,0.0,-11.0,0.0,760000.0,760000.0
hellb001,Ben Heller,Cleveland Indians,INDINS,1,4,1,5,2016,2018,2,0.85,4.57,3.72,262,129,-133,807,2,-805,102.0,377.0,275.0,0.0,0.0,0.0
hellj001,Jeremy Hellickson,Tampa Bay Devil Rays,RAYS,4,7,8,15,2014,2020,6,6.74,6.5,-0.24,692,250,-442,1729,992,-737,781.0,0.0,-781.0,7725000.0,1152200.0,-6572800.0
hellj001,Jeremy Hellickson,Arizona Diamondbacks,DBACKS,2,5,3,8,2015,2019,4,3.76,-0.4,-4.16,168,72,-96,105,272,167,1136.0,0.0,-1136.0,4275000.0,0.0,-4275000.0
hellj001,Jeremy Hellickson,Philadelphia Phillies,PHILS,2,2,4,6,2017,2020,3,-0.71,-0.92,-0.21,53,41,-12,3,97,94,209.0,2.0,-207.0,17200000.0,4200000.0,-13000000.0
hellj002,Johnny Hellweg,Anaheim Angels,ANGELS,1,3,1,4,2012,2012,0,4.26,1.47,-2.79,508,13,-495,1945,0,-1945,179.0,268.0,89.0,0.0,13500000.0,13500000.0
hellr001,Rick Helling,Texas Rangers,RNGRS,1,2,1,3,1996,1999,3,5.47,5.31,-0.16,331,108,-223,288,10,-278,2639.0,1801.0,-838.0,0.0,3550000.0,3550000.0
hellr001,Rick Helling,Florida Marlins,MARLNS,2,2,2,4,1997,1997,0,12.86,-0.08,-12.94,185,33,-152,20,0,-20,2795.0,36.0,-2759.0,0.0,450000.0,450000.0
helmt101,Tommy Helms,Cincinnati Reds,REDS,6,8,13,21,1971,1982,11,32.36,75.99,43.63,1555,3237,1682,4173,10169,5996,5915.0,4444.0,-1471.0,0.0,0.0,0.0
helmt101,Tommy Helms,Houston Astros,ASTROS,1,1,1,2,1975,1983,8,0.23,13.73,13.5,77,706,629,116,2543,2427,0.0,0.0,0.0,0.0,0.0,0.0
helmt101,Tommy Helms,Oakland Athletics,ATLTCS,5,10,14,24,1977,1991,14,17.32,67.59,50.27,1802,3570,1768,5305,11715,6410,956.0,6372.0,5416.0,0.0,440000.0,440000.0
helmw001,Wes Helms,Atlanta Braves,BRAVES,3,7,4,11,2002,2005,3,48.76,10.76,-38.0,1789,404,-1385,2230,926,-1304,9304.0,204.0,-9100.0,4218000.0,5500000.0,1282000.0
hemar101,Russ Heman,Chicago White Sox,WSOX,15,26,28,54,1957,1969,12,18.37,37.27,18.9,2207,3220,1013,3806,5515,1709,4631.0,7668.0,3037.0,148250.0,102500.0,-45750.0
hemar101,Russ Heman,Baltimore Orioles,ORLS,1,2,1,3,1958,1959,1,0.11,-0.65,-0.76,12,20,8,1,51,50,30.0,0.0,-30.0,0.0,20000.0,20000.0
hemar101,Russ Heman,Los Angeles Angels,ANGELS,5,8,7,15,1961,1968,7,-0.68,8.55,9.23,319,809,490,434,2503,2069,443.0,1270.0,827.0,44000.0,0.0,-44000.0
hembh001,Heath Hembree,San Francisco Giants,GIANTS,1,2,2,4,2014,2016,2,2.1,2.59,0.49,267,120,-147,1,96,95,779.0,924.0,145.0,0.0,0.0,0.0
hembh001,Heath Hembree,Boston Red Sox,RSOX,1,2,2,4,2020,2020,0,-0.87,0.58,1.45,25,2,-23,0,0,0,67.0,30.0,-37.0,5113000.0,0.0,-5113000.0
hemmg101,George Hemming,Louisville Colonels,LS3,2,2,3,5,1894,1896,2,9.1,-1.54,-10.64,142,98,-44,251,162,-89,1560.0,960.0,-600.0,0.0,0.0,0.0
hempc101,Charlie Hemphill,St.Louis Browns,ORLS,1,3,3,6,1907,1907,0,6.22,0.0,-6.22,491,0,-491,1891,0,-1891,92.0,0.0,-92.0,0.0,0.0,0.0
hemsr101,Rollie Hemsley,Pittsburgh Pirates,PIRATS,3,6,4,10,1931,1941,10,12.78,6.86,-5.92,596,859,263,1202,3007,1805,2406.0,0.0,-2406.0,0.0,0.0,0.0
hemsr101,Rollie Hemsley,Chicago Cubs,CUBS,2,7,3,10,1932,1941,9,3.2,27.52,24.32,621,896,275,1233,2014,781,2473.0,4458.0,1985.0,0.0,0.0,0.0
hemsr101,Rollie Hemsley,Cincinnati Reds,REDS,1,1,1,2,1933,1933,0,1.68,-0.03,-1.71,515,10,-505,1932,18,-1914,0.0,0.0,0.0,5500.0,0.0,-5500.0
hemsr101,Rollie Hemsley,St.Louis Browns,ORLS,5,7,8,15,1938,1947,9,4.92,12.88,7.96,708,1136,428,2349,3276,927,122.0,1515.0,1393.0,19500.0,15250.0,-4250.0
hemus101,Solly Hemus,St. Louis Cardinals,CARDS,4,8,7,15,1956,1963,7,12.2,1.13,-11.07,1451,761,-690,4917,2013,-2904,89.0,111.0,22.0,0.0,0.0,0.0
hemus101,Solly Hemus,Philadelphia Phillies,PHILS,6,10,10,20,1958,1984,26,32.08,55.89,23.81,1870,3393,1523,6865,8385,1520,0.0,2963.0,2963.0,0.0,123000.0,123000.0
hendb001,Ben Hendrickson,Milwaukee Brewers,BREWRS,1,1,1,2,2007,2007,0,0.0,0.0,0.0,0,0,0,0,0,0,0.0,0.0,0.0,0.0,0.0,0.0
hendb101,Bob Hendley,Milwaukee Braves,BRAVES,10,14,18,32,1963,1973,10,11.77,26.43,14.66,1218,1711,493,2811,4870,2059,2257.0,2054.0,-203.0,95000.0,38000.0,-57000.0
hendb101,Bob Hendley,San Francisco Giants,GIANTS,3,5,4,9,1965,1968,3,-1.4,-0.01,1.39,272,250,-22,397,696,299,492.0,0.0,-492.0,33000.0,30000.0,-3000.0
hendb101,Bob Hendley,Chicago Cubs,CUBS,2,2,3,5,1967,1968,1,-0.02,-0.38,-0.36,40,74,34,24,62,38,220.0,135.0,-85.0,0.0,0.0,0.0
hendd001,Dave Henderson,Boston Red Sox,RSOX,1,1,1,2,1987,1991,4,0.22,0.58,0.36,15,159,144,29,277,248,0.0,0.0,0.0,525000.0,0.0,-525000.0
hendd001,Dave Henderson,Seattle Mariners,MARNRS,3,5,8,13,1986,1989,3,0.54,-0.06,-0.6,445,432,-13,1461,1346,-115,0.0,625.0,625.0,215000.0,447500.0,232500.0
hendd101,Don Hendrickson,Milwaukee,Milwaukee,1,1,2,3,1945,1945,0,-0.75,0.0,0.75,78,0,-78,20,0,-20,226.0,0.0,-226.0,0.0,0.0,0.0
hende103,Elrod Hendricks,Baltimore Orioles,ORLS,1,1,1,2,1972,1976,4,-0.19,2.39,2.58,17,437,420,56,1839,1783,0.0,0.0,0.0,0.0,25000.0,25000.0
hende103,Elrod Hendricks,Chicago Cubs,CUBS,1,1,1,2,1972,1972,0,1.22,0.0,-1.22,267,0,-267,762,0,-762,7.0,0.0,-7.0,0.0,0.0,0.0
hende103,Elrod Hendricks,Baltimore Orioles,ORLS,4,12,12,24,1976,1988,12,17.24,67.8,50.56,919,3227,2308,801,6729,5928,6521.0,11016.0,4495.0,558333.0,0.0,-558333.0
hendg001,George Hendrick,Oakland Athletics,ATLTCS,1,2,2,4,1973,1975,2,10.02,2.05,-7.97,777,294,-483,3090,901,-2189,0.0,0.0,0.0,0.0,0.0,0.0
hendg001,George Hendrick,Cleveland Indians,INDINS,13,21,31,52,1976,2004,28,68.98,64.5,-4.48,3085,3493,408,9946,11571,1625,6797.0,7512.0,715.0,1767500.0,1412500.0,-355000.0
hendg001,George Hendrick,San Diego Padres,PADRS,1,1,1,2,1978,1981,3,17.95,1.7,-16.25,893,225,-668,3664,126,-3538,0.0,1243.0,1243.0,0.0,0.0,0.0
hendg001,George Hendrick,St. Louis Cardinals,CARDS,2,3,3,6,1984,1992,8,-0.07,18.07,18.14,99,753,654,295,2368,2073,200.0,2206.0,2006.0,1100000.0,1720000.0,620000.0
hendg001,George Hendrick,Pittsburgh Pirates,PIRATS,2,6,6,12,1985,1992,7,9.22,21.92,12.7,518,1417,899,680,1274,594,2669.0,7059.0,4390.0,1030000.0,180000.0,-850000.0
hendh101,Harvey Hendrick,Boston Red Sox,RSOX,1,2,2,4,1923,1927,4,9.14,-0.1,-9.24,571,74,-497,688,223,-465,4054.0,0.0,-4054.0,0.0,0.0,0.0
hendh101,Harvey Hendrick,Brooklyn Dodgers,DOGRS,1,1,1,2,1931,1932,1,3.96,0.0,-3.96,231,0,-231,1021,0,-1021,0.0,0.0,0.0,0.0,0.0,0.0
hendh101,Harvey Hendrick,Cincinnati Reds,REDS,1,3,1,4,1932,1932,0,-0.61,2.05,2.66,32,83,51,78,279,201,9.0,0.0,-9.0,0.0,0.0,0.0
hendh101,Harvey Hendrick,Chicago Cubs,CUBS,3,10,4,14,1933,1938,5,12.44,14.42,1.98,1291,484,-807,2611,1630,-981,3141.0,1054.0,-2087.0,10000.0,17500.0,7500.0
hendj102,Joe Henderson,UnionLaguna,UnionLaguna,1,1,1,2,1971,1971,0,-0.56,0.0,0.56,6,0,-6,1,0,-1,45.0,0.0,-45.0,0.0,0.0,0.0
hendk001,Kyle Hendricks,Texas Rangers,RNGRS,1,2,1,3,2012,2012,0,22.27,0.17,-22.1,395,12,-383,404,0,-404,3685.0,207.0,-3478.0,0.0,14000000.0,14000000.0
hendk101,Ken Henderson,San Francisco Giants,GIANTS,1,2,1,3,1972,1976,4,13.25,-0.15,-13.4,475,156,-319,1568,147,-1421,1787.0,1201.0,-586.0,0.0,0.0,0.0
hendk101,Ken Henderson,Chicago White Sox,WSOX,2,4,3,7,1975,1979,4,12.32,5.83,-6.49,561,668,107,1607,2532,925,1417.0,0.0,-1417.0,0.0,114500.0,114500.0
hendk101,Ken Henderson,Atlanta Braves,BRAVES,3,8,3,11,1976,1983,7,3.71,6.12,2.41,495,566,71,1015,2078,1063,923.0,87.0,-836.0,33500.0,0.0,-33500.0
hendk101,Ken Henderson,Texas Rangers,RNGRS,4,9,7,16,1978,1988,10,6.15,29.07,22.92,381,2027,1646,1490,7192,5702,0.0,2974.0,2974.0,0.0,0.0,0.0
hendk101,Ken Henderson,New York Mets,METS,1,1,1,2,1978,1979,1,-1.12,-0.76,0.36,74,222,148,182,17,-165,0.0,550.0,550.0,0.0,0.0,0.0
hendl001,Liam Hendriks,Toronto Blue Jays,BJAYS,1,2,1,3,2014,2015,1,-0.13,0.39,0.52,23,108,85,36,338,302,58.0,0.0,-58.0,510200.0,1065000.0,554800.0
hendl001,Liam Hendriks,Kansas City Royals,ROYALS,1,1,1,2,2014,2014,0,0.95,0.0,-0.95,67,0,-67,1,0,-1,234.0,0.0,-234.0,0.0,0.0,0.0
hendl001,Liam Hendriks,Toronto Blue Jays,BJAYS,2,2,2,4,2015,2017,2,5.97,-0.48,-6.45,306,55,-251,0,0,0,866.0,248.0,-618.0,518400.0,2150000.0,1631600.0
hendm001,Mark Hendrickson,Toronto Blue Jays,BJAYS,1,2,1,3,2003,2006,3,2.32,3.79,1.47,81,199,118,13,1,-12,1354.0,561.0,-793.0,302000.0,0.0,-302000.0
hendm001,Mark Hendrickson,Tampa Bay Devil Rays,RAYS,1,3,3,6,2006,2012,6,-0.07,1.99,2.06,130,586,456,113,1881,1768,593.0,426.0,-167.0,4200000.0,682000.0,-3518000.0
hendr001,Rickey Henderson,Oakland Athletics,ATLTCS,8,17,14,31,1984,1998,14,132.59,51.98,-80.61,4207,2365,-1842,7421,6370,-1051,13842.0,7587.0,-6255.0,6670419.0,6477500.0,-192919.0
hendr001,Rickey Henderson,New York Yankees,YANKS,2,2,5,7,1989,1993,4,40.86,6.16,-34.7,1473,539,-934,6340,354,-5986,0.0,2795.0,2795.0,2320000.0,1237766.0,-1082234.0
hendr001,Rickey Henderson,Oakland Athletics,ATLTCS,2,2,3,5,1993,1998,5,6.81,2.33,-4.48,216,232,16,204,423,219,669.0,771.0,102.0,3710000.0,0.0,-3710000.0
hendr001,Rickey Henderson,San Diego Padres,PADRS,1,1,3,4,1997,1999,2,-0.13,-0.12,0.01,32,86,54,144,233,89,0.0,0.0,0.0,3045000.0,0.0,-3045000.0
hends001,Steve Henderson,Cincinnati Reds,REDS,3,6,5,11,1977,1990,13,13.19,18.54,5.35,1751,636,-1115,5361,1105,-4256,2918.0,3754.0,836.0,450000.0,287500.0,-162500.0
hends001,Steve Henderson,New York Mets,METS,1,2,1,3,1981,1984,3,0.81,-0.14,-0.95,174,349,175,620,1292,672,0.0,0.0,0.0,0.0,0.0,0.0
hends001,Steve Henderson,Chicago Cubs,CUBS,3,8,5,13,1982,1987,5,4.49,1.16,-3.33,677,463,-214,1666,378,-1288,766.0,1115.0,349.0,873333.0,878000.0,4667.0
hendt101,Tim Hendryx,Cleveland Indians,INDINS,1,6,1,7,1913,1914,1,0.0,-0.98,-0.98,0,48,48,0,37,37,0.0,303.0,303.0,0.0,0.0,0.0
hendt101,Tim Hendryx,New York Yankees,YANKS,1,1,1,2,1918,1918,0,1.37,0.0,-1.37,88,0,-88,268,0,-268,0.0,0.0,0.0,0.0,0.0,0.0
hendt101,Tim Hendryx,Louisville,Louisville,1,1,2,3,1920,1920,0,1.94,0.0,-1.94,148,0,-148,589,0,-589,0.0,0.0,0.0,0.0,0.0,0.0
hengd001,Dave Hengel,Seattle Mariners,MARNRS,1,1,1,2,1989,1989,0,-0.55,0.0,0.55,12,0,-12,29,0,-29,0.0,0.0,0.0,0.0,0.0,0.0
henlb101,Butch Henline,New York Giants,GIANTS,1,3,1,4,1921,1926,5,11.79,12.89,1.1,909,765,-144,3326,3232,-94,0.0,0.0,0.0,5400.0,5000.0,-400.0
henlb101,Butch Henline,Philadelphia Phillies,PHILS,6,14,12,26,1927,1941,14,16.64,29.99,13.35,1563,2406,843,5836,6892,1056,324.0,5521.0,5197.0,17000.0,18200.0,1200.0
henlb101,Butch Henline,Indianapolis,Indianapolis,1,1,3,4,1920,1920,0,0.0,0.0,0.0,1,0,-1,1,0,-1,0.0,0.0,0.0,0.0,2700.0,2700.0
henlg101,Gail Henley,New York Giants,GIANTS,2,5,2,7,1952,1957,5,0.0,2.01,2.01,0,290,290,0,53,53,0.0,810.0,810.0,0.0,11000.0,11000.0
henlg101,Gail Henley,Cincinnati Reds,REDS,1,3,1,4,1952,1961,9,1.64,13.15,11.51,150,1235,1085,601,5109,4508,0.0,0.0,0.0,0.0,10500.0,10500.0
hennm001,Mike Henneman,Detroit Tigers,TIGRS,2,3,2,5,1995,1997,2,-0.45,0.07,0.52,379,160,-219,1117,518,-599,63.0,0.0,-63.0,5561334.0,109000.0,-5452334.0
hennp102,Phil Hennigan,Cleveland Indians,INDINS,2,3,3,6,1972,1974,2,0.38,-0.69,-1.07,186,38,-148,124,0,-124,1173.0,500.0,-673.0,19000.0,6000.0,-13000.0
henrb001,Butch Henry,Cincinnati Reds,REDS,1,3,1,4,1990,1993,3,-0.24,2.7,2.94,60,260,200,65,933,868,497.0,0.0,-497.0,104000.0,934000.0,830000.0
henrb001,Butch Henry,Colorado Rockies,ROCKS,1,1,1,2,1993,1994,1,6.83,0.25,-6.58,110,58,-52,89,30,-59,757.0,304.0,-453.0,152000.0,113500.0,-38500.0
henrb101,Bill Henry,Boston Red Sox,RSOX,1,1,2,3,1957,1959,2,6.99,0.0,-6.99,218,0,-218,52,0,-52,646.0,0.0,-646.0,0.0,0.0,0.0
henrb101,Bill Henry,Chicago Cubs,CUBS,3,5,4,9,1959,1961,2,8.16,-0.89,-9.05,620,173,-447,633,602,-31,802.0,0.0,-802.0,0.0,0.0,0.0
henrb101,Bill Henry,Cincinnati Reds,REDS,1,1,1,2,1965,1965,0,1.98,0.23,-1.75,210,44,-166,8,8,0,272.0,133.0,-139.0,0.0,0.0,0.0
henrb102,Bill Henry,New York Yankees,YANKS,1,1,1,2,1967,1967,0,0.0,0.0,0.0,0,0,0,0,0,0,0.0,0.0,0.0,0.0,0.0,0.0
henrd001,Dwayne Henry,Texas Rangers,RNGRS,1,1,2,3,1989,1989,0,-0.48,0.0,0.48,92,0,-92,0,0,0,153.0,0.0,-153.0,0.0,0.0,0.0
henrd002,Doug Henry,Milwaukee Brewers,BREWRS,4,6,10,16,1994,2004,10,6.52,10.48,3.96,931,1120,189,2233,2248,15,782.0,1056.0,274.0,3880000.0,595000.0,-3285000.0
henrd002,Doug Henry,Houston Astros,ASTROS,1,1,1,2,2000,2003,3,0.32,0.17,-0.15,54,96,42,0,10,10,76.0,228.0,152.0,800000.0,0.0,-800000.0
henrd101,Dutch Henry,St.Louis Browns,ORLS,30,57,63,120,1923,1952,29,152.74,143.26,-9.48,7550,11363,3813,22650,31782,9132,19168.0,30694.0,11526.0,281100.0,222150.0,-58950.0
henrd101,Dutch Henry,Cincinnati Reds,REDS,4,7,8,15,1933,1943,10,2.09,48.62,46.53,936,2007,1071,3163,5265,2102,264.0,8479.0,8215.0,23000.0,0.0,-23000.0
henro001,Oscar Henriquez,Houston Astros,ASTROS,1,3,1,4,1997,2001,4,-0.79,11.75,12.54,34,421,387,1,1777,1776,68.0,0.0,-68.0,0.0,4500000.0,4500000.0
henro001,Oscar Henriquez,Florida Marlins,MARLNS,1,1,1,2,1998,1999,1,0.0,0.41,0.41,0,82,82,0,260,260,0.0,0.0,0.0,170000.0,0.0,-170000.0
henro101,Olaf Henriksen,Brockton,Brockton,1,2,4,6,1911,1911,0,1.67,0.0,-1.67,331,0,-331,645,0,-645,0.0,0.0,0.0,0.0,0.0,0.0
henrp001,Payton Henry,Milwaukee Brewers,BREWRS,1,1,1,2,2021,2021,0,0.02,-0.78,-0.8,5,12,7,16,0,-16,0.0,13.0,13.0,0.0,0.0,0.0
henrs101,Snake Henry,Philadelphia Phillies,PHILS,5,11,9,20,1921,1936,15,25.37,1.11,-24.26,1352,2193,841,5364,9288,3924,77.0,0.0,-77.0,43100.0,12250.0,-30850.0
hensc002,Clay Hensley,San Francisco Giants,GIANTS,2,4,2,6,2003,2005,2,1.57,0.05,-1.52,224,233,9,81,2,-79,995.0,364.0,-631.0,1600000.0,0.0,-1600000.0
hensd001,Drew Henson,New York Yankees,YANKS,1,4,2,6,2000,2000,0,-1.35,0.26,1.61,143,16,-127,19,0,-19,383.0,274.0,-109.0,0.0,4750000.0,4750000.0
hensd001,Drew Henson,Cincinnati Reds,REDS,2,3,3,6,2001,2013,12,-0.92,19.24,20.16,177,833,656,524,1510,986,0.0,5071.0,5071.0,0.0,0.0,0.0
hensr101,Roy Henshaw,Chicago Cubs,CUBS,1,2,1,3,1936,1938,2,-0.75,0.91,1.66,248,78,-170,579,238,-341,469.0,0.0,-469.0,0.0,0.0,0.0
hensr101,Roy Henshaw,Brooklyn Dodgers,DOGRS,1,4,1,5,1937,1944,7,1.9,1.11,-0.79,125,343,218,330,1190,860,390.0,0.0,-390.0,10000.0,10000.0,0.0
hentp001,Pat Hentgen,Toronto Blue Jays,BJAYS,3,5,8,13,1999,2001,2,2.96,-0.34,-3.3,81,293,212,74,474,400,885.0,431.0,-454.0,8600000.0,1025000.0,-7575000.0
herbf101,Fred Herbert,Chicago Cubs,CUBS,1,1,2,3,1913,1913,0,0.0,0.34,0.34,0,4,4,0,7,7,0.0,15.0,15.0,0.0,0.0,0.0
herbr101,Ray Herbert,Kansas City Athletics,ATLTCS,19,40,34,74,1961,1976,15,67.84,34.29,-33.55,6835,3922,-2913,16048,11060,-4988,8728.0,3414.0,-5314.0,393100.0,483000.0,89900.0
herbr101,Ray Herbert,Chicago White Sox,WSOX,3,4,4,8,1964,1969,5,5.43,1.58,-3.85,657,600,-57,2273,1624,-649,543.0,0.0,-543.0,26500.0,6000.0,-20500.0
herbr102,Ron Herbel,San Francisco Giants,GIANTS,1,3,1,4,1969,1969,0,1.07,0.0,-1.07,369,0,-369,821,0,-821,333.0,0.0,-333.0,0.0,0.0,0.0
herbr102,Ron Herbel,San Diego Padres,PADRS,1,1,1,2,1970,1970,0,0.52,0.0,-0.52,24,0,-24,0,0,0,39.0,0.0,-39.0,0.0,0.0,0.0
herbr102,Ron Herbel,New York Mets,METS,1,1,1,2,1970,1971,1,-0.11,-1.27,-1.16,50,104,54,11,377,366,155.0,0.0,-155.0,0.0,0.0,0.0
heref001,Felix Heredia,Florida Marlins,MARLNS,10,20,24,44,1998,2019,21,61.27,65.42,4.15,2318,3439,1121,4579,11330,6751,9272.0,5140.0,-4132.0,30092000.0,14431425.0,-15660575.0
heref001,Felix Heredia,Chicago Cubs,CUBS,3,10,5,15,2001,2009,8,12.08,11.04,-1.04,698,868,170,2292,2781,489,413.0,718.0,305.0,6900000.0,10775000.0,3875000.0
heref001,Felix Heredia,New York Yankees,YANKS,1,1,1,2,2004,2005,1,0.11,-0.09,-0.2,6,33,27,0,0,0,8.0,42.0,34.0,1800000.0,3000000.0,1200000.0
hereg001,Gil Heredia,San Francisco Giants,GIANTS,1,1,1,2,1992,1992,0,3.14,0.0,-3.14,212,0,-212,75,0,-75,799.0,0.0,-799.0,115000.0,0.0,-115000.0
hereg001,Gil Heredia,Montreal Expos,NATEX,1,1,2,3,1997,1997,0,0.0,0.0,0.0,0,0,0,0,0,0,0.0,0.0,0.0,0.0,0.0,0.0
hereg002,Guillermo Heredia,Seattle Mariners,MARNRS,1,3,2,5,2018,2020,2,3.75,-0.48,-4.23,316,148,-168,979,613,-366,0.0,0.0,0.0,2975000.0,0.0,-2975000.0
herew001,Wilson Heredia,Texas Rangers,RNGRS,1,2,1,3,1995,1998,3,0.0,3.86,3.86,0,95,95,0,7,7,0.0,1618.0,1618.0,109000.0,1800000.0,1691000.0
hergm001,Matt Herges,Los Angeles Dodgers,DOGRS,3,8,7,15,2002,2008,6,2.91,17.96,15.05,743,864,121,1634,1120,-514,515.0,2722.0,2207.0,9106667.0,11835000.0,2728333.0
hergm001,Matt Herges,Montreal Expos,NATEX,2,3,4,7,2002,2004,2,3.6,-0.83,-4.43,40,55,15,5,159,154,603.0,0.0,-603.0,370000.0,0.0,-370000.0
hergm001,Matt Herges,San Diego Padres,PADRS,1,1,2,3,2003,2008,5,0.05,2.04,1.99,233,211,-22,2,81,79,364.0,971.0,607.0,0.0,0.0,0.0
hergm001,Matt Herges,San Francisco Giants,GIANTS,1,2,1,3,2005,2005,0,-0.47,0.0,0.47,13,0,-13,0,0,0,24.0,0.0,-24.0,1600000.0,0.0,-1600000.0
hermb101,Billy Herman,Chicago Cubs,CUBS,1,1,3,4,1941,1946,5,12.92,-1.47,-14.39,488,186,-302,2125,448,-1677,0.0,0.0,0.0,0.0,0.0,0.0
hermb101,Billy Herman,Brooklyn Dodgers,DOGRS,1,1,1,2,1946,1946,0,2.56,0.0,-2.56,75,0,-75,301,0,-301,0.0,0.0,0.0,20000.0,0.0,-20000.0
hermb101,Billy Herman,Boston Braves,BRAVES,4,7,6,13,1946,1952,6,-0.23,24.56,24.79,358,848,490,547,3228,2681,596.0,210.0,-386.0,0.0,0.0,0.0
hermb102,Babe Herman,Detroit Tigers,TIGRS,2,6,3,9,1922,1928,6,20.71,4.6,-16.11,377,336,-41,782,333,-449,2967.0,2739.0,-228.0,8000.0,13500.0,5500.0
hermb102,Babe Herman,Brooklyn Dodgers,DOGRS,7,17,12,29,1932,1948,16,60.59,33.44,-27.15,3224,2810,-414,11104,10257,-847,2159.0,791.0,-1368.0,10000.0,10000.0,0.0
hermb102,Babe Herman,Cincinnati Reds,REDS,4,6,9,15,1932,1937,5,29.61,0.55,-29.06,1688,485,-1203,5275,1430,-3845,2379.0,542.0,-1837.0,5500.0,0.0,-5500.0
hermb102,Babe Herman,Chicago Cubs,CUBS,1,3,2,5,1934,1941,7,3.72,22.26,18.54,346,634,288,358,941,583,2252.0,4458.0,2206.0,0.0,0.0,0.0
hermc001,Chad Hermansen,Pittsburgh Pirates,PIRATS,1,1,1,2,2002,2002,0,-0.58,0.0,0.58,35,0,-35,49,0,-49,0.0,0.0,0.0,223000.0,500000.0,277000.0
hermc001,Chad Hermansen,Chicago Cubs,CUBS,1,2,2,4,2002,2004,2,-0.13,2.3,2.43,32,316,284,68,1174,1106,0.0,0.0,0.0,6500000.0,11875000.0,5375000.0
hermd001,Dustin Hermanson,San Diego Padres,PADRS,2,4,4,8,1996,2006,10,3.54,21.49,17.95,377,1376,999,1296,5646,4350,0.0,4.0,4.0,8651680.0,7880000.0,-771680.0
hermd001,Dustin Hermanson,Florida Marlins,MARLNS,3,8,7,15,1997,2005,8,8.19,25.16,16.97,569,1378,809,623,4089,3466,3020.0,1719.0,-1301.0,6500000.0,9062500.0,2562500.0
hermd001,Dustin Hermanson,Montreal Expos,NATEX,1,2,2,4,2000,2003,3,5.18,-3.67,-8.85,698,376,-322,77,830,753,1408.0,493.0,-915.0,3988333.0,750000.0,-3238333.0
hermd001,Dustin Hermanson,St. Louis Cardinals,CARDS,3,4,5,9,2001,2003,2,8.47,-0.03,-8.5,447,102,-345,1848,34,-1814,66.0,386.0,320.0,5333333.0,9411948.0,4078615.0
hermg101,Gene Hermanski,Brooklyn Dodgers,DOGRS,3,6,7,13,1951,1958,7,4.28,2.12,-2.16,1667,685,-982,5534,2062,-3472,435.0,267.0,-168.0,50000.0,61500.0,11500.0
hermg101,Gene Hermanski,Chicago Cubs,CUBS,7,18,16,34,1953,1965,12,5.64,21.93,16.29,1405,1825,420,3839,2173,-1666,1451.0,4951.0,3500.0,82000.0,75000.0,-7000.0
hermj001,Jeremy Hermida,Florida Marlins,MARLNS,1,1,2,3,2009,2012,3,-0.48,0.08,0.56,52,6,-46,171,0,-171,0.0,5.0,5.0,2250000.0,400000.0,-1850000.0
hermr101,Remy Hermoso,Montreal Expos,NATEX,1,1,1,2,1972,1972,0,0.24,0.0,-0.24,48,0,-48,135,0,-135,0.0,0.0,0.0,0.0,0.0,0.0
herna003,Anderson Hernandez,Detroit Tigers,TIGRS,1,1,1,2,2005,2008,3,-0.88,1.11,1.99,81,117,36,238,341,103,0.0,0.0,0.0,0.0,0.0,0.0
herna003,Anderson Hernandez,New York Mets,METS,1,1,1,2,2008,2008,0,0.89,-0.3,-1.19,105,38,-67,346,0,-346,0.0,54.0,54.0,0.0,1700000.0,1700000.0
herna003,Anderson Hernandez,Washington Nationals,NATEX,1,1,1,2,2009,2009,0,-0.09,0.0,0.09,46,0,-46,149,0,-149,0.0,0.0,0.0,400000.0,0.0,-400000.0
herna004,Ariel Hernandez,Cincinnati Reds,REDS,2,4,4,8,2018,2018,0,1.09,0.0,-1.09,176,0,-176,2,0,-2,299.0,0.0,-299.0,0.0,0.0,0.0
hernc001,Carlos Hernandez,San Diego Padres,PADRS,3,5,6,11,2000,2011,11,-1.09,8.64,9.73,131,924,793,88,239,151,85.0,1430.0,1345.0,2077500.0,1600000.0,-477500.0
hernc003,Carlos Hernandez,Houston Astros,ASTROS,1,1,1,2,2000,2002,2,-0.12,0.0,0.12,2,0,-2,1,0,-1,0.0,0.0,0.0,0.0,0.0,0.0
hernc005,Cesar Hernandez,Cleveland Indians,INDINS,1,1,1,2,2021,2021,0,-0.67,0.0,0.67,53,0,-53,217,0,-217,0.0,0.0,0.0,5000000.0,0.0,-5000000.0
hernc101,Chico Hernandez,Chicago Cubs,CUBS,1,2,1,3,1943,1949,6,0.0,5.51,5.51,0,511,511,0,2102,2102,0.0,0.0,0.0,0.0,0.0,0.0
hernd002,David Hernandez,Baltimore Orioles,ORLS,1,2,2,4,2010,2012,2,1.15,1.04,-0.11,541,290,-251,2,1158,1156,777.0,0.0,-777.0,402500.0,833333.0,430833.0
hernd002,David Hernandez,Anaheim Angels,ANGELS,1,1,1,2,2017,2020,3,0.04,0.0,-0.04,48,0,-48,0,0,0,56.0,0.0,-56.0,535000.0,0.0,-535000.0
herne001,Enrique Hernandez,Houston Astros,ASTROS,3,8,7,15,2014,2019,5,5.86,22.81,16.95,902,718,-184,1801,1734,-67,1776.0,1238.0,-538.0,2712000.0,500000.0,-2212000.0
herne001,Enrique Hernandez,Miami Marlins,MARLNS,3,8,9,17,2014,2020,6,14.59,9.27,-5.32,1600,441,-1159,4137,1747,-2390,525.0,522.0,-3.0,17800000.0,10515000.0,-7285000.0
herne102,Enzo Hernandez,Houston Astros,ASTROS,2,4,3,7,1968,1970,2,13.55,1.65,-11.9,563,230,-333,804,931,127,6085.0,0.0,-6085.0,0.0,61000.0,61000.0
herne102,Enzo Hernandez,Baltimore Orioles,ORLS,10,29,24,53,1970,1988,18,23.09,129.53,106.44,2838,6114,3276,6187,12778,6591,10078.0,22814.0,12736.0,733833.0,72500.0,-661333.0
hernf001,Fernando Hernandez,Cleveland Indians,INDINS,2,3,2,5,1993,1994,1,-0.03,1.59,1.62,56,58,2,2,0,-2,91.0,270.0,179.0,0.0,122500.0,122500.0
herng001,Gorkys Hernandez,Detroit Tigers,TIGRS,1,2,1,3,2007,2008,1,10.42,1.11,-9.31,243,138,-105,269,547,278,2160.0,0.0,-2160.0,0.0,9000000.0,9000000.0
herng001,Gorkys Hernandez,Atlanta Braves,BRAVES,1,3,1,4,2009,2011,2,-2.0,-0.61,1.39,553,250,-303,514,1005,491,4336.0,0.0,-4336.0,0.0,2500000.0,2500000.0
herng001,Gorkys Hernandez,Pittsburgh Pirates,PIRATS,2,2,3,5,2012,2014,2,-0.75,0.79,1.54,45,309,264,147,740,593,0.0,0.0,0.0,0.0,964500.0,964500.0
herng001,Gorkys Hernandez,Miami Marlins,MARLNS,1,1,1,2,2013,2013,0,0.0,0.0,0.0,0,0,0,0,0,0,0.0,0.0,0.0,0.0,0.0,0.0
hernj001,Jose Hernandez,Cleveland Indians,INDINS,2,2,2,4,1993,1995,2,8.05,-0.12,-8.17,898,74,-824,1975,93,-1882,413.0,82.0,-331.0,165000.0,150000.0,-15000.0
hernj001,Jose Hernandez,Chicago Cubs,CUBS,2,4,5,9,1999,2001,2,0.04,-3.17,-3.21,294,120,-174,362,46,-316,1366.0,490.0,-876.0,5325000.0,1200000.0,-4125000.0
hernj001,Jose Hernandez,Colorado Rockies,ROCKS,1,1,1,2,2003,2003,0,-0.2,-0.16,0.04,23,48,25,72,134,62,0.0,0.0,0.0,1000000.0,465000.0,-535000.0
hernj001,Jose Hernandez,Chicago Cubs,CUBS,1,3,3,6,2003,2011,8,0.04,25.85,25.81,310,1180,870,721,4941,4220,0.0,0.0,0.0,0.0,4025000.0,4025000.0
hernj002,Jeremy Hernandez,St. Louis Cardinals,CARDS,1,1,1,2,1989,1989,0,0.57,0.0,-0.57,112,0,-112,5,0,-5,256.0,0.0,-256.0,0.0,0.0,0.0
hernj002,Jeremy Hernandez,San Diego Padres,PADRS,3,5,5,10,1993,2000,7,0.96,-0.7,-1.66,77,54,-23,3,11,8,299.0,168.0,-131.0,448500.0,0.0,-448500.0
hernj002,Jeremy Hernandez,Cleveland Indians,INDINS,1,1,1,2,1994,1994,0,-0.03,0.21,0.24,56,9,-47,2,0,-2,91.0,38.0,-53.0,0.0,0.0,0.0
hernj102,Jackie Hernandez,California Angels,ANGELS,3,4,5,9,1966,1969,3,10.95,8.69,-2.26,553,605,52,930,2108,1178,1992.0,0.0,-1992.0,0.0,11000.0,11000.0
hernj102,Jackie Hernandez,Kansas City Royals,ROYALS,2,6,5,11,1970,1979,9,2.78,26.16,23.38,582,1576,994,670,5382,4712,1583.0,1688.0,105.0,34500.0,38500.0,4000.0
hernj102,Jackie Hernandez,Pittsburgh Pirates,PIRATS,1,1,1,2,1974,1974,0,0.0,-0.29,-0.29,0,15,15,0,34,34,0.0,0.0,0.0,0.0,0.0,0.0
hernk001,Keith Hernandez,St. Louis Cardinals,CARDS,1,1,2,3,1983,1986,3,26.61,-0.78,-27.39,880,253,-627,3684,88,-3596,0.0,994.0,994.0,0.0,0.0,0.0
hernl001,Larry Herndon,St. Louis Cardinals,CARDS,1,2,1,3,1975,1975,0,3.9,-0.88,-4.78,682,20,-662,2305,1,-2304,0.0,26.0,26.0,0.0,0.0,0.0
hernl001,Larry Herndon,San Francisco Giants,GIANTS,1,1,2,3,1981,1983,2,11.25,-1.99,-13.24,843,58,-785,3013,18,-2995,0.0,218.0,218.0,0.0,0.0,0.0
hernl002,Leo Hernandez,Los Angeles Dodgers,DOGRS,1,1,1,2,1982,1984,2,-1.38,0.21,1.59,78,104,26,239,108,-131,0.0,0.0,0.0,0.0,0.0,0.0
hernl002,Leo Hernandez,Baltimore Orioles,ORLS,1,2,2,4,1985,1987,2,-0.33,0.34,0.67,76,66,-10,188,1,-187,0.0,321.0,321.0,558333.0,0.0,-558333.0
hernl003,Livan Hernandez,Florida Marlins,MARLNS,1,1,2,3,1999,2006,7,5.69,-0.63,-6.32,220,237,17,285,23,-262,2239.0,544.0,-1695.0,1875000.0,0.0,-1875000.0
hernl003,Livan Hernandez,San Francisco Giants,GIANTS,1,3,2,5,2003,2005,2,18.34,1.53,-16.81,443,337,-106,636,24,-612,3951.0,670.0,-3281.0,0.0,0.0,0.0
hernl003,Livan Hernandez,Washington Nationals,NATEX,1,2,2,4,2006,2011,5,3.1,-0.03,-3.13,87,194,107,106,108,2,821.0,1067.0,246.0,8000000.0,0.0,-8000000.0
hernm003,Marco Hernandez,Chicago Cubs,CUBS,1,1,1,2,2014,2015,1,-0.14,0.42,0.56,122,8,-114,271,8,-263,0.0,61.0,61.0,0.0,586000.0,586000.0
herno001,Orlando Hernandez,New York Yankees,YANKS,1,1,2,3,2003,2003,0,0.41,0.84,0.43,25,51,26,3,0,-3,385.0,152.0,-233.0,0.0,0.0,0.0
herno001,Orlando Hernandez,Chicago White Sox,WSOX,1,4,2,6,2003,2003,0,-4.18,5.0,9.18,270,36,-234,107,7,-100,449.0,726.0,277.0,0.0,0.0,0.0
herno001,Orlando Hernandez,Chicago White Sox,WSOX,3,7,7,14,2005,2015,10,21.04,18.91,-2.13,1161,870,-291,3709,2249,-1460,1060.0,1883.0,823.0,16705000.0,11000000.0,-5705000.0
herno001,Orlando Hernandez,Arizona Diamondbacks,DBACKS,2,3,2,5,2006,2009,3,3.04,0.94,-2.1,112,197,85,95,61,-34,821.0,743.0,-78.0,4625000.0,2525000.0,-2100000.0
hernp001,Pedro Hernandez,San Diego Padres,PADRS,7,19,13,32,2011,2021,10,17.4,14.23,-3.17,1323,1189,-134,3711,3610,-101,1751.0,362.0,-1389.0,9570500.0,5050000.0,-4520500.0
hernp001,Pedro Hernandez,Chicago White Sox,WSOX,1,2,1,3,2012,2012,0,5.04,0.22,-4.82,686,12,-674,2423,0,-2423,173.0,170.0,-3.0,480000.0,5500000.0,5020000.0
hernp101,Pedro Hernandez,Houston Astros,ASTROS,1,3,1,4,1978,1989,11,-3.72,7.9,11.62,160,965,805,206,3318,3112,249.0,0.0,-249.0,22500.0,0.0,-22500.0
hernr001,Roberto Hernandez,California Angels,ANGELS,1,2,1,3,1989,1989,0,10.8,0.0,-10.8,349,0,-349,0,0,0,1214.0,0.0,-1214.0,0.0,0.0,0.0
hernr001,Roberto Hernandez,Chicago White Sox,WSOX,7,14,18,32,1997,2011,14,8.23,24.04,15.81,946,1419,473,129,1458,1329,2956.0,3428.0,472.0,22052500.0,11583333.0,-10469167.0
hernr001,Roberto Hernandez,Tampa Bay Devil Rays,RAYS,1,2,1,3,2001,2003,2,1.27,3.18,1.91,123,345,222,0,1405,1405,359.0,0.0,-359.0,0.0,0.0,0.0
hernr001,Roberto Hernandez,Pittsburgh Pirates,PIRATS,3,5,7,12,2006,2016,10,1.97,9.91,7.94,388,1408,1020,455,3224,2769,1770.0,3210.0,1440.0,14150000.0,818425.0,-13331575.0
hernr002,Ramon Hernandez,Oakland Athletics,ATLTCS,2,3,3,6,2003,2012,9,7.5,9.83,2.33,434,545,111,1482,2087,605,0.0,206.0,206.0,4062500.0,4450000.0,387500.0
hernr002,Ramon Hernandez,Baltimore Orioles,ORLS,2,3,4,7,2008,2010,2,1.2,-0.23,-1.43,283,26,-257,1043,51,-992,0.0,0.0,0.0,11500000.0,3800000.0,-7700000.0
hernr002,Ramon Hernandez,Colorado Rockies,ROCKS,2,3,3,6,2013,2013,0,-0.75,0.0,0.75,41,0,-41,59,0,-59,361.0,0.0,-361.0,0.0,0.0,0.0
hernr102,Ramon Hernandez,MexicoCityReds,MexicoCityReds,1,1,1,2,1971,1971,0,8.0,0.0,-8.0,526,0,-526,42,0,-42,1043.0,0.0,-1043.0,0.0,0.0,0.0
hernr102,Ramon Hernandez,Chicago Cubs,CUBS,1,1,1,2,1977,1977,0,-0.27,-0.19,0.08,12,11,-1,0,12,12,38.0,0.0,-38.0,0.0,0.0,0.0
hernr103,Rudy Hernandez,Chicago White Sox,WSOX,1,1,2,3,1973,1981,8,0.0,8.38,8.38,0,129,129,0,0,0,0.0,2154.0,2154.0,0.0,0.0,0.0
hernt002,Teoscar Hernandez,Houston Astros,ASTROS,1,2,1,3,2017,2017,0,8.07,-0.16,-8.23,490,21,-469,1918,0,-1918,0.0,43.0,43.0,5500000.0,13666667.0,8166667.0
hernw001,Guillermo Hernandez,Chicago Cubs,CUBS,1,1,2,3,1983,1986,3,1.63,1.67,0.04,126,170,44,13,140,127,287.0,1159.0,872.0,0.0,0.0,0.0
hernw001,Guillermo Hernandez,Philadelphia Phillies,PHILS,3,6,6,12,1984,1989,5,21.01,8.65,-12.36,1868,885,-983,3542,3171,-371,2761.0,15.0,-2746.0,1629900.0,750000.0,-879900.0
hernx001,Xavier Hernandez,Houston Astros,ASTROS,2,2,3,5,1993,1995,2,-0.35,0.14,0.49,32,80,48,0,134,134,120.0,0.0,-120.0,900000.0,138000.0,-762000.0
herra101,Art Herring,Brooklyn Dodgers,DOGRS,2,6,2,8,1934,1938,4,0.05,1.5,1.45,177,398,221,491,1389,898,0.0,3.0,3.0,0.0,0.0,0.0
herrc001,Chris Herrmann,Minnesota Twins,TWINS,1,1,1,2,2015,2017,2,0.47,0.0,-0.47,162,0,-162,422,0,-422,0.0,0.0,0.0,510000.0,0.0,-510000.0
herrd001,Danny Herrera,Texas Rangers,RNGRS,1,2,1,3,2007,2012,5,4.01,22.54,18.53,363,647,284,148,2814,2666,1527.0,0.0,-1527.0,0.0,380000.0,380000.0
herrd001,Danny Herrera,Milwaukee Brewers,BREWRS,2,3,3,6,2011,2015,4,0.39,1.82,1.43,61,261,200,0,1,1,90.0,377.0,287.0,0.0,12166666.0,12166666.0
herrd002,Dilson Herrera,Pittsburgh Pirates,PIRATS,1,2,3,5,2013,2013,0,0.44,0.95,0.51,159,39,-120,169,139,-30,143.0,0.0,-143.0,0.0,0.0,0.0
herrd002,Dilson Herrera,New York Mets,METS,3,4,3,7,2016,2021,5,0.07,2.8,2.73,96,168,72,266,686,420,0.0,3.0,3.0,13000000.0,3500000.0,-9500000.0
herre102,Ed Herrmann,Chicago White Sox,WSOX,1,1,5,6,1975,1975,0,0.33,0.0,-0.33,80,0,-80,217,0,-217,0.0,0.0,0.0,0.0,0.0,0.0
herre102,Ed Herrmann,California Angels,ANGELS,2,2,3,5,1976,1980,4,-0.21,0.55,0.76,204,312,108,515,705,190,210.0,441.0,231.0,0.0,0.0,0.0
herrj001,Jose Herrera,Toronto Blue Jays,BJAYS,1,2,1,3,1993,1993,0,1.73,0.5,-1.23,187,44,-143,423,203,-220,657.0,0.0,-657.0,0.0,3550000.0,3550000.0
herrj002,Jonathan Herrera,Colorado Rockies,ROCKS,1,1,2,3,2013,2015,2,-0.06,-0.53,-0.47,42,103,61,104,39,-65,0.0,474.0,474.0,900000.0,1487500.0,587500.0
herrj101,John Herrnstein,Philadelphia Phillies,PHILS,1,3,2,5,1966,1968,2,66.82,10.77,-56.05,1243,294,-949,2604,327,-2277,8021.0,2661.0,-5360.0,0.0,0.0,0.0
herrj101,John Herrnstein,Chicago Cubs,CUBS,2,2,3,5,1966,1967,1,-0.3,-0.17,0.13,21,59,38,18,34,16,4.0,53.0,49.0,0.0,0.0,0.0
herrj101,John Herrnstein,Atlanta Braves,BRAVES,1,2,2,4,1966,1966,0,0.0,0.0,0.0,0,0,0,0,0,0,0.0,0.0,0.0,0.0,0.0,0.0
herrj102,Jose Herrera,Montreal Expos,NATEX,1,1,1,2,1970,1971,1,0.0,-0.36,-0.36,0,44,44,0,5,5,0.0,119.0,119.0,0.0,0.0,0.0
herrj102,Jose Herrera,Milwaukee Brewers,BREWRS,1,2,1,3,1971,1971,0,0.0,-0.75,-0.75,0,42,42,0,3,3,0.0,97.0,97.0,17500.0,26500.0,9000.0
herrk001,Kelvin Herrera,Kansas City Royals,ROYALS,1,1,3,4,2018,2021,3,0.15,-0.73,-0.88,41,62,21,0,233,233,56.0,0.0,-56.0,0.0,0.0,0.0
herrl101,Leroy Herrmann,Chicago Cubs,CUBS,2,8,3,11,1933,1946,13,22.35,18.34,-4.01,627,903,276,2568,3781,1213,0.0,0.0,0.0,0.0,0.0,0.0
herrp101,Pancho Herrera,Philadelphia Phillies,PHILS,1,2,1,3,1962,1964,2,-0.67,1.44,2.11,85,121,36,167,417,250,0.0,0.0,0.0,0.0,0.0,0.0
herrr001,Ronald Herrera,Oakland Athletics,ATLTCS,1,2,1,3,2014,2014,0,-0.14,0.59,0.73,51,21,-30,115,56,-59,0.0,0.0,0.0,0.0,988000.0,988000.0
herrr001,Ronald Herrera,San Diego Padres,PADRS,1,1,1,2,2015,2019,4,-0.05,0.87,0.92,2,246,244,0,863,863,9.0,0.0,-9.0,0.0,510000.0,510000.0
herrr001,Ronald Herrera,New York Yankees,YANKS,4,6,6,12,2017,2021,4,10.03,0.33,-9.7,238,102,-136,526,361,-165,1135.0,0.0,-1135.0,0.0,0.0,0.0
herrr101,Rick Herrscher,Milwaukee Braves,BRAVES,1,2,2,4,1962,1964,2,3.7,0.59,-3.11,377,85,-292,1356,234,-1122,0.0,0.0,0.0,0.0,0.0,0.0
herrt001,Tom Herr,St. Louis Cardinals,CARDS,4,6,6,12,1988,1997,9,5.03,5.54,0.51,976,963,-13,2815,1492,-1323,209.0,991.0,782.0,10009167.0,4590000.0,-5419167.0
herrt001,Tom Herr,Minnesota Twins,TWINS,1,3,2,5,1988,1989,1,2.78,0.41,-2.37,304,27,-277,1185,0,-1185,0.0,435.0,435.0,103500.0,900000.0,796500.0
herrt001,Tom Herr,Philadelphia Phillies,PHILS,1,1,2,3,1990,1990,0,-0.36,0.0,0.36,97,0,-97,306,0,-306,0.0,0.0,0.0,825000.0,0.0,-825000.0
herse101,Earl Hersh,Milwaukee Braves,BRAVES,1,2,2,4,1959,1961,2,0.0,0.34,0.34,0,49,49,0,163,163,0.0,0.0,0.0,0.0,0.0,0.0
hersm101,Mike Hershberger,Chicago White Sox,WSOX,16,33,31,64,1965,1979,14,66.9,101.26,34.36,5527,5050,-477,14821,15211,390,11511.0,9679.0,-1832.0,609700.0,568700.0,-41000.0
hersm101,Mike Hershberger,Oakland Athletics,ATLTCS,9,20,12,32,1970,1976,6,26.16,16.01,-10.15,3775,1399,-2376,8326,3903,-4423,4415.0,1098.0,-3317.0,340600.0,421500.0,80900.0
hersw101,Willard Hershberger,New York Yankees,YANKS,3,3,12,15,1937,1943,6,12.91,-0.14,-13.05,694,36,-658,2601,81,-2520,0.0,0.0,0.0,0.0,8750.0,8750.0
herzb101,Buck Herzog,New York Giants,GIANTS,1,2,1,3,1910,1913,3,4.09,2.02,-2.07,544,293,-251,2338,817,-1521,0.0,0.0,0.0,0.0,0.0,0.0
herzb101,Buck Herzog,Boston Braves,BRAVES,10,19,18,37,1911,1938,27,31.7,49.03,17.33,2338,3824,1486,6936,13187,6251,4661.0,3399.0,-1262.0,56400.0,40100.0,-16300.0
herzb101,Buck Herzog,New York Giants,GIANTS,2,4,2,6,1913,1921,8,15.0,8.81,-6.19,695,474,-221,2854,907,-1947,0.0,2915.0,2915.0,6400.0,5200.0,-1200.0
herzb101,Buck Herzog,Cincinnati Reds,REDS,2,3,5,8,1916,1930,14,6.12,44.47,38.35,494,1760,1266,2101,7377,5276,0.0,27.0,27.0,0.0,3300.0,3300.0
herzb101,Buck Herzog,New York Giants,GIANTS,2,3,4,7,1918,1923,5,10.74,16.59,5.85,496,534,38,1371,952,-419,2035.0,3773.0,1738.0,12500.0,9600.0,-2900.0
herzb101,Buck Herzog,Boston Braves,BRAVES,1,1,2,3,1919,1921,2,-0.19,4.01,4.2,143,284,141,569,1192,623,0.0,0.0,0.0,0.0,4800.0,4800.0
herzw101,Whitey Herzog,New York Yankees,YANKS,7,20,15,35,1956,1970,14,3.04,33.17,30.13,2442,2492,50,6615,5619,-996,2999.0,5239.0,2240.0,115500.0,43000.0,-72500.0
herzw101,Whitey Herzog,Kansas City Athletics,ATLTCS,24,51,45,96,1961,1976,15,93.37,59.87,-33.5,8944,6063,-2881,21756,17588,-4168,9976.0,4965.0,-5011.0,504100.0,545500.0,41400.0
herzw101,Whitey Herzog,Baltimore Orioles,ORLS,1,2,1,3,1962,1962,0,0.46,0.0,-0.46,158,0,-158,435,0,-435,0.0,0.0,0.0,0.0,0.0,0.0
hessd001,David Hess,Tampa Bay Devil Rays,RAYS,1,1,2,3,2021,2021,0,-0.91,0.0,0.91,27,0,-27,4,0,-4,54.0,0.0,-54.0,0.0,0.0,0.0
hestc001,Chris Heston,San Francisco Giants,GIANTS,2,2,2,4,2016,2019,3,-0.55,2.56,3.11,2,107,105,0,411,411,15.0,0.0,-15.0,530000.0,0.0,-530000.0
hestj001,John Hester,Arizona Diamondbacks,DBACKS,1,2,2,4,2011,2015,4,1.04,1.11,0.07,290,493,203,1158,2,-1156,0.0,721.0,721.0,0.0,0.0,0.0
heuec001,Codi Heuer,Chicago White Sox,WSOX,1,2,1,3,2021,2021,0,0.52,-0.03,-0.55,48,26,-22,0,0,0,86.0,69.0,-17.0,0.0,16000000.0,16000000.0
heuse101,Ed Heusser,Philadelphia Athletics,ATLTCS,39,84,81,165,1940,1976,36,92.78,78.07,-14.71,10628,9945,-683,25815,30208,4393,12609.0,9858.0,-2751.0,510800.0,639500.0,128700.0
heuse101,Ed Heusser,Cincinnati Reds,REDS,1,1,1,2,1946,1948,2,0.0,4.66,4.66,0,178,178,0,598,598,0.0,0.0,0.0,0.0,0.0,0.0
hevij101,Joe Heving,New York Giants,GIANTS,1,4,1,5,1931,1931,0,0.0,0.0,0.0,0,0,0,0,0,0,0.0,0.0,0.0,0.0,0.0,0.0
hevij102,Johnnie Heving,Boston Red Sox,RSOX,2,6,3,9,1925,1926,1,0.0,-1.32,-1.32,0,98,98,0,337,337,0.0,0.0,0.0,21750.0,0.0,-21750.0
heydm101,Mike Heydon,Brooklyn Dodgers,DOGRS,1,4,2,6,1899,1903,4,0.67,6.33,5.66,113,445,332,291,1743,1452,635.0,0.0,-635.0,0.0,0.0,0.0
heydm101,Mike Heydon,Indianapolis,Indianapolis,1,1,1,2,1904,1904,0,-0.01,0.0,0.01,4,0,-4,12,0,-12,0.0,0.0,0.0,0.0,0.0,0.0
heywj001,Jason Heyward,Atlanta Braves,BRAVES,3,6,6,12,2014,2021,7,6.17,11.17,5.0,236,884,648,658,2525,1867,448.0,1265.0,817.0,6525000.0,1034000.0,-5491000.0
hiatj101,Jack Hiatt,California Angels,ANGELS,3,3,3,6,1964,1969,5,11.83,4.86,-6.97,882,579,-303,2571,2006,-565,0.0,0.0,0.0,26000.0,21000.0,-5000.0
hiatj101,Jack Hiatt,Montreal Expos,NATEX,1,1,1,2,1970,1970,0,0.48,0.6,0.12,66,41,-25,215,118,-97,0.0,0.0,0.0,0.0,0.0,0.0
hiatp001,Phil Hiatt,Kansas City Royals,ROYALS,1,1,1,2,1995,1995,0,0.02,-0.11,-0.13,7,15,8,23,39,16,0.0,0.0,0.0,150000.0,375000.0,225000.0
hibbg001,Greg Hibbard,Kansas City Royals,ROYALS,2,5,3,8,1987,1989,2,6.71,1.86,-4.85,503,45,-458,494,0,-494,4503.0,794.0,-3709.0,62500.0,930000.0,867500.0
hibbg001,Greg Hibbard,Florida Marlins,MARLNS,2,3,3,6,1992,1997,5,2.75,6.53,3.78,468,640,172,88,1194,1106,1381.0,1519.0,138.0,0.0,116000.0,116000.0
hicka001,Aaron Hicks,Minnesota Twins,TWINS,2,2,2,4,2015,2019,4,9.28,-0.39,-9.67,612,69,-543,2194,90,-2104,9.0,128.0,119.0,0.0,518700.0,518700.0
hickb001,Bryan Hickerson,Minnesota Twins,TWINS,1,3,2,5,1987,1991,4,0.91,5.69,4.78,306,646,340,81,2698,2617,1068.0,6.0,-1062.0,0.0,0.0,0.0
hickc101,Charlie Hickman,Cleveland Indians,INDINS,1,1,1,2,1904,1905,1,0.7,0.57,-0.13,101,121,20,399,464,65,0.0,0.0,0.0,0.0,0.0,0.0
hickc101,Charlie Hickman,Cleveland Indians,INDINS,1,2,1,3,1908,1914,6,0.0,-1.58,-1.58,0,95,95,0,309,309,0.0,0.0,0.0,0.0,0.0,0.0
hickj101,Joe Hicks,Los Angeles Angels,ANGELS,4,5,6,11,1960,1969,9,10.52,26.6,16.08,667,1051,384,1150,2550,1400,1992.0,3710.0,1718.0,45000.0,44000.0,-1000.0
hickj103,Jim Hickman,New York Mets,METS,6,11,10,21,1966,1974,8,2.87,14.84,11.97,879,1261,382,2379,4536,2157,1072.0,0.0,-1072.0,182000.0,96000.0,-86000.0
hickj103,Jim Hickman,Los Angeles Dodgers,DOGRS,3,4,4,8,1968,1970,2,15.48,-0.58,-16.06,1246,61,-1185,2529,137,-2392,1193.0,0.0,-1193.0,36500.0,0.0,-36500.0
hickj103,Jim Hickman,Chicago Cubs,CUBS,1,1,1,2,1974,1974,0,0.5,0.0,-0.5,50,0,-50,68,0,-68,0.0,0.0,0.0,0.0,0.0,0.0
hickj104,Jesse Hickman,Houston Astros,ASTROS,3,4,3,7,1965,1969,4,-0.71,1.07,1.78,88,138,50,90,443,353,49.0,55.0,6.0,0.0,0.0,0.0
hickj105,Jim Hicks,St. Louis Cardinals,CARDS,4,5,6,11,1969,1972,3,10.28,4.7,-5.58,544,458,-86,1206,1416,210,1651.0,28.0,-1623.0,11000.0,0.0,-11000.0
hickk001,Kevin Hickey,Chicago White Sox,WSOX,2,3,3,6,1984,1985,1,3.61,-0.06,-3.67,409,47,-362,1330,158,-1172,395.0,0.0,-395.0,0.0,700000.0,700000.0
hidar001,Richard Hidalgo,Houston Astros,ASTROS,1,1,2,3,2004,2005,1,0.91,-0.5,-1.41,86,53,-33,359,2,-357,0.0,109.0,109.0,12500000.0,3933333.0,-8566667.0
higbk101,Kirby Higbe,Chicago Cubs,CUBS,1,3,1,4,1939,1947,8,6.07,34.45,28.38,546,585,39,1567,751,-816,1708.0,5741.0,4033.0,9500.0,8000.0,-1500.0
higbk101,Kirby Higbe,Philadelphia Phillies,PHILS,3,3,6,9,1940,1945,5,9.73,2.95,-6.78,550,492,-58,984,965,-19,2859.0,1645.0,-1214.0,0.0,0.0,0.0
higbk101,Kirby Higbe,Brooklyn Dodgers,DOGRS,1,5,2,7,1947,1947,0,3.3,-0.19,-3.49,337,37,-300,419,81,-338,1285.0,0.0,-1285.0,17500.0,0.0,-17500.0
higbk101,Kirby Higbe,Pittsburgh Pirates,PIRATS,1,1,2,3,1949,1949,0,0.56,-0.71,-1.27,110,25,-85,22,18,-4,345.0,108.0,-237.0,0.0,0.0,0.0
higgd101,Dennis Higgins,Chicago White Sox,WSOX,4,7,7,14,1968,1971,3,11.44,1.3,-10.14,1683,516,-1167,5097,1341,-3756,666.0,366.0,-300.0,31000.0,33000.0,2000.0
higgd101,Dennis Higgins,Washington Senators,RNGRS,10,23,17,40,1969,1988,19,45.59,49.51,3.92,2709,3553,844,8910,11036,2126,3519.0,6237.0,2718.0,494000.0,226000.0,-268000.0
higgd101,Dennis Higgins,Oakland Athletics,ATLTCS,2,2,2,4,1971,1977,6,-0.18,0.57,0.75,36,124,88,2,378,376,89.0,0.0,-89.0,0.0,0.0,0.0
higgm101,Pinky Higgins,Philadelphia Athletics,ATLTCS,1,1,1,2,1936,1939,3,3.19,4.95,1.76,356,262,-94,1486,1175,-311,0.0,0.0,0.0,10000.0,0.0,-10000.0
higgm101,Pinky Higgins,Boston Red Sox,RSOX,1,2,3,5,1938,1940,2,15.76,-0.33,-16.09,1005,102,-903,3681,69,-3612,671.0,596.0,-75.0,16000.0,19500.0,3500.0
higha101,Andy High,Boston Braves,BRAVES,1,2,1,3,1928,1929,1,2.41,2.79,0.38,392,292,-100,1482,1208,-274,0.0,0.0,0.0,0.0,0.0,0.0
higha101,Andy High,St. Louis Cardinals,CARDS,1,1,2,3,1931,1931,0,-0.65,0.0,0.65,108,0,-108,270,0,-270,0.0,0.0,0.0,0.0,0.0,0.0
highc101,Charlie High,Detroit Tigers,TIGRS,1,9,2,11,1921,1941,20,0.0,3.03,3.03,0,202,202,0,144,144,0.0,1168.0,1168.0,0.0,0.0,0.0
hilcw101,Whitey Hilcher,Cincinnati Reds,REDS,1,1,1,2,1936,1946,10,0.0,0.0,0.0,0,0,0,0,0,0,0.0,0.0,0.0,0.0,0.0,0.0
hildo101,Oral Hildebrand,Indianapolis,Indianapolis,1,1,3,4,1930,1941,11,12.34,0.0,-12.34,342,0,-342,365,0,-365,2760.0,0.0,-2760.0,0.0,2400.0,2400.0
hildo101,Oral Hildebrand,Cleveland Indians,INDINS,1,3,3,6,1937,1939,2,6.18,8.46,2.28,372,600,228,1331,2387,1056,1093.0,179.0,-914.0,0.0,0.0,0.0
hildo101,Oral Hildebrand,St.Louis Browns,ORLS,1,2,2,4,1938,1941,3,3.15,-0.79,-3.94,102,295,193,121,1044,923,438.0,3.0,-435.0,6000.0,17000.0,11000.0
hildo101,Oral Hildebrand,StPaul,StPaul,1,1,1,2,1941,1946,5,0.0,0.0,0.0,0,0,0,0,0,0,0.0,0.0,0.0,0.0,0.0,0.0
hilgt101,Tom Hilgendorf,St. Louis Cardinals,CARDS,2,2,2,4,1970,1974,4,0.03,0.0,-0.03,3,0,-3,0,0,0,31.0,0.0,-31.0,0.0,0.0,0.0
hilgt101,Tom Hilgendorf,Kansas City Royals,ROYALS,1,1,1,2,1972,1972,0,1.74,0.0,-1.74,121,0,-121,14,0,-14,570.0,0.0,-570.0,0.0,0.0,0.0
hilgt101,Tom Hilgendorf,Cleveland Indians,INDINS,3,3,3,6,1975,1984,9,1.73,1.63,-0.1,106,204,98,15,722,707,290.0,28.0,-262.0,0.0,0.0,0.0
hilje001,Erik Hiljus,New York Mets,METS,5,9,7,16,1996,1999,3,12.32,10.55,-1.77,1251,422,-829,4420,1607,-2813,1041.0,86.0,-955.0,5050000.0,4845000.0,-205000.0
hilla001,Aaron Hill,Toronto Blue Jays,BJAYS,1,2,1,3,2011,2012,1,8.13,2.83,-5.3,614,175,-439,2342,713,-1629,0.0,0.0,0.0,6500000.0,5850000.0,-650000.0
hilla001,Aaron Hill,Arizona Diamondbacks,DBACKS,2,7,4,11,2016,2019,3,30.63,10.0,-20.63,1052,220,-832,3757,754,-3003,1784.0,544.0,-1240.0,2600000.0,1044000.0,-1556000.0
hilla001,Aaron Hill,Milwaukee Brewers,BREWRS,3,4,4,8,2016,2020,4,-0.65,-0.37,0.28,62,98,36,173,228,55,0.0,115.0,115.0,0.0,0.0,0.0
hillb001,Bobby Hill,Chicago Cubs,CUBS,1,3,3,6,2003,2011,8,0.04,25.85,25.81,310,1180,870,721,4941,4220,0.0,0.0,0.0,0.0,4025000.0,4025000.0
hillb001,Bobby Hill,Pittsburgh Pirates,PIRATS,1,1,1,2,2005,2005,0,0.0,0.0,0.0,0,0,0,0,0,0,0.0,0.0,0.0,326000.0,0.0,-326000.0
hillb102,Bill Hill,Louisville Colonels,LS3,2,13,8,21,1898,1902,4,269.31,7.73,-261.58,7454,627,-6827,29109,2681,-26428,8354.0,267.0,-8087.0,4350.0,0.0,-4350.0
hillb102,Bill Hill,Cincinnati Reds,REDS,1,2,1,3,1898,1898,0,0.0,0.0,0.0,0,0,0,0,0,0,0.0,0.0,0.0,0.0,0.0,0.0
hillc101,Chuck Hiller,New York Mets,METS,1,1,1,2,1967,1968,1,0.01,-1.41,-1.42,31,102,71,45,340,295,0.0,0.0,0.0,19000.0,0.0,-19000.0
hillc102,Carmen Hill,Pittsburgh Pirates,PIRATS,3,8,4,12,1917,1922,5,39.97,14.47,-25.5,1164,978,-186,2135,3744,1609,8893.0,574.0,-8319.0,4200.0,5000.0,800.0
hilld001,Donnie Hill,Oakland Athletics,ATLTCS,1,1,2,3,1986,1992,6,0.37,3.34,2.97,194,291,97,702,0,-702,0.0,1471.0,1471.0,218200.0,240000.0,21800.0
hilld102,Dave Hillman,Chicago Cubs,CUBS,1,2,1,3,1959,1960,1,1.72,-0.14,-1.86,88,52,-36,29,107,78,345.0,0.0,-345.0,0.0,0.0,0.0
hillf101,Frank Hiller,Chicago Cubs,CUBS,1,1,1,2,1952,1952,0,0.41,1.71,1.3,57,38,-19,42,19,-23,373.0,201.0,-172.0,0.0,0.0,0.0
hillf101,Frank Hiller,Cincinnati Reds,REDS,2,4,2,6,1952,1961,9,1.04,13.15,12.11,188,1235,1047,605,5109,4504,101.0,0.0,-101.0,11000.0,10500.0,-500.0
hillf101,Frank Hiller,New York Giants,GIANTS,1,4,1,5,1953,1957,4,0.0,2.61,2.61,0,252,252,0,49,49,0.0,709.0,709.0,0.0,0.0,0.0
hillg001,Glenallen Hill,Toronto Blue Jays,BJAYS,1,4,2,6,1991,1993,2,4.36,3.25,-1.11,538,117,-421,1892,245,-1647,194.0,389.0,195.0,115000.0,2600000.0,2485000.0
hillg001,Glenallen Hill,Cleveland Indians,INDINS,1,1,1,2,1993,1994,1,4.66,-0.34,-5.0,331,70,-261,993,205,-788,0.0,0.0,0.0,975000.0,1650000.0,675000.0
hillg001,Glenallen Hill,Chicago Cubs,CUBS,3,4,4,8,2000,2002,2,0.69,2.96,2.27,125,233,108,216,800,584,101.0,74.0,-27.0,2165000.0,6500000.0,4335000.0
hillg001,Glenallen Hill,New York Yankees,YANKS,4,5,5,10,2001,2007,6,-0.66,0.27,0.93,46,179,133,84,0,-84,184.0,789.0,605.0,6000000.0,6000000.0,0.0
hillh101,Hunter Hill,St.Louis Browns,ORLS,1,2,1,3,1904,1904,0,2.03,0.03,-2.0,386,82,-304,1572,310,-1262,0.0,0.0,0.0,0.0,0.0,0.0
hillh102,Herman Hill,Minnesota Twins,TWINS,1,2,2,4,1970,1970,0,0.0,0.0,0.0,0,0,0,0,0,0,0.0,0.0,0.0,8000.0,12000.0,4000.0
hillj001,Jeremy Hill,Kansas City Royals,ROYALS,1,1,1,2,2003,2003,0,0.0,-0.68,-0.68,0,16,16,0,0,0,0.0,37.0,37.0,0.0,650000.0,650000.0
hillj102,Jesse Hill,Hollywood,Hollywood,1,1,3,4,1932,1932,0,1.79,0.0,-1.79,107,0,-107,445,0,-445,0.0,0.0,0.0,0.0,0.0,0.0
hillj102,Jesse Hill,New York Yankees,YANKS,1,2,2,4,1936,1940,4,1.79,4.55,2.76,337,355,18,641,541,-100,1980.0,2260.0,280.0,0.0,0.0,0.0
hillj102,Jesse Hill,Philadelphia Athletics,ATLTCS,2,4,2,6,1937,1946,9,1.34,-1.59,-2.93,190,315,125,733,931,198,0.0,888.0,888.0,5300.0,8000.0,2700.0
hillk001,Ken Hill,Detroit Tigers,TIGRS,1,2,1,3,1986,1990,4,-0.22,6.31,6.53,280,453,173,385,1468,1083,1743.0,0.0,-1743.0,72500.0,533333.0,460833.0
hillk001,Ken Hill,St. Louis Cardinals,CARDS,1,1,1,2,1991,1992,1,10.49,-0.32,-10.81,170,95,-75,217,347,130,1669.0,0.0,-1669.0,155000.0,0.0,-155000.0
hillk001,Ken Hill,Montreal Expos,NATEX,2,3,6,9,1995,1999,4,1.33,-0.63,-1.96,235,498,263,861,779,-82,331.0,567.0,236.0,0.0,0.0,0.0
hillk001,Ken Hill,St. Louis Cardinals,CARDS,1,1,3,4,1995,1998,3,1.44,-1.12,-2.56,12,171,159,0,473,473,224.0,0.0,-224.0,4525000.0,0.0,-4525000.0
hillk001,Ken Hill,Texas Rangers,RNGRS,2,3,5,8,1997,1999,2,7.16,7.66,0.5,307,148,-159,732,235,-497,1167.0,1253.0,86.0,5075000.0,3880472.0,-1194528.0
hillk002,Koyie Hill,Los Angeles Dodgers,DOGRS,1,3,2,5,2004,2004,0,-0.45,1.02,1.47,67,105,38,129,363,234,19.0,0.0,-19.0,0.0,7800000.0,7800000.0
hillk002,Koyie Hill,Washington Nationals,NATEX,1,1,1,2,2014,2014,0,-0.07,0.0,0.07,10,0,-10,22,0,-22,0.0,0.0,0.0,0.0,0.0,0.0
hillm001,Marc Hill,St. Louis Cardinals,CARDS,3,4,5,9,1974,1978,4,12.26,2.96,-9.3,1525,327,-1198,1506,603,-903,2919.0,609.0,-2310.0,52000.0,0.0,-52000.0
hillm101,Mack Hillis,New York Yankees,YANKS,1,4,1,5,1926,1937,11,0.0,46.39,46.39,0,1659,1659,0,7068,7068,0.0,0.0,0.0,0.0,0.0,0.0
hillr001,Rich Hill,Oakland Athletics,ATLTCS,1,2,3,5,2016,2019,3,5.89,0.29,-5.6,179,30,-149,293,2,-291,1084.0,475.0,-609.0,0.0,0.0,0.0
hillr001,Rich Hill,Tampa Bay Devil Rays,RAYS,1,1,2,3,2021,2021,0,0.56,0.0,-0.56,26,0,-26,22,0,-22,190.0,0.0,-190.0,2500000.0,100000.0,-2400000.0
hillr101,Red Hill,Philadelphia Athletics,ATLTCS,2,7,4,11,1917,1920,3,0.98,1.52,0.54,143,229,86,582,916,334,0.0,0.0,0.0,2400.0,0.0,-2400.0
hills001,Shawn Hillegas,Los Angeles Dodgers,DOGRS,1,1,1,2,1988,1989,1,1.33,-0.91,-2.24,63,70,7,0,1,1,513.0,107.0,-406.0,78000.0,532500.0,454500.0
hills001,Shawn Hillegas,Chicago White Sox,WSOX,2,3,4,7,1990,1991,1,1.38,-0.4,-1.78,97,56,-41,54,126,72,701.0,15.0,-686.0,1315000.0,700000.0,-615000.0
hills002,Shea Hillenbrand,Boston Red Sox,RSOX,2,3,3,6,2003,2005,2,1.44,1.36,-0.08,371,60,-311,1062,7,-1055,927.0,290.0,-637.0,407500.0,3250000.0,2842500.0
hills002,Shea Hillenbrand,Arizona Diamondbacks,DBACKS,1,1,1,2,2005,2005,0,2.57,0.0,-2.57,233,0,-233,964,0,-964,0.0,0.0,0.0,0.0,0.0,0.0
hills002,Shea Hillenbrand,Toronto Blue Jays,BJAYS,1,2,1,3,2006,2010,4,0.24,1.81,1.57,281,144,-137,251,0,-251,321.0,419.0,98.0,6148500.0,330000.0,-5818500.0
hillt002,Tim Hill,Kansas City Royals,ROYALS,2,5,4,9,2020,2021,1,-0.85,2.05,2.9,223,152,-71,137,580,443,233.0,11.0,-222.0,0.0,0.0,0.0
hinca001,A.J. Hinch,Oakland Athletics,ATLTCS,3,5,7,12,2001,2013,12,4.13,35.82,31.69,847,1285,438,3142,5045,1903,578.0,1155.0,577.0,8550000.0,0.0,-8550000.0
hincb001,Brett Hinchliffe,Anaheim Angels,ANGELS,1,2,3,5,2000,2000,0,0.0,0.0,0.0,0,0,0,0,0,0,0.0,0.0,0.0,0.0,0.0,0.0
hinep101,Paul Hines,Washington Senators,WS8,2,2,4,6,1887,1901,14,0.08,0.0,-0.08,1,0,-1,3,0,-3,0.0,0.0,0.0,0.0,0.0,0.0
hinse001,Eric Hinske,Chicago Cubs,CUBS,1,1,1,2,2001,2001,0,0.0,0.45,0.45,0,66,66,0,147,147,0.0,0.0,0.0,0.0,0.0,0.0
hinse001,Eric Hinske,Oakland Athletics,ATLTCS,3,8,6,14,2001,2003,2,21.78,5.28,-16.5,1503,224,-1279,3041,219,-2822,5533.0,541.0,-4992.0,2433333.0,5053333.0,2620000.0
hinse001,Eric Hinske,Pittsburgh Pirates,PIRATS,1,2,2,4,2009,2012,3,0.01,0.22,0.21,39,16,-23,98,34,-64,0.0,0.0,0.0,1500000.0,0.0,-1500000.0
hintc101,Chuck Hinton,Washington Senators,RNGRS,2,2,3,5,1964,1969,5,3.6,0.12,-3.48,774,273,-501,2102,743,-1359,0.0,0.0,0.0,38500.0,35000.0,-3500.0
hintc101,Chuck Hinton,Cleveland Indians,INDINS,10,15,16,31,1967,1984,17,49.89,15.87,-34.02,3019,3044,25,11154,10708,-446,38.0,317.0,279.0,190250.0,367100.0,176850.0
hintc101,Chuck Hinton,California Angels,ANGELS,1,1,1,2,1969,1969,0,0.84,-0.52,-1.36,289,67,-222,523,148,-375,0.0,0.0,0.0,0.0,0.0,0.0
hintr101,Rich Hinton,Chicago White Sox,WSOX,2,2,2,4,1971,1973,2,-0.52,-0.55,-0.03,14,49,35,3,85,82,50.0,0.0,-50.0,7500.0,16000.0,8500.0
hintr101,Rich Hinton,Texas Rangers,RNGRS,1,2,1,3,1973,1974,1,0.0,1.79,1.79,0,272,272,0,1149,1149,0.0,0.0,0.0,0.0,0.0,0.0
hintr101,Rich Hinton,Chicago White Sox,WSOX,2,3,2,5,1975,1979,4,1.12,4.35,3.23,126,167,41,15,0,-15,323.0,879.0,556.0,0.0,0.0,0.0
hintr101,Rich Hinton,Chicago White Sox,WSOX,1,1,1,2,1979,1979,0,-0.2,0.0,0.2,14,0,-14,0,0,0,60.0,0.0,-60.0,0.0,0.0,0.0
hinzt001,Tommy Hinzo,Cleveland Indians,INDINS,1,2,2,4,1990,1990,0,0.0,0.0,0.0,0,0,0,0,0,0,0.0,0.0,0.0,0.0,0.0,0.0
hirsj001,Jason Hirsh,Houston Astros,ASTROS,1,3,2,5,2006,2007,1,4.59,-0.73,-5.32,489,38,-451,1012,30,-982,873.0,297.0,-576.0,727000.0,4500000.0,3773000.0
hisll101,Larry Hisle,Philadelphia Phillies,PHILS,1,1,1,2,1971,1977,6,0.0,1.12,1.12,0,651,651,0,1410,1410,0.0,0.0,0.0,0.0,0.0,0.0
hisll101,Larry Hisle,Los Angeles Dodgers,DOGRS,1,1,2,3,1972,1972,0,0.0,0.0,0.0,0,0,0,0,0,0,0.0,0.0,0.0,0.0,0.0,0.0
hisll101,Larry Hisle,St. Louis Cardinals,CARDS,4,5,5,10,1972,1977,5,20.99,-1.61,-22.6,875,118,-757,2900,9,-2891,1249.0,251.0,-998.0,47500.0,42500.0,-5000.0
hisnh101,Harley Hisner,Boston Red Sox,RSOX,1,1,1,2,1952,1953,1,0.0,1.46,1.46,0,48,48,0,11,11,0.0,113.0,113.0,0.0,0.0,0.0
hitcb101,Billy Hitchcock,New York Yankees,YANKS,1,1,2,3,1941,1946,5,-1.67,-0.12,1.55,110,211,101,354,687,333,0.0,0.0,0.0,0.0,0.0,0.0
hitcb101,Billy Hitchcock,St.Louis Browns,ORLS,13,24,31,55,1947,1960,13,52.08,29.92,-22.16,3700,3192,-508,8156,7991,-165,9955.0,6124.0,-3831.0,59000.0,72800.0,13800.0
hitcb101,Billy Hitchcock,Boston Red Sox,RSOX,1,1,1,2,1949,1951,2,0.57,0.02,-0.55,311,85,-226,1156,282,-874,0.0,0.0,0.0,0.0,12000.0,12000.0
hitcb101,Billy Hitchcock,Philadelphia Athletics,ATLTCS,1,1,1,2,1953,1953,0,-0.29,-0.03,0.26,22,2,-20,41,1,-40,0.0,0.0,0.0,0.0,0.0,0.0
hitcj101,Jim Hitchcock,Washington Senators,TWINS,1,1,1,2,1938,1938,0,-0.94,0.0,0.94,28,0,-28,79,0,-79,0.0,0.0,0.0,0.0,0.0,0.0
hitcs001,Sterling Hitchcock,New York Yankees,YANKS,2,4,5,9,1995,2001,6,0.27,21.71,21.44,470,1323,853,1674,4002,2328,590.0,1102.0,512.0,234000.0,3400000.0,3166000.0
hitcs001,Sterling Hitchcock,Seattle Mariners,MARNRS,2,4,3,7,1996,1998,2,5.62,-1.45,-7.07,293,63,-230,226,2,-224,2336.0,486.0,-1850.0,1535000.0,1710000.0,175000.0
hitcs001,Sterling Hitchcock,San Diego Padres,PADRS,1,1,2,3,2001,2002,1,-0.41,0.08,0.49,62,14,-48,0,4,4,421.0,70.0,-351.0,6000000.0,0.0,-6000000.0
hitcs001,Sterling Hitchcock,New York Yankees,YANKS,2,2,3,5,2003,2007,4,0.34,0.68,0.34,16,117,101,14,0,-14,114.0,368.0,254.0,6000000.0,0.0,-6000000.0
hittl101,Lloyd Hittle,Oakland,Oakland,1,1,1,2,1949,1949,0,0.65,0.0,-0.65,94,0,-94,45,0,-45,457.0,0.0,-457.0,0.0,9000.0,9000.0
hoagm101,Myril Hoag,New York Yankees,YANKS,2,3,3,6,1938,1944,6,-0.13,2.92,3.05,384,138,-246,1290,241,-1049,3.0,438.0,435.0,17000.0,6000.0,-11000.0
hoakd101,Don Hoak,Brooklyn Dodgers,DOGRS,2,4,4,8,1955,1961,6,18.38,2.09,-16.29,1649,196,-1453,2986,562,-2424,2426.0,26.0,-2400.0,0.0,0.0,0.0
hoakd101,Don Hoak,Chicago Cubs,CUBS,2,5,4,9,1956,1958,2,7.54,-1.1,-8.64,773,105,-668,2296,34,-2262,130.0,197.0,67.0,0.0,0.0,0.0
hoakd101,Don Hoak,Cincinnati Reds,REDS,4,7,11,18,1959,1965,6,63.65,9.6,-54.05,3136,1073,-2063,9911,1717,-8194,2563.0,935.0,-1628.0,0.0,0.0,0.0
hoakd101,Don Hoak,Pittsburgh Pirates,PIRATS,7,11,13,24,1962,1973,11,0.24,-0.26,-0.5,202,126,-76,599,202,-397,16.0,36.0,20.0,17500.0,0.0,-17500.0
hobae101,Ed Hobaugh,Pittsburgh Pirates,PIRATS,1,1,1,2,1969,1969,0,0.0,0.0,0.0,0,0,0,0,0,0,0.0,0.0,0.0,0.0,0.0,0.0
hobbg101,Glen Hobbie,St. Louis Cardinals,CARDS,1,2,1,3,1965,1965,0,0.0,0.0,0.0,0,0,0,0,0,0,0.0,0.0,0.0,0.0,0.0,0.0
hobbg101,Glen Hobbie,Chicago Cubs,CUBS,1,2,2,4,1964,1965,1,0.14,0.31,0.17,26,71,45,14,56,42,133.0,454.0,321.0,0.0,0.0,0.0
hobsb101,Butch Hobson,Boston Red Sox,RSOX,3,6,6,12,1980,1989,9,34.32,7.26,-27.06,1836,1801,-35,6677,5369,-1308,547.0,1201.0,654.0,1020000.0,523333.0,-496667.0
hobsb101,Butch Hobson,California Angels,ANGELS,1,1,1,2,1982,1982,0,-0.81,0.0,0.81,30,0,-30,60,0,-60,0.0,0.0,0.0,0.0,0.0,0.0
hocke101,Ed Hock,Pittsburgh Pirates,PIRATS,2,3,2,5,1924,1927,3,0.0,3.69,3.69,0,275,275,0,284,284,0.0,1850.0,1850.0,11200.0,0.0,-11200.0
hocko101,Oris Hockett,Cleveland Indians,INDINS,1,1,1,2,1944,1946,2,1.66,-0.29,-1.95,106,32,-74,449,76,-373,0.0,6.0,6.0,7500.0,6000.0,-1500.0
hodaj101,Johnny Hodapp,Cleveland Indians,INDINS,2,3,3,6,1932,1938,6,-0.54,9.51,10.05,286,513,227,1117,1176,59,0.0,1369.0,1369.0,22500.0,11500.0,-11000.0
hodaj101,Johnny Hodapp,Chicago White Sox,WSOX,2,7,3,10,1932,1936,4,0.81,-0.11,-0.92,234,49,-185,748,93,-655,0.0,39.0,39.0,8600.0,12500.0,3900.0
hodem101,Mel Hoderlein,Boston Red Sox,RSOX,4,10,9,19,1951,1956,5,13.39,14.14,0.75,1557,1085,-472,4986,3287,-1699,2205.0,1545.0,-660.0,102000.0,52000.0,-50000.0
hodem101,Mel Hoderlein,Chicago White Sox,WSOX,23,43,38,81,1952,1969,17,54.0,56.53,2.53,5273,4792,-481,13898,10899,-2999,7275.0,8147.0,872.0,226750.0,240000.0,13250.0
hodem101,Mel Hoderlein,Washington Senators,TWINS,1,1,1,2,1954,1954,0,0.0,-0.31,-0.31,0,49,49,0,171,171,0.0,0.0,0.0,0.0,15000.0,15000.0
hodgg101,Gil Hodges,New York Mets,METS,1,1,1,2,1963,1963,0,0.0,-1.02,-1.02,0,40,40,0,140,140,0.0,0.0,0.0,0.0,0.0,0.0
hodgg101,Gil Hodges,Washington Senators,RNGRS,2,3,3,6,1967,1970,3,0.0,1.46,1.46,0,173,173,0,535,535,0.0,6.0,6.0,0.0,8000.0,8000.0
hodgk001,Kevin Hodges,Houston Astros,ASTROS,1,1,1,2,1999,2000,1,0.05,-0.77,-0.82,13,116,103,0,207,207,52.0,0.0,-52.0,0.0,500000.0,500000.0
hodgs101,Shovel Hodge,Chicago White Sox,WSOX,2,5,2,7,1922,1931,9,8.34,28.43,20.09,522,1292,770,2094,5360,3266,0.0,0.0,0.0,22100.0,10000.0,-12100.0
hoefb101,Billy Hoeft,Detroit Tigers,TIGRS,6,10,9,19,1959,1967,8,4.03,3.78,-0.25,736,1035,299,2273,1950,-323,175.0,1285.0,1110.0,38000.0,48000.0,10000.0
hoefb101,Billy Hoeft,Boston Red Sox,RSOX,1,1,1,2,1959,1959,0,3.64,-0.28,-3.92,254,17,-237,85,11,-74,934.0,74.0,-860.0,0.0,0.0,0.0
hoefb101,Billy Hoeft,Baltimore Orioles,ORLS,11,25,25,50,1962,1988,26,22.28,92.11,69.83,2229,4677,2448,3893,9050,5157,9525.0,13707.0,4182.0,725833.0,57000.0,-668833.0
hoefb101,Billy Hoeft,San Francisco Giants,GIANTS,8,14,12,26,1963,1972,9,20.6,12.56,-8.04,1709,1303,-406,5210,1731,-3479,1169.0,4789.0,3620.0,50000.0,89000.0,39000.0
hoela101,Art Hoelskoetter,Cincinnati Reds,REDS,1,2,1,3,1909,1909,0,0.0,-0.02,-0.02,0,56,56,0,162,162,0.0,0.0,0.0,0.0,0.0,0.0
hoerj101,Joe Hoerner,St. Louis Cardinals,CARDS,26,53,46,99,1969,1994,25,115.3,156.23,40.93,11163,7909,-3254,30164,26894,-3270,12224.0,4453.0,-7771.0,3323333.0,942667.0,-2380666.0
hoerj101,Joe Hoerner,Philadelphia Phillies,PHILS,1,2,2,4,1972,1973,1,-1.32,-1.5,-0.18,90,36,-54,4,15,11,108.0,168.0,60.0,0.0,0.0,0.0
hoesl001,L.J. Hoes,Baltimore Orioles,ORLS,1,3,1,4,2013,2015,2,0.01,0.61,0.6,109,65,-44,333,11,-322,0.0,847.0,847.0,0.0,0.0,0.0
hoeyj001,Jim Hoey,Baltimore Orioles,ORLS,1,2,2,4,2010,2017,7,-0.62,15.73,16.35,27,889,862,0,3636,3636,74.0,0.0,-74.0,0.0,6550000.0,6550000.0
hoffd101,Danny Hoffman,Philadelphia Athletics,ATLTCS,1,1,1,2,1906,1906,0,1.47,0.0,-1.47,236,0,-236,936,0,-936,0.0,0.0,0.0,0.0,0.0,0.0
hoffd101,Danny Hoffman,New York Yankees,YANKS,3,6,6,12,1907,1911,4,37.76,7.87,-29.89,2601,491,-2110,10473,2011,-8462,0.0,0.0,0.0,0.0,0.0,0.0
hoffg001,Glenn Hoffman,Boston Red Sox,RSOX,1,1,1,2,1987,1987,0,-0.25,0.0,0.25,40,0,-40,146,0,-146,0.0,0.0,0.0,300000.0,0.0,-300000.0
hoffg002,Guy Hoffman,Chicago Cubs,CUBS,2,2,3,5,1987,1988,1,0.82,-0.21,-1.03,92,11,-81,78,34,-44,476.0,0.0,-476.0,0.0,0.0,0.0
hoffj001,Jamie Hoffmann,Washington Nationals,NATEX,1,1,1,2,2009,2010,1,0.0,-0.85,-0.85,0,38,38,0,0,0,0.0,53.0,53.0,0.0,1250000.0,1250000.0
hoffj003,Jeff Hoffman,Toronto Blue Jays,BJAYS,1,4,2,6,2015,2018,3,-2.36,5.17,7.53,267,257,-10,284,987,703,875.0,49.0,-826.0,0.0,0.0,0.0
hoffj003,Jeff Hoffman,Colorado Rockies,ROCKS,1,2,2,4,2020,2020,0,1.03,0.0,-1.03,61,0,-61,16,0,-16,219.0,0.0,-219.0,0.0,0.0,0.0
hoffj104,John Hoffman,Houston Astros,ASTROS,1,3,3,6,1966,1968,2,0.0,-0.84,-0.84,0,120,120,0,7,7,0.0,229.0,229.0,0.0,0.0,0.0
hoffr101,Ray Hoffman,Washington Senators,TWINS,1,2,1,3,1943,1949,6,0.0,16.6,16.6,0,431,431,0,473,473,0.0,3875.0,3875.0,0.0,0.0,0.0
hoffs101,Stew Hofferth,Boston Braves,BRAVES,5,8,7,15,1946,1952,6,-0.23,27.12,27.35,358,923,565,547,3529,2982,596.0,210.0,-386.0,0.0,20000.0,20000.0
hofft001,Trevor Hoffman,Florida Marlins,MARLNS,16,36,40,76,1993,2019,26,141.98,107.88,-34.1,6566,6100,-466,15461,18577,3116,13532.0,10298.0,-3234.0,68689667.0,39069968.0,-29619699.0
hofmf101,Fred Hofmann,New York Yankees,YANKS,2,6,4,10,1925,1931,6,-1.14,6.67,7.81,271,713,442,761,2895,2134,731.0,97.0,-634.0,31500.0,18000.0,-13500.0
hofmf101,Fred Hofmann,StPaul,StPaul,5,7,11,18,1926,1930,4,0.96,0.0,-0.96,661,0,-661,1974,0,-1974,611.0,0.0,-611.0,0.0,43750.0,43750.0
hofms101,Solly Hofman,Chicago Cubs,CUBS,1,2,2,4,1912,1915,3,-1.23,9.99,11.22,69,392,323,172,1573,1401,147.0,212.0,65.0,7400.0,5000.0,-2400.0
hogas101,Shanty Hogan,Boston Braves,BRAVES,14,32,26,58,1928,1952,24,61.82,116.64,54.82,3287,6047,2760,11058,20048,8990,3053.0,10767.0,7714.0,50600.0,31000.0,-19600.0
hogas101,Shanty Hogan,Washington Senators,TWINS,1,1,1,2,1937,1948,11,0.0,-0.01,-0.01,0,8,8,0,28,28,0.0,0.0,0.0,0.0,0.0,0.0
hoggb102,Brad Hogg,Boston Braves,BRAVES,3,5,8,13,1912,1927,15,12.92,47.85,34.93,874,2487,1613,3700,10349,6649,87.0,0.0,-87.0,6600.0,17500.0,10900.0
hogsc101,Chief Hogsett,Detroit Tigers,TIGRS,1,1,1,2,1936,1936,0,1.4,0.34,-1.06,159,138,-21,143,648,505,1178.0,0.0,-1178.0,6500.0,6000.0,-500.0
hogsc101,Chief Hogsett,St.Louis Browns,ORLS,1,1,1,2,1937,1937,0,-0.62,0.0,0.62,63,0,-63,25,0,-25,273.0,0.0,-273.0,7500.0,4500.0,-3000.0
hogub101,Bobby Hogue,St.Louis Browns,ORLS,18,45,42,87,1951,1988,37,51.78,138.85,87.07,4039,8046,4007,7629,22393,14764,14591.0,15253.0,662.0,829333.0,135900.0,-693433.0
hohmb101,Bill Hohman,Philadelphia Phillies,PHILS,1,3,1,4,1928,1928,0,0.0,1.31,1.31,0,96,96,0,292,292,0.0,0.0,0.0,0.0,0.0,0.0
hoilc001,Chris Hoiles,Detroit Tigers,TIGRS,1,3,1,4,1988,1989,1,23.49,1.15,-22.34,894,144,-750,3339,504,-2835,0.0,0.0,0.0,0.0,1540000.0,1540000.0
holab001,Bryan Holaday,Detroit Tigers,TIGRS,2,2,3,5,2016,2018,2,0.0,-1.52,-1.52,72,42,-30,235,15,-220,4.0,247.0,243.0,0.0,0.0,0.0
holba001,Aaron Holbert,Boston Red Sox,RSOX,1,1,1,2,2000,2001,1,0.0,0.0,0.0,0,0,0,0,0,0,0.0,0.0,0.0,0.0,0.0,0.0
holbr001,Ray Holbert,San Diego Padres,PADRS,2,2,2,4,1995,1996,1,-0.24,0.0,0.24,10,0,-10,0,0,0,21.0,0.0,-21.0,115000.0,284000.0,169000.0
holdb101,Bill Holden,New York Yankees,YANKS,1,2,1,3,1914,1914,0,0.0,2.96,2.96,0,77,77,0,321,321,0.0,0.0,0.0,0.0,0.0,0.0
holdd001,David Holdridge,California Angels,ANGELS,1,1,1,2,1988,1992,4,0.0,7.6,7.6,0,400,400,0,1540,1540,0.0,0.0,0.0,0.0,1000000.0,1000000.0
holdf101,Fred Holdsworth,Detroit Tigers,TIGRS,1,1,1,2,1975,1975,0,0.82,0.06,-0.76,28,21,-7,0,0,0,162.0,104.0,-58.0,0.0,0.0,0.0
holdf101,Fred Holdsworth,Baltimore Orioles,ORLS,2,2,2,4,1977,1979,2,-0.24,0.0,0.24,50,0,-50,15,0,-15,195.0,0.0,-195.0,0.0,0.0,0.0
holkw101,Walter Holke,New York Giants,GIANTS,1,2,1,3,1919,1919,0,0.24,1.26,1.02,178,110,-68,609,443,-166,0.0,0.0,0.0,0.0,0.0,0.0
holkw101,Walter Holke,Cincinnati Reds,REDS,1,1,2,3,1919,1921,2,-0.18,0.38,0.56,536,28,-508,2218,48,-2170,0.0,0.0,0.0,0.0,0.0,0.0
holla001,Al Holland,Pittsburgh Pirates,PIRATS,2,4,6,10,1979,1990,11,17.64,30.66,13.02,910,2106,1196,973,7523,6550,3555.0,123.0,-3432.0,975500.0,260000.0,-715500.0
holla001,Al Holland,San Francisco Giants,GIANTS,6,13,17,30,1982,1998,16,28.77,47.69,18.92,1714,2984,1270,1934,3957,2023,4662.0,9275.0,4613.0,10227778.0,6966667.0,-3261111.0
holla001,Al Holland,Philadelphia Phillies,PHILS,1,2,1,3,1985,1988,3,1.2,7.16,5.96,76,582,506,7,14,7,176.0,1102.0,926.0,0.0,830000.0,830000.0
holla001,Al Holland,Pittsburgh Pirates,PIRATS,2,6,6,12,1985,1992,7,9.22,21.92,12.7,518,1417,899,680,1274,594,2669.0,7059.0,4390.0,1030000.0,180000.0,-850000.0
holla101,Al Hollingsworth,Cincinnati Reds,REDS,1,3,1,4,1938,1948,10,2.9,43.86,40.96,235,653,418,553,968,415,703.0,7065.0,6362.0,0.0,0.0,0.0
holla101,Al Hollingsworth,Philadelphia Phillies,PHILS,1,1,1,2,1939,1940,1,0.0,-0.77,-0.77,0,66,66,0,267,267,0.0,0.0,0.0,5500.0,0.0,-5500.0
hollb101,Bobo Holloman,Syracuse,Syracuse,1,1,2,3,1952,1952,0,-0.02,0.0,0.02,44,0,-44,22,0,-22,196.0,0.0,-196.0,0.0,0.0,0.0
hollb102,Bonnie Hollingsworth,Washington Senators,TWINS,2,4,2,6,1923,1927,4,-0.1,-0.15,-0.05,6,6,0,3,9,6,26.0,0.0,-26.0,2800.0,6000.0,3200.0
hollb102,Bonnie Hollingsworth,Brooklyn Dodgers,DOGRS,3,9,3,12,1926,1934,8,0.53,8.67,8.14,100,822,722,99,3036,2937,677.0,0.0,-677.0,30000.0,12000.0,-18000.0
hollb102,Bonnie Hollingsworth,Buffalo,Buffalo,1,1,3,4,1928,1929,1,-0.51,0.0,0.51,14,0,-14,6,0,-6,65.0,0.0,-65.0,0.0,10080.0,10080.0
hollb102,Bonnie Hollingsworth,Pittsburgh Pirates,PIRATS,1,2,1,3,1922,1922,0,0.0,2.68,2.68,0,60,60,0,250,250,0.0,0.0,0.0,3000.0,0.0,-3000.0
hollc102,Carl Holling,Detroit Tigers,TIGRS,2,6,3,9,1922,1928,6,20.71,4.6,-16.11,377,336,-41,782,333,-449,2967.0,2739.0,-228.0,8000.0,13500.0,5500.0
holld001,Dave Hollins,Philadelphia Phillies,PHILS,1,1,1,2,1995,1996,1,0.03,3.11,3.08,5,120,115,17,461,444,0.0,0.0,0.0,2000000.0,1638268.0,-361732.0
holld001,Dave Hollins,Minnesota Twins,TWINS,1,1,1,2,1996,2002,6,1.11,2.59,1.48,28,455,427,113,1693,1580,0.0,0.0,0.0,1350000.0,0.0,-1350000.0
holld001,Dave Hollins,Anaheim Angels,ANGELS,1,2,1,3,1999,1999,0,-0.47,0.0,0.47,27,0,-27,104,0,-104,0.0,0.0,0.0,0.0,0.0,0.0
holld002,Damon Hollins,Atlanta Braves,BRAVES,1,1,1,2,1998,1998,0,-0.14,0.0,0.14,5,0,-5,9,0,-9,0.0,0.0,0.0,0.0,0.0,0.0
holld003,Derek Holland,San Francisco Giants,GIANTS,1,2,1,3,2019,2019,0,-0.25,0.0,0.25,40,0,-40,3,0,-3,47.0,0.0,-47.0,6500000.0,0.0,-6500000.0
holld101,Dutch Holland,Boston Braves,BRAVES,2,5,2,7,1933,1940,7,0.0,7.42,7.42,0,397,397,0,764,764,0.0,2031.0,2031.0,0.0,0.0,0.0
hollg101,Gary Holle,Milwaukee Brewers,BREWRS,1,3,1,4,1978,1982,4,-0.15,-1.81,-1.66,16,109,93,7,0,-7,99.0,822.0,723.0,0.0,0.0,0.0
hollg101,Gary Holle,Texas Rangers,RNGRS,2,3,4,7,1979,1979,0,4.47,0.48,-3.99,245,63,-182,304,166,-138,701.0,0.0,-701.0,35000.0,0.0,-35000.0
hollg101,Gary Holle,Chicago White Sox,WSOX,1,2,1,3,1981,2007,26,0.0,0.0,0.0,0,0,0,0,0,0,0.0,0.0,0.0,0.0,0.0,0.0
hollj102,Jeff Holly,Minnesota Twins,TWINS,1,1,1,2,1979,1982,3,0.0,1.41,1.41,0,50,50,0,0,0,0.0,703.0,703.0,0.0,0.0,0.0
hollk101,Ken Holloway,Detroit Tigers,TIGRS,1,2,1,3,1928,1933,5,1.66,19.39,17.73,166,319,153,343,408,65,447.0,2479.0,2032.0,0.0,0.0,0.0
hollk101,Ken Holloway,New York Yankees,YANKS,1,3,2,5,1930,1943,13,0.0,-0.48,-0.48,0,34,34,0,24,24,0.0,173.0,173.0,6500.0,0.0,-6500.0
hollm001,Matt Holliday,Colorado Rockies,ROCKS,2,3,4,7,2008,2018,10,6.78,26.57,19.79,346,1598,1252,400,5087,4687,386.0,619.0,233.0,16800000.0,3300000.0,-13500000.0
hollm001,Matt Holliday,Oakland Athletics,ATLTCS,5,5,7,12,2009,2014,5,23.49,-1.87,-25.36,1024,74,-950,4169,228,-3941,175.0,101.0,-74.0,13500000.0,419000.0,-13081000.0
hollt001,Todd Hollandsworth,Los Angeles Dodgers,DOGRS,1,3,2,5,2000,2002,2,3.81,0.2,-3.61,184,161,-23,631,541,-90,0.0,0.0,0.0,1450000.0,3416667.0,1966667.0
hollt001,Todd Hollandsworth,Colorado Rockies,ROCKS,2,3,4,7,2002,2003,1,-0.86,0.5,1.36,91,99,8,186,247,61,127.0,0.0,-127.0,3650000.0,1850000.0,-1800000.0
hollt001,Todd Hollandsworth,Chicago Cubs,CUBS,1,1,2,3,2005,2005,0,-0.14,0.0,0.14,24,0,-24,40,0,-40,0.0,0.0,0.0,900000.0,0.0,-900000.0
holmb001,Brian Holman,Montreal Expos,NATEX,2,4,3,7,1989,1990,1,45.42,4.9,-40.52,412,48,-364,8,66,58,7430.0,530.0,-6900.0,138000.0,1350000.0,1212000.0
holmc001,Clay Holmes,Pittsburgh Pirates,PIRATS,1,1,2,3,2021,2021,0,1.27,-0.22,-1.49,30,44,14,0,149,149,84.0,0.0,-84.0,0.0,0.0,0.0
holmd001,Darren Holmes,Los Angeles Dodgers,DOGRS,1,1,1,2,1990,1991,1,0.9,0.0,-0.9,81,0,-81,0,0,0,356.0,0.0,-356.0,0.0,0.0,0.0
holmd001,Darren Holmes,New York Yankees,YANKS,6,9,8,17,1999,2007,8,-0.49,1.43,1.92,152,223,71,86,143,57,355.0,822.0,467.0,6000000.0,7500000.0,1500000.0
holmd002,David Holmberg,Chicago White Sox,WSOX,5,8,8,16,2010,2016,6,2.25,4.26,2.01,475,264,-211,194,348,154,1677.0,1215.0,-462.0,13500000.0,8100000.0,-5400000.0
holmd002,David Holmberg,Arizona Diamondbacks,DBACKS,1,3,2,5,2013,2013,0,-0.83,0.0,0.83,25,0,-25,19,0,-19,175.0,0.0,-175.0,9000000.0,0.0,-9000000.0
holmd101,Ducky Holmes,New York Giants,GIANTS,1,3,2,5,1897,1903,6,-0.53,7.63,8.16,24,437,413,105,1697,1592,0.0,0.0,0.0,0.0,0.0,0.0
holmd101,Ducky Holmes,St. Louis Cardinals,CARDS,1,2,2,4,1898,1899,1,4.06,2.38,-1.68,251,246,-5,1106,1032,-74,0.0,0.0,0.0,0.0,0.0,0.0
holmd101,Ducky Holmes,Washington Senators,TWINS,1,1,1,2,1903,1904,1,3.7,-0.88,-4.58,246,53,-193,1041,69,-972,0.0,548.0,548.0,0.0,0.0,0.0
holmd101,Ducky Holmes,Louisville Colonels,LS3,1,1,1,2,1897,1899,2,-0.53,1.74,2.27,80,162,82,338,693,355,0.0,0.0,0.0,0.0,0.0,0.0
holms001,Shawn Holman,Pittsburgh Pirates,PIRATS,1,2,1,3,1987,1987,0,0.26,-0.14,-0.4,5,36,31,0,73,73,30.0,0.0,-30.0,0.0,425000.0,425000.0
holmt101,Tommy Holmes,New York Yankees,YANKS,1,1,2,3,1941,1946,5,36.09,1.7,-34.39,1289,132,-1157,5523,581,-4942,0.0,0.0,0.0,0.0,7500.0,7500.0
holsh101,Herm Holshouser,Baltimore,Baltimore,1,1,1,2,1929,1937,8,-1.15,0.0,1.15,50,0,-50,20,0,-20,187.0,0.0,-187.0,0.0,5500.0,5500.0
holsh101,Herm Holshouser,St.Louis Browns,ORLS,1,4,1,5,1930,1932,2,0.0,-0.31,-0.31,0,16,16,0,36,36,0.0,0.0,0.0,10000.0,0.0,-10000.0
holtb001,Brian Holton,Los Angeles Dodgers,DOGRS,1,3,1,4,1988,1991,3,-1.54,8.44,9.98,185,468,283,229,1974,1745,523.0,0.0,-523.0,305000.0,2142904.0,1837904.0
holtb002,Brock Holt,Pittsburgh Pirates,PIRATS,3,5,7,12,2012,2020,8,8.64,9.38,0.74,750,717,-33,2244,6,-2238,477.0,1130.0,653.0,4100000.0,1721000.0,-2379000.0
holtc001,Chris Holt,Houston Astros,ASTROS,2,4,4,8,2000,2008,8,0.51,2.1,1.59,210,1212,1002,625,3536,2911,615.0,482.0,-133.0,4015000.0,5550000.0,1535000.0
holtj101,Jim Holt,Minnesota Twins,TWINS,4,4,6,10,1974,1982,8,3.99,8.12,4.13,544,1131,587,1693,4095,2402,0.0,0.0,0.0,285000.0,17500.0,-267500.0
holtk101,Ken Holtzman,Chicago Cubs,CUBS,7,10,15,25,1971,1996,25,34.49,106.79,72.3,2649,5222,2573,6342,21133,14791,5589.0,1723.0,-3866.0,56500.0,30000.0,-26500.0
holtk101,Ken Holtzman,Oakland Athletics,ATLTCS,2,4,6,10,1976,1978,2,9.34,5.62,-3.72,178,460,282,558,1294,736,944.0,1423.0,479.0,100000.0,0.0,-100000.0
holtk101,Ken Holtzman,Baltimore Orioles,ORLS,4,12,12,24,1976,1988,12,17.24,67.8,50.56,919,3227,2308,801,6729,5928,6521.0,11016.0,4495.0,558333.0,0.0,-558333.0
holtk101,Ken Holtzman,New York Yankees,YANKS,11,17,18,35,1978,1997,19,48.85,26.58,-22.27,2840,1568,-1272,5792,2838,-2954,8219.0,4891.0,-3328.0,4415000.0,2812500.0,-1602500.0
holtr101,Roger Holt,New York Yankees,YANKS,1,1,2,3,1980,1982,2,0.0,-0.01,-0.01,0,3,3,0,0,0,0.0,0.0,0.0,0.0,0.0,0.0
honer001,Rick Honeycutt,Pittsburgh Pirates,PIRATS,1,1,1,2,1977,1977,0,5.34,0.09,-5.25,99,2,-97,0,0,0,1682.0,9.0,-1673.0,0.0,0.0,0.0
honer001,Rick Honeycutt,Seattle Mariners,MARNRS,2,7,7,14,1980,1985,5,8.79,3.61,-5.18,489,434,-55,632,1358,726,2623.0,1017.0,-1606.0,175000.0,512500.0,337500.0
honer001,Rick Honeycutt,Texas Rangers,RNGRS,3,4,5,9,1983,1987,4,5.59,2.54,-3.05,281,142,-139,223,0,-223,2004.0,1285.0,-719.0,505000.0,156000.0,-349000.0
honer001,Rick Honeycutt,Los Angeles Dodgers,DOGRS,4,5,5,10,1987,1994,7,8.28,13.2,4.92,571,518,-53,366,1015,649,2339.0,2550.0,211.0,3705000.0,3708000.0,3000.0
hoodd101,Don Hood,Baltimore Orioles,ORLS,2,3,3,6,1975,1980,5,6.5,4.24,-2.26,389,566,177,845,1795,950,1484.0,0.0,-1484.0,0.0,0.0,0.0
hoodd101,Don Hood,Cleveland Indians,INDINS,2,2,3,5,1979,1983,4,1.25,1.33,0.08,95,171,76,227,541,314,202.0,0.0,-202.0,0.0,0.0,0.0
hoodw102,Wally Hood,New York Yankees,YANKS,2,6,2,8,1952,1955,3,5.35,0.58,-4.77,390,36,-354,1419,15,-1404,46.0,152.0,106.0,0.0,13500.0,13500.0
hookc001,Chris Hook,Cincinnati Reds,REDS,1,2,1,3,1994,1994,0,-1.17,0.0,1.17,110,0,-110,5,0,-5,197.0,0.0,-197.0,0.0,0.0,0.0
hookj101,Jay Hook,New York Mets,METS,1,2,1,3,1964,1966,2,-0.08,0.23,0.31,4,346,342,3,1225,1222,0.0,0.0,0.0,14000.0,0.0,-14000.0
hoopb101,Bob Hooper,Philadelphia Athletics,ATLTCS,52,120,132,252,1952,1976,24,220.07,117.92,-102.15,18021,16284,-1737,45492,48059,2567,21505.0,17498.0,-4007.0,571100.0,842400.0,271300.0
hooph101,Harry Hooper,Boston Red Sox,RSOX,1,1,2,3,1921,1925,4,14.84,-2.09,-16.93,662,680,18,2921,2600,-321,0.0,0.0,0.0,0.0,0.0,0.0
hootb001,Burt Hooton,Chicago Cubs,CUBS,2,2,3,5,1975,1977,2,25.57,-0.43,-26.0,697,68,-629,681,26,-655,5695.0,258.0,-5437.0,0.0,0.0,0.0
hoovd101,Dick Hoover,New York Giants,GIANTS,1,3,1,4,1948,1955,7,0.0,5.49,5.49,0,517,517,0,1993,1993,0.0,0.0,0.0,0.0,0.0,0.0
hoovj001,John Hoover,Baltimore Orioles,ORLS,2,4,3,7,1988,1990,2,0.11,0.05,-0.06,10,54,44,0,0,0,21.0,802.0,781.0,335000.0,0.0,-335000.0
hoovj002,J.J. Hoover,Atlanta Braves,BRAVES,2,2,2,4,2012,2013,1,-0.01,0.47,0.48,542,128,-414,271,320,49,727.0,0.0,-727.0,496250.0,0.0,-496250.0
hopkg101,Gail Hopkins,Chicago White Sox,WSOX,2,3,3,6,1970,1977,7,5.23,5.15,-0.08,607,692,85,1743,2721,978,0.0,0.0,0.0,15000.0,26000.0,11000.0
hopkm102,Marty Hopkins,StPaul,StPaul,1,1,3,4,1933,1934,1,-0.13,0.0,0.13,10,0,-10,32,0,-32,0.0,0.0,0.0,0.0,0.0,0.0
hoppj102,Johnny Hopp,St. Louis Cardinals,CARDS,2,2,6,8,1946,1946,0,33.57,0.0,-33.57,1180,0,-1180,5203,0,-5203,0.0,0.0,0.0,0.0,7000.0,7000.0
hoppj102,Johnny Hopp,Boston Braves,BRAVES,3,8,5,13,1947,1952,5,11.92,5.66,-6.26,840,490,-350,2908,1370,-1538,0.0,414.0,414.0,0.0,0.0,0.0
hoppj102,Johnny Hopp,Pittsburgh Pirates,PIRATS,1,2,1,3,1949,1949,0,-0.35,0.16,0.51,8,11,3,14,37,23,0.0,0.0,0.0,0.0,0.0,0.0
hoppn001,Norris Hopper,Cincinnati Reds,REDS,1,1,1,2,2009,2014,5,0.0,0.57,0.57,0,70,70,0,189,189,0.0,0.0,0.0,0.0,450000.0,450000.0
horgj001,Joe Horgan,St. Louis Cardinals,CARDS,1,1,1,2,2004,2004,0,-0.23,0.0,0.23,108,0,-108,4,0,-4,138.0,0.0,-138.0,0.0,0.0,0.0
hornr101,Rogers Hornsby,St. Louis Cardinals,CARDS,2,3,5,8,1926,1928,2,9.03,-0.55,-9.58,290,26,-264,876,8,-868,529.0,99.0,-430.0,43300.0,32850.0,-10450.0
hornr101,Rogers Hornsby,New York Giants,GIANTS,3,4,4,8,1928,1932,4,11.68,8.72,-2.96,421,964,543,1650,3531,1881,0.0,0.0,0.0,0.0,7000.0,7000.0
hornr101,Rogers Hornsby,Boston Braves,BRAVES,13,30,25,55,1928,1952,24,51.23,107.73,56.5,2507,5907,3400,8176,19427,11251,3053.0,10767.0,7714.0,50600.0,31000.0,-19600.0
horsj001,Jeremy Horst,Cincinnati Reds,REDS,1,1,1,2,2012,2012,0,0.43,-1.68,-2.11,118,77,-41,0,208,208,172.0,0.0,-172.0,0.0,0.0,0.0
horso101,Oscar Horstmann,LosAngeles,LosAngeles,1,1,2,3,1916,1916,0,-1.81,0.0,1.81,100,0,-100,58,0,-58,526.0,0.0,-526.0,0.0,3700.0,3700.0
horte101,Elmer Horton,Pittsburgh Pirates,PIRATS,1,4,2,6,1896,1898,2,3.6,0.48,-3.12,234,186,-48,984,763,-221,0.0,0.0,0.0,0.0,0.0,0.0
hortr001,Ricky Horton,St. Louis Cardinals,CARDS,1,3,1,4,1988,1992,4,20.88,6.84,-14.04,997,319,-678,3820,320,-3500,328.0,2753.0,2425.0,0.0,0.0,0.0
hortr001,Ricky Horton,Chicago White Sox,WSOX,3,4,5,9,1988,1991,3,0.47,0.93,0.46,167,119,-48,55,126,71,808.0,528.0,-280.0,1847500.0,778000.0,-1069500.0
hortt101,Tony Horton,Boston Red Sox,RSOX,1,2,1,3,1967,1968,1,7.67,2.77,-4.9,564,128,-436,2155,127,-2028,0.0,1094.0,1094.0,17000.0,24000.0,7000.0
hortw101,Willie Horton,Detroit Tigers,TIGRS,1,1,1,2,1977,1978,1,0.95,1.94,0.99,139,68,-71,569,0,-569,0.0,335.0,335.0,105000.0,0.0,-105000.0
hortw101,Willie Horton,Texas Rangers,RNGRS,1,2,2,4,1978,1978,0,0.81,0.78,-0.03,88,77,-11,186,217,31,597.0,0.0,-597.0,0.0,0.0,0.0
hortw101,Willie Horton,Oakland Athletics,ATLTCS,1,2,1,3,1978,1978,0,-2.52,1.35,3.87,64,41,-23,127,163,36,519.0,0.0,-519.0,0.0,0.0,0.0
hortw101,Willie Horton,Seattle Mariners,MARNRS,2,7,7,14,1980,1985,5,8.79,3.61,-5.18,489,434,-55,632,1358,726,2623.0,1017.0,-1606.0,175000.0,512500.0,337500.0
hosed001,Dwayne Hosey,Boston Red Sox,RSOX,5,9,9,18,1996,2000,4,9.7,3.32,-6.38,608,447,-161,1634,946,-688,1320.0,379.0,-941.0,7038500.0,823500.0,-6215000.0
hoses001,Steve Hosey,San Francisco Giants,GIANTS,1,1,1,2,1994,1994,0,0.0,0.0,0.0,0,0,0,0,0,0,0.0,0.0,0.0,0.0,0.0,0.0
hoslt101,Tim Hosley,Detroit Tigers,TIGRS,1,1,1,2,1973,1973,0,0.1,0.0,-0.1,131,0,-131,233,0,-233,0.0,0.0,0.0,0.0,0.0,0.0
hostd001,Dave Hostetler,Montreal Expos,NATEX,4,6,6,12,1982,1992,10,4.42,9.75,5.33,1501,1079,-422,5161,3321,-1840,201.0,164.0,-37.0,415000.0,210000.0,-205000.0
hostd001,Dave Hostetler,Texas Rangers,RNGRS,1,1,1,2,1984,1985,1,0.0,0.73,0.73,0,25,25,0,0,0,0.0,229.0,229.0,0.0,0.0,0.0
hostg101,Gene Host,Detroit Tigers,TIGRS,4,10,9,19,1956,1961,5,13.15,0.77,-12.38,602,579,-23,394,1616,1222,3228.0,40.0,-3188.0,13200.0,0.0,-13200.0
hottk101,Ken Hottman,Chicago White Sox,WSOX,4,6,5,11,1974,1979,5,12.32,6.24,-6.08,561,692,131,1607,2532,925,1417.0,174.0,-1243.0,0.0,114500.0,114500.0
hottt001,Tommy Hottovy,Kansas City Royals,ROYALS,1,1,1,2,2012,2013,1,0.0,0.0,0.0,0,0,0,0,0,0,0.0,0.0,0.0,0.0,0.0,0.0
housa001,Adrian Houser,Houston Astros,ASTROS,1,4,3,7,2015,2017,2,18.89,0.28,-18.61,984,198,-786,1471,487,-984,1823.0,1153.0,-670.0,0.0,512500.0,512500.0
housc001,Craig House,Colorado Rockies,ROCKS,1,3,3,6,2002,2002,0,0.0,0.1,0.1,0,193,193,0,708,708,0.0,3.0,3.0,0.0,0.0,0.0
housf103,Frank House,Detroit Tigers,TIGRS,4,12,12,24,1957,1964,7,6.47,14.38,7.91,1197,947,-250,3186,1303,-1883,1459.0,3692.0,2233.0,20000.0,9000.0,-11000.0
housf103,Frank House,Kansas City Athletics,ATLTCS,1,1,1,2,1959,1959,0,-0.26,0.0,0.26,23,0,-23,28,0,-28,0.0,0.0,0.0,14000.0,10000.0,-4000.0
housf103,Frank House,Baltimore Orioles,ORLS,2,4,2,6,1961,1962,1,-0.2,0.84,1.04,28,78,50,36,316,280,0.0,0.0,0.0,0.0,0.0,0.0
housp001,Paul Householder,Cincinnati Reds,REDS,4,7,5,12,1984,1988,4,12.23,4.23,-8.0,905,294,-611,634,363,-271,4251.0,1846.0,-2405.0,1977500.0,937500.0,-1040000.0
housp001,Paul Householder,St. Louis Cardinals,CARDS,1,2,3,5,1984,1984,0,0.51,0.0,-0.51,168,0,-168,529,0,-529,0.0,0.0,0.0,0.0,0.0,0.0
housp101,Pat House,Houston Astros,ASTROS,2,4,2,6,1969,1973,4,-0.36,3.98,4.34,121,303,182,243,70,-173,0.0,713.0,713.0,23500.0,0.0,-23500.0
houst001,Tyler Houston,Atlanta Braves,BRAVES,1,1,1,2,1996,1996,0,-0.41,0.0,0.41,313,0,-313,880,0,-880,0.0,0.0,0.0,109000.0,0.0,-109000.0
houst001,Tyler Houston,Chicago Cubs,CUBS,2,2,2,4,1999,2003,4,-0.08,-0.39,-0.31,13,148,135,30,359,329,0.0,0.0,0.0,715000.0,0.0,-715000.0
houst001,Tyler Houston,Milwaukee Brewers,BREWRS,7,14,15,29,2002,2012,10,36.64,23.05,-13.59,2498,2040,-458,9346,4727,-4619,883.0,6494.0,5611.0,10372000.0,19975667.0,9603667.0
houst101,Tom House,Atlanta Braves,BRAVES,4,9,4,13,1975,1983,8,3.54,6.25,2.71,540,620,80,1015,2104,1089,1077.0,319.0,-758.0,33500.0,30000.0,-3500.0
housw001,Wayne Housie,New York Mets,METS,1,1,1,2,1993,1995,2,0.0,0.66,0.66,0,110,110,0,6,6,0.0,226.0,226.0,0.0,0.0,0.0
houta101,Art Houtteman,Detroit Tigers,TIGRS,3,7,7,14,1953,1959,6,19.59,21.85,2.26,1560,1406,-154,4177,3381,-796,3244.0,3436.0,192.0,42000.0,15900.0,-26100.0
hovls101,Steve Hovley,Milwaukee Brewers,BREWRS,3,3,4,7,1970,1972,2,4.87,1.11,-3.76,485,256,-229,600,535,-65,2693.0,283.0,-2410.0,15000.0,62000.0,47000.0
howab001,Ben Howard,San Diego Padres,PADRS,3,3,3,6,2004,2007,3,-0.35,-0.09,0.26,80,198,118,21,28,7,137.0,291.0,154.0,375000.0,0.0,-375000.0
howab101,Bruce Howard,Chicago White Sox,WSOX,6,9,10,19,1967,1977,10,29.24,13.29,-15.95,1920,1924,4,6795,7037,242,306.0,62.0,-244.0,134800.0,182000.0,47200.0
howab101,Bruce Howard,Baltimore Orioles,ORLS,1,1,1,2,1968,1968,0,-0.83,-0.23,0.6,26,47,21,16,99,83,146.0,0.0,-146.0,17500.0,0.0,-17500.0
howac002,Chris Howard,Boston Red Sox,RSOX,1,1,1,2,1995,1995,0,0.15,0.0,-0.15,4,0,-4,0,0,0,12.0,0.0,-12.0,0.0,155000.0,155000.0
howad101,Doug Howard,California Angels,ANGELS,2,2,2,4,1974,1975,1,-0.2,1.02,1.22,112,118,6,228,415,187,0.0,0.0,0.0,12500.0,90000.0,77500.0
howad101,Doug Howard,St. Louis Cardinals,CARDS,1,1,1,2,1975,1976,1,-0.77,-0.23,0.54,39,16,-23,99,45,-54,0.0,0.0,0.0,0.0,0.0,0.0
howad101,Doug Howard,Cleveland Indians,INDINS,1,2,1,3,1976,1978,2,1.98,-0.52,-2.5,205,36,-169,757,0,-757,0.0,442.0,442.0,0.0,0.0,0.0
howad102,Del Howard,Pittsburgh Pirates,PIRATS,1,3,1,4,1905,1910,5,9.35,21.13,11.78,731,320,-411,2264,464,-1800,2702.0,3628.0,926.0,0.0,0.0,0.0
howad102,Del Howard,Boston Braves,BRAVES,2,3,3,6,1907,1917,10,1.63,18.44,16.81,350,1294,944,1288,5367,4079,0.0,0.0,0.0,0.0,0.0,0.0
howad102,Del Howard,Philadelphia Phillies,PHILS,1,2,3,5,1904,1911,7,1.77,5.1,3.33,253,872,619,1002,3354,2352,15.0,0.0,-15.0,0.0,0.0,0.0
howae101,Elston Howard,New York Yankees,YANKS,2,3,3,6,1967,1973,6,-0.3,3.2,3.5,176,440,264,366,1171,805,181.0,337.0,156.0,64000.0,0.0,-64000.0
howaf102,Frank Howard,Los Angeles Dodgers,DOGRS,4,12,9,21,1964,1984,20,57.0,60.48,3.48,4290,2463,-1827,14544,7259,-7285,4034.0,7191.0,3157.0,163000.0,22000.0,-141000.0
howal102,Larry Howard,Houston Astros,ASTROS,1,1,1,2,1973,1973,0,-0.15,0.0,0.15,4,0,-4,10,0,-10,0.0,0.0,0.0,0.0,0.0,0.0
howas003,Spencer Howard,Philadelphia Phillies,PHILS,1,3,4,7,2021,2021,0,-1.21,0.8,2.01,9,74,65,0,29,29,64.0,300.0,236.0,0.0,9766666.0,9766666.0
howat001,Thomas Howard,San Diego Padres,PADRS,1,1,2,3,1992,1994,2,0.89,0.0,-0.89,191,0,-191,581,0,-581,0.0,0.0,0.0,158000.0,0.0,-158000.0
howat001,Thomas Howard,Cleveland Indians,INDINS,3,3,3,6,1993,1994,1,0.28,0.96,0.68,412,25,-387,1134,61,-1073,15.0,40.0,25.0,325000.0,817500.0,492500.0
howaw101,Wilbur Howard,Milwaukee Brewers,BREWRS,1,1,2,3,1974,1974,0,-0.22,0.0,0.22,450,0,-450,1093,0,-1093,0.0,0.0,0.0,0.0,0.0,0.0
howea001,Art Howe,Pittsburgh Pirates,PIRATS,1,1,1,2,1976,1976,0,13.73,0.23,-13.5,706,62,-644,2543,102,-2441,0.0,0.0,0.0,0.0,0.0,0.0
howeb101,Bill Howerton,Boston Red Sox,RSOX,1,2,1,3,1946,1946,0,3.72,0.0,-3.72,260,0,-260,831,0,-831,0.0,0.0,0.0,0.0,0.0,0.0
howeb101,Bill Howerton,St. Louis Cardinals,CARDS,3,10,5,15,1951,1954,3,10.75,2.71,-8.04,1144,382,-762,2713,1234,-1479,1601.0,388.0,-1213.0,41500.0,63500.0,22000.0
howed102,Dixie Howell,Baltimore,Baltimore,1,1,4,5,1941,1942,1,-0.11,0.0,0.11,24,0,-24,62,0,-62,0.0,0.0,0.0,0.0,0.0,0.0
howed102,Dixie Howell,Brooklyn Dodgers,DOGRS,1,5,2,7,1947,1947,0,3.3,-0.19,-3.49,337,37,-300,419,81,-338,1285.0,0.0,-1285.0,17500.0,0.0,-17500.0
howed102,Dixie Howell,Pittsburgh Pirates,PIRATS,1,5,1,6,1947,1948,1,0.0,0.0,0.0,0,0,0,0,0,0,0.0,0.0,0.0,0.0,0.0,0.0
howed102,Dixie Howell,Cincinnati Reds,REDS,1,2,1,3,1952,1952,0,-0.11,0.0,0.11,24,0,-24,62,0,-62,0.0,0.0,0.0,8000.0,0.0,-8000.0
howeh101,Harry Howell,New York Yankees,YANKS,1,2,1,3,1904,1905,1,24.65,2.89,-21.76,418,168,-250,671,224,-447,4716.0,1776.0,-2940.0,0.0,0.0,0.0
howej001,Jay Howell,Cincinnati Reds,REDS,2,2,2,4,1980,1983,3,-0.12,0.72,0.84,46,76,30,70,183,113,67.0,0.0,-67.0,0.0,0.0,0.0
howej001,Jay Howell,Chicago Cubs,CUBS,4,8,7,15,1982,1990,8,11.89,11.37,-0.52,835,655,-180,2292,401,-1891,1070.0,3028.0,1958.0,890000.0,85000.0,-805000.0
howej001,Jay Howell,New York Yankees,YANKS,3,7,8,15,1984,1993,9,53.43,36.99,-16.44,2484,1135,-1349,8455,3089,-5366,3002.0,2795.0,-207.0,2415000.0,2187766.0,-227234.0
howej001,Jay Howell,Oakland Athletics,ATLTCS,1,4,2,6,1987,1994,7,8.57,10.76,2.19,979,216,-763,1815,1,-1814,1096.0,3814.0,2718.0,1137653.0,1187500.0,49847.0
howej002,Jack Howell,California Angels,ANGELS,1,1,1,2,1991,1992,1,0.71,-0.68,-1.39,58,41,-17,179,105,-74,0.0,0.0,0.0,652500.0,180000.0,-472500.0
howej003,J.P. Howell,Kansas City Royals,ROYALS,1,1,2,3,2006,2008,2,3.83,0.65,-3.18,274,266,-8,7,855,848,991.0,0.0,-991.0,0.0,337200.0,337200.0
howek001,Ken Howell,Los Angeles Dodgers,DOGRS,1,3,1,4,1988,1991,3,-1.54,8.44,9.98,185,468,283,229,1974,1745,523.0,0.0,-523.0,305000.0,2142904.0,1837904.0
howek001,Ken Howell,Baltimore Orioles,ORLS,2,3,2,5,1988,1990,2,3.17,2.97,-0.2,157,238,81,279,1027,748,944.0,0.0,-944.0,1150000.0,1455000.0,305000.0
howep001,Pat Howell,New York Mets,METS,1,1,1,2,1992,1992,0,0.0,0.0,0.0,0,0,0,0,0,0,0.0,0.0,0.0,0.0,0.0,0.0
hower001,Roy Howell,Texas Rangers,RNGRS,2,2,4,6,1977,1978,1,8.86,-0.59,-9.45,556,97,-459,2246,181,-2065,0.0,37.0,37.0,0.0,0.0,0.0
howld101,Dan Howley,Philadelphia Phillies,PHILS,1,2,1,3,1913,1913,0,0.0,0.0,0.0,0,17,17,0,37,37,0.0,0.0,0.0,2400.0,0.0,-2400.0
howrb001,Bob Howry,San Francisco Giants,GIANTS,1,6,3,9,1997,1999,2,21.4,-0.07,-21.47,1008,161,-847,1122,94,-1028,2523.0,875.0,-1648.0,0.0,9757500.0,9757500.0
howrb001,Bob Howry,Chicago White Sox,WSOX,2,4,3,7,2002,2003,1,4.79,2.04,-2.75,399,73,-326,0,289,289,1315.0,0.0,-1315.0,1200000.0,9150000.0,7950000.0
howsd101,Dick Howser,Kansas City Athletics,ATLTCS,12,26,19,45,1963,1976,13,41.52,16.46,-25.06,5320,2149,-3171,12652,5616,-7036,5181.0,2140.0,-3041.0,368100.0,463000.0,94900.0
howsd101,Dick Howser,Cleveland Indians,INDINS,1,1,2,3,1966,1966,0,0.83,0.0,-0.83,148,0,-148,368,0,-368,0.0,0.0,0.0,16500.0,0.0,-16500.0
hoy-d101,Dummy Hoy,Washington Senators,WSN,1,1,1,2,1893,1894,1,9.13,-1.19,-10.32,556,40,-516,2583,60,-2523,0.0,353.0,353.0,0.0,0.0,0.0
hoy-d101,Dummy Hoy,Cincinnati Reds,REDS,2,5,2,7,1898,1898,0,7.73,2.21,-5.52,627,66,-561,2681,105,-2576,267.0,786.0,519.0,0.0,0.0,0.0
hoytj001,James Hoyt,Atlanta Braves,BRAVES,1,2,3,5,2015,2020,5,5.33,4.65,-0.68,563,307,-256,1880,420,-1460,215.0,2002.0,1787.0,0.0,0.0,0.0
hoytj001,James Hoyt,Houston Astros,ASTROS,1,1,1,2,2018,2018,0,0.22,0.0,-0.22,9,0,-9,0,0,0,25.0,0.0,-25.0,0.0,0.0,0.0
hoytl001,LaMarr Hoyt,New York Yankees,YANKS,4,7,7,14,1977,1983,6,29.7,12.76,-16.94,1788,732,-1056,2195,2573,378,4627.0,0.0,-4627.0,0.0,400000.0,400000.0
hoytl001,LaMarr Hoyt,Chicago White Sox,WSOX,3,5,6,11,1984,1997,13,0.78,21.51,20.73,266,2126,1860,135,7098,6963,1605.0,1633.0,28.0,720500.0,260000.0,-460500.0
hoytw101,Waite Hoyt,New York Giants,GIANTS,2,8,3,11,1919,1923,4,10.49,7.89,-2.6,305,402,97,539,1094,555,2035.0,323.0,-1712.0,12500.0,9600.0,-2900.0
hoytw101,Waite Hoyt,Boston Red Sox,RSOX,11,21,24,45,1920,1937,17,85.68,51.32,-34.36,3377,2671,-706,8411,9094,683,11819.0,4939.0,-6880.0,73300.0,46200.0,-27100.0
hoytw101,Waite Hoyt,New York Yankees,YANKS,1,2,3,5,1930,1931,1,-1.14,0.55,1.69,271,146,-125,761,467,-294,731.0,97.0,-634.0,25000.0,18000.0,-7000.0
hraba101,Al Hrabosky,St. Louis Cardinals,CARDS,3,3,4,7,1977,1984,7,7.28,-0.76,-8.04,491,152,-339,738,21,-717,1187.0,232.0,-955.0,0.0,50000.0,50000.0
hrinw101,Walt Hriniak,Atlanta Braves,BRAVES,1,3,1,4,1969,1970,1,-0.8,2.26,3.06,142,212,70,403,844,441,0.0,0.0,0.0,0.0,0.0,0.0
hrinw101,Walt Hriniak,San Diego Padres,PADRS,1,1,1,2,1971,1971,0,0.0,0.0,0.0,0,0,0,0,0,0,0.0,0.0,0.0,0.0,0.0,0.0
hu--c001,Chin-lung Hu,Los Angeles Dodgers,DOGRS,1,1,1,2,2010,2010,0,-0.43,0.0,0.43,22,0,-22,23,0,-23,0.0,0.0,0.0,0.0,0.0,0.0
hu--c002,Chih-Wei Hu,Minnesota Twins,TWINS,1,2,1,3,2015,2016,1,0.22,0.73,0.51,11,63,52,0,0,0,69.0,176.0,107.0,0.0,3025000.0,3025000.0
hu--c002,Chih-Wei Hu,Tampa Bay Devil Rays,RAYS,1,1,1,2,2018,2018,0,0.0,0.0,0.0,0,0,0,0,0,0,0.0,0.0,0.0,0.0,0.0,0.0
huanw001,Wei-Chieh Huang,Arizona Diamondbacks,DBACKS,1,2,1,3,2018,2018,0,-0.06,-0.87,-0.81,4,48,44,0,0,0,17.0,43.0,26.0,0.0,2712500.0,2712500.0
hubbb101,Bill Hubbell,Philadelphia Phillies,PHILS,6,10,10,20,1925,1940,15,39.24,40.12,0.88,1970,2808,838,7440,9949,2509,260.0,679.0,419.0,26000.0,12750.0,-13250.0
hubbb101,Bill Hubbell,Brooklyn Dodgers,DOGRS,3,9,3,12,1926,1934,8,0.53,8.67,8.14,100,822,722,99,3036,2937,677.0,0.0,-677.0,30000.0,12000.0,-18000.0
hubbt001,Trent Hubbard,San Francisco Giants,GIANTS,1,2,4,6,1996,2002,6,4.28,33.7,29.42,158,1486,1328,649,4565,3916,0.0,882.0,882.0,6600000.0,391666.0,-6208334.0
hubbt001,Trent Hubbard,Atlanta Braves,BRAVES,1,3,2,5,2000,2002,2,-0.42,1.16,1.58,107,214,107,224,759,535,2.0,6.0,4.0,800000.0,4146789.0,3346789.0
hubec101,Clarence Huber,Beaumont,Beaumont,1,1,2,3,1924,1924,0,-0.97,0.0,0.97,242,0,-242,891,0,-891,0.0,0.0,0.0,0.0,4800.0,4800.0
hubej001,Justin Huber,New York Mets,METS,5,7,7,14,2004,2010,6,-2.18,11.14,13.32,693,533,-160,2079,723,-1356,683.0,3210.0,2527.0,2841000.0,10775000.0,7934000.0
hubej002,Jon Huber,San Diego Padres,PADRS,1,1,1,2,2004,2004,0,0.86,-0.59,-1.45,25,29,4,0,31,31,84.0,0.0,-84.0,0.0,750000.0,750000.0
hudej001,John Hudek,Houston Astros,ASTROS,2,2,3,5,1997,2007,10,5.91,21.57,15.66,290,905,615,1010,3428,2418,81.0,0.0,-81.0,2912500.0,205000.0,-2707500.0
hudej001,John Hudek,New York Mets,METS,1,1,1,2,1998,1998,0,0.42,-0.44,-0.86,64,75,11,4,184,180,114.0,0.0,-114.0,499000.0,775000.0,276000.0
hudej001,John Hudek,Cincinnati Reds,REDS,2,2,3,5,1999,2001,2,-0.05,0.18,0.23,63,99,36,1,0,-1,157.0,180.0,23.0,1300000.0,5200000.0,3900000.0
hudlr001,Rex Hudler,New York Yankees,YANKS,1,2,2,4,1985,1986,1,0.34,-0.33,-0.67,66,76,10,1,188,187,321.0,0.0,-321.0,0.0,558333.0,558333.0
hudlr001,Rex Hudler,Montreal Expos,NATEX,2,2,2,4,1990,1990,0,0.43,-0.22,-0.65,305,8,-297,560,0,-560,105.0,19.0,-86.0,135000.0,105000.0,-30000.0
hudsc001,Charles Hudson,Philadelphia Phillies,PHILS,5,8,8,16,1986,1990,4,1.67,-0.06,-1.73,297,223,-74,689,513,-176,783.0,49.0,-734.0,1372500.0,720833.0,-651667.0
hudsc001,Charles Hudson,New York Yankees,YANKS,1,1,1,2,1989,1989,0,-0.99,-1.23,-0.24,19,66,47,0,183,183,200.0,0.0,-200.0,0.0,0.0,0.0
hudsc101,Charlie Hudson,New York Mets,METS,1,4,4,8,1971,1975,4,1.94,1.36,-0.58,244,340,96,49,280,231,763.0,880.0,117.0,0.0,0.0,0.0
hudsc101,Charlie Hudson,St. Louis Cardinals,CARDS,1,2,1,3,1973,1974,1,0.06,-0.23,-0.29,25,42,17,0,9,9,187.0,127.0,-60.0,0.0,0.0,0.0
hudsc101,Charlie Hudson,Texas Rangers,RNGRS,1,1,1,2,1974,1974,0,0.0,0.0,0.0,0,0,0,0,0,0,0.0,0.0,0.0,0.0,0.0,0.0
hudsc101,Charlie Hudson,Cleveland Indians,INDINS,1,1,1,2,1974,1974,0,-0.2,0.0,0.2,3,0,-3,0,0,0,17.0,0.0,-17.0,0.0,0.0,0.0
hudsd001,Daniel Hudson,Chicago White Sox,WSOX,5,8,8,16,2010,2016,6,2.25,4.26,2.01,475,264,-211,194,348,154,1677.0,1215.0,-462.0,13500000.0,8100000.0,-5400000.0
hudsd001,Daniel Hudson,Pittsburgh Pirates,PIRATS,2,4,2,6,2018,2019,1,0.39,4.09,3.7,34,179,145,137,675,538,0.0,0.0,0.0,8500000.0,0.0,-8500000.0
hudsd001,Daniel Hudson,Toronto Blue Jays,BJAYS,1,1,1,2,2019,2019,0,1.7,0.0,-1.7,125,0,-125,0,0,0,235.0,0.0,-235.0,1500000.0,0.0,-1500000.0
hudsd001,Daniel Hudson,Washington Nationals,NATEX,1,1,2,3,2021,2021,0,-0.24,-0.22,0.02,45,54,9,0,0,0,57.0,65.0,8.0,6000000.0,0.0,-6000000.0
hudsj001,Joe Hudson,Boston Red Sox,RSOX,1,1,1,2,1998,1998,0,-0.18,0.0,0.18,2,0,-2,0,0,0,1.0,0.0,-1.0,0.0,0.0,0.0
hudsj101,Johnny Hudson,Brooklyn Dodgers,DOGRS,2,4,2,6,1941,1946,5,1.09,12.92,11.83,261,488,227,749,2125,1376,0.0,0.0,0.0,20000.0,0.0,-20000.0
hudsk001,Kyle Hudson,Tampa Bay Devil Rays,RAYS,1,1,1,2,2012,2013,1,0.0,-0.52,-0.52,0,23,23,0,24,24,0.0,0.0,0.0,0.0,0.0,0.0
hudsl001,Luke Hudson,Colorado Rockies,ROCKS,4,6,7,13,2001,2003,2,2.38,1.01,-1.37,515,182,-333,507,247,-260,927.0,121.0,-806.0,4816667.0,6725000.0,1908333.0
hudsn101,Nat Hudson,St.Louis Cardinals,CARDS,1,1,1,2,1889,1890,1,0.0,4.44,4.44,0,98,98,0,171,171,0.0,1169.0,1169.0,0.0,0.0,0.0
hudso001,Orlando Hudson,Toronto Blue Jays,BJAYS,5,10,12,22,2005,2014,9,23.63,23.44,-0.19,1360,1086,-274,3834,4118,284,1461.0,175.0,-1286.0,24569600.0,28118000.0,3548400.0
hudsr101,Rex Hudson,Los Angeles Dodgers,DOGRS,1,1,1,2,1977,1977,0,0.0,0.0,0.0,0,0,0,0,0,0,0.0,0.0,0.0,0.0,0.0,0.0
hudss101,Sid Hudson,Washington Senators,TWINS,1,1,2,3,1952,1956,4,3.29,3.27,-0.02,168,146,-22,116,161,45,1085.0,1293.0,208.0,0.0,12000.0,12000.0
hudst001,Tim Hudson,Oakland Athletics,ATLTCS,3,3,5,8,2004,2008,4,29.13,-2.56,-31.69,752,132,-620,606,55,-551,5341.0,513.0,-4828.0,5000000.0,370000.0,-4630000.0
huelf101,Frank Huelsman,St.Louis Browns,ORLS,1,2,1,3,1904,1904,0,2.03,0.03,-2.0,386,82,-304,1572,310,-1262,0.0,0.0,0.0,0.0,0.0,0.0
huffa001,Aubrey Huff,Tampa Bay Devil Rays,RAYS,5,10,11,21,2006,2020,14,1.34,46.23,44.89,253,2214,1961,664,8335,7671,952.0,246.0,-706.0,7425467.0,5729600.0,-1695867.0
huffa001,Aubrey Huff,Baltimore Orioles,ORLS,2,3,3,6,2009,2017,8,-1.38,15.73,17.11,67,889,822,117,3636,3519,74.0,0.0,-74.0,8000000.0,6550000.0,-1450000.0
huffm001,Mike Huff,Chicago White Sox,WSOX,1,1,1,2,1994,1994,0,1.37,0.0,-1.37,152,0,-152,435,0,-435,0.0,0.0,0.0,0.0,0.0,0.0
huffp001,Phil Huffman,San Francisco Giants,GIANTS,4,14,8,22,1978,1992,14,8.18,23.62,15.44,767,1277,510,1656,1600,-56,2714.0,7759.0,5045.0,0.0,0.0,0.0
huffp001,Phil Huffman,Oakland Athletics,ATLTCS,1,2,1,3,1978,1978,0,-2.52,1.35,3.87,64,41,-23,127,163,36,519.0,0.0,-519.0,0.0,0.0,0.0
huffp001,Phil Huffman,Toronto Blue Jays,BJAYS,1,1,1,2,1982,1992,10,0.0,15.83,15.83,0,1115,1115,0,3470,3470,0.0,0.0,0.0,0.0,0.0,0.0
huggm101,Miller Huggins,Cincinnati Reds,REDS,3,9,7,16,1910,1914,4,44.03,8.35,-35.68,2926,785,-2141,11991,2646,-9345,753.0,872.0,119.0,0.0,0.0,0.0
hughb102,Bill Hughes,Pittsburgh Pirates,PIRATS,1,5,1,6,1922,1922,0,0.0,0.0,0.0,0,0,0,0,0,0,0.0,0.0,0.0,2700.0,0.0,-2700.0
hughj102,Jim Hughey,Pittsburgh Pirates,PIRATS,3,7,3,10,1897,1910,13,16.77,28.55,11.78,976,1353,377,3303,5786,2483,2606.0,375.0,-2231.0,0.0,0.0,0.0
hughk001,Keith Hughes,Philadelphia Phillies,PHILS,3,5,6,11,1984,1990,6,0.32,13.19,12.87,143,596,453,310,1528,1218,676.0,2713.0,2037.0,1725000.0,103500.0,-1621500.0
hughk001,Keith Hughes,New York Yankees,YANKS,1,2,1,3,1987,1987,0,-0.56,-0.16,0.4,55,65,10,124,184,60,0.0,0.0,0.0,62500.0,700000.0,637500.0
hughk001,Keith Hughes,Philadelphia Phillies,PHILS,2,4,3,7,1988,1988,0,-2.46,0.71,3.17,165,85,-80,504,178,-326,0.0,49.0,49.0,395000.0,0.0,-395000.0
hughk001,Keith Hughes,Baltimore Orioles,ORLS,1,2,2,4,1989,1989,0,-0.15,0.0,0.15,8,0,-8,9,0,-9,0.0,0.0,0.0,0.0,0.0,0.0
hughp001,Phil Hughes,Minnesota Twins,TWINS,1,2,1,3,2018,2018,0,-0.2,0.0,0.2,32,0,-32,1,0,-1,62.0,0.0,-62.0,0.0,0.0,0.0
hughr001,Rhyne Hughes,Tampa Bay Devil Rays,RAYS,1,1,1,2,2009,2009,0,-0.13,0.33,0.46,14,34,20,51,99,48,0.0,0.0,0.0,0.0,1500000.0,1500000.0
hughr101,Roy Hughes,Cleveland Indians,INDINS,1,3,1,4,1938,1941,3,1.14,1.94,0.8,388,390,2,935,1415,480,285.0,0.0,-285.0,0.0,0.0,0.0
hughr101,Roy Hughes,St.Louis Browns,ORLS,3,5,4,9,1939,1947,8,0.67,12.25,11.58,155,697,542,409,2324,1915,122.0,1025.0,903.0,19500.0,15250.0,-4250.0
hughr101,Roy Hughes,New York Yankees,YANKS,1,1,1,2,1939,1939,0,-0.93,0.0,0.93,155,0,-155,568,0,-568,0.0,0.0,0.0,0.0,5500.0,5500.0
hught101,Tommy Hughes,Philadelphia Phillies,PHILS,1,1,1,2,1947,1949,2,-0.91,0.76,1.67,24,97,73,7,372,365,81.0,0.0,-81.0,0.0,0.0,0.0
hught103,Tom Hughes,Boston Red Sox,RSOX,2,2,2,4,1903,1908,5,-0.67,14.33,15.0,96,253,157,144,394,250,687.0,2663.0,1976.0,0.0,0.0,0.0
hught103,Tom Hughes,New York Yankees,YANKS,1,2,1,3,1904,1904,0,10.23,2.28,-7.95,672,44,-628,792,66,-726,6259.0,413.0,-5846.0,0.0,0.0,0.0
hught106,Terry Hughes,St. Louis Cardinals,CARDS,22,50,41,91,1973,1994,21,106.47,161.96,55.49,10190,8695,-1495,28502,26542,-1960,13842.0,9162.0,-4680.0,3130333.0,1562167.0,-1568166.0
huisj001,Justin Huisman,Colorado Rockies,ROCKS,1,1,3,4,2004,2008,4,-0.25,-0.1,0.15,15,24,9,0,1,1,75.0,42.0,-33.0,0.0,0.0,0.0
huism001,Mark Huismann,Kansas City Royals,ROYALS,2,2,2,4,1986,1988,2,1.07,0.7,-0.37,43,47,4,1,5,4,284.0,141.0,-143.0,100000.0,786667.0,686667.0
huism001,Mark Huismann,Seattle Mariners,MARNRS,1,1,1,2,1987,1987,0,-0.01,0.0,0.01,20,0,-20,0,0,0,106.0,0.0,-106.0,0.0,0.0,0.0
huisr001,Rick Huisman,Houston Astros,ASTROS,1,1,1,2,1995,1995,0,0.29,-0.5,-0.79,29,11,-18,0,37,37,117.0,0.0,-117.0,0.0,310000.0,310000.0
hulet001,Tim Hulett,Chicago White Sox,WSOX,1,1,1,2,1988,1990,2,0.0,0.0,0.0,0,0,0,0,0,0,0.0,0.0,0.0,0.0,0.0,0.0
hulet002,Tug Hulett,Texas Rangers,RNGRS,1,1,1,2,2007,2008,1,-0.19,-0.96,-0.77,30,26,-4,56,89,33,0.0,0.0,0.0,0.0,3550000.0,3550000.0
hulih101,Harry Hulihan,New York Giants,GIANTS,3,8,5,13,1922,1930,8,4.92,14.44,9.52,1096,750,-346,1706,1477,-229,6029.0,4662.0,-1367.0,17500.0,39500.0,22000.0
hulle001,Eric Hull,Los Angeles Dodgers,DOGRS,1,1,2,3,2008,2008,0,0.0,0.0,0.0,0,0,0,0,0,0,0.0,0.0,0.0,0.0,0.0,0.0
hulsd001,David Hulse,Texas Rangers,RNGRS,1,1,1,2,1995,1995,0,-1.45,-0.4,1.05,200,3,-197,491,0,-491,0.0,46.0,46.0,0.0,0.0,0.0
hulsr101,Rudy Hulswitt,Philadelphia Phillies,PHILS,1,1,1,2,1905,1905,0,0.0,-0.18,-0.18,0,42,42,0,142,142,0.0,0.0,0.0,0.0,0.0,0.0
hulvh101,Hank Hulvey,Philadelphia Athletics,ATLTCS,2,7,2,9,1923,1927,4,0.0,2.68,2.68,0,472,472,0,1997,1997,0.0,0.0,0.0,12000.0,0.0,-12000.0
humbp001,Philip Humber,New York Mets,METS,1,4,1,5,2008,2013,5,2.31,15.63,13.32,305,210,-95,963,247,-716,66.0,2151.0,2085.0,0.0,0.0,0.0
humet001,Tom Hume,Cincinnati Reds,REDS,3,5,5,10,1985,1992,7,5.33,4.06,-1.27,304,351,47,423,887,464,1092.0,605.0,-487.0,1560833.0,1784333.0,223500.0
hummt001,Tim Hummel,Chicago White Sox,WSOX,1,2,1,3,2003,2003,0,-1.28,0.3,1.58,82,15,-67,219,0,-219,0.0,43.0,43.0,0.0,2800000.0,2800000.0
humpb101,Bert Humphries,Philadelphia Phillies,PHILS,1,2,1,3,1911,1911,0,2.81,0.3,-2.51,88,66,-22,79,238,159,669.0,0.0,-669.0,0.0,0.0,0.0
humpb101,Bert Humphries,Cincinnati Reds,REDS,3,8,5,13,1912,1913,1,9.38,6.71,-2.67,842,270,-572,2287,704,-1583,1567.0,500.0,-1067.0,11280.0,7925.0,-3355.0
humpb102,Bob Humphreys,St. Louis Cardinals,CARDS,5,11,9,20,1965,1972,7,11.63,1.92,-9.71,1328,302,-1026,1454,613,-841,2062.0,364.0,-1698.0,32500.0,24000.0,-8500.0
humpb102,Bob Humphreys,Chicago Cubs,CUBS,1,1,1,2,1966,1966,0,2.67,0.0,-2.67,428,0,-428,60,0,-60,1188.0,0.0,-1188.0,0.0,0.0,0.0
humpj101,Johnny Humphries,Cleveland Indians,INDINS,1,1,1,2,1941,1942,1,8.14,0.77,-7.37,244,96,-148,301,20,-281,2436.0,250.0,-2186.0,0.0,0.0,0.0
humpm001,Mike Humphreys,San Diego Padres,PADRS,1,1,1,2,1991,1992,1,-0.36,-1.09,-0.73,54,137,83,100,242,142,0.0,0.0,0.0,0.0,0.0,0.0
humpt101,Terry Humphrey,Montreal Expos,NATEX,3,5,4,9,1974,1979,5,-1.98,12.65,14.63,252,716,464,89,1902,1813,1002.0,1380.0,378.0,39500.0,53000.0,13500.0
humpt101,Terry Humphrey,Detroit Tigers,TIGRS,1,4,3,7,1975,1979,4,4.11,5.38,1.27,431,290,-141,467,862,395,1859.0,1144.0,-715.0,16500.0,0.0,-16500.0
humpt101,Terry Humphrey,Houston Astros,ASTROS,1,2,1,3,1976,1978,2,0.55,-0.16,-0.71,312,151,-161,705,515,-190,441.0,0.0,-441.0,0.0,0.0,0.0
hundn001,Nick Hundley,San Diego Padres,PADRS,1,2,1,3,2014,2014,0,0.16,0.1,-0.06,50,16,-34,174,0,-174,0.0,22.0,22.0,0.0,0.0,0.0
hundr101,Randy Hundley,San Francisco Giants,GIANTS,2,3,3,6,1965,1968,3,45.93,0.43,-45.5,1983,248,-1735,4122,39,-4083,6327.0,677.0,-5650.0,0.0,0.0,0.0
hundr101,Randy Hundley,Chicago Cubs,CUBS,1,1,1,2,1973,1977,4,-0.15,0.12,0.27,32,373,341,93,1169,1076,0.0,0.0,0.0,50000.0,22500.0,-27500.0
hundt001,Todd Hundley,New York Mets,METS,4,7,8,15,1998,2006,8,19.49,18.13,-1.36,1116,1028,-88,1998,1238,-760,1375.0,1729.0,354.0,12550000.0,10305000.0,-2245000.0
hundt001,Todd Hundley,Chicago Cubs,CUBS,1,2,2,4,2002,2004,2,-0.13,2.3,2.43,32,316,284,68,1174,1106,0.0,0.0,0.0,6500000.0,11875000.0,5375000.0
hungb101,Bernie Hungling,St.Louis Browns,ORLS,1,4,1,5,1930,1932,2,0.0,-0.31,-0.31,0,16,16,0,36,36,0.0,0.0,0.0,10000.0,0.0,-10000.0
hunnb101,Bill Hunnefield,Chicago White Sox,WSOX,3,9,4,13,1930,1936,6,0.81,-0.65,-1.46,234,127,-107,748,417,-331,0.0,39.0,39.0,19600.0,12500.0,-7100.0
hunnb101,Bill Hunnefield,Portland,Portland,1,1,3,4,1926,1927,1,2.16,0.0,-2.16,415,0,-415,1545,0,-1545,0.0,0.0,0.0,0.0,0.0,0.0
huntb001,Brian Hunter,Atlanta Braves,BRAVES,1,1,1,2,1993,1994,1,-0.86,0.0,0.86,76,0,-76,252,0,-252,0.0,0.0,0.0,205000.0,0.0,-205000.0
huntb001,Brian Hunter,Pittsburgh Pirates,PIRATS,1,1,1,2,1994,1995,1,0.64,0.0,-0.64,49,0,-49,119,0,-119,0.0,0.0,0.0,250000.0,0.0,-250000.0
huntb002,Brian Hunter,Houston Astros,ASTROS,6,12,18,30,1996,2004,8,25.8,6.98,-18.82,2221,1542,-679,3937,2959,-978,4263.0,3434.0,-829.0,7155000.0,5554000.0,-1601000.0
huntb002,Brian Hunter,Detroit Tigers,TIGRS,1,1,2,3,1999,2004,5,-1.0,0.81,1.81,121,5,-116,527,0,-527,0.0,90.0,90.0,1750000.0,0.0,-1750000.0
huntb002,Brian Hunter,Colorado Rockies,ROCKS,1,1,1,2,2000,2000,0,0.31,0.0,-0.31,32,0,-32,48,0,-48,0.0,0.0,0.0,300000.0,0.0,-300000.0
huntb002,Brian Hunter,San Diego Padres,PADRS,1,1,1,2,2004,2004,0,0.0,-0.31,-0.31,0,80,80,0,101,101,0.0,0.0,0.0,0.0,0.0,0.0
huntb105,Billy Hunter,Brooklyn Dodgers,DOGRS,1,1,4,5,1952,1952,0,-1.44,0.0,1.44,279,0,-279,1055,0,-1055,0.0,0.0,0.0,0.0,0.0,0.0
huntb105,Billy Hunter,Baltimore Orioles,ORLS,15,37,36,73,1954,1988,34,52.13,133.41,81.28,3638,7388,3750,6759,20843,14084,14284.0,13293.0,-991.0,815833.0,128400.0,-687433.0
huntb105,Billy Hunter,New York Yankees,YANKS,6,15,13,28,1957,1970,13,5.72,32.98,27.26,1633,2423,790,4235,5558,1323,2553.0,4978.0,2425.0,115500.0,43000.0,-72500.0
huntb105,Billy Hunter,Kansas City Athletics,ATLTCS,4,5,5,10,1958,1963,5,10.24,1.76,-8.48,1153,670,-483,1352,1828,476,2603.0,934.0,-1669.0,11000.0,0.0,-11000.0
hunth101,Herb Hunter,New York Giants,GIANTS,1,3,1,4,1916,1916,0,2.13,0.44,-1.69,153,40,-113,610,161,-449,0.0,0.0,0.0,7400.0,6500.0,-900.0
huntj102,Joel Hunt,St. Louis Cardinals,CARDS,1,2,1,3,1932,1932,0,-0.57,0.0,0.57,56,0,-56,40,0,-40,317.0,0.0,-317.0,0.0,4800.0,4800.0
huntk102,Ken Hunt,Washington Senators,RNGRS,1,1,1,2,1966,1970,4,0.0,2.67,2.67,0,428,428,0,60,60,0.0,1188.0,1188.0,0.0,0.0,0.0
huntn101,Newt Hunter,KansasCity,KansasCity,1,1,3,4,1910,1910,0,0.39,0.0,-0.39,65,0,-65,249,0,-249,0.0,0.0,0.0,0.0,0.0,0.0
huntr101,Ron Hunt,New York Mets,METS,6,11,10,21,1966,1974,8,2.87,14.84,11.97,879,1261,382,2379,4536,2157,1072.0,0.0,-1072.0,182000.0,96000.0,-86000.0
huntr101,Ron Hunt,Los Angeles Dodgers,DOGRS,2,3,4,7,1968,1972,4,9.28,10.09,0.81,488,474,-14,1876,1637,-239,0.0,0.0,0.0,55000.0,0.0,-55000.0
huntr101,Ron Hunt,San Francisco Giants,GIANTS,1,1,1,2,1970,1971,1,12.72,0.0,-12.72,509,0,-509,2140,0,-2140,0.0,0.0,0.0,0.0,0.0,0.0
hunts101,Steve Huntz,St. Louis Cardinals,CARDS,2,2,2,4,1970,1970,0,1.16,-0.28,-1.44,128,36,-92,489,5,-484,0.0,65.0,65.0,0.0,0.0,0.0
hunts101,Steve Huntz,San Diego Padres,PADRS,1,1,2,3,1970,1970,0,0.0,0.0,0.0,0,0,0,0,0,0,0.0,0.0,0.0,0.0,0.0,0.0
hunts101,Steve Huntz,San Francisco Giants,GIANTS,1,1,1,2,1971,1971,0,-0.06,0.72,0.78,35,78,43,96,2,-94,0.0,134.0,134.0,0.0,0.0,0.0
hunts101,Steve Huntz,Chicago White Sox,WSOX,3,5,4,9,1971,1979,8,21.05,19.98,-1.07,765,568,-197,1638,2032,394,4047.0,189.0,-3858.0,258750.0,125000.0,-133750.0
huntt002,Tommy Hunter,Texas Rangers,RNGRS,1,2,1,3,2011,2012,1,15.4,1.58,-13.82,1387,61,-1326,4679,0,-4679,1230.0,162.0,-1068.0,442160.0,3000000.0,2557840.0
huntt002,Tommy Hunter,Baltimore Orioles,ORLS,1,1,1,2,2015,2015,0,-0.24,-0.41,-0.17,37,8,-29,0,22,22,47.0,0.0,-47.0,4650000.0,0.0,-4650000.0
huntt002,Tommy Hunter,New York Mets,METS,1,2,1,3,2021,2021,0,0.0,0.56,0.56,0,26,26,0,22,22,0.0,190.0,190.0,100000.0,2500000.0,2400000.0
huntw102,Willard Hunter,Los Angeles Dodgers,DOGRS,1,2,2,4,1962,1964,2,2.26,0.33,-1.93,344,161,-183,877,245,-632,336.0,0.0,-336.0,0.0,0.0,0.0
hurdc001,Clint Hurdle,Kansas City Royals,ROYALS,1,1,1,2,1981,1981,0,-0.43,0.0,0.43,19,0,-19,37,0,-37,0.0,0.0,0.0,0.0,0.0,0.0
hursb001,Bruce Hurst,San Diego Padres,PADRS,18,35,38,73,1993,2021,28,53.28,80.99,27.71,3600,5089,1489,12022,13376,1354,2601.0,11891.0,9290.0,37678200.0,21960000.0,-15718200.0
hursd101,Don Hurst,St. Louis Cardinals,CARDS,2,4,5,9,1928,1936,8,28.36,11.55,-16.81,2032,988,-1044,7440,3573,-3867,0.0,0.0,0.0,0.0,15000.0,15000.0
hursd101,Don Hurst,Philadelphia Phillies,PHILS,2,2,3,5,1934,1938,4,28.84,12.75,-16.09,890,540,-350,3765,2322,-1443,0.0,0.0,0.0,0.0,0.0,0.0
hursj001,Jonathan Hurst,Texas Rangers,RNGRS,1,3,1,4,1991,1991,0,2.41,-0.71,-3.12,510,12,-498,30,0,-30,668.0,186.0,-482.0,0.0,1500000.0,1500000.0
hurte001,Edwin Hurtado,Toronto Blue Jays,BJAYS,2,3,3,6,1995,1996,1,-1.74,0.08,1.82,122,9,-113,179,30,-149,326.0,0.0,-326.0,218000.0,135000.0,-83000.0
huskb001,Butch Huskey,New York Mets,METS,2,5,2,7,1998,2000,2,29.24,0.16,-29.08,1404,56,-1348,5865,211,-5654,33.0,0.0,-33.0,510000.0,3000000.0,2490000.0
huskb001,Butch Huskey,Seattle Mariners,MARNRS,1,1,1,2,1999,1999,0,-0.18,0.04,0.22,45,6,-39,131,0,-131,0.0,55.0,55.0,1500000.0,0.0,-1500000.0
huskb001,Butch Huskey,Minnesota Twins,TWINS,2,3,3,6,2000,2003,3,3.0,-0.02,-3.02,196,31,-165,636,86,-550,0.0,0.0,0.0,822500.0,0.0,-822500.0
husoj001,Jeff Huson,Montreal Expos,NATEX,1,1,1,2,1990,1991,1,3.93,-0.89,-4.82,410,84,-326,1191,5,-1186,0.0,175.0,175.0,0.0,0.0,0.0
husoj001,Jeff Huson,Colorado Rockies,ROCKS,1,1,1,2,1997,1997,0,-1.29,0.0,1.29,84,0,-84,154,0,-154,0.0,0.0,0.0,0.0,0.0,0.0
hustb101,Bert Husting,Milwaukee,Milwaukee,1,1,1,2,1900,1908,8,-0.04,0.0,0.04,4,0,-4,3,0,-3,24.0,0.0,-24.0,0.0,0.0,0.0
hustc101,Carl Husta,Philadelphia Athletics,ATLTCS,3,7,4,11,1928,1936,8,0.0,4.89,4.89,0,451,451,0,502,502,0.0,2946.0,2946.0,7500.0,0.0,-7500.0
hustw101,Warren Huston,Boston Braves,BRAVES,1,1,1,2,1944,1944,0,0.0,0.0,0.0,0,0,0,0,0,0,0.0,0.0,0.0,0.0,0.0,0.0
hutcd001,Drew Hutchison,Toronto Blue Jays,BJAYS,2,2,5,7,2016,2018,2,-0.2,1.28,1.48,33,66,33,1,129,128,77.0,396.0,319.0,15866667.0,5500000.0,-10366667.0
hutcf101,Fred Hutchinson,Seattle,Seattle,2,2,6,8,1938,1943,5,26.97,0.0,-26.97,820,0,-820,1623,0,-1623,4392.0,0.0,-4392.0,0.0,17000.0,17000.0
hutci101,Ira Hutchinson,Boston Braves,BRAVES,2,4,3,7,1938,1952,14,0.98,38.76,37.78,331,1743,1412,987,7238,6251,317.0,0.0,-317.0,7500.0,0.0,-7500.0
hutci101,Ira Hutchinson,Boston Braves,BRAVES,1,2,1,3,1945,1949,4,0.0,3.35,3.35,0,154,154,0,133,133,0.0,1068.0,1068.0,0.0,0.0,0.0
hutcj101,Johnny Hutchings,Cincinnati Reds,REDS,1,1,1,2,1941,1941,0,1.11,-0.65,-1.76,256,55,-201,124,175,51,1218.0,0.0,-1218.0,0.0,0.0,0.0
hutcj101,Johnny Hutchings,Pittsburgh Pirates,PIRATS,21,39,50,89,1946,1973,27,26.24,60.98,34.74,3262,5231,1969,9080,15581,6501,3705.0,3970.0,265.0,216500.0,102000.0,-114500.0
hutcj102,Joe Hutcheson,Brooklyn Dodgers,DOGRS,1,4,1,5,1933,1933,0,0.0,0.0,0.0,0,0,0,0,0,0,0.0,0.0,0.0,0.0,0.0,0.0
huttj101,Jim Hutto,St. Louis Cardinals,CARDS,1,2,1,3,1969,1969,0,-0.33,0.06,0.39,57,49,-8,101,68,-33,0.0,0.0,0.0,0.0,0.0,0.0
huttj101,Jim Hutto,Philadelphia Phillies,PHILS,4,9,7,16,1970,1984,14,35.07,12.55,-22.52,1678,1480,-198,5343,1739,-3604,1000.0,2166.0,1166.0,0.0,123000.0,123000.0
huttj101,Jim Hutto,California Angels,ANGELS,1,1,1,2,1973,1973,0,-0.21,0.0,0.21,4,0,-4,5,0,-5,0.0,0.0,0.0,0.0,0.0,0.0
huttm001,Mark Hutton,New York Yankees,YANKS,3,3,4,7,1996,2005,9,1.74,3.25,1.51,243,362,119,531,1162,631,362.0,83.0,-279.0,2554000.0,1125000.0,-1429000.0
huttm001,Mark Hutton,Florida Marlins,MARLNS,2,2,2,4,1997,1999,2,0.2,2.5,2.3,66,195,129,125,662,537,38.0,0.0,-38.0,450000.0,0.0,-450000.0
huttm001,Mark Hutton,Colorado Rockies,ROCKS,1,1,1,2,1997,1999,2,-0.26,-0.37,-0.11,20,119,99,1,186,185,51.0,0.0,-51.0,0.0,0.0,0.0
huttt101,Tom Hutton,Los Angeles Dodgers,DOGRS,2,2,3,5,1971,1972,1,1.12,0.0,-1.12,651,0,-651,1410,0,-1410,0.0,0.0,0.0,0.0,0.0,0.0
hyath101,Ham Hyatt,New York Yankees,YANKS,3,12,4,16,1921,1928,7,-3.56,9.03,12.59,367,917,550,1242,3654,2412,159.0,0.0,-159.0,15750.0,13000.0,-2750.0
hyded101,Dick Hyde,Washington Senators,TWINS,2,3,3,6,1959,1962,3,-0.17,-0.01,0.16,13,300,287,12,852,840,0.0,4.0,4.0,13000.0,0.0,-13000.0
hynec001,Colt Hynes,Cleveland Indians,INDINS,1,1,1,2,2014,2014,0,0.0,0.0,0.0,0,0,0,0,0,0,0.0,0.0,0.0,0.0,0.0,0.0
hynec001,Colt Hynes,Cleveland Indians,INDINS,1,1,2,3,2016,2016,0,0.0,0.12,0.12,0,20,20,0,64,64,0.0,0.0,0.0,0.0,0.0,0.0
hyzda001,Adam Hyzdu,San Francisco Giants,GIANTS,1,1,2,3,1994,1994,0,0.0,0.0,0.0,0,0,0,0,0,0,0.0,0.0,0.0,0.0,0.0,0.0
hyzda001,Adam Hyzdu,Boston Red Sox,RSOX,1,1,1,2,2005,2005,0,-0.38,-0.24,0.14,17,8,-9,25,0,-25,0.0,24.0,24.0,0.0,0.0,0.0
hyzda001,Adam Hyzdu,San Diego Padres,PADRS,1,1,1,2,2005,2007,2,0.24,0.03,-0.21,12,102,90,18,3,-15,0.0,165.0,165.0,375000.0,0.0,-375000.0
iannc001,Chris Iannetta,Colorado Rockies,ROCKS,1,1,1,2,2011,2017,6,6.02,10.24,4.22,394,216,-178,1342,183,-1159,0.0,1517.0,1517.0,2550000.0,0.0,-2550000.0
iglej001,Jose Iglesias,Boston Red Sox,RSOX,3,8,6,14,2013,2020,7,8.76,3.1,-5.66,703,304,-399,2164,10,-2154,991.0,1375.0,384.0,5113000.0,0.0,-5113000.0
iglej001,Jose Iglesias,Baltimore Orioles,ORLS,1,1,2,3,2020,2020,0,-1.09,0.0,1.09,114,0,-114,447,0,-447,0.0,0.0,0.0,2500000.0,0.0,-2500000.0
igler001,Raisel Iglesias,Cincinnati Reds,REDS,1,1,2,3,2020,2021,1,2.81,0.0,-2.81,81,0,-81,0,0,0,210.0,0.0,-210.0,5714285.0,900000.0,-4814285.0
iguct001,Tadahito Iguchi,Chicago White Sox,WSOX,2,2,2,4,2007,2009,2,0.99,0.0,-0.99,49,0,-49,163,0,-163,0.0,0.0,0.0,3250000.0,0.0,-3250000.0
incap001,Pete Incaviglia,Montreal Expos,NATEX,2,2,3,5,1985,1988,3,6.79,2.79,-4.0,712,107,-605,2736,87,-2649,137.0,806.0,669.0,0.0,0.0,0.0
incap001,Pete Incaviglia,Philadelphia Phillies,PHILS,4,6,7,13,1996,2002,6,5.3,4.73,-0.57,557,658,101,602,1100,498,2055.0,1429.0,-626.0,10946667.0,14670000.0,3723333.0
incie001,Ender Inciarte,Arizona Diamondbacks,DBACKS,2,5,3,8,2015,2018,3,16.27,-1.52,-17.79,1329,142,-1187,5122,368,-4754,281.0,417.0,136.0,513000.0,535000.0,22000.0
infao001,Omar Infante,Detroit Tigers,TIGRS,1,1,1,2,2007,2008,1,0.0,-1.21,-1.21,0,24,24,0,90,90,0.0,0.0,0.0,1300000.0,5633333.0,4333333.0
infao001,Omar Infante,Chicago Cubs,CUBS,3,6,6,12,2007,2013,6,21.27,0.88,-20.39,1494,347,-1147,4156,61,-4095,895.0,926.0,31.0,1305000.0,2300000.0,995000.0
infao001,Omar Infante,Atlanta Braves,BRAVES,1,2,1,3,2010,2014,4,6.58,3.15,-3.43,1022,499,-523,990,1984,994,984.0,0.0,-984.0,2225000.0,7800000.0,5575000.0
infao001,Omar Infante,Miami Marlins,MARLNS,3,5,6,11,2012,2015,3,12.57,-1.22,-13.79,462,200,-262,752,437,-315,2987.0,792.0,-2195.0,8000000.0,2650000.0,-5350000.0
inges101,Scotty Ingerton,Chicago Cubs,CUBS,1,2,1,3,1911,1912,1,-1.23,-0.64,0.59,195,54,-141,626,160,-466,292.0,0.0,-292.0,0.0,0.0,0.0
inksb101,Bert Inks,Baltimore Orioles,BLN,1,2,1,3,1894,1897,3,-0.83,9.45,10.28,72,136,64,119,246,127,795.0,1529.0,734.0,0.0,0.0,0.0
inksb101,Bert Inks,Louisville Colonels,LS3,1,1,1,2,1896,1896,0,-0.35,-0.71,-0.36,6,26,20,5,43,38,31.0,165.0,134.0,0.0,0.0,0.0
iorgd001,Dane Iorg,Philadelphia Phillies,PHILS,3,5,4,9,1977,1983,6,1.29,13.57,12.28,795,776,-19,1705,2597,892,551.0,251.0,-300.0,300000.0,80000.0,-220000.0
irabh001,Hideki Irabu,San Diego Padres,PADRS,2,7,4,11,1997,2001,4,12.93,12.25,-0.68,1051,464,-587,3386,1273,-2113,1459.0,771.0,-688.0,0.0,4510000.0,4510000.0
irabh001,Hideki Irabu,New York Yankees,YANKS,8,17,12,29,1999,2012,13,17.78,27.16,9.38,1143,1682,539,646,4704,4058,6675.0,2655.0,-4020.0,22173073.0,34719286.0,12546213.0
irvid001,Daryl Irvine,Boston Red Sox,RSOX,1,1,1,2,1993,1993,0,0.0,0.44,0.44,0,15,15,0,27,27,0.0,0.0,0.0,0.0,0.0,0.0
irwit101,Tommy Irwin,Cleveland Indians,INDINS,2,3,2,5,1938,1940,2,3.73,5.73,2.0,238,292,54,340,1286,946,1666.0,0.0,-1666.0,21500.0,12500.0,-9000.0
isbef101,Frank Isbell,Chicago Cubs,CUBS,3,7,3,10,1898,1902,4,10.49,0.34,-10.15,648,180,-468,2353,652,-1701,0.0,320.0,320.0,0.0,0.0,0.0
ishik001,Kazuhisa Ishii,Los Angeles Dodgers,DOGRS,1,1,1,2,2005,2005,0,-0.11,-1.38,-1.27,37,121,84,30,434,404,273.0,0.0,-273.0,0.0,0.0,0.0
isrij001,Jason Isringhausen,New York Mets,METS,1,2,1,3,1999,1999,0,4.14,-0.38,-4.52,174,36,-138,0,0,0,542.0,40.0,-502.0,1950000.0,2500000.0,550000.0
iviem101,Mike Ivie,San Diego Padres,PADRS,1,1,1,2,1978,1978,0,5.42,0.89,-4.53,336,128,-208,1131,401,-730,0.0,0.0,0.0,0.0,0.0,0.0
iviem101,Mike Ivie,San Francisco Giants,GIANTS,8,10,15,25,1981,1998,17,8.87,20.56,11.69,610,2142,1532,1351,7059,5708,1958.0,443.0,-1515.0,7402778.0,4466667.0,-2936111.0
iwama001,Akinori Iwamura,Tampa Bay Devil Rays,RAYS,2,2,2,4,2009,2010,1,-0.92,2.11,3.03,169,71,-98,197,0,-197,211.0,187.0,-24.0,3250000.0,6752000.0,3502000.0
iztuc001,Cesar Izturis,Toronto Blue Jays,BJAYS,1,2,2,4,2001,2002,1,7.04,-0.73,-7.77,933,22,-911,2400,0,-2400,462.0,215.0,-247.0,1800000.0,200000.0,-1600000.0
iztuc001,Cesar Izturis,Los Angeles Dodgers,DOGRS,1,1,1,2,2006,2006,0,-0.81,1.93,2.74,87,24,-63,286,29,-257,0.0,221.0,221.0,3200000.0,9000000.0,5800000.0
iztum001,Maicer Izturis,Cleveland Indians,INDINS,1,2,1,3,2004,2004,0,5.47,-0.76,-6.23,379,23,-356,1253,0,-1253,0.0,41.0,41.0,0.0,0.0,0.0
iztum001,Maicer Izturis,Washington Nationals,NATEX,1,2,1,3,2004,2006,2,19.76,2.71,-17.05,1354,217,-1137,5013,879,-4134,0.0,0.0,0.0,312000.0,2200000.0,1888000.0
jablr101,Ray Jablonski,St. Louis Cardinals,CARDS,1,2,1,3,1954,1956,2,-0.38,0.61,0.99,264,56,-208,738,5,-733,359.0,117.0,-242.0,0.0,10000.0,10000.0
jablr101,Ray Jablonski,Cincinnati Reds,REDS,5,9,14,23,1956,1965,9,64.39,16.2,-48.19,3193,1555,-1638,9922,3215,-6707,2746.0,1065.0,-1681.0,0.0,0.0,0.0
jablr101,Ray Jablonski,Chicago Cubs,CUBS,1,2,2,4,1957,1958,1,0.97,-1.1,-2.07,265,105,-160,781,34,-747,0.0,197.0,197.0,0.0,0.0,0.0
jablr101,Ray Jablonski,San Francisco Giants,GIANTS,1,2,2,4,1959,1961,2,28.04,6.49,-21.55,1173,252,-921,4711,231,-4480,0.0,1899.0,1899.0,0.0,0.0,0.0
jacka001,Austin Jackson,New York Yankees,YANKS,1,3,1,4,2009,2013,4,21.17,14.94,-6.23,983,513,-470,2996,2148,-848,971.0,0.0,-971.0,812225.0,3500000.0,2687775.0
jacka001,Austin Jackson,Detroit Tigers,TIGRS,3,5,5,10,2014,2021,7,3.65,10.17,6.52,207,201,-6,690,19,-671,284.0,2223.0,1939.0,29745000.0,508700.0,-29236300.0
jacka001,Austin Jackson,Seattle Mariners,MARNRS,1,2,1,3,2015,2015,0,0.09,0.0,-0.09,29,0,-29,79,0,-79,0.0,0.0,0.0,7700000.0,0.0,-7700000.0
jacka001,Austin Jackson,San Francisco Giants,GIANTS,1,3,1,4,2018,2018,0,0.75,0.0,-0.75,24,0,-24,0,0,0,64.0,0.0,-64.0,1675000.0,0.0,-1675000.0
jacka002,Alex Jackson,Seattle Mariners,MARNRS,1,2,2,4,2016,2019,3,-0.61,0.04,0.65,19,6,-13,50,0,-50,0.0,45.0,45.0,0.0,0.0,0.0
jacka002,Alex Jackson,Atlanta Braves,BRAVES,1,1,1,2,2021,2021,0,-0.24,1.19,1.43,42,55,13,123,216,93,0.0,0.0,0.0,0.0,0.0,0.0
jacka101,Al Jackson,New York Mets,METS,3,5,4,9,1965,1970,5,3.02,4.23,1.21,629,336,-293,1532,1195,-337,1019.0,0.0,-1019.0,88000.0,85000.0,-3000.0
jacka101,Al Jackson,St. Louis Cardinals,CARDS,4,6,7,13,1967,1972,5,-1.6,1.66,3.26,464,155,-309,71,218,147,1318.0,207.0,-1111.0,17500.0,12000.0,-5500.0
jackb002,Brett Jackson,Chicago Cubs,CUBS,1,1,1,2,2014,2014,0,-0.07,0.0,0.07,7,0,-7,5,0,-5,0.0,0.0,0.0,0.0,0.0,0.0
jackc002,Conor Jackson,Arizona Diamondbacks,DBACKS,1,2,1,3,2010,2012,2,0.36,-1.03,-1.39,120,141,21,437,0,-437,0.0,191.0,191.0,3100000.0,0.0,-3100000.0
jackc002,Conor Jackson,Oakland Athletics,ATLTCS,1,2,1,3,2011,2011,0,-0.39,0.0,0.39,12,0,-12,22,0,-22,0.0,0.0,0.0,3200000.0,0.0,-3200000.0
jackd001,Danny Jackson,Kansas City Royals,ROYALS,2,3,4,7,1987,1991,4,5.13,5.94,0.81,160,651,491,182,2147,1965,1537.0,256.0,-1281.0,900000.0,580000.0,-320000.0
jackd001,Danny Jackson,Chicago Cubs,CUBS,1,1,1,2,1992,1995,3,0.25,3.16,2.91,30,334,304,30,1290,1260,265.0,0.0,-265.0,2625000.0,2600000.0,-25000.0
jackd001,Danny Jackson,Florida Marlins,MARLNS,3,3,4,7,1992,2008,16,7.63,1.65,-5.98,301,301,0,152,832,680,1756.0,41.0,-1715.0,150000.0,0.0,-150000.0
jackd001,Danny Jackson,St. Louis Cardinals,CARDS,1,3,3,6,1997,1997,0,-0.21,-1.09,-0.88,425,93,-332,688,180,-508,185.0,68.0,-117.0,4942500.0,2250000.0,-2692500.0
jackd002,Darrin Jackson,Chicago Cubs,CUBS,1,3,2,5,1989,1992,3,9.01,-0.33,-9.34,632,454,-178,1598,1395,-203,382.0,0.0,-382.0,400000.0,750000.0,350000.0
jackd002,Darrin Jackson,San Diego Padres,PADRS,7,16,18,34,1993,2006,13,11.65,40.81,29.16,2759,3648,889,9247,13106,3859,712.0,1324.0,612.0,13007500.0,22494000.0,9486500.0
jackd002,Darrin Jackson,Toronto Blue Jays,BJAYS,1,1,1,2,1993,1993,0,-0.58,3.06,3.64,31,94,63,91,390,299,0.0,0.0,0.0,2100000.0,2300000.0,200000.0
jackd002,Darrin Jackson,Minnesota Twins,TWINS,1,1,1,2,1997,1997,0,0.18,0.0,-0.18,140,0,-140,299,0,-299,0.0,0.0,0.0,0.0,0.0,0.0
jackd003,Damian Jackson,Cleveland Indians,INDINS,1,4,2,6,1997,1998,1,5.24,-0.51,-5.75,1014,98,-916,190,187,-3,2567.0,112.0,-2455.0,0.0,4300000.0,4300000.0
jackd003,Damian Jackson,Cincinnati Reds,REDS,4,7,7,14,1999,2004,5,10.74,9.45,-1.29,965,646,-319,3397,2378,-1019,0.0,0.0,0.0,3650000.0,1050000.0,-2600000.0
jackd003,Damian Jackson,San Diego Padres,PADRS,1,2,2,4,2002,2002,0,-0.26,-0.46,-0.2,167,15,-152,507,42,-465,0.0,0.0,0.0,0.0,0.0,0.0
jackd003,Damian Jackson,Chicago Cubs,CUBS,1,1,1,2,2004,2004,0,-0.15,0.0,0.15,14,0,-14,16,0,-16,0.0,0.0,0.0,0.0,0.0,0.0
jackd004,Drew Jackson,Seattle Mariners,MARNRS,2,4,3,7,2017,2018,1,0.01,-0.36,-0.37,6,35,29,0,0,0,56.0,129.0,73.0,0.0,2150000.0,2150000.0
jackd004,Drew Jackson,Philadelphia Phillies,PHILS,1,1,1,2,2018,2018,0,-0.03,0.0,0.03,3,0,-3,4,0,-4,0.0,0.0,0.0,0.0,0.0,0.0
jacke001,Edwin Jackson,Los Angeles Dodgers,DOGRS,3,6,4,10,2006,2008,2,2.19,-0.23,-2.42,275,388,113,424,385,-39,1172.0,396.0,-776.0,4405000.0,800923.0,-3604077.0
jacke001,Edwin Jackson,Tampa Bay Devil Rays,RAYS,4,4,5,9,2008,2018,10,3.13,11.22,8.09,201,696,495,288,2256,1968,936.0,194.0,-742.0,7137700.0,1462500.0,-5675200.0
jacke001,Edwin Jackson,Detroit Tigers,TIGRS,4,7,9,16,2009,2021,12,3.78,52.84,49.06,248,1430,1182,733,3032,2299,687.0,6457.0,5770.0,35445000.0,2358700.0,-33086300.0
jacke001,Edwin Jackson,Arizona Diamondbacks,DBACKS,2,4,4,8,2010,2016,6,3.34,4.24,0.9,57,372,315,23,128,105,765.0,1444.0,679.0,13600000.0,0.0,-13600000.0
jacke001,Edwin Jackson,Chicago White Sox,WSOX,4,6,7,13,2011,2016,5,-1.99,0.09,2.08,103,232,129,66,344,278,233.0,625.0,392.0,13500000.0,3500000.0,-10000000.0
jacke001,Edwin Jackson,Toronto Blue Jays,BJAYS,1,4,4,8,2011,2014,3,0.4,6.43,6.03,344,416,72,89,1599,1510,547.0,15.0,-532.0,4329600.0,3193000.0,-1136600.0
jackg101,Grant Jackson,Philadelphia Phillies,PHILS,4,9,7,16,1970,1984,14,35.07,12.55,-22.52,1678,1480,-198,5343,1739,-3604,1000.0,2166.0,1166.0,0.0,123000.0,123000.0
jackg101,Grant Jackson,Baltimore Orioles,ORLS,4,12,12,24,1976,1988,12,17.24,67.8,50.56,919,3227,2308,801,6729,5928,6521.0,11016.0,4495.0,558333.0,0.0,-558333.0
jackg101,Grant Jackson,Seattle Mariners,MARNRS,5,10,11,21,1976,1985,9,23.3,29.6,6.3,2357,1242,-1115,4609,3930,-679,3692.0,3322.0,-370.0,175000.0,538500.0,363500.0
jackg101,Grant Jackson,Montreal Expos,NATEX,1,1,1,2,1982,1983,1,-0.75,0.0,0.75,20,10,-10,0,9,9,115.0,0.0,-115.0,0.0,0.0,0.0
jackg102,George Jackson,Memphis,Memphis,1,1,1,2,1911,1911,0,0.67,0.0,-0.67,152,0,-152,635,0,-635,0.0,0.0,0.0,0.0,0.0,0.0
jackj001,Jay Jackson,San Francisco Giants,GIANTS,1,1,1,2,2021,2021,0,0.0,0.0,0.0,0,0,0,0,0,0,0.0,0.0,0.0,0.0,0.0,0.0
jackj101,Shoeless Joe Jackson,Philadelphia Athletics,ATLTCS,3,7,4,11,1910,1916,6,36.05,17.77,-18.28,769,1148,379,3166,4931,1765,0.0,0.0,0.0,0.0,0.0,0.0
jackj101,Shoeless Joe Jackson,Cleveland Indians,INDINS,2,3,7,10,1915,1932,17,29.68,38.6,8.92,696,2140,1444,3015,8707,5692,0.0,807.0,807.0,0.0,0.0,0.0
jackj102,John Jackson,Philadelphia Phillies,PHILS,1,2,1,3,1933,1934,1,0.0,0.0,0.0,0,0,0,0,0,0,0.0,0.0,0.0,0.0,0.0,0.0
jackl001,Luke Jackson,Texas Rangers,RNGRS,1,1,2,3,2016,2016,0,2.77,0.0,-2.77,443,0,-443,6,0,-6,762.0,0.0,-762.0,0.0,0.0,0.0
jackl101,Lou Jackson,Chicago Cubs,CUBS,3,5,4,9,1959,1961,2,8.16,-0.89,-9.05,620,173,-447,633,602,-31,802.0,0.0,-802.0,0.0,0.0,0.0
jackl102,Larry Jackson,St. Louis Cardinals,CARDS,15,32,26,58,1962,1972,10,54.99,16.45,-38.54,4551,1419,-3132,9818,4107,-5711,7592.0,1574.0,-6018.0,32500.0,24000.0,-8500.0
jackl102,Larry Jackson,Chicago Cubs,CUBS,10,15,17,32,1966,1982,16,38.97,72.32,33.35,1515,3517,2002,3549,10033,6484,7048.0,7391.0,343.0,430000.0,24000.0,-406000.0
jackm001,Michael Jackson,Philadelphia Phillies,PHILS,2,4,4,8,1987,1989,2,8.23,2.23,-6.0,632,164,-468,1265,649,-616,1310.0,12.0,-1298.0,1629900.0,750000.0,-879900.0
jackm001,Michael Jackson,Seattle Mariners,MARNRS,2,4,3,7,1991,1993,2,19.75,1.34,-18.41,1114,134,-980,1118,402,-716,2994.0,104.0,-2890.0,5400000.0,4950000.0,-450000.0
jackm101,Mike Jackson,Boston Red Sox,RSOX,1,1,1,2,1969,1971,2,0.3,-0.15,-0.45,10,88,78,1,10,9,19.0,170.0,151.0,0.0,15000.0,15000.0
jackm101,Mike Jackson,San Diego Padres,PADRS,1,1,1,2,1971,1971,0,-1.03,0.0,1.03,23,0,-23,6,0,-6,126.0,0.0,-126.0,0.0,0.0,0.0
jackm101,Mike Jackson,Kansas City Royals,ROYALS,1,1,1,2,1973,1979,6,0.02,5.57,5.55,1,271,270,0,1,1,2.0,1317.0,1315.0,12600.0,0.0,-12600.0
jackr001,Reggie Jackson,Oakland Athletics,ATLTCS,2,4,6,10,1976,1978,2,9.34,5.62,-3.72,178,460,282,558,1294,736,944.0,1423.0,479.0,100000.0,0.0,-100000.0
jackr002,Ron Jackson,California Angels,ANGELS,2,3,3,6,1978,1987,9,2.69,22.79,20.1,795,1091,296,2836,4554,1718,0.0,0.0,0.0,0.0,60000.0,60000.0
jackr002,Ron Jackson,Minnesota Twins,TWINS,1,1,1,2,1981,1982,1,0.78,-0.31,-1.09,31,22,-9,104,58,-46,0.0,0.0,0.0,200000.0,0.0,-200000.0
jackr003,Roy Lee Jackson,New York Mets,METS,2,3,3,6,1980,1993,13,5.55,32.99,27.44,534,807,273,279,1457,1178,1448.0,4754.0,3306.0,314167.0,130000.0,-184167.0
jackr003,Roy Lee Jackson,Baltimore Orioles,ORLS,1,2,1,3,1985,1987,2,0.74,-0.72,-1.46,44,232,188,6,947,941,120.0,0.0,-120.0,0.0,512500.0,512500.0
jackr005,Ryan Jackson,Houston Astros,ASTROS,1,1,1,2,2013,2014,1,0.0,-0.74,-0.74,0,69,69,0,184,184,0.0,0.0,0.0,0.0,503200.0,503200.0
jackr005,Ryan Jackson,Kansas City Royals,ROYALS,2,3,2,5,2015,2018,3,-0.99,-1.21,-0.22,77,234,157,122,575,453,5.0,16.0,11.0,2300000.0,987500.0,-1312500.0
jackr101,Ron Jackson,Chicago White Sox,WSOX,3,3,3,6,1959,1965,6,-1.11,4.24,5.35,42,419,377,70,221,151,11.0,1805.0,1794.0,30500.0,0.0,-30500.0
jackr101,Ron Jackson,Boston Red Sox,RSOX,1,1,1,2,1960,1960,0,0.0,-0.49,-0.49,0,34,34,0,89,89,0.0,0.0,0.0,0.0,22000.0,22000.0
jackr102,Randy Jackson,Chicago Cubs,CUBS,5,9,9,18,1955,1964,9,9.43,6.83,-2.6,1051,943,-108,3111,3013,-98,133.0,368.0,235.0,0.0,0.0,0.0
jackr102,Randy Jackson,Cleveland Indians,INDINS,1,1,1,2,1959,1959,0,0.16,-0.45,-0.61,41,24,-17,91,6,-85,0.0,88.0,88.0,0.0,0.0,0.0
jacks001,Steven Jackson,Arizona Diamondbacks,DBACKS,1,4,2,6,2007,2008,1,-0.71,4.28,4.99,171,78,-93,110,78,-32,366.0,722.0,356.0,0.0,0.0,0.0
jacks102,Sonny Jackson,Houston Astros,ASTROS,9,17,16,33,1967,1989,22,77.09,75.22,-1.87,5400,5677,277,17448,17542,94,3810.0,7694.0,3884.0,705000.0,416000.0,-289000.0
jackz001,Zach Jackson,Toronto Blue Jays,BJAYS,1,3,2,5,2005,2010,5,4.16,12.24,8.08,549,739,190,828,2857,2029,2736.0,120.0,-2616.0,627000.0,446000.0,-181000.0
jackz001,Zach Jackson,Milwaukee Brewers,BREWRS,1,4,1,5,2008,2008,0,22.37,5.2,-17.17,1354,34,-1320,5551,50,-5501,190.0,392.0,202.0,0.0,11000000.0,11000000.0
jacoa101,Art Jacobs,Cleveland Indians,INDINS,1,1,2,3,1939,1939,0,-0.02,0.0,0.02,2,0,-2,0,0,0,3.0,0.0,-3.0,0.0,0.0,0.0
jacob001,Brook Jacoby,Atlanta Braves,BRAVES,1,4,1,5,1983,1986,3,32.51,0.13,-32.38,1861,94,-1767,7480,76,-7404,166.0,699.0,533.0,110000.0,475000.0,365000.0
jacob001,Brook Jacoby,Cleveland Indians,INDINS,1,1,2,3,1991,1992,1,-0.69,0.0,0.69,56,0,-56,204,0,-204,0.0,0.0,0.0,0.0,0.0,0.0
jacob101,Beany Jacobson,Washington Senators,TWINS,1,1,1,2,1905,1905,0,-0.57,0.0,0.57,62,0,-62,77,0,-77,637.0,0.0,-637.0,0.0,0.0,0.0
jacob101,Beany Jacobson,St.Louis Browns,ORLS,1,2,1,3,1907,1907,0,-0.2,1.1,1.3,4,48,44,0,54,54,7.0,471.0,464.0,0.0,0.0,0.0
jacoe101,Elmer Jacobs,Pittsburgh Pirates,PIRATS,1,1,1,2,1918,1919,1,3.24,0.92,-2.32,70,66,-4,89,81,-8,752.0,635.0,-117.0,0.0,0.0,0.0
jacoe101,Elmer Jacobs,Philadelphia Phillies,PHILS,3,6,7,13,1919,1925,6,15.32,16.37,1.05,851,640,-211,1993,1730,-263,4451.0,3043.0,-1408.0,8500.0,16850.0,8350.0
jacoe101,Elmer Jacobs,Seattle,Seattle,1,2,2,4,1923,1925,2,12.05,0.0,-12.05,628,0,-628,625,0,-625,5104.0,0.0,-5104.0,0.0,3400.0,3400.0
jacoj001,Jason Jacome,New York Mets,METS,3,5,6,11,1995,1999,4,0.09,-0.09,-0.18,89,38,-51,0,0,0,470.0,74.0,-396.0,125000.0,0.0,-125000.0
jacom001,Mike Jacobs,New York Mets,METS,1,3,2,5,2005,2009,4,-3.72,4.84,8.56,420,468,48,1504,2023,519,79.0,0.0,-79.0,0.0,4000000.0,4000000.0
jacom001,Mike Jacobs,Florida Marlins,MARLNS,1,1,1,2,2008,2012,4,-0.34,2.33,2.67,128,412,284,478,1,-477,0.0,594.0,594.0,395000.0,405000.0,10000.0
jacom102,Merwin Jacobson,New York Giants,GIANTS,1,3,1,4,1916,1916,0,2.13,0.44,-1.69,153,40,-113,610,161,-449,0.0,0.0,0.0,7400.0,6500.0,-900.0
jacom102,Merwin Jacobson,Chicago Cubs,CUBS,1,2,1,3,1918,1923,5,0.0,1.35,1.35,0,436,436,0,1534,1534,0.0,0.0,0.0,0.0,0.0,0.0
jacos101,Spook Jacobs,Kansas City Athletics,ATLTCS,40,87,90,177,1956,1976,20,168.75,57.36,-111.39,14647,9561,-5086,34265,25664,-8601,22274.0,11407.0,-10867.0,516100.0,626500.0,110400.0
jacow101,Baby Doll Jacobson,Detroit Tigers,TIGRS,1,2,1,3,1915,1919,4,28.27,2.95,-25.32,1243,192,-1051,5249,198,-5051,0.0,1643.0,1643.0,0.0,0.0,0.0
jacow101,Baby Doll Jacobson,St.Louis Browns,ORLS,2,2,2,4,1926,1933,7,12.21,19.97,7.76,837,713,-124,3116,1432,-1684,0.0,3927.0,3927.0,15500.0,15500.0,0.0
jacow101,Baby Doll Jacobson,Philadelphia Athletics,ATLTCS,1,3,1,4,1926,1930,4,3.68,8.68,5.0,373,175,-198,792,208,-584,1683.0,1623.0,-60.0,10500.0,10000.0,-500.0
jacqp101,Pat Jacquez,Chicago Cubs,CUBS,1,3,2,5,1970,1973,3,1.15,0.0,-1.15,69,0,-69,29,0,-29,290.0,0.0,-290.0,0.0,0.0,0.0
jacqp101,Pat Jacquez,Chicago White Sox,WSOX,1,1,1,2,1971,1972,1,0.0,-0.21,-0.21,0,11,11,0,11,11,0.0,0.0,0.0,9500.0,0.0,-9500.0
jacqp101,Pat Jacquez,Cincinnati Reds,REDS,1,1,1,2,1972,1972,0,0.0,0.0,0.0,0,0,0,0,0,0,0.0,0.0,0.0,0.0,0.0,0.0
jaimj001,Juan Jaime,Atlanta Braves,BRAVES,6,15,9,24,2015,2021,6,3.56,2.51,-1.05,557,291,-266,805,489,-316,986.0,676.0,-310.0,21307500.0,11500000.0,-9807500.0
jameb001,Bob James,Montreal Expos,NATEX,1,1,1,2,1984,1987,3,3.0,5.26,2.26,170,398,228,0,1515,1515,667.0,22.0,-645.0,0.0,0.0,0.0
jameb103,Bill James,St.Louis Browns,ORLS,3,3,4,7,1915,1933,18,15.16,48.24,33.08,1029,1956,927,3314,6681,3367,1643.0,3927.0,2284.0,15500.0,15500.0,0.0
jameb104,Bernie James,Dallas,Dallas,1,1,2,3,1932,1932,0,-0.06,0.0,0.06,60,0,-60,136,0,-136,0.0,0.0,0.0,0.0,0.0,0.0
jamec001,Chris James,Philadelphia Phillies,PHILS,1,1,2,3,1989,1994,5,-0.78,20.47,21.25,87,993,906,331,3735,3404,0.0,0.0,0.0,230000.0,820000.0,590000.0
jamec001,Chris James,San Diego Padres,PADRS,7,14,16,30,1989,1998,9,77.02,12.33,-64.69,5607,1502,-4105,22003,4193,-17810,1355.0,1888.0,533.0,8656667.0,4815000.0,-3841667.0
jamec001,Chris James,Houston Astros,ASTROS,1,1,1,2,1993,1993,0,1.89,0.0,-1.89,60,0,-60,193,0,-193,0.0,0.0,0.0,500000.0,0.0,-500000.0
jamec001,Chris James,Kansas City Royals,ROYALS,1,1,1,2,1995,1996,1,-0.13,0.0,0.13,16,0,-16,27,0,-27,0.0,0.0,0.0,310000.0,0.0,-310000.0
jamec102,Charlie James,St. Louis Cardinals,CARDS,1,2,1,3,1964,1966,2,-0.38,-2.37,-1.99,106,64,-42,54,43,-11,193.0,373.0,180.0,0.0,0.0,0.0
jamed001,Dion James,Milwaukee Brewers,BREWRS,1,1,1,2,1987,1988,1,3.14,-0.27,-3.41,329,7,-322,1223,17,-1206,0.0,0.0,0.0,0.0,0.0,0.0
jamed001,Dion James,Atlanta Braves,BRAVES,1,1,1,2,1989,1991,2,0.94,1.89,0.95,158,189,31,551,637,86,0.0,0.0,0.0,400000.0,375000.0,-25000.0
jamej001,Justin James,Toronto Blue Jays,BJAYS,1,1,1,2,2007,2009,2,0.0,0.07,0.07,0,8,8,0,6,6,0.0,0.0,0.0,0.0,0.0,0.0
jamej101,Johnny James,New York Yankees,YANKS,1,3,2,5,1961,1962,1,3.35,0.73,-2.62,729,113,-616,2005,155,-1850,725.0,95.0,-630.0,0.0,0.0,0.0
jamem001,Mike James,Los Angeles Dodgers,DOGRS,1,1,1,2,1993,1994,1,4.43,0.0,-4.43,188,0,-188,0,0,0,640.0,0.0,-640.0,0.0,0.0,0.0
jamic101,Charlie Jamieson,Philadelphia Athletics,ATLTCS,2,5,4,9,1919,1920,1,39.26,1.89,-37.37,2383,166,-2217,9666,676,-8990,678.0,0.0,-678.0,2400.0,0.0,-2400.0
janej101,Gerry Janeski,Chicago White Sox,WSOX,1,1,1,2,1971,1973,2,-0.45,1.62,2.07,54,285,231,19,1036,1017,223.0,0.0,-223.0,0.0,0.0,0.0
janip001,Paul Janish,Cincinnati Reds,REDS,1,1,1,2,2012,2013,1,-0.57,-0.2,0.37,107,2,-105,231,1,-230,0.0,10.0,10.0,0.0,0.0,0.0
jankt001,Travis Jankowski,San Diego Padres,PADRS,1,1,1,2,2019,2019,0,-0.28,0.0,0.28,16,0,-16,17,0,-17,0.0,0.0,0.0,1165000.0,0.0,-1165000.0
janvh101,Hal Janvrin,Boston Red Sox,RSOX,9,25,23,48,1912,1935,23,51.77,27.05,-24.72,3792,3039,-753,15081,11185,-3896,0.0,1203.0,1203.0,45050.0,29350.0,-15700.0
janvh101,Hal Janvrin,Boston Red Sox,RSOX,2,5,3,8,1919,1919,0,2.49,1.07,-1.42,628,159,-469,1976,592,-1384,282.0,106.0,-176.0,0.0,0.0,0.0
janvh101,Hal Janvrin,Washington Senators,TWINS,2,3,2,5,1919,1933,14,-0.15,16.16,16.31,11,1252,1241,23,5536,5513,0.0,0.0,0.0,34200.0,0.0,-34200.0
janvh101,Hal Janvrin,St. Louis Cardinals,CARDS,1,2,1,3,1921,1924,3,-0.25,4.34,4.59,114,209,95,179,222,43,183.0,1768.0,1585.0,5000.0,7500.0,2500.0
janzm001,Marty Janzen,New York Yankees,YANKS,1,3,1,4,1995,2000,5,-0.54,20.23,20.77,27,149,122,0,13,13,296.0,2766.0,2470.0,0.0,8000000.0,8000000.0
janzm001,Marty Janzen,Arizona Diamondbacks,DBACKS,2,3,2,5,1998,2004,6,-0.53,1.16,1.69,349,725,376,906,2569,1663,102.0,0.0,-102.0,750000.0,500000.0,-250000.0
jaraj001,Jason Jaramillo,Philadelphia Phillies,PHILS,2,2,2,4,2008,2009,1,-0.81,-0.18,0.63,119,47,-72,366,2,-364,0.0,88.0,88.0,0.0,423500.0,423500.0
jarvk001,Kevin Jarvis,San Diego Padres,PADRS,1,4,3,7,2004,2004,0,0.63,-0.51,-1.14,139,46,-93,232,85,-147,39.0,43.0,4.0,0.0,0.0,0.0
jarvp101,Pat Jarvis,Detroit Tigers,TIGRS,1,1,1,2,1963,1965,2,12.46,0.0,-12.46,442,0,-442,455,0,-455,3734.0,0.0,-3734.0,0.0,0.0,0.0
jarvp101,Pat Jarvis,Atlanta Braves,BRAVES,4,9,4,13,1973,1983,10,3.41,21.15,17.74,551,851,300,1018,2443,1425,1041.0,2934.0,1893.0,33500.0,0.0,-33500.0
jarvp101,Pat Jarvis,Montreal Expos,NATEX,3,4,3,7,1973,1978,5,19.9,0.29,-19.61,1883,303,-1580,6872,723,-6149,648.0,557.0,-91.0,40000.0,0.0,-40000.0
jarvr101,Ray Jarvis,Boston Red Sox,RSOX,6,13,11,24,1970,1987,17,23.72,33.07,9.35,1247,1904,657,3411,5540,2129,3997.0,6601.0,2604.0,192500.0,125000.0,-67500.0
jarvr102,Roy Jarvis,Pittsburgh Pirates,PIRATS,2,4,2,6,1949,1956,7,-0.28,3.82,4.1,38,374,336,9,242,233,117.0,2170.0,2053.0,0.0,0.0,0.0
jasoj001,John Jaso,Tampa Bay Devil Rays,RAYS,1,1,2,3,2011,2014,3,3.35,-0.8,-4.15,108,53,-55,361,0,-361,0.0,165.0,165.0,427200.0,414000.0,-13200.0
jasoj001,John Jaso,Seattle Mariners,MARNRS,2,2,2,4,2013,2014,1,2.61,-0.98,-3.59,181,76,-105,623,307,-316,0.0,0.0,0.0,0.0,0.0,0.0
jasoj001,John Jaso,Oakland Athletics,ATLTCS,7,12,9,21,2015,2018,3,7.5,-0.52,-8.02,615,193,-422,2031,464,-1567,103.0,312.0,209.0,8300001.0,4800000.0,-3500001.0
jastl101,Larry Jaster,Montreal Expos,NATEX,1,1,2,3,1969,1969,0,-0.48,0.0,0.48,38,0,-38,4,0,-4,104.0,0.0,-104.0,0.0,0.0,0.0
jatap101,Paul Jata,Detroit Tigers,TIGRS,1,1,1,2,1973,1975,2,0.0,0.28,0.28,0,43,43,0,159,159,0.0,0.0,0.0,0.0,0.0,0.0
javia101,Al Javier,Houston Astros,ASTROS,2,2,2,4,1977,1979,2,0.0,-0.57,-0.57,0,45,45,0,62,62,0.0,67.0,67.0,0.0,0.0,0.0
javij101,Julian Javier,Pittsburgh Pirates,PIRATS,2,3,3,6,1960,1962,2,13.99,2.03,-11.96,1772,159,-1613,6120,213,-5907,474.0,816.0,342.0,0.0,0.0,0.0
javij101,Julian Javier,St. Louis Cardinals,CARDS,1,1,1,2,1972,1972,0,-0.17,-0.47,-0.3,44,34,-10,100,3,-97,0.0,78.0,78.0,0.0,0.0,0.0
javis001,Stan Javier,St. Louis Cardinals,CARDS,1,2,3,5,1982,1982,0,3.76,0.0,-3.76,464,0,-464,1598,0,-1598,0.0,0.0,0.0,0.0,0.0,0.0
javis001,Stan Javier,New York Yankees,YANKS,3,7,8,15,1984,1993,9,53.43,36.99,-16.44,2484,1135,-1349,8455,3089,-5366,3002.0,2795.0,-207.0,2415000.0,2187766.0,-227234.0
javis001,Stan Javier,Oakland Athletics,ATLTCS,1,1,1,2,1990,1990,0,3.33,2.33,-1.0,281,93,-188,584,333,-251,0.0,0.0,0.0,310000.0,875000.0,565000.0
javis001,Stan Javier,Los Angeles Dodgers,DOGRS,1,1,2,3,1992,1992,0,1.64,0.0,-1.64,74,0,-74,313,0,-313,0.0,0.0,0.0,715000.0,175000.0,-540000.0
javis001,Stan Javier,San Francisco Giants,GIANTS,1,1,1,2,1999,1999,0,0.71,0.0,-0.71,20,0,-20,75,0,-75,0.0,0.0,0.0,1750000.0,0.0,-1750000.0
jay-j001,Jon Jay,St. Louis Cardinals,CARDS,2,3,4,7,2015,2019,4,0.8,6.31,5.51,114,418,304,413,1383,970,0.0,4.0,4.0,17125000.0,2000000.0,-15125000.0
jay-j001,Jon Jay,Kansas City Royals,ROYALS,1,1,2,3,2018,2018,0,-0.72,0.0,0.72,102,0,-102,377,0,-377,0.0,0.0,0.0,0.0,0.0,0.0
jay-j101,Joey Jay,Milwaukee Braves,BRAVES,2,3,3,6,1960,1969,9,11.93,7.0,-4.93,718,403,-315,1624,1494,-130,3308.0,0.0,-3308.0,0.0,14000.0,14000.0
jay-j101,Joey Jay,Cincinnati Reds,REDS,2,2,4,6,1966,1966,0,-1.04,-0.77,0.27,48,22,-26,26,11,-15,262.0,114.0,-148.0,0.0,35500.0,35500.0
jayem001,Myles Jaye,Toronto Blue Jays,BJAYS,1,2,1,3,2012,2012,0,-0.18,0.35,0.53,100,54,-46,0,0,0,330.0,131.0,-199.0,0.0,0.0,0.0
jayem001,Myles Jaye,Texas Rangers,RNGRS,1,2,1,3,2016,2016,0,-1.41,0.37,1.78,25,30,5,62,94,32,38.0,4.0,-34.0,0.0,0.0,0.0
jayem001,Myles Jaye,Chicago White Sox,WSOX,1,1,1,2,2015,2015,0,0.0,0.0,0.0,0,0,0,0,0,0,0.0,0.0,0.0,0.0,0.0,0.0
jeand001,Domingo Jean,Chicago White Sox,WSOX,1,3,1,4,1992,1994,2,12.77,-0.22,-12.99,326,200,-126,0,759,759,3273.0,0.0,-3273.0,0.0,0.0,0.0
jeand001,Domingo Jean,New York Yankees,YANKS,1,2,1,3,1993,1994,1,0.14,-0.35,-0.49,80,32,-48,134,0,-134,0.0,120.0,120.0,138000.0,900000.0,762000.0
jeand001,Domingo Jean,Houston Astros,ASTROS,1,1,1,2,1995,1995,0,0.0,0.0,0.0,0,0,0,0,0,0,0.0,0.0,0.0,0.0,0.0,0.0
jeffg001,Gregg Jefferies,New York Mets,METS,10,18,17,35,1991,2006,15,27.4,32.03,4.63,1969,2082,113,4193,3379,-814,2476.0,3605.0,1129.0,24814657.0,19134833.0,-5679824.0
jeffg001,Gregg Jefferies,Kansas City Royals,ROYALS,1,2,2,4,1993,1995,2,6.98,0.21,-6.77,245,278,33,1059,1031,-28,0.0,0.0,0.0,0.0,0.0,0.0
jeffg001,Gregg Jefferies,Philadelphia Phillies,PHILS,3,5,6,11,1998,2005,7,45.42,10.13,-35.29,1312,566,-746,5628,1576,-4052,0.0,291.0,291.0,19200000.0,12025000.0,-7175000.0
jeffh101,Hal Jeffcoat,Chicago Cubs,CUBS,6,11,10,21,1955,1965,10,12.98,7.53,-5.45,947,1198,251,1563,557,-1006,2818.0,2758.0,-60.0,0.0,0.0,0.0
jeffh101,Hal Jeffcoat,Cincinnati Reds,REDS,2,2,2,4,1959,1963,4,0.73,6.23,5.5,113,442,329,16,68,52,272.0,1124.0,852.0,0.0,0.0,0.0
jeffi101,Irv Jeffries,Cincinnati Reds,REDS,4,6,6,12,1933,1942,9,0.93,12.9,11.97,309,1107,798,770,4269,3499,264.0,0.0,-264.0,23000.0,0.0,-23000.0
jeffi101,Irv Jeffries,Philadelphia Phillies,PHILS,1,2,1,3,1934,1935,1,0.0,1.54,1.54,0,70,70,0,62,62,0.0,500.0,500.0,0.0,0.0,0.0
jeffj001,Jeremy Jeffress,Milwaukee Brewers,BREWRS,8,16,16,32,2010,2020,10,33.31,23.99,-9.32,2772,1309,-1463,10420,3997,-6423,777.0,2948.0,2171.0,20405500.0,10550000.0,-9855500.0
jeffj001,Jeremy Jeffress,Milwaukee Brewers,BREWRS,4,10,6,16,2016,2018,2,-0.21,7.76,7.97,1054,270,-784,3356,840,-2516,449.0,87.0,-362.0,2550000.0,9400000.0,6850000.0
jeffj001,Jeremy Jeffress,Texas Rangers,RNGRS,1,1,1,2,2017,2018,1,3.37,0.0,-3.37,276,0,-276,3,0,-3,460.0,0.0,-460.0,2100000.0,0.0,-2100000.0
jeffj101,Jesse Jefferson,Baltimore Orioles,ORLS,1,1,1,2,1975,1978,3,-2.47,-1.06,1.41,41,336,295,0,581,581,510.0,0.0,-510.0,0.0,0.0,0.0
jeffm001,Mike Jeffcoat,Cleveland Indians,INDINS,3,4,4,8,1985,1991,6,-3.07,1.08,4.15,232,262,30,182,266,84,443.0,1475.0,1032.0,0.0,500000.0,500000.0
jeffr001,Reggie Jefferson,Cincinnati Reds,REDS,5,7,6,13,1991,1998,7,0.56,-0.19,-0.75,687,300,-387,1385,823,-562,1638.0,269.0,-1369.0,399000.0,2483167.0,2084167.0
jeffr001,Reggie Jefferson,Cleveland Indians,INDINS,1,3,1,4,1993,2004,11,-0.2,30.23,30.43,237,1478,1241,811,6542,5731,0.0,0.0,0.0,1117500.0,1112500.0,-5000.0
jeffs001,Stan Jefferson,New York Mets,METS,12,24,21,45,1986,2006,20,25.44,47.58,22.14,2466,2918,452,5573,6399,826,2555.0,3756.0,1201.0,24986257.0,19799833.0,-5186424.0
jeffs001,Stan Jefferson,San Diego Padres,PADRS,1,3,2,5,1988,1992,4,-2.09,7.62,9.71,105,399,294,12,1044,1032,593.0,270.0,-323.0,375000.0,1500000.0,1125000.0
jeffs001,Stan Jefferson,New York Yankees,YANKS,3,3,3,6,1989,1997,8,1.26,5.66,4.4,101,249,148,155,0,-155,141.0,1029.0,888.0,690000.0,0.0,-690000.0
jelic001,Chris Jelic,Kansas City Royals,ROYALS,1,2,3,5,1987,1988,1,20.17,-0.31,-20.48,379,19,-360,466,21,-445,3628.0,141.0,-3487.0,0.0,0.0,0.0
jelts001,Steve Jeltz,Philadelphia Phillies,PHILS,1,1,1,2,1990,1993,3,-0.71,3.18,3.89,74,106,32,114,114,0,0.0,935.0,935.0,0.0,0.0,0.0
jenkf101,Fergie Jenkins,Philadelphia Phillies,PHILS,1,3,2,5,1966,1968,2,66.82,10.77,-56.05,1243,294,-949,2604,327,-2277,8021.0,2661.0,-5360.0,0.0,0.0,0.0
jenkf101,Fergie Jenkins,Chicago Cubs,CUBS,5,8,8,16,1973,1982,9,27.24,12.62,-14.62,966,1853,887,2596,6406,3810,4383.0,0.0,-4383.0,430000.0,24000.0,-406000.0
jenkf101,Fergie Jenkins,Texas Rangers,RNGRS,9,19,17,36,1975,1986,11,44.83,17.72,-27.11,2024,1355,-669,3128,3727,599,9799.0,2320.0,-7479.0,190000.0,250000.0,60000.0
jenkf101,Fergie Jenkins,Boston Red Sox,RSOX,1,1,2,3,1977,1977,0,11.05,0.0,-11.05,121,0,-121,0,0,0,2436.0,0.0,-2436.0,200000.0,0.0,-200000.0
jenkt001,Tyrell Jenkins,St. Louis Cardinals,CARDS,1,2,2,4,2014,2016,2,3.49,7.42,3.93,93,178,85,88,610,522,772.0,31.0,-741.0,521000.0,5990000.0,5469000.0
jenkt001,Tyrell Jenkins,Atlanta Braves,BRAVES,1,2,1,3,2016,2018,2,0.0,0.11,0.11,0,152,152,0,6,6,0.0,274.0,274.0,0.0,0.0,0.0
jenkt101,Tom Jenkins,St.Louis Browns,ORLS,1,1,1,2,1932,1932,0,0.0,-0.2,-0.2,0,18,18,0,24,24,0.0,0.0,0.0,4000.0,0.0,-4000.0
jenkt101,Tom Jenkins,Boston Red Sox,RSOX,1,3,1,4,1926,1926,0,0.0,-0.79,-0.79,0,31,31,0,103,103,0.0,0.0,0.0,7100.0,0.0,-7100.0
jennd003,Dan Jennings,Miami Marlins,MARLNS,1,1,1,2,2014,2016,2,2.32,-0.31,-2.63,173,27,-146,0,2,2,484.0,59.0,-425.0,501500.0,0.0,-501500.0
jennd003,Dan Jennings,Chicago White Sox,WSOX,1,1,1,2,2017,2017,0,0.28,0.0,-0.28,32,0,-32,0,0,0,55.0,0.0,-55.0,1400000.0,0.0,-1400000.0
jennh101,Hughie Jennings,Louisville Colonels,LS3,1,2,1,3,1893,1894,1,35.58,1.66,-33.92,755,147,-608,3472,687,-2785,0.0,0.0,0.0,0.0,0.0,0.0
jennh101,Hughie Jennings,Brooklyn Dodgers,DOGRS,1,1,2,3,1899,1901,2,0.13,-0.36,-0.49,2,87,85,8,281,273,0.0,204.0,204.0,0.0,0.0,0.0
jennh101,Hughie Jennings,Brooklyn Dodgers,DOGRS,1,4,1,5,1903,1908,5,0.0,0.0,0.0,0,0,0,0,0,0,0.0,0.0,0.0,0.0,0.0,0.0
jennj001,Jason Jennings,Colorado Rockies,ROCKS,1,2,3,5,2006,2010,4,-0.73,4.59,5.32,38,489,451,30,1012,982,297.0,873.0,576.0,4500000.0,727000.0,-3773000.0
jennr001,Robin Jennings,Oakland Athletics,ATLTCS,1,1,1,2,2001,2001,0,-0.19,-0.02,0.17,1,34,33,3,93,90,0.0,0.0,0.0,290000.0,1750000.0,1460000.0
jennr001,Robin Jennings,Colorado Rockies,ROCKS,2,5,4,9,2001,2002,1,3.51,-0.39,-3.9,333,251,-82,1296,922,-374,0.0,3.0,3.0,1050000.0,1600000.0,550000.0
jensj101,Jackie Jensen,Oakland,Oakland,1,2,2,4,1949,1951,2,6.53,0.0,-6.53,635,0,-635,2176,0,-2176,0.0,0.0,0.0,0.0,0.0,0.0
jensj101,Jackie Jensen,New York Yankees,YANKS,7,19,15,34,1952,1970,18,13.22,40.85,27.63,2406,2911,505,6464,7208,744,3937.0,4978.0,1041.0,115500.0,43000.0,-72500.0
jensj101,Jackie Jensen,Washington Senators,TWINS,14,26,27,53,1953,1963,10,37.46,-3.27,-40.73,2533,3473,940,8910,8941,31,1213.0,3299.0,2086.0,38500.0,14000.0,-24500.0
jensk001,Kyle Jensen,Miami Marlins,MARLNS,1,1,1,2,2014,2014,0,0.0,0.0,0.0,0,0,0,0,0,0,0.0,0.0,0.0,0.0,0.0,0.0
jensm001,Marcus Jensen,San Francisco Giants,GIANTS,1,1,1,2,1997,1998,1,-0.08,2.15,2.23,8,155,147,12,547,535,0.0,0.0,0.0,151500.0,600000.0,448500.0
jepsk001,Kevin Jepsen,Anaheim Angels,ANGELS,1,1,1,2,2014,2015,1,0.38,-0.85,-1.23,79,93,14,0,284,284,182.0,0.0,-182.0,1462500.0,3700000.0,2237500.0
jepsk001,Kevin Jepsen,Tampa Bay Devil Rays,RAYS,2,2,3,5,2015,2018,3,0.73,0.22,-0.51,63,11,-52,0,0,0,176.0,69.0,-107.0,3025000.0,0.0,-3025000.0
jerew001,Williams Jerez,Boston Red Sox,RSOX,1,2,2,4,2018,2018,0,0.49,-0.14,-0.63,139,37,-102,0,143,143,390.0,0.0,-390.0,0.0,11000000.0,11000000.0
jerew001,Williams Jerez,Anaheim Angels,ANGELS,1,1,1,2,2019,2019,0,0.17,-0.68,-0.85,12,8,-4,0,2,2,20.0,88.0,68.0,0.0,0.0,0.0
jestg101,Garry Jestadt,Montreal Expos,NATEX,2,2,2,4,1970,1971,1,-0.14,0.08,0.22,3,58,55,3,127,124,0.0,0.0,0.0,0.0,0.0,0.0
jestg101,Garry Jestadt,Chicago Cubs,CUBS,1,1,1,2,1971,1971,0,0.07,0.1,0.03,167,71,-96,484,234,-250,0.0,0.0,0.0,0.0,0.0,0.0
jetej101,Johnny Jeter,Pittsburgh Pirates,PIRATS,1,2,1,3,1971,1973,2,1.19,1.07,-0.12,236,104,-132,456,7,-449,405.0,247.0,-158.0,0.0,0.0,0.0
jetej101,Johnny Jeter,San Diego Padres,PADRS,1,1,1,2,1972,1975,3,-1.06,-1.06,0.0,89,206,117,313,26,-287,0.0,476.0,476.0,17000.0,27000.0,10000.0
jetej101,Johnny Jeter,Chicago White Sox,WSOX,2,3,2,5,1974,1976,2,-0.47,0.75,1.22,8,206,198,18,720,702,13.0,0.0,-13.0,0.0,0.0,0.0
jetes001,Shawn Jeter,Toronto Blue Jays,BJAYS,1,2,1,3,1991,1991,0,-0.18,-0.65,-0.47,19,21,2,18,54,36,15.0,0.0,-15.0,0.0,800000.0,800000.0
jeths101,Sam Jethroe,Brooklyn Dodgers,DOGRS,1,2,3,5,1949,1949,0,8.82,0.0,-8.82,541,0,-541,2215,0,-2215,0.0,0.0,0.0,0.0,0.0,0.0
jeths101,Sam Jethroe,Milwaukee Braves,BRAVES,2,10,2,12,1953,1960,7,8.19,12.74,4.55,794,729,-65,1824,3040,1216,2135.0,0.0,-2135.0,0.0,42000.0,42000.0
jimed001,D'Angelo Jimenez,New York Yankees,YANKS,2,2,2,4,2001,2002,1,2.93,0.22,-2.71,260,119,-141,711,245,-466,209.0,121.0,-88.0,0.0,800000.0,800000.0
jimed001,D'Angelo Jimenez,San Diego Padres,PADRS,3,5,5,10,2002,2005,3,1.02,-1.33,-2.35,447,97,-350,1468,112,-1356,24.0,184.0,160.0,4215000.0,3000000.0,-1215000.0
jimed001,D'Angelo Jimenez,Chicago White Sox,WSOX,2,4,3,7,2003,2004,1,5.63,0.32,-5.31,281,41,-240,1102,2,-1100,90.0,416.0,326.0,675000.0,1425000.0,750000.0
jimee001,Eloy Jimenez,Chicago Cubs,CUBS,1,4,1,5,2017,2020,3,6.48,3.51,-2.97,293,156,-137,969,150,-819,891.0,1319.0,428.0,0.0,0.0,0.0
jimej001,Jose Jimenez,St. Louis Cardinals,CARDS,2,6,4,10,1999,2003,4,3.2,2.78,-0.42,870,638,-232,626,106,-520,1171.0,1638.0,467.0,860000.0,10709647.0,9849647.0
jimem101,Manny Jimenez,Milwaukee Braves,BRAVES,11,17,20,37,1961,1973,12,24.16,33.51,9.35,2325,1915,-410,6983,5059,-1924,2257.0,3206.0,949.0,95000.0,38000.0,-57000.0
jimem101,Manny Jimenez,Pittsburgh Pirates,PIRATS,1,1,2,3,1969,1970,1,0.0,0.26,0.26,6,146,140,6,17,11,0.0,358.0,358.0,0.0,0.0,0.0
jimeu001,Ubaldo Jimenez,Colorado Rockies,ROCKS,3,5,8,13,2011,2015,4,3.72,1.36,-2.36,158,373,215,10,263,253,1739.0,1188.0,-551.0,2800000.0,6265500.0,3465500.0
jodib001,Brett Jodie,New York Yankees,YANKS,3,4,4,8,2001,2007,6,0.42,0.27,-0.15,30,179,149,18,0,-18,184.0,789.0,605.0,6000000.0,6000000.0,0.0
joe-c001,Connor Joe,Pittsburgh Pirates,PIRATS,1,1,1,2,2017,2018,1,0.0,-0.61,-0.61,0,105,105,0,279,279,0.0,0.0,0.0,0.0,0.0,0.0
joe-c001,Connor Joe,Atlanta Braves,BRAVES,1,1,1,2,2017,2017,0,0.0,0.0,0.0,0,0,0,0,0,0,0.0,0.0,0.0,0.0,0.0,0.0
joe-c001,Connor Joe,Cincinnati Reds,REDS,1,1,2,3,2019,2019,0,-0.11,0.0,0.11,8,0,-8,16,0,-16,0.0,0.0,0.0,0.0,0.0,0.0
johna101,Augie Johns,FortWorth,FortWorth,1,2,2,4,1925,1925,0,-0.54,0.0,0.54,83,0,-83,54,0,-54,341.0,0.0,-341.0,0.0,0.0,0.0
johna104,Alex Johnson,Philadelphia Phillies,PHILS,9,17,16,33,1965,1984,19,32.54,23.78,-8.76,2044,2671,627,6114,5833,-281,1729.0,2166.0,437.0,32000.0,138000.0,106000.0
johna104,Alex Johnson,St. Louis Cardinals,CARDS,5,11,8,19,1968,1972,4,17.08,2.08,-15.0,1534,302,-1232,2656,673,-1983,1865.0,299.0,-1566.0,32500.0,24000.0,-8500.0
johna104,Alex Johnson,Cincinnati Reds,REDS,9,11,14,25,1969,1988,19,6.47,49.11,42.64,1174,3400,2226,3915,6767,2852,279.0,5781.0,5502.0,18500.0,0.0,-18500.0
johna104,Alex Johnson,California Angels,ANGELS,2,3,5,8,1971,1974,3,-0.38,1.97,2.35,378,289,-89,1313,1028,-285,0.0,88.0,88.0,15000.0,86500.0,71500.0
johna104,Alex Johnson,Cleveland Indians,INDINS,1,1,2,3,1973,1974,1,1.79,0.0,-1.79,272,0,-272,1149,0,-1149,0.0,0.0,0.0,0.0,0.0,0.0
johnb001,Bill Johnson,Philadelphia Phillies,PHILS,4,8,7,15,1983,1989,6,22.89,10.28,-12.61,2046,1011,-1035,3682,3184,-498,3936.0,302.0,-3634.0,1629900.0,750000.0,-879900.0
johnb002,Brian Johnson,San Diego Padres,PADRS,2,3,3,6,1996,1997,1,2.37,0.0,-2.37,183,0,-183,158,0,-158,1473.0,0.0,-1473.0,920000.0,0.0,-920000.0
johnb002,Brian Johnson,Detroit Tigers,TIGRS,1,1,1,2,1997,1998,1,2.15,-0.08,-2.23,155,8,-147,547,12,-535,0.0,0.0,0.0,600000.0,151500.0,-448500.0
johnb003,Ben Johnson,St. Louis Cardinals,CARDS,1,2,2,4,2000,2000,0,0.41,0.16,-0.25,133,17,-116,223,58,-165,57.0,0.0,-57.0,1600000.0,1750000.0,150000.0
johnb003,Ben Johnson,San Diego Padres,PADRS,2,3,4,7,2006,2011,5,-1.25,8.23,9.48,114,791,677,30,16,-14,85.0,1373.0,1288.0,327500.0,0.0,-327500.0
johnb102,Bob Johnson,Philadelphia Athletics,ATLTCS,1,1,3,4,1943,1949,6,3.2,7.97,4.77,117,391,274,505,1546,1041,0.0,0.0,0.0,0.0,0.0,0.0
johnb103,Bob Johnson,New York Mets,METS,1,2,1,3,1969,1970,1,49.09,1.86,-47.23,1971,99,-1872,8041,399,-7642,642.0,0.0,-642.0,0.0,25000.0,25000.0
johnb103,Bob Johnson,Kansas City Royals,ROYALS,2,6,5,11,1970,1979,9,2.78,26.16,23.38,582,1576,994,670,5382,4712,1583.0,1688.0,105.0,34500.0,38500.0,4000.0
johnb103,Bob Johnson,Pittsburgh Pirates,PIRATS,1,1,1,2,1973,1973,0,-0.35,0.0,0.35,14,0,-14,0,0,0,216.0,0.0,-216.0,38000.0,0.0,-38000.0
johnb104,Bob Johnson,Washington Senators,RNGRS,2,3,4,7,1962,1964,2,2.63,0.81,-1.82,369,114,-255,1015,218,-797,22.0,175.0,153.0,0.0,7000.0,7000.0
johnb104,Bob Johnson,New York Mets,METS,2,5,5,10,1967,1975,8,1.95,7.19,5.24,260,746,486,66,1625,1559,763.0,880.0,117.0,0.0,0.0,0.0
johnb104,Bob Johnson,Cincinnati Reds,REDS,3,5,6,11,1968,1977,9,4.56,11.78,7.22,256,1321,1065,307,585,278,1267.0,4200.0,2933.0,0.0,0.0,0.0
johnb104,Bob Johnson,Atlanta Braves,BRAVES,2,2,2,4,1969,1969,0,-0.21,0.0,0.21,19,0,-19,32,0,-32,0.0,0.0,0.0,0.0,12000.0,12000.0
johnb104,Bob Johnson,St. Louis Cardinals,CARDS,1,1,1,2,1969,1971,2,0.47,0.02,-0.45,81,10,-71,123,6,-117,0.0,0.0,0.0,0.0,0.0,0.0
johnb107,Ben Johnson,Milwaukee Braves,BRAVES,2,7,3,10,1957,1961,4,-1.07,-0.69,0.38,281,102,-179,637,325,-312,138.0,0.0,-138.0,0.0,0.0,0.0
johnb107,Ben Johnson,Houston Astros,ASTROS,1,1,1,2,1962,1963,1,0.0,-0.49,-0.49,0,44,44,0,22,22,0.0,200.0,200.0,0.0,0.0,0.0
johnb108,Billy Johnson,New York Yankees,YANKS,17,46,40,86,1951,1970,19,53.19,79.46,26.27,7246,4796,-2450,23560,11518,-12042,3607.0,11554.0,7947.0,331250.0,125500.0,-205750.0
johnc001,Cliff Johnson,Houston Astros,ASTROS,5,8,8,16,1977,1987,10,32.76,10.5,-22.26,2646,1146,-1500,8964,3347,-5617,147.0,300.0,153.0,450000.0,0.0,-450000.0
johnc001,Cliff Johnson,New York Yankees,YANKS,1,1,1,2,1979,1979,0,1.11,1.33,0.22,126,27,-99,477,0,-477,0.0,202.0,202.0,0.0,0.0,0.0
johnc001,Cliff Johnson,Cleveland Indians,INDINS,1,1,2,3,1980,1983,3,-0.08,0.22,0.3,68,45,-23,227,64,-163,0.0,0.0,0.0,0.0,0.0,0.0
johnc001,Cliff Johnson,Chicago Cubs,CUBS,2,3,2,5,1980,1982,2,1.71,0.0,-1.71,188,0,-188,646,0,-646,0.0,0.0,0.0,0.0,0.0,0.0
johnc001,Cliff Johnson,Oakland Athletics,ATLTCS,1,1,1,2,1982,1983,1,5.46,0.0,-5.46,400,0,-400,1376,0,-1376,0.0,0.0,0.0,0.0,0.0,0.0
johnc001,Cliff Johnson,Texas Rangers,RNGRS,2,2,4,6,1985,1987,2,0.73,0.93,0.2,131,6,-125,477,0,-477,0.0,78.0,78.0,683333.0,0.0,-683333.0
johnc002,Charles Johnson,Florida Marlins,MARLNS,15,33,38,71,1998,2019,21,116.45,94.42,-22.03,4698,5470,772,15425,16217,792,10496.0,10160.0,-336.0,68580667.0,35694968.0,-32885699.0
johnc002,Charles Johnson,Los Angeles Dodgers,DOGRS,1,2,2,4,1998,2000,2,1.05,2.33,1.28,452,204,-248,1614,781,-833,0.0,0.0,0.0,280000.0,4925000.0,4645000.0
johnc002,Charles Johnson,New York Mets,METS,2,2,4,6,1998,2006,8,6.33,9.77,3.44,228,661,433,812,7,-805,28.0,1073.0,1045.0,6937500.0,1400000.0,-5537500.0
johnc002,Charles Johnson,Baltimore Orioles,ORLS,1,2,4,6,2000,2003,3,0.48,0.13,-0.35,100,312,212,320,1036,716,0.0,0.0,0.0,6600000.0,675000.0,-5925000.0
johnc002,Charles Johnson,Florida Marlins,MARLNS,4,9,11,20,2002,2015,13,11.51,22.72,11.21,893,1533,640,2983,2710,-273,1797.0,5078.0,3281.0,13177000.0,10303543.0,-2873457.0
johnc002,Charles Johnson,Colorado Rockies,ROCKS,2,3,3,6,2005,2007,2,-0.15,1.77,1.92,44,250,206,39,105,66,329.0,1085.0,756.0,2500000.0,3600000.0,1100000.0
johnc003,Chris Johnson,Houston Astros,ASTROS,1,1,2,3,2012,2014,2,0.46,-0.6,-1.06,44,119,75,160,354,194,0.0,0.0,0.0,495000.0,0.0,-495000.0
johnc003,Chris Johnson,Arizona Diamondbacks,DBACKS,5,9,11,20,2013,2019,6,9.33,5.76,-3.57,709,1160,451,2798,2556,-242,0.0,1347.0,1347.0,0.0,0.0,0.0
johnc003,Chris Johnson,Atlanta Braves,BRAVES,1,1,3,4,2015,2016,1,-0.23,-0.91,-0.68,27,92,65,93,305,212,0.0,0.0,0.0,0.0,0.0,0.0
johnc103,Connie Johnson,Chicago White Sox,WSOX,2,5,3,8,1956,1961,5,20.82,6.19,-14.63,1000,561,-439,2990,1443,-1547,2136.0,479.0,-1657.0,62000.0,42500.0,-19500.0
johnd001,Dave Johnson,Houston Astros,ASTROS,1,2,1,3,1989,1991,2,0.47,-0.34,-0.81,66,60,-6,0,130,130,1060.0,0.0,-1060.0,0.0,0.0,0.0
johnd005,DJ Johnson,Cleveland Indians,INDINS,1,2,1,3,2021,2021,0,0.29,0.0,-0.29,29,0,-29,72,0,-72,11.0,0.0,-11.0,0.0,0.0,0.0
johnd006,Daniel Johnson,Washington Nationals,NATEX,2,6,4,10,2018,2021,3,-0.4,4.3,4.7,134,190,56,433,712,279,140.0,0.0,-140.0,7000000.0,6033333.0,-966667.0
johnd101,Don Johnson,Milwaukee,Milwaukee,2,2,7,9,1943,1944,1,6.7,0.0,-6.7,673,0,-673,2771,0,-2771,0.0,0.0,0.0,0.0,3000.0,3000.0
johnd102,Don Johnson,New York Yankees,YANKS,2,8,4,12,1950,1954,4,21.38,0.72,-20.66,1235,437,-798,2252,180,-2072,6559.0,1785.0,-4774.0,29000.0,8500.0,-20500.0
johnd102,Don Johnson,Toronto,Toronto,1,1,1,2,1953,1953,0,1.41,0.0,-1.41,92,0,-92,45,0,-45,432.0,0.0,-432.0,0.0,0.0,0.0
johnd102,Don Johnson,Chicago White Sox,WSOX,29,56,55,111,1954,1971,17,64.71,122.48,57.77,7633,8254,621,20626,20005,-621,7158.0,13512.0,6354.0,248750.0,225500.0,-23250.0
johnd102,Don Johnson,Toronto,Toronto,1,1,1,2,1958,1958,0,-0.49,0.0,0.49,34,0,-34,3,0,-3,69.0,0.0,-69.0,0.0,0.0,0.0
johnd103,Deron Johnson,New York Yankees,YANKS,3,6,4,10,1961,1966,5,-0.26,3.2,3.46,405,420,15,1128,119,-1009,748.0,1424.0,676.0,84000.0,27500.0,-56500.0
johnd103,Deron Johnson,Cincinnati Reds,REDS,2,2,5,7,1967,1970,3,-0.9,0.5,1.4,158,233,75,412,406,-6,0.0,170.0,170.0,0.0,23500.0,23500.0
johnd103,Deron Johnson,Philadelphia Phillies,PHILS,1,1,1,2,1973,1973,0,0.62,0.0,-0.62,181,0,-181,718,0,-718,0.0,0.0,0.0,0.0,0.0,0.0
johnd103,Deron Johnson,Oakland Athletics,ATLTCS,1,1,2,3,1974,1974,0,-0.96,0.11,1.07,49,4,-45,174,0,-174,0.0,6.0,6.0,75000.0,0.0,-75000.0
johnd103,Deron Johnson,Chicago White Sox,WSOX,1,1,2,3,1975,1975,0,-0.13,0.0,0.13,18,0,-18,55,0,-55,0.0,0.0,0.0,0.0,0.0,0.0
johnd105,Davey Johnson,Baltimore Orioles,ORLS,6,18,15,33,1972,1988,16,21.6,72.74,51.14,1757,3477,1720,3464,7736,4272,7768.0,11016.0,3248.0,691833.0,37000.0,-654833.0
johnd105,Davey Johnson,Philadelphia Phillies,PHILS,1,1,1,2,1978,1979,1,0.52,0.0,-0.52,24,0,-24,56,0,-56,0.0,0.0,0.0,0.0,0.0,0.0
johnd106,Darrell Johnson,St.Louis Browns,ORLS,26,67,67,134,1952,1988,36,99.12,172.68,73.56,7104,11773,4669,15396,35136,19740,24196.0,16005.0,-8191.0,841333.0,150400.0,-690933.0
johnd106,Darrell Johnson,Chicago White Sox,WSOX,7,12,13,25,1953,1969,16,11.99,30.83,18.84,1538,1586,48,4583,5396,813,1710.0,1860.0,150.0,87250.0,45000.0,-42250.0
johnd106,Darrell Johnson,Baltimore Orioles,ORLS,15,37,36,73,1954,1988,34,52.13,133.41,81.28,3638,7388,3750,6759,20843,14084,14284.0,13293.0,-991.0,815833.0,128400.0,-687433.0
johnd107,Doc Johnston,NewOrleans,NewOrleans,2,2,9,11,1912,1915,3,1.74,0.0,-1.74,769,0,-769,2920,0,-2920,303.0,0.0,-303.0,0.0,0.0,0.0
johnd107,Doc Johnston,Pittsburgh Pirates,PIRATS,3,8,4,12,1916,1922,6,39.97,14.79,-25.18,1164,990,-174,2135,3762,1627,8893.0,711.0,-8182.0,9650.0,5000.0,-4650.0
johne002,Elliot Johnson,Tampa Bay Devil Rays,RAYS,8,14,20,34,2012,2020,8,32.69,16.85,-15.84,1967,1086,-881,5025,2972,-2053,4433.0,3274.0,-1159.0,6379200.0,6506400.0,127200.0
johne003,Erik Johnson,Chicago White Sox,WSOX,1,2,2,4,2016,2018,2,12.87,0.14,-12.73,280,82,-198,1180,11,-1169,59.0,1308.0,1249.0,0.0,0.0,0.0
johne102,Ernie Johnson,New York Yankees,YANKS,2,6,4,10,1925,1931,6,-1.14,6.67,7.81,271,713,442,761,2895,2134,731.0,97.0,-634.0,31500.0,18000.0,-13500.0
johnh001,Howard Johnson,Detroit Tigers,TIGRS,3,3,4,7,1984,1990,6,22.15,8.04,-14.11,1225,259,-966,4746,406,-4340,370.0,2975.0,2605.0,2148333.0,1619333.0,-529000.0
johnh101,Hank Johnson,New York Yankees,YANKS,1,3,1,4,1932,1934,2,4.01,-1.32,-5.33,261,128,-133,217,129,-88,1777.0,923.0,-854.0,12000.0,8500.0,-3500.0
johnh101,Hank Johnson,Boston Red Sox,RSOX,7,17,15,32,1936,1956,20,19.89,33.66,13.77,2712,2773,61,8706,8806,100,4863.0,6247.0,1384.0,147000.0,69122.0,-77878.0
johnh101,Hank Johnson,Cincinnati Reds,REDS,1,1,1,2,1941,1941,0,0.0,0.0,0.0,0,0,0,0,0,0,0.0,0.0,0.0,0.0,0.0,0.0
johnj001,John Henry Johnson,San Francisco Giants,GIANTS,4,14,8,22,1978,1992,14,8.18,23.62,15.44,767,1277,510,1656,1600,-56,2714.0,7759.0,5045.0,0.0,0.0,0.0
johnj001,John Henry Johnson,Oakland Athletics,ATLTCS,2,3,4,7,1979,1987,8,-0.45,7.67,8.12,210,832,622,273,2903,2630,902.0,648.0,-254.0,425000.0,1030000.0,605000.0
johnj001,John Henry Johnson,Texas Rangers,RNGRS,2,4,2,6,1982,1986,4,8.84,11.32,2.48,276,455,179,0,1715,1715,4307.0,810.0,-3497.0,0.0,250000.0,250000.0
johnj002,Jay Johnstone,California Angels,ANGELS,8,17,17,34,1970,1976,6,13.31,15.37,2.06,1179,1226,47,3267,3750,483,2333.0,345.0,-1988.0,137100.0,240300.0,103200.0
johnj002,Jay Johnstone,Philadelphia Phillies,PHILS,1,2,1,3,1978,1980,2,1.16,-1.2,-2.36,257,146,-111,709,10,-699,0.0,369.0,369.0,0.0,220000.0,220000.0
johnj002,Jay Johnstone,New York Yankees,YANKS,1,1,1,2,1979,1980,1,-0.02,0.0,0.02,75,0,-75,225,0,-225,0.0,0.0,0.0,0.0,0.0,0.0
johnj003,Joe Johnson,Atlanta Braves,BRAVES,3,4,4,8,1986,1993,7,2.29,5.2,2.91,177,785,608,6,431,425,1160.0,1516.0,356.0,958000.0,1071500.0,113500.0
johnj005,Joel Johnston,Kansas City Royals,ROYALS,1,2,1,3,1992,1995,3,-0.61,-1.65,-1.04,94,250,156,7,880,873,219.0,0.0,-219.0,113500.0,2000000.0,1886500.0
johnj007,Jason Johnson,Tampa Bay Devil Rays,RAYS,1,1,2,3,1999,1999,0,4.13,-0.26,-4.39,143,28,-115,20,89,69,2220.0,0.0,-2220.0,0.0,0.0,0.0
johnj009,Josh Johnson,Miami Marlins,MARLNS,12,33,32,65,2012,2020,8,57.99,24.95,-33.04,3997,2605,-1392,9990,7444,-2546,7539.0,4278.0,-3261.0,66200000.0,34658100.0,-31541900.0
johnj010,Jim Johnson,Baltimore Orioles,ORLS,2,3,4,7,2013,2015,2,-1.09,-0.11,0.98,58,22,-36,42,58,16,121.0,0.0,-121.0,7015000.0,0.0,-7015000.0
johnj010,Jim Johnson,Atlanta Braves,BRAVES,3,7,11,18,2015,2020,5,4.88,-1.29,-6.17,588,465,-123,687,1320,633,1642.0,246.0,-1396.0,24400000.0,34929500.0,10529500.0
johnj010,Jim Johnson,Atlanta Braves,BRAVES,1,2,1,3,2017,2017,0,-0.5,0.0,0.5,64,0,-64,0,0,0,190.0,0.0,-190.0,5000000.0,0.0,-5000000.0
johnj102,Jing Johnson,Philadelphia Athletics,ATLTCS,2,4,3,7,1928,1935,7,3.62,18.26,14.64,76,599,523,105,1064,959,735.0,4060.0,3325.0,13500.0,8000.0,-5500.0
johnj103,Johnny Johnson,New York Yankees,YANKS,1,1,1,2,1944,1946,2,-0.17,0.97,1.14,58,26,-32,18,10,-8,209.0,106.0,-103.0,4000.0,5600.0,1600.0
johnj104,Jerry Johnson,Philadelphia Phillies,PHILS,5,9,11,20,1969,1977,8,2.27,5.62,3.35,374,740,366,889,1587,698,321.0,625.0,304.0,70000.0,163500.0,93500.0
johnj104,Jerry Johnson,St. Louis Cardinals,CARDS,2,2,2,4,1970,1972,2,-1.07,3.11,4.18,433,194,-239,50,11,-39,1164.0,362.0,-802.0,0.0,0.0,0.0
johnj104,Jerry Johnson,Cleveland Indians,INDINS,6,11,13,24,1973,1980,7,19.32,1.28,-18.04,1402,446,-956,4059,397,-3662,2493.0,2986.0,493.0,69000.0,65000.0,-4000.0
johnj104,Jerry Johnson,San Diego Padres,PADRS,6,13,11,24,1977,1989,12,40.45,8.76,-31.69,3307,1362,-1945,10982,3847,-7135,2267.0,1127.0,-1140.0,475000.0,0.0,-475000.0
johnj106,Johnny Johnston,Montgomery,Montgomery,1,3,2,5,1912,1913,1,-0.14,0.0,0.14,252,0,-252,843,0,-843,0.0,0.0,0.0,0.0,0.0,0.0
johnj107,Jimmy Johnston,Brooklyn Dodgers,DOGRS,2,5,4,9,1925,1927,2,6.65,0.24,-6.41,787,339,-448,3022,1227,-1795,0.0,0.0,0.0,27500.0,4800.0,-22700.0
johnj107,Jimmy Johnston,Oakland,Oakland,1,1,3,4,1915,1916,1,17.76,0.0,-17.76,1266,0,-1266,5372,0,-5372,0.0,0.0,0.0,0.0,3000.0,3000.0
johnk001,Keith Johns,St. Louis Cardinals,CARDS,1,1,1,2,1997,1998,1,0.0,0.0,0.0,0,0,0,0,0,0,0.0,0.0,0.0,0.0,0.0,0.0
johnk001,Keith Johns,Baltimore Orioles,ORLS,1,1,1,2,1998,1998,0,0.01,0.0,-0.01,2,0,-2,1,0,-1,0.0,0.0,0.0,0.0,0.0,0.0
johnk003,Kelly Johnson,Arizona Diamondbacks,DBACKS,3,8,6,14,2011,2019,8,33.46,18.13,-15.33,1227,834,-393,4470,3096,-1374,1784.0,544.0,-1240.0,8450000.0,7544000.0,-906000.0
johnk003,Kelly Johnson,New York Yankees,YANKS,1,1,2,3,2014,2015,1,-0.18,-0.66,-0.48,10,177,167,25,583,558,0.0,0.0,0.0,3000000.0,10100000.0,7100000.0
johnk003,Kelly Johnson,Boston Red Sox,RSOX,1,2,2,4,2014,2015,1,-0.08,0.24,0.32,19,17,-2,45,41,-4,0.0,0.0,0.0,0.0,515000.0,515000.0
johnk003,Kelly Johnson,Atlanta Braves,BRAVES,5,11,7,18,2015,2021,6,3.57,1.27,-2.3,479,157,-322,663,322,-341,932.0,563.0,-369.0,21307500.0,11500000.0,-9807500.0
johnk003,Kelly Johnson,Atlanta Braves,BRAVES,2,3,2,5,2016,2018,2,0.73,0.3,-0.43,92,16,-76,201,0,-201,42.0,22.0,-20.0,0.0,0.0,0.0
johnk004,Kris Johnson,Pittsburgh Pirates,PIRATS,1,1,1,2,2013,2014,1,0.24,0.04,-0.2,4,2,-2,1,0,-1,40.0,4.0,-36.0,0.0,0.0,0.0
johnk101,Ken Johnson,St. Louis Cardinals,CARDS,1,1,1,2,1950,1950,0,0.46,-0.3,-0.76,91,7,-84,57,23,-34,500.0,0.0,-500.0,0.0,0.0,0.0
johnk102,Ken Johnson,Toronto,Toronto,1,1,2,3,1961,1961,0,1.5,0.0,-1.5,30,0,-30,26,0,-26,249.0,0.0,-249.0,0.0,0.0,0.0
johnk102,Ken Johnson,Houston Astros,ASTROS,5,7,7,14,1965,1978,13,10.97,1.23,-9.74,645,1545,900,1174,5736,4562,2468.0,122.0,-2346.0,0.0,29000.0,29000.0
johnl001,Lance Johnson,St. Louis Cardinals,CARDS,1,3,1,4,1988,1992,4,20.88,6.84,-14.04,997,319,-678,3820,320,-3500,328.0,2753.0,2425.0,0.0,0.0,0.0
johnl001,Lance Johnson,New York Mets,METS,7,15,13,28,1997,2005,8,5.2,5.1,-0.1,1347,1947,600,1609,2988,1379,2422.0,1675.0,-747.0,19588333.0,14951666.0,-4636667.0
johnl103,Larry Johnson,Cleveland Indians,INDINS,1,1,1,2,1975,1975,0,-0.14,0.0,0.14,7,0,-7,18,0,-18,0.0,0.0,0.0,0.0,0.0,0.0
johnl103,Larry Johnson,Baltimore Orioles,ORLS,1,3,2,5,1980,1980,0,0.0,0.0,0.0,0,0,0,0,0,0,0.0,0.0,0.0,0.0,0.0,0.0
johnl104,Lou Johnson,Chicago Cubs,CUBS,1,1,1,2,1961,1961,0,-0.49,0.03,0.52,68,11,-57,148,11,-137,0.0,0.0,0.0,0.0,0.0,0.0
johnl104,Lou Johnson,Los Angeles Angels,ANGELS,3,3,5,8,1961,1970,9,4.21,10.03,5.82,770,881,111,2474,2911,437,542.0,509.0,-33.0,20000.0,0.0,-20000.0
johnl104,Lou Johnson,Milwaukee Braves,BRAVES,2,3,3,6,1963,1963,0,-1.36,0.0,1.36,58,0,-58,157,0,-157,0.0,0.0,0.0,0.0,0.0,0.0
johnl104,Lou Johnson,Detroit Tigers,TIGRS,2,3,2,5,1964,1967,3,5.69,-0.02,-5.71,445,329,-116,1466,94,-1372,122.0,751.0,629.0,29000.0,0.0,-29000.0
johnl104,Lou Johnson,Los Angeles Dodgers,DOGRS,2,3,4,7,1967,1979,12,17.59,19.27,1.68,780,1426,646,2862,4558,1696,0.0,0.0,0.0,0.0,0.0,0.0
johnl104,Lou Johnson,Chicago Cubs,CUBS,2,2,2,4,1968,1973,5,0.87,-0.38,-1.25,96,271,175,276,641,365,0.0,8.0,8.0,37250.0,0.0,-37250.0
johnl104,Lou Johnson,Cleveland Indians,INDINS,1,1,1,2,1969,1972,3,-0.52,0.84,1.36,67,289,222,148,523,375,0.0,0.0,0.0,0.0,0.0,0.0
johnm002,Mike Johnson,Baltimore Orioles,ORLS,1,1,1,2,1997,1998,1,-1.41,0.0,1.41,131,0,-131,49,0,-49,535.0,0.0,-535.0,150000.0,0.0,-150000.0
johnm002,Mike Johnson,Montreal Expos,NATEX,1,1,1,2,2001,2002,1,0.0,0.24,0.24,0,55,55,0,0,0,0.0,79.0,79.0,220000.0,0.0,-220000.0
johnm003,Mark Johnson,Chicago White Sox,WSOX,4,7,9,16,2002,2011,9,3.51,0.6,-2.91,386,338,-48,35,47,12,766.0,905.0,139.0,11095000.0,2433333.0,-8661667.0
johnm003,Mark Johnson,Milwaukee Brewers,BREWRS,1,1,1,2,2005,2005,0,0.0,0.0,0.0,0,0,0,0,0,0,0.0,0.0,0.0,0.0,0.0,0.0
johnm004,Mark Johnson,Houston Astros,ASTROS,1,3,1,4,1997,2001,4,-0.79,11.75,12.54,34,421,387,1,1777,1776,68.0,0.0,-68.0,0.0,4500000.0,4500000.0
johnm004,Mark Johnson,Florida Marlins,MARLNS,8,17,20,37,1999,2019,20,61.77,64.47,2.7,1848,3278,1430,4569,10868,6299,8696.0,5082.0,-3614.0,29867000.0,14191425.0,-15675575.0
johnm006,Micah Johnson,Chicago White Sox,WSOX,3,7,6,13,2015,2017,2,4.46,5.75,1.29,441,251,-190,564,1001,437,693.0,30.0,-663.0,12535000.0,6150000.0,-6385000.0
johnm006,Micah Johnson,Los Angeles Dodgers,DOGRS,1,1,1,2,2017,2017,0,-0.13,0.0,0.13,18,0,-18,11,0,-11,0.0,0.0,0.0,0.0,0.0,0.0
johnm101,Mike Johnson,Cincinnati Reds,REDS,1,3,1,4,1973,1979,6,1.85,11.84,9.99,285,462,177,593,484,-109,64.0,3945.0,3881.0,0.0,0.0,0.0
johnn001,Nick Johnson,New York Yankees,YANKS,6,17,11,28,2003,2012,9,26.42,21.86,-4.56,2170,1008,-1162,5379,2872,-2507,5079.0,2402.0,-2677.0,1920525.0,15100000.0,13179475.0
johnn001,Nick Johnson,Washington Nationals,NATEX,1,1,1,2,2009,2010,1,0.35,0.0,-0.35,35,0,-35,150,0,-150,0.0,0.0,0.0,5500000.0,0.0,-5500000.0
johnp102,Paul Johnson,Philadelphia Athletics,ATLTCS,1,5,1,6,1922,1929,7,0.0,12.22,12.22,0,592,592,0,2318,2318,0.0,0.0,0.0,0.0,0.0,0.0
johnr001,Randy Johnson,New York Mets,METS,1,1,1,2,1980,1980,0,2.64,0.0,-2.64,204,0,-204,547,0,-547,0.0,0.0,0.0,0.0,0.0,0.0
johnr002,Ron Johnson,Kansas City Royals,ROYALS,1,1,1,2,1983,1983,0,-0.07,0.0,0.07,5,0,-5,5,0,-5,0.0,0.0,0.0,0.0,0.0,0.0
johnr005,Randy Johnson,Montreal Expos,NATEX,2,4,3,7,1989,1990,1,45.42,4.9,-40.52,412,48,-364,8,66,58,7430.0,530.0,-6900.0,138000.0,1350000.0,1212000.0
johnr005,Randy Johnson,Seattle Mariners,MARNRS,13,22,27,49,1998,2015,17,42.14,68.37,26.23,2664,3279,615,7392,9973,2581,3579.0,7754.0,4175.0,33402500.0,19315000.0,-14087500.0
johnr005,Randy Johnson,Arizona Diamondbacks,DBACKS,12,26,21,47,2005,2017,12,20.41,32.26,11.85,1092,2414,1322,2224,5933,3709,4697.0,3744.0,-953.0,45113898.0,7815000.0,-37298898.0
johnr005,Randy Johnson,New York Yankees,YANKS,4,10,9,19,2007,2012,5,11.06,11.89,0.83,1430,902,-528,2780,2853,73,3952.0,516.0,-3436.0,1556425.0,9100000.0,7543575.0
johnr006,Russ Johnson,Houston Astros,ASTROS,1,1,1,2,2000,2000,0,2.67,-0.29,-2.96,204,103,-101,633,3,-630,0.0,170.0,170.0,260000.0,0.0,-260000.0
johnr006,Russ Johnson,Tampa Bay Devil Rays,RAYS,1,2,1,3,2002,2003,1,0.0,0.68,0.68,0,34,34,0,124,124,0.0,0.0,0.0,575000.0,6250000.0,5675000.0
johnr008,Reed Johnson,Chicago Cubs,CUBS,3,5,4,9,2012,2018,6,5.31,1.57,-3.74,650,341,-309,761,587,-174,1181.0,55.0,-1126.0,2100000.0,0.0,-2100000.0
johnr101,Randy Johnson,Chicago White Sox,WSOX,2,5,2,7,1981,1985,4,2.62,4.41,1.79,199,140,-59,397,1,-396,970.0,1329.0,359.0,0.0,0.0,0.0
johnr101,Randy Johnson,Minnesota Twins,TWINS,1,2,1,3,1985,1985,0,0.0,0.99,0.99,0,129,129,0,452,452,0.0,0.0,0.0,0.0,0.0,0.0
johnr102,Roy Johnson,SanFrancisco,SanFrancisco,1,1,2,3,1928,1928,0,6.88,0.0,-6.88,473,0,-473,2134,0,-2134,0.0,0.0,0.0,0.0,0.0,0.0
johnr102,Roy Johnson,Detroit Tigers,TIGRS,1,2,1,3,1932,1933,1,12.96,0.98,-11.98,710,94,-616,2975,392,-2583,0.0,0.0,0.0,13000.0,7000.0,-6000.0
johnr102,Roy Johnson,Boston Red Sox,RSOX,1,2,1,3,1935,1936,1,0.2,-0.88,-1.08,89,82,-7,318,334,16,0.0,0.0,0.0,16500.0,12000.0,-4500.0
johnr102,Roy Johnson,Washington Senators,TWINS,1,2,2,4,1936,1939,3,4.55,1.79,-2.76,355,337,-18,541,641,100,2260.0,1980.0,-280.0,0.0,0.0,0.0
johnr104,Rankin Johnson,Boston Red Sox,RSOX,23,51,62,113,1914,1937,23,210.47,131.21,-79.26,10024,6525,-3499,28339,20821,-7518,29017.0,15462.0,-13555.0,136800.0,133950.0,-2850.0
johnr104,Rankin Johnson,Milwaukee,Milwaukee,1,2,2,4,1918,1918,0,-0.15,0.0,0.15,31,0,-31,60,0,-60,69.0,0.0,-69.0,0.0,0.0,0.0
johns001,Steve Johnson,Los Angeles Dodgers,DOGRS,1,2,1,3,2009,2010,1,0.18,0.62,0.44,106,187,81,226,1,-225,178.0,192.0,14.0,0.0,2750000.0,2750000.0
johns101,Syl Johnson,Portland,Portland,4,6,14,20,1921,1926,5,21.37,0.0,-21.37,1173,0,-1173,3235,0,-3235,2921.0,0.0,-2921.0,0.0,9050.0,9050.0
johns101,Syl Johnson,St. Louis Cardinals,CARDS,1,2,1,3,1934,1934,0,0.4,0.0,-0.4,48,0,-48,141,0,-141,20.0,0.0,-20.0,0.0,0.0,0.0
johns101,Syl Johnson,Cincinnati Reds,REDS,2,4,4,8,1934,1937,3,22.67,0.0,-22.67,911,236,-675,2270,656,-1614,2379.0,321.0,-2058.0,0.0,0.0,0.0
johns102,Stan Johnson,Chicago White Sox,WSOX,11,17,21,38,1961,1969,8,15.81,27.33,11.52,1761,2250,489,3197,3489,292,3384.0,5251.0,1867.0,77750.0,58000.0,-19750.0
johns102,Stan Johnson,Kansas City Athletics,ATLTCS,2,4,3,7,1961,1962,1,-0.07,-0.09,-0.02,40,20,-20,51,37,-14,0.0,0.0,0.0,0.0,0.0,0.0
johns103,Si Johnson,Cincinnati Reds,REDS,1,1,2,3,1936,1936,0,2.32,0.0,-2.32,112,0,-112,94,0,-94,807.0,0.0,-807.0,0.0,0.0,0.0
johnt001,Tommy John,Cleveland Indians,INDINS,3,5,5,10,1965,1968,3,40.72,5.22,-35.5,1111,420,-691,2880,1615,-1265,4479.0,0.0,-4479.0,0.0,25000.0,25000.0
johnt001,Tommy John,Chicago White Sox,WSOX,3,5,4,9,1971,1979,8,21.05,19.98,-1.07,765,568,-197,1638,2032,394,4047.0,189.0,-3858.0,258750.0,125000.0,-133750.0
johnt001,Tommy John,New York Yankees,YANKS,2,4,2,6,1982,1985,3,8.6,1.45,-7.15,321,20,-301,270,0,-270,3508.0,301.0,-3207.0,0.0,0.0,0.0
johnt102,Tim Johnson,Los Angeles Dodgers,DOGRS,1,1,1,2,1973,1973,0,-0.26,0.0,0.26,405,0,-405,1220,0,-1220,0.0,0.0,0.0,0.0,19000.0,19000.0
johnt102,Tim Johnson,Milwaukee Brewers,BREWRS,1,1,1,2,1978,1978,0,-0.35,-0.01,0.34,111,2,-109,188,8,-180,0.0,0.0,0.0,92500.0,0.0,-92500.0
johnv101,Vic Johnson,Boston Red Sox,RSOX,1,2,1,3,1945,1947,2,-0.72,-0.36,0.36,18,42,24,1,44,43,41.0,320.0,279.0,4000.0,10200.0,6200.0
johnw001,Wallace Johnson,Montreal Expos,NATEX,1,1,1,2,1983,1984,1,-0.17,0.56,0.73,7,34,27,8,62,54,0.0,0.0,0.0,0.0,0.0,0.0
joinr101,Roy Joiner,Oakland,Oakland,1,1,1,2,1934,1934,0,-1.23,0.0,1.23,44,0,-44,11,0,-11,112.0,0.0,-112.0,0.0,0.0,0.0
jok-s101,Stan Jok,St. Louis Cardinals,CARDS,1,2,1,3,1956,1956,0,0.0,0.0,0.0,0,0,0,0,0,0,0.0,0.0,0.0,0.0,0.0,0.0
jokie001,Eric Jokisch,Miami Marlins,MARLNS,1,1,1,2,2016,2016,0,0.0,0.0,0.0,0,0,0,0,0,0,0.0,0.0,0.0,0.0,0.0,0.0
jolls101,Smead Jolley,Chicago White Sox,WSOX,3,8,5,13,1932,1935,3,3.4,4.58,1.18,902,283,-619,3430,766,-2664,0.0,735.0,735.0,34500.0,20500.0,-14000.0
jolls101,Smead Jolley,Boston Red Sox,RSOX,2,5,2,7,1933,1936,3,13.03,1.41,-11.62,347,273,-74,502,1053,551,1631.0,0.0,-1631.0,28000.0,21000.0,-7000.0
jolls101,Smead Jolley,St.Louis Browns,ORLS,14,27,34,61,1933,1952,19,55.71,57.94,2.23,2756,6888,4132,8050,21355,13305,6789.0,12669.0,5880.0,138000.0,130100.0,-7900.0
jolls101,Smead Jolley,SanFrancisco,SanFrancisco,1,1,2,3,1929,1931,2,2.5,0.0,-2.5,218,0,-218,816,0,-816,0.0,0.0,0.0,0.0,0.0,0.0
jonea001,Al Jones,Chicago White Sox,WSOX,1,2,1,3,1986,1988,2,0.0,1.98,1.98,0,87,87,0,0,0,0.0,254.0,254.0,0.0,121500.0,121500.0
jonea003,Adam Jones,Seattle Mariners,MARNRS,4,9,5,14,2008,2013,5,43.53,3.71,-39.82,1975,169,-1806,6859,413,-6446,3908.0,766.0,-3142.0,1000000.0,1300000.0,300000.0
joneb002,Barry Jones,Pittsburgh Pirates,PIRATS,1,1,1,2,1988,1988,0,3.06,0.59,-2.47,110,16,-94,0,17,17,413.0,156.0,-257.0,90000.0,425000.0,335000.0
joneb002,Barry Jones,Chicago White Sox,WSOX,2,3,4,7,1990,1996,6,7.45,16.61,9.16,578,648,70,1665,2873,1208,266.0,0.0,-266.0,4830000.0,2055555.0,-2774445.0
joneb002,Barry Jones,Montreal Expos,NATEX,1,1,2,3,1991,1997,6,-0.7,3.4,4.1,88,643,555,2,2169,2167,163.0,0.0,-163.0,875000.0,0.0,-875000.0
joneb004,Bobby Jones,Colorado Rockies,ROCKS,1,2,1,3,2000,2001,1,0.11,1.15,1.04,43,56,13,4,64,60,116.0,502.0,386.0,0.0,0.0,0.0
joneb004,Bobby Jones,New York Mets,METS,1,3,2,5,2002,2003,1,0.08,0.83,0.75,11,64,53,13,7,-6,29.0,147.0,118.0,0.0,500000.0,500000.0
joneb103,Bob Jones,Detroit Tigers,TIGRS,2,6,2,8,1925,1928,3,0.0,1.07,1.07,0,324,324,0,1271,1271,0.0,0.0,0.0,0.0,30000.0,30000.0
joneb104,Binky Jones,Brooklyn Dodgers,DOGRS,3,7,5,12,1924,1927,3,6.65,3.39,-3.26,787,606,-181,3022,2382,-640,0.0,0.0,0.0,32500.0,4800.0,-27700.0
jonec002,Chris Jones,Arizona Diamondbacks,DBACKS,1,1,1,2,1998,1998,0,-0.44,-0.22,0.22,43,4,-39,100,0,-100,0.0,2.0,2.0,450000.0,0.0,-450000.0
jonec103,Clarence Jones,Chicago Cubs,CUBS,3,5,3,8,1969,1974,5,-2.15,0.81,2.96,445,387,-58,1077,715,-362,55.0,283.0,228.0,0.0,25000.0,25000.0
jonec106,Charlie Jones,Washington Senators,TWINS,1,1,1,2,1907,1907,0,0.21,0.0,-0.21,74,0,-74,280,0,-280,0.0,0.0,0.0,0.0,0.0,0.0
joned001,Doug Jones,Houston Astros,ASTROS,1,2,1,3,1993,1994,1,2.36,-0.93,-3.29,132,50,-82,33,0,-33,433.0,60.0,-373.0,2609000.0,3500000.0,891000.0
joned001,Doug Jones,Milwaukee Brewers,BREWRS,1,1,1,2,1998,1999,1,0.68,0.36,-0.32,23,184,161,0,2,2,94.0,321.0,227.0,2500000.0,1800000.0,-700000.0
joned102,Dalton Jones,Boston Red Sox,RSOX,3,3,3,6,1969,1972,3,0.07,-1.67,-1.74,251,147,-104,562,234,-328,0.0,0.0,0.0,22000.0,17000.0,-5000.0
joned102,Dalton Jones,Detroit Tigers,TIGRS,3,6,3,9,1972,1975,3,-1.05,-0.55,0.5,169,196,27,357,508,151,4.0,0.0,-4.0,118300.0,80000.0,-38300.0
joneg002,Garrett Jones,Miami Marlins,MARLNS,2,4,7,11,2014,2019,5,6.27,8.73,2.46,210,736,526,177,1879,1702,1889.0,737.0,-1152.0,7867000.0,11541425.0,3674425.0
joneg101,Gordon Jones,San Francisco Giants,GIANTS,5,9,7,16,1959,1968,9,13.15,7.42,-5.73,1312,848,-464,3499,1107,-2392,1130.0,3244.0,2114.0,43000.0,30000.0,-13000.0
joneg101,Gordon Jones,St. Louis Cardinals,CARDS,19,44,38,82,1956,1972,16,56.42,67.4,10.98,5645,3260,-2385,13530,9157,-4373,6309.0,6165.0,-144.0,120500.0,36000.0,-84500.0
joneg102,Gary Jones,New York Yankees,YANKS,1,2,1,3,1971,1973,2,0.0,0.67,0.67,0,101,101,0,310,310,0.0,0.0,0.0,4800.0,23000.0,18200.0
joneg102,Gary Jones,Texas Rangers,RNGRS,15,34,23,57,1971,1988,17,48.57,49.18,0.61,3015,3170,155,9911,9907,-4,4375.0,6620.0,2245.0,528000.0,301000.0,-227000.0
joneh001,Hunter Jones,Boston Red Sox,RSOX,1,2,1,3,2009,2010,1,0.08,-0.48,-0.56,6,52,46,0,171,171,5.0,0.0,-5.0,400000.0,2250000.0,1850000.0
jonej002,Jimmy Jones,San Diego Padres,PADRS,1,3,2,5,1988,1992,4,-2.09,7.62,9.71,105,399,294,12,1044,1032,593.0,270.0,-323.0,375000.0,1500000.0,1125000.0
jonej003,Jacque Jones,Chicago Cubs,CUBS,4,7,7,14,2007,2013,6,20.06,0.88,-19.18,1518,347,-1171,4246,61,-4185,895.0,926.0,31.0,6938333.0,3600000.0,-3338333.0
jonej005,James Jones,Seattle Mariners,MARNRS,2,5,3,8,2015,2017,2,-1.06,0.95,2.01,37,177,140,16,698,682,66.0,0.0,-66.0,6250000.0,5475000.0,-775000.0
jonej006,JaCoby Jones,Pittsburgh Pirates,PIRATS,1,1,1,2,2015,2015,0,1.1,0.73,-0.37,352,58,-294,1195,0,-1195,0.0,80.0,80.0,0.0,7000000.0,7000000.0
jonej007,Jahmai Jones,Anaheim Angels,ANGELS,1,1,2,3,2021,2021,0,-0.62,1.73,2.35,26,19,-7,72,1,-71,0.0,280.0,280.0,0.0,0.0,0.0
jonej104,Johnny Jones,New York Giants,GIANTS,1,5,1,6,1919,1926,7,8.66,14.34,5.68,964,460,-504,2314,555,-1759,3291.0,4306.0,1015.0,5412.0,6226.0,814.0
jonej106,Jake Jones,Chicago White Sox,WSOX,1,1,1,2,1947,1948,1,-0.67,0.58,1.25,145,102,-43,567,438,-129,0.0,0.0,0.0,0.0,0.0,0.0
jonem102,Mack Jones,Atlanta Braves,BRAVES,1,3,1,4,1967,1968,1,0.5,-0.77,-1.27,233,127,-106,406,383,-23,170.0,0.0,-170.0,0.0,0.0,0.0
jonen001,Nate Jones,Chicago White Sox,WSOX,1,2,2,4,2019,2019,0,0.0,0.0,0.0,0,0,0,0,0,0,0.0,0.0,0.0,4650000.0,0.0,-4650000.0
joneo001,Odell Jones,Pittsburgh Pirates,PIRATS,1,3,3,6,1978,1978,0,-3.43,0.0,3.43,296,0,-296,706,0,-706,404.0,0.0,-404.0,0.0,0.0,0.0
joneo001,Odell Jones,Seattle Mariners,MARNRS,1,1,2,3,1980,1983,3,0.88,0.54,-0.34,26,81,55,13,0,-13,163.0,442.0,279.0,0.0,0.0,0.0
jonep101,Percy Jones,Chicago Cubs,CUBS,1,6,1,7,1928,1932,4,4.13,16.12,11.99,1036,317,-719,2232,1321,-911,4216.0,0.0,-4216.0,13000.0,30600.0,17600.0
jonep101,Percy Jones,Boston Braves,BRAVES,11,26,18,44,1930,1952,22,35.11,93.56,58.45,2190,4270,2080,6855,14689,7834,3053.0,6551.0,3498.0,20000.0,18000.0,-2000.0
jonep101,Percy Jones,Chicago Cubs,CUBS,1,2,2,4,1923,1931,8,0.0,12.05,12.05,0,628,628,0,625,625,0.0,5104.0,5104.0,3400.0,0.0,-3400.0
joner001,Ross Jones,Los Angeles Dodgers,DOGRS,1,2,2,4,1983,1986,3,29.07,1.25,-27.82,528,343,-185,590,279,-311,4754.0,437.0,-4317.0,0.0,314167.0,314167.0
joner001,Ross Jones,Seattle Mariners,MARNRS,1,1,1,2,1987,1987,0,0.06,0.0,-0.06,39,0,-39,124,0,-124,0.0,0.0,0.0,0.0,0.0,0.0
joner002,Ruppert Jones,Seattle Mariners,MARNRS,1,2,4,6,1979,1986,7,0.3,12.28,11.98,84,358,274,373,605,232,2.0,2834.0,2832.0,0.0,0.0,0.0
joner002,Ruppert Jones,New York Yankees,YANKS,6,13,11,24,1981,1992,11,27.03,19.65,-7.38,2401,1053,-1348,5956,3510,-2446,5438.0,699.0,-4739.0,913333.0,1745000.0,831667.0
joner101,Randy Jones,San Diego Padres,PADRS,5,10,11,21,1980,1989,9,29.59,14.86,-14.73,2622,1215,-1407,8550,2430,-6120,2464.0,4252.0,1788.0,0.0,300000.0,300000.0
joner102,Rick Jones,Seattle Mariners,MARNRS,5,14,13,27,1978,1985,7,13.7,0.35,-13.35,1053,894,-159,693,2333,1640,4377.0,1863.0,-2514.0,175000.0,512500.0,337500.0
jones101,Steve Jones,Chicago White Sox,WSOX,4,7,7,14,1968,1971,3,11.44,1.3,-10.14,1683,516,-1167,5097,1341,-3756,666.0,366.0,-300.0,31000.0,33000.0,2000.0
jones102,Sherman Jones,San Francisco Giants,GIANTS,9,17,13,30,1961,1972,11,22.69,19.49,-3.2,2066,1611,-455,6411,2790,-3621,1334.0,4789.0,3455.0,50000.0,89000.0,39000.0
jones103,Sheldon Jones,New York Giants,GIANTS,1,2,1,3,1952,1952,0,-0.49,0.18,0.67,78,98,20,9,313,304,210.0,0.0,-210.0,0.0,0.0,0.0
jones103,Sheldon Jones,Milwaukee Braves,BRAVES,1,1,1,2,1952,1952,0,0.45,0.0,-0.45,44,0,-44,7,0,-7,118.0,0.0,-118.0,0.0,0.0,0.0
jones104,Sad Sam Jones,Cleveland Indians,INDINS,1,3,1,4,1916,1927,11,11.98,74.79,62.81,369,1519,1150,563,6634,6071,3136.0,0.0,-3136.0,0.0,0.0,0.0
jones104,Sad Sam Jones,Boston Red Sox,RSOX,10,21,30,51,1921,1937,16,73.06,40.4,-32.66,4195,2010,-2185,13395,5364,-8031,9458.0,7949.0,-1509.0,78550.0,54250.0,-24300.0
jones104,Sad Sam Jones,New York Yankees,YANKS,2,3,3,6,1927,1946,19,0.65,54.93,54.28,164,1328,1164,395,2127,1732,569.0,9587.0,9018.0,6000.0,6750.0,750.0
jones104,Sad Sam Jones,St.Louis Browns,ORLS,3,4,4,8,1927,1935,8,11.48,6.16,-5.32,387,744,357,418,523,105,3166.0,4550.0,1384.0,22500.0,15100.0,-7400.0
jones104,Sad Sam Jones,Washington Senators,TWINS,4,9,7,16,1931,1936,5,40.86,14.39,-26.47,2483,840,-1643,9607,2965,-6642,2547.0,1249.0,-1298.0,62500.0,54200.0,-8300.0
jones105,Sam Jones,Cleveland Indians,INDINS,1,3,1,4,1954,1955,1,4.04,0.12,-3.92,157,113,-44,207,390,183,1291.0,0.0,-1291.0,0.0,65000.0,65000.0
jones105,Sam Jones,Chicago Cubs,CUBS,5,10,9,19,1956,1965,9,7.39,7.94,0.55,637,1087,450,1408,195,-1213,1395.0,2758.0,1363.0,0.0,0.0,0.0
jones105,Sam Jones,St. Louis Cardinals,CARDS,12,25,21,46,1959,1972,13,38.14,29.59,-8.55,3497,1794,-1703,8651,6077,-2574,3788.0,703.0,-3085.0,32500.0,24000.0,-8500.0
jones105,Sam Jones,Houston Astros,ASTROS,5,7,10,17,1961,1973,12,1.0,10.72,9.72,370,1119,749,287,875,588,788.0,4740.0,3952.0,57500.0,75500.0,18000.0
jonet001,Tracy Jones,Cincinnati Reds,REDS,1,2,3,5,1988,1992,4,0.54,1.86,1.32,53,699,646,157,1778,1621,0.0,41.0,41.0,157500.0,330000.0,172500.0
jonet001,Tracy Jones,Montreal Expos,NATEX,1,1,1,2,1988,1991,3,-0.71,0.6,1.31,40,172,132,103,359,256,0.0,0.0,0.0,0.0,160000.0,160000.0
jonet001,Tracy Jones,San Francisco Giants,GIANTS,1,1,1,2,1989,1989,0,-0.45,0.59,1.04,96,70,-26,307,175,-132,0.0,0.0,0.0,300000.0,430000.0,130000.0
jonet001,Tracy Jones,Detroit Tigers,TIGRS,1,1,1,2,1990,1990,0,0.55,-0.86,-1.41,104,52,-52,289,122,-167,0.0,0.0,0.0,375000.0,690000.0,315000.0
jonet003,Todd Jones,Houston Astros,ASTROS,6,12,18,30,1996,2004,8,25.8,6.98,-18.82,2221,1542,-679,3937,2959,-978,4263.0,3434.0,-829.0,7155000.0,5554000.0,-1601000.0
jonet003,Todd Jones,Detroit Tigers,TIGRS,2,3,4,7,2001,2010,9,3.25,8.31,5.06,81,301,220,66,28,-38,630.0,4456.0,3826.0,3975000.0,235000.0,-3740000.0
jonet003,Todd Jones,Cincinnati Reds,REDS,1,2,2,4,2004,2006,2,-0.03,0.46,0.49,53,65,12,1,87,86,76.0,206.0,130.0,500000.0,0.0,-500000.0
jonet004,Terry Jones,Colorado Rockies,ROCKS,14,25,26,51,1997,2003,6,21.69,15.75,-5.94,2403,1893,-510,1976,1038,-938,5980.0,2902.0,-3078.0,24071314.0,15270000.0,-8801314.0
jonet101,Timothy Jones,Pittsburgh Pirates,PIRATS,1,1,1,2,1978,1978,0,0.0,-0.68,-0.68,0,12,12,0,0,0,0.0,26.0,26.0,0.0,0.0,0.0
jonet103,Tom Jones,St.Louis Browns,ORLS,1,1,1,2,1909,1909,0,1.69,-0.1,-1.79,179,2,-177,677,8,-669,0.0,0.0,0.0,0.0,0.0,0.0
jonew101,Willie Jones,Philadelphia Phillies,PHILS,1,1,2,3,1959,1960,1,0.28,-0.93,-1.21,11,35,24,19,52,33,0.0,0.0,0.0,0.0,0.0,0.0
jonnb101,Bubber Jonnard,Philadelphia Phillies,PHILS,1,3,2,5,1927,1929,2,-0.72,-1.19,-0.47,18,135,117,33,192,159,0.0,529.0,529.0,8850.0,13300.0,4450.0
jonnc101,Claude Jonnard,St.Louis Browns,ORLS,21,42,49,91,1926,1952,26,96.01,107.81,11.8,5218,9406,4188,17109,30707,13598,8613.0,15510.0,6897.0,200300.0,179450.0,-20850.0
joose101,Eddie Joost,Cincinnati Reds,REDS,5,8,7,15,1942,1958,16,10.73,21.22,10.49,1014,1434,420,2886,5138,2252,2587.0,1210.0,-1377.0,0.0,12500.0,12500.0
joose101,Eddie Joost,Boston Braves,BRAVES,4,10,6,16,1946,1952,6,11.92,12.47,0.55,840,753,-87,2908,2363,-545,0.0,414.0,414.0,0.0,0.0,0.0
joose101,Eddie Joost,St. Louis Cardinals,CARDS,1,1,4,5,1946,1946,0,26.76,0.0,-26.76,917,0,-917,4210,0,-4210,0.0,0.0,0.0,0.0,7000.0,7000.0
jordb001,Brian Jordan,Atlanta Braves,BRAVES,1,3,1,4,2002,2003,1,12.57,11.23,-1.34,452,290,-162,1035,1257,222,2316.0,0.0,-2316.0,0.0,0.0,0.0
jordb101,Buck Jordan,Baltimore,Baltimore,1,1,3,4,1932,1934,2,10.04,0.0,-10.04,601,0,-601,2506,0,-2506,0.0,0.0,0.0,0.0,0.0,0.0
jordb101,Buck Jordan,Cincinnati Reds,REDS,2,2,2,4,1938,1938,0,0.84,0.72,-0.12,87,46,-41,330,125,-205,0.0,0.0,0.0,0.0,0.0,0.0
jordb101,Buck Jordan,Washington Senators,TWINS,1,5,1,6,1931,1939,8,0.0,8.51,8.51,0,385,385,0,407,407,0.0,3095.0,3095.0,6500.0,0.0,-6500.0
jordj101,Jimmy Jordan,Brooklyn Dodgers,DOGRS,1,3,1,4,1936,1938,2,0.05,-0.59,-0.64,177,153,-24,491,535,44,0.0,3.0,3.0,0.0,0.0,0.0
jordk001,Kevin Jordan,New York Yankees,YANKS,1,3,2,5,1994,1995,1,-1.6,-0.95,0.65,666,27,-639,1569,0,-1569,587.0,372.0,-215.0,0.0,0.0,0.0
jordn101,Niles Jordan,Philadelphia Phillies,PHILS,3,8,7,15,1951,1957,6,12.59,16.8,4.21,922,1010,88,2813,3409,596,109.0,186.0,77.0,63000.0,37500.0,-25500.0
jordr002,Ricardo Jordan,Toronto Blue Jays,BJAYS,2,4,3,7,1995,2002,7,7.82,10.52,2.7,990,426,-564,2406,2,-2404,537.0,1768.0,1231.0,1909000.0,442500.0,-1466500.0
jordr002,Ricardo Jordan,Philadelphia Phillies,PHILS,1,2,1,3,1996,2000,4,-0.52,-2.87,-2.35,69,496,427,2,2022,2020,121.0,0.0,-121.0,284000.0,325000.0,41000.0
jordt102,Tom Jordan,Chicago White Sox,WSOX,1,1,1,2,1946,1947,1,-0.14,-0.41,-0.27,14,53,39,38,211,173,0.0,0.0,0.0,4800.0,13000.0,8200.0
jorgm001,Mike Jorgensen,New York Mets,METS,2,5,3,8,1972,1979,7,27.3,7.07,-20.23,2407,595,-1812,9387,2358,-7029,284.0,578.0,294.0,110000.0,95000.0,-15000.0
jorgm001,Mike Jorgensen,Montreal Expos,NATEX,1,1,1,2,1977,1982,5,0.77,0.19,-0.58,66,408,342,236,97,-139,0.0,1311.0,1311.0,0.0,0.0,0.0
jorgm001,Mike Jorgensen,Texas Rangers,RNGRS,8,16,17,33,1979,1987,8,13.69,12.82,-0.87,1524,510,-1014,3006,820,-2186,5064.0,3278.0,-1786.0,1017500.0,331000.0,-686500.0
jorgm001,Mike Jorgensen,Atlanta Braves,BRAVES,2,4,2,6,1984,1992,8,2.53,5.32,2.79,820,917,97,385,3026,2641,1122.0,0.0,-1122.0,725000.0,0.0,-725000.0
jorgr001,Ryan Jorgensen,Chicago Cubs,CUBS,1,4,2,6,2002,2004,2,19.76,10.92,-8.84,396,427,31,455,211,-244,3529.0,2185.0,-1344.0,0.0,0.0,0.0
jorgr001,Ryan Jorgensen,Florida Marlins,MARLNS,1,1,1,2,2006,2006,0,0.06,0.0,-0.06,4,0,-4,15,0,-15,0.0,0.0,0.0,0.0,0.0,0.0
jorgs101,Spider Jorgensen,New York Giants,GIANTS,1,2,1,3,1951,1951,0,0.0,0.0,0.0,0,13,13,0,13,13,0.0,0.0,0.0,0.0,0.0,0.0
josed001,Donnie Joseph,Cincinnati Reds,REDS,2,3,3,6,2012,2018,6,-0.39,1.45,1.84,105,280,175,0,4,4,160.0,420.0,260.0,0.0,4000000.0,4000000.0
josed101,Duane Josephson,Chicago White Sox,WSOX,5,7,6,13,1971,1976,5,-2.36,0.03,2.39,667,792,125,1044,1819,775,489.0,881.0,392.0,27000.0,17000.0,-10000.0
josef001,Felix Jose,Oakland Athletics,ATLTCS,1,3,1,4,1990,1990,0,4.87,0.81,-4.06,395,29,-366,1429,123,-1306,0.0,0.0,0.0,102500.0,1500000.0,1397500.0
josef001,Felix Jose,St. Louis Cardinals,CARDS,1,2,2,4,1993,1994,1,0.21,6.98,6.77,278,245,-33,1031,1059,28,0.0,0.0,0.0,0.0,0.0,0.0
josek001,Kevin Joseph,San Francisco Giants,GIANTS,2,3,3,6,2001,2005,4,0.04,0.48,0.44,34,363,329,0,0,0,44.0,378.0,334.0,1050000.0,1600000.0,550000.0
josek001,Kevin Joseph,St. Louis Cardinals,CARDS,1,1,1,2,2003,2003,0,0.0,0.0,0.0,0,0,0,0,0,0,0.0,0.0,0.0,0.0,0.0,0.0
joser101,Rick Joseph,Philadelphia Phillies,PHILS,1,1,1,2,1971,1973,2,0.0,-0.5,-0.5,0,260,260,0,40,40,0.0,731.0,731.0,0.0,0.0,0.0
joset001,Tommy Joseph,San Francisco Giants,GIANTS,1,3,1,4,2012,2018,6,-0.86,10.45,11.31,288,772,484,953,3095,2142,6.0,0.0,-6.0,1300000.0,10400000.0,9100000.0
joycb101,Bill Joyce,Brooklyn Dodgers,DOGRS,1,2,1,3,1893,1894,1,12.66,-0.67,-13.33,307,54,-253,1444,222,-1222,0.0,0.0,0.0,0.0,0.0,0.0
joycb101,Bill Joyce,Washington Senators,WSN,2,3,7,10,1896,1905,9,20.57,5.74,-14.83,1039,340,-699,4306,1120,-3186,0.0,695.0,695.0,0.0,0.0,0.0
joycb102,Bob Joyce,Oakland,Oakland,2,2,5,7,1938,1949,11,-0.94,0.0,0.94,88,0,-88,40,0,-40,403.0,0.0,-403.0,0.0,2100.0,2100.0
joycb102,Bob Joyce,Philadelphia Athletics,ATLTCS,1,4,1,5,1939,1939,0,0.0,0.0,0.0,0,0,0,0,0,0,0.0,0.0,0.0,3000.0,0.0,-3000.0
joycm001,Matt Joyce,Detroit Tigers,TIGRS,5,8,10,18,2008,2021,13,14.09,56.93,42.84,881,1465,584,2989,3036,47,687.0,7099.0,6412.0,35445000.0,2771400.0,-32673600.0
joycm001,Matt Joyce,Tampa Bay Devil Rays,RAYS,3,3,4,7,2014,2018,4,-0.12,0.91,1.03,156,63,-93,284,0,-284,176.0,194.0,18.0,6725000.0,1462500.0,-5262500.0
joynw001,Wally Joyner,Kansas City Royals,ROYALS,2,3,3,6,1995,1997,2,9.23,2.06,-7.17,520,188,-332,2004,744,-1260,0.0,6.0,6.0,6750000.0,2300000.0,-4450000.0
joynw001,Wally Joyner,San Diego Padres,PADRS,1,3,3,6,1999,2006,7,3.54,15.79,12.25,377,961,584,1296,3858,2562,0.0,4.0,4.0,8651680.0,7650000.0,-1001680.0
juddm001,Mike Judd,New York Yankees,YANKS,1,1,1,2,1996,1996,0,-0.91,-0.11,0.8,32,4,-28,13,0,-13,138.0,17.0,-121.0,0.0,0.0,0.0
juddr101,Ralph Judd,New York Giants,GIANTS,1,1,1,2,1930,1932,2,0.0,1.22,1.22,0,118,118,0,137,137,0.0,1047.0,1047.0,0.0,0.0,0.0
judef101,Frank Jude,Toledo,Toledo,1,1,2,3,1906,1909,3,-1.63,0.0,1.63,80,0,-80,329,0,-329,0.0,0.0,0.0,0.0,0.0,0.0
judej001,Jeff Juden,Houston Astros,ASTROS,1,2,1,3,1993,1994,1,2.36,-0.93,-3.29,132,50,-82,33,0,-33,433.0,60.0,-373.0,2609000.0,3500000.0,891000.0
judej001,Jeff Juden,Philadelphia Phillies,PHILS,1,2,1,3,1995,1996,1,-0.14,0.66,0.8,72,35,-37,3,118,115,125.0,0.0,-125.0,109000.0,320000.0,211000.0
judej001,Jeff Juden,Montreal Expos,NATEX,2,3,3,6,1997,2003,6,5.12,0.05,-5.07,706,898,192,77,840,763,1502.0,1243.0,-259.0,4173333.0,900000.0,-3273333.0
judej001,Jeff Juden,Cleveland Indians,INDINS,5,7,8,15,1997,2003,6,-0.44,6.0,6.44,740,264,-476,1919,1,-1918,857.0,949.0,92.0,9150000.0,8990000.0,-160000.0
judnw101,Wally Judnich,St.Louis Browns,ORLS,6,12,14,26,1947,1960,13,15.93,14.55,-1.38,866,1429,563,1976,4545,2569,2508.0,1208.0,-1300.0,30000.0,0.0,-30000.0
judsh101,Howie Judson,Chicago White Sox,WSOX,1,1,1,2,1952,1954,2,0.91,-0.02,-0.93,94,8,-86,38,18,-20,396.0,0.0,-396.0,0.0,0.0,0.0
julij001,Jorge Julio,Montreal Expos,NATEX,1,1,1,2,2000,2001,1,1.36,-1.41,-2.77,297,55,-242,0,107,107,875.0,0.0,-875.0,0.0,0.0,0.0
julij001,Jorge Julio,Baltimore Orioles,ORLS,1,2,1,3,2006,2007,1,4.49,1.83,-2.66,234,33,-201,209,9,-200,1690.0,549.0,-1141.0,0.0,0.0,0.0
julij001,Jorge Julio,New York Mets,METS,1,1,1,2,2006,2008,2,0.73,3.94,3.21,85,92,7,0,94,94,134.0,793.0,659.0,2525000.0,4625000.0,2100000.0
julij001,Jorge Julio,Arizona Diamondbacks,DBACKS,1,2,1,3,2007,2009,2,-0.9,0.21,1.11,20,112,92,1,61,60,28.0,609.0,581.0,0.0,0.0,0.0
julij001,Jorge Julio,Florida Marlins,MARLNS,1,1,1,2,2007,2007,0,0.73,-0.15,-0.88,112,44,-68,1,39,38,158.0,329.0,171.0,3600000.0,2500000.0,-1100000.0
junge001,Eric Junge,Los Angeles Dodgers,DOGRS,1,2,1,3,2001,2002,1,0.34,1.59,1.25,20,77,57,3,48,45,61.0,484.0,423.0,0.0,2750000.0,2750000.0
junkj001,Janson Junk,New York Yankees,YANKS,1,2,2,4,2021,2021,0,-0.41,-0.59,-0.18,7,14,7,0,1,1,56.0,107.0,51.0,0.0,6750000.0,6750000.0
juraa001,Ariel Jurado,Texas Rangers,RNGRS,1,1,1,2,2020,2020,0,-0.17,0.0,0.17,1,0,-1,0,0,0,12.0,0.0,-12.0,0.0,0.0,0.0
jurgb101,Billy Jurges,Chicago Cubs,CUBS,4,7,6,13,1938,1943,5,18.58,4.9,-13.68,1563,631,-932,5453,2299,-3154,405.0,0.0,-405.0,33000.0,21000.0,-12000.0
jurrj001,Jair Jurrjens,Detroit Tigers,TIGRS,1,2,1,3,2007,2008,1,10.42,1.11,-9.31,243,138,-105,269,547,278,2160.0,0.0,-2160.0,0.0,9000000.0,9000000.0
jurrj001,Jair Jurrjens,Cincinnati Reds,REDS,1,1,1,2,2014,2014,0,-0.36,0.0,0.36,4,0,-4,2,0,-2,28.0,0.0,-28.0,0.0,0.0,0.0
justd001,David Justice,Atlanta Braves,BRAVES,2,3,3,6,1997,1999,2,12.97,6.11,-6.86,700,430,-270,2648,565,-2083,105.0,396.0,291.0,575000.0,700000.0,125000.0
justd001,David Justice,Cleveland Indians,INDINS,8,10,13,23,2000,2020,20,28.78,61.83,33.05,1957,1761,-196,6639,3446,-3193,2696.0,8442.0,5746.0,35404400.0,6499000.0,-28905400.0
justd001,David Justice,New York Yankees,YANKS,4,6,6,12,2001,2012,11,-0.94,18.37,19.31,321,1351,1030,352,3939,3587,235.0,682.0,447.0,14420923.0,12005000.0,-2415923.0
justd001,David Justice,New York Mets,METS,1,1,2,3,2001,2005,4,1.64,0.66,-0.98,118,175,57,471,14,-457,0.0,284.0,284.0,0.0,1800000.0,1800000.0
jutzs101,Skip Jutze,St. Louis Cardinals,CARDS,3,4,4,8,1972,1975,3,-4.47,-0.62,3.85,305,37,-268,783,86,-697,0.0,0.0,0.0,0.0,0.0,0.0
jutzs101,Skip Jutze,Houston Astros,ASTROS,1,1,2,3,1977,1977,0,-0.35,0.0,0.35,42,0,-42,118,0,-118,0.0,0.0,0.0,0.0,0.0,0.0
juulh102,Herb Juul,Cincinnati Reds,REDS,1,2,1,3,1911,1911,0,0.0,0.0,0.0,0,0,0,0,0,0,0.0,0.0,0.0,0.0,0.0,0.0
kaaik001,Kila Ka'aihue,Kansas City Royals,ROYALS,1,1,1,2,2011,2011,0,-0.16,0.0,0.16,39,0,-39,139,0,-139,0.0,0.0,0.0,419000.0,0.0,-419000.0
kaatj101,Jim Kaat,Chicago White Sox,WSOX,4,7,7,14,1975,1981,6,15.97,6.61,-9.36,1143,1143,0,3173,4231,1058,3027.0,0.0,-3027.0,0.0,114500.0,114500.0
kahnt001,Tommy Kahnle,Colorado Rockies,ROCKS,1,1,1,2,2015,2021,6,1.61,-0.06,-1.67,71,201,130,0,9,9,190.0,372.0,182.0,0.0,0.0,0.0
kahnt001,Tommy Kahnle,Chicago White Sox,WSOX,2,4,5,9,2017,2017,0,4.16,0.5,-3.66,327,12,-315,241,0,-241,693.0,30.0,-663.0,12535000.0,6150000.0,-6385000.0
kahom101,Mike Kahoe,Indianapolis,Indianapolis,2,2,4,6,1905,1913,8,0.26,0.0,-0.26,51,0,-51,167,0,-167,0.0,0.0,0.0,0.0,0.0,0.0
kaisa101,Al Kaiser,Chicago Cubs,CUBS,3,6,7,13,1911,1916,5,-3.91,1.45,5.36,376,507,131,960,1665,705,899.0,27.0,-872.0,4500.0,0.0,-4500.0
kaisd101,Don Kaiser,Chicago Cubs,CUBS,11,20,17,37,1957,1977,20,15.71,44.12,28.41,1386,3941,2555,1236,10815,9579,4659.0,6233.0,1574.0,122500.0,58000.0,-64500.0
kaisd101,Don Kaiser,Milwaukee Braves,BRAVES,1,3,2,5,1959,1961,2,-0.44,0.34,0.78,224,49,-175,615,163,-452,0.0,0.0,0.0,0.0,0.0,0.0
kaisj001,Jeff Kaiser,Oakland Athletics,ATLTCS,1,1,1,2,1987,1987,0,-0.28,0.0,0.28,16,0,-16,0,0,0,67.0,0.0,-67.0,0.0,0.0,0.0
kallr101,Rudy Kallio,SaltLakeCity,SaltLakeCity,1,1,2,3,1924,1924,0,-0.35,0.0,0.35,14,0,-14,6,0,-6,54.0,0.0,-54.0,0.0,3300.0,3300.0
kamir001,Rob Kaminsky,St. Louis Cardinals,CARDS,1,1,1,2,2015,2016,1,0.0,0.63,0.63,0,179,179,0,615,615,0.0,0.0,0.0,0.0,6500000.0,6500000.0
kammw101,Willie Kamm,SanFrancisco,SanFrancisco,1,1,4,5,1922,1930,8,27.12,0.0,-27.12,1171,0,-1171,4851,0,-4851,0.0,0.0,0.0,0.0,10600.0,10600.0
kammw101,Willie Kamm,Chicago White Sox,WSOX,1,1,1,2,1931,1931,0,8.34,1.31,-7.03,522,121,-401,2094,509,-1585,0.0,0.0,0.0,11500.0,10000.0,-1500.0
kampa101,Alex Kampouris,Sacramento,Sacramento,1,1,1,2,1934,1934,0,2.63,0.0,-2.63,456,0,-456,1617,0,-1617,0.0,0.0,0.0,0.0,0.0,0.0
kampa101,Alex Kampouris,Cincinnati Reds,REDS,1,1,1,2,1938,1940,2,2.04,3.71,1.67,156,198,42,536,814,278,0.0,0.0,0.0,0.0,0.0,0.0
kampa101,Alex Kampouris,New York Giants,GIANTS,3,10,6,16,1939,1954,15,0.0,7.09,7.09,0,765,765,0,2631,2631,0.0,172.0,172.0,6000.0,0.0,-6000.0
kanej103,John Kane,Cincinnati Reds,REDS,2,2,4,6,1909,1911,2,-0.83,3.31,4.14,53,471,418,129,1598,1469,0.0,0.0,0.0,0.0,0.0,0.0
kanet101,Tom Kane,Boston Braves,BRAVES,1,1,1,2,1938,1938,0,0.0,-0.94,-0.94,0,28,28,0,79,79,0.0,0.0,0.0,0.0,0.0,0.0
kaplg001,Gabe Kapler,Detroit Tigers,TIGRS,1,6,3,9,1999,2004,5,20.76,4.31,-16.45,1380,309,-1071,3548,496,-3052,1196.0,551.0,-645.0,1937500.0,9240000.0,7302500.0
kaplg001,Gabe Kapler,Texas Rangers,RNGRS,1,3,2,5,2002,2002,0,0.5,-0.12,-0.62,97,54,-43,245,149,-96,0.0,127.0,127.0,1850000.0,3650000.0,1800000.0
kaprj001,James Kaprielian,New York Yankees,YANKS,4,8,7,15,2017,2021,4,10.37,1.61,-8.76,335,144,-191,733,363,-370,1504.0,587.0,-917.0,0.0,3575000.0,3575000.0
karcm001,Matt Karchner,Chicago White Sox,WSOX,2,2,2,4,1998,2008,10,1.0,21.12,20.12,147,422,275,5,755,750,772.0,4286.0,3514.0,10300000.0,8500000.0,-1800000.0
kardp101,Paul Kardow,Cleveland Indians,INDINS,1,3,1,4,1937,1938,1,0.0,0.0,0.0,0,0,0,0,0,0,0.0,0.0,0.0,0.0,0.0,0.0
karge101,Ed Karger,Pittsburgh Pirates,PIRATS,1,1,1,2,1906,1906,0,7.3,0.33,-6.97,174,12,-162,246,13,-233,1929.0,102.0,-1827.0,0.0,0.0,0.0
karge101,Ed Karger,St. Louis Cardinals,CARDS,2,5,2,7,1908,1912,4,24.55,10.02,-14.53,1473,290,-1183,4275,993,-3282,4114.0,10.0,-4104.0,0.0,0.0,0.0
karge101,Ed Karger,StPaul,StPaul,1,2,3,5,1909,1910,1,12.24,0.0,-12.24,441,0,-441,478,0,-478,3240.0,0.0,-3240.0,0.0,0.0,0.0
karla101,Andy Karl,Philadelphia Phillies,PHILS,1,1,1,2,1947,1948,1,0.26,-0.21,-0.47,54,111,57,6,254,248,105.0,0.0,-105.0,0.0,0.0,0.0
karla101,Andy Karl,Philadelphia Phillies,PHILS,2,4,2,6,1943,1949,6,23.82,3.95,-19.87,519,273,-246,570,454,-116,4467.0,1587.0,-2880.0,0.0,0.0,0.0
karlb101,Bill Karlon,New York Yankees,YANKS,1,2,1,3,1931,1931,0,0.0,0.0,0.0,0,0,0,0,0,0,0.0,0.0,0.0,0.0,0.0,0.0
karls001,Scott Karl,Milwaukee Brewers,BREWRS,4,7,8,15,1999,2003,4,6.3,0.97,-5.33,590,668,78,2079,1251,-828,242.0,2859.0,2617.0,10900000.0,890000.0,-10010000.0
karnj001,Jason Karnuth,St. Louis Cardinals,CARDS,1,2,1,3,2002,2003,1,0.0,-0.52,-0.52,0,153,153,0,10,10,0.0,287.0,287.0,0.0,2800000.0,2800000.0
karnn001,Nathan Karns,Washington Nationals,NATEX,2,3,4,7,2014,2017,3,9.42,1.79,-7.63,467,445,-22,8,658,650,1175.0,383.0,-792.0,0.0,0.0,0.0
karnn001,Nathan Karns,Tampa Bay Devil Rays,RAYS,2,5,4,9,2015,2018,3,-0.11,7.04,7.15,74,689,615,124,2370,2246,283.0,211.0,-72.0,508800.0,3779600.0,3270800.0
karnn001,Nathan Karns,Seattle Mariners,MARNRS,1,1,1,2,2017,2017,0,1.04,2.72,1.68,9,111,102,0,390,390,136.0,0.0,-136.0,0.0,0.0,0.0
karpr001,Ryan Karp,New York Yankees,YANKS,1,3,2,5,1994,1995,1,-1.6,-0.95,0.65,666,27,-639,1569,0,-1569,587.0,372.0,-215.0,0.0,0.0,0.0
karre001,Eric Karros,Los Angeles Dodgers,DOGRS,1,2,2,4,2002,2004,2,2.3,-0.13,-2.43,316,32,-284,1174,68,-1106,0.0,0.0,0.0,11875000.0,6500000.0,-5375000.0
karsj001,Jeff Karstens,New York Yankees,YANKS,1,4,2,6,2008,2011,3,7.23,0.52,-6.71,1088,146,-942,2084,276,-1808,3210.0,148.0,-3062.0,391425.0,5500000.0,5108575.0
karss001,Steve Karsay,Toronto Blue Jays,BJAYS,1,2,1,3,1993,1993,0,1.73,0.5,-1.23,187,44,-143,423,203,-220,657.0,0.0,-657.0,0.0,3550000.0,3550000.0
karss001,Steve Karsay,Oakland Athletics,ATLTCS,1,1,1,2,1997,1998,1,6.31,0.56,-5.75,172,54,-118,1,0,-1,669.0,142.0,-527.0,160000.0,0.0,-160000.0
karss001,Steve Karsay,Cleveland Indians,INDINS,2,3,3,6,2001,2003,2,-0.19,-0.02,0.17,198,59,-139,2,0,-2,300.0,180.0,-120.0,4300000.0,1900000.0,-2400000.0
kaske101,Eddie Kasko,St. Louis Cardinals,CARDS,2,5,5,10,1958,1963,5,8.1,2.95,-5.15,969,458,-511,3320,993,-2327,89.0,111.0,22.0,0.0,0.0,0.0
kaske101,Eddie Kasko,Cincinnati Reds,REDS,1,1,3,4,1964,1966,2,1.74,-0.13,-1.87,201,8,-193,727,0,-727,0.0,15.0,15.0,0.0,0.0,0.0
kaske101,Eddie Kasko,Houston Astros,ASTROS,1,1,1,2,1966,1966,0,1.0,0.02,-0.98,58,77,19,152,167,15,0.0,0.0,0.0,0.0,0.0,0.0
katam001,Matt Kata,Arizona Diamondbacks,DBACKS,1,1,2,3,2005,2005,0,-0.09,0.45,0.54,10,64,54,6,1,-5,0.0,95.0,95.0,330000.0,3050000.0,2720000.0
kattr101,Ray Katt,St. Louis Cardinals,CARDS,15,35,30,65,1956,1972,16,38.58,60.99,22.41,4144,2647,-1497,9926,7589,-2337,4766.0,5429.0,663.0,32500.0,36000.0,3500.0
kattr101,Ray Katt,Chicago Cubs,CUBS,1,2,2,4,1957,1958,1,0.97,-1.1,-2.07,265,105,-160,781,34,-747,0.0,197.0,197.0,0.0,0.0,0.0
kattr101,Ray Katt,San Francisco Giants,GIANTS,1,1,1,2,1958,1958,0,-0.09,0.21,0.3,34,34,0,72,66,-6,0.0,0.0,0.0,0.0,0.0,0.0
kattr101,Ray Katt,New York Giants,GIANTS,11,22,22,44,1956,1968,12,37.88,26.25,-11.63,3162,2563,-599,10326,4535,-5791,1384.0,7539.0,6155.0,95000.0,109500.0,14500.0
kaufb101,Benny Kauff,New York Giants,GIANTS,2,7,2,9,1920,1924,4,0.0,-1.2,-1.2,0,134,134,0,318,318,0.0,0.0,0.0,1500.0,0.0,-1500.0
kaufc001,Curt Kaufman,New York Yankees,YANKS,4,9,6,15,1983,1989,6,23.12,1.13,-21.99,1636,314,-1322,6240,852,-5388,207.0,0.0,-207.0,2062000.0,670000.0,-1392000.0
kaufd101,Dick Kauffman,St.Louis Browns,ORLS,1,3,1,4,1915,1917,2,0.0,-0.08,-0.08,0,17,17,0,34,34,0.0,0.0,0.0,1800.0,0.0,-1800.0
kauft101,Tony Kaufmann,Chicago Cubs,CUBS,1,2,1,3,1927,1927,0,-0.69,2.92,3.61,89,54,-35,289,70,-219,56.0,552.0,496.0,15500.0,0.0,-15500.0
kavam101,Marty Kavanagh,St. Louis Cardinals,CARDS,1,4,1,5,1918,1918,0,0.0,0.57,0.57,0,80,80,0,312,312,0.0,0.0,0.0,0.0,0.0,0.0
kay-a001,Anthony Kay,New York Mets,METS,1,2,2,4,2019,2021,2,0.01,4.89,4.88,27,85,58,0,81,81,206.0,716.0,510.0,0.0,7400000.0,7400000.0
kay-b101,Bill Kay,Newark,Newark,1,2,2,4,1912,1912,0,-0.4,0.0,0.4,214,0,-214,788,0,-788,0.0,0.0,0.0,0.0,4200.0,4200.0
kazae101,Eddie Kazak,St. Louis Cardinals,CARDS,2,5,3,8,1952,1954,2,-0.48,0.45,0.93,72,246,174,232,797,565,0.0,0.0,0.0,0.0,25500.0,25500.0
kazat101,Ted Kazanski,Philadelphia Phillies,PHILS,9,18,19,37,1959,1979,20,39.51,86.58,47.07,2824,3643,819,7602,10419,2817,7676.0,11796.0,4120.0,74500.0,159800.0,85300.0
kazat101,Ted Kazanski,Milwaukee Braves,BRAVES,1,1,1,2,1963,1964,1,0.0,0.0,0.0,0,0,0,0,0,0,0.0,0.0,0.0,0.0,0.0,0.0
kazms001,Scott Kazmir,New York Mets,METS,1,2,2,4,2004,2006,2,16.49,0.86,-15.63,150,111,-39,8,71,63,2502.0,670.0,-1832.0,0.0,325000.0,325000.0
kazms001,Scott Kazmir,Tampa Bay Devil Rays,RAYS,8,10,15,25,2009,2020,11,0.67,24.11,23.44,1050,1424,374,1555,3505,1950,1448.0,1779.0,331.0,9633000.0,505000.0,-9128000.0
kazms001,Scott Kazmir,Oakland Athletics,ATLTCS,3,6,6,12,2015,2021,6,0.34,9.52,9.18,161,880,719,447,3251,2804,220.0,908.0,688.0,0.0,0.0,0.0
kazms001,Scott Kazmir,Los Angeles Dodgers,DOGRS,4,17,9,26,2017,2021,4,6.07,9.48,3.41,927,279,-648,2727,1007,-1720,545.0,229.0,-316.0,71371000.0,90253480.0,18882480.0
keagg001,Greg Keagle,San Diego Padres,PADRS,6,15,14,29,1995,2006,11,8.74,38.72,29.98,1384,2329,945,3649,8703,5054,1217.0,136.0,-1081.0,12941680.0,19624000.0,6682320.0
keals101,Steve Kealey,California Angels,ANGELS,4,9,9,18,1971,1976,5,0.53,5.03,4.5,382,668,286,431,1911,1480,1134.0,244.0,-890.0,35000.0,131300.0,96300.0
keals101,Steve Kealey,Chicago White Sox,WSOX,1,1,1,2,1973,1974,1,0.0,0.33,0.33,0,5,5,0,0,0,0.0,55.0,55.0,0.0,0.0,0.0
keara001,Austin Kearns,Cincinnati Reds,REDS,1,3,5,8,2006,2012,6,0.43,-0.61,-1.04,795,705,-90,2860,181,-2679,139.0,809.0,670.0,4550000.0,1352000.0,-3198000.0
keara001,Austin Kearns,Cleveland Indians,INDINS,1,1,1,2,2010,2018,8,-0.03,2.96,2.99,36,296,260,119,6,-113,0.0,1765.0,1765.0,750000.0,0.0,-750000.0
kearb001,Bob Kearney,Oakland Athletics,ATLTCS,5,10,9,19,1983,1994,11,10.8,21.09,10.29,1624,930,-694,3370,2503,-867,1865.0,4119.0,2254.0,1837653.0,2467500.0,629847.0
keatc101,Chick Keating,Brooklyn Dodgers,DOGRS,1,2,1,3,1913,1913,0,1.78,0.0,-1.78,159,0,-159,149,0,-149,886.0,0.0,-886.0,0.0,0.0,0.0
keatg101,Greg Keatley,Chicago Cubs,CUBS,1,1,1,2,1981,1981,0,0.0,0.0,0.0,2,0,-2,0,0,0,0.0,0.0,0.0,0.0,0.0,0.0
keefd101,Dave Keefe,Philadelphia Athletics,ATLTCS,1,5,1,6,1922,1929,7,0.0,12.22,12.22,0,592,592,0,2318,2318,0.0,0.0,0.0,0.0,0.0,0.0
keelw101,Willie Keeler,Brooklyn Dodgers,DOGRS,1,2,2,4,1894,1896,2,29.72,4.69,-25.03,772,328,-444,3764,1481,-2283,0.0,0.0,0.0,0.0,0.0,0.0
keenv101,Vic Keen,Chicago Cubs,CUBS,2,3,2,5,1925,1927,2,-1.87,4.93,6.8,183,228,45,350,777,427,614.0,552.0,-62.0,22500.0,4850.0,-17650.0
keesj101,Jim Keesey,Portland,Portland,1,1,1,2,1929,1929,0,-0.03,0.0,0.03,11,0,-11,13,0,-13,0.0,0.0,0.0,0.0,0.0,0.0
keetr101,Rickey Keeton,Milwaukee Brewers,BREWRS,1,1,1,2,1981,1985,4,0.0,0.18,0.18,0,144,144,0,0,0,0.0,612.0,612.0,0.0,0.0,0.0
keisb101,Bill Keister,Philadelphia Phillies,PHILS,1,1,1,2,1904,1904,0,0.0,0.0,0.0,0,0,0,0,0,0,0.0,0.0,0.0,0.0,0.0,0.0
kekim101,Mike Kekich,Los Angeles Dodgers,DOGRS,2,2,2,4,1968,1977,9,-1.33,4.8,6.13,343,534,191,483,989,506,1691.0,2693.0,1002.0,0.0,0.0,0.0
kekim101,Mike Kekich,New York Yankees,YANKS,1,1,1,2,1973,1974,1,-1.15,0.0,1.15,19,0,-19,0,0,0,150.0,0.0,-150.0,0.0,0.0,0.0
kelak001,Keone Kela,Texas Rangers,RNGRS,1,1,2,3,2018,2018,0,1.6,0.0,-1.6,95,0,-95,0,0,0,141.0,0.0,-141.0,1200000.0,0.0,-1200000.0
kelej001,Jarred Kelenic,New York Mets,METS,1,5,3,8,2018,2018,0,-0.49,0.0,0.49,191,0,-191,565,0,-565,376.0,0.0,-376.0,16500000.0,12258065.0,-4241935.0
kella103,Alex Kellner,Cincinnati Reds,REDS,3,5,8,13,1958,1966,8,5.3,5.9,0.6,751,639,-112,1876,2223,347,111.0,126.0,15.0,0.0,10500.0,10500.0
kellb001,Bryan Kelly,Detroit Tigers,TIGRS,2,2,2,4,1987,1988,1,-0.18,0.0,0.18,11,0,-11,0,0,0,36.0,0.0,-36.0,0.0,0.0,0.0
kellb002,Roberto Kelly,New York Yankees,YANKS,1,1,2,3,1992,2001,9,2.46,26.68,24.22,125,1254,1129,538,5368,4830,0.0,0.0,0.0,2150000.0,2833333.0,683333.0
kellb002,Roberto Kelly,Cincinnati Reds,REDS,6,13,8,21,1994,2010,16,11.82,27.11,15.29,501,1515,1014,1009,5387,4378,2595.0,2089.0,-506.0,16400000.0,10195291.0,-6204709.0
kellb002,Roberto Kelly,Atlanta Braves,BRAVES,3,6,4,10,1995,1999,4,13.08,11.82,-1.26,850,727,-123,3247,1894,-1353,105.0,396.0,291.0,575000.0,700000.0,125000.0
kellb002,Roberto Kelly,Montreal Expos,NATEX,3,4,4,8,1995,2000,5,2.32,1.96,-0.36,552,545,-7,1710,1297,-413,362.0,850.0,488.0,2625000.0,373000.0,-2252000.0
kellb002,Roberto Kelly,Minnesota Twins,TWINS,1,1,2,3,1997,2005,8,1.1,10.83,9.73,30,203,173,129,21,-108,0.0,2839.0,2839.0,750000.0,0.0,-750000.0
kellb003,Brad Keller,Cincinnati Reds,REDS,1,1,1,2,2017,2017,0,8.15,0.0,-8.15,113,0,-113,20,0,-20,1482.0,0.0,-1482.0,0.0,0.0,0.0
kellb102,Bill Kelly,Philadelphia Phillies,PHILS,5,9,9,18,1928,1940,12,39.18,41.3,2.12,1904,2696,792,7415,9869,2454,0.0,0.0,0.0,21000.0,7500.0,-13500.0
kellb103,Bob Kelly,Chicago Cubs,CUBS,4,9,6,15,1953,1961,8,2.91,2.3,-0.61,226,408,182,136,878,742,1159.0,691.0,-468.0,0.0,0.0,0.0
kellb103,Bob Kelly,Cincinnati Reds,REDS,1,1,1,2,1958,1958,0,-0.16,-0.03,0.13,26,3,-23,5,1,-4,83.0,0.0,-83.0,0.0,0.0,0.0
kellc001,Casey Kelly,Boston Red Sox,RSOX,8,26,15,41,2010,2019,9,35.43,29.06,-6.37,2876,1721,-1155,5076,5808,732,4841.0,1908.0,-2933.0,4708000.0,21460000.0,16752000.0
kellc001,Casey Kelly,San Diego Padres,PADRS,1,2,1,3,2015,2017,2,-0.36,-0.48,-0.12,20,87,67,3,211,208,65.0,16.0,-49.0,0.0,507500.0,507500.0
kellc002,Carson Kelly,St. Louis Cardinals,CARDS,1,4,1,5,2018,2018,0,4.82,0.0,-4.82,382,0,-382,1034,0,-1034,549.0,0.0,-549.0,550800.0,11100000.0,10549200.0
kellf102,Frank Kellert,Baltimore Orioles,ORLS,2,4,2,6,1955,1961,6,0.69,2.14,1.45,39,125,86,91,93,2,0.0,858.0,858.0,0.0,0.0,0.0
kellf102,Frank Kellert,Chicago Cubs,CUBS,4,7,5,12,1957,1961,4,8.16,6.1,-2.06,620,391,-229,633,654,21,802.0,646.0,-156.0,0.0,0.0,0.0
kellf102,Frank Kellert,Baltimore Orioles,ORLS,1,2,3,5,1959,1959,0,0.0,0.0,0.0,0,0,0,0,0,0,0.0,0.0,0.0,0.0,0.0,0.0
kellf103,Frankie Kelleher,New York Yankees,YANKS,1,1,3,4,1942,1942,0,-0.16,0.25,0.41,47,10,-37,140,1,-139,0.0,21.0,21.0,0.0,0.0,0.0
kellg101,High Pockets Kelly,New York Giants,GIANTS,1,2,1,3,1927,1931,4,3.25,2.72,-0.53,375,301,-74,1523,1302,-221,0.0,0.0,0.0,0.0,0.0,0.0
kellg101,High Pockets Kelly,Minneapolis,Minneapolis,1,1,2,3,1930,1930,0,0.38,0.0,-0.38,39,0,-39,178,0,-178,0.0,0.0,0.0,0.0,10500.0,10500.0
kellg101,High Pockets Kelly,Minneapolis,Minneapolis,1,1,1,2,1932,1932,0,-0.36,0.0,0.36,64,0,-64,226,0,-226,0.0,0.0,0.0,0.0,0.0,0.0
kellg102,George Kell,Philadelphia Athletics,ATLTCS,1,1,1,2,1946,1951,5,23.18,8.66,-14.52,826,442,-384,3735,1820,-1915,0.0,0.0,0.0,8500.0,0.0,-8500.0
kellg102,George Kell,Detroit Tigers,TIGRS,18,41,43,84,1952,1964,12,49.33,53.4,4.07,4601,4657,56,11266,12496,1230,8483.0,9258.0,775.0,157700.0,102900.0,-54800.0
kellg102,George Kell,Boston Red Sox,RSOX,1,1,2,3,1954,1956,2,3.37,3.06,-0.31,220,230,10,856,836,-20,0.0,0.0,0.0,40000.0,0.0,-40000.0
kellg102,George Kell,Chicago White Sox,WSOX,2,5,3,8,1956,1961,5,20.82,6.19,-14.63,1000,561,-439,2990,1443,-1547,2136.0,479.0,-1657.0,62000.0,42500.0,-19500.0
kellh101,Harry Kelley,Memphis,Memphis,1,2,2,4,1924,1924,0,0.97,0.0,-0.97,178,0,-178,257,0,-257,684.0,0.0,-684.0,0.0,0.0,0.0
kellh101,Harry Kelley,Washington Senators,TWINS,2,8,2,10,1926,1941,15,14.54,44.02,29.48,801,1602,801,1696,6582,4886,3390.0,957.0,-2433.0,24000.0,6000.0,-18000.0
kellh101,Harry Kelley,Washington Senators,TWINS,2,7,2,9,1940,1943,3,7.97,0.58,-7.39,391,342,-49,1546,1354,-192,0.0,0.0,0.0,0.0,0.0,0.0
kellj001,Joe Kelly,St. Louis Cardinals,CARDS,1,2,3,5,2014,2015,1,1.43,5.3,3.87,264,83,-181,204,89,-115,1078.0,836.0,-242.0,0.0,0.0,0.0
kellj102,Joe Kelly,St.Joseph,St.Joseph,1,1,1,2,1913,1913,0,-0.51,0.0,0.51,141,0,-141,567,0,-567,0.0,0.0,0.0,0.0,0.0,0.0
kellj102,Joe Kelly,Chicago Cubs,CUBS,1,2,2,4,1916,1917,1,-1.02,0.0,1.02,181,2,-179,722,2,-720,0.0,0.0,0.0,0.0,1950.0,1950.0
kellj106,Joe Kelley,Pittsburgh Pirates,PIRATS,1,2,1,3,1892,1893,1,31.31,3.2,-28.11,781,137,-644,3624,667,-2957,0.0,0.0,0.0,0.0,3500.0,3500.0
kellk001,Kenny Kelly,Seattle Mariners,MARNRS,1,1,2,3,2003,2003,0,0.0,1.06,1.06,0,46,46,0,186,186,0.0,0.0,0.0,0.0,1300000.0,1300000.0
kellk002,Kris Keller,Detroit Tigers,TIGRS,1,1,1,2,2002,2003,1,0.0,-0.3,-0.3,0,72,72,0,270,270,0.0,0.0,0.0,0.0,0.0,0.0
kellk003,Kyle Keller,Miami Marlins,MARLNS,1,1,1,2,2020,2020,0,-0.03,0.0,0.03,2,0,-2,0,0,0,7.0,0.0,-7.0,0.0,0.0,0.0
kellm001,Mike Kelly,Atlanta Braves,BRAVES,3,3,4,7,1996,1999,3,2.81,4.25,1.44,353,331,-22,220,756,536,437.0,82.0,-355.0,150000.0,700000.0,550000.0
kellm001,Mike Kelly,Cincinnati Reds,REDS,1,1,1,2,1997,1997,0,-0.19,0.0,0.19,106,0,-106,303,0,-303,0.0,0.0,0.0,175000.0,0.0,-175000.0
kellm101,Mick Kelleher,St. Louis Cardinals,CARDS,18,41,35,76,1975,1994,19,89.8,138.96,49.16,8918,6795,-2123,24477,23221,-1256,10540.0,4019.0,-6521.0,3088333.0,809167.0,-2279166.0
kellm103,Mike Kelley,Louisville Colonels,LS3,1,12,5,17,1899,1900,1,267.1,0.0,-267.1,7388,0,-7388,29004,0,-29004,7568.0,0.0,-7568.0,4350.0,0.0,-4350.0
kellp101,Pat Kelly,Kansas City Royals,ROYALS,1,2,2,4,1970,1974,4,5.15,1.5,-3.65,692,230,-462,2721,588,-2133,0.0,0.0,0.0,26000.0,15000.0,-11000.0
kellp101,Pat Kelly,Chicago White Sox,WSOX,1,1,1,2,1976,1977,1,3.73,0.0,-3.73,377,0,-377,1155,0,-1155,0.0,0.0,0.0,0.0,0.0,0.0
kellp102,Pat Kelly,California Angels,ANGELS,1,2,1,3,1977,1977,0,-0.09,0.0,0.09,9,0,-9,25,0,-25,0.0,0.0,0.0,0.0,0.0,0.0
kellr001,Ryan Kelly,Oakland Athletics,ATLTCS,3,4,3,7,2011,2014,3,3.45,5.86,2.41,352,341,-11,551,854,303,434.0,601.0,167.0,3675000.0,3200000.0,-475000.0
kellr001,Ryan Kelly,Texas Rangers,RNGRS,1,1,1,2,2011,2013,2,0.0,-0.3,-0.3,0,10,10,0,19,19,0.0,0.0,0.0,0.0,0.0,0.0
kellr001,Ryan Kelly,Pittsburgh Pirates,PIRATS,1,1,1,2,2010,2010,0,0.0,0.0,0.0,0,0,0,0,0,0,0.0,0.0,0.0,0.0,0.0,0.0
kellr102,Ren Kelly,Philadelphia Athletics,ATLTCS,1,3,1,4,1924,1926,2,0.0,8.0,8.0,0,166,166,0,103,103,0.0,950.0,950.0,0.0,0.0,0.0
kells001,Shawn Kelley,Seattle Mariners,MARNRS,2,3,2,5,2013,2014,1,0.03,0.09,0.06,189,84,-105,182,285,103,315.0,0.0,-315.0,0.0,2250000.0,2250000.0
kells001,Shawn Kelley,New York Yankees,YANKS,2,2,2,4,2014,2017,3,0.98,-0.29,-1.27,150,13,-137,1,0,-1,240.0,39.0,-201.0,1765000.0,0.0,-1765000.0
kells001,Shawn Kelley,Washington Nationals,NATEX,1,2,1,3,2018,2018,0,0.46,0.0,-0.46,19,0,-19,0,0,0,50.0,0.0,-50.0,5500000.0,0.0,-5500000.0
kellt001,Ty Kelly,Baltimore Orioles,ORLS,1,1,1,2,2013,2013,0,0.0,0.0,0.0,0,0,0,0,0,0,0.0,0.0,0.0,0.0,0.0,0.0
kellt001,Ty Kelly,Seattle Mariners,MARNRS,1,1,1,2,2014,2017,3,0.0,0.24,0.24,0,14,14,0,5,5,0.0,187.0,187.0,0.0,0.0,0.0
kellv101,Van Kelly,Atlanta Braves,BRAVES,1,3,1,4,1969,1970,1,-0.8,2.26,3.06,142,212,70,403,844,441,0.0,0.0,0.0,0.0,0.0,0.0
kelsb101,Bill Kelso,California Angels,ANGELS,3,4,4,8,1967,1971,4,-0.47,-0.05,0.42,214,297,83,361,652,291,251.0,492.0,241.0,20000.0,26500.0,6500.0
kelsb101,Bill Kelso,Montreal Expos,NATEX,1,2,2,4,1972,1973,1,-1.6,-1.59,0.01,85,126,41,8,295,287,188.0,2.0,-186.0,0.0,0.0,0.0
kemmr101,Russ Kemmerer,Boston Red Sox,RSOX,3,5,4,9,1957,1961,4,-1.86,-2.15,-0.29,679,212,-467,1371,205,-1166,1950.0,366.0,-1584.0,0.0,36500.0,36500.0
kemmr101,Russ Kemmerer,Chicago White Sox,WSOX,1,1,1,2,1962,1963,1,0.25,0.75,0.5,106,54,-52,17,2,-15,314.0,91.0,-223.0,0.0,12500.0,12500.0
kempm001,Matt Kemp,Los Angeles Dodgers,DOGRS,4,10,8,18,2014,2021,7,6.08,11.37,5.29,476,899,423,1306,2454,1148,1807.0,359.0,-1448.0,21000000.0,12293600.0,-8706400.0
kempm001,Matt Kemp,San Diego Padres,PADRS,1,2,1,3,2016,2016,0,-1.22,0.0,1.22,171,0,-171,708,0,-708,0.0,0.0,0.0,0.0,0.0,0.0
kempm001,Matt Kemp,Atlanta Braves,BRAVES,1,1,5,6,2017,2020,3,1.15,0.27,-0.88,146,264,118,506,504,-2,0.0,246.0,246.0,21750000.0,34407000.0,12657000.0
kempm001,Matt Kemp,Los Angeles Dodgers,DOGRS,3,12,8,20,2018,2021,3,5.8,8.33,2.53,663,133,-530,2223,501,-1722,299.0,229.0,-70.0,36964000.0,68503480.0,31539480.0
kemps001,Steve Kemp,Detroit Tigers,TIGRS,1,1,1,2,1981,1981,0,2.03,0.0,-2.03,160,0,-160,679,0,-679,0.0,0.0,0.0,600000.0,0.0,-600000.0
kemps001,Steve Kemp,New York Yankees,YANKS,3,7,5,12,1984,1989,5,23.0,1.52,-21.48,1607,253,-1354,6240,680,-5560,0.0,0.0,0.0,2062000.0,670000.0,-1392000.0
kempt001,Tony Kemp,Houston Astros,ASTROS,1,1,1,2,2019,2019,0,-0.1,0.55,0.65,44,27,-17,93,98,5,0.0,0.0,0.0,583600.0,0.0,-583600.0
kempt001,Tony Kemp,Chicago Cubs,CUBS,1,1,1,2,2020,2020,0,3.17,0.0,-3.17,180,0,-180,511,0,-511,0.0,0.0,0.0,0.0,0.0,0.0
kendf101,Fred Kendall,San Diego Padres,PADRS,2,4,2,6,1976,1981,5,20.22,7.28,-12.94,1143,413,-730,4572,857,-3715,0.0,1243.0,1243.0,0.0,0.0,0.0
kendf101,Fred Kendall,Cleveland Indians,INDINS,8,14,20,34,1978,2004,26,62.43,62.22,-0.21,2207,3046,839,7220,10248,3028,6797.0,6915.0,118.0,1767500.0,1412500.0,-355000.0
kendh001,Howie Kendrick,Anaheim Angels,ANGELS,2,3,3,6,2014,2021,7,1.6,5.7,4.1,277,115,-162,1039,17,-1022,107.0,1764.0,1657.0,16100000.0,0.0,-16100000.0
kendh001,Howie Kendrick,Los Angeles Dodgers,DOGRS,1,1,2,3,2016,2017,1,1.24,0.0,-1.24,39,0,-39,156,0,-156,0.0,0.0,0.0,10000000.0,527000.0,-9473000.0
kendh001,Howie Kendrick,Philadelphia Phillies,PHILS,2,3,4,7,2017,2018,1,3.05,-0.18,-3.23,238,29,-209,808,54,-754,0.0,0.0,0.0,10000000.0,3400000.0,-6600000.0
kendj001,Jason Kendall,Pittsburgh Pirates,PIRATS,4,5,8,13,2004,2008,4,8.37,-0.3,-8.67,471,259,-212,1700,523,-1177,631.0,692.0,61.0,20821429.0,11050000.0,-9771429.0
kendj001,Jason Kendall,Oakland Athletics,ATLTCS,4,5,5,10,2007,2017,10,-1.72,5.43,7.15,231,610,379,284,1129,845,172.0,801.0,629.0,13958194.0,0.0,-13958194.0
kenna001,Adam Kennedy,St. Louis Cardinals,CARDS,4,6,6,12,2000,2019,19,27.34,51.35,24.01,1988,2348,360,6641,8016,1375,960.0,194.0,-766.0,13224540.0,0.0,-13224540.0
kenna001,Adam Kennedy,Tampa Bay Devil Rays,RAYS,1,1,1,2,2009,2010,1,1.07,0.16,-0.91,129,15,-114,587,35,-552,0.0,0.0,0.0,0.0,0.0,0.0
kennb103,Bill Kennedy,Cleveland Indians,INDINS,2,5,2,7,1948,1951,3,4.59,4.03,-0.56,440,274,-166,755,90,-665,1641.0,1005.0,-636.0,0.0,25700.0,25700.0
kennb103,Bill Kennedy,Chicago White Sox,WSOX,1,3,1,4,1953,1953,0,1.18,-0.21,-1.39,202,44,-158,118,143,25,1116.0,0.0,-1116.0,0.0,0.0,0.0
kennb104,Bob Kennedy,Chicago White Sox,WSOX,1,1,2,3,1948,1949,1,3.02,1.54,-1.48,564,179,-385,1747,480,-1267,0.0,633.0,633.0,0.0,0.0,0.0
kennb104,Bob Kennedy,Cleveland Indians,INDINS,1,1,1,2,1954,1955,1,-0.81,0.0,0.81,132,2,-130,439,2,-437,0.0,0.0,0.0,0.0,0.0,0.0
kennb104,Bob Kennedy,Chicago White Sox,WSOX,10,18,21,39,1956,1971,15,41.93,77.23,35.3,3299,4500,1201,10984,12532,1548,917.0,5807.0,4890.0,83500.0,48000.0,-35500.0
kenni001,Ian Kennedy,New York Yankees,YANKS,1,3,1,4,2009,2013,4,8.92,14.94,6.02,232,513,281,259,2148,1889,2245.0,0.0,-2245.0,812225.0,0.0,-812225.0
kenni001,Ian Kennedy,Arizona Diamondbacks,DBACKS,2,3,4,7,2013,2019,6,1.03,-1.21,-2.24,176,209,33,146,0,-146,1299.0,234.0,-1065.0,2884500.0,0.0,-2884500.0
kenni001,Ian Kennedy,Texas Rangers,RNGRS,1,4,3,7,2021,2021,0,0.8,-1.21,-2.01,74,9,-65,29,0,-29,300.0,64.0,-236.0,9766666.0,0.0,-9766666.0
kennj001,Joe Kennedy,Tampa Bay Devil Rays,RAYS,2,4,4,8,2003,2012,9,3.74,4.31,0.57,213,667,454,202,1894,1692,1356.0,1780.0,424.0,4500000.0,682000.0,-3818000.0
kennj001,Joe Kennedy,Colorado Rockies,ROCKS,3,5,4,9,2005,2010,5,4.0,-0.14,-4.14,707,385,-322,1691,690,-1001,801.0,134.0,-667.0,2526000.0,4430000.0,1904000.0
kennj101,Junior Kennedy,Baltimore Orioles,ORLS,1,3,2,5,1973,1977,4,4.01,5.74,1.73,498,137,-361,1375,0,-1375,0.0,2543.0,2543.0,40000.0,29000.0,-11000.0
kennj103,Jerry Kenney,New York Yankees,YANKS,5,8,9,17,1972,1987,15,9.09,48.73,39.64,1757,1810,53,5603,6602,999,883.0,1959.0,1076.0,246600.0,963000.0,716400.0
kennj105,John Kennedy,Washington Senators,RNGRS,25,44,50,94,1964,1986,22,142.7,105.14,-37.56,8431,6596,-1835,19421,19306,-115,25577.0,10905.0,-14672.0,342900.0,824500.0,481600.0
kennj105,John Kennedy,Los Angeles Dodgers,DOGRS,1,1,3,4,1967,1967,0,-0.55,0.0,0.55,78,0,-78,208,0,-208,0.0,0.0,0.0,0.0,0.0,0.0
kennj106,Jim Kennedy,St. Louis Cardinals,CARDS,1,2,2,4,1970,1970,0,0.05,0.0,-0.05,12,0,-12,0,0,0,13.0,0.0,-13.0,12000.0,8000.0,-4000.0
kennt001,Terry Kennedy,St. Louis Cardinals,CARDS,9,26,18,44,1980,1992,12,83.63,101.91,18.28,6733,4351,-2382,20851,14642,-6209,6532.0,3025.0,-3507.0,1533333.0,576667.0,-956666.0
kennt001,Terry Kennedy,San Diego Padres,PADRS,2,3,3,6,1986,1990,4,10.9,-1.16,-12.06,682,244,-438,834,162,-672,3461.0,484.0,-2977.0,1525000.0,583133.0,-941867.0
kennt001,Terry Kennedy,Baltimore Orioles,ORLS,2,2,2,4,1989,1992,3,3.87,2.38,-1.49,333,305,-28,995,864,-131,0.0,268.0,268.0,650000.0,0.0,-650000.0
kennv101,Vern Kennedy,Chicago White Sox,WSOX,2,4,5,9,1937,1950,13,5.83,16.69,10.86,429,2282,1853,1515,8577,7062,633.0,270.0,-363.0,37500.0,31250.0,-6250.0
kennv101,Vern Kennedy,Detroit Tigers,TIGRS,3,9,7,16,1939,1948,9,19.29,21.11,1.82,2183,1686,-497,6579,6030,-549,3951.0,2317.0,-1634.0,44300.0,54500.0,10200.0
kennv101,Vern Kennedy,St.Louis Browns,ORLS,2,2,3,5,1941,1944,3,3.13,0.7,-2.43,262,273,11,859,934,75,199.0,0.0,-199.0,9000.0,8500.0,-500.0
kennv101,Vern Kennedy,Philadelphia Phillies,PHILS,1,1,1,2,1945,1945,0,1.86,0.35,-1.51,48,49,1,55,187,132,473.0,0.0,-473.0,0.0,0.0,0.0
kensl001,Logan Kensing,Florida Marlins,MARLNS,1,1,1,2,2009,2009,0,-0.93,0.0,0.93,52,0,-52,2,0,-2,84.0,0.0,-84.0,660000.0,0.0,-660000.0
kentj001,Jeff Kent,Toronto Blue Jays,BJAYS,1,2,1,3,1992,1992,0,11.81,1.64,-10.17,781,8,-773,3098,0,-3098,0.0,159.0,159.0,109000.0,4250000.0,4141000.0
kentj001,Jeff Kent,New York Mets,METS,1,2,2,4,1996,1998,2,0.91,1.15,0.24,87,354,267,307,1284,977,0.0,0.0,0.0,4160000.0,5150000.0,990000.0
kentj001,Jeff Kent,Cleveland Indians,INDINS,3,6,6,12,1996,2001,5,40.02,3.44,-36.58,2173,212,-1961,7166,649,-6517,933.0,172.0,-761.0,7541666.0,6600000.0,-941666.0
kenwd101,Duke Kenworthy,KansasCity,KansasCity,3,4,7,11,1912,1915,3,56.9,0.0,-56.9,1282,0,-1282,2403,0,-2403,9207.0,0.0,-9207.0,0.0,5700.0,5700.0
keouj101,Joe Keough,Kansas City Royals,ROYALS,1,1,1,2,1973,1973,0,0.0,0.0,0.0,5,0,-5,1,0,-1,0.0,0.0,0.0,0.0,0.0,0.0
keoum001,Matt Keough,Oakland Athletics,ATLTCS,1,1,3,4,1983,1983,0,-0.76,-1.24,-0.48,12,9,-3,0,14,14,167.0,28.0,-139.0,0.0,0.0,0.0
keoum101,Marty Keough,Boston Red Sox,RSOX,4,8,6,14,1960,1966,6,-2.7,-1.76,0.94,273,963,690,690,2516,1826,122.0,336.0,214.0,18500.0,0.0,-18500.0
keoum101,Marty Keough,Washington Senators,RNGRS,1,2,2,4,1961,1963,2,1.4,0.77,-0.63,457,97,-360,839,291,-548,326.0,0.0,-326.0,0.0,0.0,0.0
keoum101,Marty Keough,Atlanta Braves,BRAVES,2,4,3,7,1966,1966,0,-0.17,-0.08,0.09,59,17,-42,34,18,-16,53.0,0.0,-53.0,0.0,0.0,0.0
keppj001,Jeff Keppinger,Pittsburgh Pirates,PIRATS,2,3,4,7,2004,2009,5,40.94,-2.9,-43.84,1344,558,-786,5481,2041,-3440,727.0,0.0,-727.0,7950000.0,316000.0,-7634000.0
keppj001,Jeff Keppinger,New York Mets,METS,1,1,1,2,2006,2008,2,0.13,0.08,-0.05,22,98,76,67,211,144,0.0,0.0,0.0,0.0,0.0,0.0
keppj001,Jeff Keppinger,Kansas City Royals,ROYALS,1,1,1,2,2007,2007,0,-0.16,0.0,0.16,188,0,-188,778,0,-778,0.0,0.0,0.0,0.0,0.0,0.0
keppj001,Jeff Keppinger,Cincinnati Reds,REDS,1,1,1,2,2009,2010,1,1.11,0.02,-1.09,287,44,-243,1089,79,-1010,0.0,0.0,0.0,0.0,0.0,0.0
keppj001,Jeff Keppinger,Houston Astros,ASTROS,1,1,2,3,2011,2012,1,-0.74,-0.35,0.39,56,20,-36,230,18,-212,0.0,160.0,160.0,2300000.0,0.0,-2300000.0
kerfc001,Charlie Kerfeld,Houston Astros,ASTROS,1,1,2,3,1990,1990,0,-0.56,0.0,0.56,50,0,-50,0,0,0,92.0,0.0,-92.0,122000.0,0.0,-122000.0
kerig101,Gus Keriazakos,Chicago White Sox,WSOX,2,5,3,8,1954,1956,2,0.93,2.11,1.18,375,206,-169,742,121,-621,750.0,421.0,-329.0,8500.0,0.0,-8500.0
kerig101,Gus Keriazakos,Washington Senators,TWINS,1,1,1,2,1955,1955,0,-0.73,0.0,0.73,10,0,-10,3,0,-3,35.0,0.0,-35.0,0.0,0.0,0.0
kernj001,Jim Kern,Cleveland Indians,INDINS,12,19,27,46,1978,2004,26,61.95,109.09,47.14,2403,4779,2376,7210,16982,9772,7208.0,9771.0,2563.0,2352500.0,1522500.0,-830000.0
kernj001,Jim Kern,Texas Rangers,RNGRS,1,1,2,3,1981,1982,1,0.0,-1.77,-1.77,0,88,88,0,283,283,0.0,0.0,0.0,163000.0,170000.0,7000.0
kernj001,Jim Kern,New York Mets,METS,1,3,1,4,1982,1986,4,1.8,4.68,2.88,378,655,277,630,2610,1980,505.0,0.0,-505.0,0.0,0.0,0.0
kernj001,Jim Kern,Cincinnati Reds,REDS,2,2,3,5,1982,1988,6,-0.34,0.98,1.32,25,173,148,34,225,191,86.0,476.0,390.0,0.0,0.0,0.0
kerrb101,Buddy Kerr,New York Giants,GIANTS,14,31,27,58,1949,1968,19,59.86,70.44,10.58,4286,4168,-118,14522,10114,-4408,1384.0,8678.0,7294.0,127500.0,134500.0,7000.0
kerrj101,Joe Kerrigan,Montreal Expos,NATEX,1,3,3,6,1977,1986,9,17.04,9.91,-7.13,1002,506,-496,2634,346,-2288,744.0,3222.0,2478.0,0.0,0.0,0.0
kerrj101,Joe Kerrigan,Baltimore Orioles,ORLS,1,2,2,4,1981,1981,0,0.0,0.0,0.0,0,0,0,0,0,0,0.0,0.0,0.0,0.0,0.0,0.0
kerrj102,John Kerr,Chicago White Sox,WSOX,3,5,5,10,1931,1940,9,20.15,15.13,-5.02,1226,1402,176,4055,5150,1095,2296.0,2157.0,-139.0,35600.0,36500.0,900.0
kessd101,Don Kessinger,Chicago Cubs,CUBS,7,10,16,26,1975,1996,21,23.71,94.5,70.79,2653,4614,1961,6964,18168,11204,2336.0,1952.0,-384.0,0.0,0.0,0.0
kessd101,Don Kessinger,St. Louis Cardinals,CARDS,1,1,1,2,1977,1977,0,-1.19,0.0,1.19,226,0,-226,738,0,-738,0.0,0.0,0.0,0.0,0.0,0.0
kessk001,Keith Kessinger,Cincinnati Reds,REDS,1,1,1,2,1995,1995,0,0.0,0.0,0.0,0,0,0,0,0,0,0.0,0.0,0.0,0.0,0.0,0.0
ketcf101,Fred Ketchum,Pittsburgh Pirates,PIRATS,1,3,1,4,1901,1901,0,0.0,-0.42,-0.42,0,14,14,0,21,21,0.0,133.0,133.0,0.0,0.0,0.0
kibbj101,Jack Kibble,Cleveland Indians,INDINS,1,6,1,7,1913,1914,1,0.0,-0.98,-0.98,0,48,48,0,37,37,0.0,303.0,303.0,0.0,0.0,0.0
kickm001,Mike Kickham,Chicago Cubs,CUBS,1,1,1,2,2015,2015,0,0.0,0.0,0.0,0,0,0,0,0,0,0.0,0.0,0.0,0.0,0.0,0.0
kiefj101,Joe Kiefer,Boston Red Sox,RSOX,1,3,1,4,1926,1926,0,0.0,-0.79,-0.79,0,31,31,0,103,103,0.0,0.0,0.0,7100.0,0.0,-7100.0
kiefm001,Mark Kiefer,Milwaukee Brewers,BREWRS,1,1,1,2,1996,1996,0,0.0,0.0,0.0,0,0,0,0,0,0,0.0,0.0,0.0,130000.0,0.0,-130000.0
kiefs001,Steve Kiefer,Oakland Athletics,ATLTCS,1,4,1,5,1986,1987,1,2.24,1.63,-0.61,195,21,-174,688,0,-688,0.0,339.0,339.0,0.0,0.0,0.0
kielb001,Bobby Kielty,Minnesota Twins,TWINS,1,1,2,3,2003,2007,4,-0.21,4.68,4.89,62,335,273,225,1523,1298,0.0,23.0,23.0,325000.0,6200000.0,5875000.0
kielb001,Bobby Kielty,Toronto Blue Jays,BJAYS,1,1,1,2,2003,2006,3,2.48,5.93,3.45,293,96,-197,1048,10,-1038,0.0,1516.0,1516.0,0.0,335000.0,335000.0
kiell101,Leo Kiely,Boston Red Sox,RSOX,1,1,1,2,1960,1960,0,0.0,0.1,0.1,0,7,7,0,5,5,0.0,0.0,0.0,0.0,0.0,0.0
kiell101,Leo Kiely,Cleveland Indians,INDINS,1,1,1,2,1960,1960,0,1.48,-0.36,-1.84,40,6,-34,3,0,-3,62.0,7.0,-55.0,0.0,0.0,0.0
kildp101,Pete Kilduff,New York Giants,GIANTS,1,1,1,2,1917,1919,2,0.8,-0.07,-0.87,117,82,-35,435,75,-360,0.0,667.0,667.0,0.0,0.0,0.0
kildp101,Pete Kilduff,Chicago Cubs,CUBS,1,1,1,2,1919,1919,0,5.5,1.59,-3.91,280,79,-201,1068,299,-769,0.0,0.0,0.0,0.0,0.0,0.0
kiled001,Darryl Kile,Colorado Rockies,ROCKS,13,23,24,47,1999,2003,4,20.8,11.07,-9.73,2188,1626,-562,1402,1034,-368,5980.0,2442.0,-3538.0,24071314.0,14545000.0,-9526314.0
kilgp001,Paul Kilgus,Texas Rangers,RNGRS,2,7,4,11,1988,1994,6,0.27,27.89,27.62,791,1284,493,491,4575,4084,1767.0,710.0,-1057.0,532500.0,300500.0,-232000.0
kilgp001,Paul Kilgus,Chicago Cubs,CUBS,1,1,1,2,1989,1989,0,-0.19,0.0,0.19,11,0,-11,0,0,0,49.0,0.0,-49.0,130000.0,175000.0,45000.0
kilgp001,Paul Kilgus,Toronto Blue Jays,BJAYS,1,1,1,2,1990,1991,1,-0.6,0.08,0.68,38,2,-36,0,0,0,186.0,6.0,-180.0,242500.0,104500.0,-138000.0
kilkm101,Mike Kilkenny,Detroit Tigers,TIGRS,2,2,2,4,1972,1975,3,0.03,0.09,0.06,2,79,77,0,299,299,3.0,0.0,-3.0,0.0,0.0,0.0
kilkm101,Mike Kilkenny,Oakland Athletics,ATLTCS,1,3,1,4,1972,1972,0,-0.03,-0.15,-0.12,84,20,-64,122,60,-62,13.0,0.0,-13.0,20500.0,36000.0,15500.0
kilkm101,Mike Kilkenny,San Diego Padres,PADRS,2,2,2,4,1972,1972,0,2.83,-0.3,-3.13,570,39,-531,1173,99,-1074,180.0,0.0,-180.0,0.0,10500.0,10500.0
killb101,Bill Killefer,Philadelphia Phillies,PHILS,5,11,13,24,1917,1929,12,74.14,17.51,-56.63,2587,762,-1825,7576,2068,-5508,10093.0,3446.0,-6647.0,21000.0,24850.0,3850.0
killb101,Bill Killefer,Buffalo,Buffalo,1,1,2,3,1911,1916,5,6.81,0.0,-6.81,636,0,-636,2095,0,-2095,0.0,0.0,0.0,0.0,0.0,0.0
kille101,Ed Killian,Cleveland Indians,INDINS,1,2,1,3,1904,1904,0,22.67,2.88,-19.79,462,138,-324,681,580,-101,5040.0,0.0,-5040.0,0.0,0.0,0.0
killf101,Frank Killen,Washington Senators,WSN,2,3,5,8,1893,1894,1,54.92,2.16,-52.76,1137,156,-981,2556,613,-1943,10234.0,309.0,-9925.0,0.0,0.0,0.0
killr101,Red Killefer,Detroit Tigers,TIGRS,1,2,1,3,1909,1909,0,6.2,1.23,-4.97,528,46,-482,1839,188,-1651,2.0,0.0,-2.0,0.0,0.0,0.0
killr101,Red Killefer,Cincinnati Reds,REDS,2,3,5,8,1916,1930,14,6.12,44.47,38.35,494,1760,1266,2101,7377,5276,0.0,27.0,27.0,0.0,3300.0,3300.0
killr101,Red Killefer,Minneapolis,Minneapolis,1,1,3,4,1914,1914,0,3.75,0.0,-3.75,267,0,-267,1074,0,-1074,0.0,0.0,0.0,0.0,0.0,0.0
kilof001,Franklyn Kilome,Philadelphia Phillies,PHILS,1,1,1,2,2018,2018,0,-0.31,-0.75,-0.44,4,49,45,0,185,185,34.0,0.0,-34.0,0.0,8250000.0,8250000.0
kim-b001,Byung-Hyun Kim,Arizona Diamondbacks,DBACKS,2,2,2,4,2003,2005,2,3.93,0.4,-3.53,293,233,-60,971,958,-13,290.0,0.0,-290.0,3250000.0,407500.0,-2842500.0
kim-b001,Byung-Hyun Kim,Boston Red Sox,RSOX,1,2,2,4,2005,2005,0,1.04,0.0,-1.04,138,0,-138,104,0,-104,927.0,0.0,-927.0,0.0,0.0,0.0
kim-b001,Byung-Hyun Kim,Colorado Rockies,ROCKS,1,1,1,2,2007,2007,0,-0.15,0.73,0.88,44,112,68,39,1,-38,329.0,158.0,-171.0,2500000.0,3600000.0,1100000.0
kim-h001,Hyun Soo Kim,Baltimore Orioles,ORLS,1,3,1,4,2017,2017,0,-0.92,-0.85,0.07,41,10,-31,97,0,-97,2.0,155.0,153.0,4200000.0,17200000.0,13000000.0
kim-s001,Sun-Woo Kim,Boston Red Sox,RSOX,1,2,1,3,2002,2002,0,0.77,1.55,0.78,122,47,-75,49,190,141,598.0,0.0,-598.0,0.0,0.0,0.0
kimbc001,Craig Kimbrel,Atlanta Braves,BRAVES,4,8,11,19,2015,2021,6,6.43,9.54,3.11,663,1279,616,1140,3485,2345,998.0,1493.0,495.0,8100000.0,1673000.0,-6427000.0
kimbc001,Craig Kimbrel,San Diego Padres,PADRS,4,10,9,19,2015,2021,6,17.49,6.57,-10.92,972,677,-295,2890,2192,-698,745.0,184.0,-561.0,9570500.0,0.0,-9570500.0
kimbc001,Craig Kimbrel,Chicago Cubs,CUBS,1,1,2,3,2021,2021,0,-0.03,0.52,0.55,26,48,22,0,0,0,69.0,86.0,17.0,16000000.0,0.0,-16000000.0
kimbn101,Newt Kimball,Chicago Cubs,CUBS,1,2,1,3,1939,1943,4,1.28,-0.27,-1.55,170,131,-39,187,453,266,378.0,0.0,-378.0,12500.0,10000.0,-2500.0
kimmb101,Bruce Kimm,Chicago White Sox,WSOX,1,2,1,3,1972,1973,1,0.0,0.54,0.54,0,38,38,0,7,7,0.0,399.0,399.0,0.0,0.0,0.0
kimmb101,Bruce Kimm,California Angels,ANGELS,1,1,1,2,1973,1973,0,1.22,-0.04,-1.26,77,4,-73,200,7,-193,0.0,0.0,0.0,0.0,0.0,0.0
kimmw101,Wally Kimmick,Vernon,Vernon,1,1,1,2,1924,1931,7,0.24,0.0,-0.24,90,0,-90,196,0,-196,0.0,0.0,0.0,0.0,3600.0,3600.0
kimsc101,Chad Kimsey,Chicago White Sox,WSOX,1,2,1,3,1933,1933,0,0.0,0.0,0.0,0,0,0,0,0,0,0.0,0.0,0.0,6000.0,0.0,-6000.0
kinde101,Ellis Kinder,St.Louis Browns,ORLS,13,24,31,55,1947,1960,13,52.08,29.92,-22.16,3700,3192,-508,8156,7991,-165,9955.0,6124.0,-3831.0,59000.0,72800.0,13800.0
kindj101,Jerry Kindall,Chicago Cubs,CUBS,2,2,2,4,1961,1962,1,1.94,0.0,-1.94,265,0,-265,879,0,-879,6.0,0.0,-6.0,0.0,0.0,0.0
kindj101,Jerry Kindall,Cleveland Indians,INDINS,1,1,1,2,1964,1964,0,-1.4,-0.72,0.68,187,69,-118,534,175,-359,0.0,0.0,0.0,16000.0,0.0,-16000.0
kiner101,Ralph Kiner,Pittsburgh Pirates,PIRATS,7,12,15,27,1953,1962,9,9.43,3.47,-5.96,1075,1271,196,3095,3842,747,1449.0,56.0,-1393.0,86000.0,33500.0,-52500.0
kiner101,Ralph Kiner,Chicago Cubs,CUBS,6,11,12,23,1954,1965,11,7.51,12.81,5.3,750,1225,475,1798,351,-1447,1395.0,4049.0,2654.0,65000.0,0.0,-65000.0
kingc101,Clyde King,Brooklyn Dodgers,DOGRS,1,1,2,3,1952,1952,0,0.06,0.0,-0.06,70,0,-70,13,0,-13,228.0,0.0,-228.0,0.0,8000.0,8000.0
kingc102,Chick King,Detroit Tigers,TIGRS,2,3,2,5,1957,1958,1,0.0,0.0,0.0,0,16,16,0,24,24,0.0,0.0,0.0,0.0,0.0,0.0
kingc102,Chick King,Milwaukee Braves,BRAVES,2,7,3,10,1957,1961,4,-1.07,-0.69,0.38,281,102,-179,637,325,-312,138.0,0.0,-138.0,0.0,0.0,0.0
kingc102,Chick King,Chicago Cubs,CUBS,1,1,1,2,1959,1960,1,0.02,1.9,1.88,5,77,72,8,186,178,0.0,0.0,0.0,0.0,0.0,0.0
kingd001,Dave Kingman,New York Mets,METS,2,2,3,5,1977,1979,2,0.36,-0.17,-0.53,56,215,159,187,280,93,0.0,168.0,168.0,95000.0,0.0,-95000.0
kingd001,Dave Kingman,California Angels,ANGELS,1,1,2,3,1977,1977,0,0.37,0.0,-0.37,8,0,-8,27,0,-27,0.0,0.0,0.0,0.0,0.0,0.0
kingd001,Dave Kingman,Chicago Cubs,CUBS,4,9,7,16,1981,1987,6,4.35,1.97,-2.38,1026,637,-389,2958,998,-1960,766.0,1115.0,349.0,873333.0,878000.0,4667.0
kinge001,Eric King,San Francisco Giants,GIANTS,3,6,5,11,1985,1991,6,8.16,14.64,6.48,1129,850,-279,2301,1999,-302,2390.0,2023.0,-367.0,0.0,990000.0,990000.0
kinge001,Eric King,Detroit Tigers,TIGRS,1,1,1,2,1989,1990,1,5.11,-1.56,-6.67,50,151,101,0,373,373,931.0,0.0,-931.0,0.0,0.0,0.0
kinge001,Eric King,Chicago White Sox,WSOX,2,3,4,7,1990,1991,1,1.38,-0.4,-1.78,97,56,-41,54,126,72,701.0,15.0,-686.0,1315000.0,700000.0,-615000.0
kingg001,Gene Kingsale,San Diego Padres,PADRS,1,1,1,2,2002,2003,1,-0.58,-0.41,0.17,39,19,-20,140,58,-82,0.0,0.0,0.0,0.0,200000.0,200000.0
kingh102,Hal King,Houston Astros,ASTROS,8,15,11,26,1969,1989,20,9.86,19.8,9.94,2403,1970,-433,5583,4832,-751,5444.0,4390.0,-1054.0,22500.0,16500.0,-6000.0
kingh102,Hal King,Atlanta Braves,BRAVES,1,1,1,2,1971,1975,4,0.97,-1.91,-2.88,50,173,123,150,500,350,0.0,0.0,0.0,17500.0,26000.0,8500.0
kingh102,Hal King,Texas Rangers,RNGRS,1,2,1,3,1972,1975,3,0.39,2.11,1.72,55,66,11,69,0,-69,0.0,589.0,589.0,20000.0,0.0,-20000.0
kingj001,Jeff King,Pittsburgh Pirates,PIRATS,1,2,4,6,1996,2000,4,11.41,4.01,-7.4,460,303,-157,1938,501,-1437,0.0,260.0,260.0,7200000.0,120000.0,-7080000.0
kingj101,Jim King,Chicago Cubs,CUBS,1,1,2,3,1957,1957,0,-0.1,0.09,0.19,22,26,4,39,53,14,0.0,23.0,23.0,0.0,0.0,0.0
kingj101,Jim King,St. Louis Cardinals,CARDS,1,1,1,2,1958,1958,0,0.21,-0.17,-0.38,34,19,-15,66,47,-19,0.0,0.0,0.0,0.0,0.0,0.0
kingj101,Jim King,Washington Senators,RNGRS,6,9,6,15,1967,1977,10,-1.31,6.36,7.67,410,744,334,1041,1994,953,759.0,568.0,-191.0,0.0,28500.0,28500.0
kingj101,Jim King,Chicago White Sox,WSOX,1,2,1,3,1967,1968,1,-0.19,0.06,0.25,19,60,41,22,220,198,0.0,0.0,0.0,25000.0,0.0,-25000.0
kingl101,Lee King,Philadelphia Athletics,ATLTCS,1,1,1,2,1916,1916,0,0.0,0.1,0.1,0,14,14,0,49,49,0.0,0.0,0.0,0.0,0.0,0.0
kingl103,Lee King,New York Giants,GIANTS,3,7,5,12,1921,1927,6,10.96,8.57,-2.39,1223,793,-430,4975,2790,-2185,0.0,87.0,87.0,29500.0,14875.0,-14625.0
kingm001,Mike Kingery,Kansas City Royals,ROYALS,2,5,4,9,1986,1991,5,17.35,13.35,-4.0,586,809,223,839,3196,2357,3709.0,71.0,-3638.0,1438000.0,747500.0,-690500.0
kingm002,Michael King,Miami Marlins,MARLNS,3,6,4,10,2017,2021,4,2.97,5.31,2.34,193,202,9,284,481,197,717.0,873.0,156.0,0.0,0.0,0.0
kingr001,Ray King,Cincinnati Reds,REDS,2,3,2,5,1996,1997,1,0.1,0.89,0.79,322,92,-230,303,211,-92,259.0,0.0,-259.0,175000.0,0.0,-175000.0
kingr001,Ray King,Atlanta Braves,BRAVES,1,1,1,2,1998,1999,1,-0.18,0.0,0.18,19,0,-19,1,0,-1,32.0,0.0,-32.0,0.0,0.0,0.0
kingr001,Ray King,Chicago Cubs,CUBS,1,1,1,2,2000,2000,0,3.16,0.0,-3.16,406,0,-406,2,0,-2,464.0,0.0,-464.0,0.0,0.0,0.0
kingr001,Ray King,Milwaukee Brewers,BREWRS,1,1,2,3,2002,2005,3,0.13,0.02,-0.11,157,367,210,0,1030,1030,177.0,63.0,-114.0,300000.0,250000.0,-50000.0
kingr001,Ray King,Atlanta Braves,BRAVES,2,5,3,8,2003,2005,2,48.74,10.63,-38.11,1422,247,-1175,1200,926,-274,9241.0,27.0,-9214.0,3968000.0,5200000.0,1232000.0
kingr001,Ray King,St. Louis Cardinals,CARDS,1,1,2,3,2005,2008,3,0.15,1.75,1.6,131,422,291,1,1356,1355,134.0,9.0,-125.0,1850000.0,326000.0,-1524000.0
kingr001,Ray King,Washington Nationals,NATEX,1,1,1,2,2007,2007,0,-0.02,0.0,0.02,24,0,-24,0,0,0,18.0,0.0,-18.0,850000.0,0.0,-850000.0
kinkm001,Mike Kinkade,Milwaukee Brewers,BREWRS,2,2,2,4,1998,2002,4,-0.42,0.24,0.66,37,235,198,57,531,474,20.0,436.0,416.0,0.0,0.0,0.0
kinkm001,Mike Kinkade,New York Mets,METS,1,4,1,5,2000,2000,0,28.33,0.16,-28.17,1330,56,-1274,5573,211,-5362,33.0,0.0,-33.0,210000.0,3000000.0,2790000.0
kinnd101,Dennis Kinney,Cleveland Indians,INDINS,2,2,2,4,1978,1984,6,1.04,8.89,7.85,216,294,78,17,0,-17,743.0,2348.0,1605.0,400000.0,0.0,-400000.0
kinnd101,Dennis Kinney,San Diego Padres,PADRS,2,2,2,4,1980,1981,1,-0.22,0.0,0.22,8,0,-8,0,0,0,11.0,0.0,-11.0,0.0,0.0,0.0
kinnm001,Mike Kinnunen,Minnesota Twins,TWINS,1,1,1,2,1981,1983,2,0.0,0.03,0.03,0,33,33,0,0,0,0.0,109.0,109.0,0.0,0.0,0.0
kinnm001,Mike Kinnunen,Montreal Expos,NATEX,1,2,1,3,1985,1985,0,0.0,0.55,0.55,0,68,68,0,209,209,0.0,0.0,0.0,0.0,0.0,0.0
kinnm002,Matt Kinney,Boston Red Sox,RSOX,1,3,2,5,1998,1998,0,0.81,-0.07,-0.88,43,39,-4,66,12,-54,325.0,72.0,-253.0,0.0,2100000.0,2100000.0
kinnm002,Matt Kinney,Minnesota Twins,TWINS,1,2,2,4,2002,2002,0,-0.32,0.0,0.32,128,0,-128,72,0,-72,759.0,0.0,-759.0,0.0,0.0,0.0
kinsb101,Bob Kinsella,New York Giants,GIANTS,1,3,1,4,1920,1920,0,0.0,0.0,0.0,0,0,0,0,0,0,0.0,0.0,0.0,1800.0,0.0,-1800.0
kinsi001,Ian Kinsler,Texas Rangers,RNGRS,1,1,2,3,2013,2017,4,17.41,0.11,-17.3,607,289,-318,2693,1241,-1452,0.0,0.0,0.0,13000000.0,23000000.0,10000000.0
kinsi001,Ian Kinsler,Detroit Tigers,TIGRS,1,1,2,3,2017,2017,0,2.51,0.0,-2.51,91,0,-91,391,0,-391,0.0,0.0,0.0,11000000.0,0.0,-11000000.0
kinsi001,Ian Kinsler,Anaheim Angels,ANGELS,2,3,3,6,2018,2019,1,0.03,-1.1,-1.13,49,44,-5,143,2,-141,20.0,182.0,162.0,11000000.0,0.0,-11000000.0
kinst101,Tom Kinslow,Brooklyn Dodgers,DOGRS,1,1,1,2,1895,1895,0,-0.52,0.95,1.47,19,67,48,67,105,38,0.0,702.0,702.0,0.0,0.0,0.0
kintb001,Brandon Kintzler,Minnesota Twins,TWINS,1,1,2,3,2017,2017,0,1.31,0.0,-1.31,141,0,-141,0,0,0,206.0,0.0,-206.0,2925000.0,0.0,-2925000.0
kintb001,Brandon Kintzler,Washington Nationals,NATEX,1,1,1,2,2018,2018,0,1.17,0.0,-1.17,168,0,-168,1,0,-1,225.0,0.0,-225.0,5000000.0,0.0,-5000000.0
kinzm001,Matt Kinzer,St. Louis Cardinals,CARDS,1,2,3,5,1989,1989,0,-0.12,0.0,0.12,13,0,-13,34,0,-34,5.0,0.0,-5.0,0.0,0.0,0.0
kippb001,Bob Kipper,California Angels,ANGELS,2,4,5,9,1985,1988,3,1.4,3.61,2.21,825,316,-509,630,678,48,1883.0,911.0,-972.0,800000.0,0.0,-800000.0
kippf101,Fred Kipp,Los Angeles Dodgers,DOGRS,3,4,6,10,1960,1962,2,-0.51,0.05,0.56,43,34,-9,74,37,-37,13.0,0.0,-13.0,0.0,0.0,0.0
kippt101,Thornton Kipper,Philadelphia Phillies,PHILS,1,4,4,8,1956,1956,0,0.0,0.0,0.0,0,0,0,0,0,0,0.0,0.0,0.0,0.0,0.0,0.0
kirbc101,Clay Kirby,San Diego Padres,PADRS,6,11,9,20,1973,1984,11,16.69,11.15,-5.54,1162,1282,120,3749,2918,-831,1553.0,2427.0,874.0,0.0,0.0,0.0
kirbc101,Clay Kirby,Cincinnati Reds,REDS,2,2,3,5,1975,1977,2,-1.91,0.41,2.32,89,118,29,143,233,90,236.0,0.0,-236.0,0.0,0.0,0.0
kirbw001,Wayne Kirby,St. Louis Cardinals,CARDS,1,1,1,2,1998,1998,0,-0.39,0.03,0.42,26,4,-22,33,2,-31,0.0,0.0,0.0,0.0,0.0,0.0
kirkd101,Don Kirkwood,California Angels,ANGELS,1,3,1,4,1977,1979,2,0.12,1.23,1.11,29,53,24,3,0,-3,151.0,726.0,575.0,0.0,70000.0,70000.0
kirke101,Enos Kirkpatrick,Newark,Newark,1,1,1,2,1912,1912,0,0.1,0.0,-0.1,80,0,-80,200,0,-200,0.0,0.0,0.0,0.0,2100.0,2100.0
kirke102,Ed Kirkpatrick,California Angels,ANGELS,4,9,7,16,1968,1990,22,52.18,61.82,9.64,2063,2537,474,5135,9859,4724,8249.0,1533.0,-6716.0,230000.0,50000.0,-180000.0
kirke102,Ed Kirkpatrick,Kansas City Royals,ROYALS,2,4,3,7,1973,1978,5,2.68,1.78,-0.9,438,157,-281,817,247,-570,955.0,645.0,-310.0,49000.0,68500.0,19500.0
kirke102,Ed Kirkpatrick,Pittsburgh Pirates,PIRATS,1,1,1,2,1977,1978,1,-0.24,0.53,0.77,20,56,36,52,97,45,0.0,0.0,0.0,0.0,0.0,0.0
kirke102,Ed Kirkpatrick,Texas Rangers,RNGRS,1,1,1,2,1977,1978,1,0.16,0.0,-0.16,29,0,-29,88,0,-88,0.0,0.0,0.0,0.0,0.0,0.0
kirkw101,Willie Kirkland,San Francisco Giants,GIANTS,4,7,5,12,1960,1968,8,1.33,3.3,1.97,705,765,60,1946,2705,759,636.0,0.0,-636.0,33000.0,70000.0,37000.0
kirkw101,Willie Kirkland,Cleveland Indians,INDINS,1,1,2,3,1963,1964,1,0.52,-0.9,-1.42,66,61,-5,172,147,-25,0.0,0.0,0.0,0.0,36500.0,36500.0
kisir101,Rube Kisinger,Detroit Tigers,TIGRS,1,4,2,6,1903,1911,8,0.0,16.79,16.79,0,801,801,0,3453,3453,0.0,39.0,39.0,0.0,0.0,0.0
kissb101,Bill Kissinger,Baltimore Orioles,BLN,1,2,1,3,1895,1895,0,-4.82,1.63,6.45,136,40,-96,276,66,-210,924.0,426.0,-498.0,0.0,0.0,0.0
kitsf101,Frank Kitson,Detroit Tigers,TIGRS,2,2,2,4,1905,1905,0,0.99,0.0,-0.99,107,0,-107,134,0,-134,966.0,0.0,-966.0,0.0,0.0,0.0
kitta001,Andrew Kittredge,Seattle Mariners,MARNRS,1,3,2,5,2016,2018,2,1.91,-0.63,-2.54,161,100,-61,1,297,296,549.0,3.0,-546.0,0.0,0.0,0.0
kittm101,Malachi Kittridge,Worcester,Worcester,1,1,1,2,1901,1901,0,3.14,0.0,-3.14,226,0,-226,830,0,-830,0.0,0.0,0.0,0.0,0.0,0.0
kittr001,Ron Kittle,Chicago White Sox,WSOX,1,3,3,6,1986,1991,5,0.75,-0.11,-0.86,650,316,-334,1809,1056,-753,0.0,0.0,0.0,475000.0,400873.0,-74127.0
kittr001,Ron Kittle,Chicago White Sox,WSOX,1,1,1,2,1990,1990,0,-0.63,-0.07,0.56,22,45,23,64,162,98,0.0,0.0,0.0,550000.0,1150000.0,600000.0
kivlp001,Patrick Kivlehan,Seattle Mariners,MARNRS,2,5,3,8,2015,2017,2,-1.06,0.95,2.01,37,177,140,16,698,682,66.0,0.0,-66.0,6250000.0,5475000.0,-775000.0
kivlp001,Patrick Kivlehan,Texas Rangers,RNGRS,1,1,1,2,2016,2016,0,0.0,0.0,0.0,0,0,0,0,0,0,0.0,0.0,0.0,0.0,0.0,0.0
klaeh101,Hugo Klaerner,Savannah,Savannah,1,1,1,2,1941,1946,5,0.0,0.0,0.0,0,0,0,0,0,0,0.0,0.0,0.0,0.0,0.0,0.0
klaub101,Billy Klaus,Milwaukee Braves,BRAVES,2,8,3,11,1954,1960,6,39.41,8.38,-31.03,1145,621,-524,1887,2335,448,6059.0,0.0,-6059.0,0.0,42000.0,42000.0
klaub101,Billy Klaus,New York Giants,GIANTS,1,1,1,2,1954,1954,0,6.13,0.0,-6.13,458,0,-458,1860,0,-1860,0.0,0.0,0.0,0.0,0.0,0.0
klaub101,Billy Klaus,Boston Red Sox,RSOX,1,1,1,2,1958,1960,2,1.54,-0.22,-1.76,150,62,-88,430,110,-320,0.0,0.0,0.0,0.0,18000.0,18000.0
klaub102,Bobby Klaus,Cincinnati Reds,REDS,1,1,1,2,1964,1964,0,0.81,0.0,-0.81,175,0,-175,573,0,-573,0.0,0.0,0.0,0.0,0.0,0.0
klaub102,Bobby Klaus,New York Mets,METS,1,3,1,4,1966,1966,0,-0.11,-0.09,0.02,10,31,21,19,96,77,0.0,0.0,0.0,0.0,0.0,0.0
klaub102,Bobby Klaus,San Diego Padres,PADRS,3,4,4,8,1969,1971,2,-1.24,2.5,3.74,167,452,285,311,1178,867,100.0,445.0,345.0,0.0,0.0,0.0
kleic101,Chuck Klein,FortWayne,FortWayne,1,1,1,2,1928,1928,0,37.14,0.0,-37.14,1405,0,-1405,5773,0,-5773,0.0,0.0,0.0,0.0,2400.0,2400.0
kleic101,Chuck Klein,Philadelphia Phillies,PHILS,5,10,10,20,1933,1941,8,5.03,23.76,18.73,553,1116,563,2026,2685,659,324.0,2895.0,2571.0,17500.0,10000.0,-7500.0
kleic101,Chuck Klein,Chicago Cubs,CUBS,2,6,3,9,1936,1938,2,12.91,6.74,-6.17,1222,221,-1001,2483,534,-1949,3125.0,1054.0,-2071.0,0.0,0.0,0.0
kleil101,Lou Klein,St. Louis Cardinals,CARDS,1,2,1,3,1949,1952,3,0.18,-0.58,-0.76,27,68,41,92,195,103,0.0,0.0,0.0,9000.0,0.0,-9000.0
kleil101,Lou Klein,Cleveland Indians,INDINS,1,2,1,3,1951,1952,1,0.02,-0.66,-0.68,196,94,-102,612,273,-339,0.0,0.0,0.0,0.0,16500.0,16500.0
kleir101,Red Kleinow,Toledo,Toledo,1,1,2,3,1904,1904,0,5.04,0.0,-5.04,522,0,-522,1684,0,-1684,0.0,0.0,0.0,0.0,0.0,0.0
kleit101,Ted Kleinhans,Chicago Cubs,CUBS,3,10,4,14,1933,1938,5,12.44,14.42,1.98,1291,484,-807,2611,1630,-981,3141.0,1054.0,-2087.0,10000.0,17500.0,7500.0
kleit101,Ted Kleinhans,Philadelphia Phillies,PHILS,1,3,2,5,1934,1941,7,-1.11,22.67,23.78,139,911,772,269,2270,2001,324.0,2379.0,2055.0,0.0,0.0,0.0
klepe101,Ed Klepfer,Chicago White Sox,WSOX,1,4,1,5,1915,1915,0,12.78,0.79,-11.99,588,45,-543,1793,193,-1600,1219.0,0.0,-1219.0,0.0,0.0,0.0
klepe101,Ed Klepfer,New York Yankees,YANKS,1,3,1,4,1911,1911,0,0.0,0.0,0.0,0,0,0,0,0,0,0.0,0.0,0.0,0.0,0.0,0.0
klesr001,Ryan Klesko,Atlanta Braves,BRAVES,1,3,3,6,1999,2001,2,15.79,3.54,-12.25,961,377,-584,3858,1296,-2562,4.0,0.0,-4.0,7650000.0,8651680.0,1001680.0
kliee101,Ed Klieman,Cleveland Indians,INDINS,14,26,24,50,1948,1968,20,162.56,72.5,-90.06,7462,3103,-4359,23911,8852,-15059,13186.0,8500.0,-4686.0,30900.0,42000.0,11100.0
kliee101,Ed Klieman,Chicago White Sox,WSOX,29,55,46,101,1949,1969,20,85.97,64.59,-21.38,7069,5405,-1664,17934,12236,-5698,13204.0,9922.0,-3282.0,288750.0,292500.0,3750.0
kliml101,Lou Klimchock,Kansas City Athletics,ATLTCS,14,29,24,53,1961,1976,15,53.0,28.85,-24.15,5847,3256,-2591,13868,9788,-4080,6333.0,2140.0,-4193.0,393100.0,463000.0,69900.0
kliml101,Lou Klimchock,Milwaukee Braves,BRAVES,4,5,8,13,1965,1971,6,0.93,-0.4,-1.33,225,245,20,724,738,14,0.0,0.0,0.0,0.0,17000.0,17000.0
kliml101,Lou Klimchock,New York Mets,METS,1,2,1,3,1966,1968,2,-0.53,0.0,0.53,142,0,-142,357,0,-357,0.0,0.0,0.0,0.0,0.0,0.0
klimr101,Ron Klimkowski,Boston Red Sox,RSOX,1,2,1,3,1967,1968,1,2.06,-0.63,-2.69,128,113,-15,32,358,326,431.0,0.0,-431.0,0.0,64000.0,64000.0
klimr101,Ron Klimkowski,New York Yankees,YANKS,1,2,1,3,1971,1973,2,0.33,1.03,0.7,63,344,281,8,1145,1137,181.0,0.0,-181.0,0.0,0.0,0.0
klinb103,Bob Kline,Boston Red Sox,RSOX,1,3,3,6,1933,1937,4,1.87,9.37,7.5,361,417,56,1356,657,-699,119.0,1357.0,1238.0,8500.0,31000.0,22500.0
klinb104,Bobby Kline,Washington Senators,TWINS,6,9,11,20,1956,1962,6,3.55,-3.94,-7.49,344,1439,1095,915,4243,3328,381.0,450.0,69.0,21000.0,0.0,-21000.0
klinj001,Joe Klink,New York Mets,METS,2,4,3,7,1986,1991,5,0.96,6.32,5.36,405,543,138,1082,1694,612,117.0,0.0,-117.0,637500.0,530000.0,-107500.0
klinj001,Joe Klink,Minnesota Twins,TWINS,1,1,1,2,1988,1988,0,0.83,0.0,-0.83,105,0,-105,0,0,0,305.0,0.0,-305.0,0.0,0.0,0.0
klinj101,Johnny Kling,Chicago Cubs,CUBS,3,6,7,13,1911,1916,5,-3.91,1.45,5.36,376,507,131,960,1665,705,899.0,27.0,-872.0,4500.0,0.0,-4500.0
klinj101,Johnny Kling,Boston Braves,BRAVES,1,1,2,3,1913,1914,1,1.29,1.26,-0.03,80,62,-18,226,167,-59,0.0,0.0,0.0,0.0,1500.0,1500.0
klinr102,Ron Kline,Pittsburgh Pirates,PIRATS,3,3,4,7,1959,1963,4,3.0,3.01,0.01,287,428,141,298,861,563,1533.0,814.0,-719.0,0.0,0.0,0.0
klinr102,Ron Kline,Washington Senators,RNGRS,18,40,31,71,1966,1988,22,51.31,65.52,14.21,3432,4169,737,10653,12193,1540,4752.0,9267.0,4515.0,592000.0,410800.0,-181200.0
klinr102,Ron Kline,Minnesota Twins,TWINS,1,1,1,2,1967,1968,1,1.02,0.0,-1.02,152,0,-152,24,0,-24,431.0,0.0,-431.0,35000.0,0.0,-35000.0
klinr102,Ron Kline,Pittsburgh Pirates,PIRATS,1,1,1,2,1969,1970,1,-0.01,0.85,0.86,14,152,138,0,10,10,33.0,277.0,244.0,0.0,0.0,0.0
klins001,Scott Klingenbeck,Baltimore Orioles,ORLS,1,2,1,3,1995,2003,8,-1.6,13.23,14.83,28,211,183,0,27,27,231.0,3863.0,3632.0,109000.0,1862500.0,1753500.0
klins002,Steve Kline,Cleveland Indians,INDINS,6,8,9,17,1997,2003,6,3.28,5.94,2.66,1262,272,-990,1929,1,-1928,1607.0,1043.0,-564.0,9300000.0,9175000.0,-125000.0
klins002,Steve Kline,Montreal Expos,NATEX,1,2,2,4,2000,2003,3,5.18,-3.67,-8.85,698,376,-322,77,830,753,1408.0,493.0,-915.0,3988333.0,750000.0,-3238333.0
klins002,Steve Kline,Baltimore Orioles,ORLS,1,1,1,2,2005,2006,1,0.71,0.59,-0.12,279,63,-216,1,0,-1,293.0,181.0,-112.0,2500000.0,0.0,-2500000.0
klins101,Steve Kline,New York Yankees,YANKS,16,29,28,57,1974,1997,23,45.9,36.13,-9.77,3504,2957,-547,6462,7155,693,12175.0,7546.0,-4629.0,4780000.0,3079500.0,-1700500.0
klipj101,Johnny Klippstein,Chicago Cubs,CUBS,3,6,6,12,1954,1961,7,3.29,2.06,-1.23,406,565,159,221,1460,1239,2057.0,7.0,-2050.0,0.0,4000.0,4000.0
klipj101,Johnny Klippstein,Cincinnati Reds,REDS,1,4,1,5,1958,1960,2,0.85,9.64,8.79,265,190,-75,151,233,82,590.0,1314.0,724.0,14000.0,30000.0,16000.0
klipj101,Johnny Klippstein,Washington Senators,RNGRS,1,2,2,4,1961,1963,2,1.4,0.77,-0.63,457,97,-360,839,291,-548,326.0,0.0,-326.0,0.0,0.0,0.0
klubc001,Corey Kluber,San Diego Padres,PADRS,1,2,1,3,2010,2011,1,32.15,-0.64,-32.79,223,160,-63,30,664,634,4025.0,0.0,-4025.0,0.0,0.0,0.0
klubc001,Corey Kluber,Cleveland Indians,INDINS,1,2,2,4,2019,2020,1,0.06,-0.03,-0.09,1,37,36,0,120,120,3.0,0.0,-3.0,17000000.0,1400000.0,-15600000.0
klust101,Ted Kluszewski,Cincinnati Reds,REDS,1,1,1,2,1957,1957,0,0.56,0.0,-0.56,160,0,-160,458,0,-458,0.0,0.0,0.0,40000.0,0.0,-40000.0
klust101,Ted Kluszewski,Pittsburgh Pirates,PIRATS,1,1,2,3,1959,1959,0,0.59,0.08,-0.51,112,9,-103,318,15,-303,0.0,0.0,0.0,0.0,12500.0,12500.0
klutc101,Clyde Kluttz,Boston Braves,BRAVES,2,3,3,6,1945,1946,1,1.29,-0.96,-2.25,78,148,70,249,256,7,0.0,261.0,261.0,0.0,0.0,0.0
klutc101,Clyde Kluttz,New York Giants,GIANTS,1,1,1,2,1946,1946,0,0.0,-0.61,-0.61,0,15,15,0,28,28,0.0,0.0,0.0,0.0,0.0,0.0
klutc101,Clyde Kluttz,Philadelphia Phillies,PHILS,1,1,1,2,1946,1948,2,0.31,1.87,1.56,52,348,296,151,1271,1120,0.0,0.0,0.0,0.0,0.0,0.0
klutm101,Mickey Klutts,New York Yankees,YANKS,8,15,13,28,1978,1992,14,6.29,14.79,8.5,1596,742,-854,3686,2169,-1517,2564.0,669.0,-1895.0,913333.0,1045000.0,131667.0
knapc101,Chris Knapp,Chicago White Sox,WSOX,8,12,15,27,1977,1997,20,45.63,32.75,-12.88,2200,2303,103,7990,6201,-1789,3475.0,5246.0,1771.0,1390000.0,422000.0,-968000.0
knebc001,Corey Knebel,Detroit Tigers,TIGRS,2,3,2,5,2014,2021,7,0.73,1.99,1.26,58,412,354,0,1195,1195,80.0,156.0,76.0,7000000.0,0.0,-7000000.0
knebc001,Corey Knebel,Texas Rangers,RNGRS,1,3,2,5,2015,2015,0,4.24,4.26,0.02,471,35,-436,105,4,-101,683.0,553.0,-130.0,0.0,0.0,0.0
knebc001,Corey Knebel,Milwaukee Brewers,BREWRS,1,1,1,2,2020,2020,0,0.7,0.0,-0.7,53,0,-53,2,0,-2,77.0,0.0,-77.0,5125000.0,0.0,-5125000.0
knepb001,Bob Knepper,San Francisco Giants,GIANTS,3,5,4,9,1980,1984,4,13.32,-1.81,-15.13,864,212,-652,1590,613,-977,5214.0,0.0,-5214.0,0.0,0.0,0.0
knerl101,Lou Knerr,Philadelphia Athletics,ATLTCS,38,83,80,163,1947,1976,29,92.78,73.92,-18.86,10628,9649,-979,25815,29918,4103,12609.0,7417.0,-5192.0,507800.0,639500.0,131700.0
knerl101,Lou Knerr,Toronto,Toronto,1,1,2,3,1944,1944,0,-2.22,0.0,2.22,115,0,-115,101,0,-101,835.0,0.0,-835.0,0.0,0.0,0.0
knica001,Alan Knicely,Houston Astros,ASTROS,1,1,2,3,1983,1986,3,-0.68,4.85,5.53,117,314,197,328,31,-297,0.0,776.0,776.0,0.0,0.0,0.0
knica001,Alan Knicely,Cincinnati Reds,REDS,1,3,2,5,1985,1989,4,0.22,4.93,4.71,144,460,316,269,1695,1426,243.0,0.0,-243.0,117500.0,620000.0,502500.0
knicb101,Bill Knickerbocker,Cleveland Indians,INDINS,1,3,3,6,1937,1939,2,6.18,8.46,2.28,372,600,228,1331,2387,1056,1093.0,179.0,-914.0,0.0,0.0,0.0
knicb101,Bill Knickerbocker,St.Louis Browns,ORLS,1,1,2,3,1938,1943,5,0.48,-4.11,-4.59,97,524,427,302,2039,1737,0.0,0.0,0.0,0.0,0.0,0.0
knicb101,Bill Knickerbocker,New York Yankees,YANKS,1,1,1,2,1940,1948,8,0.74,0.16,-0.58,89,33,-56,397,83,-314,0.0,0.0,0.0,9000.0,3000.0,-6000.0
knigb001,Brandon Knight,Texas Rangers,RNGRS,1,2,1,3,1999,2001,2,-0.67,0.61,1.28,13,146,133,0,511,511,62.0,0.0,-62.0,0.0,2000000.0,2000000.0
knigj102,John Knight,Washington Senators,TWINS,1,1,1,2,1912,1912,0,0.0,0.13,0.13,0,2,2,0,2,2,0.0,0.0,0.0,4000.0,0.0,-4000.0
knigj102,John Knight,Philadelphia Athletics,ATLTCS,1,1,1,2,1907,1907,0,0.39,2.21,1.82,98,99,1,390,403,13,0.0,0.0,0.0,0.0,0.0,0.0
knigj102,John Knight,Boston Red Sox,RSOX,1,2,1,3,1907,1907,0,0.0,0.02,0.02,0,4,4,0,5,5,0.0,30.0,30.0,0.0,0.0,0.0
knigj102,John Knight,New York Yankees,YANKS,1,2,1,3,1912,1912,0,4.64,-0.55,-5.19,406,29,-377,1061,95,-966,0.0,0.0,0.0,0.0,0.0,0.0
knigj102,John Knight,JerseyCity,JerseyCity,1,1,2,3,1913,1916,3,0.28,0.0,-0.28,70,0,-70,282,0,-282,0.0,0.0,0.0,0.0,0.0,0.0
knigr001,Ray Knight,Cincinnati Reds,REDS,2,2,2,4,1981,1985,4,5.84,2.37,-3.47,419,429,10,1622,1575,-47,0.0,0.0,0.0,0.0,0.0,0.0
knigr001,Ray Knight,Houston Astros,ASTROS,1,1,3,4,1984,1992,8,2.33,6.19,3.86,254,605,351,932,2016,1084,0.0,0.0,0.0,0.0,0.0,0.0
knigr001,Ray Knight,Baltimore Orioles,ORLS,1,1,1,2,1988,1989,1,-1.01,-0.03,0.98,105,92,-13,327,0,-327,0.0,494.0,494.0,0.0,0.0,0.0
knisp101,Pete Knisely,Cincinnati Reds,REDS,3,8,5,13,1912,1913,1,9.38,6.71,-2.67,842,270,-572,2287,704,-1583,1567.0,500.0,-1067.0,11280.0,7925.0,-3355.0
knobc001,Chuck Knoblauch,Minnesota Twins,TWINS,6,9,16,25,1998,2015,17,43.18,50.93,7.75,2387,3230,843,8979,10990,2011,2380.0,5474.0,3094.0,18555000.0,2336100.0,-16218900.0
knolh101,Hub Knolls,Chicago Cubs,CUBS,2,4,2,6,1906,1907,1,-0.02,0.08,0.1,4,78,74,2,146,144,20.0,415.0,395.0,0.0,0.0,0.0
knoob101,Bobby Knoop,California Angels,ANGELS,4,8,8,16,1969,1990,21,45.31,70.62,25.31,1604,3274,1670,3577,13169,9592,8249.0,1415.0,-6834.0,212000.0,65500.0,-146500.0
knoob101,Bobby Knoop,Chicago White Sox,WSOX,1,1,2,3,1971,1971,0,-0.92,0.0,0.92,116,0,-116,287,0,-287,0.0,0.0,0.0,0.0,0.0,0.0
knotf101,Fritz Knothe,Seattle,Seattle,1,1,2,3,1931,1933,2,0.8,0.0,-0.8,133,0,-133,561,0,-561,0.0,0.0,0.0,0.0,0.0,0.0
knotf101,Fritz Knothe,Philadelphia Phillies,PHILS,2,5,2,7,1933,1934,1,0.0,-0.7,-0.7,0,28,28,0,32,32,0.0,115.0,115.0,0.0,0.0,0.0
knotf101,Fritz Knothe,Boston Braves,BRAVES,3,4,4,8,1933,1938,5,5.87,7.69,1.82,599,982,383,2168,3856,1688,0.0,0.0,0.0,0.0,0.0,0.0
knotg001,Gary Knotts,Florida Marlins,MARLNS,12,23,29,52,2003,2019,16,83.08,57.28,-25.8,2779,2940,161,6322,8392,2070,15065.0,6008.0,-9057.0,40718667.0,23598092.0,-17120575.0
knotj102,Jack Knott,St.Louis Browns,ORLS,1,1,1,2,1938,1938,0,5.05,-0.37,-5.42,140,46,-94,175,18,-157,1317.0,189.0,-1128.0,6500.0,3300.0,-3200.0
knotj102,Jack Knott,Chicago White Sox,WSOX,1,1,1,2,1940,1947,7,-1.48,1.34,2.82,100,190,90,112,733,621,888.0,0.0,-888.0,8000.0,3500.0,-4500.0
knotj102,Jack Knott,Milwaukee,Milwaukee,1,2,3,5,1932,1932,0,3.6,0.0,-3.6,514,0,-514,595,0,-595,2467.0,0.0,-2467.0,0.0,3000.0,3000.0
knowd101,Darold Knowles,Baltimore Orioles,ORLS,7,19,18,37,1965,1988,23,25.46,102.26,76.8,1816,4270,2454,1785,10311,8526,8812.0,12795.0,3983.0,785333.0,89400.0,-695933.0
knowd101,Darold Knowles,Philadelphia Phillies,PHILS,2,3,2,5,1966,1969,3,9.35,1.64,-7.71,553,215,-338,133,649,516,1272.0,0.0,-1272.0,10500.0,18000.0,7500.0
knowd101,Darold Knowles,Washington Senators,RNGRS,14,27,28,55,1971,1986,15,67.34,36.98,-30.36,3624,2178,-1446,6695,5553,-1142,11858.0,4713.0,-7145.0,245000.0,416400.0,171400.0
knowd101,Darold Knowles,Oakland Athletics,ATLTCS,1,3,1,4,1974,1976,2,1.24,1.92,0.68,1157,275,-882,3065,1015,-2050,578.0,0.0,-578.0,69800.0,150000.0,80200.0
knowd101,Darold Knowles,Chicago Cubs,CUBS,1,1,2,3,1977,1979,2,0.49,-0.19,-0.68,42,220,178,0,533,533,151.0,0.0,-151.0,0.0,0.0,0.0
knudm001,Mark Knudson,Houston Astros,ASTROS,1,2,1,3,1986,1990,4,4.82,13.16,8.34,196,416,220,0,208,208,2588.0,2180.0,-408.0,0.0,610000.0,610000.0
kobej001,Jeff Kobernus,Boston Red Sox,RSOX,1,1,1,2,2012,2012,0,0.0,0.0,0.0,0,0,0,0,0,0,0.0,0.0,0.0,0.0,0.0,0.0
kobek101,Kevin Kobel,New York Mets,METS,1,1,1,2,1980,1980,0,0.0,0.0,0.0,0,0,0,0,0,0,0.0,0.0,0.0,0.0,0.0,0.0
kochb001,Billy Koch,Toronto Blue Jays,BJAYS,1,1,2,3,2001,2006,5,1.81,6.6,4.79,90,702,612,0,2561,2561,281.0,559.0,278.0,733333.0,0.0,-733333.0
kochb001,Billy Koch,Oakland Athletics,ATLTCS,2,6,5,11,2002,2003,1,15.18,3.47,-11.71,801,134,-667,480,219,-261,4974.0,260.0,-4714.0,2433333.0,4320000.0,1886667.0
kochb001,Billy Koch,Chicago White Sox,WSOX,1,1,2,3,2004,2005,1,0.26,0.33,0.07,45,19,-26,0,46,46,77.0,0.0,-77.0,6375000.0,0.0,-6375000.0
kochm001,Matt Koch,New York Mets,METS,3,8,7,15,2015,2018,3,0.7,4.78,4.08,291,310,19,600,0,-600,833.0,459.0,-374.0,24250000.0,17133065.0,-7116935.0
koegp101,Pete Koegel,Oakland Athletics,ATLTCS,1,2,1,3,1969,1969,0,-0.03,-0.27,-0.24,41,24,-17,30,3,-27,153.0,57.0,-96.0,0.0,0.0,0.0
koegp101,Pete Koegel,Milwaukee Brewers,BREWRS,4,7,4,11,1971,1976,5,4.46,14.89,10.43,682,733,51,2218,2738,520,335.0,0.0,-335.0,159600.0,25000.0,-134600.0
koegp101,Pete Koegel,Philadelphia Phillies,PHILS,1,1,1,2,1973,1973,0,0.0,0.0,0.0,0,0,0,0,0,0,0.0,0.0,0.0,0.0,17500.0,17500.0
koehp101,Pip Koehler,New York Giants,GIANTS,1,2,1,3,1926,1933,7,0.0,0.0,0.0,0,0,0,0,0,0,0.0,0.0,0.0,0.0,0.0,0.0
koeht001,Tom Koehler,Miami Marlins,MARLNS,1,2,1,3,2017,2017,0,0.48,0.0,-0.48,15,0,-15,0,0,0,51.0,0.0,-51.0,5750000.0,0.0,-5750000.0
koenl101,Len Koenecke,Indianapolis,Indianapolis,2,3,7,10,1931,1936,5,2.11,0.0,-2.11,355,0,-355,1256,0,-1256,0.0,0.0,0.0,0.0,0.0,0.0
koenm101,Mark Koenig,StPaul,StPaul,6,8,15,23,1925,1930,5,7.08,0.0,-7.08,1228,0,-1228,4402,0,-4402,611.0,0.0,-611.0,0.0,50250.0,50250.0
koenm101,Mark Koenig,New York Yankees,YANKS,1,2,3,5,1930,1931,1,-1.14,0.55,1.69,271,146,-125,761,467,-294,731.0,97.0,-634.0,25000.0,18000.0,-7000.0
koenm101,Mark Koenig,Chicago Cubs,CUBS,3,10,4,14,1933,1938,5,12.44,14.42,1.98,1291,484,-807,2611,1630,-981,3141.0,1054.0,-2087.0,10000.0,17500.0,7500.0
koenm101,Mark Koenig,Philadelphia Phillies,PHILS,3,6,4,10,1933,1935,2,-1.54,1.56,3.1,151,136,-15,661,287,-374,0.0,500.0,500.0,0.0,0.0,0.0
koenm101,Mark Koenig,Cincinnati Reds,REDS,3,4,5,9,1934,1942,8,0.78,14.44,13.66,253,956,703,577,3608,3031,264.0,0.0,-264.0,23000.0,0.0,-23000.0
kokod101,Dick Kokos,Cleveland Indians,INDINS,1,4,2,6,1947,1949,2,3.17,0.88,-2.29,606,121,-485,1943,303,-1640,368.0,217.0,-151.0,0.0,20000.0,20000.0
kokod101,Dick Kokos,Baltimore Orioles,ORLS,5,10,10,20,1954,1960,6,15.05,10.79,-4.26,745,954,209,1673,2729,1056,2291.0,1208.0,-1083.0,10000.0,0.0,-10000.0
kolaa001,Adam Kolarek,Tampa Bay Devil Rays,RAYS,1,1,1,2,2019,2019,0,1.05,0.0,-1.05,72,0,-72,0,0,0,92.0,0.0,-92.0,560800.0,0.0,-560800.0
kolaa001,Adam Kolarek,Los Angeles Dodgers,DOGRS,1,2,2,4,2021,2021,0,-0.38,-0.48,-0.1,13,33,20,0,66,66,27.0,0.0,-27.0,0.0,0.0,0.0
kolbb001,Brandon Kolb,San Diego Padres,PADRS,1,2,2,4,2000,2001,1,-1.16,-0.17,0.99,82,43,-39,8,97,89,184.0,0.0,-184.0,230000.0,0.0,-230000.0
kolbd001,Danny Kolb,Milwaukee Brewers,BREWRS,2,2,3,5,2004,2007,3,-1.69,0.62,2.31,138,166,28,1,2,1,215.0,298.0,83.0,1500000.0,0.0,-1500000.0
kolbd001,Danny Kolb,Atlanta Braves,BRAVES,1,1,1,2,2005,2006,1,-0.04,0.0,0.04,105,0,-105,0,0,0,145.0,0.0,-145.0,3400000.0,342000.0,-3058000.0
kolbg101,Gary Kolb,St. Louis Cardinals,CARDS,12,25,20,45,1964,1972,8,30.8,2.13,-28.67,3297,763,-2534,8519,1730,-6789,1865.0,703.0,-1162.0,32500.0,24000.0,-8500.0
kolbg101,Gary Kolb,Milwaukee Braves,BRAVES,1,1,1,2,1965,1965,0,-0.85,-0.11,0.74,40,31,-9,94,57,-37,0.0,0.0,0.0,0.0,0.0,0.0
kolbg101,Gary Kolb,New York Mets,METS,1,2,2,4,1966,1970,4,1.41,1.94,0.53,188,298,110,235,385,150,516.0,1427.0,911.0,0.0,26000.0,26000.0
kolld101,Don Kolloway,OklahomaCity,OklahomaCity,1,1,3,4,1939,1939,0,2.8,0.0,-2.8,683,0,-683,2785,0,-2785,0.0,0.0,0.0,0.0,4200.0,4200.0
kolld101,Don Kolloway,Chicago White Sox,WSOX,2,3,2,5,1949,1950,1,-0.26,-0.26,0.0,394,112,-282,1460,440,-1020,0.0,0.0,0.0,10000.0,0.0,-10000.0
kolld101,Don Kolloway,Detroit Tigers,TIGRS,1,1,1,2,1953,1953,0,-0.03,-0.29,-0.26,2,22,20,1,41,40,0.0,0.0,0.0,0.0,0.0,0.0
kolpr101,Ray Kolp,St.Louis Browns,ORLS,1,4,1,5,1925,1928,3,0.0,-0.47,-0.47,0,145,145,0,462,462,0.0,0.0,0.0,0.0,0.0,0.0
kolsh101,Hal Kolstad,Boston Red Sox,RSOX,8,15,16,31,1965,1977,12,34.3,15.16,-19.14,1704,1184,-520,5095,2722,-2373,3875.0,4100.0,225.0,155000.0,163750.0,8750.0
komae001,Erik Komatsu,Milwaukee Brewers,BREWRS,1,1,1,2,2011,2011,0,0.0,0.99,0.99,0,45,45,0,138,138,0.0,0.0,0.0,0.0,2000000.0,2000000.0
kommb001,Brad Komminsk,Atlanta Braves,BRAVES,2,2,2,4,1987,1991,4,0.67,5.03,4.36,165,518,353,568,1860,1292,0.0,0.0,0.0,400000.0,375000.0,-25000.0
kommf101,Fred Kommers,Springfield,Springfield,1,1,1,2,1913,1914,1,-0.54,0.0,0.54,40,0,-40,169,0,-169,0.0,0.0,0.0,0.0,1200.0,1200.0
konee101,Ed Konetchy,St. Louis Cardinals,CARDS,1,3,5,8,1913,1920,7,9.94,10.5,0.56,493,813,320,1225,2891,1666,2306.0,795.0,-1511.0,13500.0,11400.0,-2100.0
konep001,Paul Konerko,Los Angeles Dodgers,DOGRS,1,2,1,3,1998,2001,3,-0.12,3.63,3.75,362,466,104,111,0,-111,591.0,706.0,115.0,170000.0,650000.0,480000.0
konep001,Paul Konerko,Cincinnati Reds,REDS,3,7,4,11,1998,2013,15,47.91,21.42,-26.49,2964,1586,-1378,11936,4589,-7347,381.0,721.0,340.0,8282695.0,626000.0,-7656695.0
konnm101,Mike Konnick,Wilkes-Barre,Wilkes-Barre,1,1,2,3,1909,1909,0,-0.03,0.0,0.03,3,0,-3,10,0,-10,0.0,0.0,0.0,0.0,0.0,0.0
konsj101,Jim Konstanty,Cincinnati Reds,REDS,1,2,1,3,1946,1947,1,-0.01,0.38,0.39,20,72,52,3,235,232,46.0,0.0,-46.0,0.0,0.0,0.0
kontg001,George Kontos,New York Yankees,YANKS,2,2,2,4,2012,2013,1,3.19,0.83,-2.36,771,164,-607,593,497,-96,929.0,0.0,-929.0,515100.0,0.0,-515100.0
koobe101,Ernie Koob,St.Louis Browns,ORLS,1,2,1,3,1920,1920,0,0.0,5.97,5.97,0,76,76,0,110,110,0.0,806.0,806.0,0.0,0.0,0.0
koong001,Graham Koonce,Kansas City Royals,ROYALS,1,1,1,2,2007,2007,0,0.0,0.0,0.0,0,0,0,0,0,0,0.0,0.0,0.0,0.0,0.0,0.0
koosj001,Jerry Koosman,New York Mets,METS,8,19,12,31,1978,1993,15,96.4,33.36,-63.04,2897,1789,-1108,3255,2435,-820,16305.0,6137.0,-10168.0,4561000.0,9733332.0,5172332.0
koosj001,Jerry Koosman,Minnesota Twins,TWINS,3,4,6,10,1981,1985,4,3.07,0.85,-2.22,87,223,136,0,727,727,1110.0,0.0,-1110.0,0.0,0.0,0.0
koosj001,Jerry Koosman,Chicago White Sox,WSOX,1,1,1,2,1984,1985,1,2.71,1.34,-1.37,110,53,-57,126,1,-125,970.0,219.0,-751.0,0.0,0.0,0.0
kopag101,George Kopacz,Atlanta Braves,BRAVES,1,1,1,2,1969,1969,0,-0.12,0.0,0.12,10,0,-10,17,0,-17,0.0,0.0,0.0,0.0,0.0,0.0
kopag101,George Kopacz,Pittsburgh Pirates,PIRATS,1,1,1,2,1973,1973,0,0.0,0.0,0.0,0,0,0,0,0,0,0.0,0.0,0.0,0.0,0.0,0.0
kopem001,Michael Kopech,Boston Red Sox,RSOX,1,4,1,5,2016,2016,0,14.34,0.0,-14.34,583,0,-583,2288,0,-2288,251.0,0.0,-251.0,0.0,9150000.0,9150000.0
kopfl101,Larry Kopf,Cincinnati Reds,REDS,1,2,1,3,1922,1922,0,0.41,-0.04,-0.45,383,2,-381,879,1,-878,1636.0,3.0,-1633.0,0.0,0.0,0.0
koplm001,Mike Koplove,Pittsburgh Pirates,PIRATS,1,1,1,2,2009,2009,0,0.0,0.0,0.0,0,0,0,0,0,0,0.0,0.0,0.0,0.0,0.0,0.0
koppj101,Joe Koppe,Milwaukee Braves,BRAVES,2,4,4,8,1959,1964,5,9.25,-0.88,-10.13,355,69,-286,908,184,-724,1090.0,0.0,-1090.0,0.0,0.0,0.0
koppj101,Joe Koppe,Philadelphia Phillies,PHILS,7,14,15,29,1961,1979,18,36.73,77.38,40.65,2596,3152,556,7221,9470,2249,6229.0,10159.0,3930.0,74500.0,159800.0,85300.0
koppj101,Joe Koppe,Los Angeles Dodgers,DOGRS,1,1,1,2,1961,1962,1,0.0,0.0,0.0,0,0,0,0,0,0,0.0,0.0,0.0,0.0,0.0,0.0
koppm101,Merlin Kopp,Boston Red Sox,RSOX,22,48,61,109,1917,1937,20,205.66,131.1,-74.56,9653,6423,-3230,27902,20755,-7147,27230.0,14799.0,-12431.0,136800.0,133950.0,-2850.0
koppm101,Merlin Kopp,Philadelphia Athletics,ATLTCS,1,3,1,4,1919,1921,2,0.0,-1.44,-1.44,0,50,50,0,86,86,0.0,133.0,133.0,0.0,0.0,0.0
koreb001,Bobby Korecky,Philadelphia Phillies,PHILS,1,3,1,4,2003,2004,1,19.34,1.44,-17.9,901,67,-834,2722,75,-2647,2374.0,603.0,-1771.0,610000.0,6000000.0,5390000.0
koroj001,John Koronka,Cincinnati Reds,REDS,1,1,1,2,2003,2004,1,-0.3,-0.01,0.29,8,168,160,5,1,-4,47.0,241.0,194.0,0.0,0.0,0.0
koroj001,John Koronka,Chicago Cubs,CUBS,4,7,7,14,2006,2013,7,13.94,1.01,-12.93,1170,453,-717,3302,221,-3081,1125.0,1062.0,-63.0,732500.0,2300000.0,1567500.0
kosca101,Andy Kosco,New York Yankees,YANKS,2,2,2,4,1968,1974,6,-1.51,-2.01,-0.5,213,245,32,681,193,-488,150.0,1691.0,1541.0,0.0,0.0,0.0
kosca101,Andy Kosco,Los Angeles Dodgers,DOGRS,1,1,1,2,1971,1977,6,0.68,5.16,4.48,98,340,242,290,308,18,0.0,2693.0,2693.0,0.0,0.0,0.0
kosca101,Andy Kosco,Milwaukee Brewers,BREWRS,1,1,1,2,1972,1972,0,0.5,0.03,-0.47,49,72,23,151,141,-10,0.0,0.0,0.0,0.0,0.0,0.0
kosca101,Andy Kosco,California Angels,ANGELS,3,5,4,9,1972,1976,4,2.68,3.35,0.67,419,169,-250,1462,595,-867,0.0,0.0,0.0,65500.0,40000.0,-25500.0
kosca101,Andy Kosco,Boston Red Sox,RSOX,1,2,1,3,1973,1973,0,0.47,0.0,-0.47,189,0,-189,309,0,-309,0.0,0.0,0.0,0.0,0.0,0.0
koskc001,Corey Koskie,Toronto Blue Jays,BJAYS,1,1,1,2,2006,2009,3,1.11,0.72,-0.39,76,75,-1,289,0,-289,0.0,248.0,248.0,0.0,0.0,0.0
kostf101,Frank Kostro,Detroit Tigers,TIGRS,2,5,3,8,1963,1967,4,-0.97,-0.32,0.65,448,297,-151,1059,675,-384,218.0,314.0,96.0,32800.0,33000.0,200.0
kostf101,Frank Kostro,Los Angeles Angels,ANGELS,4,6,6,12,1964,1968,4,-0.55,3.52,4.07,404,392,-12,532,716,184,443.0,1270.0,827.0,44000.0,15000.0,-29000.0
kotcc001,Casey Kotchman,Anaheim Angels,ANGELS,1,2,1,3,2008,2008,0,0.7,3.71,3.01,130,54,-76,511,234,-277,0.0,0.0,0.0,1450000.0,12500000.0,11050000.0
kotcc001,Casey Kotchman,Atlanta Braves,BRAVES,1,1,1,2,2009,2009,0,0.16,1.99,1.83,39,57,18,95,242,147,0.0,0.0,0.0,2885000.0,0.0,-2885000.0
kotcc001,Casey Kotchman,Boston Red Sox,RSOX,1,1,2,3,2010,2010,0,-0.77,1.78,2.55,125,120,-5,457,382,-75,0.0,3.0,3.0,0.0,0.0,0.0
kotsm001,Mark Kotsay,Florida Marlins,MARLNS,8,11,19,30,2001,2013,12,78.22,23.68,-54.54,3802,1869,-1933,11801,2165,-9636,3483.0,6395.0,2912.0,18420219.0,799800.0,-17620419.0
kotsm001,Mark Kotsay,San Diego Padres,PADRS,3,7,5,12,2003,2005,2,6.8,6.44,-0.36,612,430,-182,2576,1148,-1428,24.0,273.0,249.0,12000000.0,8812500.0,-3187500.0
kotsm001,Mark Kotsay,Oakland Athletics,ATLTCS,1,1,2,3,2008,2012,4,1.01,2.34,1.33,88,73,-15,345,0,-345,0.0,206.0,206.0,0.0,0.0,0.0
kotsm001,Mark Kotsay,Atlanta Braves,BRAVES,1,1,1,2,2008,2008,0,-0.79,0.0,0.79,49,0,-49,170,0,-170,0.0,0.0,0.0,7000000.0,0.0,-7000000.0
kotsm001,Mark Kotsay,Boston Red Sox,RSOX,1,1,1,2,2009,2009,0,-0.65,-0.1,0.55,147,21,-126,486,21,-465,0.0,0.0,0.0,1500000.0,440000.0,-1060000.0
kottg001,George Kottaras,San Diego Padres,PADRS,1,1,1,2,2006,2007,1,-0.21,-0.26,-0.05,48,54,6,112,50,-62,0.0,441.0,441.0,0.0,4075000.0,4075000.0
kottg001,George Kottaras,Milwaukee Brewers,BREWRS,1,1,1,2,2012,2013,1,0.32,0.0,-0.32,27,0,-27,93,0,-93,0.0,0.0,0.0,700000.0,482500.0,-217500.0
koupl101,Lou Koupal,Brooklyn Dodgers,DOGRS,1,1,1,2,1929,1929,0,0.08,0.03,-0.05,56,4,-52,46,1,-45,373.0,11.0,-362.0,5500.0,4500.0,-1000.0
koupl101,Lou Koupal,Seattle,Seattle,1,1,2,3,1937,1937,0,-0.76,0.0,0.76,52,0,-52,35,0,-35,317.0,0.0,-317.0,0.0,0.0,0.0
kouzk001,Kevin Kouzmanoff,Cleveland Indians,INDINS,1,2,1,3,2006,2009,3,5.38,-0.48,-5.86,440,159,-281,1775,497,-1278,0.0,0.0,0.0,0.0,327000.0,327000.0
kouzk001,Kevin Kouzmanoff,San Diego Padres,PADRS,3,4,4,8,2010,2013,3,5.05,1.13,-3.92,706,243,-463,2175,585,-1590,34.0,54.0,20.0,0.0,0.0,0.0
kowaf101,Fabian Kowalik,Chicago Cubs,CUBS,2,6,3,9,1936,1938,2,12.91,6.74,-6.17,1222,221,-1001,2483,534,-1949,3125.0,1054.0,-2071.0,0.0,0.0,0.0
koy-e101,Ernie Koy,Brooklyn Dodgers,DOGRS,1,5,2,7,1940,1946,6,2.24,22.24,20.0,200,770,570,485,2187,1702,487.0,3020.0,2533.0,0.0,0.0,0.0
kozaa101,Al Kozar,Boston Red Sox,RSOX,5,13,10,23,1947,1956,9,13.4,14.7,1.3,2053,1460,-593,7010,4777,-2233,1880.0,1611.0,-269.0,136000.0,54500.0,-81500.0
kozaa101,Al Kozar,Washington Senators,TWINS,12,23,24,47,1950,1963,13,21.31,19.51,-1.8,2117,2519,402,6320,5694,-626,2404.0,6282.0,3878.0,32000.0,59000.0,27000.0
kozlb001,Ben Kozlowski,Atlanta Braves,BRAVES,3,6,4,10,2002,2013,11,-3.28,26.79,30.07,88,575,487,55,584,529,265.0,4939.0,4674.0,370000.0,5000000.0,4630000.0
kozlb001,Ben Kozlowski,Cincinnati Reds,REDS,1,1,1,2,2006,2015,9,0.0,-0.15,-0.15,0,2,2,0,5,5,0.0,0.0,0.0,0.0,327500.0,327500.0
krakj101,Joe Krakauskas,Washington Senators,TWINS,1,1,1,2,1940,1941,1,-1.24,-0.27,0.97,88,28,-60,25,121,96,285.0,0.0,-285.0,0.0,15000.0,15000.0
kralj101,Jack Kralick,Minnesota Twins,TWINS,2,2,3,5,1963,1973,10,9.86,29.14,19.28,269,766,497,180,681,501,2242.0,5804.0,3562.0,0.0,0.0,0.0
kramj101,Jack Kramer,St.Louis Browns,ORLS,48,119,133,252,1947,1988,41,205.08,223.58,18.5,14314,21110,6796,35907,60131,24224,36284.0,27740.0,-8544.0,987083.0,277700.0,-709383.0
kramk001,Kevin Kramer,Pittsburgh Pirates,PIRATS,1,1,1,2,2021,2021,0,0.0,0.0,0.0,0,0,0,0,0,0,0.0,0.0,0.0,0.0,0.0,0.0
kramr001,Randy Kramer,Texas Rangers,RNGRS,1,1,1,2,1986,1986,0,-0.49,0.0,0.49,106,0,-106,42,0,-42,441.0,0.0,-441.0,0.0,0.0,0.0
kramr001,Randy Kramer,Pittsburgh Pirates,PIRATS,1,1,1,2,1990,1990,0,0.14,0.0,-0.14,20,0,-20,2,0,-2,61.0,0.0,-61.0,150000.0,0.0,-150000.0
kramt001,Tom Kramer,Cleveland Indians,INDINS,1,1,1,2,1994,1994,0,0.0,0.0,0.0,0,0,0,0,0,0,0.0,0.0,0.0,0.0,0.0,0.0
krate001,Erik Kratz,Philadelphia Phillies,PHILS,1,2,1,3,2013,2014,1,0.38,-0.1,-0.48,46,4,-42,84,0,-84,37.0,7.0,-30.0,496000.0,0.0,-496000.0
krate001,Erik Kratz,Toronto Blue Jays,BJAYS,1,2,1,3,2014,2015,1,-0.13,0.39,0.52,23,108,85,36,338,302,58.0,0.0,-58.0,510200.0,1065000.0,554800.0
krate001,Erik Kratz,San Diego Padres,PADRS,1,1,1,2,2016,2016,0,-0.55,0.0,0.55,15,0,-15,30,0,-30,3.0,0.0,-3.0,0.0,0.0,0.0
krate001,Erik Kratz,New York Yankees,YANKS,1,1,1,2,2018,2018,0,-0.02,0.0,0.02,70,0,-70,219,0,-219,9.0,0.0,-9.0,0.0,0.0,0.0
krate001,Erik Kratz,Milwaukee Brewers,BREWRS,1,1,1,2,2019,2019,0,-0.21,0.0,0.21,15,0,-15,36,0,-36,0.0,0.0,0.0,0.0,0.0,0.0
krate001,Erik Kratz,San Francisco Giants,GIANTS,1,2,1,3,2019,2019,0,-0.31,0.0,0.31,6,0,-6,17,0,-17,0.0,0.0,0.0,0.0,0.0,0.0
krauj101,Jack Kraus,Brooklyn Dodgers,DOGRS,1,2,1,3,1943,1946,3,1.98,0.1,-1.88,107,168,61,100,529,429,847.0,0.0,-847.0,0.0,0.0,0.0
kraul101,Lew Krausse,Brooklyn Dodgers,DOGRS,2,4,3,7,1938,1940,2,2.67,-0.72,-3.39,454,199,-255,1715,406,-1309,0.0,317.0,317.0,0.0,0.0,0.0
kraul102,Lew Krausse,Oakland Athletics,ATLTCS,9,20,12,32,1970,1976,6,26.16,16.01,-10.15,3775,1399,-2376,8326,3903,-4423,4415.0,1098.0,-3317.0,340600.0,421500.0,80900.0
kraul102,Lew Krausse,Milwaukee Brewers,BREWRS,9,23,22,45,1971,1984,13,35.91,84.88,48.97,2475,4171,1696,6161,14852,8691,10247.0,5331.0,-4916.0,466901.0,45000.0,-421901.0
kraum001,Marc Krauss,Arizona Diamondbacks,DBACKS,6,11,12,23,2012,2019,7,8.73,6.22,-2.51,828,1204,376,3152,2716,-436,0.0,1347.0,1347.0,0.0,495000.0,495000.0
kraum001,Marc Krauss,Anaheim Angels,ANGELS,1,1,1,2,2015,2015,0,-0.26,0.0,0.26,4,0,-4,10,0,-10,0.0,0.0,0.0,0.0,0.0,0.0
kravd101,Danny Kravitz,Pittsburgh Pirates,PIRATS,2,2,3,5,1960,1960,0,-0.47,0.0,0.47,83,0,-83,262,0,-262,0.0,0.0,0.0,0.0,0.0,0.0
kravd101,Danny Kravitz,Kansas City Athletics,ATLTCS,1,1,1,2,1960,1960,0,0.0,0.0,0.0,0,0,0,0,0,0,0.0,0.0,0.0,0.0,0.0,0.0
kravk101,Ken Kravec,Chicago White Sox,WSOX,1,1,1,2,1981,1983,2,-0.89,6.09,6.98,75,122,47,25,0,-25,310.0,1299.0,989.0,0.0,0.0,0.0
kreem101,Mike Kreevich,Chicago White Sox,WSOX,1,2,1,3,1941,1946,5,0.52,12.57,12.05,116,628,512,494,2724,2230,0.0,0.0,0.0,13900.0,12500.0,-1400.0
krehj001,Joey Krehbiel,Anaheim Angels,ANGELS,1,2,2,4,2014,2014,0,0.11,-0.49,-0.6,4,34,30,0,15,15,9.0,19.0,10.0,0.0,2884500.0,2884500.0
kremd001,Dean Kremer,Los Angeles Dodgers,DOGRS,1,5,1,6,2018,2018,0,-0.21,2.49,2.7,29,66,37,41,296,255,217.0,0.0,-217.0,0.0,16000000.0,16000000.0
kremj001,Jimmy Kremers,Atlanta Braves,BRAVES,1,2,2,4,1991,1993,2,0.0,8.32,8.32,0,378,378,0,1494,1494,0.0,0.0,0.0,0.0,0.0,0.0
kremj101,Jim Kremmel,Texas Rangers,RNGRS,1,1,1,2,1973,1973,0,0.0,-1.09,-1.09,0,16,16,0,0,0,0.0,121.0,121.0,6600.0,0.0,-6600.0
kremj101,Jim Kremmel,St. Louis Cardinals,CARDS,2,2,2,4,1973,1973,0,0.0,0.0,0.0,0,0,0,0,0,0,0.0,0.0,0.0,0.0,0.0,0.0
kremj101,Jim Kremmel,Chicago White Sox,WSOX,1,4,1,5,1973,1973,0,6.5,0.0,-6.5,800,0,-800,1477,0,-1477,2061.0,0.0,-2061.0,32700.0,110000.0,77300.0
krenw001,Wayne Krenchicki,Baltimore Orioles,ORLS,1,1,1,2,1982,1982,0,3.19,0.0,-3.19,332,0,-332,701,0,-701,0.0,0.0,0.0,0.0,0.0,0.0
krenw001,Wayne Krenchicki,Cincinnati Reds,REDS,1,1,1,2,1983,1983,0,0.75,0.0,-0.75,59,0,-59,149,0,-149,0.0,0.0,0.0,0.0,0.0,0.0
krenw001,Wayne Krenchicki,Cincinnati Reds,REDS,2,2,3,5,1986,1994,8,1.73,13.14,11.41,357,667,310,247,834,587,825.0,1502.0,677.0,1200000.0,3750000.0,2550000.0
kresc101,Chuck Kress,Detroit Tigers,TIGRS,5,14,10,24,1954,1961,7,12.9,0.88,-12.02,615,749,134,406,2092,1686,3228.0,40.0,-3188.0,13200.0,8000.0,-5200.0
kresr101,Red Kress,St.Louis Browns,ORLS,4,4,8,12,1932,1936,4,13.67,15.04,1.37,895,883,-12,3348,2931,-417,691.0,2279.0,1588.0,12250.0,16600.0,4350.0
kresr101,Red Kress,Chicago White Sox,WSOX,1,1,1,2,1934,1940,6,2.34,-2.0,-4.34,252,81,-171,903,319,-584,17.0,0.0,-17.0,6000.0,4000.0,-2000.0
kresr101,Red Kress,Washington Senators,TWINS,1,3,1,4,1937,1940,3,0.0,-1.14,-1.14,0,124,124,0,429,429,0.0,0.0,0.0,0.0,0.0,0.0
kresr101,Red Kress,Boston Red Sox,RSOX,1,3,1,4,1937,1940,3,5.49,2.22,-3.27,408,291,-117,1388,1330,-58,1283.0,0.0,-1283.0,4000.0,12000.0,8000.0
kresr101,Red Kress,St.Louis Browns,ORLS,6,10,14,24,1939,1952,13,23.39,27.61,4.22,1164,2723,1559,2963,7190,4227,3417.0,6493.0,3076.0,67500.0,49800.0,-17700.0
kretl101,Lou Kretlow,Detroit Tigers,TIGRS,1,2,1,3,1949,1953,4,-1.32,6.81,8.13,157,451,294,102,1933,1831,901.0,0.0,-901.0,6000.0,0.0,-6000.0
kretl101,Lou Kretlow,Chicago White Sox,WSOX,7,12,13,25,1953,1969,16,11.99,30.83,18.84,1538,1586,48,4583,5396,813,1710.0,1860.0,150.0,87250.0,45000.0,-42250.0
kreuc001,Chad Kreuter,Chicago White Sox,WSOX,1,2,2,4,1997,1997,0,1.15,1.16,0.01,178,151,-27,735,342,-393,0.0,178.0,178.0,2847500.0,1092000.0,-1755500.0
kreuf101,Frank Kreutzer,Chicago White Sox,WSOX,3,4,5,9,1964,1969,5,-1.84,4.73,6.57,327,350,23,584,1283,699,492.0,0.0,-492.0,70250.0,45000.0,-25250.0
kreuf101,Frank Kreutzer,Washington Senators,RNGRS,1,1,1,2,1969,1975,6,0.0,0.92,0.92,0,276,276,0,106,106,0.0,1216.0,1216.0,10000.0,8500.0,-1500.0
kreur101,Rick Kreuger,Boston Red Sox,RSOX,1,1,1,2,1978,1979,1,0.15,-0.74,-0.89,6,70,64,0,120,120,28.0,0.0,-28.0,0.0,0.0,0.0
krivr001,Rick Krivda,Cleveland Indians,INDINS,1,1,2,3,1998,1998,0,-1.7,0.0,1.7,31,0,-31,4,0,-4,79.0,0.0,-79.0,205000.0,0.0,-205000.0
krolg101,Gary Kroll,Philadelphia Phillies,PHILS,1,3,1,4,1964,1965,1,-0.3,1.17,1.47,100,74,-26,65,237,172,326.0,0.0,-326.0,0.0,0.0,0.0
krolg101,Gary Kroll,New York Mets,METS,1,1,2,3,1966,1966,0,0.2,0.0,-0.2,20,0,-20,3,0,-3,71.0,0.0,-71.0,0.0,0.0,0.0
kroli001,Ian Krol,Oakland Athletics,ATLTCS,8,15,10,25,2013,2018,5,10.44,2.58,-7.86,1089,362,-727,2080,1057,-1023,1184.0,312.0,-872.0,8300001.0,4800000.0,-3500001.0
kroli001,Ian Krol,Washington Nationals,NATEX,1,3,1,4,2013,2015,2,-1.71,4.39,6.1,114,103,-11,3,101,98,324.0,801.0,477.0,501250.0,4000000.0,3498750.0
kroli001,Ian Krol,Detroit Tigers,TIGRS,2,3,2,5,2015,2019,4,1.92,2.82,0.9,314,181,-133,389,391,2,300.0,240.0,-60.0,8515000.0,7000000.0,-1515000.0
kroom001,Marc Kroon,New York Mets,METS,1,2,3,5,1993,1994,1,-0.15,-0.19,-0.04,32,20,-12,0,3,3,46.0,51.0,5.0,0.0,150000.0,150000.0
kroom001,Marc Kroon,San Diego Padres,PADRS,1,1,1,2,1998,2000,2,-0.23,-0.55,-0.32,8,22,14,0,11,11,16.0,122.0,106.0,176000.0,0.0,-176000.0
krsnr101,Rocky Krsnich,Chicago White Sox,WSOX,1,3,1,4,1953,1955,2,0.0,-0.06,-0.06,1,69,68,1,138,137,0.0,0.0,0.0,0.0,0.0,0.0
krueb001,Bill Krueger,Oakland Athletics,ATLTCS,1,1,1,2,1987,1987,0,-0.21,0.0,0.21,6,0,-6,0,0,0,14.0,0.0,-14.0,0.0,0.0,0.0
krueb001,Bill Krueger,Los Angeles Dodgers,DOGRS,1,1,1,2,1988,1988,0,0.0,0.0,0.0,0,0,0,0,0,0,0.0,0.0,0.0,0.0,0.0,0.0
krueb001,Bill Krueger,Minnesota Twins,TWINS,2,2,2,4,1992,1992,0,-0.51,-0.28,0.23,18,14,-4,4,37,33,52.0,0.0,-52.0,920000.0,119000.0,-801000.0
krueo101,Otto Krueger,St. Louis Cardinals,CARDS,1,1,1,2,1903,1906,3,0.61,1.51,0.9,166,355,189,607,1383,776,0.0,0.0,0.0,0.0,0.0,0.0
krueo101,Otto Krueger,Pittsburgh Pirates,PIRATS,2,6,3,9,1904,1910,6,14.45,22.9,8.45,1603,573,-1030,5618,1466,-4152,2702.0,3643.0,941.0,0.0,0.0,0.0
kruga101,Art Kruger,Columbus,Columbus,1,2,1,3,1909,1909,0,0.53,0.0,-0.53,106,0,-106,302,0,-302,383.0,0.0,-383.0,0.0,0.0,0.0
krugc101,Chris Krug,Chicago Cubs,CUBS,1,2,2,4,1966,1966,0,0.0,0.0,0.0,0,0,0,0,0,0,0.0,0.0,0.0,0.0,0.0,0.0
krukj001,John Kruk,San Diego Padres,PADRS,8,16,17,33,1989,1998,9,97.76,11.55,-86.21,6640,1589,-5051,25821,4524,-21297,1355.0,1888.0,533.0,9476667.0,5045000.0,-4431667.0
krukm001,Mike Krukow,Chicago Cubs,CUBS,4,6,9,15,1981,1989,8,1.13,3.09,1.96,267,1148,881,639,3744,3105,1316.0,1145.0,-171.0,0.0,0.0,0.0
krukm001,Mike Krukow,Philadelphia Phillies,PHILS,2,5,3,8,1982,1988,6,12.97,14.82,1.85,911,983,72,587,531,-56,5303.0,1684.0,-3619.0,0.0,1330000.0,1330000.0
kryhd101,Dick Kryhoski,New York Yankees,YANKS,1,1,1,2,1949,1950,1,0.37,0.0,-0.37,172,3,-169,634,3,-631,0.0,0.0,0.0,0.0,0.0,0.0
kryhd101,Dick Kryhoski,Detroit Tigers,TIGRS,11,26,24,50,1952,1961,9,21.38,15.7,-5.68,2119,2215,96,3938,6442,2504,5639.0,2357.0,-3282.0,45200.0,36000.0,-9200.0
kryhd101,Dick Kryhoski,Baltimore Orioles,ORLS,15,37,36,73,1954,1988,34,52.13,133.41,81.28,3638,7388,3750,6759,20843,14084,14284.0,13293.0,-991.0,815833.0,128400.0,-687433.0
krynd001,Dave Krynzel,Milwaukee Brewers,BREWRS,2,4,4,8,2006,2008,2,5.76,-0.61,-6.37,192,321,129,188,507,319,1641.0,616.0,-1025.0,6600000.0,5417000.0,-1183000.0
kubej002,Jason Kubel,Arizona Diamondbacks,DBACKS,1,1,2,3,2013,2014,1,-0.06,-0.06,0.0,8,16,8,23,1,-22,0.0,26.0,26.0,0.0,0.0,0.0
kubij101,Jack Kubiszyn,Cleveland Indians,INDINS,2,5,2,7,1962,1968,6,3.21,3.85,0.64,600,709,109,441,2271,1830,1817.0,0.0,-1817.0,27000.0,25000.0,-2000.0
kubik001,Kyle Kubitza,Atlanta Braves,BRAVES,1,1,2,3,2015,2018,3,-0.31,0.0,0.31,19,0,-19,39,0,-39,0.0,0.0,0.0,0.0,0.0,0.0
kubit101,Ted Kubiak,Oakland Athletics,ATLTCS,1,2,2,4,1969,1972,3,0.15,3.68,3.53,269,160,-109,950,108,-842,105.0,993.0,888.0,22500.0,36800.0,14300.0
kubit101,Ted Kubiak,Milwaukee Brewers,BREWRS,10,16,19,35,1971,1986,15,43.81,45.76,1.95,2829,2561,-268,7569,6589,-980,5854.0,7527.0,1673.0,612800.0,15000.0,-597800.0
kubit101,Ted Kubiak,St. Louis Cardinals,CARDS,1,1,1,2,1971,1971,0,-0.34,0.0,0.34,46,0,-46,130,0,-130,0.0,0.0,0.0,27000.0,15000.0,-12000.0
kubit101,Ted Kubiak,Texas Rangers,RNGRS,11,23,21,44,1972,1986,14,55.26,26.32,-28.94,2860,1699,-1161,5732,4590,-1142,9799.0,4163.0,-5636.0,214000.0,360000.0,146000.0
kubit101,Ted Kubiak,Oakland Athletics,ATLTCS,1,1,1,2,1975,1975,0,-0.93,0.46,1.39,183,18,-165,468,1,-467,0.0,183.0,183.0,42500.0,0.0,-42500.0
kubsg101,Gil Kubski,California Angels,ANGELS,1,1,1,2,1981,1981,0,0.0,0.0,0.0,0,0,0,0,0,0,0.0,0.0,0.0,0.0,0.0,0.0
kubsg101,Gil Kubski,Toronto Blue Jays,BJAYS,1,1,1,2,1981,1986,5,0.0,3.51,3.51,0,454,454,0,1261,1261,0.0,0.0,0.0,0.0,0.0,0.0
kucej101,Jack Kucek,Chicago White Sox,WSOX,2,2,2,4,1979,1982,3,8.09,4.64,-3.45,560,376,-184,1833,1430,-403,13.0,22.0,9.0,0.0,0.0,0.0
kuckj101,Johnny Kucks,New York Yankees,YANKS,3,7,5,12,1959,1966,7,10.26,14.71,4.45,1028,1524,496,3254,3264,10,1701.0,4103.0,2402.0,84000.0,27500.0,-56500.0
kuckj101,Johnny Kucks,Baltimore Orioles,ORLS,1,1,1,2,1961,1961,0,0.0,0.0,0.0,0,0,0,0,0,0,0.0,0.0,0.0,0.0,0.0,0.0
kuenh101,Harvey Kuenn,Detroit Tigers,TIGRS,5,7,7,14,1960,1972,12,10.2,23.19,12.99,762,1846,1084,1264,5438,4174,1071.0,2815.0,1744.0,103000.0,29000.0,-74000.0
kuenh101,Harvey Kuenn,Cleveland Indians,INDINS,2,2,4,6,1960,1964,4,3.83,1.83,-2.0,581,494,-87,2181,1696,-485,0.0,144.0,144.0,40000.0,36500.0,-3500.0
kuenh101,Harvey Kuenn,San Francisco Giants,GIANTS,3,5,4,9,1965,1968,3,-1.4,-0.01,1.39,272,250,-22,397,696,299,492.0,0.0,-492.0,33000.0,30000.0,-3000.0
kuhej101,Joe Kuhel,Washington Senators,TWINS,2,2,4,6,1938,1938,0,15.12,1.81,-13.31,1022,137,-885,4378,589,-3789,0.0,0.0,0.0,0.0,0.0,0.0
kuipd001,Duane Kuiper,Cleveland Indians,INDINS,2,2,3,5,1981,1984,3,14.47,1.93,-12.54,734,205,-529,1087,273,-814,4063.0,725.0,-3338.0,0.0,0.0,0.0
kunkb101,Bill Kunkel,Kansas City Athletics,ATLTCS,1,2,1,3,1962,1965,3,0.0,6.11,6.11,0,202,202,0,205,205,0.0,1684.0,1684.0,0.0,0.0,0.0
kunkj001,Jeff Kunkel,Milwaukee Brewers,BREWRS,1,1,1,2,1992,1992,0,-0.15,0.0,0.15,20,0,-20,29,0,-29,0.0,0.0,0.0,0.0,0.0,0.0
kuntr001,Rusty Kuntz,Chicago White Sox,WSOX,1,1,1,2,1983,1992,9,-0.65,0.0,0.65,31,0,-31,113,0,-113,0.0,0.0,0.0,0.0,0.0,0.0
kuntr001,Rusty Kuntz,Minnesota Twins,TWINS,1,1,1,2,1983,1983,0,-0.24,0.0,0.24,89,0,-89,175,0,-175,0.0,0.0,0.0,0.0,0.0,0.0
kunze001,Eddie Kunz,New York Mets,METS,1,1,1,2,2011,2014,3,0.0,0.0,0.0,0,0,0,0,0,0,0.0,0.0,0.0,0.0,0.0,0.0
kunze101,Earl Kunz,Sacramento,Sacramento,1,1,5,6,1922,1922,0,-0.78,0.0,0.78,42,0,-42,12,0,-12,136.0,0.0,-136.0,0.0,2700.0,2700.0
kusna101,Art Kusnyer,Chicago White Sox,WSOX,2,2,3,5,1971,1974,3,-1.52,0.66,2.18,111,200,89,278,14,-264,0.0,493.0,493.0,0.0,0.0,0.0
kusna101,Art Kusnyer,California Angels,ANGELS,3,7,8,15,1973,1976,3,0.2,6.55,6.35,187,557,370,417,1633,1216,696.0,244.0,-452.0,35000.0,131300.0,96300.0
kusna101,Art Kusnyer,Milwaukee Brewers,BREWRS,1,1,1,2,1978,1978,0,0.04,0.0,-0.04,9,0,-9,15,0,-15,0.0,0.0,0.0,0.0,0.0,0.0
kutcr001,Randy Kutcher,San Francisco Giants,GIANTS,1,1,1,2,1987,1994,7,0.58,0.22,-0.36,159,15,-144,277,29,-248,0.0,0.0,0.0,0.0,525000.0,525000.0
kutym101,Marty Kutyna,St. Louis Cardinals,CARDS,27,56,48,104,1957,1994,37,117.05,198.75,81.7,11329,9665,-1664,30194,33834,3640,12663.0,4453.0,-8210.0,3323333.0,942667.0,-2380666.0
kutym101,Marty Kutyna,Cincinnati Reds,REDS,1,1,1,2,1959,1959,0,0.95,0.0,-0.95,110,0,-110,6,0,-6,207.0,0.0,-207.0,0.0,0.0,0.0
kutym101,Marty Kutyna,Kansas City Athletics,ATLTCS,1,2,1,3,1960,1960,0,0.38,0.0,-0.38,208,0,-208,47,0,-47,663.0,0.0,-663.0,0.0,0.0,0.0
kuzab101,Bob Kuzava,Cleveland Indians,INDINS,1,2,1,3,1948,1949,1,0.65,0.86,0.21,84,50,-34,82,13,-69,618.0,186.0,-432.0,0.0,10000.0,10000.0
kuzab101,Bob Kuzava,Chicago White Sox,WSOX,10,25,21,46,1950,1963,13,23.73,52.01,28.28,4184,3652,-532,12734,11891,-843,4692.0,2309.0,-2383.0,109500.0,111000.0,1500.0
kuzab101,Bob Kuzava,Washington Senators,TWINS,9,18,18,36,1951,1963,12,12.21,16.51,4.3,1377,2054,677,3595,4242,647,1956.0,5489.0,3533.0,17500.0,25500.0,8000.0
laabc101,Chet Laabs,Detroit Tigers,TIGRS,3,9,7,16,1939,1948,9,19.29,21.11,1.82,2183,1686,-497,6579,6030,-549,3951.0,2317.0,-1634.0,44300.0,54500.0,10200.0
labic101,Clem Labine,Los Angeles Dodgers,DOGRS,1,1,2,3,1960,1960,0,-0.36,0.0,0.36,28,0,-28,2,0,-2,58.0,0.0,-58.0,28000.0,9000.0,-19000.0
laboj001,Jairo Labourt,Toronto Blue Jays,BJAYS,1,3,1,4,2015,2015,0,13.77,2.5,-11.27,310,12,-298,26,4,-22,3733.0,223.0,-3510.0,508700.0,19750000.0,19241300.0
laceb001,Bob Lacey,Oakland Athletics,ATLTCS,1,2,3,5,1981,1987,6,0.0,11.95,11.95,0,617,617,0,2241,2241,0.0,0.0,0.0,0.0,0.0,0.0
laceb001,Bob Lacey,San Diego Padres,PADRS,1,1,1,2,1981,1984,3,-0.56,2.85,3.41,14,296,282,0,1221,1221,64.0,0.0,-64.0,0.0,0.0,0.0
lachc101,Candy LaChance,Cleveland Indians,INDINS,1,1,1,2,1901,1902,1,0.74,0.11,-0.63,448,18,-430,1834,74,-1760,0.0,0.0,0.0,0.0,0.0,0.0
lackj001,John Lackey,Boston Red Sox,RSOX,1,3,2,5,2014,2018,4,5.3,1.43,-3.87,83,264,181,89,204,115,836.0,1078.0,242.0,0.0,0.0,0.0
lacof001,Frank LaCorte,Atlanta Braves,BRAVES,1,1,1,2,1979,1981,2,-1.78,-0.34,1.44,392,74,-318,30,6,-24,845.0,149.0,-696.0,0.0,0.0,0.0
lacop101,Pete LaCock,Chicago Cubs,CUBS,1,1,1,2,1976,1977,1,0.79,0.0,-0.79,452,0,-452,1214,0,-1214,0.0,0.0,0.0,0.0,0.0,0.0
lacyk001,Kerry Lacy,Texas Rangers,RNGRS,1,2,2,4,1996,1996,0,0.03,0.73,0.7,108,23,-85,0,0,0,377.0,67.0,-310.0,123500.0,1975000.0,1851500.0
lacyl001,Lee Lacy,Los Angeles Dodgers,DOGRS,1,4,2,6,1975,1984,9,-0.88,19.14,20.02,1504,1261,-243,5163,4749,-414,0.0,0.0,0.0,0.0,0.0,0.0
lacyl001,Lee Lacy,Atlanta Braves,BRAVES,1,2,1,3,1976,1977,1,4.08,0.61,-3.47,368,56,-312,639,9,-630,292.0,128.0,-164.0,0.0,135000.0,135000.0
laddp001,Pete Ladd,Boston Red Sox,RSOX,1,3,1,4,1979,1979,0,-0.68,2.56,3.24,58,84,26,7,347,340,138.0,0.0,-138.0,0.0,0.0,0.0
laddp001,Pete Ladd,Houston Astros,ASTROS,1,1,1,2,1981,1981,0,0.18,0.0,-0.18,144,0,-144,0,0,0,612.0,0.0,-612.0,0.0,0.0,0.0
laded101,Doyle Lade,Cleveland Indians,INDINS,1,1,1,2,1941,1941,0,0.0,0.0,0.0,0,0,0,0,0,0,0.0,0.0,0.0,0.0,0.0,0.0
ladet001,Tyler Ladendorf,Minnesota Twins,TWINS,1,1,1,2,2009,2009,0,-0.43,-0.05,0.38,54,59,5,68,260,192,3.0,0.0,-3.0,0.0,4000000.0,4000000.0
lafaj101,Joe Lafata,New York Giants,GIANTS,1,5,3,8,1950,1954,4,0.0,-0.44,-0.44,0,186,186,0,308,308,0.0,172.0,172.0,0.0,0.0,0.0
laffa001,Aaron Laffey,Cleveland Indians,INDINS,1,1,2,3,2011,2011,0,0.19,0.0,-0.19,37,0,-37,0,0,0,128.0,0.0,-128.0,0.0,0.0,0.0
lagam001,Mike Laga,Detroit Tigers,TIGRS,1,2,1,3,1986,1990,4,-0.22,6.31,6.53,280,453,173,385,1468,1083,1743.0,0.0,-1743.0,72500.0,533333.0,460833.0
lagrl101,Lerrin LaGrow,St. Louis Cardinals,CARDS,4,5,6,11,1977,1990,13,8.31,14.6,6.29,508,1056,548,1263,2605,1342,1883.0,1997.0,114.0,740000.0,0.0,-740000.0
lahoj101,Joe Lahoud,Boston Red Sox,RSOX,5,10,10,20,1971,1977,6,35.42,11.92,-23.5,1569,736,-833,4628,2092,-2536,3846.0,2344.0,-1502.0,155000.0,100500.0,-54500.0
lahoj101,Joe Lahoud,Milwaukee Brewers,BREWRS,3,7,7,14,1973,1978,5,7.23,1.8,-5.43,546,209,-337,1533,327,-1206,524.0,1634.0,1110.0,168301.0,15000.0,-153301.0
lahtj001,Jeff Lahti,Cincinnati Reds,REDS,1,2,1,3,1982,1982,0,2.67,1.5,-1.17,410,82,-328,39,48,9,858.0,458.0,-400.0,0.0,0.0,0.0
lairb001,Brandon Laird,Kansas City Royals,ROYALS,1,1,1,2,2014,2014,0,0.0,0.0,0.0,0,0,0,0,0,0,0.0,0.0,0.0,0.0,0.0,0.0
lairg001,Gerald Laird,Oakland Athletics,ATLTCS,7,12,11,23,2002,2009,7,21.2,14.17,-7.03,1375,998,-377,3394,3388,-6,5508.0,716.0,-4792.0,947000.0,0.0,-947000.0
lairg001,Gerald Laird,Texas Rangers,RNGRS,3,3,4,7,2008,2013,5,2.85,-0.23,-3.08,311,21,-290,970,19,-951,384.0,44.0,-340.0,1600000.0,0.0,-1600000.0
lakea101,Al Lakeman,Cincinnati Reds,REDS,1,1,2,3,1947,1954,7,-2.12,23.82,25.94,88,519,431,262,570,308,2.0,4467.0,4465.0,0.0,0.0,0.0
lakee101,Eddie Lake,Boston Red Sox,RSOX,2,2,2,4,1946,1947,1,4.74,2.01,-2.73,593,311,-282,2454,1326,-1128,0.0,0.0,0.0,0.0,0.0,0.0
lakef101,Fred Lake,Boston Braves,BRAVES,4,6,7,13,1897,1917,20,22.76,69.87,47.11,670,2683,2013,1752,8723,6971,3628.0,10422.0,6794.0,0.0,0.0,0.0
lakej001,Junior Lake,Chicago Cubs,CUBS,1,1,1,2,2015,2015,0,-0.41,-0.24,0.17,8,37,29,22,0,-22,0.0,47.0,47.0,0.0,4650000.0,4650000.0
lakej101,Joe Lake,New York Yankees,YANKS,1,2,1,3,1909,1909,0,6.01,0.0,-6.01,373,0,-373,970,0,-970,1597.0,0.0,-1597.0,0.0,0.0,0.0
lakes001,Steve Lake,Milwaukee Brewers,BREWRS,2,4,4,8,1983,1987,4,0.96,0.59,-0.37,175,124,-51,420,432,12,0.0,0.0,0.0,0.0,0.0,0.0
lakes001,Steve Lake,St. Louis Cardinals,CARDS,1,2,1,3,1988,1992,4,-1.2,10.67,11.87,295,514,219,652,1641,989,0.0,0.0,0.0,340000.0,240000.0,-100000.0
laket001,Tim Laker,Los Angeles Dodgers,DOGRS,1,1,1,2,1999,2001,2,-0.01,0.0,0.01,6,0,-6,9,0,-9,0.0,0.0,0.0,0.0,0.0,0.0
lakit001,Travis Lakins,Boston Red Sox,RSOX,1,1,1,2,2020,2020,0,0.0,0.0,0.0,0,0,0,0,0,0,0.0,0.0,0.0,0.0,0.0,0.0
lallb001,Blake Lalli,Chicago Cubs,CUBS,1,1,1,2,2012,2012,0,0.0,0.12,0.12,0,9,9,0,21,21,0.0,0.0,0.0,0.0,480000.0,480000.0
lamaa101,Al LaMacchia,St.Louis Browns,ORLS,1,2,1,3,1946,1947,1,1.06,5.22,4.16,159,227,68,625,935,310,8.0,0.0,-8.0,3000.0,0.0,-3000.0
lamab101,Bill Lamar,Boston Red Sox,RSOX,1,2,1,3,1920,1920,0,0.0,1.88,1.88,0,99,99,0,420,420,0.0,0.0,0.0,0.0,0.0,0.0
lamab101,Bill Lamar,Toledo,Toledo,1,1,3,4,1924,1924,0,4.07,0.0,-4.07,425,0,-425,1818,0,-1818,0.0,0.0,0.0,0.0,12000.0,12000.0
lamaj101,Jack Lamabe,Pittsburgh Pirates,PIRATS,2,3,3,6,1962,1967,5,1.35,11.96,10.61,573,824,251,1418,1789,371,1199.0,1482.0,283.0,30000.0,0.0,-30000.0
lamaj101,Jack Lamabe,Boston Red Sox,RSOX,1,1,1,2,1965,1968,3,-0.05,1.46,1.51,6,175,169,4,105,101,38.0,984.0,946.0,19500.0,0.0,-19500.0
lamaj101,Jack Lamabe,Houston Astros,ASTROS,5,9,10,19,1965,1973,8,-0.32,0.69,1.01,384,965,581,306,1025,719,923.0,2019.0,1096.0,57500.0,88500.0,31000.0
lamaj101,Jack Lamabe,New York Mets,METS,1,1,1,2,1967,1969,2,0.58,-0.76,-1.34,46,70,24,11,31,20,143.0,311.0,168.0,0.0,0.0,0.0
lamaj101,Jack Lamabe,St. Louis Cardinals,CARDS,3,5,6,11,1968,1972,4,-0.84,1.08,1.92,394,109,-285,40,207,167,1007.0,64.0,-943.0,17500.0,12000.0,-5500.0
lamaj101,Jack Lamabe,Chicago Cubs,CUBS,2,3,3,6,1969,1976,7,1.26,-2.01,-3.27,234,496,262,608,1128,520,0.0,471.0,471.0,0.0,0.0,0.0
lamar001,Ryan LaMarre,Anaheim Angels,ANGELS,1,1,1,2,2017,2017,0,-0.14,0.0,0.14,3,0,-3,8,0,-8,0.0,0.0,0.0,0.0,0.0,0.0
lamaw101,Wayne LaMaster,Philadelphia Phillies,PHILS,2,2,2,4,1938,1940,2,15.0,3.5,-11.5,414,134,-280,436,342,-94,3540.0,613.0,-2927.0,0.0,8000.0,8000.0
lamba001,Andrew Lambo,Los Angeles Dodgers,DOGRS,2,3,3,6,2010,2010,0,2.04,0.31,-1.73,235,38,-197,259,1,-258,1323.0,56.0,-1267.0,0.0,3250000.0,3250000.0
lambc001,Chris Lambert,St. Louis Cardinals,CARDS,1,1,1,2,2007,2007,0,-0.81,-2.36,-1.55,10,29,19,0,11,11,82.0,114.0,32.0,0.0,2950000.0,2950000.0
lambj002,John Lamb,Kansas City Royals,ROYALS,1,3,2,5,2015,2015,0,-1.23,0.27,1.5,231,13,-218,147,0,-147,1419.0,244.0,-1175.0,0.0,10000000.0,10000000.0
lambm001,Mike Lamb,Texas Rangers,RNGRS,1,1,1,2,2004,2004,0,0.0,0.0,0.0,0,0,0,0,0,0,0.0,0.0,0.0,0.0,0.0,0.0
lambm001,Mike Lamb,New York Yankees,YANKS,1,1,1,2,2004,2004,0,4.32,0.0,-4.32,487,0,-487,1436,0,-1436,0.0,0.0,0.0,0.0,0.0,0.0
lambr101,Ray Lamb,Los Angeles Dodgers,DOGRS,1,2,1,3,1970,1972,2,4.26,1.8,-2.46,259,141,-118,136,432,296,1602.0,0.0,-1602.0,10000.0,26000.0,16000.0
lamob101,Bobby LaMotte,St.Louis Browns,ORLS,25,52,60,112,1927,1952,25,169.13,172.17,3.04,8392,11292,2900,28367,37730,9363,13765.0,19339.0,5574.0,243500.0,227450.0,-16050.0
lamob101,Bobby LaMotte,St.Louis Browns,ORLS,21,42,49,91,1926,1952,26,96.01,107.81,11.8,5218,9406,4188,17109,30707,13598,8613.0,15510.0,6897.0,200300.0,179450.0,-20850.0
lamog101,Gene Lamont,Detroit Tigers,TIGRS,1,1,1,2,1973,1974,1,0.0,0.28,0.28,0,7,7,0,25,25,0.0,0.0,0.0,0.0,0.0,0.0
lampd001,Dennis Lamp,Chicago Cubs,CUBS,1,1,1,2,1981,1982,1,6.09,-0.89,-6.98,122,75,-47,0,25,25,1299.0,310.0,-989.0,0.0,0.0,0.0
lampk101,Keith Lampard,St. Louis Cardinals,CARDS,1,1,1,2,1972,1972,0,0.0,0.0,0.0,0,0,0,0,0,0,0.0,0.0,0.0,0.0,0.0,0.0
lampt001,Tom Lampkin,Cleveland Indians,INDINS,3,4,4,8,1990,1995,5,2.91,2.56,-0.35,388,226,-162,1163,817,-346,0.0,0.0,0.0,162500.0,0.0,-162500.0
lampt001,Tom Lampkin,San Francisco Giants,GIANTS,1,1,1,2,1996,1997,1,0.64,-0.71,-1.35,201,12,-189,515,1,-514,0.0,31.0,31.0,230000.0,0.0,-230000.0
lampt001,Tom Lampkin,Seattle Mariners,MARNRS,12,24,25,49,2001,2015,14,25.13,36.61,11.48,2313,2617,304,5473,8533,3060,4049.0,2794.0,-1255.0,29602500.0,19930000.0,-9672500.0
lancg101,Gary Lance,Kansas City Royals,ROYALS,1,1,1,2,1978,1978,0,0.0,0.0,0.0,0,0,0,0,0,0,0.0,0.0,0.0,0.0,0.0,0.0
lancr001,Rick Lancellotti,Pittsburgh Pirates,PIRATS,1,2,2,4,1980,1982,2,6.29,0.5,-5.79,723,83,-640,2424,87,-2337,6.0,76.0,70.0,0.0,0.0,0.0
lancr001,Rick Lancellotti,San Diego Padres,PADRS,2,2,3,5,1985,1986,1,0.04,0.5,0.46,22,36,14,42,1,-41,0.0,70.0,70.0,0.0,0.0,0.0
landb001,Bill Landrum,Cincinnati Reds,REDS,1,1,1,2,1988,1991,3,-0.14,1.81,1.95,14,300,286,2,836,834,37.0,0.0,-37.0,0.0,0.0,0.0
landb101,Bill Landis,Boston Red Sox,RSOX,2,2,2,4,1970,1971,1,0.0,0.0,0.0,0,0,0,0,0,0,0.0,0.0,0.0,0.0,0.0,0.0
landc001,Ced Landrum,Chicago Cubs,CUBS,1,1,1,2,1992,1992,0,0.0,-0.15,-0.15,0,20,20,0,29,29,0.0,0.0,0.0,0.0,0.0,0.0
landd101,Don Landrum,St. Louis Cardinals,CARDS,1,2,2,4,1962,1963,1,2.09,-0.45,-2.54,348,91,-257,1098,139,-959,0.0,0.0,0.0,0.0,0.0,0.0
landd101,Don Landrum,Chicago Cubs,CUBS,4,8,5,13,1965,1977,12,12.44,36.7,24.26,637,2096,1459,244,5232,4988,3515.0,5246.0,1731.0,122500.0,47500.0,-75000.0
landd101,Don Landrum,Philadelphia Phillies,PHILS,2,3,7,10,1960,1962,2,-0.16,-0.53,-0.37,170,16,-154,318,59,-259,42.0,0.0,-42.0,0.0,0.0,0.0
landg101,Grover Land,Toledo,Toledo,1,1,2,3,1908,1908,0,-1.58,0.0,1.58,95,0,-95,309,0,-309,0.0,0.0,0.0,0.0,0.0,0.0
landh101,Hobie Landrith,Cincinnati Reds,REDS,3,3,3,6,1955,1963,8,0.32,11.82,11.5,224,752,528,378,223,-155,272.0,2547.0,2275.0,0.0,0.0,0.0
landh101,Hobie Landrith,Chicago Cubs,CUBS,5,10,9,19,1956,1965,9,7.39,7.94,0.55,637,1087,450,1408,195,-1213,1395.0,2758.0,1363.0,0.0,0.0,0.0
landh101,Hobie Landrith,St. Louis Cardinals,CARDS,2,6,5,11,1958,1965,7,0.78,23.86,23.08,573,513,-60,1253,888,-365,694.0,3387.0,2693.0,0.0,12000.0,12000.0
landh101,Hobie Landrith,New York Mets,METS,1,2,1,3,1962,1962,0,0.38,0.25,-0.13,62,116,54,190,396,206,0.0,0.0,0.0,0.0,0.0,0.0
landj102,Jesse Landrum,Chicago White Sox,WSOX,3,6,3,9,1939,1950,11,-0.26,2.54,2.8,394,795,401,1460,3225,1765,0.0,0.0,0.0,14200.0,0.0,-14200.0
landj103,Jim Landis,Chicago White Sox,WSOX,16,33,31,64,1965,1979,14,66.9,101.26,34.36,5527,5050,-477,14821,15211,390,11511.0,9679.0,-1832.0,609700.0,568700.0,-41000.0
landj103,Jim Landis,Kansas City Athletics,ATLTCS,10,22,14,36,1965,1976,11,26.85,38.2,11.35,3876,2816,-1060,8514,9189,675,4493.0,1098.0,-3395.0,362100.0,428500.0,66400.0
landj103,Jim Landis,Cleveland Indians,INDINS,2,4,4,8,1967,1969,2,1.58,2.6,1.02,217,267,50,702,761,59,0.0,0.0,0.0,0.0,0.0,0.0
landj103,Jim Landis,Houston Astros,ASTROS,1,1,1,2,1967,1968,1,-0.12,-0.89,-0.77,25,58,33,56,5,-51,0.0,122.0,122.0,0.0,29000.0,29000.0
landk001,Ken Landreaux,California Angels,ANGELS,1,4,1,5,1979,1985,6,6.38,17.39,11.01,810,834,24,2648,3570,922,1590.0,0.0,-1590.0,0.0,0.0,0.0
landk001,Ken Landreaux,Minnesota Twins,TWINS,1,1,3,4,1981,1987,6,8.48,3.72,-4.76,868,672,-196,2981,2514,-467,0.0,0.0,0.0,0.0,0.0,0.0
landl101,Larry Landreth,Montreal Expos,NATEX,1,2,1,3,1978,1979,1,0.0,-1.34,-1.34,10,94,84,4,5,1,54.0,184.0,130.0,0.0,0.0,0.0
landr001,Rafael Landestoy,Los Angeles Dodgers,DOGRS,1,2,2,4,1978,1981,3,4.6,3.69,-0.91,609,283,-326,1828,907,-921,0.0,0.0,0.0,0.0,0.0,0.0
landr001,Rafael Landestoy,Houston Astros,ASTROS,1,1,1,2,1981,1985,4,-0.51,-0.85,-0.34,92,184,92,144,343,199,0.0,0.0,0.0,0.0,0.0,0.0
landr001,Rafael Landestoy,Cincinnati Reds,REDS,10,14,20,34,1983,2006,23,18.56,36.05,17.49,3038,2935,-103,2001,4186,2185,4092.0,5583.0,1491.0,22668833.0,10745833.0,-11923000.0
landt001,Tito Landrum,St. Louis Cardinals,CARDS,1,1,1,2,1983,1984,1,-0.07,-0.3,-0.23,39,56,17,72,117,45,0.0,0.0,0.0,0.0,0.0,0.0
landt001,Tito Landrum,Baltimore Orioles,ORLS,1,1,1,2,1984,1984,0,1.04,0.0,-1.04,316,0,-316,655,0,-655,0.0,0.0,0.0,0.0,0.0,0.0
lanfw101,Walt Lanfranconi,Boston Braves,BRAVES,1,2,1,3,1948,1948,0,-0.05,-0.28,-0.23,48,34,-14,105,82,-23,0.0,0.0,0.0,0.0,0.0,0.0
langa001,Alex Lange,Chicago Cubs,CUBS,1,2,2,4,2019,2019,0,0.3,1.75,1.45,39,51,12,0,225,225,107.0,0.0,-107.0,0.0,9950000.0,9950000.0
langd102,Don Lang,Cincinnati Reds,REDS,1,2,1,3,1940,1941,1,0.0,-0.31,-0.31,0,15,15,0,6,6,0.0,73.0,73.0,0.0,13500.0,13500.0
langd102,Don Lang,Boston Red Sox,RSOX,1,2,1,3,1946,1946,0,3.72,0.0,-3.72,260,0,-260,831,0,-831,0.0,0.0,0.0,0.0,0.0,0.0
langm001,Mark Langston,Seattle Mariners,MARNRS,15,25,31,56,1989,2015,26,47.96,108.51,60.55,2885,3632,747,7463,9980,2517,4388.0,14029.0,9641.0,34882500.0,19453000.0,-15429500.0
langm002,Matt Langwell,Cleveland Indians,INDINS,1,2,1,3,2013,2013,0,-0.06,-0.06,0.0,16,8,-8,1,23,22,26.0,0.0,-26.0,0.0,0.0,0.0
langr001,Rick Langford,Pittsburgh Pirates,PIRATS,5,10,11,21,1977,1988,11,53.71,31.99,-21.72,2929,1675,-1254,9660,6568,-3092,5429.0,149.0,-5280.0,807000.0,0.0,-807000.0
langr002,Ryan Langerhans,Oakland Athletics,ATLTCS,1,1,1,2,2007,2007,0,-0.21,0.24,0.45,176,6,-170,326,25,-301,0.0,0.0,0.0,0.0,450000.0,450000.0
langr002,Ryan Langerhans,Washington Nationals,NATEX,5,9,8,17,2009,2020,11,4.09,17.73,13.64,553,1365,812,690,1506,816,1207.0,2502.0,1295.0,8731616.0,4000000.0,-4731616.0
lanim101,Max Lanier,St. Louis Cardinals,CARDS,1,2,1,3,1951,1951,0,0.42,0.0,-0.42,122,0,-122,75,0,-75,427.0,0.0,-427.0,25000.0,32500.0,7500.0
lankr001,Ray Lankford,St. Louis Cardinals,CARDS,1,2,1,3,2001,2004,3,0.53,11.71,11.18,121,185,64,385,221,-164,0.0,1766.0,1766.0,8100000.0,5083333.0,-3016667.0
lannj101,Johnny Lanning,Boston Braves,BRAVES,1,1,2,3,1939,1945,6,6.51,20.23,13.72,292,447,155,168,628,460,1592.0,4101.0,2509.0,4500.0,10000.0,5500.0
lansc001,Carney Lansford,California Angels,ANGELS,2,4,3,7,1980,1986,6,8.12,4.18,-3.94,957,338,-619,2329,1304,-1025,1201.0,0.0,-1201.0,233333.0,0.0,-233333.0
lansc001,Carney Lansford,Boston Red Sox,RSOX,1,3,2,5,1982,1986,4,26.9,1.92,-24.98,1356,609,-747,5373,2373,-3000,4.0,0.0,-4.0,440000.0,0.0,-440000.0
lansj101,Joe Lansford,San Diego Padres,PADRS,10,18,19,37,1985,1998,13,97.76,19.36,-78.4,6640,1871,-4769,25821,5457,-20364,1355.0,1888.0,533.0,9476667.0,5045000.0,-4431667.0
lansm001,Mike Lansing,Montreal Expos,NATEX,3,6,6,12,1997,2001,4,6.33,1.3,-5.03,602,104,-498,1203,335,-868,1105.0,214.0,-891.0,3425000.0,3125000.0,-300000.0
lansm001,Mike Lansing,Colorado Rockies,ROCKS,7,13,12,25,2000,2002,2,6.04,1.37,-4.67,876,433,-443,660,150,-510,2239.0,928.0,-1311.0,9375000.0,6575000.0,-2800000.0
lapap102,Paul LaPalme,Pittsburgh Pirates,PIRATS,1,1,2,3,1955,1955,0,2.31,0.73,-1.58,114,22,-92,20,5,-15,277.0,84.0,-193.0,0.0,0.0,0.0
lapap102,Paul LaPalme,St. Louis Cardinals,CARDS,1,1,1,2,1956,1956,0,0.39,0.0,-0.39,22,0,-22,6,0,-6,81.0,0.0,-81.0,0.0,0.0,0.0
lapod001,Dave LaPoint,Milwaukee Brewers,BREWRS,2,5,6,11,1980,1986,6,6.59,20.26,13.67,970,997,27,2159,3010,851,2112.0,2376.0,264.0,0.0,0.0,0.0
lapod001,Dave LaPoint,St. Louis Cardinals,CARDS,1,4,1,5,1985,1987,2,10.04,9.7,-0.34,1204,322,-882,3785,1371,-2414,620.0,0.0,-620.0,0.0,0.0,0.0
lapod001,Dave LaPoint,San Francisco Giants,GIANTS,3,6,5,11,1985,1991,6,8.16,14.64,6.48,1129,850,-279,2301,1999,-302,2390.0,2023.0,-367.0,0.0,990000.0,990000.0
lapod001,Dave LaPoint,Detroit Tigers,TIGRS,2,2,2,4,1986,1988,2,-0.35,0.84,1.19,140,180,40,12,327,315,678.0,340.0,-338.0,550000.0,270000.0,-280000.0
lapod001,Dave LaPoint,St. Louis Cardinals,CARDS,1,1,1,2,1987,1987,0,5.2,0.0,-5.2,39,0,-39,0,0,0,732.0,0.0,-732.0,0.0,0.0,0.0
lapod001,Dave LaPoint,Chicago White Sox,WSOX,3,4,5,9,1988,1996,8,8.04,20.1,12.06,594,752,158,1682,2873,1191,422.0,391.0,-31.0,5255000.0,2145555.0,-3109445.0
lapof101,Frank LaPorte,New York Yankees,YANKS,1,1,1,2,1907,1908,1,0.52,1.29,0.77,62,75,13,167,301,134,0.0,0.0,0.0,0.0,0.0,0.0
lapof101,Frank LaPorte,Boston Red Sox,RSOX,1,1,1,2,1908,1910,2,4.01,0.97,-3.04,252,181,-71,999,716,-283,0.0,0.0,0.0,0.0,0.0,0.0
lapof101,Frank LaPorte,New York Yankees,YANKS,1,2,2,4,1911,1911,0,24.82,2.99,-21.83,1527,144,-1383,6167,615,-5552,0.0,0.0,0.0,0.0,0.0,0.0
lapom001,Matt LaPorta,Milwaukee Brewers,BREWRS,1,4,1,5,2008,2008,0,22.37,5.2,-17.17,1354,34,-1320,5551,50,-5501,190.0,392.0,202.0,0.0,11000000.0,11000000.0
lapor101,Ralph LaPointe,Philadelphia Phillies,PHILS,4,10,8,18,1948,1957,9,11.82,23.96,12.14,1009,1518,509,3058,5428,2370,109.0,186.0,77.0,63000.0,37500.0,-25500.0
larkn101,Norm Larker,Houston Astros,ASTROS,1,1,3,4,1962,1965,3,-0.09,3.88,3.97,64,176,112,177,179,2,0.0,1524.0,1524.0,0.0,0.0,0.0
larkp101,Pat Larkin,San Francisco Giants,GIANTS,2,2,2,4,1984,1989,5,0.0,0.02,0.02,0,12,12,0,2,2,0.0,37.0,37.0,0.0,0.0,0.0
larks001,Stephen Larkin,Texas Rangers,RNGRS,1,2,1,3,1995,1996,1,0.02,0.43,0.41,1,39,38,3,104,101,0.0,0.0,0.0,0.0,0.0,0.0
laroa001,Adam LaRoche,Atlanta Braves,BRAVES,6,14,16,30,2007,2014,7,20.02,10.31,-9.71,2739,1550,-1189,4450,3506,-944,3035.0,1968.0,-1067.0,26080000.0,24455000.0,-1625000.0
laroa001,Adam LaRoche,Pittsburgh Pirates,PIRATS,1,1,2,3,2009,2013,4,-0.02,-0.42,-0.4,6,22,16,19,36,17,0.0,0.0,0.0,7050000.0,0.0,-7050000.0
laroa001,Adam LaRoche,Boston Red Sox,RSOX,2,2,3,5,2009,2010,1,1.22,1.94,0.72,182,159,-23,699,477,-222,0.0,3.0,3.0,0.0,2885000.0,2885000.0
laroa002,Andy LaRoche,Los Angeles Dodgers,DOGRS,1,2,1,3,2008,2010,2,0.68,6.26,5.58,458,223,-235,1050,892,-158,281.0,0.0,-281.0,392500.0,0.0,-392500.0
larod101,Dave LaRoche,California Angels,ANGELS,2,2,3,5,1971,1974,3,-0.02,2.62,2.64,196,305,109,227,1031,804,286.0,0.0,-286.0,15500.0,45000.0,29500.0
larod101,Dave LaRoche,Minnesota Twins,TWINS,1,1,3,4,1972,1976,4,0.4,7.0,6.6,189,163,-26,33,0,-33,439.0,2282.0,1843.0,25000.0,72500.0,47500.0
larod101,Dave LaRoche,Chicago Cubs,CUBS,1,2,1,3,1975,1976,1,5.2,-0.21,-5.41,136,50,-86,0,3,3,592.0,115.0,-477.0,0.0,0.0,0.0
larod101,Dave LaRoche,Cleveland Indians,INDINS,2,3,4,7,1977,1983,6,4.0,9.46,5.46,343,468,125,13,775,762,1466.0,1221.0,-245.0,85000.0,0.0,-85000.0
larsd101,Dan Larson,St. Louis Cardinals,CARDS,1,2,1,3,1974,1975,1,-0.69,-0.39,0.3,92,16,-76,63,7,-56,570.0,68.0,-502.0,0.0,100000.0,100000.0
larsd101,Dan Larson,Houston Astros,ASTROS,1,1,1,2,1978,1979,1,0.45,-0.02,-0.47,42,10,-32,32,2,-30,281.0,32.0,-249.0,0.0,0.0,0.0
larsd101,Dan Larson,Philadelphia Phillies,PHILS,3,8,5,13,1981,1988,7,16.51,17.82,1.31,2071,1049,-1022,4347,608,-3739,6629.0,2308.0,-4321.0,0.0,1330000.0,1330000.0
larsd102,Don Larsen,Baltimore Orioles,ORLS,15,37,36,73,1954,1988,34,52.13,133.41,81.28,3638,7388,3750,6759,20843,14084,14284.0,13293.0,-991.0,815833.0,128400.0,-687433.0
larsd102,Don Larsen,New York Yankees,YANKS,4,7,6,13,1959,1969,10,14.99,27.57,12.58,1233,1032,-201,4340,4017,-323,296.0,0.0,-296.0,175000.0,51000.0,-124000.0
larsd102,Don Larsen,Kansas City Athletics,ATLTCS,19,40,34,74,1961,1976,15,67.84,34.29,-33.55,6835,3922,-2913,16048,11060,-4988,8728.0,3414.0,-5314.0,393100.0,483000.0,89900.0
larsd102,Don Larsen,Chicago White Sox,WSOX,6,7,11,18,1961,1968,7,9.19,14.32,5.13,984,1200,216,811,1186,375,2300.0,2896.0,596.0,31250.0,52000.0,20750.0
larsd102,Don Larsen,Houston Astros,ASTROS,1,1,2,3,1965,1965,0,0.29,0.0,-0.29,54,0,-54,11,0,-11,162.0,0.0,-162.0,0.0,0.0,0.0
larut101,Tony LaRussa,Atlanta Braves,BRAVES,1,1,1,2,1972,1972,0,0.0,0.0,0.0,1,0,-1,0,0,0,0.0,0.0,0.0,0.0,0.0,0.0
larut101,Tony LaRussa,Chicago White Sox,WSOX,1,1,1,2,1976,1977,1,0.0,-0.22,-0.22,0,5,5,0,0,0,0.0,8.0,8.0,0.0,0.0,0.0
laryf101,Frank Lary,New York Mets,METS,2,3,4,7,1964,1970,6,1.31,5.65,4.34,198,446,248,238,478,240,553.0,2271.0,1718.0,30000.0,26000.0,-4000.0
laryf101,Frank Lary,New York Mets,METS,2,4,2,6,1965,1966,1,-0.17,-0.64,-0.47,38,55,17,22,134,112,80.0,0.0,-80.0,0.0,13500.0,13500.0
laryl101,Lyn Lary,Oakland,Oakland,1,2,1,3,1927,1927,0,12.23,0.0,-12.23,638,0,-638,2477,0,-2477,0.0,0.0,0.0,0.0,0.0,0.0
laryl101,Lyn Lary,New York Yankees,YANKS,1,1,2,3,1934,1934,0,0.54,0.0,-0.54,129,0,-129,501,0,-501,0.0,0.0,0.0,7500.0,0.0,-7500.0
laryl101,Lyn Lary,Boston Red Sox,RSOX,1,2,1,3,1934,1946,12,-0.53,27.76,28.29,39,1134,1095,121,4584,4463,0.0,0.0,0.0,0.0,22000.0,22000.0
laryl101,Lyn Lary,Washington Senators,TWINS,1,1,1,2,1935,1937,2,3.8,-0.16,-3.96,275,20,-255,1246,59,-1187,0.0,0.0,0.0,8000.0,3500.0,-4500.0
laryl101,Lyn Lary,St.Louis Browns,ORLS,12,23,32,55,1937,1952,15,55.87,54.37,-1.5,2736,6464,3728,7991,19515,11524,6789.0,12669.0,5880.0,129000.0,122100.0,-6900.0
lashf101,Fred Lasher,Detroit Tigers,TIGRS,1,1,2,3,1970,1970,0,-0.64,-0.16,0.48,86,28,-58,9,38,29,173.0,0.0,-173.0,0.0,8070.0,8070.0
laskb001,Bill Laskey,Kansas City Royals,ROYALS,1,2,1,3,1981,1983,2,7.18,1.45,-5.73,329,160,-169,289,613,324,2571.0,0.0,-2571.0,0.0,0.0,0.0
laskb001,Bill Laskey,San Francisco Giants,GIANTS,1,2,1,3,1985,1986,1,-1.74,-0.39,1.35,56,69,13,46,222,176,103.0,0.0,-103.0,552000.0,0.0,-552000.0
laskb001,Bill Laskey,Montreal Expos,NATEX,3,3,4,7,1985,1990,5,0.41,-0.44,-0.85,115,47,-68,115,57,-58,424.0,26.0,-398.0,0.0,200000.0,200000.0
lasot101,Tom Lasorda,Kansas City Athletics,ATLTCS,1,1,1,2,1956,1956,0,0.0,2.56,2.56,0,36,36,0,45,45,0.0,363.0,363.0,0.0,0.0,0.0
lastt001,Tommy La Stella,Atlanta Braves,BRAVES,2,3,3,6,2014,2019,5,0.92,4.18,3.26,315,439,124,587,0,-587,37.0,635.0,598.0,5375000.0,8500000.0,3125000.0
lastt001,Tommy La Stella,Chicago Cubs,CUBS,1,1,1,2,2018,2018,0,2.16,0.0,-2.16,108,0,-108,438,0,-438,0.0,0.0,0.0,950000.0,0.0,-950000.0
lastt001,Tommy La Stella,Anaheim Angels,ANGELS,1,1,1,2,2020,2021,1,0.42,-0.23,-0.65,27,6,-21,111,18,-93,0.0,0.0,0.0,3250000.0,0.0,-3250000.0
latha101,Arlie Latham,Cincinnati Reds,REDS,4,11,5,16,1895,1906,11,8.81,24.47,15.66,1114,1079,-35,4520,3525,-995,393.0,2208.0,1815.0,1500.0,0.0,-1500.0
lathb001,Bill Latham,New York Mets,METS,2,4,3,7,1986,1991,5,0.96,6.32,5.36,405,543,138,1082,1694,612,117.0,0.0,-117.0,637500.0,530000.0,-107500.0
lathb001,Bill Latham,Minnesota Twins,TWINS,1,1,1,2,1987,1987,0,0.0,0.0,0.0,0,0,0,0,0,0,0.0,0.0,0.0,0.0,0.0,0.0
lathc001,Chris Latham,Los Angeles Dodgers,DOGRS,1,4,2,6,1995,1998,3,-0.49,1.39,1.88,829,429,-400,2713,30,-2683,618.0,819.0,201.0,218000.0,4410000.0,4192000.0
lathc001,Chris Latham,Minnesota Twins,TWINS,1,1,1,2,1999,2000,1,0.0,0.0,0.0,0,0,0,0,0,0,0.0,0.0,0.0,202500.0,0.0,-202500.0
latit101,Tacks Latimer,Louisville Colonels,LS3,1,12,5,17,1899,1900,1,267.1,0.0,-267.1,7388,0,-7388,29004,0,-29004,7568.0,0.0,-7568.0,4350.0,0.0,-4350.0
latmb101,Barry Latman,Chicago White Sox,WSOX,1,1,1,2,1960,1960,0,1.41,0.7,-0.71,318,46,-272,218,35,-183,1958.0,341.0,-1617.0,0.0,0.0,0.0
latmb101,Barry Latman,Cleveland Indians,INDINS,9,16,15,31,1963,1978,15,26.81,13.21,-13.6,2236,1670,-566,5404,5743,339,2936.0,1183.0,-1753.0,115500.0,141500.0,26000.0
latmb101,Barry Latman,California Angels,ANGELS,1,1,2,3,1965,1970,5,1.4,0.0,-1.4,140,0,-140,40,0,-40,542.0,0.0,-542.0,20000.0,0.0,-20000.0
latom001,Mat Latos,San Diego Padres,PADRS,12,21,25,46,2011,2021,10,36.6,13.97,-22.63,2134,1982,-152,5215,5140,-75,5096.0,2387.0,-2709.0,6329300.0,40298125.0,33968825.0
latom001,Mat Latos,Cincinnati Reds,REDS,1,1,2,3,2014,2020,6,0.44,6.45,6.01,31,217,186,27,221,194,265.0,1870.0,1605.0,7250000.0,0.0,-7250000.0
latom001,Mat Latos,Miami Marlins,MARLNS,1,3,3,6,2015,2015,0,-0.52,0.0,0.52,12,0,-12,7,0,-7,73.0,0.0,-73.0,9400000.0,0.0,-9400000.0
lau-c101,Charlie Lau,Detroit Tigers,TIGRS,1,2,2,4,1959,1959,0,0.34,0.0,-0.34,101,0,-101,212,0,-212,0.0,0.0,0.0,0.0,0.0,0.0
lau-c101,Charlie Lau,Detroit Tigers,TIGRS,1,2,3,5,1959,1964,5,0.34,-0.23,-0.57,101,194,93,212,543,331,0.0,0.0,0.0,0.0,0.0,0.0
lau-c101,Charlie Lau,Kansas City Athletics,ATLTCS,1,1,1,2,1964,1967,3,1.47,3.8,2.33,159,296,137,359,29,-330,0.0,713.0,713.0,0.0,13500.0,13500.0
lauee001,Eric Lauer,San Diego Padres,PADRS,2,8,4,12,2019,2020,1,4.06,1.62,-2.44,306,12,-294,771,0,-771,833.0,208.0,-625.0,6368900.0,24600000.0,18231100.0
laurr001,Ramon Laureano,Houston Astros,ASTROS,1,1,1,2,2017,2019,2,9.58,0.0,-9.58,313,0,-313,1257,0,-1257,0.0,0.0,0.0,0.0,0.0,0.0
lauzg101,George Lauzerique,Oakland Athletics,ATLTCS,1,2,2,4,1969,1972,3,0.15,3.68,3.53,269,160,-109,950,108,-842,105.0,993.0,888.0,22500.0,36800.0,14300.0
lauzg101,George Lauzerique,Milwaukee Brewers,BREWRS,5,11,10,21,1970,1978,8,8.62,9.79,1.17,793,534,-259,2099,1479,-620,524.0,1634.0,1110.0,180301.0,32500.0,-147801.0
lavac101,Cookie Lavagetto,Pittsburgh Pirates,PIRATS,1,2,1,3,1936,1939,3,12.93,4.3,-8.63,841,114,-727,3255,108,-3147,89.0,818.0,729.0,0.0,0.0,0.0
lavac101,Cookie Lavagetto,Oakland,Oakland,1,1,2,3,1933,1937,4,-0.57,0.0,0.57,225,0,-225,798,0,-798,0.0,0.0,0.0,0.0,0.0,0.0
lavad101,Doc Lavan,St.Louis Browns,ORLS,1,2,2,4,1917,1920,3,3.97,0.15,-3.82,243,110,-133,1072,129,-943,0.0,1048.0,1048.0,9000.0,3200.0,-5800.0
lavam001,Mike LaValliere,St. Louis Cardinals,CARDS,1,3,1,4,1987,1989,2,43.01,2.18,-40.83,1782,406,-1376,6646,1435,-5211,1043.0,0.0,-1043.0,0.0,0.0,0.0
laveg001,Gary Lavelle,San Francisco Giants,GIANTS,1,1,3,4,1985,1986,1,0.56,0.97,0.41,92,70,-22,0,60,60,301.0,484.0,183.0,0.0,0.0,0.0
lavej101,Jimmy Lavender,Chicago Cubs,CUBS,3,4,3,7,1917,1919,2,5.24,4.61,-0.63,418,244,-174,1183,779,-404,1055.0,423.0,-632.0,0.0,0.0,0.0
law-d001,Derek Law,San Francisco Giants,GIANTS,1,3,1,4,2019,2019,0,-0.38,0.77,1.15,80,156,76,48,628,580,182.0,0.0,-182.0,0.0,0.0,0.0
law-r001,Rudy Law,Los Angeles Dodgers,DOGRS,2,4,3,7,1982,1987,5,20.6,2.18,-18.42,1937,186,-1751,6428,630,-5798,0.0,0.0,0.0,0.0,975500.0,975500.0
law-r101,Ron Law,Cleveland Indians,INDINS,5,8,7,15,1969,1974,5,5.0,-0.41,-5.41,1218,311,-907,2882,450,-2432,1036.0,482.0,-554.0,104000.0,86000.0,-18000.0
law-v001,Vance Law,Pittsburgh Pirates,PIRATS,1,2,2,4,1982,1983,1,4.04,-0.83,-4.87,410,24,-386,1402,12,-1390,0.0,132.0,132.0,0.0,0.0,0.0
law-v001,Vance Law,Chicago White Sox,WSOX,1,1,1,2,1984,1987,3,5.26,3.0,-2.26,398,170,-228,1515,0,-1515,22.0,667.0,645.0,0.0,0.0,0.0
lawlt001,Tom Lawless,Cincinnati Reds,REDS,1,1,1,2,1984,1986,2,-0.14,0.35,0.49,11,217,206,17,880,863,0.0,0.0,0.0,0.0,700000.0,700000.0
lawlt001,Tom Lawless,Montreal Expos,NATEX,1,1,1,2,1985,1985,0,0.03,0.28,0.25,166,18,-148,217,17,-200,0.0,145.0,145.0,0.0,0.0,0.0
lawrb001,Brian Lawrence,San Diego Padres,PADRS,1,2,1,3,2005,2006,1,0.0,-0.84,-0.84,0,72,72,0,269,269,0.0,0.0,0.0,2375000.0,3000000.0,625000.0
lawrb002,Brett Lawrie,Milwaukee Brewers,BREWRS,1,1,1,2,2010,2012,2,12.67,4.46,-8.21,345,106,-239,1431,120,-1311,0.0,974.0,974.0,0.0,850000.0,850000.0
lawrb002,Brett Lawrie,Toronto Blue Jays,BJAYS,2,6,2,8,2014,2018,4,6.54,19.48,12.94,350,462,112,887,2066,1179,1411.0,0.0,-1411.0,23516100.0,500000.0,-23016100.0
lawrb002,Brett Lawrie,Oakland Athletics,ATLTCS,1,1,2,3,2015,2021,6,1.19,1.38,0.19,94,101,7,384,0,-384,0.0,336.0,336.0,1925000.0,0.0,-1925000.0
lawrb103,Brooks Lawrence,St. Louis Cardinals,CARDS,16,37,31,68,1956,1972,16,46.04,61.47,15.43,4532,2723,-1809,10204,7606,-2598,7123.0,5609.0,-1514.0,32500.0,36000.0,3500.0
lawro101,Otis Lawry,Philadelphia Athletics,ATLTCS,2,7,4,11,1917,1920,3,0.98,1.52,0.54,143,229,86,582,916,334,0.0,0.0,0.0,2400.0,0.0,-2400.0
lawsr101,Roxie Lawson,Detroit Tigers,TIGRS,3,9,7,16,1939,1948,9,19.29,21.11,1.82,2183,1686,-497,6579,6030,-549,3951.0,2317.0,-1634.0,44300.0,54500.0,10200.0
lawss101,Steve Lawson,Oakland Athletics,ATLTCS,2,4,3,7,1972,1975,3,-3.14,2.17,5.31,448,341,-107,1329,643,-686,48.0,183.0,135.0,42500.0,0.0,-42500.0
lawtm001,Marcus Lawton,New York Mets,METS,1,1,1,2,1989,1989,0,-0.46,0.0,0.46,10,0,-10,14,0,-14,0.0,0.0,0.0,0.0,0.0,0.0
lawtm002,Matt Lawton,Minnesota Twins,TWINS,1,1,1,2,2001,2003,2,0.32,3.65,3.33,48,74,26,213,6,-207,0.0,1172.0,1172.0,3900000.0,6750000.0,2850000.0
lawtm002,Matt Lawton,New York Mets,METS,3,9,8,17,2001,2008,7,12.43,-0.5,-12.93,1334,336,-998,2309,1012,-1297,1613.0,327.0,-1286.0,8000000.0,8077500.0,77500.0
lawtm002,Matt Lawton,Cleveland Indians,INDINS,2,2,2,4,2004,2008,4,0.85,2.32,1.47,208,298,90,445,910,465,137.0,130.0,-7.0,7250000.0,0.0,-7250000.0
lawtm002,Matt Lawton,Pittsburgh Pirates,PIRATS,1,1,2,3,2005,2007,2,-0.49,-0.11,0.38,19,4,-15,83,18,-65,0.0,0.0,0.0,7750000.0,0.0,-7750000.0
lawtm002,Matt Lawton,Chicago Cubs,CUBS,1,1,1,2,2005,2012,7,-0.42,0.28,0.7,21,119,98,57,2,-55,0.0,192.0,192.0,0.0,0.0,0.0
laxtb001,Brett Laxton,Oakland Athletics,ATLTCS,2,2,2,4,2000,2002,2,1.66,3.59,1.93,88,359,271,211,1143,932,50.0,0.0,-50.0,1065000.0,500000.0,-565000.0
laxtb101,Bill Laxton,Pittsburgh Pirates,PIRATS,2,5,4,9,1967,1973,6,15.42,-1.44,-16.86,860,110,-750,2406,119,-2287,2691.0,948.0,-1743.0,75000.0,45000.0,-30000.0
laxtb101,Bill Laxton,New York Mets,METS,1,2,2,4,1975,1979,4,6.09,1.21,-4.88,575,71,-504,2407,95,-2312,284.0,578.0,294.0,110000.0,95000.0,-15000.0
laxtb101,Bill Laxton,Seattle Mariners,MARNRS,1,2,1,3,1977,1977,0,-0.02,0.07,0.09,2,11,9,0,36,36,5.0,0.0,-5.0,0.0,75000.0,75000.0
laxtb101,Bill Laxton,Cleveland Indians,INDINS,2,2,2,4,1978,1979,1,-0.32,-1.03,-0.71,42,12,-30,0,0,0,273.0,133.0,-140.0,0.0,0.0,0.0
laydp101,Pete Layden,Boston Red Sox,RSOX,2,8,5,13,1947,1955,8,6.5,21.93,15.43,835,962,127,1487,3127,1640,2844.0,2066.0,-778.0,10000.0,32000.0,22000.0
laynh102,Herman Layne,Toronto,Toronto,1,1,1,2,1926,1926,0,-0.13,0.0,0.13,11,0,-11,7,0,-7,0.0,0.0,0.0,0.0,0.0,0.0
lazzt101,Tony Lazzeri,SaltLakeCity,SaltLakeCity,1,1,4,5,1925,1934,9,46.39,0.0,-46.39,1659,0,-1659,7068,0,-7068,0.0,0.0,0.0,0.0,0.0,0.0
leacf101,Freddy Leach,Philadelphia Phillies,PHILS,6,13,12,25,1928,1941,13,20.25,42.09,21.84,1782,1994,212,6979,5506,-1473,324.0,4825.0,4501.0,24000.0,25700.0,1700.0
leacj001,Jalal Leach,Seattle Mariners,MARNRS,1,2,1,3,1998,1998,0,-0.17,0.32,0.49,8,8,0,12,23,11,0.0,0.0,0.0,0.0,0.0,0.0
leact001,Terry Leach,New York Mets,METS,2,4,3,7,1983,1986,3,6.19,2.33,-3.86,605,254,-351,2016,932,-1084,0.0,0.0,0.0,0.0,0.0,0.0
leact001,Terry Leach,Chicago Cubs,CUBS,2,2,3,5,1984,1986,2,-0.29,0.14,0.43,16,70,54,0,5,5,71.0,155.0,84.0,0.0,0.0,0.0
leact001,Terry Leach,New York Mets,METS,1,1,1,2,1989,1989,0,-0.38,0.0,0.38,30,0,-30,0,0,0,221.0,0.0,-221.0,425000.0,0.0,-425000.0
leact101,Tommy Leach,Louisville Colonels,LS3,1,12,5,17,1899,1900,1,267.1,0.0,-267.1,7388,0,-7388,29004,0,-29004,7568.0,0.0,-7568.0,4350.0,0.0,-4350.0
leact101,Tommy Leach,Pittsburgh Pirates,PIRATS,1,2,2,4,1912,1914,2,9.53,-1.23,-10.76,405,69,-336,1580,172,-1408,276.0,147.0,-129.0,5000.0,7400.0,2400.0
leagb001,Brandon League,Toronto Blue Jays,BJAYS,1,2,1,3,2009,2014,5,0.98,5.22,4.24,193,105,-88,0,11,11,555.0,1614.0,1059.0,640000.0,425000.0,-215000.0
leagb001,Brandon League,Seattle Mariners,MARNRS,1,1,2,3,2012,2012,0,0.25,0.0,-0.25,290,0,-290,3,0,-3,434.0,0.0,-434.0,5000000.0,0.0,-5000000.0
leakm001,Mike Leake,Cincinnati Reds,REDS,3,3,6,9,2015,2019,4,2.65,6.14,3.49,244,500,256,630,1743,1113,253.0,107.0,-146.0,10420000.0,565000.0,-9855000.0
leakm001,Mike Leake,St. Louis Cardinals,CARDS,1,2,1,3,2017,2017,0,4.73,0.0,-4.73,61,0,-61,6,0,-6,1064.0,0.0,-1064.0,0.0,0.0,0.0
leakm001,Mike Leake,Seattle Mariners,MARNRS,1,2,1,3,2019,2019,0,-0.62,0.0,0.62,20,0,-20,22,0,-22,180.0,0.0,-180.0,16000000.0,0.0,-16000000.0
leall001,Luis Leal,Toronto Blue Jays,BJAYS,1,2,1,3,1987,1987,0,-0.66,0.0,0.66,21,0,-21,64,0,-64,0.0,0.0,0.0,0.0,0.0,0.0
learf102,Fred Lear,New York Giants,GIANTS,2,6,2,8,1920,1926,6,11.79,12.89,1.1,909,766,-143,3326,3233,-93,0.0,0.0,0.0,8100.0,5000.0,-3100.0
leart001,Tim Leary,New York Mets,METS,2,2,2,4,1985,1985,0,2.94,0.0,-2.94,62,0,-62,0,0,0,1034.0,0.0,-1034.0,0.0,0.0,0.0
leart001,Tim Leary,Milwaukee Brewers,BREWRS,1,2,1,3,1986,1991,5,9.4,4.13,-5.27,749,517,-232,173,1958,1785,2632.0,0.0,-2632.0,90000.0,325000.0,235000.0
leart001,Tim Leary,Los Angeles Dodgers,DOGRS,2,3,3,6,1989,1993,4,3.28,8.3,5.02,375,891,516,1244,2884,1640,269.0,0.0,-269.0,3370000.0,325000.0,-3045000.0
leart001,Tim Leary,Cincinnati Reds,REDS,1,2,2,4,1989,1997,8,0.48,12.7,12.22,78,910,832,0,3572,3572,1277.0,0.0,-1277.0,0.0,0.0,0.0
leart001,Tim Leary,New York Yankees,YANKS,1,2,1,3,1992,1992,0,0.13,0.0,-0.13,42,0,-42,0,0,0,640.0,0.0,-640.0,2175000.0,0.0,-2175000.0
leblw001,Wade LeBlanc,San Diego Padres,PADRS,1,1,1,2,2011,2013,2,1.02,0.2,-0.82,75,79,4,29,260,231,352.0,0.0,-352.0,0.0,417000.0,417000.0
leblw001,Wade LeBlanc,Toronto Blue Jays,BJAYS,1,1,1,2,2016,2016,0,3.21,0.0,-3.21,74,0,-74,6,0,-6,1000.0,0.0,-1000.0,0.0,0.0,0.0
leblw001,Wade LeBlanc,Seattle Mariners,MARNRS,1,1,1,2,2016,2016,0,0.55,0.0,-0.55,112,0,-112,6,0,-6,240.0,0.0,-240.0,0.0,0.0,0.0
lebob101,Bevo LeBourveau,Toledo,Toledo,2,3,2,5,1927,1928,1,-0.26,0.0,0.26,44,0,-44,66,0,-66,0.0,0.0,0.0,0.0,0.0,0.0
ledea001,Aaron Ledesma,New York Mets,METS,1,1,1,2,1996,1996,0,0.0,0.0,0.0,0,0,0,0,0,0,0.0,0.0,0.0,0.0,0.0,0.0
ledea001,Aaron Ledesma,Tampa Bay Devil Rays,RAYS,1,2,1,3,1999,2001,2,-0.33,-0.6,-0.27,69,109,40,75,451,376,304.0,0.0,-304.0,477500.0,6000000.0,5522500.0
leder001,Ricky Ledee,New York Yankees,YANKS,5,9,7,16,2000,2012,12,11.39,22.07,10.68,570,1540,970,441,4696,4255,3809.0,682.0,-3127.0,14660923.0,19005000.0,4344077.0
leder001,Ricky Ledee,Cleveland Indians,INDINS,1,1,1,2,2000,2000,0,-1.73,0.96,2.69,136,57,-79,512,245,-267,0.0,0.0,0.0,0.0,4325000.0,4325000.0
leder001,Ricky Ledee,Philadelphia Phillies,PHILS,2,3,2,5,2004,2005,1,-0.1,4.09,4.19,66,156,90,60,406,346,97.0,63.0,-34.0,1225000.0,6150000.0,4925000.0
ledew001,Wil Ledezma,Detroit Tigers,TIGRS,1,1,1,2,2007,2009,2,-0.4,-0.23,0.17,24,20,-4,0,0,0,28.0,53.0,25.0,415000.0,400000.0,-15000.0
ledew001,Wil Ledezma,Atlanta Braves,BRAVES,1,2,1,3,2007,2008,1,-0.32,-1.08,-0.76,68,103,35,14,0,-14,206.0,82.0,-124.0,0.0,0.0,0.0
lee-b001,Braxton Lee,Tampa Bay Devil Rays,RAYS,2,4,2,6,2017,2018,1,0.0,0.91,0.91,23,138,115,65,518,453,0.0,0.0,0.0,5900000.0,0.0,-5900000.0
lee-b101,Bill Lee,Boston Red Sox,RSOX,2,3,2,5,1978,1980,2,3.39,0.78,-2.61,191,101,-90,144,278,134,1323.0,0.0,-1323.0,0.0,0.0,0.0
lee-b103,Bill Lee,Chicago Cubs,CUBS,1,1,1,2,1943,1947,4,2.12,1.72,-0.4,114,192,78,123,613,490,1037.0,0.0,-1037.0,0.0,0.0,0.0
lee-b104,Bob Lee,California Angels,ANGELS,6,6,7,13,1966,1973,7,0.39,3.62,3.23,367,666,299,804,481,-323,536.0,1872.0,1336.0,37500.0,61000.0,23500.0
lee-c001,Carlos Lee,Chicago White Sox,WSOX,4,8,10,18,2004,2015,11,24.22,21.59,-2.63,1425,1269,-156,4832,3644,-1188,1060.0,2093.0,1033.0,23205000.0,11950000.0,-11255000.0
lee-c001,Carlos Lee,Milwaukee Brewers,BREWRS,1,2,4,6,2006,2008,2,12.97,2.6,-10.37,855,354,-501,3435,502,-2933,0.0,270.0,270.0,8500000.0,7270260.0,-1229740.0
lee-c001,Carlos Lee,Houston Astros,ASTROS,2,2,3,5,2012,2015,3,-0.39,1.76,2.15,81,340,259,338,1309,971,0.0,0.0,0.0,18500000.0,0.0,-18500000.0
lee-c002,Corey Lee,Texas Rangers,RNGRS,1,1,1,2,2001,2004,3,0.0,1.52,1.52,0,192,192,0,673,673,0.0,0.0,0.0,0.0,975000.0,975000.0
lee-c003,Cliff Lee,Montreal Expos,NATEX,2,6,6,12,2002,2004,2,48.64,-2.57,-51.21,1323,330,-993,4723,156,-4567,4264.0,874.0,-3390.0,4000000.0,4925000.0,925000.0
lee-c003,Cliff Lee,Cleveland Indians,INDINS,6,12,19,31,2009,2021,12,33.76,50.43,16.67,987,1821,834,2686,3190,504,3042.0,8206.0,5164.0,29385300.0,10902500.0,-18482800.0
lee-c003,Cliff Lee,Philadelphia Phillies,PHILS,1,1,3,4,2009,2015,6,3.42,-1.46,-4.88,14,125,111,3,3,0,311.0,203.0,-108.0,0.0,0.0,0.0
lee-c003,Cliff Lee,Seattle Mariners,MARNRS,5,8,8,16,2010,2014,4,3.8,5.22,1.42,345,797,452,623,2614,1991,753.0,1105.0,352.0,10564000.0,427200.0,-10136800.0
lee-c101,Cliff Lee,Cincinnati Reds,REDS,1,1,1,2,1924,1924,0,0.0,0.0,0.0,0,0,0,0,0,0,0.0,0.0,0.0,4500.0,0.0,-4500.0
lee-d001,Derek Lee,Minnesota Twins,TWINS,1,1,1,2,1994,1994,0,0.0,0.0,0.0,0,0,0,0,0,0,0.0,0.0,0.0,0.0,0.0,0.0
lee-d002,Derrek Lee,San Diego Padres,PADRS,1,3,1,4,1997,1998,1,8.67,9.07,0.4,908,70,-838,3276,93,-3183,272.0,771.0,499.0,0.0,4510000.0,4510000.0
lee-d002,Derrek Lee,Florida Marlins,MARLNS,11,20,27,47,2003,2019,16,98.47,55.74,-42.73,3402,2977,-425,10315,8666,-1649,10672.0,5424.0,-5248.0,42818667.0,23603092.0,-19215575.0
lee-d002,Derrek Lee,Chicago Cubs,CUBS,1,1,3,4,2010,2010,0,0.92,0.0,-0.92,39,0,-39,151,0,-151,0.0,0.0,0.0,13250000.0,0.0,-13250000.0
lee-d002,Derrek Lee,Baltimore Orioles,ORLS,1,1,1,2,2011,2011,0,0.86,0.0,-0.86,28,0,-28,113,0,-113,0.0,0.0,0.0,7250000.0,0.0,-7250000.0
lee-d003,David Lee,Colorado Rockies,ROCKS,1,1,2,3,2001,2001,0,0.0,0.0,0.0,0,0,0,0,0,0,0.0,0.0,0.0,0.0,0.0,0.0
lee-d003,David Lee,New York Yankees,YANKS,1,1,1,2,2001,2001,0,0.68,0.25,-0.43,79,11,-68,1,0,-1,146.0,32.0,-114.0,0.0,0.0,0.0
lee-d003,David Lee,Los Angeles Dodgers,DOGRS,1,1,1,2,2003,2003,0,-0.13,0.0,0.13,12,0,-12,0,0,0,36.0,0.0,-36.0,0.0,0.0,0.0
lee-d102,Don Lee,Detroit Tigers,TIGRS,1,2,3,5,1959,1964,5,0.34,-0.23,-0.57,101,194,93,212,543,331,0.0,0.0,0.0,0.0,0.0,0.0
lee-d102,Don Lee,Minnesota Twins,TWINS,1,1,1,2,1962,1962,0,2.67,-0.41,-3.08,220,12,-208,129,2,-127,1232.0,31.0,-1201.0,0.0,0.0,0.0
lee-d102,Don Lee,California Angels,ANGELS,1,1,1,2,1965,1966,1,0.69,0.69,0.0,32,57,25,2,115,113,78.0,0.0,-78.0,16500.0,0.0,-16500.0
lee-h101,Hal Lee,Brooklyn Dodgers,DOGRS,2,6,3,9,1930,1936,6,9.9,18.06,8.16,811,786,-25,1763,3200,1437,2519.0,0.0,-2519.0,18200.0,17000.0,-1200.0
lee-h101,Hal Lee,Philadelphia Phillies,PHILS,4,10,6,16,1933,1941,8,6.58,22.7,16.12,1012,1092,80,3802,2883,-919,324.0,2494.0,2170.0,0.0,0.0,0.0
lee-k001,Khalil Lee,Kansas City Royals,ROYALS,1,4,2,6,2021,2021,0,-0.36,2.43,2.79,11,134,123,18,538,520,0.0,0.0,0.0,0.0,0.0,0.0
lee-l101,Leron Lee,St. Louis Cardinals,CARDS,5,6,5,11,1971,1976,5,12.13,1.76,-10.37,660,184,-476,1378,165,-1213,1880.0,841.0,-1039.0,34000.0,12500.0,-21500.0
lee-m001,Manuel Lee,New York Mets,METS,1,3,1,4,1984,1986,2,6.19,2.33,-3.86,605,254,-351,2016,932,-1084,0.0,0.0,0.0,0.0,0.0,0.0
lee-m002,Mark Lee,Detroit Tigers,TIGRS,1,2,1,3,1988,1989,1,-0.33,-0.3,0.03,105,4,-101,125,0,-125,15.0,56.0,41.0,0.0,575000.0,575000.0
lee-m101,Mark Lee,San Diego Padres,PADRS,3,8,6,14,1980,1989,9,23.83,6.58,-17.25,2167,688,-1479,6899,2080,-4819,2009.0,1127.0,-882.0,0.0,0.0,0.0
lee-m102,Mike Lee,Cleveland Indians,INDINS,1,3,1,4,1961,1962,1,0.0,0.7,0.7,3,41,38,3,74,71,0.0,0.0,0.0,0.0,0.0,0.0
lee-t002,Travis Lee,Arizona Diamondbacks,DBACKS,5,14,12,26,2000,2008,8,42.79,24.27,-18.52,2947,854,-2093,6888,689,-6199,9063.0,3504.0,-5559.0,23673667.0,11709000.0,-11964667.0
lee-t101,Thornton Lee,Cleveland Indians,INDINS,1,1,1,2,1936,1939,3,30.28,-1.03,-31.31,523,118,-405,732,125,-607,5664.0,922.0,-4742.0,5000.0,0.0,-5000.0
lee-z001,Zach Lee,Los Angeles Dodgers,DOGRS,1,1,1,2,2016,2021,5,0.0,14.83,14.83,0,657,657,0,2444,2444,0.0,0.0,0.0,0.0,0.0,0.0
lefeb101,Bill LeFebvre,Minneapolis,Minneapolis,1,1,1,2,1943,1943,0,-0.19,0.0,0.19,97,0,-97,90,0,-90,306.0,0.0,-306.0,0.0,0.0,0.0
lefej001,Joe Lefebvre,New York Yankees,YANKS,6,13,11,24,1981,1992,11,27.03,19.65,-7.38,2401,1053,-1348,5956,3510,-2446,5438.0,699.0,-4739.0,913333.0,1745000.0,831667.0
lefej001,Joe Lefebvre,San Diego Padres,PADRS,1,1,1,2,1983,1984,1,1.67,0.31,-1.36,167,120,-47,503,12,-491,0.0,251.0,251.0,0.0,300000.0,300000.0
leffc001,Craig Lefferts,Chicago Cubs,CUBS,1,3,1,4,1983,1989,6,15.56,10.82,-4.74,1534,321,-1213,2801,249,-2552,1977.0,2213.0,236.0,0.0,0.0,0.0
leffc001,Craig Lefferts,San Diego Padres,PADRS,4,8,8,16,1987,1991,4,23.07,10.95,-12.12,1220,1067,-153,3009,1254,-1755,1633.0,2625.0,992.0,3883333.0,1525000.0,-2358333.0
leffc001,Craig Lefferts,San Diego Padres,PADRS,7,16,18,34,1992,2006,14,12.48,39.05,26.57,2718,3613,895,9058,12864,3806,811.0,1324.0,513.0,15049167.0,22494000.0,7444833.0
leflr101,Ron LeFlore,Detroit Tigers,TIGRS,2,3,2,5,1979,1986,7,0.5,12.31,11.81,197,727,530,605,2558,1953,218.0,792.0,574.0,0.0,0.0,0.0
leflw101,Wade Lefler,Washington Senators,TWINS,4,11,5,16,1924,1941,17,16.54,44.06,27.52,920,1674,754,2170,6771,4601,3390.0,1035.0,-2355.0,27200.0,6000.0,-21200.0
legel101,Lou Legett,Chicago Cubs,CUBS,1,6,1,7,1928,1932,4,4.13,16.12,11.99,1036,317,-719,2232,1321,-911,4216.0,0.0,-4216.0,13000.0,30600.0,17600.0
lehmk101,Ken Lehman,Philadelphia Phillies,PHILS,1,2,1,3,1962,1962,0,0.0,-1.42,-1.42,19,65,46,19,111,92,0.0,0.0,0.0,0.0,0.0,0.0
lehnp101,Paul Lehner,St.Louis Browns,ORLS,1,2,5,7,1949,1951,2,2.11,-0.19,-2.3,207,217,10,887,812,-75,0.0,0.0,0.0,0.0,0.0,0.0
lehnp101,Paul Lehner,Philadelphia Athletics,ATLTCS,35,74,76,150,1951,1976,25,94.84,72.83,-22.01,10296,9253,-1043,24713,28375,3662,12563.0,7417.0,-5146.0,500300.0,639500.0,139200.0
lehnp101,Paul Lehner,Chicago White Sox,WSOX,27,53,44,97,1951,1969,18,83.35,62.63,-20.72,6936,5271,-1665,17430,11733,-5697,13187.0,9922.0,-3265.0,288750.0,292500.0,3750.0
lehrj001,Justin Lehr,Oakland Athletics,ATLTCS,1,2,1,3,2004,2006,2,-0.55,-0.87,-0.32,86,51,-35,10,156,146,151.0,0.0,-151.0,0.0,383333.0,383333.0
leibc001,Charlie Leibrandt,Cincinnati Reds,REDS,1,1,1,2,1983,1983,0,22.85,0.0,-22.85,194,0,-194,0,0,0,3771.0,0.0,-3771.0,0.0,0.0,0.0
leibc001,Charlie Leibrandt,Kansas City Royals,ROYALS,1,2,2,4,1989,1990,1,8.3,0.22,-8.08,256,133,-123,214,512,298,1914.0,0.0,-1914.0,1318000.0,662500.0,-655500.0
leibc001,Charlie Leibrandt,Atlanta Braves,BRAVES,3,4,3,7,1992,1999,7,0.31,0.4,0.09,48,230,182,82,473,391,451.0,0.0,-451.0,3294833.0,185000.0,-3109833.0
leibh101,Hank Leiber,New York Giants,GIANTS,2,7,4,11,1938,1949,11,11.69,46.84,35.15,813,1845,1032,2964,7276,4312,38.0,0.0,-38.0,0.0,0.0,0.0
leibh101,Hank Leiber,Chicago Cubs,CUBS,1,1,1,2,1941,1941,0,-0.08,0.0,0.08,59,0,-59,170,0,-170,27.0,0.0,-27.0,0.0,0.0,0.0
leibn101,Nemo Leibold,Milwaukee,Milwaukee,1,1,1,2,1913,1915,2,2.31,0.0,-2.31,265,0,-265,1014,0,-1014,0.0,0.0,0.0,0.0,2040.0,2040.0
leibn101,Nemo Leibold,Chicago White Sox,WSOX,1,2,1,3,1921,1921,0,-2.09,3.07,5.16,680,108,-572,2600,485,-2115,0.0,0.0,0.0,0.0,0.0,0.0
leicj001,Jon Leicester,Chicago Cubs,CUBS,1,1,1,2,2005,2005,0,0.0,0.0,0.0,0,0,0,0,0,0,0.0,0.0,0.0,300000.0,0.0,-300000.0
leifl101,Lefty Leifield,Pittsburgh Pirates,PIRATS,1,2,2,4,1912,1914,2,9.53,-1.23,-10.76,405,69,-336,1580,172,-1408,276.0,147.0,-129.0,5000.0,7400.0,2400.0
leipd001,Dave Leiper,Oakland Athletics,ATLTCS,1,2,1,3,1987,1989,2,0.04,3.46,3.42,202,69,-133,145,0,-145,296.0,1204.0,908.0,73133.0,605000.0,531867.0
leipd001,Dave Leiper,Oakland Athletics,ATLTCS,1,1,1,2,1995,1995,0,0.28,0.0,-0.28,66,0,-66,1,0,-1,78.0,0.0,-78.0,195000.0,0.0,-195000.0
leita001,Al Leiter,New York Yankees,YANKS,1,1,1,2,1989,1992,3,8.49,9.91,1.42,91,396,305,0,1525,1525,1246.0,0.0,-1246.0,80000.0,1300000.0,1220000.0
leita001,Al Leiter,Florida Marlins,MARLNS,12,16,26,42,1998,2013,15,104.01,35.74,-68.27,4242,2426,-1816,12260,2618,-9642,7601.0,10460.0,2859.0,18420219.0,799800.0,-17620419.0
leitm001,Mark Leiter,New York Yankees,YANKS,1,1,1,2,1991,1992,1,2.42,-0.45,-2.87,102,22,-80,0,59,59,1060.0,0.0,-1060.0,0.0,0.0,0.0
leitm001,Mark Leiter,San Francisco Giants,GIANTS,1,1,2,3,1996,2005,9,0.67,12.18,11.51,24,598,574,29,619,590,209.0,4901.0,4692.0,1850000.0,860000.0,-990000.0
leitm001,Mark Leiter,Philadelphia Phillies,PHILS,2,2,2,4,1998,2002,4,0.11,5.22,5.11,41,221,180,0,220,220,190.0,1853.0,1663.0,2450000.0,634000.0,-1816000.0
leitm001,Mark Leiter,New York Mets,METS,1,1,1,2,2001,2001,0,0.0,0.1,0.1,0,6,6,0,1,1,0.0,26.0,26.0,0.0,0.0,0.0
leitm001,Mark Leiter,Colorado Rockies,ROCKS,3,5,5,10,2001,2002,1,3.56,0.31,-3.25,524,189,-335,63,5,-58,907.0,301.0,-606.0,0.0,0.0,0.0
lejaf101,Frank Leja,New York Yankees,YANKS,1,1,1,2,1961,1961,0,0.0,0.0,0.0,0,0,0,0,0,0,0.0,0.0,0.0,0.0,0.0,0.0
lejaf101,Frank Leja,Los Angeles Angels,ANGELS,3,3,3,6,1962,1965,3,0.53,0.33,-0.2,78,198,120,8,17,9,193.0,430.0,237.0,0.0,0.0,0.0
lelib101,Bill Lelivelt,Mobile,Mobile,1,1,3,4,1909,1916,7,-0.07,0.0,0.07,10,0,-10,11,0,-11,87.0,0.0,-87.0,0.0,0.0,0.0
lelij101,Jack Lelivelt,Rochester,Rochester,1,1,2,3,1912,1913,1,1.09,0.0,-1.09,54,0,-54,184,0,-184,0.0,0.0,0.0,0.0,0.0,0.0
lelij101,Jack Lelivelt,New York Yankees,YANKS,5,13,8,21,1913,1946,33,28.8,113.37,84.57,1052,3692,2640,1402,9991,8589,7730.0,15194.0,7464.0,42500.0,38450.0,-4050.0
lelij101,Jack Lelivelt,Washington Senators,TWINS,5,11,10,21,1911,1926,15,13.21,49.63,36.42,1111,2437,1326,3734,9513,5779,894.0,3052.0,2158.0,21400.0,11500.0,-9900.0
lemad001,DJ LeMahieu,Chicago Cubs,CUBS,1,2,2,4,2011,2013,2,17.66,0.03,-17.63,1081,55,-1026,4267,202,-4065,0.0,0.0,0.0,440000.0,2287500.0,1847500.0
lemad101,Dave Lemanczyk,Toronto Blue Jays,BJAYS,1,1,1,2,1980,1982,2,0.01,-0.15,-0.16,21,26,5,0,0,0,200.0,139.0,-61.0,0.0,0.0,0.0
lemad102,Denny Lemaster,Atlanta Braves,BRAVES,1,2,2,4,1967,1974,7,20.12,0.7,-19.42,938,637,-301,2766,2102,-664,2072.0,0.0,-2072.0,0.0,0.0,0.0
lemad103,Dick LeMay,San Francisco Giants,GIANTS,1,2,1,3,1962,1964,2,0.0,-0.41,-0.41,0,54,54,0,153,153,0.0,0.0,0.0,0.0,0.0,0.0
lemad103,Dick LeMay,Houston Astros,ASTROS,3,7,4,11,1963,1965,2,1.38,1.37,-0.01,248,133,-115,214,502,288,382.0,0.0,-382.0,0.0,0.0,0.0
lemad103,Dick LeMay,Chicago Cubs,CUBS,1,1,1,2,1964,1964,0,0.0,0.17,0.17,0,30,30,0,16,16,0.0,54.0,54.0,0.0,0.0,0.0
lemaj001,Johnnie LeMaster,San Francisco Giants,GIANTS,1,1,2,3,1985,1986,1,-0.5,-0.96,-0.46,11,109,98,21,117,96,0.0,66.0,66.0,500000.0,0.0,-500000.0
lemaj001,Johnnie LeMaster,Cleveland Indians,INDINS,2,2,3,5,1985,1991,6,-2.11,1.58,3.69,123,251,128,65,245,180,377.0,1475.0,1098.0,0.0,0.0,0.0
lemoc001,Chet Lemon,Oakland Athletics,ATLTCS,2,3,3,6,1975,1977,2,29.94,3.7,-26.24,1323,136,-1187,3295,237,-3058,1993.0,795.0,-1198.0,0.0,0.0,0.0
lemoc001,Chet Lemon,Chicago White Sox,WSOX,1,1,1,2,1981,1982,1,30.69,2.03,-28.66,1203,160,-1043,4676,679,-3997,0.0,0.0,0.0,0.0,600000.0,600000.0
lemod101,Dave Lemonds,Chicago Cubs,CUBS,1,3,2,5,1970,1973,3,1.15,0.0,-1.15,69,0,-69,29,0,-29,290.0,0.0,-290.0,0.0,0.0,0.0
lemom101,Mark Lemongello,Detroit Tigers,TIGRS,1,4,3,7,1975,1979,4,4.11,5.38,1.27,431,290,-141,467,862,395,1859.0,1144.0,-715.0,16500.0,0.0,-16500.0
lemom101,Mark Lemongello,Houston Astros,ASTROS,1,3,1,4,1978,1989,11,-3.72,7.9,11.62,160,965,805,206,3318,3112,249.0,0.0,-249.0,22500.0,0.0,-22500.0
lenhd101,Don Lenhardt,St.Louis Browns,ORLS,19,46,45,91,1951,1988,37,52.85,138.19,85.34,4103,8075,3972,7856,22495,14639,14591.0,15253.0,662.0,829333.0,135900.0,-693433.0
lenhd101,Don Lenhardt,Chicago White Sox,WSOX,26,50,43,93,1951,1969,18,84.01,61.56,-22.45,6907,5207,-1700,17328,11506,-5822,13187.0,9922.0,-3265.0,288750.0,292500.0,3750.0
lenhd101,Don Lenhardt,Boston Red Sox,RSOX,2,6,6,12,1952,1956,4,8.2,10.1,1.9,1335,867,-468,4777,3045,-1732,507.0,401.0,-106.0,80000.0,40000.0,-40000.0
lenhd101,Don Lenhardt,Detroit Tigers,TIGRS,6,16,16,32,1952,1961,9,19.6,10.08,-9.52,1436,1371,-65,2274,3811,1537,4378.0,2214.0,-2164.0,23200.0,36000.0,12800.0
lennb102,Bob Lennon,New York Giants,GIANTS,3,5,5,10,1957,1961,4,26.85,7.67,-19.18,1312,551,-761,4817,1078,-3739,197.0,1899.0,1702.0,0.0,0.0,0.0
lentj101,Jim Lentine,St. Louis Cardinals,CARDS,1,1,2,3,1980,1983,3,0.54,1.37,0.83,67,153,86,195,89,-106,0.0,831.0,831.0,0.0,0.0,0.0
lentj101,Jim Lentine,Cleveland Indians,INDINS,2,3,2,5,1981,1988,7,-0.63,0.93,1.56,71,387,316,116,855,739,0.0,0.0,0.0,190000.0,0.0,-190000.0
leond003,Dominic Leone,Seattle Mariners,MARNRS,3,7,4,11,2015,2017,2,4.57,3.33,-1.24,655,244,-411,2424,508,-1916,92.0,403.0,311.0,9532900.0,9014000.0,-518900.0
leond003,Dominic Leone,Toronto Blue Jays,BJAYS,1,2,1,3,2018,2018,0,-0.49,2.45,2.94,137,124,-13,0,462,462,194.0,0.0,-194.0,0.0,0.0,0.0
leond101,Dave Leonhard,Baltimore Orioles,ORLS,1,1,1,2,1973,1973,0,0.0,0.0,0.0,0,0,0,0,0,0,0.0,0.0,0.0,0.0,0.0,0.0
leond102,Dutch Leonard,Boston Red Sox,RSOX,4,11,11,22,1918,1925,7,12.28,-1.18,-13.46,1743,839,-904,6150,3067,-3083,700.0,265.0,-435.0,3300.0,12700.0,9400.0
leond102,Dutch Leonard,Detroit Tigers,TIGRS,2,6,2,8,1925,1928,3,0.0,1.07,1.07,0,324,324,0,1271,1271,0.0,0.0,0.0,0.0,30000.0,30000.0
leond103,Dutch Leonard,Brooklyn Dodgers,DOGRS,1,3,1,4,1936,1938,2,0.05,-0.59,-0.64,177,153,-24,491,535,44,0.0,3.0,3.0,0.0,0.0,0.0
leond103,Dutch Leonard,Philadelphia Phillies,PHILS,1,2,2,4,1948,1954,6,13.76,7.72,-6.04,587,642,55,227,2516,2289,2431.0,597.0,-1834.0,0.0,16000.0,16000.0
leone102,Eddie Leon,Cleveland Indians,INDINS,5,8,6,14,1972,1976,4,-4.65,5.11,9.76,465,173,-292,963,371,-592,1098.0,1299.0,201.0,90500.0,59000.0,-31500.0
leone102,Eddie Leon,Chicago White Sox,WSOX,1,1,1,2,1974,1976,2,0.0,0.79,0.79,1,29,28,0,0,0,0.0,142.0,142.0,29000.0,0.0,-29000.0
leonj001,Jeffrey Leonard,Los Angeles Dodgers,DOGRS,1,2,2,4,1978,1981,3,4.6,3.69,-0.91,609,283,-326,1828,907,-921,0.0,0.0,0.0,0.0,0.0,0.0
leonj001,Jeffrey Leonard,Houston Astros,ASTROS,1,2,1,3,1981,1982,1,11.7,-0.13,-11.83,1042,26,-1016,3644,52,-3592,0.0,0.0,0.0,0.0,0.0,0.0
leonj001,Jeffrey Leonard,San Francisco Giants,GIANTS,5,7,11,18,1988,1998,10,9.31,9.81,0.5,513,1045,532,1166,3331,2165,1958.0,96.0,-1862.0,7402778.0,4466667.0,-2936111.0
leonj002,Jose Leon,St. Louis Cardinals,CARDS,1,1,2,3,2000,2000,0,-0.66,2.14,2.8,88,51,-37,221,197,-24,0.0,0.0,0.0,0.0,6000000.0,6000000.0
leonj101,Joe Leonard,Cleveland Indians,INDINS,1,2,2,4,1916,1916,0,1.57,0.61,-0.96,293,50,-243,1105,56,-1049,0.0,182.0,182.0,0.0,5000.0,5000.0
leonm001,Mark Leonard,San Francisco Giants,GIANTS,1,1,1,2,1993,1996,3,-0.25,1.3,1.55,10,281,271,21,810,789,0.0,0.0,0.0,0.0,0.0,0.0
leons001,Sandy Leon,Boston Red Sox,RSOX,1,1,1,2,2019,2019,0,-0.16,0.0,0.16,25,0,-25,81,0,-81,0.0,0.0,0.0,2475000.0,0.0,-2475000.0
lepct101,Ted Lepcio,Boston Red Sox,RSOX,2,3,2,5,1959,1959,0,7.37,-0.54,-7.91,476,29,-447,344,14,-330,1329.0,127.0,-1202.0,11000.0,0.0,-11000.0
lepct101,Ted Lepcio,Detroit Tigers,TIGRS,5,9,7,16,1959,1967,8,4.29,0.05,-4.24,724,813,89,2270,1691,-579,122.0,890.0,768.0,38000.0,37000.0,-1000.0
leppd101,Don Leppert,Dallas,Dallas,1,1,1,2,1960,1961,1,0.65,0.0,-0.65,67,0,-67,216,0,-216,0.0,0.0,0.0,0.0,0.0,0.0
leppd101,Don Leppert,Pittsburgh Pirates,PIRATS,1,1,2,3,1962,1962,0,-0.33,0.0,0.33,123,0,-123,369,0,-369,0.0,0.0,0.0,0.0,0.0,0.0
leppd102,Don Leppert,New York Yankees,YANKS,12,33,27,60,1954,1970,16,40.55,76.98,36.43,5201,4368,-833,16466,10777,-5689,3212.0,10751.0,7539.0,302500.0,109500.0,-193000.0
lercr001,Randy Lerch,Philadelphia Phillies,PHILS,3,3,3,6,1981,1983,2,-1.26,0.49,1.75,48,118,70,12,263,251,658.0,0.0,-658.0,160000.0,0.0,-160000.0
leriw101,Walt Lerian,NewHaven,NewHaven,1,1,3,4,1928,1928,0,1.99,0.0,-1.99,201,0,-201,625,0,-625,0.0,0.0,0.0,0.0,0.0,0.0
lersb101,Barry Lersch,Philadelphia Phillies,PHILS,1,2,1,3,1973,1977,4,-0.85,1.42,2.27,197,250,53,576,78,-498,0.0,1037.0,1037.0,0.0,0.0,0.0
leskc001,Curt Leskanic,Cleveland Indians,INDINS,1,2,1,3,1992,1995,3,-0.31,3.9,4.21,10,487,477,0,1779,1779,106.0,0.0,-106.0,0.0,0.0,0.0
leskc001,Curt Leskanic,Colorado Rockies,ROCKS,3,3,4,7,1999,2006,7,5.07,3.08,-1.99,614,513,-101,88,616,528,740.0,256.0,-484.0,1050000.0,800000.0,-250000.0
leskc001,Curt Leskanic,Milwaukee Brewers,BREWRS,2,2,3,5,2003,2006,3,0.53,0.38,-0.15,46,223,177,0,83,83,125.0,891.0,766.0,4042000.0,3400000.0,-642000.0
leslr101,Roy Leslie,Philadelphia Phillies,PHILS,4,9,8,17,1922,1936,14,25.37,3.27,-22.1,1352,2052,700,5364,8721,3357,77.0,0.0,-77.0,43100.0,12250.0,-30850.0
leslr101,Roy Leslie,NewOrleans,NewOrleans,1,1,2,3,1921,1922,1,-2.16,0.0,2.16,141,0,-141,567,0,-567,0.0,0.0,0.0,0.0,0.0,0.0
lesls101,Sam Leslie,New York Giants,GIANTS,1,1,2,3,1933,1935,2,7.41,2.63,-4.78,384,203,-181,1597,478,-1119,0.0,188.0,188.0,0.0,0.0,0.0
lestj001,Jon Lester,Boston Red Sox,RSOX,2,6,3,9,2014,2019,5,10.72,10.88,0.16,412,221,-191,504,237,-267,1024.0,2892.0,1868.0,15500000.0,8500000.0,-7000000.0
lestj001,Jon Lester,Washington Nationals,NATEX,1,1,1,2,2021,2021,0,0.07,1.31,1.24,23,45,22,22,206,184,198.0,0.0,-198.0,0.0,0.0,0.0
levej101,Jim Levey,St.Louis Browns,ORLS,14,27,34,61,1933,1952,19,55.71,57.94,2.23,2756,6888,4132,8050,21355,13305,6789.0,12669.0,5880.0,138000.0,130100.0,-7900.0
levia001,Al Levine,Chicago White Sox,WSOX,1,2,1,3,1997,1998,1,0.48,0.0,-0.48,32,0,-32,0,0,0,174.0,0.0,-174.0,157500.0,200000.0,42500.0
levij001,Jesse Levis,Cleveland Indians,INDINS,1,1,2,3,1996,1999,3,1.72,0.0,-1.72,237,0,-237,590,0,-590,0.0,0.0,0.0,0.0,0.0,0.0
levye101,Ed Levy,New York Yankees,YANKS,1,1,2,3,1940,1940,0,0.0,0.0,0.0,1,0,-1,1,0,-1,0.0,0.0,0.0,0.0,0.0,0.0
levye101,Ed Levy,New York Yankees,YANKS,1,3,1,4,1943,1947,4,0.0,11.41,11.41,0,568,568,0,2373,2373,0.0,0.0,0.0,0.0,0.0,0.0
levye101,Ed Levy,New York Yankees,YANKS,1,2,1,3,1944,1944,0,0.0,2.33,2.33,0,85,85,0,368,368,0.0,0.0,0.0,0.0,0.0,0.0
levye101,Ed Levy,Milwaukee,Milwaukee,1,1,3,4,1944,1944,0,0.0,0.0,0.0,0,0,0,0,0,0,0.0,0.0,0.0,0.0,0.0,0.0
lewad101,Dennis Lewallyn,Los Angeles Dodgers,DOGRS,1,2,1,3,1980,1981,1,-0.26,-0.19,0.07,4,39,35,0,48,48,17.0,0.0,-17.0,0.0,0.0,0.0
lewib101,Bill Lewis,Boston Braves,BRAVES,2,2,3,5,1936,1940,4,3.89,9.19,5.3,101,210,109,121,334,213,909.0,2042.0,1133.0,12500.0,4500.0,-8000.0
lewib102,Bert Lewis,Richmond,Richmond,1,1,1,2,1924,1924,0,0.1,0.0,-0.1,24,0,-24,5,0,-5,54.0,0.0,-54.0,0.0,0.0,0.0
lewid001,Darren Lewis,Oakland Athletics,ATLTCS,1,2,1,3,1990,1991,1,4.57,0.41,-4.16,496,108,-388,2054,321,-1733,0.0,0.0,0.0,100000.0,675000.0,575000.0
lewid001,Darren Lewis,San Francisco Giants,GIANTS,3,5,8,13,1995,1998,3,9.99,0.74,-9.25,311,256,-55,447,555,108,1958.0,96.0,-1862.0,5827778.0,4116667.0,-1711111.0
lewid001,Darren Lewis,Chicago White Sox,WSOX,1,1,1,2,1997,1997,0,0.61,-0.06,-0.67,26,9,-17,85,11,-74,0.0,0.0,0.0,1325000.0,240000.0,-1085000.0
lewid001,Darren Lewis,Chicago Cubs,CUBS,2,3,3,6,2002,2004,2,-0.13,1.72,1.85,32,351,319,68,1223,1155,0.0,0.0,0.0,7000000.0,12098000.0,5098000.0
lewid101,Duffy Lewis,Boston Red Sox,RSOX,4,11,11,22,1918,1925,7,12.28,-1.18,-13.46,1743,839,-904,6150,3067,-3083,700.0,265.0,-435.0,3300.0,12700.0,9400.0
lewid101,Duffy Lewis,New York Yankees,YANKS,1,2,1,3,1920,1920,0,16.01,0.0,-16.01,317,0,-317,510,0,-510,3052.0,0.0,-3052.0,11500.0,5400.0,-6100.0
lewij001,Jim Lewis,Seattle Mariners,MARNRS,1,2,4,6,1979,1986,7,0.3,12.28,11.98,84,358,274,373,605,232,2.0,2834.0,2832.0,0.0,0.0,0.0
lewij002,Jim Lewis,San Diego Padres,PADRS,1,2,2,4,1992,1993,1,0.0,0.0,0.0,0,0,0,0,0,0,0.0,0.0,0.0,0.0,0.0,0.0
lewij102,Johnny Lewis,St. Louis Cardinals,CARDS,1,2,2,4,1964,1964,0,0.92,0.0,-0.92,326,0,-326,777,0,-777,213.0,0.0,-213.0,0.0,0.0,0.0
lewim001,Mark Lewis,Cleveland Indians,INDINS,1,1,1,2,1994,1994,0,0.21,0.0,-0.21,180,0,-180,398,0,-398,0.0,0.0,0.0,182500.0,0.0,-182500.0
lewim001,Mark Lewis,Cincinnati Reds,REDS,3,5,4,9,1995,1998,3,1.13,-0.21,-1.34,524,176,-348,786,483,-303,1638.0,269.0,-1369.0,299000.0,2300667.0,2001667.0
lewim001,Mark Lewis,Detroit Tigers,TIGRS,1,1,1,2,1996,1996,0,-0.25,0.0,0.25,118,0,-118,372,0,-372,0.0,0.0,0.0,670000.0,0.0,-670000.0
lewir001,Richie Lewis,Montreal Expos,NATEX,1,1,1,2,1991,1991,0,-0.69,0.0,0.69,4,0,-4,0,0,0,34.0,0.0,-34.0,0.0,0.0,0.0
lewir001,Richie Lewis,San Diego Padres,PADRS,2,4,4,8,1996,1998,2,1.67,-1.26,-2.93,549,225,-324,1460,118,-1342,1084.0,637.0,-447.0,0.0,0.0,0.0
ley-t101,Terry Ley,New York Yankees,YANKS,1,2,1,3,1971,1973,2,0.0,0.67,0.67,0,101,101,0,310,310,0.0,0.0,0.0,4800.0,23000.0,18200.0
ley-t101,Terry Ley,Texas Rangers,RNGRS,15,34,23,57,1971,1988,17,48.57,49.18,0.61,3015,3170,155,9911,9907,-4,4375.0,6620.0,2245.0,528000.0,301000.0,-227000.0
ley-t101,Terry Ley,Cleveland Indians,INDINS,1,2,1,3,1974,1974,0,1.74,-1.01,-2.75,126,11,-115,121,0,-121,1043.0,131.0,-912.0,0.0,0.0,0.0
leybd001,Domingo Leyba,Detroit Tigers,TIGRS,2,3,3,6,2014,2021,7,9.39,0.09,-9.3,428,326,-102,315,226,-89,2587.0,942.0,-1645.0,4000000.0,0.0,-4000000.0
leyrj001,Jim Leyritz,New York Yankees,YANKS,1,1,2,3,1996,1996,0,2.0,0.0,-2.0,84,0,-84,342,0,-342,0.0,0.0,0.0,1470000.0,0.0,-1470000.0
leyrj001,Jim Leyritz,Anaheim Angels,ANGELS,1,2,1,3,1997,2000,3,0.66,4.28,3.62,38,78,40,115,11,-104,0.0,1167.0,1167.0,1916972.0,4850000.0,2933028.0
leyrj001,Jim Leyritz,Texas Rangers,RNGRS,1,2,3,5,1997,1999,2,2.88,7.0,4.12,229,110,-119,721,120,-601,0.0,1253.0,1253.0,225000.0,1963500.0,1738500.0
leyrj001,Jim Leyritz,Boston Red Sox,RSOX,2,3,4,7,1998,1999,1,0.18,0.39,0.21,112,44,-68,326,16,-310,0.0,139.0,139.0,2000000.0,0.0,-2000000.0
leyrj001,Jim Leyritz,San Diego Padres,PADRS,3,5,5,10,1999,2002,3,3.84,0.64,-3.2,428,277,-151,1432,508,-924,0.0,215.0,215.0,3650000.0,1850000.0,-1800000.0
leyrj001,Jim Leyritz,New York Yankees,YANKS,1,1,2,3,2000,2000,0,-0.61,0.24,0.85,41,73,32,68,191,123,0.0,0.0,0.0,1000000.0,3500000.0,2500000.0
lezcs001,Sixto Lezcano,Milwaukee Brewers,BREWRS,2,5,6,11,1980,1986,6,6.59,20.26,13.67,970,997,27,2159,3010,851,2112.0,2376.0,264.0,0.0,0.0,0.0
lezcs001,Sixto Lezcano,St. Louis Cardinals,CARDS,1,3,3,6,1981,1992,11,19.37,59.81,40.44,1893,1695,-198,5833,6828,995,883.0,553.0,-330.0,793333.0,0.0,-793333.0
lezcs001,Sixto Lezcano,San Diego Padres,PADRS,4,7,8,15,1983,1992,9,0.01,11.95,11.94,244,925,681,351,1136,785,610.0,1770.0,1160.0,375000.0,2175000.0,1800000.0
libea001,Adam Liberatore,Tampa Bay Devil Rays,RAYS,1,2,2,4,2014,2015,1,0.98,0.23,-0.75,298,5,-293,4,0,-4,353.0,17.0,-336.0,3000000.0,501000.0,-2499000.0
librf101,Frankie Libran,Chicago Cubs,CUBS,3,6,4,10,1969,1974,5,4.19,2.65,-1.54,1200,512,-688,1393,950,-443,2550.0,898.0,-1652.0,19000.0,24000.0,5000.0
liddd001,Dave Liddell,Chicago Cubs,CUBS,1,2,1,3,1986,1987,1,0.08,1.13,1.05,1,162,161,1,51,50,0.0,630.0,630.0,0.0,530000.0,530000.0
liddd101,Don Liddle,Milwaukee Braves,BRAVES,2,8,3,11,1954,1960,6,39.41,8.38,-31.03,1145,621,-524,1887,2335,448,6059.0,0.0,-6059.0,0.0,42000.0,42000.0
liddd101,Don Liddle,New York Giants,GIANTS,11,22,22,44,1956,1968,12,37.88,26.25,-11.63,3162,2563,-599,10326,4535,-5791,1384.0,7539.0,6155.0,95000.0,109500.0,14500.0
lidgb001,Brad Lidge,Houston Astros,ASTROS,5,17,11,28,2007,2020,13,26.64,22.25,-4.39,2124,1522,-602,3444,4092,648,4062.0,2080.0,-1982.0,15247800.0,20847915.0,5600115.0
lidlc001,Cory Lidle,Milwaukee Brewers,BREWRS,1,1,1,2,1996,1997,1,0.35,-0.45,-0.8,105,44,-61,6,68,62,245.0,0.0,-245.0,0.0,0.0,0.0
lidlc001,Cory Lidle,Tampa Bay Devil Rays,RAYS,1,2,1,3,2001,2003,2,6.9,3.18,-3.72,63,345,282,4,1405,1401,1140.0,0.0,-1140.0,0.0,0.0,0.0
lidlc001,Cory Lidle,Oakland Athletics,ATLTCS,1,1,2,3,2002,2006,4,0.58,0.04,-0.54,33,8,-25,6,26,20,578.0,0.0,-578.0,2550000.0,0.0,-2550000.0
lidlc001,Cory Lidle,Cincinnati Reds,REDS,3,4,6,10,2004,2007,3,1.18,-0.86,-2.04,141,141,0,181,284,103,1117.0,428.0,-689.0,4750000.0,0.0,-4750000.0
lidlc001,Cory Lidle,Philadelphia Phillies,PHILS,1,2,4,6,2006,2009,3,7.5,0.06,-7.44,382,46,-336,1631,0,-1631,136.0,38.0,-98.0,16900000.0,0.0,-16900000.0
liebg101,Glenn Liebhardt,Cleveland Indians,INDINS,1,1,2,3,1909,1910,1,0.0,0.53,0.53,0,106,106,0,302,302,0.0,383.0,383.0,0.0,0.0,0.0
liebj001,Jon Lieber,Kansas City Royals,ROYALS,1,2,1,3,1993,1994,1,4.73,-0.04,-4.77,577,61,-516,244,0,-244,2577.0,229.0,-2348.0,0.0,1165000.0,1165000.0
liebj001,Jon Lieber,Pittsburgh Pirates,PIRATS,2,2,2,4,1998,2000,2,12.51,-1.66,-14.17,328,202,-126,382,524,142,2623.0,0.0,-2623.0,1740000.0,380000.0,-1360000.0
liefj001,Jeff Liefer,Chicago White Sox,WSOX,1,4,2,6,2003,2003,0,-4.18,5.0,9.18,270,36,-234,107,7,-100,449.0,726.0,277.0,0.0,0.0,0.0
liesf101,Fred Liese,Chicago Cubs,CUBS,1,1,1,2,1909,1909,0,0.0,-0.27,-0.27,0,13,13,0,28,28,0.0,0.0,0.0,0.0,0.0,0.0
liesf101,Fred Liese,Chicago Cubs,CUBS,1,2,1,3,1910,1910,0,0.0,0.76,0.76,5,76,71,4,210,206,0.0,0.0,0.0,0.0,0.0,0.0
lighp001,Pat Light,Boston Red Sox,RSOX,1,1,1,2,2016,2017,1,-0.48,0.22,0.7,16,72,56,0,0,0,42.0,169.0,127.0,0.0,0.0,0.0
lighp001,Pat Light,Minnesota Twins,TWINS,1,1,1,2,2017,2017,0,0.0,0.0,0.0,0,0,0,0,0,0,0.0,0.0,0.0,0.0,0.0,0.0
lillb001,Brent Lillibridge,Pittsburgh Pirates,PIRATS,2,3,4,7,2007,2013,6,1.29,2.54,1.25,298,397,99,105,1590,1485,375.0,0.0,-375.0,7050000.0,0.0,-7050000.0
lillb001,Brent Lillibridge,Atlanta Braves,BRAVES,5,12,14,26,2008,2014,6,17.06,9.0,-8.06,2364,1258,-1106,2896,3420,524,3035.0,1593.0,-1442.0,26080000.0,24455000.0,-1625000.0
lillb001,Brent Lillibridge,Chicago White Sox,WSOX,1,2,2,4,2012,2012,0,-0.96,1.4,2.36,12,80,68,16,344,328,17.0,0.0,-17.0,0.0,0.0,0.0
lillb001,Brent Lillibridge,Boston Red Sox,RSOX,1,1,1,2,2012,2013,1,-0.07,-0.13,-0.06,43,7,-36,123,0,-123,0.0,34.0,34.0,500000.0,0.0,-500000.0
lillb101,Bob Lillis,Los Angeles Dodgers,DOGRS,1,2,1,3,1961,1963,2,-1.3,1.55,2.85,292,144,-148,701,421,-280,0.0,0.0,0.0,0.0,0.0,0.0
lilld001,Derek Lilliquist,Atlanta Braves,BRAVES,1,1,1,2,1990,1991,1,-0.08,0.02,0.1,44,66,22,25,6,-19,224.0,157.0,-67.0,135000.0,400000.0,265000.0
lillg101,Gene Lillard,Chicago Cubs,CUBS,2,7,2,9,1936,1947,11,6.07,33.87,27.8,546,772,226,1567,1415,-152,1708.0,5741.0,4033.0,9500.0,8000.0,-1500.0
lillg101,Gene Lillard,Chicago Cubs,CUBS,2,4,3,7,1939,1947,8,5.18,0.94,-4.24,213,106,-107,268,37,-231,1599.0,395.0,-1204.0,7800.0,2400.0,-5400.0
lillt001,Ted Lilly,Los Angeles Dodgers,DOGRS,4,8,8,16,1998,2006,8,3.75,12.46,8.71,1576,982,-594,3524,3610,86,1585.0,233.0,-1352.0,12365000.0,8350000.0,-4015000.0
lillt001,Ted Lilly,Montreal Expos,NATEX,1,3,1,4,2000,2001,1,1.49,-0.32,-1.81,57,27,-30,6,21,15,645.0,214.0,-431.0,0.0,0.0,0.0
lillt001,Ted Lilly,New York Yankees,YANKS,2,7,2,9,2002,2005,3,6.71,3.6,-3.11,546,85,-461,184,2,-182,2652.0,1328.0,-1324.0,4387150.0,15714286.0,11327136.0
lillt001,Ted Lilly,Oakland Athletics,ATLTCS,1,1,1,2,2003,2007,4,5.93,2.48,-3.45,96,293,197,10,1048,1038,1516.0,0.0,-1516.0,335000.0,0.0,-335000.0
lillt001,Ted Lilly,Chicago Cubs,CUBS,1,3,3,6,2010,2012,2,3.28,-0.26,-3.54,168,192,24,342,477,135,1023.0,0.0,-1023.0,15600000.0,410000.0,-15190000.0
limaj001,Jose Lima,Detroit Tigers,TIGRS,5,12,14,26,1996,2010,14,13.89,24.32,10.43,4127,1434,-2693,10052,2196,-7856,4562.0,6757.0,2195.0,11529000.0,4780000.0,-6749000.0
limaj001,Jose Lima,Houston Astros,ASTROS,1,1,1,2,2001,2001,0,-0.43,0.16,0.59,39,36,-3,1,30,29,543.0,260.0,-283.0,6250000.0,5300000.0,-950000.0
lincb001,Brad Lincoln,Pittsburgh Pirates,PIRATS,4,5,6,11,2012,2018,6,2.63,4.38,1.75,186,458,272,242,958,716,843.0,1241.0,398.0,9167000.0,0.0,-9167000.0
lincb001,Brad Lincoln,Toronto Blue Jays,BJAYS,3,6,4,10,2013,2015,2,-1.33,0.83,2.16,51,179,128,36,422,386,108.0,94.0,-14.0,510200.0,1561000.0,1050800.0
linda001,Adam Lind,Toronto Blue Jays,BJAYS,1,1,1,2,2014,2018,4,3.6,10.06,6.46,149,131,-18,572,16,-556,0.0,2060.0,2060.0,7000000.0,3325000.0,-3675000.0
linda001,Adam Lind,Milwaukee Brewers,BREWRS,1,1,3,4,2015,2015,0,-0.26,0.0,0.26,126,0,-126,430,0,-430,0.0,0.0,0.0,7500000.0,0.0,-7500000.0
lindb001,Bill Lindsey,New York Yankees,YANKS,2,5,4,9,1986,1992,6,1.11,3.87,2.76,606,1169,563,1878,3720,1842,0.0,0.0,0.0,400873.0,475000.0,74127.0
lindc103,Carl Lindquist,Boston Braves,BRAVES,2,4,3,7,1944,1948,4,-0.05,3.65,3.7,48,381,333,105,1465,1360,0.0,0.0,0.0,0.0,0.0,0.0
lindd001,Doug Lindsey,Philadelphia Phillies,PHILS,1,1,1,2,1993,1993,0,-0.03,0.28,0.31,2,16,14,1,0,-1,0.0,53.0,53.0,0.0,500000.0,500000.0
lindf001,Francisco Lindor,Cleveland Indians,INDINS,1,2,4,6,2021,2021,0,2.19,2.78,0.59,149,209,60,543,798,255,161.0,0.0,-161.0,0.0,0.0,0.0
lindf101,Freddie Lindstrom,New York Giants,GIANTS,6,16,9,25,1932,1949,17,14.14,67.57,53.43,1519,2679,1160,5550,10428,4878,296.0,142.0,-154.0,0.0,10500.0,10500.0
lindf101,Freddie Lindstrom,Pittsburgh Pirates,PIRATS,1,2,3,5,1934,1938,4,22.26,3.72,-18.54,634,346,-288,941,358,-583,4458.0,2252.0,-2206.0,0.0,0.0,0.0
lindj001,Jim Lindeman,St. Louis Cardinals,CARDS,1,2,3,5,1989,1989,0,-0.12,0.0,0.12,13,0,-13,34,0,-34,5.0,0.0,-5.0,0.0,0.0,0.0
lindj002,Jose Lind,Pittsburgh Pirates,PIRATS,1,1,2,3,1992,1994,2,-1.65,-0.61,1.04,250,94,-156,880,7,-873,0.0,219.0,219.0,2000000.0,113500.0,-1886500.0
lindj004,Josh Lindblom,Los Angeles Dodgers,DOGRS,1,3,1,4,2012,2012,0,-1.0,1.11,2.11,86,53,-33,10,235,225,202.0,0.0,-202.0,483000.0,9500000.0,9017000.0
lindj004,Josh Lindblom,Philadelphia Phillies,PHILS,3,6,4,10,2012,2014,2,0.71,-1.18,-1.89,80,130,50,137,512,375,193.0,7.0,-186.0,496000.0,16000000.0,15504000.0
lindj004,Josh Lindblom,Texas Rangers,RNGRS,2,4,3,7,2013,2015,2,1.42,-3.21,-4.63,125,105,-20,314,281,-33,19.0,129.0,110.0,1001100.0,3000000.0,1998900.0
lindj101,Johnny Lindell,St. Louis Cardinals,CARDS,1,1,1,2,1950,1950,0,0.0,0.0,0.0,0,0,0,0,0,0,0.0,0.0,0.0,0.0,0.0,0.0
lindj102,Jim Lindsey,Cincinnati Reds,REDS,1,3,1,4,1934,1936,2,0.0,1.84,1.84,0,131,131,0,110,110,0.0,910.0,910.0,3000.0,0.0,-3000.0
lindj102,Jim Lindsey,Cleveland Indians,INDINS,1,5,1,6,1922,1935,13,0.0,5.93,5.93,0,850,850,0,2604,2604,0.0,0.0,0.0,0.0,0.0,0.0
lindm001,Matt Lindstrom,New York Mets,METS,2,9,5,14,2006,2010,4,11.2,-1.8,-13.0,974,362,-612,1347,182,-1165,2746.0,356.0,-2390.0,3398000.0,5132000.0,1734000.0
lindm001,Matt Lindstrom,Florida Marlins,MARLNS,1,1,3,4,2009,2009,0,0.25,0.0,-0.25,114,0,-114,0,0,0,160.0,0.0,-160.0,410000.0,0.0,-410000.0
lindm001,Matt Lindstrom,Houston Astros,ASTROS,1,1,2,3,2010,2010,0,1.04,0.0,-1.04,124,0,-124,0,0,0,162.0,0.0,-162.0,1625000.0,0.0,-1625000.0
lindm001,Matt Lindstrom,Colorado Rockies,ROCKS,2,3,2,5,2012,2012,0,6.7,-1.0,-7.7,199,47,-152,28,33,5,2842.0,306.0,-2536.0,8200000.0,5600000.0,-2600000.0
lindm001,Matt Lindstrom,Baltimore Orioles,ORLS,1,2,2,4,2012,2012,0,0.25,0.76,0.51,24,7,-17,0,0,0,32.0,134.0,102.0,3600000.0,6000000.0,2400000.0
lindp101,Paul Lindblad,Oakland Athletics,ATLTCS,5,12,6,18,1971,1976,5,13.14,12.72,-0.42,2868,1140,-1728,6939,2992,-3947,2263.0,1076.0,-1187.0,223600.0,363000.0,139400.0
lindp101,Paul Lindblad,Texas Rangers,RNGRS,2,2,3,5,1972,1973,1,3.91,1.38,-2.53,223,82,-141,1,263,262,1247.0,0.0,-1247.0,31000.0,36400.0,5400.0
lindr001,Rod Lindsey,San Diego Padres,PADRS,1,1,1,2,1998,1998,0,0.12,-0.22,-0.34,11,46,35,5,1,-4,0.0,92.0,92.0,0.0,1700000.0,1700000.0
lindv101,Vive Lindaman,Pittsburgh Pirates,PIRATS,1,3,1,4,1905,1910,5,9.35,21.13,11.78,731,320,-411,2264,464,-1800,2702.0,3628.0,926.0,0.0,0.0,0.0
lines001,Scott Linebrink,San Francisco Giants,GIANTS,1,1,1,2,2000,2000,0,0.17,0.32,0.15,96,54,-42,10,0,-10,228.0,76.0,-152.0,0.0,800000.0,800000.0
lines001,Scott Linebrink,San Diego Padres,PADRS,2,3,4,7,2007,2015,8,-1.28,4.08,5.36,259,701,442,1,132,131,301.0,1875.0,1574.0,2150000.0,0.0,-2150000.0
lines001,Scott Linebrink,Chicago White Sox,WSOX,1,2,1,3,2010,2010,0,0.42,0.0,-0.42,126,0,-126,0,0,0,163.0,0.0,-163.0,5000000.0,0.0,-5000000.0
linic001,Cole Liniak,Boston Red Sox,RSOX,1,2,1,3,1999,2001,2,0.54,2.66,2.12,201,119,-82,36,1,-35,221.0,406.0,185.0,1600000.0,5500000.0,3900000.0
linke101,Ed Linke,Washington Senators,TWINS,1,1,1,2,1937,1938,1,-0.56,-0.62,-0.06,42,63,21,12,25,13,119.0,273.0,154.0,4500.0,7500.0,3000.0
linkf101,Fred Link,Columbus,Columbus,1,2,1,3,1909,1909,0,0.53,0.0,-0.53,106,0,-106,302,0,-302,383.0,0.0,-383.0,0.0,0.0,0.0
linkj001,Jon Link,San Diego Padres,PADRS,1,1,1,2,2007,2007,0,0.0,0.03,0.03,0,28,28,0,61,61,0.0,0.0,0.0,0.0,2750000.0,2750000.0
linkj001,Jon Link,Chicago White Sox,WSOX,1,2,1,3,2009,2011,2,-1.22,-0.64,0.58,67,318,251,36,1445,1409,372.0,0.0,-372.0,0.0,10000000.0,10000000.0
lintl101,Larry Lintz,Montreal Expos,NATEX,2,3,3,6,1975,1978,3,0.07,2.86,2.79,87,598,511,159,1574,1415,0.0,0.0,0.0,0.0,0.0,0.0
lintl101,Larry Lintz,St. Louis Cardinals,CARDS,1,1,1,2,1975,1975,0,0.35,0.0,-0.35,109,0,-109,44,0,-44,0.0,0.0,0.0,0.0,0.0,0.0
linzf101,Frank Linzy,San Francisco Giants,GIANTS,1,1,1,2,1970,1973,3,3.11,-0.5,-3.61,194,296,102,11,40,29,362.0,743.0,381.0,0.0,0.0,0.0
linzf101,Frank Linzy,St. Louis Cardinals,CARDS,1,1,1,2,1972,1972,0,-0.57,0.0,0.57,137,0,-137,10,0,-10,421.0,0.0,-421.0,0.0,0.0,0.0
linzf101,Frank Linzy,Milwaukee Brewers,BREWRS,1,1,1,2,1973,1974,1,0.14,0.0,-0.14,44,0,-44,0,0,0,74.0,0.0,-74.0,0.0,0.0,0.0
linzp101,Phil Linz,New York Yankees,YANKS,1,1,1,2,1965,1968,3,-0.68,-0.7,-0.02,63,191,128,92,543,451,0.0,0.0,0.0,20200.0,20000.0,-200.0
linzp101,Phil Linz,Philadelphia Phillies,PHILS,1,1,1,2,1967,1967,0,-1.41,0.01,1.42,102,31,-71,340,45,-295,0.0,0.0,0.0,0.0,19000.0,19000.0
lipoj101,Johnny Lipon,Detroit Tigers,TIGRS,18,41,43,84,1952,1964,12,49.33,53.4,4.07,4601,4657,56,11266,12496,1230,8483.0,9258.0,775.0,157700.0,102900.0,-54800.0
lipoj101,Johnny Lipon,Baltimore Orioles,ORLS,6,12,12,24,1954,1960,6,16.12,9.55,-6.57,902,1031,129,2238,2995,757,2291.0,1208.0,-1083.0,10000.0,0.0,-10000.0
lipoj101,Johnny Lipon,Chicago White Sox,WSOX,4,8,5,13,1954,1961,7,23.88,9.53,-14.35,1231,794,-437,3827,2335,-1492,2136.0,479.0,-1657.0,62000.0,82500.0,20500.0
lipsb101,Bob Lipski,St. Louis Cardinals,CARDS,1,2,1,3,1965,1965,0,0.0,0.0,0.0,0,0,0,0,0,0,0.0,0.0,0.0,0.0,0.0,0.0
liraf001,Felipe Lira,Detroit Tigers,TIGRS,6,18,12,30,1997,2002,5,3.14,14.72,11.58,1662,1186,-476,4060,2874,-1186,1346.0,2263.0,917.0,9860000.0,4940000.0,-4920000.0
lirif001,Francisco Liriano,San Francisco Giants,GIANTS,1,3,2,5,2003,2004,1,27.51,0.25,-27.26,760,131,-629,32,510,478,4915.0,0.0,-4915.0,300000.0,365000.0,65000.0
lirif001,Francisco Liriano,Minnesota Twins,TWINS,2,2,5,7,2012,2018,6,5.77,5.04,-0.73,376,686,310,1544,2423,879,170.0,173.0,3.0,10350000.0,480000.0,-9870000.0
lirif001,Francisco Liriano,Pittsburgh Pirates,PIRATS,1,3,1,4,2016,2017,1,1.56,-0.04,-1.6,169,12,-157,400,1,-399,396.0,34.0,-362.0,0.0,2200000.0,2200000.0
lirif001,Francisco Liriano,Toronto Blue Jays,BJAYS,1,1,2,3,2017,2017,0,-0.16,0.88,1.04,21,38,17,0,129,129,43.0,0.0,-43.0,13666667.0,5500000.0,-8166667.0
lirin001,Nelson Liriano,Toronto Blue Jays,BJAYS,1,2,1,3,1990,1990,0,0.48,-0.21,-0.69,536,13,-523,1913,0,-1913,0.0,64.0,64.0,255000.0,500000.0,245000.0
lirip001,Pedro Liriano,Anaheim Angels,ANGELS,1,3,2,5,2002,2002,0,-0.5,0.27,0.77,52,39,-13,74,76,2,47.0,0.0,-47.0,500000.0,2750000.0,2250000.0
lirir001,Rymer Liriano,San Diego Padres,PADRS,1,1,1,2,2016,2016,0,0.0,0.0,0.0,0,0,0,0,0,0,0.0,0.0,0.0,0.0,0.0,0.0
lis-j101,Joe Lis,Philadelphia Phillies,PHILS,1,3,1,4,1972,1973,1,-1.38,0.91,2.29,154,97,-57,334,364,30,133.0,0.0,-133.0,14500.0,55000.0,40500.0
liseh101,Hod Lisenbee,Washington Senators,TWINS,1,5,1,6,1928,1941,13,14.54,41.49,26.95,801,1492,691,1696,6460,4764,3390.0,0.0,-3390.0,20500.0,6000.0,-14500.0
liseh101,Hod Lisenbee,Memphis,Memphis,2,2,5,7,1926,1940,14,4.5,0.0,-4.5,280,0,-280,708,0,-708,957.0,0.0,-957.0,0.0,7500.0,7500.0
lisir101,Rick Lisi,Texas Rangers,RNGRS,1,1,1,2,1982,1982,0,0.0,0.0,0.0,0,0,0,0,0,0,0.0,0.0,0.0,0.0,0.0,0.0
listp001,Pat Listach,Milwaukee Brewers,BREWRS,11,23,25,48,1996,2012,16,48.89,48.53,-0.36,3405,3905,500,10041,7823,-2218,2917.0,8947.0,6030.0,18537000.0,21422667.0,2885667.0
littb001,Bryan Little,Montreal Expos,NATEX,1,1,1,2,1984,1985,1,1.15,0.34,-0.81,93,84,-9,262,1,-261,0.0,204.0,204.0,0.0,0.0,0.0
littd101,Dennis Littlejohn,San Francisco Giants,GIANTS,1,1,1,2,1982,1985,3,0.0,-0.98,-0.98,0,46,46,0,4,4,0.0,115.0,115.0,0.0,0.0,0.0
littd102,Dick Littlefield,Boston Red Sox,RSOX,3,9,8,17,1950,1956,6,14.02,9.79,-4.23,1662,1085,-577,5506,3192,-2314,1880.0,1611.0,-269.0,111000.0,40000.0,-71000.0
littd102,Dick Littlefield,Chicago White Sox,WSOX,2,6,4,10,1951,1963,12,1.43,25.02,23.59,363,1422,1059,910,5079,4169,614.0,0.0,-614.0,0.0,0.0,0.0
littd102,Dick Littlefield,St.Louis Browns,ORLS,17,42,41,83,1952,1988,36,52.55,138.07,85.52,3971,7990,4019,7618,22164,14546,14427.0,15253.0,826.0,829333.0,135900.0,-693433.0
littd102,Dick Littlefield,Detroit Tigers,TIGRS,6,16,16,32,1952,1961,9,19.6,10.08,-9.52,1436,1371,-65,2274,3811,1537,4378.0,2214.0,-2164.0,23200.0,36000.0,12800.0
littd102,Dick Littlefield,Baltimore Orioles,ORLS,2,2,2,4,1954,1956,2,1.94,5.99,4.05,132,274,142,101,1056,955,893.0,0.0,-893.0,16000.0,11000.0,-5000.0
littd102,Dick Littlefield,Pittsburgh Pirates,PIRATS,1,2,1,3,1956,1965,9,0.09,18.14,18.05,108,1409,1301,317,5853,5536,29.0,0.0,-29.0,0.0,10000.0,10000.0
littd102,Dick Littlefield,New York Giants,GIANTS,1,2,1,3,1956,1956,0,0.0,0.0,0.0,0,0,0,0,0,0,0.0,0.0,0.0,0.0,31500.0,31500.0
littd102,Dick Littlefield,New York Giants,GIANTS,3,5,5,10,1957,1961,4,26.85,7.67,-19.18,1312,551,-761,4817,1078,-3739,197.0,1899.0,1702.0,0.0,0.0,0.0
littd102,Dick Littlefield,St. Louis Cardinals,CARDS,19,44,38,82,1956,1972,16,56.42,67.4,10.98,5645,3260,-2385,13530,9157,-4373,6309.0,6165.0,-144.0,120500.0,36000.0,-84500.0
littj101,Jeff Little,St. Louis Cardinals,CARDS,1,1,1,2,1981,1983,2,0.03,0.0,-0.03,33,0,-33,0,0,0,109.0,0.0,-109.0,0.0,0.0,0.0
littj102,John Littlefield,St. Louis Cardinals,CARDS,9,26,18,44,1980,1992,12,83.63,101.91,18.28,6733,4351,-2382,20851,14642,-6209,6532.0,3025.0,-3507.0,1533333.0,576667.0,-956666.0
littl101,Larry Littleton,Pittsburgh Pirates,PIRATS,2,4,2,6,1979,1982,3,-0.15,0.88,1.03,107,26,-81,27,13,-14,442.0,163.0,-279.0,0.0,0.0,0.0
littl101,Larry Littleton,Cleveland Indians,INDINS,1,1,1,2,1982,1982,0,0.0,-0.36,-0.36,0,82,82,0,319,319,0.0,0.0,0.0,0.0,0.0,0.0
littm001,Mark Little,Texas Rangers,RNGRS,5,11,11,22,1998,2007,9,64.71,14.02,-50.69,2900,693,-2207,10742,1670,-9072,2420.0,2612.0,192.0,7720000.0,9894000.0,2174000.0
littm001,Mark Little,Colorado Rockies,ROCKS,1,2,3,5,2002,2003,1,-0.58,3.78,4.36,21,232,211,25,840,815,163.0,36.0,-127.0,1350000.0,362500.0,-987500.0
littm001,Mark Little,New York Mets,METS,1,1,1,2,2002,2002,0,0.02,0.0,-0.02,15,0,-15,28,0,-28,0.0,0.0,0.0,0.0,0.0,0.0
littm101,Mark Littell,Kansas City Royals,ROYALS,1,2,1,3,1977,1979,2,2.3,2.25,-0.05,386,116,-270,35,0,-35,783.0,420.0,-363.0,50000.0,0.0,-50000.0
litts001,Scott Little,New York Mets,METS,2,3,3,6,1987,1990,3,0.91,0.12,-0.79,161,49,-112,446,62,-384,0.0,0.0,0.0,0.0,250000.0,250000.0
littw001,Wes Littleton,Texas Rangers,RNGRS,1,1,2,3,2008,2008,0,0.0,0.0,0.0,0,0,0,0,0,0,0.0,0.0,0.0,0.0,0.0,0.0
littz001,Zack Littell,Seattle Mariners,MARNRS,4,8,6,14,2016,2019,3,12.9,2.82,-10.08,683,190,-493,2542,289,-2253,142.0,311.0,169.0,17350000.0,37545833.0,20195833.0
littz001,Zack Littell,New York Yankees,YANKS,1,2,1,3,2017,2017,0,0.02,-0.11,-0.13,48,9,-39,2,2,0,203.0,112.0,-91.0,0.0,0.0,0.0
litwd101,Danny Litwhiler,Philadelphia Phillies,PHILS,3,4,6,10,1943,1946,3,9.8,8.3,-1.5,880,637,-243,3396,2656,-740,0.0,0.0,0.0,0.0,0.0,0.0
litwd101,Danny Litwhiler,Boston Braves,BRAVES,1,1,1,2,1948,1949,1,4.68,1.4,-3.28,274,103,-171,891,314,-577,0.0,0.0,0.0,0.0,0.0,0.0
liveb001,Ben Lively,Cincinnati Reds,REDS,2,3,3,6,2014,2015,1,1.93,0.81,-1.12,78,96,18,189,388,199,337.0,0.0,-337.0,0.0,8000000.0,8000000.0
livim101,Mickey Livingston,Brooklyn Dodgers,DOGRS,2,9,3,12,1940,1947,7,2.8,7.69,4.89,657,371,-286,1221,447,-774,1499.0,2793.0,1294.0,17500.0,0.0,-17500.0
livim101,Mickey Livingston,Philadelphia Phillies,PHILS,1,1,1,2,1943,1945,2,1.72,2.12,0.4,192,114,-78,613,123,-490,0.0,1037.0,1037.0,0.0,0.0,0.0
livip101,Paddy Livingston,St. Louis Cardinals,CARDS,1,5,1,6,1917,1917,0,0.0,0.36,0.36,0,28,28,0,29,29,0.0,256.0,256.0,9800.0,0.0,-9800.0
livis001,Scott Livingstone,Detroit Tigers,TIGRS,1,2,1,3,1994,1994,0,0.37,-0.32,-0.69,295,11,-284,639,0,-639,0.0,34.0,34.0,365000.0,750000.0,385000.0
livis001,Scott Livingstone,San Diego Padres,PADRS,4,10,11,21,1997,2006,9,5.86,22.51,16.65,827,1744,917,2661,6285,3624,68.0,189.0,121.0,10901680.0,12592500.0,1690820.0
lloyg001,Graeme Lloyd,Philadelphia Phillies,PHILS,1,1,1,2,1992,1992,0,3.6,0.0,-3.6,184,0,-184,0,0,0,581.0,0.0,-581.0,0.0,0.0,0.0
lloyg001,Graeme Lloyd,Milwaukee Brewers,BREWRS,11,23,25,48,1996,2012,16,48.89,48.53,-0.36,3405,3905,500,10041,7823,-2218,2917.0,8947.0,6030.0,18537000.0,21422667.0,2885667.0
lloyg001,Graeme Lloyd,New York Yankees,YANKS,1,3,1,4,1999,2003,4,11.64,19.58,7.94,456,165,-291,1235,16,-1219,1600.0,3012.0,1412.0,0.0,0.0,0.0
lloyg001,Graeme Lloyd,Montreal Expos,NATEX,2,6,6,12,2002,2005,3,7.25,0.27,-6.98,492,319,-173,648,239,-409,1719.0,1333.0,-386.0,4812500.0,6500000.0,1687500.0
lloyg001,Graeme Lloyd,New York Mets,METS,1,1,1,2,2003,2006,3,-0.68,0.0,0.68,16,0,-16,0,0,0,37.0,0.0,-37.0,650000.0,0.0,-650000.0
loaie001,Esteban Loaiza,Pittsburgh Pirates,PIRATS,1,1,2,3,1998,2002,4,3.11,1.28,-1.83,67,375,308,3,1310,1307,921.0,141.0,-780.0,450000.0,0.0,-450000.0
loaie001,Esteban Loaiza,Texas Rangers,RNGRS,5,8,8,16,2000,2015,15,4.23,22.63,18.4,386,1954,1568,834,8328,7494,1398.0,338.0,-1060.0,19651100.0,3220000.0,-16431100.0
loaie001,Esteban Loaiza,Chicago White Sox,WSOX,2,3,3,6,2004,2009,5,-0.12,9.88,10.0,24,156,132,4,18,14,178.0,2700.0,2522.0,14000000.0,8500000.0,-5500000.0
lobaj001,Jose Lobaton,Tampa Bay Devil Rays,RAYS,3,8,5,13,2014,2018,4,0.49,9.21,8.72,459,720,261,782,2375,1593,577.0,688.0,111.0,508800.0,3779600.0,3270800.0
lobeh101,Hans Lobert,Cincinnati Reds,REDS,2,6,5,11,1910,1914,4,23.79,7.43,-16.36,1495,715,-780,6220,2571,-3649,283.0,231.0,-52.0,0.0,0.0,0.0
lobeh101,Hans Lobert,Philadelphia Phillies,PHILS,6,11,15,26,1915,1929,14,30.92,28.6,-2.32,2041,1450,-591,6407,4294,-2113,4874.0,5311.0,437.0,8500.0,19850.0,11350.0
lobsk001,Kyle Lobstein,Pittsburgh Pirates,PIRATS,1,1,1,2,2016,2016,0,0.0,0.18,0.18,0,16,16,0,0,0,0.0,20.0,20.0,520000.0,0.0,-520000.0
locat001,Tim Locastro,Toronto Blue Jays,BJAYS,1,2,1,3,2015,2015,0,0.08,0.0,-0.08,21,0,-21,15,0,-15,0.0,0.0,0.0,0.0,0.0,0.0
locat001,Tim Locastro,Los Angeles Dodgers,DOGRS,1,1,2,3,2018,2018,0,-0.05,0.0,0.05,9,0,-9,23,0,-23,0.0,0.0,0.0,0.0,0.0,0.0
locat001,Tim Locastro,New York Yankees,YANKS,1,1,1,2,2019,2019,0,0.36,0.0,-0.36,179,0,-179,465,0,-465,0.0,0.0,0.0,0.0,0.0,0.0
locat001,Tim Locastro,Arizona Diamondbacks,DBACKS,1,1,1,2,2021,2021,0,-0.05,0.0,0.05,9,0,-9,23,0,-23,0.0,0.0,0.0,0.0,0.0,0.0
lockb101,Bobby Locke,Cleveland Indians,INDINS,2,2,2,4,1961,1964,3,-1.4,1.15,2.55,187,332,145,534,1054,520,0.0,0.0,0.0,16000.0,0.0,-16000.0
lockb101,Bobby Locke,Chicago Cubs,CUBS,1,1,1,2,1962,1962,0,0.07,0.0,-0.07,2,0,-2,0,0,0,6.0,0.0,-6.0,0.0,0.0,0.0
lockb101,Bobby Locke,St. Louis Cardinals,CARDS,3,4,3,7,1962,1964,2,0.95,1.5,0.55,172,76,-96,34,5,-29,466.0,170.0,-296.0,0.0,0.0,0.0
lockb101,Bobby Locke,California Angels,ANGELS,1,1,2,3,1965,1965,0,-0.48,0.05,0.53,22,34,12,2,1,-1,52.0,84.0,32.0,0.0,0.0,0.0
lockb102,Bob Locker,Chicago White Sox,WSOX,1,1,1,2,1969,1969,0,1.78,-0.44,-2.22,158,46,-112,14,6,-8,331.0,116.0,-215.0,0.0,40000.0,40000.0
lockb102,Bob Locker,Oakland Athletics,ATLTCS,2,2,2,4,1972,1978,6,4.01,19.41,15.4,280,747,467,393,3076,2683,417.0,0.0,-417.0,35000.0,11000.0,-24000.0
lockb102,Bob Locker,Chicago Cubs,CUBS,3,3,3,6,1973,1978,5,0.43,1.08,0.65,11,93,82,0,61,61,35.0,142.0,107.0,69000.0,24000.0,-45000.0
lockb102,Bob Locker,Oakland Athletics,ATLTCS,1,3,1,4,1974,1976,2,1.24,1.92,0.68,1157,275,-882,3065,1015,-2050,578.0,0.0,-578.0,69800.0,150000.0,80200.0
lockd101,Don Lock,New York Yankees,YANKS,1,1,1,2,1962,1963,1,10.43,0.46,-9.97,653,55,-598,2397,129,-2268,0.0,0.0,0.0,0.0,0.0,0.0
lockd101,Don Lock,Washington Senators,RNGRS,15,28,30,58,1966,1986,20,68.98,45.92,-23.06,3839,2636,-1203,7344,5616,-1728,11858.0,5834.0,-6024.0,263000.0,426900.0,163900.0
lockd101,Don Lock,Philadelphia Phillies,PHILS,1,1,1,2,1969,1969,0,-0.08,0.0,0.08,53,0,-53,70,0,-70,0.0,0.0,0.0,0.0,0.0,0.0
lockg101,Gene Locklear,Cincinnati Reds,REDS,1,3,1,4,1973,1979,6,1.85,11.84,9.99,285,462,177,593,484,-109,64.0,3945.0,3881.0,0.0,0.0,0.0
lockg101,Gene Locklear,San Diego Padres,PADRS,1,1,1,2,1976,1977,1,-0.29,0.41,0.7,14,138,124,39,58,19,0.0,578.0,578.0,0.0,0.0,0.0
lockj001,Jeff Locke,Atlanta Braves,BRAVES,1,3,1,4,2009,2011,2,-2.0,-0.61,1.39,553,250,-303,514,1005,491,4336.0,0.0,-4336.0,0.0,2500000.0,2500000.0
lockk001,Keith Lockhart,Kansas City Royals,ROYALS,2,3,3,6,1997,2002,5,6.48,5.78,-0.7,926,799,-127,2620,3080,460,0.0,181.0,181.0,3800000.0,3550000.0,-250000.0
lockr101,Ron Locke,New York Mets,METS,1,2,1,3,1966,1966,0,0.0,0.78,0.78,0,34,34,0,12,12,0.0,130.0,130.0,0.0,0.0,0.0
locks101,Skip Lockwood,Milwaukee Brewers,BREWRS,3,7,7,14,1973,1978,5,7.23,1.8,-5.43,546,209,-337,1533,327,-1206,524.0,1634.0,1110.0,168301.0,15000.0,-153301.0
locks101,Skip Lockwood,California Angels,ANGELS,1,1,1,2,1974,1975,1,0.0,-0.55,-0.55,0,30,30,0,73,73,0.0,0.0,0.0,20000.0,30000.0,10000.0
locks102,Stu Locklin,Cleveland Indians,INDINS,1,1,1,2,1958,1959,1,0.0,0.0,0.0,0,0,0,0,0,0,0.0,0.0,0.0,0.0,0.0,0.0
lockw001,Walker Lockett,San Diego Padres,PADRS,1,1,1,2,2018,2018,0,0.0,0.0,0.0,0,0,0,0,0,0,0.0,0.0,0.0,0.0,0.0,0.0
lockw001,Walker Lockett,Cleveland Indians,INDINS,1,2,1,3,2019,2019,0,-0.48,-0.04,0.44,31,61,30,11,174,163,92.0,6.0,-86.0,0.0,0.0,0.0
lockw101,Whitey Lockman,St. Louis Cardinals,CARDS,1,1,1,2,1957,1957,0,-1.14,0.28,1.42,225,80,-145,643,6,-637,0.0,165.0,165.0,0.0,0.0,0.0
lockw101,Whitey Lockman,Baltimore Orioles,ORLS,1,1,1,2,1959,1961,2,0.0,0.4,0.4,73,155,82,102,398,296,0.0,0.0,0.0,0.0,2000.0,2000.0
lockw101,Whitey Lockman,New York Giants,GIANTS,11,22,22,44,1956,1968,12,37.88,26.25,-11.63,3162,2563,-599,10326,4535,-5791,1384.0,7539.0,6155.0,95000.0,109500.0,14500.0
lodid101,Dario Lodigiani,Oakland,Oakland,1,1,3,4,1937,1943,6,-0.11,0.0,0.11,215,0,-215,819,0,-819,0.0,0.0,0.0,0.0,1800.0,1800.0
lodid101,Dario Lodigiani,Philadelphia Athletics,ATLTCS,1,1,1,2,1940,1946,6,1.34,-1.48,-2.82,190,100,-90,733,112,-621,0.0,888.0,888.0,3500.0,8000.0,4500.0
lodup001,Paul Lo Duca,Los Angeles Dodgers,DOGRS,2,6,5,11,2004,2008,4,2.71,12.71,10.0,623,499,-124,1632,1049,-583,321.0,2036.0,1715.0,9106667.0,11835000.0,2728333.0
lodup001,Paul Lo Duca,Florida Marlins,MARLNS,2,2,3,5,2005,2008,3,2.55,0.89,-1.66,243,50,-193,1039,0,-1039,0.0,40.0,40.0,4666667.0,0.0,-4666667.0
loepg101,George Loepp,Baltimore,Baltimore,2,3,6,9,1929,1930,1,-0.47,0.0,0.47,84,0,-84,186,0,-186,173.0,0.0,-173.0,0.0,6500.0,6500.0
loesb101,Billy Loes,Baltimore Orioles,ORLS,1,1,1,2,1959,1959,0,0.0,0.0,0.0,0,0,0,0,0,0,0.0,0.0,0.0,0.0,0.0,0.0
loesb101,Billy Loes,Baltimore Orioles,ORLS,8,21,21,42,1959,1988,29,33.15,113.26,80.11,2390,5136,2746,2159,13379,11220,12056.0,12975.0,919.0,785333.0,99400.0,-685933.0
loewc001,Carlton Loewer,Philadelphia Phillies,PHILS,3,6,5,11,1999,2003,4,6.55,1.13,-5.42,362,281,-81,360,99,-261,2958.0,1114.0,-1844.0,6615000.0,10757500.0,4142500.0
loftd101,Dick Loftus,Brooklyn Dodgers,DOGRS,3,9,3,12,1926,1934,8,0.53,8.67,8.14,100,822,722,99,3036,2937,677.0,0.0,-677.0,30000.0,12000.0,-18000.0
loftf101,Frank Loftus,Philadelphia Athletics,ATLTCS,1,3,1,4,1924,1926,2,0.0,8.0,8.0,0,166,166,0,103,103,0.0,950.0,950.0,0.0,0.0,0.0
loftk001,Kenny Lofton,Houston Astros,ASTROS,2,3,4,7,1991,1995,4,53.38,-0.45,-53.83,1975,315,-1660,8100,672,-7428,0.0,285.0,285.0,375000.0,100000.0,-275000.0
loftk001,Kenny Lofton,Cleveland Indians,INDINS,14,19,23,42,1997,2020,23,33.89,80.62,46.73,2990,2655,-335,9123,6094,-3029,3747.0,9391.0,5644.0,44554400.0,15489000.0,-29065400.0
loftk001,Kenny Lofton,Chicago White Sox,WSOX,2,2,3,5,2002,2005,3,1.76,-1.16,-2.92,46,50,4,205,100,-105,0.0,148.0,148.0,1025000.0,575000.0,-450000.0
loftk001,Kenny Lofton,Pittsburgh Pirates,PIRATS,2,4,4,8,2003,2005,2,25.85,-0.22,-26.07,1180,243,-937,4941,589,-4352,0.0,0.0,0.0,4351000.0,0.0,-4351000.0
loftk001,Kenny Lofton,New York Yankees,YANKS,1,1,1,2,2004,2005,1,3.55,0.31,-3.24,110,35,-75,406,0,-406,0.0,97.0,97.0,3100000.0,0.0,-3100000.0
loftk001,Kenny Lofton,Texas Rangers,RNGRS,1,1,1,2,2007,2011,4,0.74,0.29,-0.45,52,45,-7,196,140,-56,0.0,0.0,0.0,6000000.0,0.0,-6000000.0
logab001,Boone Logan,Chicago White Sox,WSOX,2,4,6,10,2008,2015,7,5.25,6.88,1.63,121,767,646,107,2238,2131,727.0,0.0,-727.0,11905000.0,0.0,-11905000.0
logab001,Boone Logan,Atlanta Braves,BRAVES,3,6,8,14,2009,2014,5,9.14,2.66,-6.48,1368,918,-450,996,2818,1822,2035.0,774.0,-1261.0,14152500.0,10750000.0,-3402500.0
logab101,Bob Logan,Indianapolis,Indianapolis,1,2,3,5,1936,1936,0,49.01,0.0,-49.01,1002,0,-1002,1002,0,-1002,7777.0,0.0,-7777.0,0.0,0.0,0.0
logab101,Bob Logan,Chicago Cubs,CUBS,1,2,1,3,1938,1938,0,0.0,0.41,0.41,0,26,26,0,27,27,0.0,204.0,204.0,0.0,0.0,0.0
logab101,Bob Logan,Indianapolis,Indianapolis,1,1,2,3,1945,1945,0,2.8,0.0,-2.8,68,0,-68,69,0,-69,561.0,0.0,-561.0,0.0,0.0,0.0
logaj101,Johnny Logan,Milwaukee Braves,BRAVES,1,1,1,2,1961,1961,0,-0.36,-0.48,-0.12,152,37,-115,355,131,-224,0.0,0.0,0.0,0.0,0.0,0.0
lohrb101,Bill Lohrman,New York Giants,GIANTS,1,4,1,5,1941,1949,8,5.95,28.96,23.01,346,655,309,1181,2815,1634,38.0,0.0,-38.0,0.0,0.0,0.0
lohrb101,Bill Lohrman,New York Giants,GIANTS,2,4,3,7,1943,1945,2,-0.25,-0.04,0.21,36,72,36,28,39,11,123.0,375.0,252.0,0.0,0.0,0.0
lohrb101,Bill Lohrman,Brooklyn Dodgers,DOGRS,1,3,1,4,1944,1946,2,-0.35,6.14,6.49,4,237,233,0,969,969,5.0,0.0,-5.0,0.0,0.0,0.0
lohrj101,Jack Lohrke,New York Giants,GIANTS,1,1,1,2,1951,1951,0,-0.12,0.0,0.12,37,0,-37,47,0,-47,0.0,0.0,0.0,12000.0,0.0,-12000.0
lohrj101,Jack Lohrke,Philadelphia Phillies,PHILS,5,10,8,18,1954,1968,14,28.54,39.33,10.79,1270,2132,862,1527,6127,4600,4802.0,3446.0,-1356.0,0.0,0.0,0.0
lohsk001,Kyle Lohse,Chicago Cubs,CUBS,2,3,3,6,1999,2001,2,5.9,3.0,-2.9,235,338,103,49,464,415,3132.0,564.0,-2568.0,0.0,8300000.0,8300000.0
lohsk001,Kyle Lohse,Minnesota Twins,TWINS,1,1,1,2,2006,2006,0,2.25,0.0,-2.25,64,0,-64,66,0,-66,584.0,0.0,-584.0,3950000.0,0.0,-3950000.0
lohsk001,Kyle Lohse,Cincinnati Reds,REDS,1,1,1,2,2007,2011,4,0.65,0.05,-0.6,26,44,18,23,24,1,183.0,240.0,57.0,4200000.0,0.0,-4200000.0
loisr001,Rich Loiselle,San Diego Padres,PADRS,1,2,1,3,1995,1995,0,-0.01,0.15,0.16,84,54,-30,3,165,162,134.0,0.0,-134.0,140000.0,2000000.0,1860000.0
loisr001,Rich Loiselle,Houston Astros,ASTROS,1,1,1,2,1996,1996,0,2.3,-0.94,-3.24,397,30,-367,11,12,1,672.0,127.0,-545.0,0.0,550000.0,550000.0
lolim101,Mickey Lolich,Detroit Tigers,TIGRS,2,3,4,7,1975,1979,4,1.24,6.09,4.85,109,575,466,196,2407,2211,578.0,284.0,-294.0,95000.0,110000.0,15000.0
lolls101,Sherm Lollar,Cleveland Indians,INDINS,3,5,5,10,1946,1955,9,0.0,7.38,7.38,349,809,460,998,1967,969,633.0,1677.0,1044.0,0.0,0.0,0.0
lolls101,Sherm Lollar,New York Yankees,YANKS,2,7,3,10,1948,1954,6,24.48,2.06,-22.42,970,341,-629,1730,188,-1542,4702.0,1746.0,-2956.0,11500.0,10000.0,-1500.0
lolls101,Sherm Lollar,St.Louis Browns,ORLS,34,89,94,183,1951,1988,37,141.32,199.23,57.91,10082,16608,6526,23224,49618,26394,30166.0,18711.0,-11455.0,889583.0,189900.0,-699683.0
lollt001,Tim Lollar,New York Yankees,YANKS,6,13,11,24,1981,1992,11,27.03,19.65,-7.38,2401,1053,-1348,5956,3510,-2446,5438.0,699.0,-4739.0,913333.0,1745000.0,831667.0
lollt001,Tim Lollar,San Diego Padres,PADRS,2,6,4,10,1984,1989,5,23.33,0.76,-22.57,2084,146,-1938,6812,127,-6685,1933.0,1127.0,-806.0,0.0,0.0,0.0
lollt001,Tim Lollar,Chicago White Sox,WSOX,1,1,1,2,1985,1987,2,-0.43,0.29,0.72,50,125,75,2,286,284,330.0,0.0,-330.0,463000.0,260000.0,-203000.0
lombe101,Ernie Lombardi,Oakland,Oakland,1,1,2,3,1931,1932,1,0.44,0.0,-0.44,73,0,-73,196,0,-196,0.0,0.0,0.0,0.0,0.0,0.0
lombe101,Ernie Lombardi,Brooklyn Dodgers,DOGRS,7,17,12,29,1932,1948,16,60.59,33.44,-27.15,3224,2810,-414,11104,10257,-847,2159.0,791.0,-1368.0,10000.0,10000.0,0.0
lombe101,Ernie Lombardi,Boston Braves,BRAVES,2,2,3,5,1943,1954,11,11.0,16.26,5.26,715,1091,376,2508,4022,1514,0.0,0.0,0.0,0.0,0.0,0.0
lombg001,George Lombard,Atlanta Braves,BRAVES,1,1,1,2,2002,2002,0,-0.3,0.0,0.3,72,0,-72,270,0,-270,0.0,0.0,0.0,0.0,0.0,0.0
lombp001,Phil Lombardi,New York Yankees,YANKS,1,3,2,5,1987,1989,2,0.13,-0.61,-0.74,44,148,104,95,521,426,0.0,0.0,0.0,0.0,250000.0,250000.0
lombs001,Steve Lombardozzi,Minnesota Twins,TWINS,1,1,2,3,1989,1989,0,0.35,0.0,-0.35,23,0,-23,43,0,-43,0.0,0.0,0.0,0.0,0.0,0.0
lombs002,Steve Lombardozzi,Washington Nationals,NATEX,1,3,1,4,2013,2015,2,-1.71,4.39,6.1,114,103,-11,3,101,98,324.0,801.0,477.0,501250.0,4000000.0,3498750.0
lombs002,Steve Lombardozzi,Detroit Tigers,TIGRS,1,1,1,2,2014,2014,0,-0.68,-0.53,0.15,20,9,-11,74,32,-42,0.0,0.0,0.0,0.0,0.0,0.0
lombv101,Vic Lombardi,Brooklyn Dodgers,DOGRS,3,7,9,16,1947,1954,7,6.69,26.56,19.87,628,1156,528,1259,3340,2081,1417.0,3832.0,2415.0,38000.0,0.0,-38000.0
lonbj101,Jim Lonborg,Boston Red Sox,RSOX,5,10,10,20,1971,1977,6,35.42,11.92,-23.5,1569,736,-833,4628,2092,-2536,3846.0,2344.0,-1502.0,155000.0,100500.0,-54500.0
lonbj101,Jim Lonborg,Milwaukee Brewers,BREWRS,3,6,5,11,1972,1984,12,7.41,27.71,20.3,475,1402,927,547,5127,4580,4062.0,1332.0,-2730.0,59800.0,15000.0,-44800.0
lonej001,James Loney,Los Angeles Dodgers,DOGRS,5,22,14,36,2012,2021,9,4.41,31.13,26.72,1016,1541,525,2843,5562,2719,1152.0,835.0,-317.0,78709000.0,90253480.0,11544480.0
lonew101,Walter Lonergan,Boston Red Sox,RSOX,9,25,23,48,1912,1935,23,51.77,27.05,-24.72,3792,3039,-753,15081,11185,-3896,0.0,1203.0,1203.0,45050.0,29350.0,-15700.0
lonew101,Walter Lonergan,Brockton,Brockton,1,2,4,6,1911,1911,0,1.67,0.0,-1.67,331,0,-331,645,0,-645,0.0,0.0,0.0,0.0,0.0,0.0
longb002,Bill Long,San Diego Padres,PADRS,2,6,4,10,1984,1989,5,23.33,0.76,-22.57,2084,146,-1938,6812,127,-6685,1933.0,1127.0,-806.0,0.0,0.0,0.0
longb002,Bill Long,Chicago White Sox,WSOX,1,1,1,2,1990,1990,0,0.28,0.0,-0.28,84,0,-84,6,0,-6,167.0,0.0,-167.0,257500.0,0.0,-257500.0
longd101,Dale Long,Middletown,Middletown,1,2,2,4,1945,1945,0,0.0,0.0,0.0,0,0,0,0,0,0,0.0,0.0,0.0,0.0,0.0,0.0
longd101,Dale Long,Pittsburgh Pirates,PIRATS,3,4,5,9,1957,1959,2,9.68,2.34,-7.34,949,404,-545,3178,1303,-1875,0.0,0.0,0.0,0.0,70000.0,70000.0
longd101,Dale Long,Washington Senators,RNGRS,16,29,31,60,1962,1986,24,69.44,56.35,-13.09,3894,3289,-605,7473,8013,540,11858.0,5834.0,-6024.0,263000.0,426900.0,163900.0
longe001,Evan Longoria,Tampa Bay Devil Rays,RAYS,3,7,8,15,2017,2019,2,8.59,1.25,-7.34,553,79,-474,1848,289,-1559,188.0,0.0,-188.0,18300000.0,11000000.0,-7300000.0
longh101,Herman Long,New York Yankees,YANKS,1,2,1,3,1903,1909,6,0.01,19.09,19.08,92,667,575,343,2757,2414,0.0,0.0,0.0,0.0,0.0,0.0
longj101,Jeoff Long,Chicago White Sox,WSOX,3,4,4,8,1964,1969,5,5.43,1.58,-3.85,657,600,-57,2273,1624,-649,543.0,0.0,-543.0,26500.0,6000.0,-20500.0
longs001,Shed Long,Cincinnati Reds,REDS,1,2,2,4,2019,2019,0,0.0,5.83,5.83,0,63,63,0,60,60,0.0,526.0,526.0,0.0,0.0,0.0
longs001,Shed Long,New York Yankees,YANKS,2,3,3,6,2019,2021,2,-0.42,0.33,0.75,110,102,-8,417,361,-56,0.0,0.0,0.0,0.0,0.0,0.0
longt001,Tony Longmire,Pittsburgh Pirates,PIRATS,2,4,2,6,1990,1991,1,3.0,-0.21,-3.21,512,23,-489,1575,37,-1538,0.0,0.0,0.0,925000.0,700000.0,-225000.0
longt002,Terrence Long,New York Mets,METS,1,2,1,3,1999,1999,0,4.65,1.12,-3.53,602,24,-578,2480,30,-2450,0.0,228.0,228.0,200000.0,5000000.0,4800000.0
longt002,Terrence Long,Oakland Athletics,ATLTCS,2,3,3,6,2003,2012,9,7.5,9.83,2.33,434,545,111,1482,2087,605,0.0,206.0,206.0,4062500.0,4450000.0,387500.0
longt002,Terrence Long,San Diego Padres,PADRS,2,6,3,9,2004,2005,1,-0.69,-0.05,0.64,140,84,-56,489,11,-478,24.0,273.0,249.0,7550000.0,4750000.0,-2800000.0
lonnj101,Joe Lonnett,Philadelphia Phillies,PHILS,2,2,3,5,1958,1961,3,3.25,2.09,-1.16,305,311,6,785,858,73,0.0,0.0,0.0,0.0,9000.0,9000.0
lonnj101,Joe Lonnett,Milwaukee Braves,BRAVES,1,2,2,4,1959,1961,2,0.0,0.34,0.34,0,49,49,0,163,163,0.0,0.0,0.0,0.0,0.0,0.0
lookb101,Bruce Look,New York Yankees,YANKS,1,1,1,2,1971,1971,0,0.0,0.0,0.0,0,0,0,0,0,0,0.0,0.0,0.0,0.0,0.0,0.0
lookb101,Bruce Look,Milwaukee Brewers,BREWRS,2,3,3,6,1971,1973,2,-0.12,-0.77,-0.65,3,126,123,9,406,397,0.0,22.0,22.0,18000.0,0.0,-18000.0
loonb001,Brian Looney,Boston Red Sox,RSOX,1,1,1,2,1996,1997,1,0.0,-0.22,-0.22,0,21,21,0,0,0,0.0,67.0,67.0,0.0,202500.0,202500.0
loopa001,Aaron Looper,Seattle Mariners,MARNRS,1,2,1,3,2004,2005,1,0.0,0.37,0.37,0,113,113,0,391,391,0.0,0.0,0.0,0.0,0.0,0.0
loopa001,Aaron Looper,Los Angeles Dodgers,DOGRS,1,1,1,2,2004,2004,0,0.0,0.0,0.0,0,0,0,0,0,0,0.0,0.0,0.0,0.0,0.0,0.0
loopb001,Braden Looper,St. Louis Cardinals,CARDS,1,3,1,4,1998,2004,6,3.02,16.68,13.66,1222,903,-319,88,3759,3671,1761.0,0.0,-1761.0,170000.0,255000.0,85000.0
lopae101,Eddie Lopat,Chicago White Sox,WSOX,13,20,26,46,1948,1968,20,32.37,102.48,70.11,2995,4360,1365,5442,9081,3639,8616.0,15133.0,6517.0,51250.0,83000.0,31750.0
lopae101,Eddie Lopat,New York Yankees,YANKS,1,1,1,2,1955,1956,1,0.39,0.0,-0.39,20,0,-20,18,0,-18,147.0,0.0,-147.0,0.0,0.0,0.0
lopas101,Stan Lopata,Philadelphia Phillies,PHILS,9,18,19,37,1959,1979,20,39.51,86.58,47.07,2824,3643,819,7602,10419,2817,7676.0,11796.0,4120.0,74500.0,159800.0,85300.0
lopea001,Aurelio Lopez,St. Louis Cardinals,CARDS,4,6,8,14,1978,1994,16,8.24,37.26,29.02,800,1928,1128,1636,7432,5796,2139.0,691.0,-1448.0,1500000.0,102500.0,-1397500.0
lopea002,Albie Lopez,Tampa Bay Devil Rays,RAYS,2,3,3,6,2001,2003,2,0.72,-0.23,-0.95,68,152,84,104,387,283,243.0,290.0,47.0,3750000.0,200000.0,-3550000.0
lopea003,Aquilino Lopez,Philadelphia Phillies,PHILS,1,1,2,3,2006,2006,0,0.0,0.0,0.0,0,0,0,0,0,0,0.0,0.0,0.0,0.0,0.0,0.0
lopea102,Al Lopez,Brooklyn Dodgers,DOGRS,5,10,8,18,1935,1948,13,23.18,15.94,-7.24,1423,1121,-302,4586,3821,-765,1769.0,791.0,-978.0,0.0,0.0,0.0
lopea102,Al Lopez,Boston Braves,BRAVES,1,1,2,3,1940,1942,2,4.62,-0.87,-5.49,656,205,-451,2135,559,-1576,0.0,0.0,0.0,0.0,0.0,0.0
lopea102,Al Lopez,Pittsburgh Pirates,PIRATS,2,6,2,8,1946,1947,1,0.35,0.08,-0.27,61,22,-39,135,87,-48,0.0,0.0,0.0,5000.0,0.0,-5000.0
lopec101,Carlos Lopez,Seattle Mariners,MARNRS,2,3,2,5,1977,1982,5,-0.28,1.01,1.29,129,138,9,207,50,-157,0.0,1472.0,1472.0,0.0,0.0,0.0
loped001,Davey Lopes,Los Angeles Dodgers,DOGRS,1,1,1,2,1982,1982,0,5.3,0.0,-5.3,347,0,-347,1324,0,-1324,0.0,0.0,0.0,0.0,0.0,0.0
loped001,Davey Lopes,Oakland Athletics,ATLTCS,1,1,2,3,1984,1985,1,3.96,-1.23,-5.19,174,16,-158,539,0,-539,0.0,92.0,92.0,450000.0,0.0,-450000.0
loped001,Davey Lopes,Chicago Cubs,CUBS,1,1,1,2,1986,1988,2,0.84,0.82,-0.02,84,324,240,169,15,-154,0.0,631.0,631.0,490000.0,280000.0,-210000.0
lopef001,Felipe Lopez,Toronto Blue Jays,BJAYS,1,1,1,2,2002,2002,0,4.22,0.0,-4.22,371,0,-371,1566,0,-1566,0.0,0.0,0.0,221000.0,0.0,-221000.0
lopef001,Felipe Lopez,Cincinnati Reds,REDS,1,3,5,8,2006,2012,6,0.43,-0.61,-1.04,795,705,-90,2860,181,-2679,139.0,809.0,670.0,4550000.0,1352000.0,-3198000.0
lopef001,Felipe Lopez,Arizona Diamondbacks,DBACKS,1,1,2,3,2009,2012,3,1.78,-0.62,-2.4,82,50,-32,348,120,-228,0.0,0.0,0.0,3500000.0,0.0,-3500000.0
lopeh101,Hector Lopez,Kansas City Athletics,ATLTCS,17,36,31,67,1959,1976,17,68.33,55.7,-12.63,8021,5164,-2857,18125,17078,-1047,14086.0,3207.0,-10879.0,387100.0,512500.0,125400.0
lopej001,Javy Lopez,Baltimore Orioles,ORLS,1,1,2,3,2006,2008,2,-0.68,0.0,0.68,18,2,-16,65,0,-65,0.0,0.0,0.0,9000000.0,335000.0,-8665000.0
lopej002,Javier Lopez,Boston Red Sox,RSOX,1,1,1,2,2003,2003,0,0.01,0.0,-0.01,276,0,-276,8,0,-8,303.0,0.0,-303.0,0.0,0.0,0.0
lopej002,Javier Lopez,Chicago White Sox,WSOX,1,1,1,2,2006,2006,0,2.51,0.55,-1.96,182,37,-145,1,0,-1,385.0,103.0,-282.0,0.0,1800000.0,1800000.0
lopej002,Javier Lopez,Pittsburgh Pirates,PIRATS,1,1,2,3,2010,2011,1,5.3,0.17,-5.13,867,55,-812,4,96,92,753.0,26.0,-727.0,775000.0,410000.0,-365000.0
lopej003,Jose Lopez,Seattle Mariners,MARNRS,1,1,1,2,2010,2011,1,-0.43,0.0,0.43,38,0,-38,129,0,-129,0.0,0.0,0.0,3000000.0,0.0,-3000000.0
lopej004,Jorge Lopez,Milwaukee Brewers,BREWRS,1,2,1,3,2018,2019,1,-0.83,3.09,3.92,134,197,63,238,802,564,475.0,0.0,-475.0,0.0,0.0,0.0
lopel002,Luis Lopez,San Diego Padres,PADRS,1,1,1,2,1997,1997,0,0.0,0.0,0.0,0,0,0,0,0,0,0.0,0.0,0.0,0.0,0.0,0.0
lopel002,Luis Lopez,Houston Astros,ASTROS,1,1,1,2,1997,2000,3,-0.04,0.72,0.76,263,394,131,612,1149,537,0.0,6.0,6.0,0.0,0.0,0.0
lopel002,Luis Lopez,New York Mets,METS,13,26,28,54,2000,2021,21,24.29,23.27,-1.02,1150,1892,742,2106,4808,2702,6006.0,3574.0,-2432.0,30731467.0,5425000.0,-25306467.0
lopem002,Mickey Lopez,Milwaukee Brewers,BREWRS,1,1,1,2,2001,2001,0,0.0,0.0,0.0,0,0,0,0,0,0,0.0,0.0,0.0,0.0,0.0,0.0
lopem101,Marcelino Lopez,Philadelphia Phillies,PHILS,1,2,1,3,1964,1964,0,3.87,0.04,-3.83,190,18,-172,145,50,-95,1270.0,0.0,-1270.0,0.0,24000.0,24000.0
lopem101,Marcelino Lopez,California Angels,ANGELS,2,3,2,5,1967,1968,1,0.18,0.22,0.04,210,95,-115,182,230,48,443.0,0.0,-443.0,0.0,0.0,0.0
lopem101,Marcelino Lopez,Baltimore Orioles,ORLS,7,19,17,36,1971,1988,17,19.83,74.86,55.03,1822,3555,1733,3482,7755,4273,7971.0,11298.0,3327.0,691833.0,37000.0,-654833.0
lopep002,Pablo Lopez,Seattle Mariners,MARNRS,1,4,1,5,2017,2018,1,5.31,0.23,-5.08,114,11,-103,89,0,-89,990.0,26.0,-964.0,0.0,4600000.0,4600000.0
loper001,Rodrigo Lopez,Baltimore Orioles,ORLS,1,1,2,3,2007,2010,3,0.74,0.16,-0.58,27,8,-19,24,0,-24,238.0,23.0,-215.0,0.0,0.0,0.0
loper001,Rodrigo Lopez,Atlanta Braves,BRAVES,1,1,1,2,2011,2014,3,-0.51,0.09,0.6,59,2,-57,33,0,-33,312.0,3.0,-309.0,0.0,0.0,0.0
loper002,Rafael Lopez,Chicago Cubs,CUBS,1,1,2,3,2015,2015,0,0.0,0.0,0.0,0,0,0,0,0,0,0.0,0.0,0.0,0.0,0.0,0.0
loper003,Reynaldo Lopez,Washington Nationals,NATEX,1,3,1,4,2016,2020,4,16.01,2.64,-13.37,233,310,77,19,1309,1290,3554.0,0.0,-3554.0,0.0,2750000.0,2750000.0
lopet001,Tim Lopes,Seattle Mariners,MARNRS,2,2,2,4,2016,2017,1,0.0,-0.15,-0.15,0,7,7,0,0,0,0.0,40.0,40.0,0.0,0.0,0.0
lopew001,Wilton Lopez,Houston Astros,ASTROS,1,2,2,4,2012,2015,3,0.63,0.0,-0.63,153,0,-153,1,0,-1,245.0,0.0,-245.0,515500.0,0.0,-515500.0
lopey001,Yoan Lopez,Arizona Diamondbacks,DBACKS,1,1,1,2,2021,2021,0,0.0,0.0,0.0,0,0,0,0,0,0,0.0,0.0,0.0,0.0,0.0,0.0
lordb101,Bris Lord,Cleveland Indians,INDINS,3,4,9,13,1910,1932,22,36.24,73.71,37.47,997,2838,1841,4399,11636,7237,0.0,807.0,807.0,0.0,0.0,0.0
lordb101,Bris Lord,Philadelphia Athletics,ATLTCS,2,5,3,8,1912,1916,4,0.94,11.21,10.27,71,847,776,237,3547,3310,0.0,0.0,0.0,0.0,0.0,0.0
lordb101,Bris Lord,Baltimore,Baltimore,1,1,1,2,1913,1913,0,-0.46,0.0,0.46,73,0,-73,247,0,-247,0.0,0.0,0.0,0.0,0.0,0.0
lordh101,Harry Lord,Boston Red Sox,RSOX,10,27,25,52,1910,1935,25,63.77,27.05,-36.72,4436,3125,-1311,17821,11484,-6337,0.0,1291.0,1291.0,45050.0,29350.0,-15700.0
lorem001,Mark Loretta,Milwaukee Brewers,BREWRS,4,7,10,17,2002,2010,8,13.31,7.33,-5.98,1249,1228,-21,4481,1606,-2875,156.0,2352.0,2196.0,13883333.0,7270260.0,-6613073.0
lorem001,Mark Loretta,San Diego Padres,PADRS,3,3,5,8,2005,2011,6,0.19,5.34,5.15,314,878,564,1006,1202,196,131.0,712.0,581.0,4680900.0,1853400.0,-2827500.0
lorra001,Andrew Lorraine,California Angels,ANGELS,1,4,2,6,1995,1997,2,5.3,-0.85,-6.15,439,40,-399,87,0,-87,1686.0,680.0,-1006.0,0.0,2905000.0,2905000.0
lorra001,Andrew Lorraine,Chicago White Sox,WSOX,1,2,1,3,1996,1996,0,-0.05,0.57,0.62,12,132,120,0,541,541,89.0,0.0,-89.0,0.0,0.0,0.0
loucs001,Scott Loucks,Houston Astros,ASTROS,1,1,1,2,1984,1984,0,0.0,0.0,0.0,0,0,0,0,0,0,0.0,0.0,0.0,0.0,0.0,0.0
lougd001,David Lough,Kansas City Royals,ROYALS,3,3,4,7,2013,2015,2,2.66,0.2,-2.46,371,59,-312,680,155,-525,234.0,58.0,-176.0,1065000.0,510200.0,-554800.0
loupa001,Aaron Loup,Toronto Blue Jays,BJAYS,1,1,1,2,2018,2021,3,0.09,0.26,0.17,18,29,11,0,3,3,12.0,287.0,275.0,1812500.0,0.0,-1812500.0
lovel102,Lynn Lovenguth,Toronto,Toronto,1,1,2,3,1956,1956,0,0.19,0.0,-0.19,5,0,-5,2,0,-2,27.0,0.0,-27.0,0.0,0.0,0.0
loves101,Slim Love,New York Yankees,YANKS,5,19,8,27,1918,1928,10,9.22,7.55,-1.67,1051,1233,182,2808,4705,1897,3476.0,418.0,-3058.0,39950.0,18400.0,-21550.0
loves101,Slim Love,Boston Red Sox,RSOX,1,3,1,4,1919,1919,0,4.45,1.63,-2.82,567,133,-434,1739,583,-1156,282.0,0.0,-282.0,0.0,0.0,0.0
lovev001,Vance Lovelace,Chicago Cubs,CUBS,3,4,3,7,1983,1988,5,1.79,5.67,3.88,345,610,265,964,2221,1257,0.0,37.0,37.0,0.0,0.0,0.0
lovij101,Jay Loviglio,Philadelphia Phillies,PHILS,1,1,1,2,1981,1982,1,-0.79,0.31,1.1,29,70,41,49,7,-42,0.0,189.0,189.0,0.0,0.0,0.0
lovij102,Joe Lovitto,Texas Rangers,RNGRS,2,3,2,5,1975,1977,2,-0.19,1.08,1.27,220,158,-62,533,480,-53,0.0,151.0,151.0,0.0,0.0,0.0
lovut001,Torey Lovullo,Detroit Tigers,TIGRS,1,1,1,2,1991,1994,3,-0.45,2.42,2.87,22,102,80,59,0,-59,0.0,1060.0,1060.0,0.0,0.0,0.0
lowdg101,Grover Lowdermilk,Chicago Cubs,CUBS,1,3,5,8,1912,1913,1,3.8,1.08,-2.72,112,82,-30,420,326,-94,0.0,0.0,0.0,7925.0,9780.0,1855.0
lowdg101,Grover Lowdermilk,Cincinnati Reds,REDS,1,1,1,2,1913,1913,0,0.0,1.62,1.62,0,78,78,0,58,58,0.0,500.0,500.0,0.0,0.0,0.0
lowdg101,Grover Lowdermilk,St.Louis Browns,ORLS,1,6,1,7,1921,1921,0,0.0,0.0,0.0,0,0,0,0,0,0,0.0,0.0,0.0,6600.0,0.0,-6600.0
lowdg101,Grover Lowdermilk,Minneapolis,Minneapolis,1,1,1,2,1921,1933,12,0.0,0.0,0.0,0,0,0,0,0,0,0.0,0.0,0.0,0.0,0.0,0.0
lowed001,Derek Lowe,Seattle Mariners,MARNRS,1,2,1,3,1997,1998,1,43.6,0.43,-43.17,1956,90,-1866,5862,0,-5862,3111.0,288.0,-2823.0,0.0,2300000.0,2300000.0
lowed001,Derek Lowe,Atlanta Braves,BRAVES,2,3,2,5,2011,2013,2,-0.36,0.43,0.79,23,73,50,4,0,-4,357.0,93.0,-264.0,15000000.0,0.0,-15000000.0
lowej001,John Lowenstein,Cleveland Indians,INDINS,3,4,3,7,1976,1979,3,1.78,5.31,3.53,491,315,-176,1873,1149,-724,0.0,405.0,405.0,0.0,0.0,0.0
lowej001,John Lowenstein,Toronto Blue Jays,BJAYS,1,1,1,2,1977,1978,1,-0.25,-0.33,-0.08,81,91,10,172,294,122,0.0,0.0,0.0,0.0,0.0,0.0
lowej001,John Lowenstein,Cleveland Indians,INDINS,2,4,5,9,1978,1980,2,-0.65,0.26,0.91,196,116,-80,422,243,-179,0.0,597.0,597.0,0.0,0.0,0.0
lowem001,Mike Lowell,New York Yankees,YANKS,2,5,5,10,1999,2000,1,12.83,0.4,-12.43,1124,23,-1101,4024,0,-4024,383.0,334.0,-49.0,0.0,4750000.0,4750000.0
lowem001,Mike Lowell,Florida Marlins,MARLNS,7,14,19,33,2005,2019,14,61.63,50.29,-11.34,1841,2297,456,4569,6863,2294,8636.0,5082.0,-3554.0,29867000.0,14191425.0,-15675575.0
lowem002,Mark Lowe,Seattle Mariners,MARNRS,5,8,8,16,2010,2014,4,3.8,5.22,1.42,345,797,452,623,2614,1991,753.0,1105.0,352.0,10564000.0,427200.0,-10136800.0
lowem002,Mark Lowe,Seattle Mariners,MARNRS,4,8,9,17,2015,2020,5,1.54,-0.4,-1.94,243,115,-128,269,160,-109,257.0,195.0,-62.0,0.0,532500.0,532500.0
lowen001,Nate Lowe,Tampa Bay Devil Rays,RAYS,1,3,3,6,2020,2020,0,2.36,0.0,-2.36,157,0,-157,642,0,-642,0.0,0.0,0.0,0.0,0.0,0.0
lowes001,Sean Lowe,St. Louis Cardinals,CARDS,1,1,1,2,1999,1999,0,5.1,0.0,-5.1,171,0,-171,3,0,-3,880.0,0.0,-880.0,0.0,0.0,0.0
lowes001,Sean Lowe,Chicago White Sox,WSOX,1,3,2,5,2001,2002,1,9.76,-1.6,-11.36,587,29,-558,520,5,-515,4516.0,401.0,-4115.0,300000.0,1933333.0,1633333.0
lowet001,Terrell Lowery,Texas Rangers,RNGRS,2,3,4,7,1996,1999,3,2.88,7.64,4.76,229,322,93,721,686,-35,0.0,1253.0,1253.0,225000.0,1963500.0,1738500.0
lownt101,Turk Lown,Chicago Cubs,CUBS,1,1,1,2,1958,1958,0,-0.14,-0.72,-0.58,22,18,-4,1,1,0,35.0,39.0,4.0,0.0,0.0,0.0
lowrj001,Jed Lowrie,Boston Red Sox,RSOX,2,6,3,9,2011,2019,8,10.72,7.46,-3.26,739,668,-71,662,2223,1561,960.0,157.0,-803.0,971000.0,4521000.0,3550000.0
lowrj001,Jed Lowrie,Houston Astros,ASTROS,2,3,5,8,2013,2020,7,13.46,8.06,-5.4,1071,776,-295,3907,2069,-1838,325.0,1629.0,1304.0,590100.0,0.0,-590100.0
lowrj001,Jed Lowrie,Houston Astros,ASTROS,1,1,1,2,2015,2015,0,7.25,0.0,-7.25,536,0,-536,2206,0,-2206,0.0,0.0,0.0,8000000.0,0.0,-8000000.0
lowrp101,Peanuts Lowrey,Chicago Cubs,CUBS,4,8,7,15,1949,1958,9,10.8,25.37,14.57,1114,1705,591,3490,6393,2903,130.0,197.0,67.0,0.0,10000.0,10000.0
loynm001,Mike Loynd,Texas Rangers,RNGRS,1,1,1,2,1988,1988,0,0.0,0.0,0.0,0,0,0,0,0,0,0.0,0.0,0.0,0.0,0.0,0.0
lubyh101,Hal Luby,Philadelphia Athletics,ATLTCS,2,4,2,6,1937,1946,9,1.34,-1.59,-2.93,190,315,125,733,931,198,0.0,888.0,888.0,5300.0,8000.0,2700.0
lucag001,Gary Lucas,San Diego Padres,PADRS,7,11,14,25,1983,1991,8,23.33,25.72,2.39,1598,2365,767,3397,3990,593,1995.0,3779.0,1784.0,4113333.0,1525000.0,-2588333.0
lucag001,Gary Lucas,Montreal Expos,NATEX,1,1,2,3,1985,1986,1,0.47,0.0,-0.47,75,0,-75,0,0,0,360.0,0.0,-360.0,513500.0,340000.0,-173500.0
lucaj001,Josh Lucas,St. Louis Cardinals,CARDS,1,1,1,2,2018,2018,0,-0.21,0.0,0.21,9,0,-9,0,0,0,43.0,0.0,-43.0,0.0,0.0,0.0
lucar101,Ray Lucas,Brooklyn Dodgers,DOGRS,3,5,3,8,1934,1939,5,16.05,2.05,-14.0,637,340,-297,2368,295,-2073,132.0,2357.0,2225.0,0.0,0.0,0.0
lucar102,Red Lucas,Boston Braves,BRAVES,15,35,27,62,1925,1952,27,61.82,121.75,59.93,3287,6434,3147,11058,21686,10628,3053.0,10767.0,7714.0,50600.0,31000.0,-19600.0
lucar102,Red Lucas,Cincinnati Reds,REDS,1,2,2,4,1933,1935,2,11.2,-0.59,-11.79,432,112,-320,556,459,-97,2051.0,0.0,-2051.0,0.0,0.0,0.0
luccj001,Joey Lucchesi,San Diego Padres,PADRS,1,5,1,6,2021,2021,0,0.12,3.49,3.37,21,68,47,11,57,46,115.0,544.0,429.0,0.0,0.0,0.0
lucie001,Elvis Luciano,Arizona Diamondbacks,DBACKS,1,2,1,3,2018,2018,0,-0.12,-0.27,-0.15,25,84,59,0,320,320,62.0,0.0,-62.0,0.0,0.0,0.0
lucrj001,Jonathan Lucroy,Milwaukee Brewers,BREWRS,4,10,6,16,2016,2018,2,-0.21,7.76,7.97,1054,270,-784,3356,840,-2516,449.0,87.0,-362.0,2550000.0,9400000.0,6850000.0
lucrj001,Jonathan Lucroy,Texas Rangers,RNGRS,1,1,1,2,2017,2017,0,0.82,0.0,-0.82,46,0,-46,175,0,-175,0.0,0.0,0.0,5250000.0,0.0,-5250000.0
ludef101,Fred Luderus,Chicago Cubs,CUBS,1,1,1,2,1910,1910,0,19.94,-0.27,-20.21,1311,4,-1307,5308,2,-5306,0.0,15.0,15.0,0.0,0.0,0.0
ludwe001,Eric Ludwick,New York Mets,METS,5,9,7,16,1996,1999,3,12.32,10.55,-1.77,1251,422,-829,4420,1607,-2813,1041.0,86.0,-955.0,5050000.0,4845000.0,-205000.0
ludwe001,Eric Ludwick,St. Louis Cardinals,CARDS,1,3,1,4,1997,1997,0,-0.38,2.04,2.42,256,51,-205,9,224,215,1161.0,0.0,-1161.0,395000.0,7150000.0,6755000.0
ludwe001,Eric Ludwick,Oakland Athletics,ATLTCS,2,2,3,5,1997,1998,1,-1.95,-0.55,1.4,164,35,-129,388,136,-252,98.0,0.0,-98.0,1000000.0,650000.0,-350000.0
ludwe001,Eric Ludwick,Detroit Tigers,TIGRS,1,1,1,2,1998,1999,1,-0.11,-0.26,-0.15,1,1,0,0,0,0,3.0,12.0,9.0,0.0,0.0,0.0
ludwr001,Ryan Ludwick,Oakland Athletics,ATLTCS,7,12,11,23,2002,2009,7,21.2,14.17,-7.03,1375,998,-377,3394,3388,-6,5508.0,716.0,-4792.0,947000.0,0.0,-947000.0
ludwr001,Ryan Ludwick,Texas Rangers,RNGRS,2,2,3,5,2003,2009,6,1.1,4.95,3.85,73,182,109,247,231,-16,0.0,2049.0,2049.0,0.0,4102400.0,4102400.0
ludwr001,Ryan Ludwick,St. Louis Cardinals,CARDS,1,1,2,3,2010,2015,5,-0.64,1.05,1.69,160,226,66,664,193,-471,0.0,1757.0,1757.0,5450000.0,0.0,-5450000.0
luebd101,Dick Luebke,Baltimore Orioles,ORLS,2,3,3,6,1962,1966,4,0.15,0.64,0.49,200,82,-118,614,176,-438,0.0,0.0,0.0,8500.0,0.0,-8500.0
luebl001,Larry Luebbers,Cincinnati Reds,REDS,2,4,2,6,1993,1996,3,1.51,1.69,0.18,53,302,249,0,11,11,157.0,464.0,307.0,817000.0,2412500.0,1595500.0
luebs101,Steve Luebber,Baltimore Orioles,ORLS,1,1,1,2,1982,1982,0,0.0,0.0,0.0,0,0,0,0,0,0,0.0,0.0,0.0,0.0,0.0,0.0
luecr001,Rick Luecken,Seattle Mariners,MARNRS,1,2,3,5,1986,1991,5,13.13,9.05,-4.08,676,330,-346,2684,625,-2059,71.0,1795.0,1724.0,85000.0,120000.0,35000.0
luecr001,Rick Luecken,Kansas City Royals,ROYALS,1,2,2,4,1989,1990,1,8.3,0.22,-8.08,256,133,-123,214,512,298,1914.0,0.0,-1914.0,1318000.0,662500.0,-655500.0
luekj001,Josh Lueke,Texas Rangers,RNGRS,1,4,2,6,2010,2012,2,2.66,1.99,-0.67,576,111,-465,1946,0,-1946,977.0,588.0,-389.0,0.0,10150000.0,10150000.0
luekj001,Josh Lueke,Seattle Mariners,MARNRS,3,4,3,7,2011,2014,3,1.81,2.37,0.56,234,184,-50,623,668,45,165.0,0.0,-165.0,414000.0,427200.0,13200.0
lugod001,Dawel Lugo,Toronto Blue Jays,BJAYS,1,1,2,3,2015,2015,0,0.0,-0.34,-0.34,0,33,33,0,92,92,0.0,0.0,0.0,0.0,3275000.0,3275000.0
lugod001,Dawel Lugo,Arizona Diamondbacks,DBACKS,1,3,1,4,2017,2017,0,-1.37,2.41,3.78,123,62,-61,423,257,-166,0.0,0.0,0.0,0.0,0.0,0.0
lugoj001,Julio Lugo,Tampa Bay Devil Rays,RAYS,1,1,2,3,2006,2008,2,-0.96,-0.26,0.7,49,16,-33,164,39,-125,0.0,0.0,0.0,4950000.0,0.0,-4950000.0
lugoj001,Julio Lugo,Boston Red Sox,RSOX,1,1,1,2,2009,2009,0,0.64,0.0,-0.64,51,0,-51,170,0,-170,0.0,0.0,0.0,9250000.0,825000.0,-8425000.0
lugor002,Ruddy Lugo,Milwaukee Brewers,BREWRS,1,2,1,3,2001,2001,0,1.1,0.82,-0.28,246,126,-120,839,432,-407,0.0,0.0,0.0,0.0,0.0,0.0
lugor002,Ruddy Lugo,Los Angeles Dodgers,DOGRS,1,1,1,2,2003,2003,0,0.0,-1.07,-1.07,0,52,52,0,114,114,0.0,0.0,0.0,0.0,0.0,0.0
lum-m101,Mike Lum,Atlanta Braves,BRAVES,1,1,1,2,1975,1979,4,0.12,-1.7,-1.82,251,379,128,469,1206,737,0.0,0.0,0.0,0.0,0.0,0.0
lumpj101,Jerry Lumpe,New York Yankees,YANKS,3,7,5,12,1959,1966,7,10.26,14.71,4.45,1028,1524,496,3254,3264,10,1701.0,4103.0,2402.0,84000.0,27500.0,-56500.0
lumpj101,Jerry Lumpe,Kansas City Athletics,ATLTCS,15,33,27,60,1963,1976,13,55.99,46.74,-9.25,6677,4175,-2502,14870,13661,-1209,10290.0,2197.0,-8093.0,387100.0,512500.0,125400.0
lunaf001,Fernando Lunar,Atlanta Braves,BRAVES,1,3,2,5,2000,2002,2,-0.42,1.16,1.58,107,214,107,224,759,535,2.0,6.0,4.0,800000.0,4146789.0,3346789.0
lunaf001,Fernando Lunar,Texas Rangers,RNGRS,1,1,1,2,2003,2003,0,0.0,0.0,0.0,0,0,0,0,0,0,0.0,0.0,0.0,0.0,0.0,0.0
lunah001,Hector Luna,St. Louis Cardinals,CARDS,1,1,1,2,2006,2006,0,-0.77,0.14,0.91,37,54,17,134,211,77,0.0,0.0,0.0,340000.0,4000000.0,3660000.0
lundg101,Gordy Lund,Cleveland Indians,INDINS,3,4,5,9,1967,1969,2,0.08,0.41,0.33,486,148,-338,67,15,-52,1385.0,377.0,-1008.0,75600.0,66000.0,-9600.0
lundg101,Gordy Lund,Baltimore Orioles,ORLS,1,2,1,3,1969,1972,3,-0.94,-0.21,0.73,159,174,15,161,395,234,993.0,0.0,-993.0,0.0,0.0,0.0
lundt101,Tom Lundstedt,Chicago Cubs,CUBS,1,1,1,2,1974,1978,4,-0.37,-0.22,0.15,18,27,9,32,40,8,0.0,0.0,0.0,0.0,0.0,0.0
luplj001,Jordan Luplow,Pittsburgh Pirates,PIRATS,1,2,3,5,2018,2021,3,1.8,0.18,-1.62,170,174,4,509,578,69,0.0,0.0,0.0,0.0,547800.0,547800.0
luplj001,Jordan Luplow,Cleveland Indians,INDINS,1,2,1,3,2021,2021,0,0.29,0.0,-0.29,29,0,-29,72,0,-72,11.0,0.0,-11.0,0.0,0.0,0.0
luqud101,Dolf Luque,Cincinnati Reds,REDS,1,1,1,2,1930,1930,0,3.36,-0.24,-3.6,100,16,-84,123,8,-115,911.0,77.0,-834.0,0.0,0.0,0.0
lushb101,Billy Lush,Detroit Tigers,TIGRS,1,1,2,3,1904,1910,6,2.88,22.67,19.79,138,462,324,580,681,101,0.0,5040.0,5040.0,0.0,0.0,0.0
lushj101,Johnny Lush,Philadelphia Phillies,PHILS,14,28,31,59,1907,1931,24,118.02,97.66,-20.36,5707,5480,-227,17636,19732,2096,16115.0,6766.0,-9349.0,25000.0,31850.0,6850.0
lutzj101,Joe Lutz,St.Louis Browns,ORLS,18,45,42,87,1951,1988,37,52.55,137.89,85.34,3971,8023,4052,7618,22268,14650,14427.0,15253.0,826.0,834433.0,135900.0,-698533.0
luulk001,Keith Luuloa,Anaheim Angels,ANGELS,1,2,3,5,2000,2000,0,0.0,0.0,0.0,0,0,0,0,0,0,0.0,0.0,0.0,0.0,0.0,0.0
luzaj001,Jesus Luzardo,Washington Nationals,NATEX,2,4,3,7,2017,2020,3,5.92,4.82,-1.1,246,410,164,62,3,-59,883.0,620.0,-263.0,8230366.0,0.0,-8230366.0
luzaj001,Jesus Luzardo,Oakland Athletics,ATLTCS,1,1,1,2,2021,2021,0,-0.51,1.92,2.43,23,56,33,19,251,232,172.0,0.0,-172.0,0.0,0.0,0.0
lylej001,Jordan Lyles,Houston Astros,ASTROS,3,4,5,9,2013,2016,3,5.67,6.06,0.39,774,357,-417,2028,1370,-658,843.0,53.0,-790.0,491700.0,4250000.0,3758300.0
lylej001,Jordan Lyles,Pittsburgh Pirates,PIRATS,1,1,1,2,2019,2019,0,1.85,0.0,-1.85,21,0,-21,22,0,-22,176.0,0.0,-176.0,2050000.0,0.0,-2050000.0
lyles101,Sparky Lyle,Boston Red Sox,RSOX,3,3,4,7,1972,1978,6,14.95,3.84,-11.11,571,480,-91,261,1229,968,2237.0,606.0,-1631.0,0.0,0.0,0.0
lyles101,Sparky Lyle,New York Yankees,YANKS,22,49,42,91,1978,1997,19,81.62,59.61,-22.01,5721,3574,-2147,13100,7561,-5539,18451.0,9704.0,-8747.0,5628333.0,4757500.0,-870833.0
lyles101,Sparky Lyle,Texas Rangers,RNGRS,2,2,2,4,1980,1983,3,1.64,1.16,-0.48,254,112,-142,10,293,283,645.0,0.0,-645.0,0.0,0.0,0.0
lynce001,Ed Lynch,Texas Rangers,RNGRS,8,16,17,33,1979,1987,8,13.69,12.82,-0.87,1524,510,-1014,3006,820,-2186,5064.0,3278.0,-1786.0,1017500.0,331000.0,-686500.0
lynce001,Ed Lynch,New York Mets,METS,1,1,2,3,1986,1990,4,1.13,0.08,-1.05,162,1,-161,51,1,-50,630.0,0.0,-630.0,530000.0,0.0,-530000.0
lyncj102,Jerry Lynch,Cincinnati Reds,REDS,2,2,3,5,1963,1964,1,0.52,0.45,-0.07,523,97,-426,1123,280,-843,0.0,0.0,0.0,26500.0,31000.0,4500.0
lynnf001,Fred Lynn,Boston Red Sox,RSOX,1,2,3,5,1981,1985,4,12.81,0.12,-12.69,526,77,-449,1947,135,-1812,774.0,448.0,-326.0,0.0,0.0,0.0
lynnf001,Fred Lynn,Baltimore Orioles,ORLS,2,3,5,8,1988,1989,1,1.0,0.0,-1.0,152,0,-152,513,0,-513,0.0,0.0,0.0,1540000.0,0.0,-1540000.0
lynnl001,Lance Lynn,Minnesota Twins,TWINS,2,3,3,6,2018,2019,1,0.65,0.29,-0.36,82,37,-45,149,141,-8,163.0,0.0,-163.0,12000000.0,0.0,-12000000.0
lynnl001,Lance Lynn,Texas Rangers,RNGRS,1,1,2,3,2020,2020,0,5.38,0.0,-5.38,30,0,-30,5,0,-5,471.0,0.0,-471.0,11333334.0,0.0,-11333334.0
lyona101,Al Lyons,Pittsburgh Pirates,PIRATS,2,5,3,8,1947,1949,2,5.52,3.82,-1.7,394,236,-158,1349,883,-466,38.0,0.0,-38.0,0.0,0.0,0.0
lyona101,Al Lyons,Boston Braves,BRAVES,1,3,1,4,1948,1952,4,0.0,-0.21,-0.21,0,104,104,0,35,35,0.0,376.0,376.0,0.0,0.0,0.0
lyonb003,Brandon Lyon,Boston Red Sox,RSOX,3,9,6,15,2003,2008,5,19.22,17.72,-1.5,1732,227,-1505,2840,14,-2826,1848.0,2473.0,625.0,943500.0,12066667.0,11123167.0
lyonb003,Brandon Lyon,Pittsburgh Pirates,PIRATS,5,8,9,17,2003,2013,10,4.43,21.03,16.6,571,1401,830,955,4379,3424,773.0,467.0,-306.0,13800000.0,0.0,-13800000.0
lyonb003,Brandon Lyon,Boston Red Sox,RSOX,1,4,1,5,2003,2008,5,0.73,17.72,16.99,728,123,-605,51,11,-40,1381.0,2025.0,644.0,634000.0,10000000.0,9366000.0
lyonb003,Brandon Lyon,Houston Astros,ASTROS,4,10,10,20,2012,2019,7,17.22,11.07,-6.15,1238,246,-992,2359,341,-2018,4222.0,1816.0,-2406.0,8335000.0,6555000.0,-1780000.0
lyonc001,Curt Lyons,Cincinnati Reds,REDS,1,1,2,3,1997,1998,1,0.0,0.02,0.02,0,6,6,0,9,9,0.0,0.0,0.0,0.0,0.0,0.0
lyong101,George Lyons,St.Louis Browns,ORLS,29,55,62,117,1924,1952,28,152.63,143.12,-9.51,7484,11236,3752,22593,31279,8686,18747.0,30694.0,11947.0,281100.0,219150.0,-61950.0
lyong101,George Lyons,St. Louis Cardinals,CARDS,1,3,1,4,1921,1921,0,0.0,0.87,0.87,0,76,76,0,77,77,0.0,625.0,625.0,0.0,0.0,0.0
lyons001,Steve Lyons,Boston Red Sox,RSOX,1,1,1,2,1986,1986,0,1.71,1.94,0.23,498,16,-482,1529,0,-1529,6.0,313.0,307.0,0.0,1132652.0,1132652.0
lysar001,Rick Lysander,Oakland Athletics,ATLTCS,1,1,1,2,1981,1983,2,0.0,0.27,0.27,0,76,76,0,157,157,0.0,0.0,0.0,0.0,0.0,0.0
lysar001,Rick Lysander,Houston Astros,ASTROS,1,1,1,2,1983,1983,0,0.29,0.0,-0.29,132,0,-132,0,0,0,728.0,0.0,-728.0,0.0,0.0,0.0
lyttj101,Jim Lyttle,New York Yankees,YANKS,1,1,1,2,1971,1972,1,-0.55,-0.52,0.03,44,14,-30,84,3,-81,0.0,50.0,50.0,16000.0,7500.0,-8500.0
lyttj101,Jim Lyttle,Chicago White Sox,WSOX,1,1,1,2,1973,1973,0,0.0,0.0,0.0,0,5,5,0,1,1,0.0,0.0,0.0,0.0,0.0,0.0
maasd101,Duke Maas,Detroit Tigers,TIGRS,4,12,12,24,1957,1964,7,6.47,14.38,7.91,1197,947,-250,3186,1303,-1883,1459.0,3692.0,2233.0,20000.0,9000.0,-11000.0
maasd101,Duke Maas,Kansas City Athletics,ATLTCS,3,4,4,8,1958,1960,2,-3.45,4.79,8.24,286,319,33,181,498,317,1056.0,779.0,-277.0,12500.0,34500.0,22000.0
maasd101,Duke Maas,Los Angeles Angels,ANGELS,1,1,1,2,1961,1961,0,-0.14,-0.79,-0.65,2,21,19,0,55,55,1.0,0.0,-1.0,0.0,0.0,0.0
mabeb101,Bob Mabe,St. Louis Cardinals,CARDS,2,5,5,10,1958,1963,5,8.1,2.95,-5.15,969,458,-511,3320,993,-2327,89.0,111.0,22.0,0.0,0.0,0.0
mabrj001,John Mabry,Seattle Mariners,MARNRS,1,2,1,3,2000,2001,1,0.34,1.23,0.89,184,142,-42,130,469,339,215.0,0.0,-215.0,1850000.0,1750000.0,-100000.0
mabrj001,John Mabry,Philadelphia Phillies,PHILS,3,4,4,8,2002,2004,2,2.03,1.6,-0.43,204,147,-57,454,214,-240,206.0,112.0,-94.0,500000.0,1565000.0,1065000.0
macdh101,Harvey MacDonald,Philadelphia Phillies,PHILS,6,11,11,22,1928,1941,13,5.03,58.02,52.99,553,1939,1386,2026,6396,4370,324.0,2895.0,2571.0,19900.0,10000.0,-9900.0
macdm001,Mike MacDougal,Kansas City Royals,ROYALS,6,12,12,24,2006,2021,15,13.66,47.45,33.79,983,2988,2005,2084,10524,8440,3468.0,2429.0,-1039.0,27030000.0,15358267.0,-11671733.0
macfd101,Danny MacFayden,Boston Red Sox,RSOX,10,23,20,43,1932,1956,24,31.6,39.08,7.48,3187,3307,120,9337,10076,739,7417.0,8024.0,607.0,183500.0,102122.0,-81378.0
macfd101,Danny MacFayden,Boston Braves,BRAVES,1,1,2,3,1939,1940,1,0.77,-0.39,-1.16,70,8,-62,29,3,-26,274.0,28.0,-246.0,10000.0,7000.0,-3000.0
macfm001,Mike Macfarlane,Kansas City Royals,ROYALS,1,1,2,3,1998,1998,0,0.52,0.37,-0.15,159,66,-93,474,229,-245,0.0,0.0,0.0,725000.0,450000.0,-275000.0
macha001,Anderson Machado,Philadelphia Phillies,PHILS,1,2,2,4,2004,2004,0,0.46,-0.03,-0.49,65,53,-12,87,1,-86,206.0,76.0,-130.0,0.0,500000.0,500000.0
macha002,Alejandro Machado,Atlanta Braves,BRAVES,1,2,1,3,2001,2001,0,-0.65,0.03,0.68,44,49,5,1,163,162,205.0,0.0,-205.0,0.0,2300000.0,2300000.0
macha002,Alejandro Machado,Kansas City Royals,ROYALS,1,2,1,3,2003,2004,1,0.42,0.53,0.11,118,46,-72,83,0,-83,746.0,125.0,-621.0,0.0,3700000.0,3700000.0
macha002,Alejandro Machado,Washington Nationals,NATEX,1,1,1,2,2005,2005,0,0.23,0.0,-0.23,10,0,-10,6,0,-6,0.0,0.0,0.0,0.0,0.0,0.0
machd101,Dave Machemer,California Angels,ANGELS,2,4,2,6,1976,1979,3,0.01,3.49,3.48,36,153,117,0,0,0,119.0,938.0,819.0,0.0,0.0,0.0
machd101,Dave Machemer,Boston Red Sox,RSOX,1,1,1,2,1977,1977,0,0.11,0.0,-0.11,10,0,-10,25,0,-25,0.0,0.0,0.0,0.0,0.0,0.0
machj001,Julio Machado,New York Mets,METS,1,2,2,4,1990,1993,3,2.61,2.24,-0.37,84,232,148,0,659,659,559.0,0.0,-559.0,200000.0,150000.0,-50000.0
machm001,Manny Machado,Baltimore Orioles,ORLS,1,1,5,6,2018,2020,2,2.49,0.11,-2.38,66,12,-54,296,41,-255,0.0,0.0,0.0,16000000.0,0.0,-16000000.0
machr001,Robert Machado,Chicago Cubs,CUBS,1,1,1,2,2002,2002,0,0.1,0.0,-0.1,51,0,-51,169,0,-169,0.0,0.0,0.0,277500.0,0.0,-277500.0
macij001,Jose Macias,Detroit Tigers,TIGRS,1,1,1,2,2002,2002,0,-0.82,-1.4,-0.58,201,89,-112,540,292,-248,0.0,0.0,0.0,375000.0,270000.0,-105000.0
macij001,Jose Macias,Montreal Expos,NATEX,1,1,1,2,2003,2003,0,-0.64,0.0,0.64,210,0,-210,394,0,-394,0.0,0.0,0.0,825000.0,0.0,-825000.0
mackj101,Joe Mack,St. Louis Cardinals,CARDS,1,1,1,2,1944,1944,0,-0.32,0.0,0.32,66,0,-66,303,0,-303,0.0,0.0,0.0,0.0,0.0,0.0
mackj101,Joe Mack,Toronto,Toronto,1,2,1,3,1942,1943,1,0.32,0.0,-0.32,4,0,-4,2,0,-2,21.0,0.0,-21.0,0.0,0.0,0.0
mackk101,Ken MacKenzie,New York Mets,METS,1,1,1,2,1963,1963,0,-0.17,-0.07,0.1,16,18,2,0,3,3,26.0,57.0,31.0,0.0,0.0,0.0
mackk101,Ken MacKenzie,St. Louis Cardinals,CARDS,13,26,21,47,1963,1972,9,30.59,2.13,-28.46,3317,763,-2554,8519,1730,-6789,1892.0,703.0,-1189.0,32500.0,24000.0,-8500.0
mackp101,Pete Mackanin,Texas Rangers,RNGRS,2,3,3,6,1974,1976,2,4.6,-0.5,-5.1,567,57,-510,1479,176,-1303,1066.0,63.0,-1003.0,14000.0,110000.0,96000.0
mackp101,Pete Mackanin,Philadelphia Phillies,PHILS,1,1,1,2,1979,1979,0,-0.3,0.0,0.3,185,0,-185,579,0,-579,0.0,0.0,0.0,0.0,0.0,0.0
mackr001,Rob Mackowiak,Pittsburgh Pirates,PIRATS,3,4,7,11,2005,2016,11,1.61,9.69,8.08,343,1504,1161,834,2178,1344,148.0,3661.0,3513.0,11000000.0,1641425.0,-9358575.0
mackr001,Rob Mackowiak,Chicago White Sox,WSOX,2,3,2,5,2007,2011,4,-1.19,-0.64,0.55,95,318,223,97,1445,1348,372.0,0.0,-372.0,2750000.0,10000000.0,7250000.0
mackr101,Ray Mack,Cleveland Indians,INDINS,3,5,5,10,1946,1955,9,0.0,7.38,7.38,349,809,460,998,1967,969,633.0,1677.0,1044.0,0.0,0.0,0.0
macks001,Shane Mack,Oakland Athletics,ATLTCS,1,2,1,3,1998,1999,1,0.37,0.52,0.15,66,159,93,229,474,245,0.0,0.0,0.0,450000.0,725000.0,275000.0
macle001,Evan MacLane,New York Mets,METS,1,1,2,3,2006,2007,1,0.0,0.23,0.23,0,164,164,0,617,617,0.0,0.0,0.0,0.0,10213898.0,10213898.0
macrm001,Matt Macri,Colorado Rockies,ROCKS,1,1,1,2,2007,2007,0,-0.07,-0.05,0.02,18,20,2,36,2,-34,0.0,39.0,39.0,0.0,3100000.0,3100000.0
maddc101,Clarence Maddern,Chicago Cubs,CUBS,1,1,1,2,1951,1951,0,-0.14,0.0,0.14,11,0,-11,12,0,-12,0.0,0.0,0.0,0.0,0.0,0.0
maddc101,Clarence Maddern,Cleveland Indians,INDINS,1,1,1,2,1951,1951,0,0.0,0.0,0.0,0,0,0,0,0,0,0.0,0.0,0.0,0.0,0.0,0.0
madde101,Elliott Maddox,Detroit Tigers,TIGRS,3,8,7,15,1970,1979,9,1.68,25.88,24.2,545,2212,1667,1182,7310,6128,747.0,4256.0,3509.0,232600.0,149500.0,-83100.0
madde101,Elliott Maddox,New York Yankees,YANKS,1,2,1,3,1977,1979,2,0.81,-0.33,-1.14,49,160,111,128,324,196,0.0,0.0,0.0,0.0,0.0,0.0
maddg001,Garry Maddox,San Francisco Giants,GIANTS,3,6,4,10,1975,1983,8,28.09,28.47,0.38,1615,1896,281,6128,7295,1167,0.0,0.0,0.0,0.0,0.0,0.0
maddg002,Greg Maddux,Chicago Cubs,CUBS,1,1,1,2,2006,2007,1,1.68,-0.81,-2.49,38,87,49,42,286,244,343.0,0.0,-343.0,9000000.0,3200000.0,-5800000.0
maddg002,Greg Maddux,San Diego Padres,PADRS,1,1,2,3,2008,2008,0,-0.25,0.0,0.25,14,0,-14,13,0,-13,122.0,0.0,-122.0,10000000.0,0.0,-10000000.0
maddm001,Mike Madden,Milwaukee Brewers,BREWRS,2,5,4,9,1982,1986,4,18.77,6.8,-11.97,1695,100,-1595,3977,0,-3977,2039.0,1974.0,-65.0,625000.0,1425000.0,800000.0
maddm002,Mike Maddux,San Diego Padres,PADRS,2,2,3,5,1992,1995,3,0.3,2.43,2.13,250,204,-46,9,12,3,532.0,427.0,-105.0,810000.0,0.0,-810000.0
maddm003,Morris Madden,Detroit Tigers,TIGRS,1,2,1,3,1987,1988,1,0.01,-0.36,-0.37,138,58,-80,389,196,-193,59.0,0.0,-59.0,170000.0,317500.0,147500.0
madel001,Luis Madero,Arizona Diamondbacks,DBACKS,1,1,1,2,2017,2017,0,0.0,0.04,0.04,0,48,48,0,0,0,0.0,56.0,56.0,0.0,535000.0,535000.0
madia101,Art Madison,Pittsburgh Pirates,PIRATS,4,11,16,27,1899,1914,15,23.91,73.99,50.08,1271,3182,1911,4723,12859,8136,1693.0,797.0,-896.0,5000.0,11750.0,6750.0
madid101,Dave Madison,St.Louis Browns,ORLS,8,14,16,30,1952,1960,8,32.49,23.42,-9.07,2082,1835,-247,5453,4904,-549,5614.0,2626.0,-2988.0,41000.0,25800.0,-15200.0
madis001,Scotti Madison,Minnesota Twins,TWINS,1,2,2,4,1982,1984,2,0.0,5.34,5.34,0,201,201,0,513,513,0.0,1207.0,1207.0,0.0,0.0,0.0
madlb001,Bill Madlock,Texas Rangers,RNGRS,10,21,18,39,1973,1986,13,53.55,28.53,-25.02,2537,1434,-1103,5090,3729,-1361,9799.0,4115.0,-5684.0,214000.0,360000.0,146000.0
madlb001,Bill Madlock,Chicago Cubs,CUBS,3,6,5,11,1977,1982,5,6.0,5.18,-0.82,669,907,238,2312,3575,1263,152.0,0.0,-152.0,320000.0,0.0,-320000.0
madlb001,Bill Madlock,San Francisco Giants,GIANTS,11,23,25,48,1979,1998,19,47.48,66.07,18.59,2727,4533,1806,5432,5570,138,5201.0,15628.0,10427.0,10487778.0,6966667.0,-3521111.0
madlb001,Bill Madlock,Pittsburgh Pirates,PIRATS,1,1,3,4,1985,1990,5,2.02,14.19,12.17,166,1259,1093,618,4250,3632,0.0,0.0,0.0,975500.0,0.0,-975500.0
madra001,Alex Madrid,Milwaukee Brewers,BREWRS,1,1,1,2,1988,1989,1,0.25,-0.38,-0.63,22,8,-14,10,18,8,123.0,0.0,-123.0,0.0,395000.0,395000.0
madrn001,Nick Madrigal,Chicago White Sox,WSOX,1,2,1,3,2021,2021,0,0.52,-0.03,-0.55,48,26,-22,0,0,0,86.0,69.0,-17.0,0.0,16000000.0,16000000.0
madsr001,Ryan Madson,Oakland Athletics,ATLTCS,3,5,6,11,2017,2021,4,3.83,7.65,3.82,466,297,-169,88,313,225,792.0,885.0,93.0,0.0,563700.0,563700.0
madsr001,Ryan Madson,Washington Nationals,NATEX,1,1,1,2,2018,2018,0,-0.19,0.0,0.19,18,0,-18,0,0,0,25.0,0.0,-25.0,7666666.0,0.0,-7666666.0
maduc001,Calvin Maduro,Baltimore Orioles,ORLS,1,2,2,4,1996,1997,1,0.34,0.44,0.1,89,89,0,71,320,249,679.0,0.0,-679.0,0.0,3250000.0,3250000.0
maedk001,Kenta Maeda,Los Angeles Dodgers,DOGRS,1,3,3,6,2020,2020,0,1.94,0.24,-1.7,36,23,-13,4,0,-4,519.0,70.0,-449.0,0.0,0.0,0.0
magad001,Dave Magadan,Florida Marlins,MARLNS,2,3,3,6,1993,1994,1,-0.22,1.85,2.07,73,194,121,269,671,402,12.0,0.0,-12.0,900000.0,900000.0,0.0
magad001,Dave Magadan,Seattle Mariners,MARNRS,2,2,3,5,1993,1995,2,2.39,0.2,-2.19,178,35,-143,529,88,-441,133.0,12.0,-121.0,0.0,200000.0,200000.0
magel101,Lee Magee,New York Yankees,YANKS,1,1,1,2,1917,1917,0,-0.31,0.29,0.6,36,25,-11,127,100,-27,0.0,0.0,0.0,8333.0,4000.0,-4333.0
magel101,Lee Magee,St.Louis Browns,ORLS,1,1,1,2,1918,1919,1,2.92,1.37,-1.55,119,88,-31,514,268,-246,0.0,0.0,0.0,0.0,0.0,0.0
magel101,Lee Magee,Brooklyn Dodgers,DOGRS,1,1,1,2,1919,1919,0,1.59,0.49,-1.1,79,32,-47,299,89,-210,0.0,0.0,0.0,0.0,0.0,0.0
mages101,Sherry Magee,Philadelphia Phillies,PHILS,4,6,8,14,1914,1923,9,18.25,3.64,-14.61,978,1038,60,3812,3992,180,0.0,0.0,0.0,14500.0,8200.0,-6300.0
magew001,Wendell Magee,Philadelphia Phillies,PHILS,2,2,2,4,2000,2001,1,1.58,0.0,-1.58,278,0,-278,795,0,-795,0.0,0.0,0.0,0.0,0.0,0.0
magew001,Wendell Magee,Cleveland Indians,INDINS,2,2,2,4,2003,2003,0,0.0,0.0,0.0,0,0,0,0,0,0,0.0,0.0,0.0,0.0,0.0,0.0
magim001,Matt Magill,Los Angeles Dodgers,DOGRS,1,1,1,2,2014,2015,1,-0.02,0.21,0.23,10,33,23,0,72,72,13.0,0.0,-13.0,0.0,1760000.0,1760000.0
magnd001,Damien Magnifico,Milwaukee Brewers,BREWRS,1,1,1,2,2017,2017,0,0.0,0.0,0.0,0,0,0,0,0,0,0.0,0.0,0.0,0.0,0.0,0.0
magnd001,Damien Magnifico,Baltimore Orioles,ORLS,1,1,1,2,2017,2017,0,0.01,0.0,-0.01,1,0,-1,0,0,0,1.0,0.0,-1.0,0.0,0.0,0.0
magnt001,Trystan Magnuson,Toronto Blue Jays,BJAYS,1,2,1,3,2010,2013,3,-0.15,1.6,1.75,9,345,336,0,1185,1185,44.0,0.0,-44.0,0.0,1350000.0,1350000.0
magog101,George Magoon,Brooklyn Dodgers,DOGRS,2,4,2,6,1899,1902,3,3.35,2.49,-0.86,192,219,27,742,830,88,0.0,0.0,0.0,0.0,0.0,0.0
magog101,George Magoon,Baltimore Orioles,BLN,2,3,2,5,1899,1906,7,0.15,0.95,0.8,146,62,-84,513,265,-248,204.0,0.0,-204.0,0.0,0.0,0.0
magog101,George Magoon,Cincinnati Reds,REDS,1,1,2,3,1903,1905,2,-0.01,1.3,1.31,94,324,230,382,1382,1000,0.0,0.0,0.0,0.0,0.0,0.0
magog101,George Magoon,Chicago White Sox,WSOX,1,1,1,2,1904,1905,1,0.0,-0.01,-0.01,0,4,4,0,12,12,0.0,0.0,0.0,0.0,0.0,0.0
magrc001,Chris Magruder,San Francisco Giants,GIANTS,1,3,1,4,2001,2001,0,1.58,0.17,-1.41,103,49,-54,31,174,143,323.0,0.0,-323.0,0.0,6000000.0,6000000.0
magrc001,Chris Magruder,Texas Rangers,RNGRS,1,1,1,2,2002,2002,0,-0.08,0.0,0.08,96,0,-96,308,0,-308,0.0,0.0,0.0,0.0,0.0,0.0
magrp101,Pete Magrini,Boston Red Sox,RSOX,1,2,1,3,1967,1968,1,2.06,-0.63,-2.69,128,113,-15,32,358,326,431.0,0.0,-431.0,0.0,64000.0,64000.0
magrt001,Tom Magrann,Baltimore Orioles,ORLS,1,2,2,4,1988,1988,0,-0.33,0.0,0.33,9,0,-9,10,0,-10,0.0,0.0,0.0,0.0,0.0,0.0
maguf101,Freddie Maguire,Chicago Cubs,CUBS,1,6,1,7,1928,1932,4,4.13,16.12,11.99,1036,317,-719,2232,1321,-911,4216.0,0.0,-4216.0,13000.0,30600.0,17600.0
maguj101,Jack Maguire,St.Louis Browns,ORLS,2,5,3,8,1951,1952,1,0.64,0.33,-0.31,156,96,-60,332,319,-13,0.0,0.0,0.0,0.0,20000.0,20000.0
mahaa102,Art Mahaffey,Philadelphia Phillies,PHILS,9,17,16,33,1965,1984,19,32.54,23.78,-8.76,2044,2671,627,6114,5833,-281,1729.0,2166.0,437.0,32000.0,138000.0,106000.0
mahaa102,Art Mahaffey,St. Louis Cardinals,CARDS,1,3,3,6,1967,1967,0,-0.52,-0.9,-0.38,197,52,-145,651,76,-575,0.0,0.0,0.0,0.0,0.0,0.0
mahar001,Ron Mahay,Texas Rangers,RNGRS,8,20,28,48,2007,2021,14,23.19,61.95,38.76,1540,2663,1123,4320,8186,3866,2620.0,5087.0,2467.0,14431080.0,1106250.0,-13324830.0
mahar101,Roy Mahaffey,St.Louis Browns,ORLS,1,2,1,3,1937,1937,0,0.0,-0.76,-0.76,0,52,52,0,35,35,0.0,317.0,317.0,0.0,0.0,0.0
mahar101,Roy Mahaffey,Portland,Portland,1,2,4,6,1929,1933,4,5.27,0.0,-5.27,394,0,-394,395,0,-395,2946.0,0.0,-2946.0,0.0,7500.0,7500.0
mahlg101,Greg Mahlberg,Texas Rangers,RNGRS,1,2,2,4,1980,1983,3,0.0,-0.43,-0.43,0,24,24,0,73,73,0.0,0.0,0.0,0.0,0.0,0.0
mahlm001,Mickey Mahler,Pittsburgh Pirates,PIRATS,2,3,3,6,1981,1986,5,0.66,9.75,9.09,117,671,554,351,2696,2345,43.0,0.0,-43.0,0.0,0.0,0.0
mahlm001,Mickey Mahler,St. Louis Cardinals,CARDS,1,1,1,2,1985,1988,3,0.28,0.03,-0.25,18,166,148,17,217,200,145.0,0.0,-145.0,0.0,0.0,0.0
mahob101,Bob Mahoney,St.Louis Browns,ORLS,16,41,37,78,1952,1988,36,52.13,131.97,79.84,3638,7667,4029,6759,21898,15139,14284.0,13293.0,-991.0,815833.0,128400.0,-687433.0
mahoj101,Jim Mahoney,Los Angeles Angels,ANGELS,1,1,1,2,1960,1960,0,-0.37,0.0,0.37,43,0,-43,114,0,-114,0.0,0.0,0.0,0.0,0.0,0.0
mahoj101,Jim Mahoney,Washington Senators,RNGRS,4,7,5,12,1961,1970,9,4.25,0.29,-3.96,404,337,-67,701,1154,453,1913.0,6.0,-1907.0,0.0,8000.0,8000.0
mahoj101,Jim Mahoney,Houston Astros,ASTROS,1,2,1,3,1966,1966,0,0.0,-0.43,-0.43,0,21,21,0,38,38,0.0,0.0,0.0,0.0,20000.0,20000.0
mahop001,Pat Mahomes,Minnesota Twins,TWINS,1,1,1,2,1996,1996,0,-0.22,0.0,0.22,21,0,-21,0,0,0,67.0,0.0,-67.0,202500.0,0.0,-202500.0
mahop002,Paul Maholm,Chicago Cubs,CUBS,3,5,4,9,2012,2018,6,5.31,1.57,-3.74,650,341,-309,761,587,-174,1181.0,55.0,-1126.0,2100000.0,0.0,-2100000.0
mahtm001,Mikie Mahtook,Tampa Bay Devil Rays,RAYS,2,2,2,4,2017,2017,0,1.23,0.13,-1.1,304,52,-252,655,200,-455,229.0,0.0,-229.0,0.0,7250000.0,7250000.0
mailw101,Duster Mails,Sacramento,Sacramento,1,1,3,4,1920,1920,0,4.21,0.0,-4.21,138,0,-138,140,0,-140,1087.0,0.0,-1087.0,0.0,0.0,0.0
mailw101,Duster Mails,Oakland,Oakland,1,1,5,6,1924,1927,3,0.2,0.0,-0.2,44,0,-44,50,0,-50,396.0,0.0,-396.0,0.0,6900.0,6900.0
mainj001,John Maine,Baltimore Orioles,ORLS,1,2,1,3,2006,2007,1,4.49,1.83,-2.66,234,33,-201,209,9,-200,1690.0,549.0,-1141.0,0.0,0.0,0.0
mains001,Scott Maine,Arizona Diamondbacks,DBACKS,1,2,1,3,2009,2011,2,-0.04,-1.17,-1.13,79,197,118,2,2,0,122.0,322.0,200.0,0.0,1625000.0,1625000.0
mairo001,Oswaldo Mairena,New York Yankees,YANKS,5,7,6,13,2000,2007,7,-0.77,1.65,2.42,50,219,169,84,143,59,190.0,789.0,599.0,6000000.0,7500000.0,1500000.0
mairo001,Oswaldo Mairena,Chicago Cubs,CUBS,2,3,2,5,2001,2002,1,-0.69,3.07,3.76,85,229,144,73,800,727,101.0,68.0,-33.0,665000.0,6500000.0,5835000.0
maisf101,Fritz Maisel,New York Yankees,YANKS,5,14,12,26,1918,1931,13,64.97,61.9,-3.07,2396,2093,-303,7435,5797,-1638,6303.0,6917.0,614.0,44500.0,41500.0,-3000.0
maisf101,Fritz Maisel,Baltimore,Baltimore,1,1,3,4,1913,1914,1,7.77,0.0,-7.77,502,0,-502,2095,0,-2095,0.0,0.0,0.0,0.0,0.0,0.0
majeg001,Gary Majewski,Chicago White Sox,WSOX,3,9,5,14,2001,2003,2,-3.34,5.16,8.5,321,102,-219,107,7,-100,601.0,942.0,341.0,0.0,0.0,0.0
majeg001,Gary Majewski,Los Angeles Dodgers,DOGRS,1,3,2,5,2001,2001,0,0.0,0.96,0.96,0,24,24,0,27,27,0.0,238.0,238.0,0.0,5950000.0,5950000.0
majeg001,Gary Majewski,Chicago White Sox,WSOX,1,2,1,3,2004,2005,1,7.36,0.15,-7.21,749,178,-571,35,716,681,1328.0,0.0,-1328.0,0.0,3000000.0,3000000.0
majeg001,Gary Majewski,Washington Nationals,NATEX,1,5,3,8,2006,2009,3,-0.61,0.43,1.04,705,795,90,181,2860,2679,809.0,139.0,-670.0,1352000.0,4550000.0,3198000.0
majeh101,Hank Majeski,Philadelphia Athletics,ATLTCS,1,1,1,2,1949,1950,1,1.96,-0.18,-2.14,134,10,-124,503,1,-502,0.0,17.0,17.0,0.0,0.0,0.0
majeh101,Hank Majeski,Chicago White Sox,WSOX,28,54,45,99,1951,1969,18,86.15,62.63,-23.52,7059,5271,-1788,17933,11733,-6200,13187.0,9922.0,-3265.0,288750.0,292500.0,3750.0
majeh101,Hank Majeski,Cleveland Indians,INDINS,1,1,1,2,1955,1957,2,-0.41,0.18,0.59,16,19,3,43,47,4,0.0,0.0,0.0,0.0,0.0,0.0
maksm001,Mike Maksudian,Chicago White Sox,WSOX,1,2,2,4,1988,1989,1,0.0,0.5,0.5,0,6,6,0,0,0,0.0,39.0,39.0,0.0,0.0,0.0
maldc001,Candy Maldonado,Los Angeles Dodgers,DOGRS,1,1,1,2,1985,1988,3,4.89,1.71,-3.18,522,161,-361,1862,389,-1473,0.0,0.0,0.0,140000.0,462500.0,322500.0
maldc001,Candy Maldonado,Milwaukee Brewers,BREWRS,1,1,2,3,1991,1993,2,3.82,-0.04,-3.86,250,33,-217,958,34,-924,0.0,0.0,0.0,875000.0,0.0,-875000.0
maldc001,Candy Maldonado,Chicago Cubs,CUBS,1,1,1,2,1993,1995,2,-0.34,2.54,2.88,70,120,50,205,392,187,0.0,0.0,0.0,1650000.0,975000.0,-675000.0
maldc002,Carlos Maldonado,Kansas City Royals,ROYALS,1,1,1,2,1992,1992,0,0.08,0.0,-0.08,30,0,-30,0,0,0,112.0,0.0,-112.0,0.0,0.0,0.0
maldc003,Carlos Maldonado,Seattle Mariners,MARNRS,1,1,1,2,2000,2000,0,0.0,-0.12,-0.12,0,2,2,0,1,1,0.0,0.0,0.0,0.0,0.0,0.0
maldm001,Martin Maldonado,Milwaukee Brewers,BREWRS,1,2,1,3,2016,2018,2,1.97,-1.05,-3.02,216,84,-132,761,259,-502,0.0,0.0,0.0,1125000.0,0.0,-1125000.0
maldm001,Martin Maldonado,Anaheim Angels,ANGELS,1,1,2,3,2018,2018,0,1.45,0.0,-1.45,240,0,-240,803,0,-803,0.0,0.0,0.0,3900000.0,0.0,-3900000.0
maldm001,Martin Maldonado,Kansas City Royals,ROYALS,1,1,1,2,2019,2020,1,-0.37,0.41,0.78,4,17,13,13,1,-12,0.0,208.0,208.0,2500000.0,2440000.0,-60000.0
maldm001,Martin Maldonado,Chicago Cubs,CUBS,2,2,2,4,2019,2020,1,4.51,-0.1,-4.61,379,44,-335,1200,93,-1107,0.0,0.0,0.0,0.0,583600.0,583600.0
malej101,Jim Maler,Seattle Mariners,MARNRS,1,1,1,2,1984,1984,0,0.0,0.0,0.0,0,0,0,0,0,0,0.0,0.0,0.0,0.0,0.0,0.0
mallb002,Brian Mallette,Milwaukee Brewers,BREWRS,7,14,15,29,2002,2012,10,36.64,23.05,-13.59,2498,2040,-458,9346,4727,-4619,883.0,6494.0,5611.0,10372000.0,19975667.0,9603667.0
malls101,Sheldon Mallory,Kansas City Royals,ROYALS,1,1,1,2,1976,1980,4,0.0,0.79,0.79,0,452,452,0,1214,1214,0.0,0.0,0.0,0.0,0.0,0.0
malls101,Sheldon Mallory,Oakland Athletics,ATLTCS,1,1,1,2,1978,1978,0,0.0,0.7,0.7,0,47,47,0,97,97,0.0,0.0,0.0,0.0,0.0,0.0
malls101,Sheldon Mallory,Toronto Blue Jays,BJAYS,1,1,1,2,1979,1979,0,0.0,-0.32,-0.32,0,42,42,0,0,0,0.0,273.0,273.0,0.0,0.0,0.0
malob101,Billy Maloney,Chicago Cubs,CUBS,1,5,1,6,1905,1913,8,5.14,19.07,13.93,814,1001,187,3290,4393,1103,0.0,0.0,0.0,0.0,0.0,0.0
maloe101,Eddie Malone,St. Louis Cardinals,CARDS,1,1,1,2,1947,1947,0,0.0,0.0,0.0,0,0,0,0,0,0,0.0,0.0,0.0,0.0,0.0,0.0
maloe101,Eddie Malone,New York Yankees,YANKS,11,30,24,54,1950,1970,20,23.49,50.63,27.14,3914,4260,346,10162,9994,-168,6791.0,6740.0,-51.0,128000.0,55500.0,-72500.0
maloe101,Eddie Malone,New York Yankees,YANKS,1,3,1,4,1951,1955,4,0.0,0.28,0.28,0,56,56,0,29,29,0.0,270.0,270.0,0.0,0.0,0.0
maloj102,Jim Maloney,Cincinnati Reds,REDS,1,1,1,2,1970,1970,0,-0.3,0.0,0.3,26,0,-26,5,0,-5,91.0,0.0,-91.0,57500.0,0.0,-57500.0
malom001,Matt Maloney,Philadelphia Phillies,PHILS,1,1,1,2,2007,2007,0,0.05,0.65,0.6,44,26,-18,24,23,-1,240.0,183.0,-57.0,0.0,4200000.0,4200000.0
malop103,Pat Malone,Chicago Cubs,CUBS,5,9,7,16,1934,1943,9,18.58,8.45,-10.13,1563,956,-607,5453,3270,-2183,405.0,0.0,-405.0,33000.0,21000.0,-12000.0
mamaa101,Al Mamaux,Pittsburgh Pirates,PIRATS,2,4,3,7,1918,1922,4,39.97,14.96,-25.01,1164,899,-265,2135,3669,1534,8893.0,0.0,-8893.0,4200.0,5000.0,800.0
manas001,Sean Manaea,Kansas City Royals,ROYALS,1,2,2,4,2015,2015,0,11.48,1.17,-10.31,167,59,-108,19,264,245,2493.0,0.0,-2493.0,0.0,0.0,0.0
mancf101,Frank Mancuso,St.Louis Browns,ORLS,1,1,1,2,1946,1948,2,-1.19,1.42,2.61,43,87,44,137,268,131,0.0,0.0,0.0,6500.0,0.0,-6500.0
mancg101,Gus Mancuso,St. Louis Cardinals,CARDS,3,6,6,12,1932,1939,7,8.47,6.35,-2.12,942,482,-460,3293,766,-2527,60.0,2559.0,2499.0,0.0,0.0,0.0
mancg101,Gus Mancuso,New York Giants,GIANTS,2,7,4,11,1938,1949,11,11.69,46.84,35.15,813,1845,1032,2964,7276,4312,38.0,0.0,-38.0,0.0,0.0,0.0
mancg101,Gus Mancuso,Chicago Cubs,CUBS,1,2,1,3,1939,1943,4,1.28,-0.27,-1.55,170,131,-39,187,453,266,378.0,0.0,-378.0,12500.0,10000.0,-2500.0
mancg101,Gus Mancuso,Brooklyn Dodgers,DOGRS,1,3,1,4,1940,1949,9,0.16,3.28,3.12,111,521,410,388,1916,1528,0.0,0.0,0.0,0.0,0.0,0.0
manga101,Angel Mangual,Pittsburgh Pirates,PIRATS,1,1,1,2,1970,1971,1,2.23,0.61,-1.62,444,100,-344,1314,11,-1303,0.0,261.0,261.0,0.0,37000.0,37000.0
mangl101,Leo Mangum,Minneapolis,Minneapolis,1,2,2,4,1924,1930,6,-1.39,0.0,1.39,129,0,-129,265,0,-265,183.0,0.0,-183.0,0.0,9100.0,9100.0
mangl101,Leo Mangum,Chicago White Sox,WSOX,1,2,1,3,1927,1927,0,2.1,1.22,-0.88,71,68,-3,101,246,145,616.0,0.0,-616.0,0.0,0.0,0.0
mangl101,Leo Mangum,Chicago White Sox,WSOX,4,12,5,17,1926,1936,10,0.81,1.51,0.7,234,542,308,748,1962,1214,0.0,39.0,39.0,19600.0,12500.0,-7100.0
mangp101,Pepe Mangual,Montreal Expos,NATEX,1,2,2,4,1976,1978,2,-0.15,2.45,2.6,60,488,428,138,1259,1121,0.0,0.0,0.0,0.0,0.0,0.0
mangp101,Pepe Mangual,New York Mets,METS,1,1,1,2,1978,1978,0,0.0,0.3,0.3,0,11,11,0,33,33,0.0,0.0,0.0,0.0,0.0,0.0
manic101,Clyde Manion,St.Louis Browns,ORLS,1,4,1,5,1930,1932,2,0.0,-0.31,-0.31,0,16,16,0,36,36,0.0,0.0,0.0,10000.0,0.0,-10000.0
mankp101,Phil Mankowski,Detroit Tigers,TIGRS,1,2,1,3,1979,1982,3,-0.84,3.18,4.02,115,250,135,268,851,583,0.0,0.0,0.0,0.0,200000.0,200000.0
mannc001,Charlie Manning,New York Yankees,YANKS,1,3,1,4,2003,2004,1,0.09,1.41,1.32,113,54,-59,110,209,99,929.0,0.0,-929.0,0.0,3700000.0,3700000.0
mannc001,Charlie Manning,Cincinnati Reds,REDS,1,2,1,3,2004,2004,0,0.0,-0.62,-0.62,0,80,80,0,0,0,0.0,117.0,117.0,0.0,1925000.0,1925000.0
manne101,Ernie Manning,St.Louis Browns,ORLS,1,4,2,6,1915,1924,9,0.0,-0.32,-0.32,0,2,2,0,1,1,0.0,10.0,10.0,0.0,0.0,0.0
mannf101,Fred Mann,Philadelphia Athletics,ATLTCS,1,4,2,6,1887,1892,5,4.43,9.58,5.15,169,488,319,668,2210,1542,0.0,3.0,3.0,0.0,0.0,0.0
mannj001,Jim Mann,Toronto Blue Jays,BJAYS,1,1,1,2,2000,2000,0,-0.07,0.0,0.07,4,0,-4,0,0,0,8.0,0.0,-8.0,0.0,0.0,0.0
mannk001,Kelly Mann,Chicago Cubs,CUBS,2,3,2,5,1989,1995,6,0.08,5.77,5.69,44,681,637,53,415,362,52.0,994.0,942.0,2665333.0,271000.0,-2394333.0
mannl101,Les Mann,Buffalo,Buffalo,1,1,1,2,1913,1913,0,4.88,0.0,-4.88,572,0,-572,2024,0,-2024,0.0,0.0,0.0,0.0,1800.0,1800.0
mannl101,Les Mann,Chicago Cubs,CUBS,1,2,1,3,1919,1921,2,5.35,-0.19,-5.54,455,143,-312,1719,569,-1150,0.0,0.0,0.0,4800.0,0.0,-4800.0
mannr001,Rick Manning,Cleveland Indians,INDINS,4,6,7,13,1983,1989,6,6.39,10.47,4.08,1149,933,-216,3782,2485,-1297,450.0,1586.0,1136.0,1515000.0,600000.0,-915000.0
manoj001,Julio Manon,Cincinnati Reds,REDS,1,1,1,2,2007,2007,0,0.0,0.0,0.0,0,0,0,0,0,0,0.0,0.0,0.0,0.0,0.0,0.0
manrf001,Fred Manrique,Montreal Expos,NATEX,10,15,17,32,1986,1996,10,5.8,0.75,-5.05,1324,1131,-193,2191,1465,-726,2901.0,1691.0,-1210.0,955000.0,1022500.0,67500.0
manrf001,Fred Manrique,St. Louis Cardinals,CARDS,1,1,1,2,1986,1987,1,1.7,0.45,-1.25,320,120,-200,919,15,-904,0.0,290.0,290.0,0.0,0.0,0.0
manrf001,Fred Manrique,Chicago White Sox,WSOX,9,18,22,40,1989,2011,22,68.5,42.52,-25.98,3028,2464,-564,8796,4720,-4076,3081.0,6620.0,3539.0,22245000.0,12851333.0,-9393667.0
manrf001,Fred Manrique,Texas Rangers,RNGRS,1,1,2,3,1990,1990,0,-0.23,0.0,0.23,69,0,-69,237,0,-237,0.0,0.0,0.0,0.0,0.0,0.0
mantf101,Felix Mantilla,New York Mets,METS,2,3,5,8,1962,1964,2,6.55,1.44,-5.11,469,269,-200,1384,501,-883,740.0,1141.0,401.0,0.0,0.0,0.0
mantf101,Felix Mantilla,Boston Red Sox,RSOX,1,1,1,2,1966,1966,0,0.02,1.0,0.98,77,58,-19,167,152,-15,0.0,0.0,0.0,0.0,0.0,0.0
mantj001,Jeff Manto,California Angels,ANGELS,1,2,1,3,1990,1992,2,-0.04,-1.98,-1.94,120,101,-19,352,0,-352,0.0,377.0,377.0,0.0,0.0,0.0
mantj001,Jeff Manto,Boston Red Sox,RSOX,1,1,1,2,1996,1996,0,-0.31,-0.41,-0.1,21,21,0,63,62,-1,0.0,0.0,0.0,200000.0,0.0,-200000.0
mantj001,Jeff Manto,Toronto Blue Jays,BJAYS,1,1,1,2,1997,1997,0,-0.08,0.0,0.08,43,0,-43,107,0,-107,0.0,0.0,0.0,0.0,0.0,0.0
mantm001,Matt Mantei,Florida Marlins,MARLNS,12,21,29,50,1999,2019,20,78.04,61.7,-16.34,2887,3608,721,6541,8765,2224,11193.0,8868.0,-2325.0,39603667.0,23298092.0,-16305575.0
manuc101,Charlie Manuel,Minnesota Twins,TWINS,1,2,2,4,1973,1973,0,0.0,0.0,0.0,19,0,-19,19,0,-19,0.0,0.0,0.0,0.0,0.0,0.0
manuh101,Heinie Manush,Detroit Tigers,TIGRS,2,5,6,11,1927,1932,5,22.97,3.43,-19.54,913,569,-344,3930,2101,-1829,97.0,731.0,634.0,36000.0,31000.0,-5000.0
manuh101,Heinie Manush,St.Louis Browns,ORLS,21,40,49,89,1930,1952,22,132.72,109.57,-23.15,6415,9088,2673,21139,29444,8305,12102.0,15510.0,3408.0,207500.0,189450.0,-18050.0
manuh101,Heinie Manush,Washington Senators,TWINS,3,6,5,11,1935,1940,5,3.67,0.85,-2.82,437,550,113,875,1388,513,2260.0,1980.0,-280.0,12000.0,16500.0,4500.0
manuj101,Jerry Manuel,Detroit Tigers,TIGRS,1,1,1,2,1980,1981,1,0.11,-0.54,-0.65,34,50,16,69,126,57,0.0,0.0,0.0,0.0,0.0,0.0
manuj101,Jerry Manuel,Montreal Expos,NATEX,1,1,1,2,1982,1982,0,-0.03,0.0,0.03,2,0,-2,6,0,-6,0.0,0.0,0.0,0.0,0.0,0.0
manuj101,Jerry Manuel,San Diego Padres,PADRS,1,1,1,2,1982,1983,1,0.0,0.04,0.04,0,14,14,0,1,1,0.0,31.0,31.0,0.0,0.0,0.0
manuj101,Jerry Manuel,Montreal Expos,NATEX,1,1,1,2,1983,1983,0,0.0,0.0,0.0,0,0,0,0,0,0,0.0,0.0,0.0,0.0,0.0,0.0
manur001,Robert Manuel,New York Mets,METS,1,1,2,3,2006,2007,1,0.15,-0.46,-0.61,6,16,10,0,12,12,13.0,100.0,87.0,0.0,1400000.0,1400000.0
manur001,Robert Manuel,Cincinnati Reds,REDS,1,1,1,2,2009,2010,1,0.0,0.78,0.78,0,40,40,0,125,125,0.0,0.0,0.0,400000.0,405000.0,5000.0
manvd101,Dick Manville,Chicago Cubs,CUBS,1,2,1,3,1952,1956,4,0.0,-0.4,-0.4,0,166,166,0,450,450,0.0,0.0,0.0,0.0,0.0,0.0
manwk001,Kirt Manwaring,San Francisco Giants,GIANTS,1,1,2,3,1996,1997,1,0.4,1.77,1.37,37,118,81,89,393,304,0.0,0.0,0.0,1875000.0,1550000.0,-325000.0
manzj001,Josias Manzanillo,Milwaukee Brewers,BREWRS,1,1,1,2,1993,1993,0,0.61,0.0,-0.61,135,0,-135,7,0,-7,282.0,0.0,-282.0,0.0,0.0,0.0
mapec101,Cliff Mapes,New York Yankees,YANKS,1,1,3,4,1951,1952,1,0.78,-0.77,-1.55,56,68,12,229,11,-218,0.0,164.0,164.0,0.0,0.0,0.0
mapec101,Cliff Mapes,St.Louis Browns,ORLS,17,42,41,83,1952,1988,36,52.55,138.07,85.52,3971,7990,4019,7618,22164,14546,14427.0,15253.0,826.0,829333.0,135900.0,-693433.0
mapec101,Cliff Mapes,Detroit Tigers,TIGRS,1,3,1,4,1952,1952,0,-0.5,0.0,0.5,62,0,-62,121,0,-121,0.0,0.0,0.0,10000.0,0.0,-10000.0
marag101,Georges Maranda,Minnesota Twins,TWINS,1,3,1,4,1962,1963,1,-0.08,-0.13,-0.05,2,12,10,0,6,6,4.0,58.0,54.0,0.0,0.0,0.0
marar101,Rabbit Maranville,NewBedford,NewBedford,1,1,2,3,1912,1914,2,30.45,0.0,-30.45,1795,0,-1795,7536,0,-7536,0.0,0.0,0.0,0.0,1600.0,1600.0
marar101,Rabbit Maranville,Boston Braves,BRAVES,2,3,7,10,1921,1927,6,12.92,20.52,7.6,874,1440,566,3700,5949,2249,87.0,0.0,-87.0,5000.0,17500.0,12500.0
marar101,Rabbit Maranville,Pittsburgh Pirates,PIRATS,4,6,7,13,1924,1932,8,11.08,42.87,31.79,1606,1347,-259,6101,4357,-1744,1307.0,3847.0,2540.0,22300.0,13500.0,-8800.0
marbf101,Firpo Marberry,Washington Senators,TWINS,2,3,2,5,1932,1937,5,6.78,12.58,5.8,394,270,-124,393,428,35,3029.0,2990.0,-39.0,6500.0,0.0,-6500.0
marcj101,Johnny Marcum,Philadelphia Athletics,ATLTCS,1,2,3,5,1935,1936,1,40.03,-0.08,-40.11,1089,70,-1019,4170,77,-4093,1354.0,649.0,-705.0,5500.0,7000.0,1500.0
marcj101,Johnny Marcum,Boston Red Sox,RSOX,1,1,1,2,1938,1946,8,-0.14,-0.26,-0.12,28,126,98,23,263,240,143.0,0.0,-143.0,8500.0,0.0,-8500.0
marcj101,Johnny Marcum,St.Louis Browns,ORLS,1,1,1,2,1939,1939,0,0.06,0.2,0.14,57,52,-5,62,19,-43,270.0,198.0,-72.0,6000.0,0.0,-6000.0
marcj101,Johnny Marcum,Louisville,Louisville,1,1,2,3,1933,1937,4,8.5,0.0,-8.5,208,0,-208,263,0,-263,1535.0,0.0,-1535.0,0.0,3000.0,3000.0
marcs001,Shaun Marcum,Toronto Blue Jays,BJAYS,3,7,3,10,2010,2018,8,11.0,32.15,21.15,456,807,351,1007,3497,2490,2385.0,0.0,-2385.0,24366100.0,500000.0,-23866100.0
marct001,Tucupita Marcano,San Diego Padres,PADRS,1,3,2,5,2021,2021,0,0.0,0.98,0.98,0,57,57,0,211,211,0.0,0.0,0.0,0.0,4300000.0,4300000.0
marel101,Leo Marentette,Detroit Tigers,TIGRS,1,2,1,3,1968,1968,0,1.07,0.21,-0.86,466,31,-435,26,57,31,791.0,0.0,-791.0,0.0,0.0,0.0
margm001,Manuel Margot,Boston Red Sox,RSOX,1,4,1,5,2015,2018,3,5.44,6.73,1.29,670,203,-467,2136,0,-2136,153.0,553.0,400.0,0.0,9000000.0,9000000.0
margm001,Manuel Margot,San Diego Padres,PADRS,1,2,1,3,2020,2020,0,3.8,0.04,-3.76,172,23,-149,623,0,-623,0.0,66.0,66.0,0.0,0.0,0.0
marij001,Jhan Marinez,Florida Marlins,MARLNS,1,2,2,4,2011,2011,0,0.17,0.0,-0.17,2,0,-2,0,0,0,8.0,0.0,-8.0,0.0,0.0,0.0
marij002,Jake Marisnick,Toronto Blue Jays,BJAYS,3,15,11,26,2012,2018,6,24.75,21.38,-3.37,2099,1087,-1012,5739,3162,-2577,4668.0,4579.0,-89.0,8732900.0,43179800.0,34446900.0
marij002,Jake Marisnick,Miami Marlins,MARLNS,7,20,18,38,2014,2020,6,36.69,11.6,-25.09,2821,868,-1953,6455,1964,-4491,3539.0,2374.0,-1165.0,18850000.0,18675200.0,-174800.0
marij002,Jake Marisnick,Houston Astros,ASTROS,1,1,2,3,2019,2019,0,0.19,0.0,-0.19,16,0,-16,34,0,-34,0.0,0.0,0.0,2212000.0,0.0,-2212000.0
marij002,Jake Marisnick,Chicago Cubs,CUBS,1,1,1,2,2021,2021,0,-0.19,0.0,0.19,34,0,-34,54,0,-54,0.0,0.0,0.0,1000000.0,0.0,-1000000.0
marir101,Roger Maris,Cleveland Indians,INDINS,18,28,30,58,1958,1984,26,63.62,52.24,-11.38,5094,5420,326,14869,17997,3128,4436.0,3464.0,-972.0,307350.0,510600.0,203250.0
marir101,Roger Maris,Kansas City Athletics,ATLTCS,23,46,43,89,1959,1976,17,99.11,44.56,-54.55,8270,5153,-3117,21179,15408,-5771,8728.0,3756.0,-4972.0,440600.0,542000.0,101400.0
marir101,Roger Maris,New York Yankees,YANKS,3,3,3,6,1966,1969,3,5.57,1.2,-4.37,269,182,-87,861,542,-319,0.0,0.0,0.0,116000.0,36000.0,-80000.0
marjm001,Mike Marjama,Tampa Bay Devil Rays,RAYS,3,4,5,9,2017,2018,1,1.01,2.33,1.32,315,140,-175,740,560,-180,268.0,0.0,-268.0,0.0,0.0,0.0
markc101,Cliff Markle,StPaul,StPaul,1,1,1,2,1924,1924,0,-1.0,0.0,1.0,14,0,-14,8,0,-8,70.0,0.0,-70.0,0.0,0.0,0.0
markd101,Duke Markell,St.Louis Browns,ORLS,1,2,1,3,1952,1953,1,0.0,-0.02,-0.02,0,44,44,0,22,22,0.0,196.0,196.0,0.0,0.0,0.0
markj001,Justin Marks,Oakland Athletics,ATLTCS,1,2,1,3,2010,2011,1,-1.02,1.13,2.15,29,131,102,7,506,499,223.0,0.0,-223.0,0.0,4700000.0,4700000.0
marmc001,Carlos Marmol,Chicago Cubs,CUBS,1,2,1,3,2013,2013,0,0.26,0.34,0.08,41,29,-12,1,0,-1,64.0,38.0,-26.0,0.0,0.0,0.0
marnh101,Hal Marnie,Philadelphia Phillies,PHILS,1,2,1,3,1942,1943,1,0.0,0.0,0.0,0,0,0,0,0,0,0.0,0.0,0.0,0.0,0.0,0.0
marom001,Mike Maroth,Boston Red Sox,RSOX,1,1,1,2,1999,2001,2,6.39,-0.23,-6.62,158,54,-104,25,0,-25,2640.0,264.0,-2376.0,0.0,1300000.0,1300000.0
marom001,Mike Maroth,Detroit Tigers,TIGRS,1,1,1,2,2007,2009,2,-2.36,-0.81,1.55,29,10,-19,11,0,-11,114.0,82.0,-32.0,2950000.0,0.0,-2950000.0
marqb101,Bob Marquis,New York Yankees,YANKS,1,5,1,6,1952,1955,3,5.35,0.52,-4.83,390,26,-364,1419,10,-1409,46.0,107.0,61.0,0.0,13500.0,13500.0
marqg001,German Marquez,Tampa Bay Devil Rays,RAYS,2,3,5,8,2016,2021,5,22.25,4.27,-17.98,873,307,-566,919,1191,272,3030.0,0.0,-3030.0,0.0,0.0,0.0
marqg101,Gonzalo Marquez,Oakland Athletics,ATLTCS,2,2,2,4,1973,1974,1,-0.56,-0.09,0.47,53,126,73,148,217,69,0.0,0.0,0.0,17500.0,25000.0,7500.0
marqi001,Isidro Marquez,Los Angeles Dodgers,DOGRS,2,5,3,8,1993,1998,5,-0.53,1.39,1.92,836,429,-407,2713,30,-2683,638.0,819.0,181.0,218000.0,4410000.0,4192000.0
marqj001,Jason Marquis,Atlanta Braves,BRAVES,2,5,3,8,2003,2005,2,48.74,10.63,-38.11,1422,247,-1175,1200,926,-274,9241.0,27.0,-9214.0,3968000.0,5200000.0,1232000.0
marqj001,Jason Marquis,Chicago Cubs,CUBS,1,1,1,2,2009,2009,0,3.48,0.25,-3.23,69,8,-61,75,0,-75,648.0,11.0,-637.0,0.0,0.0,0.0
marqj001,Jason Marquis,Washington Nationals,NATEX,2,2,3,5,2011,2014,3,-1.36,0.9,2.26,48,89,41,128,252,124,34.0,0.0,-34.0,7500000.0,10000000.0,2500000.0
marqj002,Jeffrey Marquez,New York Yankees,YANKS,1,3,2,5,2008,2012,4,-0.72,11.97,12.69,28,599,571,50,2501,2451,20.0,3.0,-17.0,1165000.0,3600000.0,2435000.0
marql101,Luis Marquez,Chicago Cubs,CUBS,1,1,1,2,1954,1954,0,0.02,-1.31,-1.33,14,51,37,14,81,67,0.0,0.0,0.0,0.0,0.0,0.0
marqr102,Rube Marquard,Brooklyn Dodgers,DOGRS,1,1,1,2,1920,1924,4,2.52,11.22,8.7,78,334,256,99,445,346,794.0,2767.0,1973.0,0.0,7500.0,7500.0
marqr102,Rube Marquard,Cincinnati Reds,REDS,1,2,1,3,1922,1922,0,0.41,-0.04,-0.45,383,2,-381,879,1,-878,1636.0,3.0,-1633.0,0.0,0.0,0.0
marrd001,Deven Marrero,Boston Red Sox,RSOX,1,1,1,2,2018,2018,0,-0.36,0.0,0.36,49,0,-49,85,0,-85,0.0,0.0,0.0,0.0,0.0,0.0
marre001,Eli Marrero,St. Louis Cardinals,CARDS,2,3,5,8,2003,2021,18,10.7,51.54,40.84,366,1812,1446,926,2456,1530,134.0,9250.0,9116.0,7050000.0,1294000.0,-5756000.0
marre001,Eli Marrero,Atlanta Braves,BRAVES,1,2,1,3,2004,2005,1,-1.05,0.08,1.13,32,12,-20,100,1,-99,0.0,27.0,27.0,3000000.0,0.0,-3000000.0
marre001,Eli Marrero,Kansas City Royals,ROYALS,1,2,1,3,2005,2005,0,0.23,0.0,-0.23,22,0,-22,56,0,-56,0.0,0.0,0.0,3200000.0,0.0,-3200000.0
marre001,Eli Marrero,Colorado Rockies,ROCKS,1,1,2,3,2006,2007,1,0.05,3.93,3.88,25,136,111,41,579,538,0.0,0.0,0.0,350000.0,8033333.0,7683333.0
marro001,Oreste Marrero,Milwaukee Brewers,BREWRS,1,2,2,4,1993,1993,0,-0.51,0.0,0.51,36,0,-36,100,0,-100,0.0,0.0,0.0,0.0,0.0,0.0
marsa101,Armando Marsans,St.Louis Browns,ORLS,2,2,2,4,1917,1919,2,2.53,1.06,-1.47,181,124,-57,746,395,-351,0.0,0.0,0.0,4000.0,8333.0,4333.0
marsc101,Cuddles Marshall,Seattle,Seattle,1,1,2,3,1944,1944,0,-1.41,0.0,1.41,90,0,-90,41,0,-41,394.0,0.0,-394.0,0.0,0.0,0.0
marsd101,Dave Marshall,California Angels,ANGELS,2,2,2,4,1966,1967,1,-3.71,0.23,3.94,418,26,-392,1234,7,-1227,0.0,91.0,91.0,0.0,0.0,0.0
marsd101,Dave Marshall,San Francisco Giants,GIANTS,2,3,3,6,1969,1971,2,8.87,-0.91,-9.78,806,89,-717,1416,200,-1216,1801.0,0.0,-1801.0,0.0,13000.0,13000.0
marsd101,Dave Marshall,New York Mets,METS,1,1,1,2,1972,1972,0,0.19,0.0,-0.19,39,0,-39,59,0,-59,0.0,0.0,0.0,0.0,0.0,0.0
marsd102,Doc Marshall,New York Giants,GIANTS,1,2,1,3,1906,1908,2,0.72,1.14,0.42,182,308,126,648,1333,685,0.0,0.0,0.0,0.0,0.0,0.0
marse101,Doc Marshall,New York Giants,GIANTS,4,14,6,20,1932,1949,17,8.76,68.78,60.02,1268,2638,1370,4502,10545,6043,296.0,0.0,-296.0,0.0,10500.0,10500.0
marse101,Doc Marshall,New York Giants,GIANTS,2,3,2,5,1937,1938,1,0.0,0.73,0.73,0,71,71,0,263,263,0.0,0.0,0.0,0.0,0.0,0.0
marsf101,Fred Marsh,Cleveland Indians,INDINS,1,2,2,4,1951,1951,0,-2.02,0.66,2.68,326,69,-257,1133,142,-991,0.0,0.0,0.0,0.0,0.0,0.0
marsf101,Fred Marsh,St.Louis Browns,ORLS,1,2,1,3,1952,1952,0,-0.84,0.79,1.63,38,55,17,46,190,144,171.0,0.0,-171.0,6000.0,14500.0,8500.0
marsf101,Fred Marsh,Washington Senators,TWINS,1,1,1,2,1952,1952,0,-0.56,0.06,0.62,196,46,-150,650,74,-576,0.0,0.0,0.0,0.0,0.0,0.0
marsf101,Fred Marsh,St.Louis Browns,ORLS,1,1,2,3,1953,1953,0,1.2,0.0,-1.2,129,9,-120,220,9,-211,0.0,0.0,0.0,0.0,0.0,0.0
marsf101,Fred Marsh,Chicago White Sox,WSOX,29,56,55,111,1954,1971,17,64.71,122.48,57.77,7633,8254,621,20626,20005,-621,7158.0,13512.0,6354.0,248750.0,225500.0,-23250.0
marsj101,Jim Marshall,Chicago White Sox,WSOX,15,26,28,54,1957,1969,12,18.37,37.27,18.9,2207,3220,1013,3806,5515,1709,4631.0,7668.0,3037.0,148250.0,102500.0,-45750.0
marsj101,Jim Marshall,Chicago Cubs,CUBS,1,2,1,3,1959,1960,1,1.72,-0.14,-1.86,88,52,-36,29,107,78,345.0,0.0,-345.0,0.0,0.0,0.0
marsj101,Jim Marshall,Boston Red Sox,RSOX,3,7,4,11,1960,1966,6,-0.53,-1.25,-0.72,125,550,425,299,1387,1088,0.0,336.0,336.0,18500.0,0.0,-18500.0
marsj101,Jim Marshall,Boston Red Sox,RSOX,1,1,1,2,1960,1960,0,0.2,-0.51,-0.71,119,12,-107,176,1,-175,0.0,35.0,35.0,0.0,0.0,0.0
marsj101,Jim Marshall,New York Mets,METS,1,1,1,2,1962,1962,0,-0.08,-0.78,-0.7,55,34,-21,116,8,-108,0.0,114.0,114.0,0.0,0.0,0.0
marsl001,Lou Marson,Philadelphia Phillies,PHILS,3,6,6,12,2009,2015,6,27.43,-0.46,-27.89,716,374,-342,1539,630,-909,4038.0,442.0,-3596.0,1175000.0,6421400.0,5246400.0
marsm001,Mike Marshall,Los Angeles Dodgers,DOGRS,1,2,1,3,1989,1992,3,2.0,2.55,0.55,245,343,98,183,1353,1170,417.0,0.0,-417.0,1975000.0,0.0,-1975000.0
marsm001,Mike Marshall,New York Mets,METS,4,5,6,11,1990,1994,4,3.09,1.07,-2.02,383,342,-41,797,888,91,1125.0,394.0,-731.0,5216666.0,2749167.0,-2467499.0
marsm101,Mike Marshall,Houston Astros,ASTROS,1,1,1,2,1970,1970,0,6.99,0.0,-6.99,494,0,-494,100,0,-100,1413.0,0.0,-1413.0,0.0,0.0,0.0
marsm101,Mike Marshall,Montreal Expos,NATEX,3,5,6,11,1973,1986,13,19.15,15.87,-3.28,1432,1128,-304,2872,2103,-769,1885.0,4288.0,2403.0,110000.0,114000.0,4000.0
marsm101,Mike Marshall,Los Angeles Dodgers,DOGRS,1,1,2,3,1976,1978,2,0.61,4.08,3.47,56,368,312,9,639,630,128.0,292.0,164.0,135000.0,0.0,-135000.0
marsm102,Max Marshall,St. Louis Cardinals,CARDS,5,12,8,20,1942,1954,12,11.42,4.84,-6.58,1473,525,-948,4094,1686,-2408,1601.0,388.0,-1213.0,41500.0,63500.0,22000.0
marss001,Sam Marsonek,Texas Rangers,RNGRS,1,2,1,3,1999,2001,2,-0.67,0.61,1.28,13,146,133,0,511,511,62.0,0.0,-62.0,0.0,2000000.0,2000000.0
marss002,Sean Marshall,Chicago Cubs,CUBS,1,1,3,4,2011,2016,5,1.09,7.63,6.54,203,509,306,0,388,388,256.0,2074.0,1818.0,1600000.0,422500.0,-1177500.0
marsw101,Willard Marshall,New York Giants,GIANTS,14,31,27,58,1949,1968,19,59.86,70.44,10.58,4286,4168,-118,14522,10114,-4408,1384.0,8678.0,7294.0,127500.0,134500.0,7000.0
marsw101,Willard Marshall,Cincinnati Reds,REDS,1,1,3,4,1953,1954,1,-0.06,0.0,0.06,69,1,-68,138,1,-137,0.0,0.0,0.0,0.0,0.0,0.0
marta001,Al Martin,Pittsburgh Pirates,PIRATS,2,4,5,9,2000,2006,6,22.88,0.62,-22.26,458,510,52,929,1122,193,3209.0,841.0,-2368.0,5050000.0,310000.0,-4740000.0
marta001,Al Martin,San Diego Padres,PADRS,1,1,2,3,2000,2002,2,1.23,0.34,-0.89,142,184,42,469,130,-339,0.0,215.0,215.0,1750000.0,1850000.0,100000.0
marta002,Sandy Martinez,Toronto Blue Jays,BJAYS,1,1,1,2,1997,1997,0,-0.43,0.0,0.43,62,0,-62,132,0,-132,0.0,0.0,0.0,0.0,0.0,0.0
marta003,Anastacio Martinez,Boston Red Sox,RSOX,3,9,6,15,2003,2008,5,19.22,17.72,-1.5,1732,227,-1505,2840,14,-2826,1848.0,2473.0,625.0,943500.0,12066667.0,11123167.0
marta003,Anastacio Martinez,Pittsburgh Pirates,PIRATS,5,8,9,17,2003,2013,10,4.43,21.03,16.6,571,1401,830,955,4379,3424,773.0,467.0,-306.0,13800000.0,0.0,-13800000.0
marta004,Andy Marte,Atlanta Braves,BRAVES,3,5,5,10,2005,2012,7,-0.89,18.1,18.99,691,766,75,1061,2490,1429,4336.0,2160.0,-2176.0,9000000.0,10500000.0,1500000.0
marta004,Andy Marte,Boston Red Sox,RSOX,6,12,8,20,2006,2011,5,15.42,8.9,-6.52,1619,794,-825,3010,1778,-1232,1235.0,750.0,-485.0,8391733.0,1897000.0,-6494733.0
marta005,Alfredo Marte,Baltimore Orioles,ORLS,1,1,1,2,2016,2016,0,0.0,0.0,0.0,0,0,0,0,0,0,0.0,0.0,0.0,0.0,0.0,0.0
martb001,Buck Martinez,Houston Astros,ASTROS,1,3,1,4,1968,1968,0,0.37,0.0,-0.37,361,0,-361,1073,0,-1073,0.0,0.0,0.0,0.0,0.0,0.0
martb001,Buck Martinez,Kansas City Royals,ROYALS,1,2,1,3,1977,1979,2,2.3,2.25,-0.05,386,116,-270,35,0,-35,783.0,420.0,-363.0,50000.0,0.0,-50000.0
martb001,Buck Martinez,St. Louis Cardinals,CARDS,2,2,2,4,1977,1984,7,5.03,-0.76,-5.79,375,152,-223,738,21,-717,767.0,232.0,-535.0,0.0,0.0,0.0
martb001,Buck Martinez,Milwaukee Brewers,BREWRS,1,1,1,2,1981,1981,0,3.51,0.0,-3.51,454,0,-454,1261,0,-1261,0.0,0.0,0.0,0.0,0.0,0.0
martb102,Bob Martyn,New York Yankees,YANKS,3,9,7,16,1957,1962,5,10.27,3.25,-7.02,1508,714,-794,3698,610,-3088,2854.0,1762.0,-1092.0,12500.0,12500.0,0.0
martb102,Bob Martyn,Kansas City Athletics,ATLTCS,25,53,47,100,1959,1976,17,93.37,60.18,-33.19,8944,6275,-2669,21756,18191,-3565,9976.0,4965.0,-5011.0,504100.0,545500.0,41400.0
martb105,Billy Martin,Oakland,Oakland,1,2,2,4,1949,1951,2,6.53,0.0,-6.53,635,0,-635,2176,0,-2176,0.0,0.0,0.0,0.0,0.0,0.0
martb105,Billy Martin,New York Yankees,YANKS,3,9,7,16,1957,1962,5,10.27,3.25,-7.02,1508,714,-794,3698,610,-3088,2854.0,1762.0,-1092.0,12500.0,12500.0,0.0
martb105,Billy Martin,Kansas City Athletics,ATLTCS,31,62,61,123,1957,1976,19,95.85,56.38,-39.47,9593,6643,-2950,23097,19018,-4079,12004.0,6179.0,-5825.0,476100.0,606500.0,130400.0
martb105,Billy Martin,Detroit Tigers,TIGRS,1,2,3,5,1958,1964,6,0.2,14.33,14.13,125,305,180,263,345,82,132.0,2789.0,2657.0,0.0,0.0,0.0
martb105,Billy Martin,Cleveland Indians,INDINS,3,5,5,10,1959,1965,6,6.43,1.26,-5.17,1198,354,-844,3637,1453,-2184,454.0,0.0,-454.0,7500.0,10500.0,3000.0
martb105,Billy Martin,Milwaukee Braves,BRAVES,1,1,1,2,1961,1961,0,-0.89,0.0,0.89,108,0,-108,398,0,-398,0.0,0.0,0.0,0.0,0.0,0.0
martc001,Carmelo Martinez,Chicago Cubs,CUBS,1,3,1,4,1983,1989,6,15.56,10.82,-4.74,1534,321,-1213,2801,249,-2552,1977.0,2213.0,236.0,0.0,0.0,0.0
martc001,Carmelo Martinez,Philadelphia Phillies,PHILS,5,8,9,17,1990,2000,10,9.65,1.55,-8.1,566,1101,535,262,3701,3439,1674.0,703.0,-971.0,1751500.0,2034000.0,282500.0
martc001,Carmelo Martinez,Pittsburgh Pirates,PIRATS,1,1,1,2,1991,1991,0,0.45,0.0,-0.45,44,0,-44,148,0,-148,0.0,0.0,0.0,925000.0,0.0,-925000.0
martc001,Carmelo Martinez,Kansas City Royals,ROYALS,2,2,3,5,1991,1994,3,-0.49,1.03,1.52,174,215,41,469,721,252,0.0,0.0,0.0,0.0,965000.0,965000.0
martc002,Carlos Martinez,New York Yankees,YANKS,2,5,4,9,1986,1992,6,1.11,3.87,2.76,606,1169,563,1878,3720,1842,0.0,0.0,0.0,400873.0,475000.0,74127.0
martc007,Chris Martin,Boston Red Sox,RSOX,1,2,1,3,2013,2014,1,-0.53,-0.06,0.47,103,42,-61,39,104,65,474.0,0.0,-474.0,1487500.0,900000.0,-587500.0
martc007,Chris Martin,Texas Rangers,RNGRS,1,1,1,2,2019,2019,0,1.69,0.79,-0.9,146,10,-136,0,2,2,237.0,136.0,-101.0,2250000.0,0.0,-2250000.0
martc009,Corbin Martin,Houston Astros,ASTROS,1,4,2,6,2019,2021,2,-0.93,3.35,4.28,254,54,-200,791,4,-787,100.0,902.0,802.0,0.0,34500000.0,34500000.0
martd001,Dennis Martinez,Baltimore Orioles,ORLS,2,3,2,5,1986,1991,5,29.01,1.13,-27.88,569,267,-302,791,631,-160,4827.0,0.0,-4827.0,630458.0,0.0,-630458.0
martd002,Dave Martinez,Chicago Cubs,CUBS,2,2,2,4,1988,1991,3,9.41,2.09,-7.32,573,252,-321,1968,779,-1189,1.0,0.0,-1.0,685000.0,647500.0,-37500.0
martd002,Dave Martinez,Montreal Expos,NATEX,2,4,4,8,1991,2001,10,7.84,6.46,-1.38,825,557,-268,1993,412,-1581,539.0,721.0,182.0,287500.0,0.0,-287500.0
martd002,Dave Martinez,Tampa Bay Devil Rays,RAYS,2,3,3,6,2000,2003,3,0.74,1.14,0.4,52,238,186,56,846,790,251.0,96.0,-155.0,3000000.0,1600000.0,-1400000.0
martd002,Dave Martinez,Chicago Cubs,CUBS,1,1,1,2,2000,2000,0,0.5,-0.69,-1.19,38,54,16,134,102,-32,0.0,0.0,0.0,0.0,0.0,0.0
martd002,Dave Martinez,Texas Rangers,RNGRS,1,1,1,2,2000,2001,1,0.81,0.0,-0.81,47,0,-47,206,0,-206,0.0,0.0,0.0,0.0,220000.0,220000.0
martd003,Domingo Martinez,Toronto Blue Jays,BJAYS,1,1,1,2,1994,1996,2,0.0,1.37,1.37,0,152,152,0,435,435,0.0,0.0,0.0,0.0,0.0,0.0
martd004,Damaso Marte,New York Yankees,YANKS,1,1,1,2,2001,2004,3,2.76,-3.12,-5.88,411,264,-147,8,636,628,560.0,0.0,-560.0,0.0,635000.0,635000.0
martd004,Damaso Marte,Pittsburgh Pirates,PIRATS,1,2,1,3,2002,2003,1,7.99,0.0,-7.99,294,0,-294,1,0,-1,777.0,0.0,-777.0,0.0,0.0,0.0
martd004,Damaso Marte,Chicago White Sox,WSOX,3,4,3,7,2005,2011,6,1.48,0.45,-1.03,460,515,55,101,2003,1902,823.0,0.0,-823.0,4000000.0,11500000.0,7500000.0
martd004,Damaso Marte,Pittsburgh Pirates,PIRATS,2,3,6,9,2008,2016,8,0.52,7.02,6.5,146,1139,993,276,2174,1898,148.0,3210.0,3062.0,9500000.0,391425.0,-9108575.0
marte002,Ethan Martin,Los Angeles Dodgers,DOGRS,1,3,1,4,2012,2012,0,-1.0,1.11,2.11,86,53,-33,10,235,225,202.0,0.0,-202.0,483000.0,9500000.0,9017000.0
martf002,Fernando Martinez,Houston Astros,ASTROS,1,1,1,2,2013,2013,0,0.0,0.0,0.0,0,0,0,0,0,0,0.0,0.0,0.0,493000.0,0.0,-493000.0
martf003,Francis Martes,Miami Marlins,MARLNS,7,20,18,38,2014,2020,6,36.69,11.6,-25.09,2821,868,-1953,6455,1964,-4491,3539.0,2374.0,-1165.0,18850000.0,18675200.0,-174800.0
martg101,Gene Martin,Washington Senators,RNGRS,8,16,13,29,1970,1982,12,21.36,8.18,-13.18,1080,728,-352,2708,1819,-889,4391.0,989.0,-3402.0,326500.0,280000.0,-46500.0
marth101,Hersh Martin,Milwaukee,Milwaukee,2,2,5,7,1944,1944,0,4.9,0.0,-4.9,202,0,-202,847,0,-847,0.0,0.0,0.0,0.0,0.0,0.0
martj001,Jerry Martin,Philadelphia Phillies,PHILS,7,17,13,30,1979,1999,20,25.6,38.01,12.41,2807,3562,755,9986,9588,-398,522.0,1259.0,737.0,2950000.0,165000.0,-2785000.0
martj001,Jerry Martin,Chicago Cubs,CUBS,1,3,2,5,1980,1980,0,-0.93,0.0,0.93,72,0,-72,267,0,-267,0.0,0.0,0.0,0.0,0.0,0.0
martj001,Jerry Martin,San Francisco Giants,GIANTS,4,5,5,10,1981,1986,5,-1.3,6.67,7.97,316,383,67,745,545,-200,372.0,2489.0,2117.0,552000.0,0.0,-552000.0
martj002,Jose Martinez,Florida Marlins,MARLNS,16,36,40,76,1993,2019,26,141.98,107.88,-34.1,6566,6100,-466,15461,18577,3116,13532.0,10298.0,-3234.0,68689667.0,39069968.0,-29619699.0
martj004,Joe Martinez,San Francisco Giants,GIANTS,1,2,1,3,2010,2016,6,0.17,5.3,5.13,55,867,812,96,4,-92,26.0,753.0,727.0,410000.0,775000.0,365000.0
martj006,J.D. Martinez,Detroit Tigers,TIGRS,1,1,3,4,2017,2021,4,2.41,-1.37,-3.78,62,123,61,257,423,166,0.0,0.0,0.0,0.0,0.0,0.0
martj007,Jefry Marte,New York Mets,METS,2,2,2,4,2012,2013,1,2.7,-0.46,-3.16,211,23,-188,466,63,-403,0.0,0.0,0.0,493520.0,482500.0,-11020.0
martj007,Jefry Marte,Detroit Tigers,TIGRS,1,1,1,2,2016,2016,0,0.25,0.0,-0.25,223,0,-223,638,0,-638,0.0,0.0,0.0,0.0,0.0,0.0
martj008,Jose Martinez,St. Louis Cardinals,CARDS,1,3,3,6,2020,2020,0,5.13,0.0,-5.13,188,0,-188,756,0,-756,0.0,0.0,0.0,0.0,0.0,0.0
martj008,Jose Martinez,Tampa Bay Devil Rays,RAYS,1,1,2,3,2020,2020,0,-0.6,0.0,0.6,10,0,-10,22,0,-22,0.0,0.0,0.0,0.0,0.0,0.0
martj009,Jason Martin,Houston Astros,ASTROS,1,4,1,5,2018,2019,1,3.26,12.09,8.83,813,71,-742,1676,16,-1660,1316.0,1238.0,-78.0,0.0,0.0,0.0
martj010,Jose Marte,San Francisco Giants,GIANTS,1,3,1,4,2021,2021,0,-0.36,0.65,1.01,27,52,25,0,0,0,63.0,73.0,10.0,0.0,1000000.0,1000000.0
martj101,John Martin,Detroit Tigers,TIGRS,1,2,1,3,1980,1981,1,1.37,0.54,-0.83,153,67,-86,89,195,106,831.0,0.0,-831.0,0.0,0.0,0.0
martj102,Joe Marty,SanFrancisco,SanFrancisco,1,1,4,5,1936,1939,3,-0.58,0.0,0.58,187,0,-187,664,0,-664,0.0,0.0,0.0,0.0,0.0,0.0
martj102,Joe Marty,Chicago Cubs,CUBS,1,3,1,4,1939,1947,8,6.07,34.45,28.38,546,585,39,1567,751,-816,1708.0,5741.0,4033.0,9500.0,8000.0,-1500.0
martj105,Joe Martin,New York Giants,GIANTS,4,6,4,10,1936,1945,9,3.9,-0.67,-4.57,337,256,-81,591,680,89,1753.0,409.0,-1344.0,0.0,0.0,0.0
martj107,J.C. Martin,Chicago White Sox,WSOX,3,5,5,10,1967,1971,4,9.67,-0.45,-10.12,1085,468,-617,4072,1523,-2549,79.0,0.0,-79.0,35500.0,55000.0,19500.0
martj107,J.C. Martin,New York Mets,METS,1,1,1,2,1970,1970,0,-0.66,0.0,0.66,112,0,-112,299,0,-299,0.0,0.0,0.0,0.0,0.0,0.0
martj108,Joe Martin,Washington Senators,TWINS,1,1,1,2,1903,1903,0,-0.42,-0.01,0.41,44,63,19,189,234,45,0.0,0.0,0.0,0.0,0.0,0.0
martj109,Jack Martin,New York Yankees,YANKS,1,2,1,3,1912,1912,0,0.0,-0.21,-0.21,0,41,41,0,175,175,0.0,0.0,0.0,0.0,0.0,0.0
martj109,Jack Martin,Boston Braves,BRAVES,1,1,1,2,1914,1915,1,-0.56,-0.55,0.01,83,51,-32,333,152,-181,0.0,0.0,0.0,0.0,0.0,0.0
martj109,Jack Martin,Philadelphia Phillies,PHILS,1,1,1,2,1916,1916,0,0.0,0.0,0.0,0,0,0,0,0,0,0.0,0.0,0.0,0.0,0.0,0.0
martk001,Ketel Marte,Seattle Mariners,MARNRS,4,9,8,17,2016,2019,3,31.56,9.44,-22.12,1249,337,-912,4632,1487,-3145,656.0,14.0,-642.0,18394000.0,40145833.0,21751833.0
martl001,Luis Martinez,St. Louis Cardinals,CARDS,1,3,1,4,2004,2005,1,0.0,3.28,3.28,0,144,144,0,545,545,0.0,0.0,0.0,0.0,12666667.0,12666667.0
martl002,Luis Martinez,San Diego Padres,PADRS,1,1,1,2,2011,2013,2,-0.3,0.0,0.3,10,0,-10,19,0,-19,0.0,0.0,0.0,0.0,0.0,0.0
martl004,Leonys Martin,Texas Rangers,RNGRS,2,3,4,7,2015,2020,5,1.97,-1.24,-3.21,224,21,-203,698,0,-698,144.0,64.0,-80.0,5475000.0,1400000.0,-4075000.0
martl004,Leonys Martin,Seattle Mariners,MARNRS,1,2,1,3,2017,2017,0,0.18,0.0,-0.18,16,0,-16,16,0,-16,2.0,0.0,-2.0,4850000.0,0.0,-4850000.0
martl004,Leonys Martin,Detroit Tigers,TIGRS,1,2,1,3,2018,2018,0,0.14,0.0,-0.14,71,0,-71,281,0,-281,0.0,0.0,0.0,1750000.0,0.0,-1750000.0
martm001,Mike Martin,Milwaukee Brewers,BREWRS,1,1,2,3,1986,1986,0,-0.31,0.0,0.31,8,0,-8,15,0,-15,0.0,0.0,0.0,0.0,0.0,0.0
martm003,Michael Martinez,Cleveland Indians,INDINS,1,1,1,2,2017,2017,0,-0.29,0.0,0.29,13,0,-13,29,0,-29,0.0,0.0,0.0,0.0,0.0,0.0
martm101,Morrie Martin,Philadelphia Athletics,ATLTCS,3,5,7,12,1954,1956,2,1.85,3.26,1.41,238,491,253,141,1005,864,434.0,737.0,303.0,0.0,28500.0,28500.0
martm101,Morrie Martin,Cleveland Indians,INDINS,2,4,3,7,1959,1960,1,-1.11,0.25,1.36,167,69,-98,374,39,-335,7.0,147.0,140.0,0.0,0.0,0.0
martm101,Morrie Martin,Houston Astros,ASTROS,1,1,1,2,1961,1963,2,0.0,-0.21,-0.21,0,82,82,0,264,264,0.0,0.0,0.0,0.0,0.0,0.0
martm102,Marty Martinez,Atlanta Braves,BRAVES,2,2,2,4,1968,1972,4,-2.29,-1.21,1.08,290,194,-96,814,368,-446,2.0,155.0,153.0,0.0,35000.0,35000.0
martm102,Marty Martinez,Houston Astros,ASTROS,1,1,1,2,1971,1973,2,0.02,-0.52,-0.54,9,27,18,7,38,31,0.0,0.0,0.0,0.0,0.0,0.0
martm102,Marty Martinez,St. Louis Cardinals,CARDS,1,1,1,2,1972,1972,0,-0.48,-0.26,0.22,22,13,-9,44,19,-25,0.0,0.0,0.0,0.0,23500.0,23500.0
martm102,Marty Martinez,Oakland Athletics,ATLTCS,2,4,3,7,1972,1975,3,-3.14,2.17,5.31,448,341,-107,1329,643,-686,48.0,183.0,135.0,42500.0,0.0,-42500.0
marto001,Osvaldo Martinez,Florida Marlins,MARLNS,1,2,2,4,2011,2011,0,0.17,0.0,-0.17,2,0,-2,0,0,0,8.0,0.0,-8.0,0.0,0.0,0.0
marto001,Osvaldo Martinez,Los Angeles Dodgers,DOGRS,1,1,1,2,2014,2014,0,0.0,0.0,0.0,0,0,0,0,0,0,0.0,0.0,0.0,0.0,0.0,0.0
martp001,Pedro Martinez,Los Angeles Dodgers,DOGRS,1,1,1,2,1993,1996,3,18.96,3.21,-15.75,234,370,136,291,1511,1220,2392.0,0.0,-2392.0,119000.0,1537500.0,1418500.0
martp001,Pedro Martinez,Montreal Expos,NATEX,3,7,8,15,1997,2006,9,60.76,10.18,-50.58,703,769,66,669,669,0,5870.0,5152.0,-718.0,8427500.0,6500000.0,-1927500.0
martp002,Pedro Martinez,San Diego Padres,PADRS,6,15,16,31,1994,2006,12,12.56,40.19,27.63,2713,3390,677,9058,12055,2997,712.0,1324.0,612.0,13007500.0,22494000.0,9486500.0
martp002,Pedro Martinez,Houston Astros,ASTROS,1,1,1,2,1995,1996,1,0.0,0.0,0.0,0,0,0,0,0,0,0.0,0.0,0.0,175000.0,115000.0,-60000.0
martp002,Pedro Martinez,San Diego Padres,PADRS,1,1,1,2,1995,1996,1,-0.24,0.0,0.24,10,0,-10,0,0,0,21.0,0.0,-21.0,0.0,109000.0,109000.0
martp003,Pablo Martinez,San Diego Padres,PADRS,2,4,3,7,1993,2000,7,-0.42,-0.7,-0.28,28,54,26,3,11,8,67.0,168.0,101.0,326000.0,0.0,-326000.0
martr001,Renie Martin,Kansas City Royals,ROYALS,3,7,5,12,1982,1990,8,15.6,24.69,9.09,1105,393,-712,1343,512,-831,5715.0,4650.0,-1065.0,1318000.0,662500.0,-655500.0
martr001,Renie Martin,San Francisco Giants,GIANTS,2,4,3,7,1984,1992,8,-0.69,5.26,5.95,80,443,363,148,292,144,73.0,2798.0,2725.0,0.0,0.0,0.0
martr003,Ramon Martinez,Kansas City Royals,ROYALS,2,2,2,4,1996,1997,1,3.32,0.0,-3.32,368,0,-368,1045,0,-1045,0.0,0.0,0.0,0.0,0.0,0.0
martr003,Ramon Martinez,Detroit Tigers,TIGRS,1,2,1,3,2005,2009,4,-0.18,19.15,19.33,143,632,489,65,2819,2754,157.0,0.0,-157.0,5025000.0,4600000.0,-425000.0
martr004,Russell Martin,Toronto Blue Jays,BJAYS,1,2,2,4,2019,2019,0,0.72,0.0,-0.72,87,0,-87,249,0,-249,12.0,0.0,-12.0,0.0,0.0,0.0
martr101,Randy Martz,Chicago Cubs,CUBS,3,6,6,12,1983,1990,7,9.95,11.91,1.96,748,630,-118,2292,307,-1985,429.0,3028.0,2599.0,890000.0,85000.0,-805000.0
marts001,Shairon Martis,San Francisco Giants,GIANTS,1,1,1,2,2006,2006,0,0.59,0.66,0.07,38,52,14,35,1,-34,319.0,70.0,-249.0,0.0,1000000.0,1000000.0
marts002,Starling Marte,Pittsburgh Pirates,PIRATS,1,2,3,5,2020,2020,0,1.09,0.0,-1.09,33,0,-33,138,0,-138,0.0,0.0,0.0,0.0,0.0,0.0
marts002,Starling Marte,Arizona Diamondbacks,DBACKS,1,1,3,4,2020,2020,0,3.3,0.27,-3.03,92,4,-88,387,0,-387,0.0,33.0,33.0,0.0,0.0,0.0
marts002,Starling Marte,Miami Marlins,MARLNS,1,1,1,2,2021,2021,0,1.92,-0.51,-2.43,56,23,-33,251,19,-232,0.0,172.0,172.0,0.0,0.0,0.0
marts101,Silvio Martinez,Pittsburgh Pirates,PIRATS,1,2,2,4,1976,1977,1,2.48,6.27,3.79,151,213,62,599,52,-547,63.0,661.0,598.0,0.0,0.0,0.0
marts101,Silvio Martinez,Chicago White Sox,WSOX,1,3,1,4,1977,1978,1,1.03,-0.14,-1.17,221,8,-213,205,0,-205,1727.0,34.0,-1693.0,0.0,0.0,0.0
marts101,Silvio Martinez,St. Louis Cardinals,CARDS,2,3,2,5,1981,1990,9,6.11,11.74,5.63,370,733,363,1263,2386,1123,1236.0,0.0,-1236.0,740000.0,0.0,-740000.0
marts103,Stu Martin,Minneapolis,Minneapolis,1,1,1,2,1943,1943,0,0.36,0.0,-0.36,64,0,-64,136,0,-136,0.0,0.0,0.0,0.0,0.0,0.0
martt001,Tippy Martinez,New York Yankees,YANKS,12,22,23,45,1976,1997,21,98.9,27.78,-71.12,5024,1689,-3335,9897,2906,-6991,18250.0,6192.0,-12058.0,4415000.0,2812500.0,-1602500.0
martt002,Tino Martinez,Seattle Mariners,MARNRS,3,7,5,12,1995,1999,4,28.82,-1.18,-30.0,1743,533,-1210,4473,1676,-2797,3491.0,1076.0,-2415.0,2835000.0,1944000.0,-891000.0
martt002,Tino Martinez,St. Louis Cardinals,CARDS,1,1,2,3,2003,2003,0,2.35,0.0,-2.35,138,0,-138,538,0,-538,0.0,0.0,0.0,7500000.0,0.0,-7500000.0
martt003,Tom Martin,Baltimore Orioles,ORLS,1,2,2,4,1992,1992,0,0.0,0.0,0.0,0,0,0,0,0,0,0.0,0.0,0.0,0.0,0.0,0.0
martt003,Tom Martin,Arizona Diamondbacks,DBACKS,1,3,1,4,1997,2003,6,6.04,8.29,2.25,656,595,-61,2425,2462,37,172.0,0.0,-172.0,0.0,7150000.0,7150000.0
martt003,Tom Martin,Cleveland Indians,INDINS,1,1,1,2,2001,2001,0,-0.92,0.0,0.92,28,0,-28,3,0,-3,51.0,0.0,-51.0,0.0,0.0,0.0
martt003,Tom Martin,Los Angeles Dodgers,DOGRS,1,1,1,2,2004,2004,0,-0.11,0.0,0.11,66,0,-66,0,0,0,58.0,0.0,-58.0,1400000.0,0.0,-1400000.0
martt101,Tony Martinez,St. Louis Cardinals,CARDS,1,3,3,6,1967,1967,0,-0.52,-0.9,-0.38,197,52,-145,651,76,-575,0.0,0.0,0.0,0.0,0.0,0.0
martt102,Ted Martinez,New York Mets,METS,2,2,3,5,1974,1978,4,-1.26,-0.69,0.57,90,265,175,188,805,617,0.0,0.0,0.0,0.0,0.0,0.0
martt102,Ted Martinez,St. Louis Cardinals,CARDS,3,3,4,7,1975,1977,2,-1.08,-0.15,0.93,139,18,-121,159,0,-159,66.0,23.0,-43.0,0.0,0.0,0.0
martv001,Victor Martinez,Cleveland Indians,INDINS,2,2,4,6,2009,2015,6,4.14,7.67,3.53,200,322,122,784,19,-765,92.0,3207.0,3115.0,5900000.0,415500.0,-5484500.0
masao001,Onan Masaoka,Los Angeles Dodgers,DOGRS,1,3,2,5,2001,2001,0,0.0,0.96,0.96,0,24,24,0,27,27,0.0,238.0,238.0,0.0,5950000.0,5950000.0
mashc101,Clyde Mashore,Cincinnati Reds,REDS,1,1,1,2,1970,1972,2,-1.18,0.77,1.95,239,117,-122,483,196,-287,0.0,0.0,0.0,0.0,0.0,0.0
masip101,Phil Masi,Boston Braves,BRAVES,2,4,2,6,1949,1949,0,1.49,-0.18,-1.67,141,79,-62,419,234,-185,0.0,0.0,0.0,0.0,0.0,0.0
masod101,Don Mason,San Francisco Giants,GIANTS,2,3,2,5,1970,1971,1,-1.33,0.72,2.05,165,78,-87,493,2,-491,0.0,134.0,134.0,0.0,0.0,0.0
masoj101,Jim Mason,Toronto Blue Jays,BJAYS,1,3,1,4,1977,1980,3,-0.59,9.29,9.88,97,516,419,181,2168,1987,37.0,0.0,-37.0,0.0,0.0,0.0
masoj101,Jim Mason,Texas Rangers,RNGRS,1,1,1,2,1978,1978,0,-0.43,0.0,0.43,40,0,-40,78,0,-78,0.0,0.0,0.0,0.0,0.0,0.0
masom001,Mike Mason,Texas Rangers,RNGRS,1,1,1,2,1987,1990,3,0.17,0.0,-0.17,35,0,-35,13,0,-13,114.0,0.0,-114.0,0.0,0.0,0.0
masor001,Roger Mason,Detroit Tigers,TIGRS,2,3,2,5,1985,1986,1,-1.22,-0.38,0.84,75,106,31,94,226,132,347.0,0.0,-347.0,0.0,0.0,0.0
masor001,Roger Mason,New York Mets,METS,1,2,1,3,1992,1994,2,1.1,0.52,-0.58,68,170,102,3,6,3,150.0,357.0,207.0,0.0,510000.0,510000.0
masor001,Roger Mason,San Diego Padres,PADRS,1,1,1,2,1993,1995,2,-0.22,1.33,1.55,80,136,56,3,9,6,175.0,277.0,102.0,300000.0,0.0,-300000.0
massn001,Nick Masset,Texas Rangers,RNGRS,1,3,2,5,2006,2010,4,19.87,1.7,-18.17,323,47,-276,31,7,-24,4762.0,663.0,-4099.0,0.0,332000.0,332000.0
massn001,Nick Masset,Chicago White Sox,WSOX,1,2,2,4,2008,2008,0,3.05,0.44,-2.61,495,41,-454,49,150,101,721.0,0.0,-721.0,396000.0,8282695.0,7886695.0
mastj001,Justin Masterson,Boston Red Sox,RSOX,1,3,1,4,2009,2010,1,7.47,4.91,-2.56,325,183,-142,19,775,756,3215.0,0.0,-3215.0,415500.0,5900000.0,5484500.0
mastj001,Justin Masterson,Cleveland Indians,INDINS,1,1,1,2,2014,2014,0,-0.77,0.0,0.77,17,0,-17,9,0,-9,92.0,0.0,-92.0,0.0,0.0,0.0
mastt001,Tom Mastny,Toronto Blue Jays,BJAYS,1,1,1,2,2004,2005,1,-0.67,1.16,1.83,86,37,-49,0,106,106,282.0,0.0,-282.0,0.0,324400.0,324400.0
mastw101,Walt Masterson,Washington Senators,TWINS,8,10,14,24,1949,1962,13,-0.51,10.55,11.06,754,2784,2030,1851,8045,6194,1009.0,3394.0,2385.0,39500.0,41500.0,2000.0
mastw101,Walt Masterson,Boston Red Sox,RSOX,1,2,1,3,1952,1955,3,3.27,3.29,0.02,146,168,22,161,116,-45,1293.0,1085.0,-208.0,12000.0,0.0,-12000.0
matct101,Tommy Matchick,Detroit Tigers,TIGRS,4,7,4,11,1969,1975,6,-1.28,-0.46,0.82,179,375,196,373,892,519,4.0,0.0,-4.0,118300.0,80000.0,-38300.0
matct101,Tommy Matchick,Boston Red Sox,RSOX,2,2,2,4,1970,1972,2,-0.02,-1.44,-1.42,72,137,65,178,218,40,0.0,0.0,0.0,22000.0,17000.0,-5000.0
matct101,Tommy Matchick,Kansas City Royals,ROYALS,1,1,1,2,1971,1971,0,0.12,-0.39,-0.51,42,19,-23,122,32,-90,0.0,0.0,0.0,0.0,22000.0,22000.0
matct101,Tommy Matchick,Milwaukee Brewers,BREWRS,2,3,3,6,1971,1973,2,-0.12,-0.77,-0.65,3,126,123,9,406,397,0.0,22.0,22.0,18000.0,0.0,-18000.0
matct101,Tommy Matchick,Baltimore Orioles,ORLS,1,1,1,2,1973,1973,0,0.0,0.11,0.11,0,44,44,0,71,71,0.0,0.0,0.0,0.0,0.0,0.0
matej001,Julio Mateo,Seattle Mariners,MARNRS,1,1,1,2,2007,2011,4,0.0,0.0,0.0,0,0,0,0,0,0,0.0,0.0,0.0,1075000.0,0.0,-1075000.0
matej003,Jorge Mateo,New York Yankees,YANKS,4,8,7,15,2017,2021,4,10.37,1.61,-8.76,335,144,-191,733,363,-370,1504.0,587.0,-917.0,0.0,3575000.0,3575000.0
matej003,Jorge Mateo,Oakland Athletics,ATLTCS,1,1,1,2,2020,2020,0,-0.18,0.0,0.18,79,0,-79,121,0,-121,0.0,0.0,0.0,0.0,0.0,0.0
matem001,Marcos Mateo,Cincinnati Reds,REDS,2,2,2,4,2007,2009,2,-0.01,-0.15,-0.14,96,20,-76,10,38,28,134.0,0.0,-134.0,0.0,0.0,0.0
mater001,Ruben Mateo,Texas Rangers,RNGRS,1,2,1,3,2001,2003,2,2.17,-0.72,-2.89,634,36,-598,2326,2,-2324,0.0,598.0,598.0,300000.0,250000.0,-50000.0
mathc102,Christy Mathewson,Cincinnati Reds,REDS,1,1,1,2,1900,1900,0,106.61,0.0,-106.61,1281,0,-1281,1886,0,-1886,14339.0,0.0,-14339.0,0.0,0.0,0.0
mathc102,Christy Mathewson,New York Giants,GIANTS,3,6,6,12,1916,1923,7,51.71,19.99,-31.72,1982,727,-1255,7625,1751,-5874,2062.0,3773.0,1711.0,15800.0,9600.0,-6200.0
mathe101,Eddie Mathews,Houston Astros,ASTROS,1,1,2,3,1967,1973,6,1.09,1.07,-0.02,67,466,399,185,26,-159,0.0,791.0,791.0,57500.0,18000.0,-39500.0
mathe101,Eddie Mathews,Atlanta Braves,BRAVES,1,3,2,5,1966,1968,2,0.94,-0.28,-1.22,101,10,-91,383,29,-354,0.0,0.0,0.0,57500.0,0.0,-57500.0
mathj001,Jeff Mathis,Anaheim Angels,ANGELS,1,1,1,2,2011,2013,2,0.67,0.3,-0.37,72,1,-71,227,0,-227,6.0,15.0,9.0,1700000.0,0.0,-1700000.0
mathj001,Jeff Mathis,Toronto Blue Jays,BJAYS,3,15,11,26,2012,2018,6,24.75,21.38,-3.37,2099,1087,-1012,5739,3162,-2577,4668.0,4579.0,-89.0,8732900.0,43179800.0,34446900.0
mathm002,Mark Mathias,Cleveland Indians,INDINS,1,1,1,2,2019,2019,0,0.04,0.0,-0.04,16,0,-16,36,0,-36,0.0,0.0,0.0,0.0,0.0,0.0
mathn101,Nelson Mathews,Chicago Cubs,CUBS,2,2,2,4,1963,1967,4,-1.1,-0.87,0.23,284,24,-260,842,13,-829,186.0,123.0,-63.0,0.0,0.0,0.0
matht001,Terry Mathews,Florida Marlins,MARLNS,1,1,1,2,1996,1998,2,0.38,0.01,-0.37,95,174,79,0,545,545,307.0,0.0,-307.0,292500.0,140000.0,-152500.0
matht002,T.J. Mathews,St. Louis Cardinals,CARDS,1,3,1,4,1997,1997,0,-0.38,2.04,2.42,256,51,-205,9,224,215,1161.0,0.0,-1161.0,395000.0,7150000.0,6755000.0
matij101,John Matias,Baltimore Orioles,ORLS,2,4,4,8,1967,1973,6,9.46,19.82,10.36,579,770,191,2185,2951,766,146.0,306.0,160.0,72000.0,40300.0,-31700.0
matij101,John Matias,Chicago White Sox,WSOX,2,3,3,6,1970,1977,7,5.23,5.15,-0.08,607,692,85,1743,2721,978,0.0,0.0,0.0,15000.0,26000.0,11000.0
matlj101,Jon Matlack,New York Mets,METS,5,7,9,16,1977,1990,13,13.77,7.59,-6.18,495,1539,1044,407,2359,1952,3452.0,4564.0,1112.0,615000.0,190000.0,-425000.0
matoj001,Julius Matos,Montreal Expos,NATEX,1,1,1,2,2004,2004,0,0.0,0.0,0.0,0,0,0,0,0,0,0.0,0.0,0.0,0.0,0.0,0.0
matop002,Phil Maton,San Diego Padres,PADRS,1,1,1,2,2019,2019,0,0.14,0.0,-0.14,76,0,-76,1,0,-1,226.0,0.0,-226.0,562900.0,0.0,-562900.0
matop002,Phil Maton,Cleveland Indians,INDINS,1,2,1,3,2021,2021,0,-0.24,1.78,2.02,31,60,29,0,268,268,76.0,0.0,-76.0,975000.0,0.0,-975000.0
matsk001,Kazuo Matsui,New York Mets,METS,1,2,1,3,2006,2006,0,3.93,0.05,-3.88,136,25,-111,579,41,-538,0.0,0.0,0.0,8033333.0,350000.0,-7683333.0
mattb101,Bobby Mattick,Chicago Cubs,CUBS,1,2,1,3,1940,1940,0,0.59,0.0,-0.59,137,0,-137,458,0,-458,0.0,0.0,0.0,0.0,9500.0,9500.0
matte101,Earl Mattingly,Brooklyn Dodgers,DOGRS,3,7,4,11,1932,1944,12,2.72,9.15,6.43,227,1029,802,615,3670,3055,390.0,469.0,79.0,10000.0,10000.0,0.0
mattg001,Gary Matthews,Atlanta Braves,BRAVES,1,1,1,2,1981,1984,3,4.79,-0.95,-5.74,395,90,-305,1644,74,-1570,0.0,634.0,634.0,0.0,0.0,0.0
mattg001,Gary Matthews,Philadelphia Phillies,PHILS,3,6,4,10,1984,1986,2,8.36,-0.43,-8.79,1292,232,-1060,3847,16,-3831,227.0,557.0,330.0,0.0,0.0,0.0
mattg001,Gary Matthews,Chicago Cubs,CUBS,1,1,1,2,1987,1987,0,-0.82,0.0,0.82,45,0,-45,135,0,-135,0.0,0.0,0.0,880000.0,0.0,-880000.0
mattg002,Gary Matthews,San Diego Padres,PADRS,1,1,1,2,2000,2002,2,-0.01,-1.1,-1.09,186,104,-82,477,3,-474,0.0,212.0,212.0,0.0,0.0,0.0
mattg002,Gary Matthews,New York Mets,METS,1,1,1,2,2002,2003,1,1.85,0.0,-1.85,150,0,-150,569,0,-569,0.0,0.0,0.0,237500.0,0.0,-237500.0
mattg002,Gary Matthews,Anaheim Angels,ANGELS,1,2,1,3,2010,2010,0,-0.59,-0.59,0.0,36,16,-20,65,0,-65,0.0,50.0,50.0,0.0,0.0,0.0
matti001,Isaac Mattson,Anaheim Angels,ANGELS,1,4,1,5,2019,2021,2,0.0,1.39,1.39,4,37,33,0,4,4,13.0,469.0,456.0,0.0,2800000.0,2800000.0
mattm001,Mike Matthews,Cleveland Indians,INDINS,1,1,1,2,1999,1999,0,0.0,0.0,0.0,0,0,0,0,0,0,0.0,0.0,0.0,0.0,0.0,0.0
mattm001,Mike Matthews,Boston Red Sox,RSOX,1,2,1,3,1999,1999,0,1.49,0.53,-0.96,212,5,-207,24,0,-24,420.0,77.0,-343.0,0.0,2500000.0,2500000.0
mattm001,Mike Matthews,St. Louis Cardinals,CARDS,1,2,2,4,2002,2002,0,0.04,0.01,-0.03,8,8,0,1,6,5,12.0,45.0,33.0,300000.0,4250000.0,3950000.0
mattr001,Ryan Mattheus,Colorado Rockies,ROCKS,1,2,1,3,2009,2010,1,1.26,1.09,-0.17,282,192,-90,1,1,0,427.0,182.0,-245.0,0.0,2000000.0,2000000.0
mattw103,Wid Matthews,Milwaukee,Milwaukee,1,1,2,3,1922,1922,0,-0.66,0.0,0.66,129,0,-129,543,0,-543,0.0,0.0,0.0,0.0,0.0,0.0
mattw103,Wid Matthews,Philadelphia Athletics,ATLTCS,1,4,1,5,1923,1932,9,0.0,51.22,51.22,0,1240,1240,0,5473,5473,0.0,0.0,0.0,9900.0,0.0,-9900.0
mattw103,Wid Matthews,Milwaukee,Milwaukee,4,4,9,13,1924,1927,3,7.22,0.0,-7.22,846,0,-846,3377,0,-3377,0.0,0.0,0.0,0.0,21000.0,21000.0
mattw103,Wid Matthews,Washington Senators,TWINS,7,18,11,29,1924,1941,17,54.71,70.39,15.68,4079,2979,-1100,12814,11128,-1686,8820.0,3821.0,-4999.0,95600.0,78200.0,-17400.0
matub001,Brian Matusz,Baltimore Orioles,ORLS,1,2,2,4,2016,2016,0,0.0,0.0,0.0,0,0,0,0,0,0,0.0,0.0,0.0,0.0,0.0,0.0
matuh101,Harry Matuzak,Memphis,Memphis,1,1,1,2,1941,1941,0,0.0,0.0,0.0,0,0,0,0,0,0,0.0,0.0,0.0,0.0,0.0,0.0
matul001,Len Matuszek,Philadelphia Phillies,PHILS,1,1,3,4,1985,1985,0,-0.68,0.42,1.1,62,52,-10,166,3,-163,0.0,109.0,109.0,0.0,0.0,0.0
matul001,Len Matuszek,Toronto Blue Jays,BJAYS,1,1,1,2,1985,1985,0,0.99,-0.63,-1.62,150,61,-89,314,195,-119,0.0,0.0,0.0,185000.0,750000.0,565000.0
matzs001,Steven Matz,New York Mets,METS,2,3,4,7,2021,2021,0,2.02,-0.87,-2.89,30,74,44,2,21,19,452.0,137.0,-315.0,0.0,0.0,0.0
maucg101,Gene Mauch,Brooklyn Dodgers,DOGRS,1,5,2,7,1947,1947,0,3.3,-0.19,-3.49,337,37,-300,419,81,-338,1285.0,0.0,-1285.0,17500.0,0.0,-17500.0
maucg101,Gene Mauch,Pittsburgh Pirates,PIRATS,1,3,3,6,1947,1950,3,26.56,1.84,-24.72,1156,287,-869,3340,710,-2630,3832.0,295.0,-3537.0,0.0,0.0,0.0
maucg101,Gene Mauch,Chicago Cubs,CUBS,1,2,1,3,1949,1949,0,-0.08,0.0,0.08,67,0,-67,165,0,-165,0.0,0.0,0.0,0.0,0.0,0.0
maurb001,Brandon Maurer,Seattle Mariners,MARNRS,2,2,3,5,2014,2017,3,0.4,2.01,1.61,429,302,-127,373,892,519,480.0,392.0,-88.0,504600.0,4500000.0,3995400.0
maurb001,Brandon Maurer,San Diego Padres,PADRS,1,3,4,7,2017,2017,0,-1.51,-0.81,0.7,107,22,-85,1,17,16,304.0,157.0,-147.0,4194700.0,538900.0,-3655800.0
maurc101,Carmen Mauro,Chicago Cubs,CUBS,8,19,17,36,1951,1965,14,5.38,23.07,17.69,1413,1956,543,3848,2666,-1182,1451.0,4951.0,3500.0,82000.0,75000.0,-7000.0
maurc101,Carmen Mauro,Brooklyn Dodgers,DOGRS,1,1,1,2,1953,1953,0,-0.08,0.0,0.08,17,0,-17,24,0,-24,0.0,0.0,0.0,0.0,0.0,0.0
maurc101,Carmen Mauro,Philadelphia Athletics,ATLTCS,46,109,116,225,1953,1976,23,189.08,109.39,-79.69,16486,13560,-2926,40867,38903,-1964,20759.0,16429.0,-4330.0,546100.0,754900.0,208800.0
maust001,Tim Mauser,Philadelphia Phillies,PHILS,1,1,1,2,1993,1994,1,1.33,-0.22,-1.55,136,80,-56,9,3,-6,277.0,175.0,-102.0,0.0,300000.0,300000.0
maxcb001,Brian Maxcy,Detroit Tigers,TIGRS,1,2,2,4,1996,1996,0,0.33,-0.3,-0.63,17,16,-1,37,0,-37,0.0,71.0,71.0,0.0,180000.0,180000.0
maxvd101,Dal Maxvill,St. Louis Cardinals,CARDS,2,3,4,7,1972,1974,2,0.42,0.24,-0.18,172,16,-156,196,0,-196,0.0,24.0,24.0,0.0,16000.0,16000.0
maxwc101,Charlie Maxwell,Detroit Tigers,TIGRS,1,1,1,2,1962,1962,0,1.73,-0.53,-2.26,142,36,-106,409,65,-344,0.0,0.0,0.0,0.0,0.0,0.0
maxwj002,Justin Maxwell,Washington Nationals,NATEX,1,1,1,2,2011,2011,0,0.0,0.0,0.0,0,0,0,0,0,0,0.0,0.0,0.0,0.0,0.0,0.0
maxwj002,Justin Maxwell,Houston Astros,ASTROS,1,1,1,2,2013,2013,0,-0.56,0.0,0.56,55,0,-55,156,0,-156,0.0,0.0,0.0,0.0,0.0,0.0
may-b101,Buckshot May,Pittsburgh Pirates,PIRATS,1,1,2,3,1924,1927,3,0.0,0.53,0.53,0,98,98,0,46,46,0.0,457.0,457.0,2400.0,0.0,-2400.0
may-c101,Carlos May,Chicago White Sox,WSOX,4,4,7,11,1976,1982,6,0.32,4.9,4.58,277,635,358,733,1658,925,726.0,1007.0,281.0,70000.0,0.0,-70000.0
may-d001,Derrick May,Milwaukee Brewers,BREWRS,1,1,1,2,1995,1995,0,2.93,0.0,-2.93,187,0,-187,523,0,-523,0.0,0.0,0.0,0.0,0.0,0.0
may-d002,Darrell May,Kansas City Royals,ROYALS,1,2,3,5,2004,2005,1,-0.35,0.13,0.48,40,137,97,10,489,479,178.0,0.0,-178.0,1750000.0,3575000.0,1825000.0
may-d002,Darrell May,San Diego Padres,PADRS,1,3,1,4,2005,2005,0,-0.82,0.3,1.12,3,44,41,0,1,1,24.0,95.0,71.0,3975000.0,3000000.0,-975000.0
may-d101,Dave May,Baltimore Orioles,ORLS,1,1,2,3,1970,1971,1,11.37,0.0,-11.37,717,0,-717,2798,0,-2798,0.0,0.0,0.0,14000.0,0.0,-14000.0
may-d101,Dave May,Milwaukee Brewers,BREWRS,1,2,1,3,1974,1974,0,1.37,0.0,-1.37,187,0,-187,473,0,-473,0.0,0.0,0.0,0.0,220000.0,220000.0
may-d101,Dave May,Atlanta Braves,BRAVES,3,8,3,11,1976,1983,7,3.71,6.12,2.41,495,566,71,1015,2078,1063,923.0,87.0,-836.0,33500.0,0.0,-33500.0
may-j101,Jerry May,Pittsburgh Pirates,PIRATS,3,5,5,10,1970,1974,4,25.46,1.32,-24.14,1582,453,-1129,5382,666,-4716,1881.0,1147.0,-734.0,76500.0,34500.0,-42000.0
may-l001,Lucas May,Los Angeles Dodgers,DOGRS,1,2,1,3,2010,2010,0,-0.45,-0.69,-0.24,12,39,27,39,160,121,0.0,0.0,0.0,0.0,1650000.0,1650000.0
may-l001,Lucas May,Kansas City Royals,ROYALS,1,1,1,2,2011,2011,0,0.0,0.0,0.0,0,0,0,0,0,0,0.0,0.0,0.0,0.0,0.0,0.0
may-l101,Lee May,Cincinnati Reds,REDS,6,8,13,21,1971,1982,11,32.36,75.99,43.63,1555,3237,1682,4173,10169,5996,5915.0,4444.0,-1471.0,0.0,0.0,0.0
may-l101,Lee May,Houston Astros,ASTROS,6,9,10,19,1974,1989,15,0.9,31.67,30.77,1396,3000,1604,4891,8483,3592,0.0,5622.0,5622.0,705000.0,416000.0,-289000.0
may-m001,Milt May,Pittsburgh Pirates,PIRATS,3,5,5,10,1973,1992,19,29.22,54.97,25.75,946,1350,404,1371,1564,193,5981.0,12549.0,6568.0,1030000.0,180000.0,-850000.0
may-m001,Milt May,Houston Astros,ASTROS,6,11,9,20,1975,1989,14,10.73,12.05,1.32,1452,1687,235,3403,4505,1102,3386.0,1859.0,-1527.0,22500.0,16500.0,-6000.0
may-m001,Milt May,San Francisco Giants,GIANTS,1,2,1,3,1983,1984,1,-0.33,0.32,0.65,57,63,6,120,181,61,0.0,0.0,0.0,280000.0,0.0,-280000.0
may-r101,Rudy May,Chicago White Sox,WSOX,2,3,5,8,1964,1967,3,2.05,-0.33,-2.38,164,75,-89,481,41,-440,0.0,379.0,379.0,13000.0,0.0,-13000.0
may-r101,Rudy May,Philadelphia Phillies,PHILS,1,2,1,3,1964,1966,2,4.55,-0.7,-5.25,450,79,-371,427,37,-390,3416.0,375.0,-3041.0,5400.0,15000.0,9600.0
may-r101,Rudy May,New York Yankees,YANKS,12,22,23,45,1976,1997,21,98.9,27.78,-71.12,5024,1689,-3335,9897,2906,-6991,18250.0,6192.0,-12058.0,4415000.0,2812500.0,-1602500.0
may-r101,Rudy May,Baltimore Orioles,ORLS,3,7,7,14,1977,1987,10,17.37,17.58,0.21,774,1051,277,733,2635,1902,4935.0,985.0,-3950.0,558333.0,0.0,-558333.0
may-s001,Scott May,Los Angeles Dodgers,DOGRS,2,2,2,4,1987,1989,2,0.39,0.0,-0.39,80,0,-80,187,0,-187,22.0,0.0,-22.0,0.0,0.0,0.0
may-s001,Scott May,Texas Rangers,RNGRS,1,2,2,4,1989,1989,0,0.0,0.0,0.0,0,0,0,0,0,0,0.0,0.0,0.0,0.0,0.0,0.0
may-t001,Trevor May,Philadelphia Phillies,PHILS,3,4,4,8,2012,2016,4,1.59,4.92,3.33,336,335,-1,250,1350,1100,1151.0,0.0,-1151.0,4595000.0,492500.0,-4102500.0
maybc001,Cameron Maybin,Detroit Tigers,TIGRS,2,8,3,11,2007,2010,3,-0.1,-1.19,-1.09,705,27,-678,1077,3,-1074,1506.0,303.0,-1203.0,12380000.0,13850000.0,1470000.0
maybc001,Cameron Maybin,Florida Marlins,MARLNS,2,2,3,5,2010,2013,3,9.26,4.23,-5.03,576,566,-10,1460,5,-1455,273.0,919.0,646.0,2030000.0,419800.0,-1610200.0
maybc001,Cameron Maybin,San Diego Padres,PADRS,6,17,12,29,2015,2021,6,17.57,11.2,-6.37,1317,971,-346,3711,2795,-916,1719.0,362.0,-1357.0,9570500.0,0.0,-9570500.0
maybc001,Cameron Maybin,Atlanta Braves,BRAVES,2,3,5,8,2015,2021,6,0.33,8.0,7.67,166,860,694,484,2433,1949,417.0,519.0,102.0,7535000.0,1028000.0,-6507000.0
maybc001,Cameron Maybin,Detroit Tigers,TIGRS,1,1,1,2,2016,2019,3,1.49,1.15,-0.34,93,87,-6,387,0,-387,0.0,240.0,240.0,8000000.0,0.0,-8000000.0
maybc001,Cameron Maybin,Miami Marlins,MARLNS,1,1,2,3,2018,2018,0,-0.16,0.0,0.16,30,0,-30,97,0,-97,0.0,0.0,0.0,3250000.0,0.0,-3250000.0
maybc001,Cameron Maybin,Detroit Tigers,TIGRS,1,1,1,2,2020,2020,0,-0.02,0.0,0.02,18,0,-18,56,0,-56,0.0,0.0,0.0,1500000.0,0.0,-1500000.0
maybj001,John Mayberry,Texas Rangers,RNGRS,2,2,3,5,2008,2010,2,1.66,-0.03,-1.69,533,1,-532,1405,1,-1404,0.0,0.0,0.0,0.0,0.0,0.0
maybj001,John Mayberry,Philadelphia Phillies,PHILS,1,1,1,2,2014,2014,0,-0.02,0.0,0.02,15,0,-15,30,0,-30,0.0,0.0,0.0,1587500.0,0.0,-1587500.0
maybj101,John Mayberry,Houston Astros,ASTROS,9,16,13,29,1971,1989,18,44.32,17.37,-26.95,2726,2302,-424,7585,5583,-2002,6887.0,3796.0,-3091.0,35500.0,41750.0,6250.0
maybj101,John Mayberry,Toronto Blue Jays,BJAYS,4,8,10,18,1982,1997,15,19.07,54.74,35.67,1399,2746,1347,5439,11023,5584,360.0,453.0,93.0,4400000.0,3156667.0,-1243333.0
mayee101,Erskine Mayer,Philadelphia Phillies,PHILS,4,7,8,15,1918,1925,7,16.24,19.61,3.37,917,710,-207,2074,1819,-255,5086.0,3795.0,-1291.0,8500.0,16850.0,8350.0
mayee102,Ed Mayer,St. Louis Cardinals,CARDS,2,3,2,5,1957,1958,1,0.52,-0.27,-0.79,98,41,-57,124,86,-38,94.0,0.0,-94.0,0.0,0.0,0.0
mayel101,Lee Maye,Milwaukee Braves,BRAVES,2,4,3,7,1965,1969,4,0.56,7.28,6.72,456,395,-61,1230,669,-561,170.0,2309.0,2139.0,0.0,0.0,0.0
mayel101,Lee Maye,Houston Astros,ASTROS,4,5,6,11,1967,1978,11,2.92,1.17,-1.75,377,1322,945,888,4912,4024,159.0,122.0,-37.0,0.0,29000.0,29000.0
mayel101,Lee Maye,Cleveland Indians,INDINS,1,1,2,3,1969,1969,0,1.6,0.0,-1.6,167,0,-167,535,0,-535,0.0,0.0,0.0,0.0,0.0,0.0
maynb001,Brent Mayne,Kansas City Royals,ROYALS,1,1,1,2,1995,1995,0,-0.13,0.0,0.13,70,0,-70,113,0,-113,0.0,0.0,0.0,675000.0,0.0,-675000.0
maynb001,Brent Mayne,Colorado Rockies,ROCKS,1,1,2,3,2001,2001,0,-0.5,-0.28,0.22,265,31,-234,964,74,-890,0.0,19.0,19.0,2150000.0,320000.0,-1830000.0
maynb001,Brent Mayne,Arizona Diamondbacks,DBACKS,1,2,3,5,2004,2008,4,1.02,-0.45,-1.47,105,67,-38,363,129,-234,0.0,19.0,19.0,7800000.0,0.0,-7800000.0
mayoe101,Eddie Mayo,Baltimore,Baltimore,1,1,1,2,1936,1937,1,-0.46,0.0,0.46,46,0,-46,152,0,-152,0.0,0.0,0.0,0.0,0.0,0.0
mayoe101,Eddie Mayo,New York Giants,GIANTS,3,5,3,8,1936,1945,9,3.9,-0.21,-4.11,337,210,-127,591,528,-63,1753.0,409.0,-1344.0,0.0,0.0,0.0
mayoe101,Eddie Mayo,Philadelphia Athletics,ATLTCS,1,2,2,4,1943,1943,0,0.0,-0.05,-0.05,0,2,2,0,3,3,0.0,21.0,21.0,9500.0,0.0,-9500.0
maysc101,Carl Mays,Boston Red Sox,RSOX,6,8,10,18,1919,1929,10,39.74,22.45,-17.29,1556,1599,43,4170,5625,1455,4261.0,1664.0,-2597.0,10750.0,18500.0,7750.0
maysj001,Joe Mays,Seattle Mariners,MARNRS,1,2,1,3,1997,1997,0,10.83,1.1,-9.73,203,30,-173,21,129,108,2839.0,0.0,-2839.0,0.0,750000.0,750000.0
maysw101,Willie Mays,San Francisco Giants,GIANTS,1,1,2,3,1972,1972,0,1.61,-0.39,-2.0,135,6,-129,481,2,-479,0.0,28.0,28.0,165000.0,0.0,-165000.0
mazan001,Nomar Mazara,Texas Rangers,RNGRS,1,1,1,2,2019,2019,0,-0.13,0.0,0.13,42,0,-42,149,0,-149,0.0,0.0,0.0,3300000.0,0.0,-3300000.0
mazzc001,Cory Mazzoni,New York Mets,METS,1,2,1,3,2015,2015,0,-1.89,0.09,1.98,94,76,-18,2,1,-1,145.0,103.0,-42.0,0.0,0.0,0.0
mazzc002,Chris Mazza,Boston Red Sox,RSOX,1,3,2,5,2021,2021,0,0.11,0.0,-0.11,61,0,-61,0,0,0,216.0,0.0,-216.0,0.0,0.0,0.0
mazzl001,Lee Mazzilli,New York Mets,METS,4,5,5,10,1982,1993,11,6.85,42.11,35.26,305,1983,1678,231,5329,5098,4118.0,6313.0,2195.0,4344334.0,1600000.0,-2744334.0
mazzl001,Lee Mazzilli,Texas Rangers,RNGRS,1,1,1,2,1982,1984,2,0.27,0.7,0.43,37,177,140,144,614,470,0.0,0.0,0.0,400000.0,0.0,-400000.0
mazzl001,Lee Mazzilli,New York Yankees,YANKS,2,2,5,7,1982,1983,1,14.44,0.0,-14.44,1223,0,-1223,927,0,-927,1801.0,0.0,-1801.0,0.0,0.0,0.0
mazzv001,Vin Mazzaro,Oakland Athletics,ATLTCS,1,2,1,3,2010,2011,1,-1.02,1.13,2.15,29,131,102,7,506,499,223.0,0.0,-223.0,0.0,4700000.0,4700000.0
mazzv001,Vin Mazzaro,Kansas City Royals,ROYALS,1,2,2,4,2012,2015,3,1.15,0.0,-1.15,120,0,-120,7,0,-7,252.0,0.0,-252.0,0.0,0.0,0.0
mcafb101,Bill McAfee,Chicago Cubs,CUBS,3,9,5,14,1930,1941,11,5.24,32.0,26.76,900,1038,138,2126,2153,27,2562.0,5533.0,2971.0,3600.0,16000.0,12400.0
mcafb101,Bill McAfee,Boston Braves,BRAVES,1,3,1,4,1932,1937,5,0.0,10.04,10.04,0,601,601,0,2506,2506,0.0,0.0,0.0,0.0,0.0,0.0
mcafb101,Bill McAfee,Washington Senators,TWINS,3,6,4,10,1933,1939,6,1.0,0.24,-0.76,49,144,95,167,448,281,0.0,29.0,29.0,9750.0,0.0,-9750.0
mcalb101,Bill McAllester,Montgomery,Montgomery,1,3,2,5,1912,1913,1,-0.14,0.0,0.14,252,0,-252,843,0,-843,0.0,0.0,0.0,0.0,0.0,0.0
mcals101,Sport McAllister,Detroit Tigers,TIGRS,1,4,2,6,1903,1911,8,0.0,16.79,16.79,0,801,801,0,3453,3453,0.0,39.0,39.0,0.0,0.0,0.0
mcalz001,Zach McAllister,New York Yankees,YANKS,1,1,1,2,2010,2010,0,2.96,-0.03,-2.99,296,36,-260,6,119,113,1765.0,0.0,-1765.0,0.0,750000.0,750000.0
mcanj001,Jamie McAndrew,Florida Marlins,MARLNS,1,1,1,2,1993,1996,3,-0.11,0.0,0.11,15,0,-15,0,0,0,167.0,0.0,-167.0,0.0,0.0,0.0
mcanj101,Jim McAndrew,New York Mets,METS,1,1,1,2,1973,1973,0,-0.44,0.0,0.44,30,0,-30,10,0,-10,125.0,0.0,-125.0,0.0,0.0,0.0
mcanj102,Jim McAnany,Los Angeles Angels,ANGELS,4,4,6,10,1961,1970,9,4.24,10.06,5.82,788,882,94,2492,2911,419,542.0,509.0,-33.0,20000.0,0.0,-20000.0
mcaud101,Dick McAuliffe,Detroit Tigers,TIGRS,2,2,3,5,1973,1978,5,21.48,7.23,-14.25,1256,474,-782,4991,1468,-3523,0.0,701.0,701.0,60000.0,61500.0,1500.0
mcaui101,Ike McAuley,Pittsburgh Pirates,PIRATS,1,3,2,5,1917,1919,2,0.0,0.0,0.0,0,175,175,0,676,676,0.0,0.0,0.0,0.0,0.0,0.0
mcavw101,Wickey McAvoy,Baltimore,Baltimore,1,2,5,7,1917,1920,3,0.91,0.0,-0.91,304,0,-304,1098,0,-1098,1.0,0.0,-1.0,0.0,1800.0,1800.0
mcbea101,Al McBean,San Diego Padres,PADRS,1,1,2,3,1969,1969,0,0.06,-2.15,-2.21,64,112,48,4,312,308,148.0,47.0,-101.0,0.0,0.0,0.0
mcbem001,Marcus McBeth,Oakland Athletics,ATLTCS,1,2,1,3,2007,2009,2,-0.06,0.33,0.39,44,33,-11,0,73,73,59.0,0.0,-59.0,0.0,0.0,0.0
mcbrb101,Bake McBride,St. Louis Cardinals,CARDS,10,23,19,42,1977,1992,15,86.36,109.79,23.43,6625,4679,-1946,21245,15231,-6014,7151.0,5142.0,-2009.0,1613333.0,19000.0,-1594333.0
mcbrb101,Bake McBride,Philadelphia Phillies,PHILS,2,2,2,4,1982,1983,1,0.27,1.43,1.16,217,223,6,343,308,-35,251.0,251.0,0.0,300000.0,0.0,-300000.0
mcbrg101,George McBride,Pittsburgh Pirates,PIRATS,2,4,2,6,1905,1910,5,7.6,22.84,15.24,902,405,-497,2899,798,-2101,2702.0,3628.0,926.0,0.0,0.0,0.0
mcbrg101,George McBride,St. Louis Cardinals,CARDS,1,2,1,3,1906,1907,1,0.0,-0.14,-0.14,0,22,22,0,79,79,0.0,0.0,0.0,0.0,0.0,0.0
mcbrm001,Macay McBride,Atlanta Braves,BRAVES,2,3,2,5,2007,2008,1,-0.55,-1.48,-0.93,88,127,39,14,0,-14,259.0,110.0,-149.0,400000.0,415000.0,15000.0
mcbrm002,Matt McBride,Cleveland Indians,INDINS,1,4,1,5,2011,2013,2,-0.32,1.97,2.29,204,79,-125,247,10,-237,813.0,1274.0,461.0,0.0,2800000.0,2800000.0
mcbrr001,Ryan McBroom,Toronto Blue Jays,BJAYS,1,1,1,2,2017,2017,0,0.0,-0.2,-0.2,0,32,32,0,58,58,0.0,0.0,0.0,0.0,0.0,0.0
mccaa103,Alex McCarthy,Pittsburgh Pirates,PIRATS,1,3,2,5,1917,1919,2,0.0,0.0,0.0,0,175,175,0,676,676,0.0,0.0,0.0,0.0,0.0,0.0
mccab001,Brandon McCarthy,Chicago White Sox,WSOX,2,4,5,9,2006,2016,10,4.75,20.31,15.56,542,364,-178,56,181,125,1384.0,4762.0,3378.0,728000.0,8282695.0,7554695.0
mccab001,Brandon McCarthy,Arizona Diamondbacks,DBACKS,2,4,5,9,2014,2018,4,4.41,4.31,-0.1,204,280,76,363,795,432,671.0,386.0,-285.0,0.0,2100000.0,2100000.0
mccab001,Brandon McCarthy,Los Angeles Dodgers,DOGRS,4,17,9,26,2017,2021,4,6.07,9.48,3.41,927,279,-648,2727,1007,-1720,545.0,229.0,-316.0,71371000.0,90253480.0,18882480.0
mccab002,Brian McCann,New York Yankees,YANKS,2,5,3,8,2016,2017,1,4.0,0.0,-4.0,502,0,-502,1984,0,-1984,8.0,0.0,-8.0,26857143.0,14500000.0,-12357143.0
mccab106,Bill McCahan,Philadelphia Athletics,ATLTCS,2,3,2,5,1949,1952,3,0.0,2.06,2.06,0,232,232,0,892,892,0.0,0.0,0.0,0.0,0.0,0.0
mccad001,Dave McCarty,Minnesota Twins,TWINS,1,1,1,2,1995,1995,0,0.0,0.0,0.0,0,0,0,0,0,0,0.0,0.0,0.0,150000.0,0.0,-150000.0
mccad001,Dave McCarty,Cincinnati Reds,REDS,5,11,7,18,1995,2010,15,11.19,26.95,15.76,438,1436,998,728,5040,4312,2595.0,2089.0,-506.0,13266667.0,6562778.0,-6703889.0
mccad001,Dave McCarty,San Francisco Giants,GIANTS,1,1,2,3,1998,1998,0,0.32,0.0,-0.32,8,0,-8,23,0,-23,0.0,0.0,0.0,0.0,0.0,0.0
mccae101,Emmet McCann,Detroit Tigers,TIGRS,1,9,2,11,1921,1941,20,0.0,3.03,3.03,0,202,202,0,144,144,0.0,1168.0,1168.0,0.0,0.0,0.0
mccae101,Emmet McCann,Portland,Portland,2,3,3,6,1925,1926,1,-0.61,0.0,0.61,23,0,-23,16,0,-16,63.0,0.0,-63.0,0.0,4250.0,4250.0
mccaj002,Joe McCarthy,Tampa Bay Devil Rays,RAYS,1,1,1,2,2019,2019,0,-0.37,0.0,0.37,4,0,-4,10,0,-10,0.0,0.0,0.0,0.0,0.0,0.0
mccaj104,Johnny McCarthy,Brooklyn Dodgers,DOGRS,2,5,3,8,1936,1940,4,2.67,4.3,1.63,454,607,153,1715,2060,345,0.0,317.0,317.0,0.0,0.0,0.0
mccaj104,Johnny McCarthy,New York Giants,GIANTS,1,4,1,5,1941,1949,8,5.95,28.96,23.01,346,655,309,1181,2815,1634,38.0,0.0,-38.0,0.0,0.0,0.0
mccaj105,Jack McCarthy,Cincinnati Reds,REDS,1,5,3,8,1897,1900,3,8.1,12.35,4.25,718,395,-323,2747,1335,-1412,936.0,1747.0,811.0,0.0,0.0,0.0
mccaj105,Jack McCarthy,Chicago Cubs,CUBS,1,5,1,6,1905,1913,8,5.14,19.07,13.93,814,1001,187,3290,4393,1103,0.0,0.0,0.0,0.0,0.0,0.0
mccaj108,Joe McCabe,Minnesota Twins,TWINS,2,2,2,4,1964,1967,3,0.15,0.11,-0.04,14,10,-4,32,20,-12,0.0,0.0,0.0,7000.0,13000.0,6000.0
mccal101,Larry McCall,New York Yankees,YANKS,22,49,42,91,1978,1997,19,81.62,59.61,-22.01,5721,3574,-2147,13100,7561,-5539,18451.0,9704.0,-8747.0,5628333.0,4757500.0,-870833.0
mccal101,Larry McCall,Texas Rangers,RNGRS,1,3,2,5,1980,1980,0,-0.55,-1.43,-0.88,28,119,91,57,205,148,0.0,0.0,0.0,0.0,0.0,0.0
mccal102,Lew McCarty,Brooklyn Dodgers,DOGRS,1,1,1,2,1916,1917,1,2.34,-0.18,-2.52,288,25,-263,820,86,-734,0.0,0.0,0.0,4250.0,6000.0,1750.0
mccam001,Tom McCarthy,Boston Red Sox,RSOX,7,15,13,28,1985,1993,8,20.97,19.79,-1.18,2048,1909,-139,3771,4732,961,4874.0,3574.0,-1300.0,3550000.0,2472500.0,-1077500.0
mccam001,Tom McCarthy,New York Mets,METS,1,2,2,4,1988,1989,1,0.86,0.0,-0.86,37,0,-37,0,0,0,239.0,0.0,-239.0,0.0,0.0,0.0
mccar101,Roger McCardell,San Francisco Giants,GIANTS,5,9,7,16,1959,1968,9,13.15,7.42,-5.73,1312,848,-464,3499,1107,-2392,1130.0,3244.0,2114.0,43000.0,30000.0,-13000.0
mccat101,Tim McCarver,St. Louis Cardinals,CARDS,26,53,46,99,1969,1994,25,115.3,156.23,40.93,11163,7909,-3254,30164,26894,-3270,12224.0,4453.0,-7771.0,3323333.0,942667.0,-2380666.0
mccat101,Tim McCarver,Philadelphia Phillies,PHILS,1,1,1,2,1972,1973,1,0.44,-1.21,-1.65,77,82,5,259,265,6,0.0,0.0,0.0,0.0,0.0,0.0
mccat101,Tim McCarver,Montreal Expos,NATEX,1,1,1,2,1972,1972,0,0.03,0.0,-0.03,204,0,-204,518,0,-518,0.0,0.0,0.0,0.0,0.0,0.0
mccat102,Tom McCarthy,Pittsburgh Pirates,PIRATS,1,2,1,3,1908,1909,1,1.07,0.43,-0.64,57,32,-25,69,31,-38,500.0,269.0,-231.0,1500.0,0.0,-1500.0
mccat102,Tom McCarthy,Boston Braves,BRAVES,1,1,1,2,1909,1909,0,0.0,-0.72,-0.72,0,8,8,0,9,9,0.0,65.0,65.0,0.0,0.0,0.0
mccaw102,Windy McCall,SanFrancisco,SanFrancisco,1,1,4,5,1953,1953,0,2.61,0.0,-2.61,252,0,-252,49,0,-49,709.0,0.0,-709.0,0.0,0.0,0.0
mcclb001,Bob McClure,Kansas City Royals,ROYALS,2,4,3,7,1977,1980,3,4.07,20.62,16.55,704,736,32,973,2593,1620,2869.0,802.0,-2067.0,0.0,0.0,0.0
mcclb001,Bob McClure,Milwaukee Brewers,BREWRS,1,1,1,2,1986,1986,0,0.9,0.0,-0.9,246,0,-246,8,0,-8,402.0,0.0,-402.0,487500.0,0.0,-487500.0
mccll001,Lloyd McClendon,New York Mets,METS,1,3,1,4,1982,1984,2,-1.57,2.55,4.12,181,68,-113,297,77,-220,497.0,693.0,196.0,0.0,375000.0,375000.0
mccll001,Lloyd McClendon,Cincinnati Reds,REDS,1,1,1,2,1988,1990,2,-0.43,0.61,1.04,141,137,-4,427,395,-32,0.0,0.0,0.0,75000.0,62500.0,-12500.0
mccll001,Lloyd McClendon,Chicago Cubs,CUBS,1,1,1,2,1990,1990,0,0.42,0.0,-0.42,312,0,-312,714,0,-714,0.0,0.0,0.0,210000.0,0.0,-210000.0
mccls001,Scott McClain,Baltimore Orioles,ORLS,1,2,1,3,1997,1998,1,0.7,0.0,-0.7,54,0,-54,161,0,-161,0.0,0.0,0.0,0.0,0.0,0.0
mccls002,Seth McClung,Tampa Bay Devil Rays,RAYS,1,1,1,2,2007,2010,3,1.11,3.84,2.73,179,219,40,29,1,-28,538.0,609.0,71.0,0.0,0.0,0.0
mcclz001,Zach McClellan,Kansas City Royals,ROYALS,1,3,1,4,2004,2006,2,-0.1,-0.25,-0.15,24,15,-9,1,0,-1,42.0,75.0,33.0,0.0,0.0,0.0
mccoa101,Amby McConnell,Boston Red Sox,RSOX,10,27,25,52,1910,1935,25,63.77,27.05,-36.72,4436,3125,-1311,17821,11484,-6337,0.0,1291.0,1291.0,45050.0,29350.0,-15700.0
mccob101,Barney McCosky,Detroit Tigers,TIGRS,19,42,44,86,1946,1964,18,57.99,76.58,18.59,5043,5483,440,13086,16231,3145,8483.0,9258.0,775.0,157700.0,111400.0,-46300.0
mccob102,Benny McCoy,Detroit Tigers,TIGRS,1,1,1,2,1939,1952,13,4.33,0.0,-4.33,275,0,-275,1183,0,-1183,0.0,0.0,0.0,4200.0,12500.0,8300.0
mccob104,Barry McCormick,St.Louis Browns,ORLS,1,1,1,2,1903,1903,0,-1.12,-0.42,0.7,176,44,-132,679,189,-490,0.0,0.0,0.0,0.0,0.0,0.0
mccob105,Billy McCool,San Diego Padres,PADRS,2,2,3,5,1970,1970,0,-0.28,1.52,1.8,36,106,70,5,427,422,65.0,0.0,-65.0,0.0,0.0,0.0
mccob105,Billy McCool,St. Louis Cardinals,CARDS,1,1,1,2,1970,1970,0,0.0,0.0,0.0,0,0,0,0,0,0,0.0,0.0,0.0,0.0,0.0,0.0
mccob105,Billy McCool,Boston Red Sox,RSOX,1,1,1,2,1971,1971,0,0.0,0.0,0.0,0,0,0,0,0,0,0.0,0.0,0.0,0.0,0.0,0.0
mccoj103,Jim McCormick,Chicago Cubs,CUBS,1,1,2,3,1887,1893,6,2.8,5.98,3.18,72,310,238,138,1158,1020,967.0,1220.0,253.0,0.0,0.0,0.0
mccom001,Mike McCoy,Baltimore Orioles,ORLS,1,1,1,2,2008,2008,0,-0.02,-1.17,-1.15,12,54,42,6,166,160,0.0,0.0,0.0,0.0,0.0,0.0
mccom101,Mike McCormick,Buffalo,Buffalo,1,1,3,4,1937,1937,0,0.0,0.0,0.0,0,0,0,0,0,0,0.0,0.0,0.0,0.0,0.0,0.0
mccom101,Mike McCormick,Boston Braves,BRAVES,1,2,1,3,1948,1950,2,-0.55,1.6,2.15,55,137,82,158,356,198,0.0,0.0,0.0,0.0,0.0,0.0
mccom101,Mike McCormick,Chicago White Sox,WSOX,1,1,1,2,1950,1954,4,0.53,2.29,1.76,81,258,177,272,600,328,0.0,0.0,0.0,0.0,0.0,0.0
mccom103,Mike McCormick,San Francisco Giants,GIANTS,10,18,16,34,1962,1972,10,36.27,10.66,-25.61,2635,1445,-1190,6319,1774,-4545,3135.0,5237.0,2102.0,50000.0,108000.0,58000.0
mccom103,Mike McCormick,Baltimore Orioles,ORLS,1,1,2,3,1965,1965,0,4.02,0.0,-4.02,171,0,-171,125,0,-125,1122.0,0.0,-1122.0,0.0,0.0,0.0
mccom103,Mike McCormick,Washington Senators,RNGRS,14,29,24,53,1966,1988,22,51.82,50.93,-0.89,3334,4606,1272,9827,13245,3418,6092.0,7154.0,1062.0,551000.0,258500.0,-292500.0
mccom103,Mike McCormick,San Francisco Giants,GIANTS,2,2,2,4,1970,1972,2,-1.18,1.35,2.53,46,122,76,11,71,60,127.0,663.0,536.0,0.0,0.0,0.0
mccom104,Moose McCormick,New York Giants,GIANTS,1,1,1,2,1904,1911,7,0.67,13.71,13.04,66,396,330,260,1628,1368,0.0,0.0,0.0,0.0,0.0,0.0
mccom104,Moose McCormick,Pittsburgh Pirates,PIRATS,2,6,3,9,1904,1910,6,14.45,22.9,8.45,1603,573,-1030,5618,1466,-4152,2702.0,3643.0,941.0,0.0,0.0,0.0
mccow101,Willie McCovey,San Francisco Giants,GIANTS,3,7,6,13,1973,1979,6,5.12,0.53,-4.59,507,876,369,1563,1384,-179,25.0,2162.0,2137.0,125000.0,0.0,-125000.0
mccra001,Adam McCreery,Anaheim Angels,ANGELS,1,1,1,2,2016,2016,0,-0.08,0.37,0.45,2,30,28,0,2,2,3.0,352.0,349.0,0.0,0.0,0.0
mccrj101,Judge McCredie,Brooklyn Dodgers,DOGRS,1,4,1,5,1903,1908,5,0.0,0.0,0.0,0,0,0,0,0,0,0.0,0.0,0.0,0.0,0.0,0.0
mccrq001,Quinton McCracken,Arizona Diamondbacks,DBACKS,1,1,2,3,2003,2004,1,-0.37,-0.58,-0.21,19,20,1,23,28,5,0.0,0.0,0.0,1750000.0,750000.0,-1000000.0
mccrt101,Tom McCreery,Louisville Colonels,LS3,1,1,2,3,1897,1897,0,0.35,0.73,0.38,84,14,-70,348,22,-326,0.0,164.0,164.0,0.0,0.0,0.0
mccrt102,Tommy McCraw,Chicago White Sox,WSOX,1,1,1,2,1971,1971,0,-0.26,-1.28,-1.02,122,53,-69,234,153,-81,0.0,0.0,0.0,0.0,0.0,0.0
mccrt102,Tommy McCraw,Texas Rangers,RNGRS,4,7,4,11,1972,1977,5,0.46,2.24,1.78,334,178,-156,834,481,-353,759.0,568.0,-191.0,0.0,21000.0,21000.0
mccrt102,Tommy McCraw,Cleveland Indians,INDINS,3,6,3,9,1973,1974,1,2.93,-1.31,-4.24,422,87,-335,1042,273,-769,0.0,0.0,0.0,19750.0,160000.0,140250.0
mccua001,Andrew McCutchen,Pittsburgh Pirates,PIRATS,1,2,3,5,2018,2021,3,1.55,1.11,-0.44,130,285,155,568,0,-568,0.0,418.0,418.0,0.0,0.0,0.0
mccua001,Andrew McCutchen,San Francisco Giants,GIANTS,2,5,3,8,2018,2020,2,0.55,0.73,0.18,105,166,61,162,647,485,182.0,0.0,-182.0,14750000.0,0.0,-14750000.0
mccuc101,Clyde McCullough,Chicago Cubs,CUBS,1,2,2,4,1948,1955,7,10.4,0.75,-9.65,514,154,-360,1252,339,-913,1459.0,506.0,-953.0,6500.0,0.0,-6500.0
mccuc101,Clyde McCullough,Pittsburgh Pirates,PIRATS,1,1,2,3,1952,1952,0,-0.4,0.0,0.4,166,0,-166,450,0,-450,0.0,0.0,0.0,0.0,0.0,0.0
mccud001,Daniel McCutchen,New York Yankees,YANKS,1,4,2,6,2008,2011,3,7.23,0.52,-6.71,1088,146,-942,2084,276,-1808,3210.0,148.0,-3062.0,391425.0,5500000.0,5108575.0
mccuh101,Harry McCurdy,St. Louis Cardinals,CARDS,1,2,2,4,1929,1932,3,0.24,-1.21,-1.45,299,26,-273,578,77,-501,65.0,0.0,-65.0,7500.0,6000.0,-1500.0
mccul001,Lance McCullers,Philadelphia Phillies,PHILS,1,4,2,6,1983,1984,1,4.33,2.1,-2.23,526,139,-387,92,339,247,1500.0,17.0,-1483.0,0.0,0.0,0.0
mccul001,Lance McCullers,San Diego Padres,PADRS,1,3,2,5,1988,1992,4,-2.09,7.62,9.71,105,399,294,12,1044,1032,593.0,270.0,-323.0,375000.0,1500000.0,1125000.0
mccul001,Lance McCullers,New York Yankees,YANKS,1,2,1,3,1990,1994,4,1.65,4.46,2.81,34,452,418,0,1510,1510,242.0,0.0,-242.0,800000.0,650000.0,-150000.0
mcdal101,Lindy McDaniel,St. Louis Cardinals,CARDS,15,32,26,58,1962,1972,10,54.99,16.45,-38.54,4551,1419,-3132,9818,4107,-5711,7592.0,1574.0,-6018.0,32500.0,24000.0,-8500.0
mcdal101,Lindy McDaniel,Chicago Cubs,CUBS,4,8,5,13,1965,1977,12,12.44,36.7,24.26,637,2096,1459,244,5232,4988,3515.0,5246.0,1731.0,122500.0,47500.0,-75000.0
mcdal101,Lindy McDaniel,San Francisco Giants,GIANTS,1,1,1,2,1968,1968,0,9.86,-0.29,-10.15,484,14,-470,71,0,-71,1635.0,36.0,-1599.0,0.0,0.0,0.0
mcdal101,Lindy McDaniel,New York Yankees,YANKS,2,2,3,5,1973,2002,29,0.87,9.84,8.97,79,1066,987,0,3577,3577,554.0,187.0,-367.0,68000.0,65000.0,-3000.0
mcded101,Danny McDevitt,New York Yankees,YANKS,2,2,3,5,1961,1962,1,0.28,-0.04,-0.32,121,45,-76,304,110,-194,80.0,0.0,-80.0,0.0,0.0,0.0
mcdem102,Mickey McDermott,Boston Red Sox,RSOX,1,2,1,3,1953,1953,0,2.57,0.0,-2.57,409,0,-409,921,0,-921,1057.0,0.0,-1057.0,0.0,0.0,0.0
mcdem102,Mickey McDermott,Washington Senators,TWINS,6,9,11,20,1956,1962,6,3.55,-3.94,-7.49,344,1439,1095,915,4243,3328,381.0,450.0,69.0,21000.0,0.0,-21000.0
mcdem102,Mickey McDermott,New York Yankees,YANKS,6,15,13,28,1957,1970,13,5.72,32.98,27.26,1633,2423,790,4235,5558,1323,2553.0,4978.0,2425.0,115500.0,43000.0,-72500.0
mcdem102,Mickey McDermott,Kansas City Athletics,ATLTCS,31,62,61,123,1957,1976,19,95.85,56.38,-39.47,9593,6643,-2950,23097,19018,-4079,12004.0,6179.0,-5825.0,476100.0,606500.0,130400.0
mcdia001,Allen McDill,New York Mets,METS,3,5,6,11,1995,1999,4,0.09,-0.09,-0.18,89,38,-51,0,0,0,470.0,74.0,-396.0,125000.0,0.0,-125000.0
mcdob001,Ben McDonald,Milwaukee Brewers,BREWRS,2,5,3,8,1997,2001,4,0.99,0.01,-0.98,271,614,343,839,2349,1510,81.0,415.0,334.0,6930000.0,4850000.0,-2080000.0
mcdob001,Ben McDonald,Cleveland Indians,INDINS,1,1,1,2,1998,2000,2,0.0,-0.18,-0.18,0,8,8,0,0,0,0.0,19.0,19.0,0.0,0.0,0.0
mcdod002,Darnell McDonald,Washington Nationals,NATEX,1,1,1,2,2007,2008,1,-0.22,-1.69,-1.47,4,50,46,11,8,-3,0.0,144.0,144.0,0.0,0.0,0.0
mcdod102,Dave McDonald,New York Yankees,YANKS,1,1,1,2,1970,1972,2,-0.5,1.23,1.73,24,100,76,45,12,-33,0.0,272.0,272.0,0.0,0.0,0.0
mcdod102,Dave McDonald,Montreal Expos,NATEX,1,1,1,2,1970,1974,4,0.0,12.72,12.72,0,509,509,0,2140,2140,0.0,0.0,0.0,0.0,0.0,0.0
mcdod102,Dave McDonald,Montreal Expos,NATEX,1,1,1,2,1972,1972,0,0.0,0.0,0.0,0,0,0,0,0,0,0.0,0.0,0.0,0.0,0.0,0.0
mcdoj001,Jack McDowell,Chicago White Sox,WSOX,1,1,2,3,1994,1997,3,4.02,1.86,-2.16,30,233,203,0,702,702,653.0,0.0,-653.0,5300000.0,0.0,-5300000.0
mcdoj003,John McDonald,Cleveland Indians,INDINS,1,1,1,2,2004,2008,4,5.2,-0.67,-5.87,549,86,-463,1453,0,-1453,0.0,282.0,282.0,324400.0,0.0,-324400.0
mcdoj003,John McDonald,Toronto Blue Jays,BJAYS,1,2,1,3,2011,2012,1,8.13,2.83,-5.3,614,175,-439,2342,713,-1629,0.0,0.0,0.0,6500000.0,5850000.0,-650000.0
mcdoj003,John McDonald,Philadelphia Phillies,PHILS,1,1,1,2,2013,2015,2,-0.08,-0.15,-0.07,6,8,2,9,0,-9,0.0,12.0,12.0,0.0,0.0,0.0
mcdoj004,James McDonald,Los Angeles Dodgers,DOGRS,2,3,3,6,2010,2010,0,2.04,0.31,-1.73,235,38,-197,259,1,-258,1323.0,56.0,-1267.0,0.0,3250000.0,3250000.0
mcdoj101,Jim McDonnell,Cleveland Indians,INDINS,1,1,1,2,1946,1946,0,0.0,-0.01,-0.01,0,3,3,0,3,3,0.0,0.0,0.0,0.0,0.0,0.0
mcdoj104,Jim McDonald,Boston Red Sox,RSOX,3,7,4,11,1951,1954,3,1.03,-2.94,-3.97,539,149,-390,1347,410,-937,675.0,0.0,-675.0,8500.0,0.0,-8500.0
mcdoj104,Jim McDonald,St.Louis Browns,ORLS,5,8,10,18,1951,1960,9,15.63,13.98,-1.65,885,1228,343,1766,3784,2018,3101.0,1208.0,-1893.0,0.0,0.0,0.0
mcdoj104,Jim McDonald,New York Yankees,YANKS,12,33,27,60,1954,1970,16,40.55,76.98,36.43,5201,4368,-833,16466,10777,-5689,3212.0,10751.0,7539.0,302500.0,109500.0,-193000.0
mcdoj104,Jim McDonald,Baltimore Orioles,ORLS,1,1,1,2,1955,1955,0,0.0,0.39,0.39,0,20,20,0,18,18,0.0,147.0,147.0,0.0,0.0,0.0
mcdom001,Marshall McDougall,Oakland Athletics,ATLTCS,1,1,1,2,2002,2005,3,0.0,2.72,2.72,0,233,233,0,0,0,0.0,471.0,471.0,0.0,1500000.0,1500000.0
mcdoo001,Oddibe McDowell,Texas Rangers,RNGRS,1,3,1,4,1988,1993,5,6.72,20.24,13.52,624,632,8,2545,2680,135,0.0,0.0,0.0,930000.0,975000.0,45000.0
mcdoo001,Oddibe McDowell,Cleveland Indians,INDINS,1,1,1,2,1989,1990,1,1.89,0.94,-0.95,189,158,-31,637,551,-86,0.0,0.0,0.0,375000.0,400000.0,25000.0
mcdor001,Roger McDowell,New York Mets,METS,13,21,23,44,1989,1999,10,42.74,12.21,-30.53,2762,1749,-1013,6221,1744,-4477,4175.0,4730.0,555.0,13614666.0,12979167.0,-635499.0
mcdor001,Roger McDowell,Philadelphia Phillies,PHILS,2,2,3,5,1991,1996,5,2.71,3.43,0.72,422,429,7,10,199,189,949.0,999.0,50.0,2225000.0,165000.0,-2060000.0
mcdos101,Sam McDowell,Cleveland Indians,INDINS,8,10,15,25,1971,1989,18,20.02,90.97,70.95,1507,3544,2037,4040,10458,6418,4102.0,11030.0,6928.0,1747000.0,744000.0,-1003000.0
mcdot101,Tex McDonald,Cincinnati Reds,REDS,1,2,1,3,1913,1913,0,1.26,1.29,0.03,62,80,18,167,226,59,0.0,0.0,0.0,1500.0,0.0,-1500.0
mcelc001,Chuck McElroy,Philadelphia Phillies,PHILS,3,5,4,9,1991,1996,5,0.9,5.94,5.04,864,567,-297,60,158,98,1703.0,1127.0,-576.0,3609000.0,2929000.0,-680000.0
mcelc001,Chuck McElroy,Chicago Cubs,CUBS,1,1,3,4,1993,1995,2,1.08,0.0,-1.08,216,0,-216,11,0,-11,331.0,0.0,-331.0,312500.0,0.0,-312500.0
mcelc001,Chuck McElroy,Cincinnati Reds,REDS,1,1,1,2,1996,1996,0,1.51,0.61,-0.9,53,86,33,0,0,0,157.0,133.0,-24.0,817000.0,2100000.0,1283000.0
mcelc001,Chuck McElroy,Anaheim Angels,ANGELS,1,2,2,4,1997,1998,1,1.16,1.24,0.08,151,175,24,342,727,385,178.0,0.0,-178.0,1092000.0,2847500.0,1755500.0
mcelc001,Chuck McElroy,Arizona Diamondbacks,DBACKS,1,1,1,2,1997,1997,0,3.41,0.0,-3.41,232,0,-232,8,0,-8,327.0,0.0,-327.0,0.0,150000.0,150000.0
mcelc001,Chuck McElroy,Colorado Rockies,ROCKS,2,3,4,7,1999,2000,1,0.73,-0.11,-0.84,211,33,-178,561,29,-532,40.0,37.0,-3.0,4663333.0,3750000.0,-913333.0
mcelc001,Chuck McElroy,New York Mets,METS,2,2,2,4,1999,2005,6,0.3,0.53,0.23,77,502,425,0,1169,1169,333.0,0.0,-333.0,0.0,800000.0,800000.0
mcenw101,Will McEnaney,Cincinnati Reds,REDS,3,5,4,9,1976,1981,5,8.77,1.11,-7.66,1082,372,-710,1854,353,-1501,1843.0,1635.0,-208.0,85000.0,0.0,-85000.0
mcenw101,Will McEnaney,Montreal Expos,NATEX,1,1,1,2,1978,1978,0,-0.68,0.0,0.68,12,0,-12,0,0,0,26.0,0.0,-26.0,0.0,0.0,0.0
mcevl101,Lou McEvoy,New York Yankees,YANKS,1,5,2,7,1931,1947,16,0.0,15.3,15.3,0,992,992,0,1098,1098,0.0,2971.0,2971.0,19500.0,0.0,-19500.0
mcewj001,Joe McEwing,St. Louis Cardinals,CARDS,1,1,1,2,2000,2000,0,0.53,-0.25,-0.78,502,12,-490,1169,0,-1169,0.0,7.0,7.0,0.0,0.0,0.0
mcfac102,Chappie McFarland,St. Louis Cardinals,CARDS,3,6,3,9,1906,1912,6,24.88,17.32,-7.56,1485,464,-1021,4288,1239,-3049,4216.0,1939.0,-2277.0,0.0,0.0,0.0
mcfad101,Dan McFarlan,Brooklyn Dodgers,DOGRS,1,4,2,6,1899,1903,4,0.67,6.33,5.66,113,445,332,291,1743,1452,635.0,0.0,-635.0,0.0,0.0,0.0
mcfae101,Ed McFarland,Cincinnati Reds,REDS,4,11,5,16,1895,1906,11,8.81,24.47,15.66,1114,1079,-35,4520,3525,-995,393.0,2208.0,1815.0,1500.0,0.0,-1500.0
mcfae101,Ed McFarland,St. Louis Cardinals,CARDS,3,5,7,12,1897,1899,2,23.25,0.71,-22.54,1111,436,-675,4512,1666,-2846,0.0,668.0,668.0,0.0,0.0,0.0
mcfae101,Ed McFarland,Chicago White Sox,WSOX,1,1,1,2,1908,1909,1,0.34,-0.98,-1.32,19,32,13,50,53,3,0.0,0.0,0.0,0.0,0.0,0.0
mcfal101,Leon McFadden,Houston Astros,ASTROS,1,2,1,3,1970,1973,3,-0.36,4.11,4.47,121,272,151,243,41,-202,0.0,713.0,713.0,0.0,0.0,0.0
mcgaa001,Andy McGaffigan,New York Yankees,YANKS,1,2,1,3,1982,1983,1,0.43,-1.33,-1.76,102,24,-78,34,0,-34,441.0,285.0,-156.0,0.0,0.0,0.0
mcgaa001,Andy McGaffigan,Montreal Expos,NATEX,5,6,7,13,1984,1990,6,0.99,-0.06,-1.05,232,245,13,372,641,269,776.0,129.0,-647.0,0.0,752000.0,752000.0
mcgaa001,Andy McGaffigan,Cincinnati Reds,REDS,3,6,4,10,1985,1988,3,12.45,4.93,-7.52,892,228,-664,620,336,-284,4251.0,1549.0,-2702.0,1777500.0,937500.0,-840000.0
mcgaa001,Andy McGaffigan,Montreal Expos,NATEX,1,1,1,2,1990,1990,0,-0.34,0.0,0.34,8,0,-8,0,0,0,14.0,0.0,-14.0,0.0,0.0,0.0
mcgac101,Chippy McGarr,Philadelphia Athletics,ATLTCS,1,4,2,6,1887,1892,5,4.43,9.58,5.15,169,488,319,668,2210,1542,0.0,3.0,3.0,0.0,0.0,0.0
mcgad102,Dan McGann,Washington Senators,WSN,2,4,6,10,1897,1900,3,18.96,3.72,-15.24,481,583,102,1837,2412,575,1122.0,0.0,-1122.0,0.0,0.0,0.0
mcgad102,Dan McGann,Brooklyn Dodgers,DOGRS,1,2,1,3,1899,1902,3,2.44,3.21,0.77,77,202,125,321,766,445,0.0,0.0,0.0,0.0,0.0,0.0
mcgad102,Dan McGann,New York Giants,GIANTS,4,11,6,17,1907,1921,14,45.64,34.38,-11.26,2445,1600,-845,8369,5323,-3046,1733.0,2915.0,1182.0,6400.0,5200.0,-1200.0
mcgad102,Dan McGann,Cincinnati Reds,REDS,1,2,1,3,1909,1909,0,0.0,-0.02,-0.02,0,56,56,0,162,162,0.0,0.0,0.0,0.0,0.0,0.0
mcgeb101,Bill McGee,St. Louis Cardinals,CARDS,1,1,3,4,1941,1944,3,-0.79,6.28,7.07,106,205,99,63,186,123,632.0,1502.0,870.0,0.0,0.0,0.0
mcgec001,Casey McGehee,Pittsburgh Pirates,PIRATS,1,1,1,2,2012,2012,0,-0.66,-0.3,0.36,22,34,12,59,0,-59,0.0,41.0,41.0,2537500.0,0.0,-2537500.0
mcgec001,Casey McGehee,Milwaukee Brewers,BREWRS,1,1,1,2,2011,2012,1,0.38,0.53,0.15,92,139,47,293,0,-293,0.0,201.0,201.0,478000.0,0.0,-478000.0
mcgec001,Casey McGehee,Miami Marlins,MARLNS,4,9,8,17,2014,2019,5,11.45,0.0,-11.45,589,369,-220,738,128,-610,2851.0,1439.0,-1412.0,1650000.0,7660200.0,6010200.0
mcgef101,Frank McGee,Peoria,Peoria,1,1,1,2,1925,1925,0,-0.08,0.0,0.08,2,0,-2,3,0,-3,0.0,0.0,0.0,0.0,0.0,0.0
mcgej001,Jake McGee,Tampa Bay Devil Rays,RAYS,2,3,5,8,2016,2021,5,22.25,4.27,-17.98,873,307,-566,919,1191,272,3030.0,0.0,-3030.0,0.0,0.0,0.0
mcgek001,Kevin McGehee,San Francisco Giants,GIANTS,1,1,1,2,1993,1993,0,-0.02,-0.34,-0.32,5,18,13,0,29,29,50.0,0.0,-50.0,0.0,120000.0,120000.0
mcgew001,Willie McGee,New York Yankees,YANKS,1,1,1,2,1981,1981,0,25.57,0.0,-25.57,1661,0,-1661,6100,0,-6100,0.0,0.0,0.0,0.0,0.0,0.0
mcgew001,Willie McGee,St. Louis Cardinals,CARDS,2,3,5,8,1990,1994,4,1.02,11.85,10.83,307,640,333,1154,2488,1334,0.0,0.0,0.0,1500000.0,102500.0,-1397500.0
mcghe101,Ed McGhee,Chicago White Sox,WSOX,4,11,8,19,1953,1961,8,18.88,11.66,-7.22,2482,1258,-1224,8241,3866,-4375,2246.0,488.0,-1758.0,62000.0,80000.0,18000.0
mcghe101,Ed McGhee,Philadelphia Athletics,ATLTCS,3,5,7,12,1954,1956,2,1.85,3.26,1.41,238,491,253,141,1005,864,434.0,737.0,303.0,0.0,28500.0,28500.0
mcgid101,Dan McGinn,Montreal Expos,NATEX,1,2,2,4,1972,1973,1,-1.6,-1.59,0.01,85,126,41,8,295,287,188.0,2.0,-186.0,0.0,0.0,0.0
mcgij104,John McGillen,Philadelphia Athletics,ATLTCS,1,3,1,4,1944,1946,2,0.0,0.0,0.0,0,0,0,0,0,0,0.0,0.0,0.0,0.0,0.0,0.0
mcgir001,Russ McGinnis,Milwaukee Brewers,BREWRS,1,1,1,2,1987,1987,0,0.0,0.0,0.0,0,0,0,0,0,0,0.0,0.0,0.0,0.0,0.0,0.0
mcgir101,Randy McGilberry,Kansas City Royals,ROYALS,1,1,1,2,1980,1980,0,0.0,0.0,0.0,0,0,0,0,0,0,0.0,0.0,0.0,0.0,0.0,0.0
mcglj101,Jim McGlothlin,California Angels,ANGELS,3,6,7,13,1969,1974,5,8.36,4.59,-3.77,1680,510,-1170,1673,1948,275,4531.0,88.0,-4443.0,15000.0,105000.0,90000.0
mcglj101,Jim McGlothlin,Cincinnati Reds,REDS,1,1,1,2,1973,1973,0,0.33,0.0,-0.33,5,0,-5,0,0,0,55.0,0.0,-55.0,0.0,0.0,0.0
mcgll101,Lynn McGlothen,Boston Red Sox,RSOX,1,3,3,6,1973,1978,5,14.84,4.69,-10.15,678,283,-395,435,79,-356,3953.0,2795.0,-1158.0,53000.0,42000.0,-11000.0
mcgll101,Lynn McGlothen,St. Louis Cardinals,CARDS,2,4,2,6,1976,1984,8,12.93,6.84,-6.09,1102,1115,13,4070,2441,-1629,278.0,1190.0,912.0,0.0,700000.0,700000.0
mcgll101,Lynn McGlothen,San Francisco Giants,GIANTS,2,2,2,4,1978,1980,2,7.21,-0.85,-8.06,428,155,-273,463,251,-212,1587.0,138.0,-1449.0,0.0,0.0,0.0
mcgll101,Lynn McGlothen,Chicago Cubs,CUBS,1,1,1,2,1981,1982,1,0.02,-0.31,-0.33,11,65,54,0,72,72,65.0,0.0,-65.0,0.0,0.0,0.0
mcgob101,Beauty McGowan,Newark,Newark,1,1,1,2,1922,1922,0,-0.47,0.0,0.47,194,0,-194,689,0,-689,0.0,0.0,0.0,0.0,0.0,0.0
mcgob101,Beauty McGowan,Philadelphia Athletics,ATLTCS,1,4,1,5,1923,1932,9,0.0,51.22,51.22,0,1240,1240,0,5473,5473,0.0,0.0,0.0,9900.0,0.0,-9900.0
mcgob101,Beauty McGowan,KansasCity,KansasCity,1,1,1,2,1928,1928,0,2.78,0.0,-2.78,172,0,-172,725,0,-725,0.0,0.0,0.0,0.0,0.0,0.0
mcgob101,Beauty McGowan,St.Louis Browns,ORLS,2,5,2,7,1929,1932,3,0.0,-1.46,-1.46,0,66,66,0,56,56,0.0,187.0,187.0,15500.0,0.0,-15500.0
mcgok002,Kyle McGowin,Anaheim Angels,ANGELS,1,2,1,3,2016,2017,1,-0.03,-0.47,-0.44,104,77,-27,6,254,248,215.0,0.0,-215.0,0.0,2875000.0,2875000.0
mcgos001,Scott McGough,Los Angeles Dodgers,DOGRS,1,2,2,4,2012,2014,2,2.73,9.76,7.03,137,350,213,121,1120,999,1127.0,40.0,-1087.0,0.0,1500000.0,1500000.0
mcgrb101,Bob McGraw,New York Yankees,YANKS,1,3,1,4,1919,1923,4,4.53,19.1,14.57,242,331,89,205,452,247,1664.0,3271.0,1607.0,4800.0,0.0,-4800.0
mcgrb101,Bob McGraw,Minneapolis,Minneapolis,1,1,3,4,1925,1925,0,0.71,0.0,-0.71,72,0,-72,74,0,-74,591.0,0.0,-591.0,0.0,0.0,0.0
mcgrb101,Bob McGraw,Brooklyn Dodgers,DOGRS,1,1,1,2,1927,1931,4,-1.16,1.1,2.26,36,327,291,37,1148,1111,282.0,0.0,-282.0,7500.0,0.0,-7500.0
mcgrb101,Bob McGraw,Philadelphia Phillies,PHILS,1,2,2,4,1929,1933,4,-1.21,0.77,1.98,26,281,255,77,572,495,0.0,0.0,0.0,6000.0,7500.0,1500.0
mcgrb101,Bob McGraw,New York Yankees,YANKS,3,12,4,16,1921,1928,7,-3.56,9.03,12.59,367,917,550,1242,3654,2412,159.0,0.0,-159.0,15750.0,13000.0,-2750.0
mcgrf001,Fred McGriff,New York Yankees,YANKS,1,4,2,6,1982,1985,3,24.16,-0.71,-24.87,840,62,-778,3265,0,-3265,136.0,360.0,224.0,650000.0,0.0,-650000.0
mcgrf001,Fred McGriff,Toronto Blue Jays,BJAYS,1,2,2,4,1990,1997,7,12.72,30.74,18.02,688,1742,1054,2938,7599,4661,0.0,0.0,0.0,2950000.0,2256667.0,-693333.0
mcgrf001,Fred McGriff,San Diego Padres,PADRS,3,5,7,12,1993,1998,5,12.75,-1.51,-14.26,1185,414,-771,4165,455,-3710,1084.0,742.0,-342.0,4300000.0,0.0,-4300000.0
mcgrf001,Fred McGriff,Tampa Bay Devil Rays,RAYS,1,1,2,3,2001,2003,2,3.26,-0.39,-3.65,195,27,-168,796,73,-723,0.0,0.0,0.0,6500000.0,665000.0,-5835000.0
mcgrs001,Scott McGregor,New York Yankees,YANKS,12,22,23,45,1976,1997,21,98.9,27.78,-71.12,5024,1689,-3335,9897,2906,-6991,18250.0,6192.0,-12058.0,4415000.0,2812500.0,-1602500.0
mcgrt001,Tug McGraw,New York Mets,METS,6,9,10,19,1974,1984,10,10.05,22.43,12.38,1462,1185,-277,1334,4141,2807,2280.0,196.0,-2084.0,90000.0,0.0,-90000.0
mcgrt002,Terry McGriff,Cincinnati Reds,REDS,1,3,1,4,1990,1993,3,-0.24,2.7,2.94,60,260,200,65,933,868,497.0,0.0,-497.0,104000.0,934000.0,830000.0
mcgrt003,Tom McGraw,Milwaukee Brewers,BREWRS,1,1,1,2,1993,1997,4,0.0,-0.11,-0.11,0,15,15,0,0,0,0.0,167.0,167.0,0.0,0.0,0.0
mcguc001,Chris McGuiness,Boston Red Sox,RSOX,1,4,1,5,2010,2013,3,0.81,5.19,4.38,55,355,300,34,1329,1295,134.0,0.0,-134.0,0.0,418580.0,418580.0
mcguc001,Chris McGuiness,Texas Rangers,RNGRS,1,1,1,2,2013,2014,1,0.0,-0.85,-0.85,0,11,11,0,2,2,0.0,172.0,172.0,0.0,0.0,0.0
mcgud101,Deacon McGuire,Washington Senators,WSN,1,1,2,3,1899,1900,1,3.21,2.44,-0.77,202,77,-125,766,321,-445,0.0,0.0,0.0,0.0,0.0,0.0
mcgum101,Mickey McGuire,Baltimore Orioles,ORLS,1,1,1,2,1970,1973,3,0.0,0.33,0.33,0,31,31,0,3,3,0.0,74.0,74.0,0.0,0.0,0.0
mcgur001,Ryan McGuire,Boston Red Sox,RSOX,2,4,3,7,1996,1997,1,-1.72,2.82,4.54,535,239,-296,705,937,232,864.0,0.0,-864.0,0.0,0.0,0.0
mcgur002,Reese McGuire,Pittsburgh Pirates,PIRATS,1,3,1,4,2016,2017,1,1.56,-0.04,-1.6,169,12,-157,400,1,-399,396.0,34.0,-362.0,0.0,2200000.0,2200000.0
mcgwm001,Mark McGwire,Oakland Athletics,ATLTCS,4,6,7,13,1997,2001,4,19.4,1.7,-17.7,839,336,-503,2643,151,-2492,1295.0,1953.0,658.0,8351500.0,5845000.0,-2506500.0
mcham101,Marty McHale,Boston Red Sox,RSOX,9,25,23,48,1912,1935,23,51.77,27.05,-24.72,3792,3039,-753,15081,11185,-3896,0.0,1203.0,1203.0,45050.0,29350.0,-15700.0
mchea101,Austin McHenry,Milwaukee,Milwaukee,1,1,4,5,1918,1918,0,10.1,0.0,-10.1,543,0,-543,2143,0,-2143,0.0,0.0,0.0,0.0,0.0,0.0
mchev101,Vance McHenry,Seattle Mariners,MARNRS,1,1,1,2,1983,1983,0,0.0,0.0,0.0,0,0,0,0,0,0,0.0,0.0,0.0,0.0,0.0,0.0
mchuc001,Collin McHugh,New York Mets,METS,1,1,1,2,2013,2014,1,-0.62,2.01,2.63,8,191,183,4,734,730,57.0,0.0,-57.0,0.0,492000.0,492000.0
mcinh101,Harry McIntire,Brooklyn Dodgers,DOGRS,1,1,3,4,1910,1910,0,2.43,-1.28,-3.71,121,277,156,145,1042,897,1039.0,0.0,-1039.0,0.0,0.0,0.0
mcinj101,Joe McIntosh,San Diego Padres,PADRS,1,2,1,3,1975,1977,2,-0.91,4.82,5.73,30,191,161,2,745,743,65.0,0.0,-65.0,0.0,0.0,0.0
mcinm101,Matty McIntyre,Buffalo,Buffalo,1,2,4,6,1903,1904,1,16.79,0.0,-16.79,801,0,-801,3453,0,-3453,39.0,0.0,-39.0,0.0,0.0,0.0
mcinm101,Matty McIntyre,Chicago White Sox,WSOX,1,5,1,6,1912,1928,16,0.0,33.22,33.22,0,1757,1757,0,6239,6239,0.0,0.0,0.0,0.0,0.0,0.0
mcins101,Stuffy McInnis,Philadelphia Athletics,ATLTCS,3,6,7,13,1918,1923,5,45.65,20.16,-25.49,2920,1028,-1892,11909,4219,-7690,678.0,0.0,-678.0,2400.0,0.0,-2400.0
mcins101,Stuffy McInnis,Boston Red Sox,RSOX,7,16,21,37,1921,1935,14,33.5,17.21,-16.29,2930,2181,-749,11538,8048,-3490,0.0,1203.0,1203.0,45050.0,29350.0,-15700.0
mcjad101,Doc McJames,Washington Senators,WSN,2,4,6,10,1897,1900,3,18.96,3.72,-15.24,481,583,102,1837,2412,575,1122.0,0.0,-1122.0,0.0,0.0,0.0
mckaa101,Archie McKain,Boston Red Sox,RSOX,1,2,3,5,1938,1940,2,15.76,-0.33,-16.09,1005,102,-903,3681,69,-3612,671.0,596.0,-75.0,16000.0,19500.0,3500.0
mckaa101,Archie McKain,St.Louis Browns,ORLS,1,2,1,3,1943,1943,0,0.96,-1.44,-2.4,36,20,-16,28,16,-12,207.0,157.0,-50.0,12000.0,15000.0,3000.0
mckah101,Hal McKain,Chicago White Sox,WSOX,1,1,1,2,1932,1932,0,0.0,-0.57,-0.57,0,6,6,0,1,1,0.0,21.0,21.0,5000.0,0.0,-5000.0
mckeb101,Bill McKechnie,Pittsburgh Pirates,PIRATS,2,6,5,11,1912,1915,3,18.03,4.57,-13.46,1733,358,-1375,6155,1366,-4789,795.0,0.0,-795.0,13500.0,13500.0,0.0
mckeb101,Bill McKechnie,New York Giants,GIANTS,3,6,6,12,1916,1923,7,51.71,19.99,-31.72,1982,727,-1255,7625,1751,-5874,2062.0,3773.0,1711.0,15800.0,9600.0,-6200.0
mckej001,Joel McKeon,Chicago White Sox,WSOX,2,3,2,5,1988,1989,1,0.24,0.81,0.57,9,66,57,0,229,229,99.0,0.0,-99.0,0.0,0.0,0.0
mckem001,Michael McKenry,Colorado Rockies,ROCKS,3,4,3,7,2011,2012,1,0.0,0.09,0.09,0,4,4,0,0,0,0.0,6.0,6.0,0.0,2700000.0,2700000.0
mcker103,Red McKee,New York Yankees,YANKS,1,1,1,2,1912,1913,1,1.49,0.22,-1.27,189,23,-166,508,73,-435,0.0,0.0,0.0,0.0,0.0,0.0
mckia001,Andrew McKirahan,Atlanta Braves,BRAVES,2,3,3,6,2017,2017,0,-0.1,1.0,1.1,24,121,97,105,500,395,0.0,0.0,0.0,0.0,0.0,0.0
mckia101,Alex McKinnon,St. Louis Maroons,SL5,1,1,2,3,1886,1887,1,1.5,0.0,-1.5,48,0,-48,208,0,-208,0.0,0.0,0.0,0.0,0.0,0.0
mckib001,Billy McKinney,Oakland Athletics,ATLTCS,2,6,6,12,2014,2020,6,10.93,24.37,13.44,708,1106,398,2216,4232,2016,860.0,540.0,-320.0,5345000.0,500000.0,-4845000.0
mckib001,Billy McKinney,Chicago Cubs,CUBS,1,4,1,5,2016,2016,0,9.71,1.2,-8.51,545,54,-491,1768,0,-1768,353.0,80.0,-273.0,0.0,0.0,0.0
mckib001,Billy McKinney,New York Yankees,YANKS,1,2,1,3,2018,2020,2,-1.13,4.31,5.44,271,53,-218,932,4,-928,0.0,823.0,823.0,621900.0,13000000.0,12378100.0
mckib001,Billy McKinney,Milwaukee Brewers,BREWRS,1,1,1,2,2021,2021,0,0.31,0.0,-0.31,39,0,-39,102,0,-102,0.0,0.0,0.0,0.0,0.0,0.0
mckib001,Billy McKinney,New York Mets,METS,1,1,1,2,2021,2021,0,-0.22,0.0,0.22,37,0,-37,98,0,-98,0.0,0.0,0.0,0.0,0.0,0.0
mckir101,Rich McKinney,Chicago White Sox,WSOX,4,7,5,12,1971,1982,11,34.05,40.39,6.34,1531,1264,-267,5010,3974,-1036,2522.0,3171.0,649.0,9000.0,633000.0,624000.0
mckir101,Rich McKinney,New York Yankees,YANKS,1,2,1,3,1972,1973,1,-1.68,1.39,3.07,150,123,-27,306,538,232,22.0,0.0,-22.0,35500.0,100000.0,64500.0
mcknj101,Jim McKnight,St. Louis Cardinals,CARDS,1,1,1,2,1960,1961,1,-0.83,-0.33,0.5,63,92,29,93,254,161,0.0,0.0,0.0,0.0,0.0,0.0
mcknj101,Jim McKnight,Chicago Cubs,CUBS,1,1,1,2,1962,1964,2,0.0,0.03,0.03,0,20,20,0,38,38,0.0,0.0,0.0,0.0,0.0,0.0
mcknt001,Tony McKnight,Houston Astros,ASTROS,1,1,1,2,2001,2001,0,0.08,0.27,0.19,24,50,26,23,0,-23,208.0,67.0,-141.0,0.0,1200000.0,1200000.0
mclab101,Bo McLaughlin,Houston Astros,ASTROS,1,1,1,2,1979,1983,4,-0.34,-1.78,-1.44,74,392,318,6,30,24,149.0,845.0,696.0,0.0,0.0,0.0
mclab102,Byron McLaughlin,Seattle Mariners,MARNRS,1,1,1,2,1980,1981,1,0.0,0.0,0.0,0,0,0,0,0,0,0.0,0.0,0.0,0.0,0.0,0.0
mclad101,Denny McLain,Detroit Tigers,TIGRS,3,8,7,15,1970,1979,9,1.68,25.88,24.2,545,2212,1667,1182,7310,6128,747.0,4256.0,3509.0,232600.0,149500.0,-83100.0
mclad101,Denny McLain,Texas Rangers,RNGRS,4,5,6,11,1972,1976,4,2.75,-2.07,-4.82,623,350,-273,1485,570,-915,1225.0,962.0,-263.0,23900.0,160000.0,136100.0
mclad101,Denny McLain,Oakland Athletics,ATLTCS,1,1,1,2,1972,1972,0,-0.92,0.0,0.92,30,3,-27,16,3,-13,162.0,0.0,-162.0,75000.0,0.0,-75000.0
mclaj001,Joey McLaughlin,Atlanta Braves,BRAVES,1,3,2,5,1979,1986,7,6.25,5.96,-0.29,653,1043,390,1647,3360,1713,1023.0,3.0,-1020.0,0.0,0.0,0.0
mclej101,Jim McLeod,Philadelphia Phillies,PHILS,1,3,1,4,1933,1934,1,0.0,-0.02,-0.02,0,6,6,0,21,21,0.0,0.0,0.0,0.0,0.0,0.0
mclej101,Jim McLeod,Albany,Albany,1,1,1,2,1933,1933,0,-2.05,0.0,2.05,67,0,-67,251,0,-251,0.0,0.0,0.0,0.0,0.0,0.0
mclel101,Larry McLean,Chicago Cubs,CUBS,2,4,3,7,1903,1912,9,14.83,52.1,37.27,532,1045,513,1056,2195,1139,4091.0,6835.0,2744.0,0.0,2400.0,2400.0
mclel101,Larry McLean,St. Louis Cardinals,CARDS,1,1,1,2,1913,1913,0,-0.02,0.0,0.02,122,2,-120,275,2,-273,0.0,0.0,0.0,0.0,3300.0,3300.0
mclem001,Mark McLemore,California Angels,ANGELS,1,1,1,2,1990,1993,3,-0.22,0.7,0.92,8,179,171,12,383,371,0.0,0.0,0.0,175000.0,0.0,-175000.0
mclem002,Marty McLeary,Florida Marlins,MARLNS,1,1,1,2,2004,2004,0,-0.18,0.0,0.18,6,0,-6,0,0,0,11.0,0.0,-11.0,0.0,0.0,0.0
mclew101,Wayne McLeland,Seattle,Seattle,2,3,6,9,1951,1954,3,0.2,0.0,-0.2,158,0,-158,88,0,-88,781.0,0.0,-781.0,0.0,0.0,0.0
mclic101,Cal McLish,Brooklyn Dodgers,DOGRS,1,5,2,7,1947,1947,0,3.3,-0.19,-3.49,337,37,-300,419,81,-338,1285.0,0.0,-1285.0,17500.0,0.0,-17500.0
mclic101,Cal McLish,Pittsburgh Pirates,PIRATS,22,40,53,93,1948,1973,25,26.59,60.08,33.49,3582,5165,1583,9869,14610,4741,4211.0,5429.0,1218.0,216500.0,108500.0,-108000.0
mclic101,Cal McLish,Cleveland Indians,INDINS,3,5,5,10,1959,1965,6,6.43,1.26,-5.17,1198,354,-844,3637,1453,-2184,454.0,0.0,-454.0,7500.0,10500.0,3000.0
mclic101,Cal McLish,Cincinnati Reds,REDS,1,2,1,3,1960,1963,3,15.36,2.72,-12.64,449,236,-213,454,894,440,3599.0,0.0,-3599.0,0.0,0.0,0.0
mclon001,Nate McLouth,Pittsburgh Pirates,PIRATS,4,4,7,11,2009,2016,7,-1.1,-1.11,-0.01,303,854,551,1159,1249,90,52.0,4336.0,4284.0,10500000.0,964500.0,-9535500.0
mcmad102,Don McMahon,Cleveland Indians,INDINS,3,6,4,10,1966,1968,2,5.05,0.29,-4.76,824,214,-610,588,274,-314,3146.0,179.0,-2967.0,27000.0,25000.0,-2000.0
mcmad102,Don McMahon,Boston Red Sox,RSOX,1,2,1,3,1967,1968,1,3.8,1.35,-2.45,154,163,9,14,561,547,413.0,0.0,-413.0,0.0,31250.0,31250.0
mcmad102,Don McMahon,Chicago White Sox,WSOX,1,1,1,2,1968,1968,0,0.72,-1.22,-1.94,108,34,-74,10,7,-3,218.0,94.0,-124.0,0.0,24500.0,24500.0
mcmad102,Don McMahon,Detroit Tigers,TIGRS,1,1,1,2,1969,1972,3,5.26,-1.81,-7.07,420,190,-230,35,548,513,915.0,0.0,-915.0,0.0,9000.0,9000.0
mcmaj102,Jack McMahan,Pittsburgh Pirates,PIRATS,1,2,1,3,1956,1956,0,-0.27,-0.37,-0.1,46,11,-35,14,41,27,185.0,0.0,-185.0,0.0,0.0,0.0
mcmaj102,Jack McMahan,Kansas City Athletics,ATLTCS,38,80,81,161,1957,1976,19,137.3,59.64,-77.66,12943,8836,-4107,29783,24655,-5128,18720.0,9434.0,-9286.0,506100.0,626500.0,120400.0
mcmaj103,Jack McMahon,New York Giants,GIANTS,2,6,3,9,1894,1899,5,4.47,33.12,28.65,259,755,496,879,2015,1136,369.0,5250.0,4881.0,0.0,0.0,0.0
mcmaj105,Jim McManus,Detroit Tigers,TIGRS,4,12,12,24,1957,1964,7,6.47,14.38,7.91,1197,947,-250,3186,1303,-1883,1459.0,3692.0,2233.0,0.0,0.0,0.0
mcmam101,Marty McManus,St.Louis Browns,ORLS,25,52,60,112,1927,1952,25,169.13,172.17,3.04,8392,11292,2900,28367,37730,9363,13765.0,19339.0,5574.0,243500.0,227450.0,-16050.0
mcmam101,Marty McManus,Detroit Tigers,TIGRS,1,1,1,2,1931,1934,3,3.49,-0.44,-3.93,216,65,-151,840,211,-629,0.0,0.0,0.0,12500.0,10000.0,-2500.0
mcmib001,Billy McMillon,Florida Marlins,MARLNS,1,1,1,2,1997,1997,0,0.53,0.48,-0.05,24,52,28,81,152,71,0.0,0.0,0.0,0.0,4825000.0,4825000.0
mcmig001,Greg McMichael,Atlanta Braves,BRAVES,1,1,2,3,1996,1998,2,1.08,-0.7,-1.78,284,64,-220,4,9,5,480.0,165.0,-315.0,460000.0,123000.0,-337000.0
mcmig001,Greg McMichael,New York Mets,METS,1,2,2,4,1998,1999,1,1.17,0.6,-0.57,64,36,-28,46,33,-13,438.0,278.0,-160.0,3150000.0,2800000.0,-350000.0
mcmig001,Greg McMichael,Los Angeles Dodgers,DOGRS,1,2,1,3,1998,1998,0,-0.35,2.59,2.94,141,28,-113,1,35,34,217.0,292.0,75.0,0.0,350000.0,350000.0
mcmig001,Greg McMichael,New York Mets,METS,1,2,1,3,1999,1999,0,4.14,-0.38,-4.52,174,36,-138,0,0,0,542.0,40.0,-502.0,1950000.0,2500000.0,550000.0
mcmin101,Norm McMillan,New York Yankees,YANKS,1,4,1,5,1923,1934,11,-1.25,33.68,34.93,272,692,420,598,908,310,765.0,6610.0,5845.0,0.0,0.0,0.0
mcmin101,Norm McMillan,Boston Red Sox,RSOX,2,3,2,5,1924,1927,3,-0.11,2.38,2.49,76,333,257,226,1222,996,0.0,0.0,0.0,7200.0,7000.0,-200.0
mcmin101,Norm McMillan,St.Louis Browns,ORLS,1,4,1,5,1925,1928,3,0.0,-0.47,-0.47,0,145,145,0,462,462,0.0,0.0,0.0,0.0,0.0,0.0
mcmir101,Roy McMillan,Cincinnati Reds,REDS,4,5,7,12,1960,1966,6,21.4,13.65,-7.75,896,630,-266,1971,1304,-667,3861.0,3422.0,-439.0,0.0,35500.0,35500.0
mcmir101,Roy McMillan,Milwaukee Braves,BRAVES,1,1,2,3,1964,1969,5,0.23,-0.08,-0.31,346,4,-342,1225,3,-1222,0.0,0.0,0.0,0.0,14000.0,14000.0
mcmit101,Tommy McMillan,Rochester,Rochester,1,1,2,3,1912,1913,1,-0.21,0.0,0.21,41,0,-41,175,0,-175,0.0,0.0,0.0,0.0,0.0,0.0
mcmit102,Tom McMillan,Seattle Mariners,MARNRS,5,14,13,27,1978,1985,7,13.7,0.35,-13.35,1053,894,-159,693,2333,1640,4377.0,1863.0,-2514.0,175000.0,512500.0,337500.0
mcmuc001,Craig McMurtry,Atlanta Braves,BRAVES,1,1,2,3,1987,1988,1,0.0,-0.66,-0.66,0,21,21,0,64,64,0.0,0.0,0.0,0.0,0.0,0.0
mcmuh101,Hugh McMullen,Chicago Cubs,CUBS,2,8,3,11,1933,1946,13,22.35,18.34,-4.01,627,903,276,2568,3781,1213,0.0,0.0,0.0,0.0,0.0,0.0
mcmuk101,Ken McMullen,Los Angeles Dodgers,DOGRS,4,12,9,21,1964,1984,20,57.0,60.48,3.48,4290,2463,-1827,14544,7259,-7285,4034.0,7191.0,3157.0,163000.0,22000.0,-141000.0
mcmuk101,Ken McMullen,Washington Senators,RNGRS,8,12,14,26,1970,1976,6,41.95,6.2,-35.75,3496,1129,-2367,11326,2648,-8678,5481.0,1797.0,-3684.0,75900.0,337100.0,261200.0
mcmuk101,Ken McMullen,California Angels,ANGELS,9,14,19,33,1972,1977,5,23.23,20.03,-3.2,1306,1112,-194,3665,3424,-241,3213.0,1843.0,-1370.0,313500.0,358250.0,44750.0
mcnad102,Dave McNally,Baltimore Orioles,ORLS,6,18,17,35,1974,1988,14,24.52,108.22,83.7,1282,4856,3574,1868,13359,11491,8105.0,12121.0,4016.0,705333.0,98500.0,-606833.0
mcnae101,Eric McNair,Philadelphia Athletics,ATLTCS,1,2,3,5,1936,1936,0,2.69,-1.63,-4.32,1023,75,-948,4530,240,-4290,12.0,35.0,23.0,0.0,0.0,0.0
mcnae101,Eric McNair,Boston Red Sox,RSOX,1,1,1,2,1938,1939,1,1.32,0.03,-1.29,195,20,-175,793,33,-760,0.0,0.0,0.0,10500.0,4000.0,-6500.0
mcnam101,Mike McNally,Boston Red Sox,RSOX,11,21,24,45,1920,1937,17,85.68,51.32,-34.36,3377,2671,-706,8411,9094,683,11819.0,4939.0,-6880.0,73300.0,46200.0,-27100.0
mcnam101,Mike McNally,New York Yankees,YANKS,1,1,1,2,1924,1925,1,0.0,0.11,0.11,0,66,66,0,184,184,0.0,0.0,0.0,5500.0,6500.0,1000.0
mcnam101,Mike McNally,Boston Red Sox,RSOX,2,3,2,5,1924,1925,1,-0.33,2.0,2.33,12,119,107,22,474,452,0.0,0.0,0.0,4250.0,3200.0,-1050.0
mcnat101,Tim McNamara,Boston Braves,BRAVES,1,1,1,2,1925,1926,1,-0.24,-2.55,-2.31,12,89,77,0,45,45,18.0,425.0,407.0,3300.0,0.0,-3300.0
mcnee101,Earl McNeely,Sacramento,Sacramento,1,1,2,3,1924,1924,0,3.52,0.0,-3.52,362,0,-362,1353,0,-1353,0.0,0.0,0.0,0.0,4000.0,4000.0
mcnee101,Earl McNeely,Washington Senators,TWINS,6,16,10,26,1927,1941,14,54.71,66.87,12.16,4079,2617,-1462,12814,9775,-3039,8820.0,3821.0,-4999.0,91600.0,78200.0,-13400.0
mcnej001,Jeff McNeely,Boston Red Sox,RSOX,1,2,1,3,1994,1996,2,0.0,2.28,2.28,0,132,132,0,511,511,0.0,0.0,0.0,122000.0,650000.0,528000.0
mcnej101,Jerry McNertney,Milwaukee Brewers,BREWRS,5,11,10,21,1970,1978,8,8.62,9.79,1.17,793,534,-259,2099,1479,-620,524.0,1634.0,1110.0,180301.0,32500.0,-147801.0
mcner101,Rusty McNealy,Seattle Mariners,MARNRS,1,2,1,3,1981,1986,5,-0.02,2.62,2.64,15,104,89,4,0,-4,0.0,696.0,696.0,0.0,0.0,0.0
mcner101,Rusty McNealy,Oakland Athletics,ATLTCS,3,6,4,10,1983,1985,2,5.99,6.32,0.33,113,66,-47,0,0,0,1871.0,1218.0,-653.0,600000.0,1225000.0,625000.0
mcnub101,Bill McNulty,Oakland Athletics,ATLTCS,1,2,1,3,1972,1977,5,0.0,3.91,3.91,0,223,223,0,1,1,0.0,1247.0,1247.0,36400.0,31000.0,-5400.0
mcnub101,Bill McNulty,Texas Rangers,RNGRS,1,1,1,2,1973,1973,0,0.0,1.38,1.38,0,82,82,0,263,263,0.0,0.0,0.0,0.0,0.0,0.0
mcnup101,Pat McNulty,Cleveland Indians,INDINS,1,5,1,6,1922,1935,13,0.0,5.93,5.93,0,850,850,0,2604,2604,0.0,0.0,0.0,0.0,0.0,0.0
mcqug101,George McQuinn,St.Louis Browns,ORLS,1,1,1,2,1945,1945,0,-0.74,0.0,0.74,136,0,-136,556,0,-556,0.0,0.0,0.0,10000.0,12000.0,2000.0
mcqug103,George McQuillan,Philadelphia Phillies,PHILS,12,24,28,52,1910,1931,21,100.95,91.27,-9.68,4848,5202,354,15981,18765,2784,10753.0,6282.0,-4471.0,25000.0,31850.0,6850.0
mcqug103,George McQuillan,Cincinnati Reds,REDS,1,2,1,3,1911,1911,0,0.0,0.0,0.0,0,0,0,0,0,0,0.0,0.0,0.0,0.0,0.0,0.0
mcqug103,George McQuillan,Columbus,Columbus,1,1,2,3,1913,1913,0,3.36,0.0,-3.36,200,0,-200,183,0,-183,1648.0,0.0,-1648.0,0.0,2400.0,2400.0
mcquh101,Hugh McQuillan,Boston Braves,BRAVES,8,14,15,29,1922,1938,16,24.55,24.58,0.03,1430,2750,1320,3384,9349,5965,5737.0,3676.0,-2061.0,46500.0,21100.0,-25400.0
mcquh101,Hugh McQuillan,New York Giants,GIANTS,2,4,4,8,1927,1930,3,-1.4,7.13,8.53,721,460,-261,1415,1177,-238,3501.0,2253.0,-1248.0,8500.0,35000.0,26500.0
mcquh102,Herb McQuaid,StPaul,StPaul,1,1,1,2,1925,1925,0,-0.82,0.0,0.82,34,0,-34,8,0,-8,115.0,0.0,-115.0,0.0,0.0,0.0
mcqum103,Mike McQueen,Atlanta Braves,BRAVES,1,1,1,2,1974,1974,0,0.0,0.0,0.0,0,0,0,0,0,0,0.0,0.0,0.0,0.0,0.0,0.0
mcrab001,Brian McRae,Kansas City Royals,ROYALS,3,7,6,13,1995,1999,4,9.1,-0.12,-9.22,478,162,-316,1831,0,-1831,148.0,890.0,742.0,0.0,250000.0,250000.0
mcrab001,Brian McRae,Chicago Cubs,CUBS,2,4,4,8,1997,2001,4,3.27,3.1,-0.17,1097,717,-380,1379,2198,819,1191.0,830.0,-361.0,9308333.0,6555000.0,-2753333.0
mcrab001,Brian McRae,New York Mets,METS,3,5,4,9,1999,2005,6,0.19,1.57,1.38,110,682,572,29,1629,1600,370.0,40.0,-330.0,3750000.0,5463333.0,1713333.0
mcrab001,Brian McRae,Colorado Rockies,ROCKS,1,1,1,2,1999,1999,0,-0.31,0.0,0.31,31,0,-31,101,0,-101,0.0,0.0,0.0,0.0,0.0,0.0
mcrah001,Hal McRae,Cincinnati Reds,REDS,2,3,4,7,1972,1974,2,29.0,0.89,-28.11,1940,85,-1855,7657,116,-7541,179.0,420.0,241.0,68500.0,39550.0,-28950.0
mcran101,Norm McRae,Detroit Tigers,TIGRS,3,8,7,15,1970,1979,9,1.68,25.88,24.2,545,2212,1667,1182,7310,6128,747.0,4256.0,3509.0,232600.0,149500.0,-83100.0
mcran101,Norm McRae,Texas Rangers,RNGRS,1,1,1,2,1972,1973,1,0.0,-0.96,-0.96,0,72,72,0,166,166,0.0,0.0,0.0,0.0,30000.0,30000.0
mcran101,Norm McRae,Detroit Tigers,TIGRS,2,5,2,7,1972,1975,3,-0.09,-0.55,-0.46,97,196,99,191,508,317,4.0,0.0,-4.0,88300.0,80000.0,-8300.0
mcrek001,Kevin McReynolds,San Diego Padres,PADRS,7,15,16,31,1986,1992,6,36.08,17.42,-18.66,2233,2005,-228,6347,3857,-2490,2335.0,2895.0,560.0,4783333.0,3737500.0,-1045833.0
mcrek001,Kevin McReynolds,New York Mets,METS,10,18,17,35,1991,2006,15,27.4,32.03,4.63,1969,2082,113,4193,3379,-814,2476.0,3605.0,1129.0,24814657.0,19134833.0,-5679824.0
mcrek001,Kevin McReynolds,Kansas City Royals,ROYALS,2,2,3,5,1994,1997,3,0.55,-1.51,-2.06,91,191,100,377,801,424,0.0,52.0,52.0,250000.0,115000.0,-135000.0
mctib101,Bill McTigue,Boston Braves,BRAVES,1,1,1,2,1913,1913,0,0.0,-0.46,-0.46,0,73,73,0,247,247,0.0,0.0,0.0,0.0,0.0,0.0
mcwed101,Doug McWeeny,Chicago White Sox,WSOX,2,5,2,7,1922,1931,9,8.34,28.43,20.09,522,1292,770,2094,5360,3266,0.0,0.0,0.0,22100.0,10000.0,-12100.0
mcwed101,Doug McWeeny,Chicago White Sox,WSOX,6,16,8,24,1924,1936,12,0.32,2.24,1.92,474,816,342,1478,2777,1299,0.0,222.0,222.0,28700.0,12500.0,-16200.0
mcwed101,Doug McWeeny,Brooklyn Dodgers,DOGRS,1,1,1,2,1930,1932,2,-0.24,3.36,3.6,16,100,84,8,123,115,77.0,911.0,834.0,0.0,0.0,0.0
mcwil001,Larry McWilliams,Atlanta Braves,BRAVES,1,1,2,3,1982,1986,4,8.17,6.94,-1.23,340,204,-136,296,222,-74,2507.0,1805.0,-702.0,90000.0,0.0,-90000.0
mcwil001,Larry McWilliams,Philadelphia Phillies,PHILS,1,1,1,2,1989,1989,0,0.1,0.0,-0.1,21,0,-21,0,0,0,123.0,0.0,-123.0,68000.0,0.0,-68000.0
meacb001,Bob Meacham,St. Louis Cardinals,CARDS,1,2,3,5,1982,1982,0,3.76,0.0,-3.76,464,0,-464,1598,0,-1598,0.0,0.0,0.0,0.0,0.0,0.0
meacb001,Bob Meacham,New York Yankees,YANKS,1,1,1,2,1988,1988,0,0.0,0.0,0.0,0,0,0,0,0,0,0.0,0.0,0.0,212500.0,98000.0,-114500.0
meacr001,Rusty Meacham,Kansas City Royals,ROYALS,1,1,1,2,1996,1996,0,-0.15,0.0,0.15,15,0,-15,0,0,0,127.0,0.0,-127.0,0.0,0.0,0.0
meada001,Austin Meadows,Pittsburgh Pirates,PIRATS,1,3,1,4,2018,2020,2,12.58,1.43,-11.15,379,64,-315,1364,58,-1306,825.0,516.0,-309.0,556500.0,0.0,-556500.0
meadb001,Brian Meadows,Florida Marlins,MARLNS,1,1,1,2,1999,2001,2,-0.24,-0.34,-0.1,43,148,105,44,0,-44,374.0,220.0,-154.0,265000.0,1100000.0,835000.0
meadb001,Brian Meadows,San Diego Padres,PADRS,5,7,7,14,2000,2005,5,1.18,0.5,-0.68,503,354,-149,1468,844,-624,511.0,486.0,-25.0,5375000.0,3250000.0,-2125000.0
meadl101,Lee Meadows,St. Louis Cardinals,CARDS,1,2,3,5,1919,1926,7,13.87,-0.32,-14.19,461,130,-331,1191,116,-1075,2559.0,705.0,-1854.0,6650.0,3000.0,-3650.0
meadl101,Lee Meadows,Philadelphia Phillies,PHILS,2,3,5,8,1923,1925,2,15.64,3.41,-12.23,721,322,-399,1877,1147,-730,3746.0,484.0,-3262.0,5500.0,10200.0,4700.0
mecij001,Jim Mecir,Seattle Mariners,MARNRS,3,7,5,12,1995,1999,4,28.82,-1.18,-30.0,1743,533,-1210,4473,1676,-2797,3491.0,1076.0,-2415.0,2835000.0,1944000.0,-891000.0
mecij001,Jim Mecir,New York Yankees,YANKS,1,2,2,4,1997,1997,0,0.0,0.17,0.17,0,28,28,0,103,103,0.0,0.0,0.0,0.0,2100000.0,2100000.0
mecij001,Jim Mecir,Tampa Bay Devil Rays,RAYS,1,2,1,3,2000,2006,6,2.82,0.05,-2.77,267,200,-67,0,2,2,762.0,753.0,-9.0,350000.0,0.0,-350000.0
medid101,Doc Medich,New York Yankees,YANKS,3,6,5,11,1975,1988,13,1.27,58.36,57.09,482,1914,1432,1065,8000,6935,1466.0,1352.0,-114.0,0.0,100000.0,100000.0
medid101,Doc Medich,Pittsburgh Pirates,PIRATS,5,10,11,21,1977,1988,11,53.71,31.99,-21.72,2929,1675,-1254,9660,6568,-3092,5429.0,149.0,-5280.0,807000.0,0.0,-807000.0
medir001,Rafael Medina,New York Yankees,YANKS,10,23,17,40,1997,2012,15,32.6,51.23,18.63,1993,1981,-12,3061,4822,1761,8275.0,6854.0,-1421.0,22173073.0,34719286.0,12546213.0
medir001,Rafael Medina,San Diego Padres,PADRS,1,3,1,4,1997,1998,1,8.67,9.07,0.4,908,70,-838,3276,93,-3183,272.0,771.0,499.0,0.0,4510000.0,4510000.0
mediy001,Yoervis Medina,Seattle Mariners,MARNRS,4,8,5,13,2015,2017,2,4.45,2.99,-1.46,664,250,-414,2424,536,-1888,119.0,403.0,284.0,9532900.0,9014000.0,-518900.0
mediy001,Yoervis Medina,Pittsburgh Pirates,PIRATS,1,1,1,2,2016,2016,0,0.0,0.0,0.0,0,0,0,0,0,0,0.0,0.0,0.0,0.0,0.0,0.0
medvs001,Scott Medvin,Detroit Tigers,TIGRS,5,7,8,15,1985,1991,6,13.23,9.61,-3.62,999,888,-111,2374,2066,-308,1829.0,1754.0,-75.0,1440000.0,1070000.0,-370000.0
medvs001,Scott Medvin,San Francisco Giants,GIANTS,1,2,1,3,1987,1991,4,-1.33,7.08,8.41,332,192,-140,71,229,158,980.0,1803.0,823.0,0.0,750000.0,750000.0
medvs001,Scott Medvin,Pittsburgh Pirates,PIRATS,1,1,1,2,1990,1996,6,-0.11,-0.19,-0.08,5,48,43,0,0,0,13.0,97.0,84.0,0.0,0.0,0.0
medwj101,Joe Medwick,St. Louis Cardinals,CARDS,1,2,5,7,1940,1942,2,22.71,2.24,-20.47,811,200,-611,2272,485,-1787,3020.0,487.0,-2533.0,0.0,0.0,0.0
medwj101,Joe Medwick,New York Giants,GIANTS,2,3,2,5,1945,1946,1,-0.4,0.68,1.08,74,93,19,237,277,40,41.0,0.0,-41.0,0.0,0.0,0.0
meeke001,Evan Meek,San Diego Padres,PADRS,1,2,1,3,2006,2007,1,-0.26,0.94,1.2,13,88,75,1,235,234,47.0,0.0,-47.0,0.0,0.0,0.0
meekj101,Jouett Meekin,Washington Senators,WSN,1,2,3,5,1894,1894,0,30.33,-0.6,-30.93,706,32,-674,1804,50,-1754,5250.0,309.0,-4941.0,0.0,0.0,0.0
meekr101,Roy Meeker,Philadelphia Athletics,ATLTCS,1,4,1,5,1925,1925,0,0.0,0.15,0.15,0,133,133,0,522,522,0.0,0.0,0.0,4850.0,0.0,-4850.0
meekr101,Roy Meeker,Portland,Portland,1,2,1,3,1926,1926,0,-0.58,0.0,0.58,17,0,-17,12,0,-12,63.0,0.0,-63.0,0.0,0.0,0.0
meeks101,Sammy Meeks,Cincinnati Reds,REDS,1,1,2,3,1952,1952,0,0.0,0.0,0.0,0,0,0,0,0,0,0.0,0.0,0.0,0.0,0.0,0.0
meied001,Dave Meier,Texas Rangers,RNGRS,1,2,1,3,1988,1988,0,-0.02,-0.74,-0.72,2,12,10,5,0,-5,0.0,188.0,188.0,0.0,0.0,0.0
mejia001,Adalberto Mejia,San Francisco Giants,GIANTS,3,3,4,7,2016,2021,5,-0.83,2.17,3.0,274,306,32,850,926,76,443.0,334.0,-109.0,4200000.0,0.0,-4200000.0
mejie001,Erick Mejia,Seattle Mariners,MARNRS,2,2,2,4,2016,2016,0,0.0,-0.23,-0.23,0,1,1,0,0,0,0.0,15.0,15.0,590000.0,0.0,-590000.0
mejie001,Erick Mejia,Los Angeles Dodgers,DOGRS,1,4,2,6,2018,2021,3,-0.68,0.86,1.54,21,242,221,43,6,-37,41.0,333.0,292.0,0.0,0.0,0.0
mejif001,Francisco Mejia,Cleveland Indians,INDINS,1,1,2,3,2018,2020,2,0.25,2.92,2.67,116,229,113,344,0,-344,0.0,585.0,585.0,0.0,0.0,0.0
mejif001,Francisco Mejia,San Diego Padres,PADRS,1,4,1,5,2020,2020,0,1.51,0.0,-1.51,105,0,-105,277,0,-277,238.0,0.0,-238.0,0.0,7600000.0,7600000.0
mejih001,Humberto Mejia,Miami Marlins,MARLNS,2,4,2,6,2020,2021,1,2.61,2.79,0.18,160,115,-45,284,406,122,441.0,172.0,-269.0,0.0,0.0,0.0
mejij002,Jean Carlos Mejia,Cleveland Indians,INDINS,1,1,1,2,2021,2021,0,0.0,0.0,0.0,0,0,0,0,0,0,0.0,0.0,0.0,0.0,0.0,0.0
mejim001,Miguel Mejia,Kansas City Royals,ROYALS,1,1,1,2,1995,1996,1,-0.39,0.0,0.39,45,0,-45,23,0,-23,0.0,0.0,0.0,0.0,0.0,0.0
mejir001,Roberto Mejia,Cincinnati Reds,REDS,1,2,1,3,1996,1996,0,0.0,1.33,1.33,0,37,37,0,141,141,0.0,0.0,0.0,0.0,1135000.0,1135000.0
mejir101,Roman Mejias,Houston Astros,ASTROS,1,1,1,2,1962,1964,2,-0.35,0.46,0.81,173,146,-27,490,508,18,0.0,0.0,0.0,0.0,0.0,0.0
mejis101,Sam Mejias,Milwaukee Brewers,BREWRS,1,1,1,2,1976,1976,0,-0.02,1.05,1.07,18,32,14,23,0,-23,0.0,148.0,148.0,0.0,0.0,0.0
mejis101,Sam Mejias,St. Louis Cardinals,CARDS,7,10,11,21,1976,1992,16,18.25,16.78,-1.47,1455,1377,-78,2974,3172,198,3388.0,4921.0,1533.0,1943333.0,497500.0,-1445833.0
mejis101,Sam Mejias,Montreal Expos,NATEX,1,1,2,3,1978,1983,5,-0.08,3.97,4.05,31,798,767,14,2458,2444,0.0,0.0,0.0,0.0,0.0,0.0
melam001,Mark Melancon,New York Yankees,YANKS,1,2,1,3,2010,2010,0,-0.72,-0.33,0.39,296,37,-259,397,123,-274,275.0,0.0,-275.0,0.0,14500000.0,14500000.0
melam001,Mark Melancon,Houston Astros,ASTROS,3,4,7,11,2011,2020,9,12.85,10.28,-2.57,1115,873,-242,3907,2456,-1451,460.0,1629.0,1169.0,1011100.0,450000.0,-561100.0
melam001,Mark Melancon,Boston Red Sox,RSOX,1,4,2,6,2012,2019,7,7.63,8.07,0.44,566,624,58,6,2223,2217,907.0,22.0,-885.0,521000.0,4100000.0,3579000.0
melam001,Mark Melancon,Pittsburgh Pirates,PIRATS,2,3,3,6,2016,2020,4,0.57,1.75,1.18,126,151,25,21,0,-21,455.0,223.0,-232.0,0.0,1200000.0,1200000.0
melam001,Mark Melancon,San Francisco Giants,GIANTS,1,1,2,3,2019,2019,0,1.32,0.0,-1.32,68,0,-68,0,0,0,131.0,0.0,-131.0,14000000.0,1610000.0,-12390000.0
melef001,Francisco Melendez,San Francisco Giants,GIANTS,1,1,1,2,1989,1989,0,-0.06,0.0,0.06,9,0,-9,13,0,-13,0.0,0.0,0.0,0.0,0.0,0.0
melej001,Jose Melendez,San Diego Padres,PADRS,7,16,17,33,1992,2006,14,13.22,41.43,28.21,2732,3624,892,9058,12976,3918,809.0,1324.0,515.0,13157500.0,22694000.0,9536500.0
melel101,Luis Melendez,St. Louis Cardinals,CARDS,8,11,12,23,1976,1992,16,17.83,16.54,-1.29,1535,1471,-64,3101,3178,77,3388.0,5085.0,1697.0,1943333.0,497500.0,-1445833.0
meles101,Sam Mele,Boston Red Sox,RSOX,2,4,2,6,1949,1955,6,5.69,3.6,-2.09,738,340,-398,1644,197,-1447,2239.0,1844.0,-395.0,22000.0,0.0,-22000.0
meles101,Sam Mele,Washington Senators,TWINS,7,9,12,21,1952,1962,10,-0.82,8.13,8.95,582,2192,1610,1770,6562,4792,250.0,2448.0,2198.0,39500.0,31500.0,-8000.0
meles101,Sam Mele,Chicago White Sox,WSOX,22,41,37,78,1954,1969,15,45.6,54.96,9.36,4683,4529,-154,11508,9881,-1627,7275.0,8147.0,872.0,218750.0,240000.0,21250.0
melis101,Ski Melillo,St.Louis Browns,ORLS,13,24,34,58,1935,1952,17,53.1,59.51,6.41,2966,6743,3777,8865,20779,11914,6789.0,12669.0,5880.0,136500.0,122100.0,-14400.0
mellk001,Keury Mella,San Francisco Giants,GIANTS,1,2,1,3,2015,2015,0,6.27,0.49,-5.78,455,19,-436,1700,17,-1683,51.0,166.0,115.0,0.0,9775000.0,9775000.0
meloj001,Juan Melo,San Diego Padres,PADRS,1,1,1,2,1999,1999,0,0.0,0.0,0.0,0,0,0,0,0,0,0.0,0.0,0.0,0.0,0.0,0.0
meloj001,Juan Melo,Toronto Blue Jays,BJAYS,1,1,1,2,1999,1999,0,0.0,0.0,0.0,0,0,0,0,0,0,0.0,0.0,0.0,0.0,0.0,0.0
meloj001,Juan Melo,New York Yankees,YANKS,2,2,2,4,2000,2000,0,0.35,-0.01,-0.36,58,31,-27,131,51,-80,0.0,0.0,0.0,213000.0,0.0,-213000.0
meloj002,Jon Meloan,Los Angeles Dodgers,DOGRS,1,2,2,4,2008,2011,3,29.84,9.15,-20.69,1336,406,-930,5723,1608,-4115,6.0,0.0,-6.0,0.0,6100000.0,6100000.0
meloj002,Jon Meloan,Cleveland Indians,INDINS,1,1,1,2,2009,2009,0,0.0,-0.25,-0.25,0,3,3,0,0,0,0.0,7.0,7.0,0.0,0.0,0.0
meltb101,Bill Melton,Chicago White Sox,WSOX,2,5,5,10,1975,1978,3,1.08,-0.17,-1.25,421,278,-143,1261,1093,-168,18.0,0.0,-18.0,70000.0,0.0,-70000.0
meltb101,Bill Melton,California Angels,ANGELS,1,1,2,3,1976,1977,1,0.05,0.0,-0.05,50,0,-50,154,0,-154,0.0,0.0,0.0,0.0,0.0,0.0
meltd101,Dave Melton,Kansas City Athletics,ATLTCS,1,1,1,2,1958,1959,1,0.0,0.0,0.0,0,0,0,0,0,0,0.0,0.0,0.0,0.0,0.0,0.0
meltr101,Rube Melton,Philadelphia Phillies,PHILS,1,1,2,3,1942,1943,1,3.54,0.0,-3.54,190,0,-190,142,0,-142,1234.0,0.0,-1234.0,0.0,0.0,0.0
melum001,Mitch Meluskey,Cleveland Indians,INDINS,1,2,2,4,1995,1995,0,1.75,0.0,-1.75,147,0,-147,459,0,-459,0.0,0.0,0.0,0.0,0.0,0.0
melum001,Mitch Meluskey,Houston Astros,ASTROS,2,4,4,8,2000,2008,8,0.51,2.1,1.59,210,1212,1002,625,3536,2911,615.0,482.0,-133.0,4015000.0,5550000.0,1535000.0
melvb001,Bob Melvin,Detroit Tigers,TIGRS,5,7,8,15,1985,1991,6,13.23,9.61,-3.62,999,888,-111,2374,2066,-308,1829.0,1754.0,-75.0,1440000.0,1070000.0,-370000.0
melvb001,Bob Melvin,San Francisco Giants,GIANTS,1,1,1,2,1989,1991,2,0.98,3.55,2.57,257,301,44,864,918,54,0.0,0.0,0.0,0.0,0.0,0.0
melvb001,Bob Melvin,Baltimore Orioles,ORLS,1,1,1,2,1991,1992,1,0.32,1.4,1.08,32,48,16,77,0,-77,0.0,268.0,268.0,650000.0,0.0,-650000.0
melvb001,Bob Melvin,California Angels,ANGELS,1,1,1,2,1994,1994,0,-0.26,0.1,0.36,11,4,-7,21,0,-21,0.0,20.0,20.0,0.0,150000.0,150000.0
menck001,Kevin Mench,Texas Rangers,RNGRS,1,4,2,6,2006,2013,7,2.6,12.97,10.37,354,855,501,502,3435,2933,270.0,0.0,-270.0,7270260.0,8500000.0,1229740.0
mendl001,Luis Mendoza,Boston Red Sox,RSOX,1,1,1,2,2006,2008,2,-2.25,0.28,2.53,34,32,-2,2,0,-2,241.0,111.0,-130.0,0.0,0.0,0.0
mendm101,Mario Mendoza,Pittsburgh Pirates,PIRATS,1,3,3,6,1978,1978,0,-3.43,0.0,3.43,296,0,-296,706,0,-706,404.0,0.0,-404.0,0.0,0.0,0.0
mendm101,Mario Mendoza,Seattle Mariners,MARNRS,2,7,7,14,1980,1985,5,8.79,3.61,-5.18,489,434,-55,632,1358,726,2623.0,1017.0,-1606.0,175000.0,512500.0,337500.0
mendr002,Roman Mendez,Boston Red Sox,RSOX,1,4,1,5,2010,2013,3,0.81,5.19,4.38,55,355,300,34,1329,1295,134.0,0.0,-134.0,0.0,418580.0,418580.0
menej101,Jock Menefee,Louisville Colonels,LS3,1,1,2,3,1894,1894,0,0.41,-0.65,-1.06,30,30,0,52,117,65,340.0,51.0,-289.0,0.0,0.0,0.0
mengd001,Daniel Mengden,Houston Astros,ASTROS,1,2,1,3,2015,2015,0,2.02,-0.15,-2.17,65,14,-51,15,2,-13,908.0,220.0,-688.0,0.0,0.0,0.0
menhp001,Paul Menhart,Toronto Blue Jays,BJAYS,2,3,3,6,1995,1996,1,-1.74,0.08,1.82,122,9,-113,179,30,-149,326.0,0.0,-326.0,218000.0,135000.0,-83000.0
menhp001,Paul Menhart,Seattle Mariners,MARNRS,1,1,1,2,1997,1997,0,0.45,0.0,-0.45,17,0,-17,14,0,-14,132.0,0.0,-132.0,0.0,0.0,0.0
menkd101,Denis Menke,Atlanta Braves,BRAVES,1,2,2,4,1967,1974,7,20.12,0.7,-19.42,938,637,-301,2766,2102,-664,2072.0,0.0,-2072.0,0.0,0.0,0.0
menkd101,Denis Menke,Houston Astros,ASTROS,8,15,14,29,1971,1989,18,76.39,55.08,-21.31,4763,4769,6,15346,14810,-536,3810.0,5622.0,1812.0,705000.0,416000.0,-289000.0
menkd101,Denis Menke,Cincinnati Reds,REDS,3,3,5,8,1974,1977,3,17.28,0.57,-16.71,269,116,-153,34,72,38,4814.0,634.0,-4180.0,0.0,0.0,0.0
menom101,Mike Menosky,Washington Senators,TWINS,3,6,5,11,1919,1926,7,13.31,20.32,7.01,1029,562,-467,3656,1370,-2286,534.0,3052.0,2518.0,16400.0,11500.0,-4900.0
meolm101,Mike Meola,Chicago Cubs,CUBS,1,1,1,2,1935,1935,0,-0.2,0.0,0.2,18,0,-18,2,0,-2,58.0,0.0,-58.0,0.0,4000.0,4000.0
meolr101,Rudy Meoli,California Angels,ANGELS,1,2,1,3,1975,1975,0,0.37,0.02,-0.35,66,1,-65,152,0,-152,0.0,15.0,15.0,0.0,0.0,0.0
meolr101,Rudy Meoli,San Diego Padres,PADRS,1,1,1,2,1976,1977,1,0.0,2.31,2.31,0,193,193,0,338,338,0.0,0.0,0.0,0.0,0.0,0.0
merch002,Hector Mercado,Philadelphia Phillies,PHILS,1,1,1,2,1997,1997,0,0.0,0.0,0.0,0,0,0,0,0,0,0.0,0.0,0.0,0.0,0.0,0.0
merch002,Hector Mercado,Cincinnati Reds,REDS,1,1,1,2,2002,2004,2,-0.39,-0.16,0.23,87,235,148,6,505,499,173.0,0.0,-173.0,0.0,0.0,0.0
merck001,Kent Mercker,Atlanta Braves,BRAVES,1,1,2,3,1995,1997,2,-1.07,-0.03,1.04,14,84,70,0,3,3,174.0,150.0,-24.0,2250000.0,109000.0,-2141000.0
merck001,Kent Mercker,Baltimore Orioles,ORLS,1,1,1,2,1996,1996,0,0.32,0.17,-0.15,10,64,54,0,263,263,35.0,0.0,-35.0,2825000.0,2000000.0,-825000.0
merck001,Kent Mercker,St. Louis Cardinals,CARDS,2,3,4,7,1999,2002,3,0.57,1.5,0.93,13,220,207,1,30,29,89.0,465.0,376.0,2800000.0,4250000.0,1450000.0
merck001,Kent Mercker,Cincinnati Reds,REDS,1,1,1,2,2003,2008,5,0.54,0.56,0.02,36,262,226,1,88,87,51.0,1025.0,974.0,550000.0,0.0,-550000.0
mercl001,Luis Mercedes,Baltimore Orioles,ORLS,1,1,1,2,1993,1993,0,-0.34,-0.02,0.32,18,5,-13,29,0,-29,0.0,50.0,50.0,120000.0,0.0,-120000.0
merco001,Orlando Mercado,Seattle Mariners,MARNRS,1,1,1,2,1985,1986,1,-0.41,-0.22,0.19,46,80,34,112,205,93,0.0,0.0,0.0,0.0,0.0,0.0
merco001,Orlando Mercado,Texas Rangers,RNGRS,1,1,1,2,1987,1987,0,-0.31,0.0,0.31,10,0,-10,24,0,-24,0.0,0.0,0.0,0.0,0.0,0.0
merco001,Orlando Mercado,Detroit Tigers,TIGRS,2,2,2,4,1987,1988,1,0.2,0.01,-0.19,7,6,-1,6,6,0,0.0,0.0,0.0,0.0,0.0,0.0
merco002,Orlando Merced,Pittsburgh Pirates,PIRATS,3,5,8,13,1996,2007,11,2.44,5.98,3.54,539,1682,1143,911,3950,3039,615.0,1633.0,1018.0,9245000.0,3600000.0,-5645000.0
merco002,Orlando Merced,Minnesota Twins,TWINS,2,4,5,9,1998,2002,4,-0.39,0.81,1.2,167,43,-124,84,66,-18,831.0,325.0,-506.0,2100000.0,0.0,-2100000.0
merco003,Oscar Mercado,St. Louis Cardinals,CARDS,1,1,2,3,2018,2018,0,2.75,0.0,-2.75,223,0,-223,813,0,-813,0.0,0.0,0.0,0.0,0.0,0.0
merec001,Cla Meredith,Boston Red Sox,RSOX,1,3,1,4,2006,2008,2,5.93,-0.85,-6.78,724,107,-617,907,303,-604,712.0,0.0,-712.0,353400.0,1500000.0,1146600.0
merec001,Cla Meredith,San Diego Padres,PADRS,1,1,1,2,2009,2011,2,0.5,-0.35,-0.85,52,140,88,0,269,269,131.0,0.0,-131.0,430900.0,0.0,-430900.0
merir001,Ron Meridith,Houston Astros,ASTROS,1,1,1,2,1984,1984,0,0.0,0.0,0.0,0,0,0,0,0,0,0.0,0.0,0.0,0.0,0.0,0.0
merir001,Ron Meridith,Atlanta Braves,BRAVES,1,1,1,2,1984,1984,0,0.14,0.0,-0.14,70,0,-70,5,0,-5,155.0,0.0,-155.0,0.0,0.0,0.0
merir001,Ron Meridith,Chicago Cubs,CUBS,1,1,2,3,1986,1986,0,-0.29,0.0,0.29,16,0,-16,0,0,0,71.0,0.0,-71.0,0.0,0.0,0.0
merkf101,Fred Merkle,New York Giants,GIANTS,1,1,1,2,1916,1920,4,-0.18,2.34,2.52,25,288,263,86,820,734,0.0,0.0,0.0,6000.0,4250.0,-1750.0
merll001,Lou Merloni,San Diego Padres,PADRS,1,1,1,2,2003,2003,0,0.05,0.0,-0.05,15,0,-15,34,0,-34,0.0,0.0,0.0,560000.0,0.0,-560000.0
merrb001,Brett Merriman,Colorado Rockies,ROCKS,1,1,2,3,1993,1993,0,-1.18,0.21,1.39,34,130,96,0,1,1,132.0,187.0,55.0,0.0,0.0,0.0
merrj001,Julian Merryweather,Cleveland Indians,INDINS,1,1,2,3,2018,2018,0,0.45,0.4,-0.05,21,16,-5,0,60,60,78.0,0.0,-78.0,0.0,23000000.0,23000000.0
merrj102,Jim Merritt,Minnesota Twins,TWINS,3,3,5,8,1968,1976,8,4.61,19.31,14.7,558,760,202,861,1953,1092,2239.0,2568.0,329.0,93000.0,124500.0,31500.0
merrj102,Jim Merritt,Cincinnati Reds,REDS,1,1,2,3,1972,1972,0,2.11,0.0,-2.11,66,0,-66,0,0,0,589.0,0.0,-589.0,0.0,20000.0,20000.0
merrl101,Lloyd Merritt,St. Louis Cardinals,CARDS,17,32,26,58,1959,1972,13,32.69,16.32,-16.37,3575,2596,-979,8857,7912,-945,2795.0,1167.0,-1628.0,42500.0,24000.0,-18500.0
merrl101,Lloyd Merritt,Los Angeles Dodgers,DOGRS,1,3,2,5,1959,1959,0,0.0,0.0,0.0,0,0,0,0,0,0,0.0,0.0,0.0,0.0,0.0,0.0
merts101,Sam Mertes,Columbus,Columbus,1,2,2,4,1898,1905,7,6.83,0.0,-6.83,327,0,-327,1338,0,-1338,0.0,0.0,0.0,0.0,0.0,0.0
merts101,Sam Mertes,New York Giants,GIANTS,1,2,1,3,1906,1908,2,0.72,1.14,0.42,182,308,126,648,1333,685,0.0,0.0,0.0,0.0,0.0,0.0
merum001,Matt Merullo,Chicago White Sox,WSOX,1,1,1,2,1994,1994,0,-0.27,0.0,0.27,4,0,-4,13,0,-13,0.0,0.0,0.0,0.0,0.0,0.0
mesaj001,Jose Mesa,Toronto Blue Jays,BJAYS,1,2,1,3,1987,1990,3,-2.03,4.09,6.12,69,76,7,0,0,0,1066.0,1357.0,291.0,0.0,625000.0,625000.0
mesaj001,Jose Mesa,Baltimore Orioles,ORLS,1,1,1,2,1992,1992,0,10.38,0.0,-10.38,348,0,-348,0,0,0,1942.0,0.0,-1942.0,0.0,0.0,0.0
mesaj001,Jose Mesa,Cleveland Indians,INDINS,7,12,14,26,1998,2011,13,4.4,12.56,8.16,1064,1445,381,2423,3925,1502,442.0,1477.0,1035.0,9756200.0,3392500.0,-6363700.0
mesns101,Steve Mesner,Chicago Cubs,CUBS,2,4,3,7,1939,1947,8,5.18,0.94,-4.24,213,106,-107,268,37,-231,1599.0,395.0,-1204.0,7800.0,2400.0,-5400.0
mesod001,Devin Mesoraco,Cincinnati Reds,REDS,1,2,1,3,2018,2018,0,0.75,0.95,0.2,66,48,-18,229,50,-179,0.0,384.0,384.0,0.0,0.0,0.0
messa101,Andy Messersmith,California Angels,ANGELS,9,14,19,33,1972,1977,5,23.23,20.03,-3.2,1306,1112,-194,3665,3424,-241,3213.0,1843.0,-1370.0,313500.0,358250.0,44750.0
messr001,Randy Messenger,Florida Marlins,MARLNS,1,1,2,3,2007,2007,0,0.01,-0.9,-0.91,73,70,-3,0,0,0,122.0,99.0,-23.0,380000.0,9866219.0,9486219.0
messt101,Tom Messitt,Louisville Colonels,LS3,1,12,5,17,1899,1900,1,267.1,0.0,-267.1,7388,0,-7388,29004,0,-29004,7568.0,0.0,-7568.0,4350.0,0.0,-4350.0
metkg101,George Metkovich,SanFrancisco,SanFrancisco,1,1,2,3,1943,1943,0,2.88,0.0,-2.88,436,0,-436,1857,0,-1857,0.0,0.0,0.0,0.0,6500.0,6500.0
metkg101,George Metkovich,Cleveland Indians,INDINS,1,2,1,3,1947,1950,3,0.0,-0.23,-0.23,0,120,120,0,319,319,0.0,0.0,0.0,0.0,14000.0,14000.0
metkg101,George Metkovich,Cleveland Indians,INDINS,1,3,1,4,1948,1948,0,0.0,0.0,0.0,0,0,0,0,0,0,0.0,0.0,0.0,0.0,0.0,0.0
metkg101,George Metkovich,Oakland,Oakland,2,2,4,6,1949,1951,2,-0.16,0.0,0.16,106,0,-106,394,0,-394,0.0,0.0,0.0,0.0,0.0,0.0
metkg101,George Metkovich,Pittsburgh Pirates,PIRATS,7,12,15,27,1953,1962,9,9.43,3.47,-5.96,1075,1271,196,3095,3842,747,1449.0,56.0,-1393.0,86000.0,33500.0,-52500.0
metrc101,Charlie Metro,Philadelphia Athletics,ATLTCS,2,7,2,9,1945,1954,9,0.34,26.52,26.18,48,961,913,112,4308,4196,0.0,0.0,0.0,15000.0,0.0,-15000.0
metza101,Alex Metzler,WichitaFalls,WichitaFalls,1,1,1,2,1926,1926,0,-0.21,0.0,0.21,20,0,-20,74,0,-74,0.0,0.0,0.0,0.0,0.0,0.0
metza101,Alex Metzler,St.Louis Browns,ORLS,1,4,1,5,1930,1932,2,0.0,-0.31,-0.31,0,16,16,0,36,36,0.0,0.0,0.0,10000.0,0.0,-10000.0
metzb101,Butch Metzger,San Francisco Giants,GIANTS,10,13,17,30,1974,1998,24,12.0,28.62,16.62,1215,2851,1636,2939,9682,6743,2410.0,443.0,-1967.0,7402778.0,4466667.0,-2936111.0
metzb101,Butch Metzger,San Diego Padres,PADRS,2,3,3,6,1977,1982,5,1.33,-0.97,-2.3,138,452,314,6,464,458,340.0,1013.0,673.0,0.0,0.0,0.0
metzr101,Roger Metzger,Chicago Cubs,CUBS,2,3,3,6,1970,1972,2,4.59,-1.64,-6.23,1356,116,-1240,4944,71,-4873,2.0,188.0,186.0,0.0,0.0,0.0
meusi101,Irish Meusel,Washington Senators,TWINS,1,1,1,2,1915,1915,0,0.0,-0.12,-0.12,0,14,14,0,47,47,0.0,0.0,0.0,0.0,0.0,0.0
meusi101,Irish Meusel,Philadelphia Phillies,PHILS,9,18,18,36,1921,1941,20,54.03,48.35,-5.68,3445,4318,873,13677,14163,486,324.0,6217.0,5893.0,26500.0,28600.0,2100.0
meyea001,Alex Meyer,Washington Nationals,NATEX,1,1,1,2,2012,2015,3,-0.41,8.42,8.83,6,361,355,0,1605,1605,19.0,0.0,-19.0,0.0,3000000.0,3000000.0
meyea001,Alex Meyer,Minnesota Twins,TWINS,1,3,2,5,2016,2018,2,3.27,-0.15,-3.42,67,80,13,11,0,-11,1029.0,566.0,-463.0,0.0,0.0,0.0
meyeb101,Billy Meyer,Philadelphia Athletics,ATLTCS,2,7,4,11,1917,1920,3,0.98,1.52,0.54,143,229,86,582,916,334,0.0,0.0,0.0,2400.0,0.0,-2400.0
meyeb102,Bob Meyer,Oakland Athletics,ATLTCS,1,2,1,3,1969,1969,0,-0.03,-0.27,-0.24,41,24,-17,30,3,-27,153.0,57.0,-96.0,0.0,0.0,0.0
meyeb103,Benny Meyer,Toronto,Toronto,1,1,1,2,1912,1912,0,-0.42,0.0,0.42,38,0,-38,102,0,-102,0.0,0.0,0.0,0.0,2150.0,2150.0
meyed001,Dan Meyer,Seattle Mariners,MARNRS,2,2,2,4,1981,1984,3,-1.58,1.24,2.82,307,237,-70,659,848,189,326.0,39.0,-287.0,0.0,0.0,0.0
meyed002,Dan Meyer,Atlanta Braves,BRAVES,1,3,1,4,2004,2013,9,-3.0,25.61,28.61,78,476,398,55,578,523,230.0,4719.0,4489.0,370000.0,5000000.0,4630000.0
meyed101,Dutch Meyer,New York Giants,GIANTS,1,1,1,2,1940,1940,0,-0.67,0.0,0.67,83,0,-83,283,0,-283,0.0,0.0,0.0,0.0,0.0,0.0
meyed101,Dutch Meyer,Detroit Tigers,TIGRS,1,2,1,3,1945,1947,2,5.36,14.82,9.46,363,401,38,1392,1659,267,0.0,0.0,0.0,0.0,9500.0,9500.0
meyed101,Dutch Meyer,Cleveland Indians,INDINS,1,2,1,3,1946,1948,2,0.0,0.17,0.17,0,46,46,0,71,71,0.0,0.0,0.0,0.0,3600.0,3600.0
meyej001,Joey Meyer,Minnesota Twins,TWINS,1,1,1,2,1991,1991,0,0.0,0.0,0.0,0,0,0,0,0,0,0.0,0.0,0.0,0.0,0.0,0.0
meyer101,Russ Meyer,Philadelphia Phillies,PHILS,1,2,1,3,1953,1955,2,-0.66,5.25,5.91,176,293,117,180,1204,1024,1334.0,0.0,-1334.0,0.0,0.0,0.0
meyer101,Russ Meyer,Brooklyn Dodgers,DOGRS,2,4,4,8,1955,1961,6,18.38,2.09,-16.29,1649,196,-1453,2986,562,-2424,2426.0,26.0,-2400.0,0.0,0.0,0.0
meyes101,Scott Meyer,Oakland Athletics,ATLTCS,1,2,3,5,1982,1982,0,0.0,-0.02,-0.02,0,8,8,0,20,20,0.0,0.0,0.0,0.0,0.0,0.0
miadb001,Bart Miadich,Boston Red Sox,RSOX,1,1,1,2,1998,1999,1,0.0,-0.14,-0.14,0,4,4,0,0,0,0.0,20.0,20.0,0.0,0.0,0.0
miced001,Dan Miceli,Kansas City Royals,ROYALS,1,2,1,3,1993,1994,1,4.73,-0.04,-4.77,577,61,-516,244,0,-244,2577.0,229.0,-2348.0,0.0,1165000.0,1165000.0
miced001,Dan Miceli,Pittsburgh Pirates,PIRATS,1,1,1,2,1996,1997,1,0.34,1.0,0.66,73,89,16,0,2,2,248.0,156.0,-92.0,220000.0,109000.0,-111000.0
miced001,Dan Miceli,Detroit Tigers,TIGRS,2,5,3,8,1997,1998,1,5.42,-0.93,-6.35,622,96,-526,194,193,-1,1023.0,185.0,-838.0,1475000.0,3035000.0,1560000.0
miced001,Dan Miceli,San Diego Padres,PADRS,6,8,8,16,1999,2005,6,0.84,0.26,-0.58,651,397,-254,1468,888,-580,731.0,860.0,129.0,6475000.0,3515000.0,-2960000.0
michc101,Cass Michaels,Chicago White Sox,WSOX,10,25,21,46,1950,1963,13,23.73,52.01,28.28,4184,3652,-532,12734,11891,-843,4692.0,2309.0,-2383.0,109500.0,111000.0,1500.0
michc101,Cass Michaels,Washington Senators,TWINS,2,2,3,5,1952,1954,2,0.23,-0.78,-1.01,251,84,-167,840,120,-720,0.0,171.0,171.0,14500.0,6000.0,-8500.0
michg101,Gene Michael,Pittsburgh Pirates,PIRATS,1,2,1,3,1966,1968,2,-0.49,7.77,8.26,319,302,-17,982,1350,368,0.0,0.0,0.0,0.0,85000.0,85000.0
michj001,Jason Michaels,Philadelphia Phillies,PHILS,1,1,1,2,2006,2006,0,1.3,0.06,-1.24,249,107,-142,910,0,-910,0.0,137.0,137.0,0.0,0.0,0.0
michj102,John Michaels,Buffalo,Buffalo,1,1,2,3,1931,1938,7,0.01,0.0,-0.01,57,0,-57,22,0,-22,242.0,0.0,-242.0,0.0,2400.0,2400.0
mickk001,Kameron Mickolio,Seattle Mariners,MARNRS,4,9,5,14,2008,2013,5,43.53,3.71,-39.82,1975,169,-1806,6859,413,-6446,3908.0,766.0,-3142.0,1000000.0,1300000.0,300000.0
mickk001,Kameron Mickolio,Baltimore Orioles,ORLS,1,2,2,4,2010,2012,2,1.15,1.04,-0.11,541,290,-251,2,1158,1156,777.0,0.0,-777.0,402500.0,833333.0,430833.0
middj001,Jason Middlebrook,San Diego Padres,PADRS,2,5,4,9,2002,2009,7,20.01,17.43,-2.58,923,844,-79,3191,3702,511,1341.0,29.0,-1312.0,805000.0,8833333.0,8028333.0
middj102,Jim Middleton,Detroit Tigers,TIGRS,1,9,2,11,1921,1941,20,0.0,3.03,3.03,0,202,202,0,144,144,0.0,1168.0,1168.0,3000.0,0.0,-3000.0
middw001,Will Middlebrooks,Boston Red Sox,RSOX,1,1,1,2,2014,2016,2,-0.81,-0.09,0.72,83,89,6,270,314,44,0.0,0.0,0.0,540000.0,0.0,-540000.0
midke101,Ezra Midkiff,New York Yankees,YANKS,6,17,13,30,1913,1931,18,64.97,69.67,4.7,2396,2595,199,7435,7892,457,6303.0,6917.0,614.0,44500.0,41500.0,-3000.0
miend001,Doug Mientkiewicz,Minnesota Twins,TWINS,1,1,1,2,2004,2004,0,-0.34,0.0,0.34,49,0,-49,119,0,-119,0.0,0.0,0.0,2800000.0,0.0,-2800000.0
miend001,Doug Mientkiewicz,Boston Red Sox,RSOX,1,2,1,3,2005,2005,0,1.08,0.0,-1.08,87,0,-87,313,0,-313,0.0,0.0,0.0,0.0,0.0,0.0
miesm001,Matt Mieske,San Diego Padres,PADRS,3,6,6,12,1992,2008,16,33.52,31.92,-1.6,1981,2091,110,6462,948,-5514,2787.0,3132.0,345.0,3375000.0,109000.0,-3266000.0
miesm001,Matt Mieske,Seattle Mariners,MARNRS,1,1,1,2,1999,1999,0,-0.77,0.0,0.77,116,0,-116,207,0,-207,0.0,0.0,0.0,500000.0,0.0,-500000.0
mikkp101,Pete Mikkelsen,New York Yankees,YANKS,1,2,1,3,1965,1966,1,1.61,-0.56,-2.17,206,24,-182,30,14,-16,547.0,134.0,-413.0,11000.0,37500.0,26500.0
mikkp101,Pete Mikkelsen,Chicago Cubs,CUBS,3,5,5,10,1968,1976,8,1.41,-2.65,-4.06,244,580,336,611,1135,524,48.0,653.0,605.0,0.0,0.0,0.0
mikkp101,Pete Mikkelsen,St. Louis Cardinals,CARDS,2,3,4,7,1968,1972,4,-0.2,0.93,1.13,310,99,-211,33,204,171,825.0,16.0,-809.0,17500.0,12000.0,-5500.0
mikom001,Miles Mikolas,San Diego Padres,PADRS,2,3,2,5,2013,2019,6,1.1,0.61,-0.49,248,107,-141,694,312,-382,3.0,0.0,-3.0,0.0,0.0,0.0
mikom001,Miles Mikolas,Pittsburgh Pirates,PIRATS,1,1,1,2,2013,2014,1,-0.85,0.0,0.85,11,0,-11,2,0,-2,172.0,0.0,-172.0,0.0,0.0,0.0
mikse101,Eddie Miksis,Brooklyn Dodgers,DOGRS,3,6,7,13,1951,1958,7,4.28,2.12,-2.16,1667,685,-982,5534,2062,-3472,435.0,267.0,-168.0,50000.0,61500.0,11500.0
mikse101,Eddie Miksis,Chicago Cubs,CUBS,5,10,9,19,1956,1965,9,7.39,7.94,0.55,637,1087,450,1408,195,-1213,1395.0,2758.0,1363.0,0.0,0.0,0.0
milab001,Bob Milacki,Kansas City Royals,ROYALS,1,1,1,2,1995,1995,0,-0.46,0.36,0.82,7,9,2,0,0,0,63.0,96.0,33.0,0.0,750000.0,750000.0
milbl001,Larry Milbourne,Houston Astros,ASTROS,1,1,1,2,1977,1978,1,-0.7,0.11,0.81,487,8,-479,1420,0,-1420,0.0,19.0,19.0,0.0,0.0,0.0
milbl001,Larry Milbourne,Seattle Mariners,MARNRS,1,2,2,4,1980,1986,6,0.82,-0.08,-0.9,108,8,-100,284,16,-268,0.0,0.0,0.0,0.0,0.0,0.0
milbl001,Larry Milbourne,New York Yankees,YANKS,4,8,8,16,1982,1992,10,8.27,12.89,4.62,1161,565,-596,2474,1712,-762,2564.0,669.0,-1895.0,913333.0,1045000.0,131667.0
milbl001,Larry Milbourne,Minnesota Twins,TWINS,1,1,1,2,1982,1982,0,-0.36,0.0,0.36,82,0,-82,319,0,-319,0.0,0.0,0.0,0.0,0.0,0.0
milbl001,Larry Milbourne,New York Yankees,YANKS,2,3,4,7,1984,1995,11,-1.54,12.32,13.86,98,675,577,235,2177,1942,199.0,234.0,35.0,0.0,0.0,0.0
milea001,Aaron Miles,Chicago White Sox,WSOX,1,1,1,2,2003,2008,5,0.28,7.33,7.05,233,672,439,913,2504,1591,0.0,0.0,0.0,0.0,300000.0,300000.0
milea001,Aaron Miles,Colorado Rockies,ROCKS,1,2,1,3,2005,2006,1,1.78,0.15,-1.63,503,131,-372,1507,1,-1506,15.0,134.0,119.0,326000.0,1850000.0,1524000.0
milea001,Aaron Miles,Chicago Cubs,CUBS,1,2,3,5,2009,2010,1,-0.2,-0.27,-0.07,39,14,-25,106,0,-106,0.0,28.0,28.0,2601500.0,400000.0,-2201500.0
milea001,Aaron Miles,Oakland Athletics,ATLTCS,1,2,2,4,2010,2013,3,0.0,1.78,1.78,0,197,197,0,612,612,0.0,0.0,0.0,0.0,0.0,0.0
miled101,Dee Miles,Philadelphia Athletics,ATLTCS,1,1,1,2,1942,1944,2,0.0,1.01,1.01,0,224,224,0,889,889,0.0,0.0,0.0,6000.0,0.0,-6000.0
miled101,Dee Miles,Boston Red Sox,RSOX,1,2,1,3,1943,1947,4,0.0,2.88,2.88,0,436,436,0,1857,1857,0.0,0.0,0.0,6500.0,0.0,-6500.0
miled101,Dee Miles,Chattanooga,Chattanooga,1,1,2,3,1938,1939,1,0.45,0.0,-0.45,373,0,-373,1127,0,-1127,0.0,0.0,0.0,0.0,0.0,0.0
milew001,Wade Miley,Arizona Diamondbacks,DBACKS,1,1,3,4,2014,2017,3,2.29,-0.45,-2.74,33,125,92,2,96,94,581.0,834.0,253.0,523500.0,0.0,-523500.0
milew001,Wade Miley,Boston Red Sox,RSOX,2,3,3,6,2015,2019,4,1.53,0.12,-1.41,94,36,-58,9,0,-9,632.0,95.0,-537.0,3666000.0,0.0,-3666000.0
milew001,Wade Miley,Seattle Mariners,MARNRS,1,1,1,2,2016,2018,2,-0.59,1.69,2.28,48,47,-1,9,6,-3,634.0,663.0,29.0,0.0,0.0,0.0
milla001,Alan Mills,California Angels,ANGELS,1,2,1,3,1987,1988,1,0.09,0.46,0.37,42,58,16,0,167,167,174.0,0.0,-174.0,0.0,0.0,0.0
milla001,Alan Mills,New York Yankees,YANKS,1,1,2,3,1992,1992,0,5.57,0.0,-5.57,357,0,-357,0,0,0,1440.0,0.0,-1440.0,0.0,0.0,0.0
milla001,Alan Mills,Los Angeles Dodgers,DOGRS,1,2,1,3,2000,2001,1,-0.89,0.51,1.4,42,48,6,0,4,4,113.0,97.0,-16.0,2250000.0,620000.0,-1630000.0
milla002,Andrew Miller,Detroit Tigers,TIGRS,2,8,3,11,2007,2010,3,-0.1,-1.19,-1.09,705,27,-678,1077,3,-1074,1506.0,303.0,-1203.0,12380000.0,13850000.0,1470000.0
milla002,Andrew Miller,Florida Marlins,MARLNS,1,1,1,2,2010,2011,1,1.45,0.0,-1.45,164,0,-164,4,0,-4,535.0,0.0,-535.0,1790219.0,0.0,-1790219.0
milla002,Andrew Miller,Boston Red Sox,RSOX,1,1,1,2,2014,2021,7,0.96,15.37,14.41,24,172,148,0,29,29,60.0,2570.0,2510.0,1900000.0,0.0,-1900000.0
milla002,Andrew Miller,New York Yankees,YANKS,3,5,6,11,2016,2021,5,3.3,2.69,-0.61,294,299,5,8,815,807,1281.0,615.0,-666.0,0.0,4900000.0,4900000.0
milla003,Alec Mills,Kansas City Royals,ROYALS,2,2,2,4,2017,2020,3,0.64,0.0,-0.64,107,0,-107,54,0,-54,706.0,0.0,-706.0,0.0,0.0,0.0
millb001,Brad Mills,Toronto Blue Jays,BJAYS,4,16,12,28,2011,2018,7,25.05,22.05,-3.0,2100,1159,-941,5739,3389,-2350,4683.0,4585.0,-98.0,8732900.0,44879800.0,36146900.0
millb002,Brad Miller,Seattle Mariners,MARNRS,4,7,6,13,2015,2017,2,9.3,3.09,-6.21,1092,200,-892,3957,584,-3373,347.0,283.0,-64.0,10679600.0,5022800.0,-5656800.0
millb002,Brad Miller,Tampa Bay Devil Rays,RAYS,1,2,1,3,2018,2018,0,-0.1,1.13,1.23,27,49,22,80,189,109,0.0,0.0,0.0,0.0,0.0,0.0
millb101,Brad Mills,Montreal Expos,NATEX,1,1,1,2,1984,1984,0,0.0,0.0,0.0,0,0,0,0,0,0,0.0,0.0,0.0,0.0,0.0,0.0
millb102,Bob Miller,Cincinnati Reds,REDS,2,3,2,5,1962,1963,1,-1.36,0.31,1.67,146,63,-83,266,207,-59,61.0,0.0,-61.0,0.0,0.0,0.0
millb104,Bill Miller,New York Yankees,YANKS,12,33,27,60,1954,1970,16,40.55,76.98,36.43,5201,4368,-833,16466,10777,-5689,3212.0,10751.0,7539.0,302500.0,109500.0,-193000.0
millb106,Bob Miller,New York Mets,METS,3,5,4,9,1962,1966,4,4.79,1.88,-2.91,560,368,-192,149,1217,1068,1793.0,0.0,-1793.0,0.0,0.0,0.0
millb106,Bob Miller,Los Angeles Dodgers,DOGRS,1,3,2,5,1967,1968,1,7.85,0.27,-7.58,924,202,-722,948,467,-481,1656.0,285.0,-1371.0,122000.0,73000.0,-49000.0
millb106,Bob Miller,Minnesota Twins,TWINS,2,5,4,9,1969,1971,2,19.42,3.86,-15.56,887,264,-623,3069,67,-3002,587.0,852.0,265.0,120000.0,70000.0,-50000.0
millb106,Bob Miller,Cleveland Indians,INDINS,4,5,5,10,1970,1974,4,-1.97,-1.79,0.18,296,169,-127,575,413,-162,422.0,0.0,-422.0,83000.0,67000.0,-16000.0
millb106,Bob Miller,San Diego Padres,PADRS,2,2,3,5,1971,1975,4,0.01,0.46,0.45,193,350,157,320,469,149,247.0,614.0,367.0,17000.0,27000.0,10000.0
millb107,Bruce Miller,Chicago White Sox,WSOX,1,2,1,3,1972,1973,1,0.0,0.54,0.54,0,38,38,0,7,7,0.0,399.0,399.0,0.0,0.0,0.0
millb107,Bruce Miller,California Angels,ANGELS,1,1,1,2,1973,1973,0,-0.92,0.85,1.77,196,110,-86,593,352,-241,0.0,0.0,0.0,0.0,0.0,0.0
millb108,Buster Mills,Boston Red Sox,RSOX,1,3,1,4,1937,1940,3,5.49,2.22,-3.27,408,291,-117,1388,1330,-58,1283.0,0.0,-1283.0,4000.0,12000.0,8000.0
millb108,Buster Mills,St.Louis Browns,ORLS,1,2,2,4,1938,1941,3,3.15,-0.79,-3.94,102,295,193,121,1044,923,438.0,3.0,-435.0,6000.0,17000.0,11000.0
millb108,Buster Mills,New York Yankees,YANKS,1,1,1,2,1942,1944,2,0.66,-0.23,-0.89,89,36,-53,246,120,-126,0.0,0.0,0.0,0.0,0.0,0.0
millb110,Bing Miller,Washington Senators,TWINS,3,6,4,10,1922,1933,11,25.21,14.57,-10.64,1580,710,-870,6114,2665,-3449,0.0,616.0,616.0,0.0,0.0,0.0
millb110,Bing Miller,Philadelphia Athletics,ATLTCS,2,4,2,6,1926,1930,4,8.5,8.68,0.18,610,175,-435,1746,208,-1538,1683.0,1623.0,-60.0,18500.0,17500.0,-1000.0
millb110,Bing Miller,St.Louis Browns,ORLS,1,1,1,2,1927,1933,6,12.57,15.15,2.58,820,476,-344,3078,478,-2600,0.0,3927.0,3927.0,8000.0,7500.0,-500.0
millb110,Bing Miller,LittleRock,LittleRock,1,2,2,4,1920,1920,0,1.39,0.0,-1.39,118,0,-118,471,0,-471,0.0,0.0,0.0,0.0,3600.0,3600.0
millb115,Bill Mills,Philadelphia Athletics,ATLTCS,1,2,1,3,1944,1946,2,0.0,-0.08,-0.08,0,9,9,0,16,16,0.0,0.0,0.0,0.0,0.0,0.0
millc001,Corky Miller,Chicago White Sox,WSOX,1,1,1,2,2009,2009,0,0.57,0.0,-0.57,70,0,-70,189,0,-189,0.0,0.0,0.0,450000.0,0.0,-450000.0
milld002,Damian Miller,Arizona Diamondbacks,DBACKS,1,1,2,3,2002,2002,0,0.29,0.0,-0.29,114,0,-114,400,0,-400,0.0,0.0,0.0,2650000.0,0.0,-2650000.0
milld002,Damian Miller,Chicago Cubs,CUBS,3,6,5,11,2003,2007,4,3.71,5.06,1.35,539,498,-41,838,1870,1032,801.0,0.0,-801.0,7233333.0,13240494.0,6007161.0
milld101,Dyar Miller,Baltimore Orioles,ORLS,1,1,1,2,1977,1977,0,4.21,0.01,-4.2,96,36,-60,0,0,0,637.0,119.0,-518.0,0.0,0.0,0.0
milld101,Dyar Miller,Toronto Blue Jays,BJAYS,1,1,1,2,1979,1979,0,0.0,0.55,0.55,0,36,36,0,121,121,0.0,0.0,0.0,0.0,0.0,0.0
milld102,Dots Miller,Pittsburgh Pirates,PIRATS,1,5,3,8,1913,1915,2,18.03,3.31,-14.72,1733,233,-1500,6155,938,-5217,795.0,0.0,-795.0,11400.0,13500.0,2100.0
milld106,Doc Miller,Chicago Cubs,CUBS,2,2,2,4,1910,1913,3,2.4,8.58,6.18,327,256,-71,1391,268,-1123,0.0,2226.0,2226.0,2500.0,0.0,-2500.0
milld106,Doc Miller,Boston Braves,BRAVES,1,1,1,2,1912,1913,1,0.46,3.7,3.24,136,183,47,285,734,449,0.0,0.0,0.0,3600.0,0.0,-3600.0
mille001,Eddie Miller,Texas Rangers,RNGRS,4,9,7,16,1977,1988,11,9.87,29.07,19.2,738,2027,1289,1844,7192,5348,1774.0,2974.0,1200.0,330000.0,0.0,-330000.0
mille001,Eddie Miller,Atlanta Braves,BRAVES,1,1,1,2,1982,1982,0,-0.76,0.0,0.76,14,0,-14,33,0,-33,0.0,0.0,0.0,0.0,0.0,0.0
mille001,Eddie Miller,Detroit Tigers,TIGRS,1,1,1,2,1983,1983,0,0.0,0.0,0.0,0,0,0,0,0,0,0.0,0.0,0.0,0.0,0.0,0.0
mille102,Elmer Miller,New York Yankees,YANKS,2,7,3,10,1922,1928,6,-3.56,9.12,12.68,367,900,533,1242,3603,2361,159.0,0.0,-159.0,15750.0,13000.0,-2750.0
mille104,Eddie Miller,Cincinnati Reds,REDS,1,2,1,3,1937,1937,0,0.0,0.0,0.0,0,0,0,0,0,0,0.0,0.0,0.0,0.0,0.0,0.0
mille104,Eddie Miller,New York Yankees,YANKS,2,2,10,12,1938,1943,5,11.55,-0.14,-11.69,534,36,-498,2161,81,-2080,0.0,0.0,0.0,0.0,8750.0,8750.0
mille104,Eddie Miller,Boston Braves,BRAVES,5,11,9,20,1942,1952,10,22.0,21.77,-0.23,1506,1101,-405,5516,3280,-2236,0.0,2449.0,2449.0,12500.0,0.0,-12500.0
mille104,Eddie Miller,Cincinnati Reds,REDS,4,5,6,11,1948,1958,10,1.43,11.14,9.71,666,768,102,1969,2530,561,552.0,1210.0,658.0,0.0,0.0,0.0
millf105,Felix Millan,Atlanta Braves,BRAVES,2,3,3,6,1972,1978,6,10.9,-1.86,-12.76,922,458,-464,3059,568,-2491,1139.0,600.0,-539.0,0.0,42000.0,42000.0
millh103,Hack Miller,LosAngeles,LosAngeles,1,1,1,2,1922,1989,67,5.85,0.0,-5.85,334,0,-334,1258,0,-1258,0.0,0.0,0.0,0.0,0.0,0.0
millj002,Justin Miller,Colorado Rockies,ROCKS,3,5,7,12,1999,2008,9,-0.58,15.28,15.86,278,1324,1046,840,1373,533,125.0,2205.0,2080.0,5440000.0,837500.0,-4602500.0
millj002,Justin Miller,Oakland Athletics,ATLTCS,3,8,6,14,2001,2003,2,21.78,5.28,-16.5,1503,224,-1279,3041,219,-2822,5533.0,541.0,-4992.0,2433333.0,5053333.0,2620000.0
millj005,Jim Miller,Colorado Rockies,ROCKS,1,2,1,3,2007,2007,0,0.16,0.74,0.58,8,27,19,0,24,24,23.0,238.0,215.0,0.0,0.0,0.0
millj006,Justin Miller,Toronto Blue Jays,BJAYS,1,1,1,2,2020,2020,0,0.0,0.0,0.0,0,0,0,0,0,0,0.0,0.0,0.0,0.0,0.0,0.0
millj104,John Miller,New York Yankees,YANKS,1,3,1,4,1967,1968,1,-0.17,-0.55,-0.38,26,78,52,40,208,168,0.0,0.0,0.0,0.0,0.0,0.0
millj107,Jack Mills,Cleveland Indians,INDINS,1,3,1,4,1912,1915,3,0.0,1.09,1.09,0,280,280,0,1151,1151,0.0,0.0,0.0,0.0,0.0,0.0
millj108,Jocko Milligan,Philadelphia Athletics,ATLTCS,1,4,2,6,1887,1892,5,4.43,9.58,5.15,169,488,319,668,2210,1542,0.0,3.0,3.0,0.0,0.0,0.0
millj109,Jake Miller,St. Louis Cardinals,CARDS,1,2,1,3,1932,1932,0,-0.57,0.0,0.57,56,0,-56,40,0,-40,317.0,0.0,-317.0,0.0,4800.0,4800.0
millj110,John Milligan,Philadelphia Phillies,PHILS,1,2,1,3,1933,1933,0,0.0,0.68,0.68,0,40,40,0,31,31,0.0,246.0,246.0,0.0,0.0,0.0
millj110,John Milligan,Albany,Albany,1,1,1,2,1934,1934,0,-0.04,0.0,0.04,4,0,-4,0,0,0,8.0,0.0,-8.0,0.0,0.0,0.0
millk001,Keith Miller,New York Mets,METS,10,18,17,35,1991,2006,15,27.4,32.03,4.63,1969,2082,113,4193,3379,-814,2476.0,3605.0,1129.0,24814657.0,19134833.0,-5679824.0
millk003,Kurt Miller,Pittsburgh Pirates,PIRATS,2,3,2,5,1991,1992,1,2.39,2.58,0.19,362,141,-221,1290,483,-807,354.0,265.0,-89.0,2600000.0,3400000.0,800000.0
millk003,Kurt Miller,Texas Rangers,RNGRS,1,2,1,3,1993,1994,1,2.51,0.73,-1.78,607,75,-532,25,0,-25,1163.0,273.0,-890.0,109000.0,725000.0,616000.0
millk004,Kevin Millwood,Atlanta Braves,BRAVES,4,4,5,9,2002,2009,7,2.72,3.38,0.66,375,585,210,751,1130,379,1202.0,864.0,-338.0,5285000.0,0.0,-5285000.0
millk004,Kevin Millwood,Texas Rangers,RNGRS,2,4,3,7,2009,2010,1,0.32,-0.15,-0.47,89,98,9,5,195,190,644.0,95.0,-549.0,13843892.0,5350000.0,-8493892.0
milll002,Lastings Milledge,New York Mets,METS,3,4,4,8,2007,2010,3,0.57,5.46,4.89,204,547,343,813,1980,1167,0.0,0.0,0.0,8183000.0,7672000.0,-511000.0
milll002,Lastings Milledge,Washington Nationals,NATEX,2,3,4,7,2009,2012,3,9.27,5.6,-3.67,881,663,-218,1403,793,-610,688.0,605.0,-83.0,872000.0,820000.0,-52000.0
milll101,Larry Miller,Los Angeles Dodgers,DOGRS,2,2,2,4,1964,1967,3,-0.41,-0.22,0.19,64,10,-54,13,7,-6,197.0,0.0,-197.0,0.0,0.0,0.0
milln101,Norm Miller,Houston Astros,ASTROS,2,2,2,4,1973,1974,1,0.07,-0.62,-0.69,58,138,80,60,3,-57,24.0,250.0,226.0,0.0,68000.0,68000.0
millo001,Orlando Miller,New York Yankees,YANKS,2,2,3,5,1990,1995,5,0.51,0.29,-0.22,372,43,-329,1178,89,-1089,0.0,0.0,0.0,116000.0,0.0,-116000.0
millo001,Orlando Miller,Houston Astros,ASTROS,6,12,18,30,1996,2004,8,25.8,6.98,-18.82,2221,1542,-679,3937,2959,-978,4263.0,3434.0,-829.0,7155000.0,5554000.0,-1601000.0
millo002,Owen Miller,San Diego Padres,PADRS,2,7,4,11,2020,2021,1,3.34,0.62,-2.72,311,5,-306,892,4,-888,493.0,57.0,-436.0,3000000.0,4100000.0,1100000.0
millo101,Ox Miller,Washington Senators,TWINS,1,3,2,5,1943,1946,3,0.45,8.73,8.28,110,267,157,206,710,504,209.0,1415.0,1206.0,3000.0,19000.0,16000.0
millo102,Otis Miller,Detroit Tigers,TIGRS,2,5,4,9,1927,1934,7,25.64,16.62,-9.02,1182,957,-225,3618,3579,-39,3712.0,0.0,-3712.0,12500.0,10000.0,-2500.0
millo102,Otis Miller,St.Louis Browns,ORLS,23,46,52,98,1927,1952,25,139.77,131.99,-7.78,6854,9855,3001,22708,32907,10199,12609.0,15510.0,2901.0,218500.0,207450.0,-11050.0
millr001,Rick Miller,California Angels,ANGELS,2,4,3,7,1980,1986,6,8.12,4.18,-3.94,957,338,-619,2329,1304,-1025,1201.0,0.0,-1201.0,233333.0,0.0,-233333.0
millr002,Randy Milligan,New York Mets,METS,2,7,3,10,1988,1992,4,34.6,11.89,-22.71,847,584,-263,103,1206,1103,6852.0,1699.0,-5153.0,378000.0,2766666.0,2388666.0
millr002,Randy Milligan,Pittsburgh Pirates,PIRATS,1,1,1,2,1988,1988,0,11.1,0.0,-11.1,511,0,-511,2048,0,-2048,0.0,0.0,0.0,62500.0,0.0,-62500.0
millr002,Randy Milligan,Cincinnati Reds,REDS,1,1,1,2,1993,1996,3,1.09,0.39,-0.7,19,355,336,61,1036,975,0.0,0.0,0.0,635000.0,325000.0,-310000.0
millr002,Randy Milligan,Cleveland Indians,INDINS,2,2,2,4,1993,1994,1,-0.11,-0.13,-0.02,57,6,-51,98,0,-98,15.0,40.0,25.0,0.0,182500.0,182500.0
millr003,Ralph Milliard,Florida Marlins,MARLNS,12,16,26,42,1998,2013,15,104.01,35.74,-68.27,4242,2426,-1816,12260,2618,-9642,7601.0,10460.0,2859.0,18420219.0,799800.0,-17620419.0
millr003,Ralph Milliard,New York Mets,METS,3,5,4,9,1999,2002,3,4.04,-0.88,-4.92,267,50,-217,904,26,-878,36.0,198.0,162.0,362500.0,1350000.0,987500.0
millr107,Ray Miller,Pittsburgh Pirates,PIRATS,1,3,2,5,1917,1919,2,0.0,0.0,0.0,0,175,175,0,676,676,0.0,0.0,0.0,0.0,0.0,0.0
millr109,Randy Miller,Baltimore Orioles,ORLS,3,7,7,14,1977,1987,10,17.37,17.58,0.21,774,1051,277,733,2635,1902,4935.0,985.0,-3950.0,558333.0,0.0,-558333.0
mills001,Shelby Miller,St. Louis Cardinals,CARDS,1,2,2,4,2014,2016,2,3.49,7.42,3.93,93,178,85,88,610,522,772.0,31.0,-741.0,521000.0,5990000.0,5469000.0
mills001,Shelby Miller,Atlanta Braves,BRAVES,1,2,3,5,2015,2021,6,-1.25,7.57,8.82,58,639,581,48,2431,2383,417.0,219.0,-198.0,535000.0,513000.0,-22000.0
mills101,Stu Miller,St. Louis Cardinals,CARDS,1,3,2,5,1956,1958,2,5.63,6.28,0.65,262,246,-16,209,231,22,1575.0,1837.0,262.0,0.0,0.0,0.0
mills101,Stu Miller,Philadelphia Phillies,PHILS,1,1,1,2,1956,1959,3,13.01,0.61,-12.4,617,162,-455,223,37,-186,2413.0,475.0,-1938.0,0.0,0.0,0.0
mills101,Stu Miller,San Francisco Giants,GIANTS,10,18,16,34,1962,1972,10,36.27,10.66,-25.61,2635,1445,-1190,6319,1774,-4545,3135.0,5237.0,2102.0,50000.0,108000.0,58000.0
millt002,Trever Miller,Detroit Tigers,TIGRS,5,12,14,26,1996,2010,14,13.89,24.32,10.43,4127,1434,-2693,10052,2196,-7856,4562.0,6757.0,2195.0,11529000.0,4780000.0,-6749000.0
millt002,Trever Miller,Houston Astros,ASTROS,1,1,1,2,2000,2000,0,-0.49,-0.27,0.22,28,65,37,0,1,1,42.0,68.0,26.0,0.0,0.0,0.0
millt002,Trever Miller,St. Louis Cardinals,CARDS,2,5,5,10,2011,2013,2,7.58,0.4,-7.18,577,344,-233,1599,89,-1510,283.0,547.0,264.0,3193000.0,4329600.0,1136600.0
millw104,Ward Miller,Pittsburgh Pirates,PIRATS,1,2,1,3,1909,1909,0,0.92,0.0,-0.92,124,1,-123,278,0,-278,0.0,0.0,0.0,0.0,0.0,0.0
milne001,Eddie Milner,Cincinnati Reds,REDS,1,1,3,4,1987,1988,1,0.95,2.82,1.87,101,290,189,239,7,-232,0.0,505.0,505.0,0.0,0.0,0.0
milnj101,John Milner,New York Mets,METS,5,7,9,16,1977,1990,13,3.83,7.59,3.76,754,1539,785,1516,2359,843,707.0,4564.0,3857.0,615000.0,0.0,-615000.0
milnj101,John Milner,Pittsburgh Pirates,PIRATS,1,1,1,2,1981,1982,1,0.08,-0.4,-0.48,57,65,8,121,74,-47,0.0,0.0,0.0,0.0,0.0,0.0
milot001,Tom Milone,Washington Nationals,NATEX,2,6,4,10,2011,2018,7,12.32,19.68,7.36,414,407,-7,1035,430,-605,1666.0,3760.0,2094.0,12000000.0,420000.0,-11580000.0
milot001,Tom Milone,Oakland Athletics,ATLTCS,1,1,1,2,2014,2016,2,0.26,1.8,1.54,51,180,129,4,532,528,659.0,0.0,-659.0,510000.0,0.0,-510000.0
milot001,Tom Milone,Baltimore Orioles,ORLS,1,1,2,3,2020,2020,0,-0.65,0.0,0.65,3,0,-3,0,0,0,29.0,0.0,-29.0,100000.0,0.0,-100000.0
milte001,Eric Milton,New York Yankees,YANKS,1,5,1,6,1998,2001,3,22.8,7.48,-15.32,1163,539,-624,4014,2478,-1536,2978.0,0.0,-2978.0,0.0,0.0,0.0
milte001,Eric Milton,Minnesota Twins,TWINS,1,1,3,4,2003,2010,7,1.44,19.34,17.9,67,901,834,75,2722,2647,603.0,2374.0,1771.0,6000000.0,610000.0,-5390000.0
mincd101,Don Mincher,Chicago White Sox,WSOX,3,5,6,11,1960,1967,7,32.09,12.95,-19.14,2200,685,-1515,7735,1568,-6167,0.0,2599.0,2599.0,44000.0,0.0,-44000.0
mincd101,Don Mincher,Minnesota Twins,TWINS,3,8,6,14,1966,1971,5,25.4,14.58,-10.82,1429,584,-845,4690,560,-4130,873.0,2844.0,1971.0,153000.0,115000.0,-38000.0
mincd101,Don Mincher,Milwaukee Brewers,BREWRS,13,32,32,64,1970,1984,14,47.88,123.46,75.58,3414,6405,2991,8076,20920,12844,14309.0,8780.0,-5529.0,506701.0,99000.0,-407701.0
mincd101,Don Mincher,Oakland Athletics,ATLTCS,5,12,6,18,1971,1976,5,13.14,12.72,-0.42,2868,1140,-1728,6939,2992,-3947,2263.0,1076.0,-1187.0,223600.0,363000.0,139400.0
mincd101,Don Mincher,Texas Rangers,RNGRS,11,23,21,44,1972,1986,14,55.26,26.32,-28.94,2860,1699,-1161,5732,4590,-1142,9799.0,4163.0,-5636.0,214000.0,360000.0,146000.0
mincn001,Nate Minchey,Montreal Expos,NATEX,5,11,10,21,1989,2001,12,21.4,30.38,8.98,1830,1831,1,4276,2869,-1407,3122.0,2278.0,-844.0,1435000.0,850000.0,-585000.0
mincn001,Nate Minchey,Atlanta Braves,BRAVES,1,2,1,3,1992,1992,0,-0.49,0.67,1.16,13,28,15,0,0,0,186.0,47.0,-139.0,0.0,2633334.0,2633334.0
mincn001,Nate Minchey,Boston Red Sox,RSOX,1,2,1,3,1994,1996,2,0.0,2.28,2.28,0,132,132,0,511,511,0.0,0.0,0.0,122000.0,650000.0,528000.0
minec101,Craig Minetto,Oakland Athletics,ATLTCS,1,1,1,2,1982,1982,0,0.0,0.0,0.0,0,0,0,0,0,0,0.0,0.0,0.0,0.0,0.0,0.0
minec101,Craig Minetto,Baltimore Orioles,ORLS,1,1,1,2,1983,1983,0,0.0,0.0,0.0,0,0,0,0,0,0,0.0,0.0,0.0,0.0,0.0,0.0
minez001,Zach Miner,Atlanta Braves,BRAVES,1,2,1,3,2005,2005,0,3.3,0.97,-2.33,202,52,-150,7,0,-7,1262.0,82.0,-1180.0,318500.0,1975000.0,1656500.0
mings101,Steve Mingori,Cincinnati Reds,REDS,1,1,1,2,1970,1970,0,2.85,0.05,-2.8,238,6,-232,11,5,-6,437.0,0.0,-437.0,0.0,0.0,0.0
mings101,Steve Mingori,Cleveland Indians,INDINS,1,1,1,2,1973,1973,0,5.57,0.02,-5.55,271,1,-270,1,0,-1,1317.0,2.0,-1315.0,0.0,12600.0,12600.0
minob001,Blas Minor,New York Mets,METS,1,1,1,2,1996,1996,0,0.05,0.0,-0.05,11,0,-11,0,0,0,76.0,0.0,-76.0,198000.0,0.0,-198000.0
minod001,Damon Minor,San Francisco Giants,GIANTS,1,1,1,2,2003,2003,0,0.0,0.0,0.0,0,0,0,0,0,0,0.0,0.0,0.0,0.0,0.0,0.0
minom001,Mike Minor,Texas Rangers,RNGRS,1,2,3,5,2020,2020,0,0.01,0.0,-0.01,5,0,-5,0,0,0,64.0,0.0,-64.0,9833333.0,0.0,-9833333.0
minom101,Minnie Minoso,Cleveland Indians,INDINS,1,3,1,4,1951,1951,0,41.46,1.96,-39.5,1373,108,-1265,5916,24,-5892,0.0,338.0,338.0,0.0,0.0,0.0
minom101,Minnie Minoso,Chicago White Sox,WSOX,9,15,19,34,1957,1971,14,41.54,76.26,34.72,3085,4270,1185,10587,11970,1383,740.0,5807.0,5067.0,72500.0,48000.0,-24500.0
minom101,Minnie Minoso,Cleveland Indians,INDINS,6,11,11,22,1959,1968,9,95.02,18.27,-76.75,3674,1436,-2238,12659,5344,-7315,4502.0,50.0,-4452.0,0.0,32000.0,32000.0
minom101,Minnie Minoso,Chicago White Sox,WSOX,4,5,6,11,1961,1969,8,-2.09,10.93,13.02,366,606,240,692,2313,1621,492.0,0.0,-492.0,70250.0,45000.0,-25250.0
minor001,Ryan Minor,Baltimore Orioles,ORLS,2,3,2,5,2000,2007,7,3.08,3.19,0.11,289,330,41,316,9,-307,1690.0,1424.0,-266.0,0.0,0.0,0.0
mintg001,Greg Minton,Kansas City Royals,ROYALS,2,2,2,4,1973,1985,12,13.17,23.55,10.38,1180,610,-570,327,1060,733,2611.0,5104.0,2493.0,0.0,0.0,0.0
miraa002,Ariel Miranda,Baltimore Orioles,ORLS,1,1,1,2,2016,2017,1,1.69,-0.59,-2.28,47,48,1,6,9,3,663.0,634.0,-29.0,0.0,0.0,0.0
mirad001,Doug Mirabelli,Texas Rangers,RNGRS,3,3,3,6,2001,2002,1,15.45,-0.64,-16.09,1058,5,-1053,1159,0,-1159,1966.0,44.0,-1922.0,295000.0,0.0,-295000.0
mirad001,Doug Mirabelli,Boston Red Sox,RSOX,1,1,1,2,2005,2006,1,-0.24,0.54,0.78,14,155,141,26,703,677,0.0,0.0,0.0,1500000.0,2750000.0,1250000.0
mirad001,Doug Mirabelli,San Diego Padres,PADRS,2,2,4,6,2006,2011,5,-0.35,5.58,5.93,159,864,705,303,1176,873,131.0,712.0,581.0,1930900.0,353400.0,-1577500.0
miraj001,Juan Miranda,New York Yankees,YANKS,1,1,1,2,2010,2010,0,-0.38,0.0,0.38,65,0,-65,202,0,-202,0.0,0.0,0.0,400000.0,0.0,-400000.0
mirap001,Paul Mirabella,Texas Rangers,RNGRS,8,18,14,32,1978,1986,8,37.88,13.97,-23.91,1966,931,-1035,3128,2213,-915,8593.0,2102.0,-6491.0,0.0,250000.0,250000.0
mirap001,Paul Mirabella,New York Yankees,YANKS,13,23,23,46,1979,1997,18,40.16,16.71,-23.45,2656,1808,-848,6433,3520,-2913,8337.0,5150.0,-3187.0,4715000.0,3012500.0,-1702500.0
mirap001,Paul Mirabella,Toronto Blue Jays,BJAYS,1,1,1,2,1981,1983,2,0.0,0.54,0.54,0,63,63,0,0,0,0.0,252.0,252.0,0.0,0.0,0.0
mirap001,Paul Mirabella,Chicago Cubs,CUBS,1,3,1,4,1982,1982,0,-0.09,0.93,1.02,40,128,88,0,477,477,152.0,0.0,-152.0,0.0,0.0,0.0
miraw101,Willie Miranda,Washington Senators,TWINS,1,1,1,2,1951,1953,2,0.27,0.52,0.25,70,88,18,172,307,135,0.0,0.0,0.0,0.0,12500.0,12500.0
miraw101,Willie Miranda,Chicago White Sox,WSOX,2,3,3,6,1952,1954,2,-0.05,0.64,0.69,740,156,-584,2104,332,-1772,0.0,0.0,0.0,20000.0,0.0,-20000.0
miraw101,Willie Miranda,Chicago White Sox,WSOX,5,13,10,23,1952,1961,9,17.5,10.87,-6.63,3154,1282,-1872,10106,3886,-6220,2246.0,536.0,-1710.0,62000.0,99250.0,37250.0
miraw101,Willie Miranda,New York Yankees,YANKS,12,33,27,60,1954,1970,16,40.55,76.98,36.43,5201,4368,-833,16466,10777,-5689,3212.0,10751.0,7539.0,302500.0,109500.0,-193000.0
miraw101,Willie Miranda,Baltimore Orioles,ORLS,9,23,20,43,1960,1988,28,27.92,121.63,93.71,1879,5109,3230,2628,13546,10918,8511.0,12795.0,4284.0,787833.0,104900.0,-682933.0
misia001,Anthony Misiewicz,Seattle Mariners,MARNRS,1,3,2,5,2017,2019,2,0.0,0.36,0.36,0,30,30,0,38,38,0.0,44.0,44.0,0.0,0.0,0.0
misia001,Anthony Misiewicz,Tampa Bay Devil Rays,RAYS,1,1,1,2,2017,2017,0,0.33,0.0,-0.33,90,0,-90,0,0,0,224.0,0.0,-224.0,0.0,0.0,0.0
mitcb001,Bryan Mitchell,New York Yankees,YANKS,2,4,2,6,2017,2018,1,-1.8,0.0,1.8,81,0,-81,124,0,-124,219.0,0.0,-219.0,13550625.0,0.0,-13550625.0
mitcb101,Bobby Mitchell,Los Angeles Dodgers,DOGRS,1,2,2,4,1982,1984,2,5.49,0.0,-5.49,260,0,-260,694,0,-694,1207.0,0.0,-1207.0,0.0,0.0,0.0
mitcb102,Bobby Mitchell,New York Yankees,YANKS,14,25,25,50,1971,1997,26,98.22,28.51,-69.71,5419,1835,-3584,10839,3270,-7569,18250.0,6192.0,-12058.0,4415000.0,2839500.0,-1575500.0
mitcc001,Charlie Mitchell,Boston Red Sox,RSOX,1,1,1,2,1985,1986,1,0.0,-0.11,-0.11,0,21,21,0,34,34,0.0,0.0,0.0,0.0,0.0,0.0
mitcc102,Clarence Mitchell,Brooklyn Dodgers,DOGRS,1,1,1,2,1923,1924,1,9.33,0.11,-9.22,371,50,-321,424,27,-397,2366.0,273.0,-2093.0,0.0,0.0,0.0
mitcc102,Clarence Mitchell,St. Louis Cardinals,CARDS,1,1,1,2,1930,1930,0,1.22,0.0,-1.22,118,0,-118,137,0,-137,1047.0,0.0,-1047.0,0.0,0.0,0.0
mitcd001,D.J. Mitchell,New York Yankees,YANKS,1,2,1,3,2012,2014,2,0.38,3.31,2.93,163,360,197,0,1180,1180,533.0,0.0,-533.0,0.0,17000000.0,17000000.0
mitcf101,Fred Mitchell,Boston Braves,BRAVES,1,2,2,4,1916,1919,3,0.0,-1.02,-1.02,2,181,179,2,722,720,0.0,0.0,0.0,1950.0,0.0,-1950.0
mitcj001,John Mitchell,Boston Red Sox,RSOX,7,15,13,28,1985,1993,8,20.97,19.79,-1.18,2048,1909,-139,3771,4732,961,4874.0,3574.0,-1300.0,3550000.0,2472500.0,-1077500.0
mitcj001,John Mitchell,New York Mets,METS,1,2,2,4,1989,1990,1,0.07,-0.15,-0.22,24,8,-16,0,9,9,343.0,0.0,-343.0,0.0,0.0,0.0
mitcj101,Johnny Mitchell,New York Yankees,YANKS,2,7,3,10,1922,1928,6,-3.56,9.12,12.68,367,900,533,1242,3603,2361,159.0,0.0,-159.0,15750.0,13000.0,-2750.0
mitcj101,Johnny Mitchell,Vernon,Vernon,1,1,5,6,1920,1929,9,-0.09,0.0,0.09,17,0,-17,51,0,-51,0.0,0.0,0.0,0.0,12500.0,12500.0
mitck001,Kevin Mitchell,New York Mets,METS,12,24,21,45,1986,2006,20,25.44,47.58,22.14,2466,2918,452,5573,6399,826,2555.0,3756.0,1201.0,24986257.0,19799833.0,-5186424.0
mitck001,Kevin Mitchell,San Diego Padres,PADRS,4,8,8,16,1987,1991,4,23.07,10.95,-12.12,1220,1067,-153,3009,1254,-1755,1633.0,2625.0,992.0,3883333.0,1525000.0,-2358333.0
mitck001,Kevin Mitchell,San Francisco Giants,GIANTS,4,7,11,18,1991,1998,7,10.32,12.82,2.5,410,1133,723,849,798,-51,1958.0,3071.0,1113.0,9577778.0,5766667.0,-3811111.0
mitck001,Kevin Mitchell,Seattle Mariners,MARNRS,1,1,1,2,1992,1993,1,7.66,1.01,-6.65,225,35,-190,874,0,-874,0.0,104.0,104.0,3750000.0,1200000.0,-2550000.0
mitck001,Kevin Mitchell,Boston Red Sox,RSOX,1,1,2,3,1996,1997,1,1.33,0.0,-1.33,37,0,-37,141,0,-141,0.0,0.0,0.0,1135000.0,0.0,-1135000.0
mitcm102,Mike Mitchell,Cincinnati Reds,REDS,3,8,5,13,1912,1913,1,9.38,6.71,-2.67,842,270,-572,2287,704,-1583,1567.0,500.0,-1067.0,11280.0,7925.0,-3355.0
mitcp101,Paul Mitchell,Baltimore Orioles,ORLS,5,15,15,30,1976,1988,12,24.68,74.72,50.04,1245,3374,2129,1799,7287,5488,7873.0,11309.0,3436.0,558333.0,0.0,-558333.0
mitcp101,Paul Mitchell,Seattle Mariners,MARNRS,1,1,1,2,1979,1982,3,0.72,-0.94,-1.66,35,28,-7,0,0,0,493.0,152.0,-341.0,0.0,0.0,0.0
mitrs001,Sergio Mitre,Chicago Cubs,CUBS,1,3,1,4,2005,2006,1,14.84,1.99,-12.85,973,162,-811,493,750,257,4940.0,0.0,-4940.0,0.0,3700000.0,3700000.0
mitrs001,Sergio Mitre,New York Yankees,YANKS,1,1,1,2,2011,2013,2,0.18,0.49,0.31,43,85,42,2,72,70,99.0,0.0,-99.0,0.0,0.0,0.0
mittg101,George Mitterwald,Minnesota Twins,TWINS,1,1,1,2,1973,1974,1,0.12,-0.15,-0.27,373,32,-341,1169,93,-1076,0.0,0.0,0.0,22500.0,50000.0,27500.0
mizej101,Johnny Mize,St. Louis Cardinals,CARDS,1,1,4,5,1941,1948,7,28.96,5.95,-23.01,655,346,-309,2815,1181,-1634,0.0,38.0,38.0,0.0,0.0,0.0
mizew101,Vinegar Bend Mizell,St. Louis Cardinals,CARDS,16,30,25,55,1960,1972,12,32.35,16.26,-16.09,3499,2551,-948,8719,7845,-874,2795.0,1167.0,-1628.0,32500.0,24000.0,-8500.0
mizew101,Vinegar Bend Mizell,Pittsburgh Pirates,PIRATS,1,1,1,2,1962,1962,0,-0.78,-0.08,0.7,34,55,21,8,116,108,114.0,0.0,-114.0,0.0,0.0,0.0
mlicd001,Dave Mlicki,Cleveland Indians,INDINS,5,11,9,20,1994,2001,7,59.36,5.4,-53.96,3537,380,-3157,10591,1129,-9462,3110.0,195.0,-2915.0,7871666.0,7925000.0,53334.0
mlicd001,Dave Mlicki,New York Mets,METS,1,2,2,4,1998,1999,1,1.17,0.6,-0.57,64,36,-28,46,33,-13,438.0,278.0,-160.0,3150000.0,2800000.0,-350000.0
mlicd001,Dave Mlicki,Los Angeles Dodgers,DOGRS,1,2,3,5,1999,1999,0,0.03,-0.71,-0.74,81,18,-63,9,4,-5,1195.0,47.0,-1148.0,6833334.0,0.0,-6833334.0
mlicd001,Dave Mlicki,Detroit Tigers,TIGRS,1,1,1,2,2001,2002,1,0.15,-0.43,-0.58,80,39,-41,57,1,-56,518.0,543.0,25.0,5300000.0,6250000.0,950000.0
mockg001,Garrett Mock,Arizona Diamondbacks,DBACKS,1,2,2,4,2006,2007,1,-0.03,3.1,3.13,194,87,-107,108,106,-2,1067.0,821.0,-246.0,0.0,8000000.0,8000000.0
moehb001,Brian Moehler,Detroit Tigers,TIGRS,2,5,4,9,2002,2005,3,-0.66,0.33,0.99,20,180,160,16,775,759,130.0,0.0,-130.0,2400000.0,340000.0,-2060000.0
moelc001,Chad Moeller,Minnesota Twins,TWINS,2,2,2,4,2001,2001,0,1.41,0.0,-1.41,140,0,-140,455,0,-455,0.0,0.0,0.0,0.0,305000.0,305000.0
moelc001,Chad Moeller,Arizona Diamondbacks,DBACKS,1,6,3,9,2003,2005,2,15.82,-0.12,-15.94,1881,61,-1820,5048,104,-4944,2593.0,37.0,-2556.0,3548667.0,5425000.0,1876333.0
moeld001,Dennis Moeller,Kansas City Royals,ROYALS,1,2,1,3,1992,1995,3,-0.61,-1.65,-1.04,94,250,156,7,880,873,219.0,0.0,-219.0,113500.0,2000000.0,1886500.0
moeld101,Danny Moeller,Washington Senators,TWINS,1,2,2,4,1916,1917,1,-0.1,0.72,0.82,82,122,40,78,517,439,360.0,0.0,-360.0,5000.0,0.0,-5000.0
moeld101,Danny Moeller,Rochester,Rochester,2,4,5,9,1911,1913,2,29.68,0.0,-29.68,1807,0,-1807,7810,0,-7810,0.0,0.0,0.0,0.0,0.0,0.0
mofoh101,Herb Moford,St. Louis Cardinals,CARDS,1,1,1,2,1957,1957,0,1.06,0.0,-1.06,50,0,-50,41,0,-41,328.0,0.0,-328.0,0.0,0.0,0.0
mofoh101,Herb Moford,Detroit Tigers,TIGRS,1,1,1,2,1958,1958,0,-0.68,0.0,0.68,8,0,-8,1,0,-1,26.0,0.0,-26.0,0.0,0.0,0.0
mofoh101,Herb Moford,Boston Red Sox,RSOX,1,1,2,3,1960,1960,0,0.0,0.0,0.0,0,0,0,0,0,0,0.0,0.0,0.0,0.0,0.0,0.0
mogrg101,George Mogridge,New York Yankees,YANKS,1,2,1,3,1920,1920,0,16.01,0.0,-16.01,317,0,-317,510,0,-510,3052.0,0.0,-3052.0,11500.0,5400.0,-6100.0
mogrg101,George Mogridge,Washington Senators,TWINS,1,2,1,3,1925,1926,1,2.26,0.7,-1.56,163,72,-91,505,162,-343,46.0,0.0,-46.0,3200.0,0.0,-3200.0
mogrg101,George Mogridge,St.Louis Browns,ORLS,2,3,3,6,1926,1929,3,-0.56,11.12,11.68,45,385,340,116,1302,1186,0.0,0.0,0.0,10000.0,6000.0,-4000.0
mohod001,Dale Mohorcic,Texas Rangers,RNGRS,1,1,1,2,1988,1989,1,-0.46,0.31,0.77,47,58,11,0,0,0,241.0,221.0,-20.0,157500.0,380000.0,222500.0
mohrd001,Dustan Mohr,Minnesota Twins,TWINS,1,1,1,2,2003,2003,0,0.3,0.0,-0.3,117,0,-117,324,0,-324,0.0,0.0,0.0,315000.0,0.0,-315000.0
mokaj101,Johnny Mokan,Philadelphia Phillies,PHILS,1,3,2,5,1927,1929,2,-0.72,-1.19,-0.47,18,135,117,33,192,159,0.0,529.0,529.0,8850.0,13300.0,4450.0
molib001,Bengie Molina,San Francisco Giants,GIANTS,1,1,2,3,2010,2010,0,-0.8,0.12,0.92,57,56,-1,195,0,-195,0.0,72.0,72.0,4500000.0,975000.0,-3525000.0
molib101,Bob Molinaro,Chicago White Sox,WSOX,1,1,1,2,1982,1982,0,-0.31,0.0,0.31,65,0,-65,72,0,-72,0.0,0.0,0.0,0.0,0.0,0.0
molig001,Gabe Molina,Baltimore Orioles,ORLS,1,2,3,5,2000,2002,2,1.16,-0.42,-1.58,214,107,-107,759,224,-535,6.0,2.0,-4.0,4146789.0,800000.0,-3346789.0
molii001,Izzy Molina,Arizona Diamondbacks,DBACKS,1,2,2,4,1999,2000,1,-0.22,0.28,0.5,4,102,98,0,2,2,33.0,165.0,132.0,0.0,0.0,0.0
molij001,Jose Molina,Anaheim Angels,ANGELS,1,1,1,2,2007,2007,0,1.07,0.0,-1.07,181,0,-181,523,0,-523,0.0,0.0,0.0,1350000.0,0.0,-1350000.0
mollf101,Fritz Mollwitz,Chicago Cubs,CUBS,1,1,1,2,1914,1914,0,-2.49,-0.41,2.08,250,28,-222,875,105,-770,0.0,0.0,0.0,0.0,3300.0,3300.0
mollf101,Fritz Mollwitz,KansasCity,KansasCity,1,2,3,5,1917,1918,1,0.77,0.0,-0.77,267,0,-267,890,0,-890,475.0,0.0,-475.0,0.0,2725.0,2725.0
monab101,Blas Monaco,Cleveland Indians,INDINS,1,3,1,4,1937,1938,1,0.0,0.0,0.0,0,0,0,0,0,0,0.0,0.0,0.0,0.0,0.0,0.0
monac001,Carlos Monasterios,New York Yankees,YANKS,1,4,2,6,2006,2008,2,0.06,7.5,7.44,46,382,336,0,1631,1631,38.0,136.0,98.0,0.0,16900000.0,16900000.0
monbb101,Bill Monbouquette,Boston Red Sox,RSOX,1,1,3,4,1965,1971,6,-0.68,1.36,2.04,64,222,158,31,488,457,314.0,0.0,-314.0,33000.0,32800.0,-200.0
monbb101,Bill Monbouquette,New York Yankees,YANKS,3,3,4,7,1968,2002,34,0.58,19.7,19.12,93,1550,1457,0,3648,3648,590.0,1822.0,1232.0,68000.0,65000.0,-3000.0
moncy001,Yoan Moncada,Boston Red Sox,RSOX,1,4,1,5,2016,2016,0,14.34,0.0,-14.34,583,0,-583,2288,0,-2288,251.0,0.0,-251.0,0.0,9150000.0,9150000.0
mondr001,Rick Monday,Oakland Athletics,ATLTCS,3,5,7,12,1971,1978,7,20.59,17.1,-3.49,880,660,-220,3530,1399,-2131,944.0,4676.0,3732.0,130000.0,56500.0,-73500.0
mondr001,Rick Monday,Chicago Cubs,CUBS,6,9,14,23,1977,1996,19,23.01,95.54,72.53,2449,4520,2071,6237,18161,11924,2336.0,1723.0,-613.0,0.0,0.0,0.0
mondr002,Raul Mondesi,Los Angeles Dodgers,DOGRS,6,14,16,30,1999,2008,9,11.13,39.67,28.54,2076,1867,-209,6047,4980,-1067,1264.0,3315.0,2051.0,19163667.0,19160000.0,-3667.0
mondr002,Raul Mondesi,Toronto Blue Jays,BJAYS,1,1,1,2,2002,2003,1,2.07,0.04,-2.03,169,3,-166,705,0,-705,0.0,8.0,8.0,11000000.0,0.0,-11000000.0
mondr002,Raul Mondesi,New York Yankees,YANKS,2,3,4,7,2003,2007,4,0.52,-0.76,-1.28,48,88,40,183,134,-49,9.0,91.0,82.0,13000000.0,1200000.0,-11800000.0
moned101,Don Money,Pittsburgh Pirates,PIRATS,2,5,4,9,1967,1973,6,15.42,-1.44,-16.86,860,110,-750,2406,119,-2287,2691.0,948.0,-1743.0,75000.0,45000.0,-30000.0
moned101,Don Money,Philadelphia Phillies,PHILS,3,7,6,13,1972,1979,7,31.4,20.05,-11.35,1669,1025,-644,5610,3103,-2507,2357.0,4062.0,1705.0,29500.0,80800.0,51300.0
mongs001,Sid Monge,California Angels,ANGELS,1,3,2,5,1977,1982,5,9.5,4.45,-5.05,371,221,-150,444,0,-444,1221.0,1215.0,-6.0,0.0,85000.0,85000.0
mongs001,Sid Monge,Cleveland Indians,INDINS,1,1,1,2,1982,1983,1,-0.45,-0.04,0.41,122,97,-25,13,331,318,251.0,0.0,-251.0,0.0,0.0,0.0
mongs001,Sid Monge,Philadelphia Phillies,PHILS,1,1,1,2,1983,1983,0,0.31,1.88,1.57,120,101,-19,12,295,283,251.0,0.0,-251.0,300000.0,0.0,-300000.0
monrc001,Craig Monroe,Detroit Tigers,TIGRS,1,2,1,3,2007,2009,2,-0.36,0.16,0.52,23,33,10,55,0,-55,0.0,81.0,81.0,4775000.0,0.0,-4775000.0
monrj101,John Monroe,New York Giants,GIANTS,2,7,2,9,1921,1924,3,-1.56,-0.07,1.49,187,154,-33,261,191,-70,992.0,253.0,-739.0,6000.0,0.0,-6000.0
monrj101,John Monroe,Philadelphia Phillies,PHILS,5,11,9,20,1921,1936,15,25.37,1.11,-24.26,1352,2193,841,5364,9288,3924,77.0,0.0,-77.0,43100.0,12250.0,-30850.0
monrz101,Zach Monroe,New York Yankees,YANKS,2,3,4,7,1960,1963,3,0.32,3.3,2.98,35,426,391,37,78,41,0.0,912.0,912.0,0.0,0.0,0.0
monta101,Al Montreuil,Boston Red Sox,RSOX,1,3,1,4,1969,1972,3,-0.13,8.46,8.59,5,232,227,13,323,310,0.0,2477.0,2477.0,0.0,0.0,0.0
monta103,Aurelio Monteagudo,Cincinnati Reds,REDS,2,2,2,4,1969,1970,1,0.0,0.0,0.0,0,20,20,0,2,2,0.0,49.0,49.0,0.0,0.0,0.0
monta103,Aurelio Monteagudo,San Diego Padres,PADRS,2,2,2,4,1973,1973,0,-0.31,0.0,0.31,16,0,-16,1,0,-1,90.0,0.0,-90.0,0.0,0.0,0.0
monta103,Aurelio Monteagudo,California Angels,ANGELS,2,4,3,7,1973,1976,3,2.26,3.34,1.08,402,155,-247,1412,564,-848,0.0,0.0,0.0,38500.0,40000.0,1500.0
montc001,Charlie Montoyo,Milwaukee Brewers,BREWRS,1,2,2,4,1993,1993,0,-0.51,0.0,0.51,36,0,-36,100,0,-100,0.0,0.0,0.0,0.0,0.0,0.0
monte101,Ed Montague,Cleveland Indians,INDINS,2,6,4,10,1930,1939,9,6.18,20.8,14.62,372,942,570,1331,2752,1421,1093.0,2939.0,1846.0,2400.0,0.0,-2400.0
montf001,Frankie Montas,Boston Red Sox,RSOX,3,8,6,14,2013,2020,7,1.74,3.1,1.36,152,304,152,96,10,-86,1036.0,1375.0,339.0,5113000.0,0.0,-5113000.0
montf001,Frankie Montas,Chicago White Sox,WSOX,3,7,6,13,2015,2017,2,4.46,5.75,1.29,441,251,-190,564,1001,437,693.0,30.0,-663.0,12535000.0,6150000.0,-6385000.0
montf001,Frankie Montas,Los Angeles Dodgers,DOGRS,1,3,2,5,2016,2019,3,5.79,5.89,0.1,131,179,48,13,293,280,1774.0,1084.0,-690.0,0.0,0.0,0.0
montj001,John Montefusco,San Francisco Giants,GIANTS,2,3,3,6,1980,1984,4,-0.65,4.3,4.95,76,142,66,15,92,77,517.0,884.0,367.0,0.0,150000.0,150000.0
montj001,John Montefusco,San Diego Padres,PADRS,2,3,4,7,1983,1986,3,7.55,6.05,-1.5,127,402,275,0,1397,1397,2130.0,41.0,-2089.0,0.0,0.0,0.0
montj002,Jeff Montgomery,Cincinnati Reds,REDS,2,3,3,6,1988,1997,9,21.37,12.59,-8.78,775,929,154,0,3608,3608,3825.0,0.0,-3825.0,0.0,0.0,0.0
montj003,Jesus Montero,New York Yankees,YANKS,3,7,6,13,2012,2020,8,-1.73,11.1,12.83,260,478,218,802,248,-554,452.0,2363.0,1911.0,6150000.0,12535000.0,6385000.0
montj101,John Montague,Baltimore Orioles,ORLS,1,1,1,2,1973,1973,0,0.54,-0.01,-0.55,125,1,-124,14,0,-14,324.0,5.0,-319.0,0.0,0.0,0.0
montj101,John Montague,Seattle Mariners,MARNRS,1,1,1,2,1979,1982,3,-0.93,0.29,1.22,51,186,135,0,536,536,274.0,0.0,-274.0,0.0,0.0,0.0
montm001,Miguel Montero,Arizona Diamondbacks,DBACKS,2,2,3,5,2014,2019,5,1.66,0.8,-0.86,245,268,23,799,258,-541,7.0,1562.0,1555.0,10000000.0,1250000.0,-8750000.0
montm001,Miguel Montero,Chicago Cubs,CUBS,1,2,1,3,2017,2017,0,-0.61,0.0,0.61,32,0,-32,101,0,-101,0.0,0.0,0.0,14000000.0,0.0,-14000000.0
montm002,Mike Montgomery,Kansas City Royals,ROYALS,3,6,5,11,2012,2021,9,12.05,17.51,5.46,480,779,299,994,1767,773,2270.0,2321.0,51.0,16050000.0,12652767.0,-3397233.0
montm002,Mike Montgomery,Tampa Bay Devil Rays,RAYS,2,2,3,5,2015,2017,2,2.35,3.54,1.19,77,159,82,9,2,-7,778.0,1044.0,266.0,3125000.0,6000000.0,2875000.0
montm002,Mike Montgomery,Seattle Mariners,MARNRS,2,3,3,6,2016,2020,4,3.31,0.75,-2.56,262,353,91,86,1268,1182,1374.0,0.0,-1374.0,0.0,3150000.0,3150000.0
montm002,Mike Montgomery,Chicago Cubs,CUBS,3,3,3,6,2019,2020,1,4.92,-0.47,-5.39,396,48,-348,1201,106,-1095,208.0,0.0,-208.0,2440000.0,3083600.0,643600.0
montm101,Manny Montejo,Detroit Tigers,TIGRS,1,2,1,3,1961,1962,1,12.08,0.99,-11.09,318,60,-258,331,21,-310,2721.0,244.0,-2477.0,0.0,0.0,0.0
montr001,Rafael Montalvo,Los Angeles Dodgers,DOGRS,1,2,1,3,1985,1986,1,-0.17,0.39,0.56,15,164,149,41,506,465,3.0,0.0,-3.0,0.0,291667.0,291667.0
montr002,Rich Monteleone,Detroit Tigers,TIGRS,2,3,2,5,1985,1988,3,0.0,0.71,0.71,141,253,112,389,952,563,80.0,0.0,-80.0,170000.0,317500.0,147500.0
montr002,Rich Monteleone,California Angels,ANGELS,1,2,1,3,1990,1993,3,0.54,2.38,1.84,153,560,407,83,2347,2264,698.0,0.0,-698.0,675000.0,200000.0,-475000.0
montr002,Rich Monteleone,New York Yankees,YANKS,1,1,1,2,1996,1996,0,-0.12,0.02,0.14,12,33,21,0,77,77,46.0,3.0,-43.0,0.0,250000.0,250000.0
montr004,Rafael Montero,Texas Rangers,RNGRS,1,1,2,3,2020,2021,1,-1.75,0.0,1.75,41,0,-41,0,0,0,130.0,0.0,-130.0,785000.0,0.0,-785000.0
montr004,Rafael Montero,Seattle Mariners,MARNRS,1,2,2,4,2021,2021,0,0.78,1.64,0.86,33,83,50,0,253,253,87.0,54.0,-33.0,3500000.0,4000000.0,500000.0
monts001,Steve Montgomery,St. Louis Cardinals,CARDS,1,1,1,2,1996,1997,1,-0.62,0.59,1.21,12,237,225,0,1,1,60.0,339.0,279.0,0.0,0.0,0.0
monts001,Steve Montgomery,Philadelphia Phillies,PHILS,3,6,5,11,1999,2003,4,6.55,1.13,-5.42,362,281,-81,360,99,-261,2958.0,1114.0,-1844.0,6615000.0,10757500.0,4142500.0
montw101,Willie Montanez,Philadelphia Phillies,PHILS,1,1,1,2,1975,1985,10,1.12,28.99,27.87,195,1322,1127,826,5030,4204,0.0,0.0,0.0,0.0,0.0,0.0
montw101,Willie Montanez,San Francisco Giants,GIANTS,2,5,3,8,1976,1983,7,-0.82,27.35,28.17,287,1701,1414,1089,6469,5380,0.0,0.0,0.0,0.0,0.0,0.0
montw101,Willie Montanez,Atlanta Braves,BRAVES,4,5,9,14,1977,1983,6,-1.12,5.01,6.13,459,628,169,1458,837,-621,541.0,2701.0,2160.0,480000.0,150000.0,-330000.0
montw101,Willie Montanez,New York Mets,METS,2,2,4,6,1979,1990,11,2.33,5.34,3.01,200,698,498,205,900,695,630.0,2191.0,1561.0,530000.0,0.0,-530000.0
montw101,Willie Montanez,Texas Rangers,RNGRS,7,14,16,30,1980,1987,7,8.43,11.62,3.19,827,472,-355,2107,666,-1441,2873.0,3278.0,405.0,1017500.0,331000.0,-686500.0
montw101,Willie Montanez,San Diego Padres,PADRS,3,5,5,10,1980,1984,4,14.59,2.85,-11.74,999,296,-703,3588,1221,-2367,64.0,0.0,-64.0,0.0,0.0,0.0
montw101,Willie Montanez,Montreal Expos,NATEX,1,1,1,2,1981,1982,1,-0.4,0.08,0.48,65,57,-8,74,121,47,0.0,0.0,0.0,0.0,0.0,0.0
monzd101,Dan Monzon,Minnesota Twins,TWINS,1,1,1,2,1974,1974,0,0.0,0.0,0.0,0,0,0,0,0,0,0.0,0.0,0.0,0.0,0.0,0.0
moonb001,Bill Mooneyham,Oakland Athletics,ATLTCS,1,1,1,2,1987,1990,3,0.0,0.0,0.0,0,0,0,0,0,0,0.0,0.0,0.0,0.0,0.0,0.0
moonj101,Jim Mooney,New York Giants,GIANTS,3,11,6,17,1932,1949,17,15.21,55.77,40.56,1303,2528,1225,3690,9780,6090,2269.0,40.0,-2229.0,0.0,0.0,0.0
moonw101,Wally Moon,St. Louis Cardinals,CARDS,2,4,2,6,1958,1961,3,12.54,-1.35,-13.89,901,211,-690,3090,605,-2485,156.0,353.0,197.0,0.0,15000.0,15000.0
moora002,Andrew Moore,Seattle Mariners,MARNRS,3,4,6,10,2018,2019,1,3.4,4.58,1.18,251,276,25,571,810,239,250.0,139.0,-111.0,581200.0,5860000.0,5278800.0
moora102,Anse Moore,Detroit Tigers,TIGRS,1,3,1,4,1949,1950,1,0.0,0.0,0.0,0,0,0,0,0,0,0.0,0.0,0.0,0.0,0.0,0.0
moorb001,Bobby Moore,Oakland Athletics,ATLTCS,1,1,1,2,1982,1982,0,0.0,0.0,0.0,0,0,0,0,0,0,0.0,0.0,0.0,0.0,0.0,0.0
moorb004,Bobby Moore,Kansas City Royals,ROYALS,1,1,1,2,1991,1994,3,0.0,1.07,1.07,0,105,105,0,275,275,0.0,0.0,0.0,0.0,0.0,0.0
moorb105,Barry Moore,Washington Senators,RNGRS,10,23,17,40,1969,1988,19,45.59,49.51,3.92,2709,3553,844,8910,11036,2126,3519.0,6237.0,2718.0,494000.0,226000.0,-268000.0
moorb105,Barry Moore,Cleveland Indians,INDINS,4,5,5,10,1970,1974,4,-1.97,-1.79,0.18,296,169,-127,575,413,-162,422.0,0.0,-422.0,83000.0,67000.0,-16000.0
moorb105,Barry Moore,Chicago White Sox,WSOX,2,2,2,4,1970,1971,1,2.12,0.0,-2.12,351,0,-351,1072,0,-1072,0.0,0.0,0.0,0.0,0.0,0.0
moorc101,Cy Moore,Brooklyn Dodgers,DOGRS,6,13,10,23,1932,1948,16,22.8,18.44,-4.36,1723,1313,-410,5249,4047,-1202,2633.0,2535.0,-98.0,0.0,0.0,0.0
moord001,Donnie Moore,Chicago Cubs,CUBS,1,1,1,2,1979,1982,3,-0.16,-1.51,-1.35,22,173,151,6,466,460,65.0,0.0,-65.0,0.0,0.0,0.0
moord001,Donnie Moore,St. Louis Cardinals,CARDS,1,1,1,2,1982,1982,0,1.73,0.0,-1.73,212,0,-212,13,0,-13,482.0,0.0,-482.0,0.0,0.0,0.0
moord002,Dylan Moore,Texas Rangers,RNGRS,1,1,1,2,2016,2016,0,0.0,0.0,0.0,0,0,0,0,0,0,0.0,0.0,0.0,0.0,0.0,0.0
moore101,Euel Moore,Baltimore,Baltimore,1,1,2,3,1934,1934,0,0.14,0.0,-0.14,110,0,-110,81,0,-81,663.0,0.0,-663.0,0.0,0.0,0.0
moore102,Eddie Moore,Brooklyn Dodgers,DOGRS,8,19,13,32,1931,1948,17,60.59,33.88,-26.71,3224,2883,-341,11104,10453,-651,2159.0,791.0,-1368.0,10000.0,10000.0,0.0
moore102,Eddie Moore,New York Giants,GIANTS,1,2,1,3,1932,1933,1,0.0,-0.06,-0.06,0,60,60,0,136,136,0.0,0.0,0.0,0.0,0.0,0.0
moore103,Earl Moore,Cleveland Indians,INDINS,1,1,2,3,1907,1907,0,-1.19,-0.55,0.64,24,49,25,22,87,65,180.0,278.0,98.0,0.0,0.0,0.0
moorg104,Gene Moore,Brooklyn Dodgers,DOGRS,2,3,2,5,1936,1939,3,16.05,5.67,-10.38,637,216,-421,2368,193,-2175,132.0,1522.0,1390.0,0.0,0.0,0.0
moorg104,Gene Moore,Boston Braves,BRAVES,2,4,3,7,1938,1952,14,0.98,38.76,37.78,331,1743,1412,987,7238,6251,317.0,0.0,-317.0,7500.0,0.0,-7500.0
moorg104,Gene Moore,Boston Braves,BRAVES,1,2,1,3,1942,1952,10,1.7,36.09,34.39,132,1289,1157,581,5523,4942,0.0,0.0,0.0,0.0,0.0,0.0
moorj102,Jackie Moore,Detroit Tigers,TIGRS,1,3,1,4,1966,1967,1,0.26,-0.68,-0.94,350,64,-286,935,31,-904,0.0,314.0,314.0,0.0,0.0,0.0
moorj104,Johnny Moore,Chicago Cubs,CUBS,2,7,3,10,1932,1941,9,3.2,27.52,24.32,621,896,275,1233,2014,781,2473.0,4458.0,1985.0,0.0,0.0,0.0
moorj104,Johnny Moore,Cincinnati Reds,REDS,2,4,4,8,1934,1937,3,22.67,0.0,-22.67,911,236,-675,2270,656,-1614,2379.0,321.0,-2058.0,0.0,0.0,0.0
moorj106,Jimmy Moore,Philadelphia Athletics,ATLTCS,3,6,4,10,1931,1936,5,2.31,4.79,2.48,270,523,253,676,1095,419,552.0,1925.0,1373.0,12000.0,6000.0,-6000.0
moorj107,Jim Moore,Chicago White Sox,WSOX,4,13,7,20,1932,1936,4,4.13,0.06,-4.07,711,272,-439,2521,849,-1672,0.0,39.0,39.0,28700.0,39000.0,10300.0
moork001,Kerwin Moore,Florida Marlins,MARLNS,2,2,2,4,1993,1998,5,-0.62,0.81,1.43,57,450,393,154,1468,1314,0.0,98.0,98.0,650000.0,109000.0,-541000.0
moork101,Kelvin Moore,Oakland Athletics,ATLTCS,1,1,1,2,1983,1983,0,0.0,0.0,0.0,0,0,0,0,0,0,0.0,0.0,0.0,0.0,0.0,0.0
moork101,Kelvin Moore,New York Mets,METS,1,1,1,2,1984,1984,0,0.0,0.0,0.0,0,0,0,0,0,0,0.0,0.0,0.0,0.0,0.0,0.0
moorm002,Marcus Moore,California Angels,ANGELS,2,4,5,9,1990,1993,3,21.39,3.93,-17.46,688,442,-246,3033,1668,-1365,79.0,0.0,-79.0,1180000.0,3888333.0,2708333.0
moorm002,Marcus Moore,Colorado Rockies,ROCKS,1,1,1,2,1995,1999,4,-0.52,-0.24,0.28,46,35,-11,3,70,67,79.0,0.0,-79.0,0.0,0.0,0.0
moorm003,Matt Moore,Tampa Bay Devil Rays,RAYS,2,2,4,6,2016,2020,4,0.39,3.13,2.74,87,216,129,81,834,753,728.0,0.0,-728.0,0.0,0.0,0.0
moorm003,Matt Moore,San Francisco Giants,GIANTS,1,2,2,4,2017,2017,0,-1.31,0.0,1.31,42,0,-42,0,0,0,306.0,0.0,-306.0,7000000.0,0.0,-7000000.0
moorr101,Ray Moore,Brooklyn Dodgers,DOGRS,1,1,1,2,1954,1954,0,5.5,0.0,-5.5,224,0,-224,211,0,-211,1692.0,0.0,-1692.0,0.0,0.0,0.0
moorr101,Ray Moore,Baltimore Orioles,ORLS,17,35,36,71,1957,1988,31,40.74,110.41,69.67,3408,5865,2457,6586,11971,5385,12624.0,16106.0,3482.0,725833.0,113000.0,-612833.0
moorr103,Randy Moore,Boston Braves,BRAVES,9,22,18,40,1935,1952,17,30.65,55.97,25.32,2386,3342,956,8192,10691,2499,702.0,5153.0,4451.0,12500.0,0.0,-12500.0
moorr103,Randy Moore,Brooklyn Dodgers,DOGRS,2,4,2,6,1937,1938,1,-0.18,-1.09,-0.91,8,96,88,7,228,221,0.0,0.0,0.0,0.0,0.0,0.0
moors001,Scott Moore,Detroit Tigers,TIGRS,3,5,4,9,2005,2010,5,1.05,4.48,3.43,399,254,-145,54,7,-47,685.0,1390.0,705.0,1975000.0,318500.0,-1656500.0
moors001,Scott Moore,Chicago Cubs,CUBS,1,2,1,3,2007,2007,0,-1.45,-0.48,0.97,90,8,-82,155,7,-148,100.0,52.0,-48.0,0.0,3000000.0,3000000.0
moort001,Trey Moore,Seattle Mariners,MARNRS,2,4,3,7,1996,1999,3,0.25,7.02,6.77,475,103,-372,1514,15,-1499,341.0,1794.0,1453.0,5016667.0,2800000.0,-2216667.0
moort002,Tyler Moore,Washington Nationals,NATEX,1,1,1,2,2016,2016,0,0.0,0.0,0.0,0,0,0,0,0,0,0.0,0.0,0.0,0.0,0.0,0.0
moort101,Tommy Moore,New York Mets,METS,1,2,1,3,1974,1977,3,0.04,1.83,1.79,36,254,218,2,794,792,89.0,0.0,-89.0,0.0,150000.0,150000.0
moort101,Tommy Moore,St. Louis Cardinals,CARDS,3,4,3,7,1975,1976,1,0.91,1.54,0.63,156,98,-58,524,376,-148,63.0,0.0,-63.0,0.0,0.0,0.0
moort101,Tommy Moore,Seattle Mariners,MARNRS,2,3,2,5,1977,1982,5,-0.28,1.01,1.29,129,138,9,207,50,-157,0.0,1472.0,1472.0,0.0,0.0,0.0
moorw101,Wilcy Moore,New York Yankees,YANKS,1,3,1,4,1929,1930,1,0.0,0.05,0.05,0,45,45,0,121,121,0.0,0.0,0.0,15000.0,0.0,-15000.0
moorw101,Wilcy Moore,Boston Red Sox,RSOX,3,5,4,9,1932,1946,14,-1.19,45.83,47.02,188,1466,1278,125,4680,4555,1053.0,3384.0,2331.0,22000.0,11500.0,-10500.0
moorw102,Whitey Moore,Cincinnati Reds,REDS,1,1,2,3,1942,1947,5,-0.02,5.25,5.27,18,308,290,2,155,153,37.0,1547.0,1510.0,0.0,0.0,0.0
moraa102,Al Moran,Boston Red Sox,RSOX,2,4,2,6,1963,1966,3,1.63,7.14,5.51,379,407,28,759,1449,690,1141.0,0.0,-1141.0,0.0,0.0,0.0
morab101,Billy Moran,Toronto,Toronto,1,1,2,3,1961,1961,0,5.03,0.0,-5.03,417,0,-417,1787,0,-1787,0.0,0.0,0.0,0.0,0.0,0.0
morab101,Billy Moran,Los Angeles Angels,ANGELS,4,6,6,12,1964,1968,4,-0.68,3.52,4.2,319,392,73,434,716,282,443.0,1270.0,827.0,44000.0,0.0,-44000.0
morac001,Colin Moran,Miami Marlins,MARLNS,7,20,18,38,2014,2020,6,36.69,11.6,-25.09,2821,868,-1953,6455,1964,-4491,3539.0,2374.0,-1165.0,18850000.0,18675200.0,-174800.0
morac001,Colin Moran,Houston Astros,ASTROS,1,4,1,5,2018,2019,1,3.26,12.09,8.83,813,71,-742,1676,16,-1660,1316.0,1238.0,-78.0,0.0,0.0,0.0
morac101,Charles Moran,Washington Senators,TWINS,1,1,2,3,1904,1904,0,-0.25,-0.9,-0.65,109,161,52,405,656,251,0.0,0.0,0.0,0.0,0.0,0.0
moraf001,Franklin Morales,Boston Red Sox,RSOX,1,2,1,3,2013,2014,1,-0.53,-0.06,0.47,103,42,-61,39,104,65,474.0,0.0,-474.0,1487500.0,900000.0,-587500.0
morah101,Herbie Moran,Boston Braves,BRAVES,1,2,1,3,1915,1917,2,0.0,0.67,0.67,0,170,170,0,638,638,0.0,0.0,0.0,6800.0,0.0,-6800.0
moraj001,Jose Morales,Baltimore Orioles,ORLS,2,3,3,6,1982,1987,5,-0.12,-1.04,-0.92,180,144,-36,296,240,-56,0.0,321.0,321.0,558333.0,0.0,-558333.0
moraj002,Jose Morales,Minnesota Twins,TWINS,1,1,1,2,2010,2010,0,-0.17,0.0,0.17,22,0,-22,71,0,-71,0.0,0.0,0.0,412500.0,0.0,-412500.0
moraj101,Jerry Morales,San Diego Padres,PADRS,1,1,2,3,1973,1975,2,-1.06,-0.81,0.25,792,73,-719,2848,201,-2647,0.0,0.0,0.0,0.0,0.0,0.0
moraj101,Jerry Morales,Chicago Cubs,CUBS,12,22,23,45,1977,1990,13,19.55,19.15,-0.4,3026,1816,-1210,7924,3345,-4579,1137.0,4804.0,3667.0,1020000.0,140000.0,-880000.0
moraj101,Jerry Morales,St. Louis Cardinals,CARDS,4,6,8,14,1978,1994,16,8.24,37.26,29.02,800,1928,1128,1636,7432,5796,2139.0,691.0,-1448.0,1500000.0,102500.0,-1397500.0
moraj101,Jerry Morales,Detroit Tigers,TIGRS,1,2,1,3,1979,1982,3,-0.84,3.18,4.02,115,250,135,268,851,583,0.0,0.0,0.0,0.0,200000.0,200000.0
morak001,Kendrys Morales,Anaheim Angels,ANGELS,1,1,1,2,2012,2013,1,2.64,1.95,-0.69,215,24,-191,896,0,-896,0.0,450.0,450.0,2975000.0,4850000.0,1875000.0
morak001,Kendrys Morales,Minnesota Twins,TWINS,1,1,1,2,2014,2015,1,-0.22,0.0,0.22,59,0,-59,239,0,-239,0.0,0.0,0.0,0.0,0.0,0.0
morak001,Kendrys Morales,Toronto Blue Jays,BJAYS,1,2,2,4,2019,2019,0,-0.53,0.0,0.53,35,0,-35,126,0,-126,3.0,0.0,-3.0,0.0,0.0,0.0
morak001,Kendrys Morales,Oakland Athletics,ATLTCS,1,1,1,2,2019,2019,0,-0.39,0.0,0.39,19,0,-19,75,0,-75,0.0,0.0,0.0,12000000.0,0.0,-12000000.0
moram001,Mickey Morandini,Philadelphia Phillies,PHILS,1,1,1,2,1997,2002,5,2.76,9.41,6.65,298,753,455,1190,3250,2060,0.0,0.0,0.0,1850000.0,155000.0,-1695000.0
moram001,Mickey Morandini,Philadelphia Phillies,PHILS,1,1,1,2,2000,2001,1,-0.22,-0.11,0.11,35,142,107,116,217,101,0.0,0.0,0.0,750000.0,0.0,-750000.0
moram002,Melvin Mora,New York Mets,METS,1,4,1,5,2000,2000,0,28.33,0.16,-28.17,1330,56,-1274,5573,211,-5362,33.0,0.0,-33.0,210000.0,3000000.0,2790000.0
morap101,Pat Moran,Boston Braves,BRAVES,1,1,2,3,1905,1909,4,3.49,2.44,-1.05,262,144,-118,905,239,-666,0.0,1361.0,1361.0,0.0,0.0,0.0
mordm001,Mike Mordecai,Montreal Expos,NATEX,2,6,6,12,2002,2005,3,7.25,0.27,-6.98,492,319,-173,648,239,-409,1719.0,1333.0,-386.0,4812500.0,6500000.0,1687500.0
mored001,Diego Moreno,Pittsburgh Pirates,PIRATS,1,2,2,4,2012,2013,1,0.0,3.95,3.95,4,119,115,0,138,138,31.0,1180.0,1149.0,0.0,0.0,0.0
morej001,Juan Moreno,Texas Rangers,RNGRS,1,1,1,2,2002,2002,0,-0.14,0.0,0.14,8,0,-8,0,0,0,18.0,0.0,-18.0,0.0,0.0,0.0
morej101,Jose Moreno,Philadelphia Phillies,PHILS,1,2,1,3,1979,1981,2,1.99,1.3,-0.69,173,122,-51,601,132,-469,0.0,1086.0,1086.0,0.0,0.0,0.0
morej101,Jose Moreno,New York Mets,METS,1,2,1,3,1980,1982,2,-0.04,-2.0,-1.96,34,82,48,50,50,0,0.0,501.0,501.0,0.0,0.0,0.0
morek001,Keith Moreland,Philadelphia Phillies,PHILS,3,8,5,13,1981,1988,7,16.51,17.82,1.31,2071,1049,-1022,4347,608,-3739,6629.0,2308.0,-4321.0,0.0,1330000.0,1330000.0
morek001,Keith Moreland,Chicago Cubs,CUBS,2,3,4,7,1988,1989,1,-1.95,-0.22,1.73,155,94,-61,562,6,-556,188.0,131.0,-57.0,0.0,0.0,0.0
morek001,Keith Moreland,San Diego Padres,PADRS,2,4,3,7,1988,1990,2,-0.11,0.47,0.58,120,230,110,406,663,257,249.0,443.0,194.0,2283333.0,1240000.0,-1043333.0
morek001,Keith Moreland,Detroit Tigers,TIGRS,1,1,1,2,1989,1990,1,-0.74,0.82,1.56,33,18,-15,111,0,-111,0.0,283.0,283.0,1483333.0,0.0,-1483333.0
morel101,Lew Moren,Philadelphia Phillies,PHILS,12,24,28,52,1910,1931,21,100.95,91.27,-9.68,4848,5202,354,15981,18765,2784,10753.0,6282.0,-4471.0,25000.0,31850.0,6850.0
morem001,Mitch Moreland,Boston Red Sox,RSOX,1,1,2,3,2020,2020,0,0.02,0.0,-0.02,20,0,-20,73,0,-73,0.0,0.0,0.0,2500000.0,0.0,-2500000.0
moreo001,Omar Moreno,Houston Astros,ASTROS,3,3,4,7,1983,1990,7,1.5,10.94,9.44,518,992,474,1458,3853,2395,0.0,0.0,0.0,700000.0,750000.0,50000.0
morer101,Roger Moret,Boston Red Sox,RSOX,1,1,1,2,1975,1977,2,0.13,-0.17,-0.3,54,45,-9,26,0,-26,232.0,154.0,-78.0,30000.0,0.0,-30000.0
morer101,Roger Moret,Atlanta Braves,BRAVES,3,8,3,11,1976,1983,7,3.71,6.12,2.41,495,566,71,1015,2078,1063,923.0,87.0,-836.0,33500.0,0.0,-33500.0
morer102,Ray Morehart,Chicago White Sox,WSOX,1,2,1,3,1927,1928,1,-0.49,2.12,2.61,240,145,-95,730,550,-180,0.0,0.0,0.0,0.0,0.0,0.0
mores101,Seth Morehead,Philadelphia Phillies,PHILS,2,3,3,6,1959,1962,3,0.29,0.05,-0.24,209,84,-125,180,12,-168,468.0,231.0,-237.0,0.0,0.0,0.0
mores101,Seth Morehead,Chicago Cubs,CUBS,7,13,11,24,1961,1977,16,12.22,41.5,29.28,942,3000,2058,716,8425,7709,3637.0,5246.0,1609.0,122500.0,47500.0,-75000.0
morgb102,Bobby Morgan,Brooklyn Dodgers,DOGRS,1,1,2,3,1954,1954,0,4.71,0.0,-4.71,281,0,-281,1133,0,-1133,0.0,0.0,0.0,0.0,0.0,0.0
morgb102,Bobby Morgan,Philadelphia Phillies,PHILS,7,11,11,22,1956,1984,28,31.81,59.85,28.04,1931,3646,1715,6995,9141,2146,0.0,2963.0,2963.0,0.0,123000.0,123000.0
morgb102,Bobby Morgan,St. Louis Cardinals,CARDS,3,7,6,13,1956,1963,7,8.24,1.4,-6.84,1198,700,-498,4161,1883,-2278,89.0,111.0,22.0,0.0,0.0,0.0
morgc102,Cy Morgan,St.Louis Browns,ORLS,3,4,4,8,1905,1907,2,-1.04,4.18,5.22,52,223,171,153,810,657,0.0,0.0,0.0,0.0,0.0,0.0
morgc103,Chet Morgan,Detroit Tigers,TIGRS,1,3,2,5,1938,1946,8,-0.33,15.76,16.09,102,1005,903,69,3681,3612,596.0,671.0,75.0,19500.0,16000.0,-3500.0
morge101,Eddie Morgan,St. Louis Cardinals,CARDS,1,1,1,2,1936,1936,0,-0.28,-0.49,-0.21,31,40,9,59,18,-41,0.0,173.0,173.0,0.0,0.0,0.0
morge101,Eddie Morgan,Brooklyn Dodgers,DOGRS,4,9,6,15,1938,1947,9,-0.39,36.06,36.45,76,1426,1350,39,5780,5741,380.0,123.0,-257.0,0.0,0.0,0.0
morgj001,Joe Morgan,Houston Astros,ASTROS,8,15,14,29,1971,1989,18,76.39,55.08,-21.31,4763,4769,6,15346,14810,-536,3810.0,5622.0,1812.0,705000.0,416000.0,-289000.0
morgj001,Joe Morgan,San Francisco Giants,GIANTS,6,13,17,30,1982,1998,16,28.77,47.69,18.92,1714,2984,1270,1934,3957,2023,4662.0,9275.0,4613.0,10227778.0,6966667.0,-3261111.0
morgj101,Joe Morgan,Milwaukee Braves,BRAVES,3,4,4,8,1960,1961,1,2.41,-0.26,-2.67,525,106,-419,1975,157,-1818,0.0,122.0,122.0,0.0,0.0,0.0
morgj101,Joe Morgan,Cleveland Indians,INDINS,1,3,1,4,1961,1962,1,0.0,0.7,0.7,3,41,38,3,74,71,0.0,0.0,0.0,0.0,0.0,0.0
morgk001,Kevin Morgan,Detroit Tigers,TIGRS,1,1,1,2,1994,1994,0,-0.02,0.0,0.02,1,0,-1,1,0,-1,0.0,0.0,0.0,0.0,0.0,0.0
morgm001,Mike Morgan,Oakland Athletics,ATLTCS,1,1,1,2,1980,1982,2,1.96,-0.89,-2.85,30,167,137,0,427,427,451.0,0.0,-451.0,0.0,0.0,0.0
morgm001,Mike Morgan,New York Yankees,YANKS,1,4,2,6,1982,1985,3,24.16,-0.71,-24.87,840,62,-778,3265,0,-3265,136.0,360.0,224.0,650000.0,0.0,-650000.0
morgm001,Mike Morgan,Seattle Mariners,MARNRS,1,1,1,2,1987,1987,0,-0.34,0.0,0.34,22,0,-22,0,0,0,214.0,0.0,-214.0,185000.0,155000.0,-30000.0
morgm001,Mike Morgan,Baltimore Orioles,ORLS,1,1,1,2,1989,1994,5,8.5,13.3,4.8,214,751,537,205,3122,2917,1800.0,0.0,-1800.0,0.0,0.0,0.0
morgm001,Mike Morgan,Chicago Cubs,CUBS,1,3,2,5,1995,1995,0,0.22,-1.32,-1.54,70,79,9,79,325,246,629.0,0.0,-629.0,0.0,3700000.0,3700000.0
morgm001,Mike Morgan,Minnesota Twins,TWINS,3,4,5,9,1998,2006,8,2.45,7.1,4.65,298,208,-90,106,24,-82,1216.0,2925.0,1709.0,9550000.0,0.0,-9550000.0
morgn001,Nyjer Morgan,Pittsburgh Pirates,PIRATS,4,7,9,16,2009,2020,11,14.34,15.86,1.52,1433,1357,-76,3037,658,-2379,1099.0,1818.0,719.0,4920000.0,2593000.0,-2327000.0
morgn001,Nyjer Morgan,Washington Nationals,NATEX,1,1,2,3,2011,2011,0,2.79,0.0,-2.79,241,0,-241,751,0,-751,0.0,0.0,0.0,0.0,0.0,0.0
morgt101,Tom Morgan,New York Yankees,YANKS,6,15,13,28,1957,1970,13,5.72,32.98,27.26,1633,2423,790,4235,5558,1323,2553.0,4978.0,2425.0,115500.0,43000.0,-72500.0
morgt101,Tom Morgan,Kansas City Athletics,ATLTCS,31,62,61,123,1957,1976,19,95.85,56.38,-39.47,9593,6643,-2950,23097,19018,-4079,12004.0,6179.0,-5825.0,476100.0,606500.0,130400.0
morgt101,Tom Morgan,Detroit Tigers,TIGRS,2,3,3,6,1960,1961,1,2.45,0.7,-1.75,227,142,-85,90,74,-16,805.0,344.0,-461.0,0.0,0.0,0.0
morma001,Alvin Morman,Houston Astros,ASTROS,1,1,1,2,1997,2001,4,-0.21,1.48,1.69,73,181,108,1,3,2,121.0,325.0,204.0,0.0,0.0,0.0
morma001,Alvin Morman,Cleveland Indians,INDINS,7,12,14,26,1998,2011,13,4.4,12.56,8.16,1064,1445,381,2423,3925,1502,442.0,1477.0,1035.0,9756200.0,3392500.0,-6363700.0
mornj001,Justin Morneau,Minnesota Twins,TWINS,2,2,3,5,2013,2014,1,0.01,0.0,-0.01,27,32,5,92,123,31,4.0,40.0,36.0,0.0,0.0,0.0
morod101,Dan Morogiello,Atlanta Braves,BRAVES,1,1,1,2,1982,1985,3,0.0,1.73,1.73,0,212,212,0,13,13,0.0,482.0,482.0,0.0,0.0,0.0
moroj001,Jeff Moronko,Cleveland Indians,INDINS,1,1,1,2,1985,1987,2,0.0,0.0,0.0,0,0,0,0,0,0,0.0,0.0,0.0,0.0,0.0,0.0
morom001,Max Moroff,Pittsburgh Pirates,PIRATS,1,2,3,5,2018,2021,3,1.8,0.18,-1.62,170,174,4,509,578,69,0.0,0.0,0.0,0.0,547800.0,547800.0
morra001,Akeel Morris,New York Mets,METS,1,1,2,3,2016,2016,0,0.3,0.78,0.48,16,82,66,0,201,201,22.0,0.0,-22.0,0.0,0.0,0.0
morra001,Akeel Morris,Atlanta Braves,BRAVES,1,1,1,2,2018,2018,0,-0.05,0.0,0.05,10,0,-10,0,0,0,42.0,0.0,-42.0,0.0,0.0,0.0
morra002,A.J. Morris,Washington Nationals,NATEX,1,3,1,4,2011,2012,1,0.0,1.64,1.64,0,148,148,0,40,40,0.0,531.0,531.0,0.0,0.0,0.0
morrb001,Brandon Morrow,Seattle Mariners,MARNRS,2,2,4,6,2009,2012,3,5.47,0.98,-4.49,395,193,-202,14,0,-14,2048.0,555.0,-1493.0,5425000.0,640000.0,-4785000.0
morrb002,Bryan Morris,Los Angeles Dodgers,DOGRS,1,2,1,3,2008,2010,2,0.68,6.26,5.58,458,223,-235,1050,892,-158,281.0,0.0,-281.0,392500.0,0.0,-392500.0
morrb002,Bryan Morris,Pittsburgh Pirates,PIRATS,1,1,1,2,2014,2014,0,2.59,0.0,-2.59,253,0,-253,1,0,-1,364.0,0.0,-364.0,511500.0,0.0,-511500.0
morrb103,Bugs Bennett,Tulsa,Tulsa,1,1,1,2,1921,1921,0,-0.35,0.0,0.35,6,0,-6,1,0,-1,17.0,0.0,-17.0,0.0,0.0,0.0
morrh001,Hal Morris,New York Yankees,YANKS,2,4,3,7,1989,1992,3,13.18,0.48,-12.7,1091,78,-1013,3762,0,-3762,640.0,1277.0,637.0,2175000.0,0.0,-2175000.0
morrj002,Jim Morrison,Philadelphia Phillies,PHILS,1,1,1,2,1979,1979,0,4.69,-0.11,-4.8,370,8,-362,1430,0,-1430,0.0,13.0,13.0,0.0,0.0,0.0
morrj002,Jim Morrison,Chicago White Sox,WSOX,1,1,1,2,1982,1982,0,8.2,-0.05,-8.25,552,6,-546,1833,0,-1833,0.0,22.0,22.0,0.0,0.0,0.0
morrj002,Jim Morrison,Pittsburgh Pirates,PIRATS,5,5,7,12,1987,1993,6,1.03,3.46,2.43,777,318,-459,2768,983,-1785,0.0,77.0,77.0,1442500.0,1020000.0,-422500.0
morrj003,John Morris,Kansas City Royals,ROYALS,1,1,1,2,1985,1987,2,0.07,3.36,3.29,274,302,28,462,1263,801,0.0,0.0,0.0,0.0,740000.0,740000.0
morrj106,John Morris,Philadelphia Phillies,PHILS,1,1,1,2,1967,1968,1,0.06,1.58,1.52,38,160,122,6,20,14,95.0,396.0,301.0,0.0,0.0,0.0
morrj106,John Morris,Milwaukee Brewers,BREWRS,4,8,9,17,1971,1978,7,7.01,0.21,-6.8,608,258,-350,1535,355,-1180,624.0,2009.0,1385.0,168301.0,15000.0,-153301.0
morrl001,Logan Morrison,Miami Marlins,MARLNS,4,9,7,16,2013,2019,6,13.58,1.36,-12.22,785,446,-339,1476,128,-1348,2851.0,1546.0,-1305.0,1041500.0,8151900.0,7110400.0
morrl001,Logan Morrison,Seattle Mariners,MARNRS,4,7,6,13,2015,2017,2,9.3,3.09,-6.21,1092,200,-892,3957,584,-3373,347.0,283.0,-64.0,10679600.0,5022800.0,-5656800.0
morrm001,Matt Morris,San Francisco Giants,GIANTS,1,1,2,3,2007,2008,1,-1.2,0.22,1.42,32,63,31,31,181,150,253.0,0.0,-253.0,10037283.0,0.0,-10037283.0
morrw001,Warren Morris,Texas Rangers,RNGRS,6,10,9,19,1998,2015,17,5.51,25.74,20.23,761,2021,1260,2144,8331,6187,1539.0,1259.0,-280.0,19651100.0,3670000.0,-15981100.0
morrw001,Warren Morris,Minnesota Twins,TWINS,1,1,1,2,2002,2002,0,0.0,0.0,0.0,0,0,0,0,0,0,0.0,0.0,0.0,275000.0,0.0,-275000.0
morsm001,Michael Morse,Chicago White Sox,WSOX,4,9,8,17,2004,2013,9,26.28,24.52,-1.76,2038,506,-1532,7101,844,-6257,1892.0,4790.0,2898.0,12920000.0,9770000.0,-3150000.0
morsm001,Michael Morse,Seattle Mariners,MARNRS,1,1,1,2,2009,2011,2,5.58,0.86,-4.72,378,117,-261,1353,318,-1035,0.0,0.0,0.0,0.0,0.0,0.0
morsm001,Michael Morse,Washington Nationals,NATEX,4,8,7,15,2013,2020,7,3.23,12.15,8.92,436,987,551,372,153,-219,1207.0,2502.0,1295.0,8731616.0,4000000.0,-4731616.0
morsm001,Michael Morse,Seattle Mariners,MARNRS,1,1,1,2,2013,2014,1,-0.49,0.0,0.49,12,0,-12,30,0,-30,0.0,0.0,0.0,0.0,0.0,0.0
morsm001,Michael Morse,Miami Marlins,MARLNS,1,3,3,6,2015,2015,0,-0.52,0.0,0.52,12,0,-12,7,0,-7,73.0,0.0,-73.0,9400000.0,0.0,-9400000.0
morsm001,Michael Morse,Los Angeles Dodgers,DOGRS,1,2,1,3,2015,2016,1,-0.21,0.0,0.21,51,0,-51,90,0,-90,0.0,0.0,0.0,0.0,4000000.0,4000000.0
mortb101,Bubba Morton,Cleveland Indians,INDINS,5,9,8,17,1965,1973,8,26.02,3.2,-22.82,1968,411,-1557,6884,1010,-5874,0.0,78.0,78.0,7000.0,21500.0,14500.0
mortc002,Charlie Morton,Atlanta Braves,BRAVES,1,3,1,4,2009,2011,2,-2.0,-0.61,1.39,553,250,-303,514,1005,491,4336.0,0.0,-4336.0,0.0,2500000.0,2500000.0
mortc002,Charlie Morton,Pittsburgh Pirates,PIRATS,1,1,1,2,2015,2015,0,0.26,0.0,-0.26,8,0,-8,7,0,-7,52.0,0.0,-52.0,8000000.0,0.0,-8000000.0
mortc003,Clayton Mortensen,St. Louis Cardinals,CARDS,1,3,1,4,2009,2016,7,-0.87,23.07,23.94,9,982,973,8,4121,4113,101.0,0.0,-101.0,0.0,13500000.0,13500000.0
mortc003,Clayton Mortensen,Oakland Athletics,ATLTCS,2,2,2,4,2011,2012,1,0.27,-0.16,-0.43,31,39,8,15,139,124,175.0,0.0,-175.0,0.0,419000.0,419000.0
mortc003,Clayton Mortensen,Colorado Rockies,ROCKS,2,3,2,5,2012,2015,3,4.38,-1.84,-6.22,246,237,-9,830,752,-78,217.0,0.0,-217.0,6000000.0,0.0,-6000000.0
mortc003,Clayton Mortensen,Boston Red Sox,RSOX,1,1,1,2,2013,2013,0,0.0,0.39,0.39,0,13,13,0,9,9,0.0,0.0,0.0,504500.0,0.0,-504500.0
mortc102,Carl Morton,Montreal Expos,NATEX,4,5,4,9,1973,1978,5,34.93,-0.01,-34.94,2168,359,-1809,7237,726,-6511,3495.0,675.0,-2820.0,40000.0,0.0,-40000.0
mortc102,Carl Morton,Atlanta Braves,BRAVES,3,8,3,11,1976,1983,7,3.71,6.12,2.41,495,566,71,1015,2078,1063,923.0,87.0,-836.0,33500.0,0.0,-33500.0
moryw101,Walt Moryn,Brooklyn Dodgers,DOGRS,2,4,4,8,1955,1961,6,18.38,2.09,-16.29,1649,196,-1453,2986,562,-2424,2426.0,26.0,-2400.0,0.0,0.0,0.0
moryw101,Walt Moryn,Chicago Cubs,CUBS,2,2,2,4,1960,1964,4,-0.33,-0.8,-0.47,92,83,-9,254,131,-123,0.0,0.0,0.0,0.0,0.0,0.0
moscg001,Guillermo Moscoso (Corredor),Detroit Tigers,TIGRS,1,2,1,3,2008,2010,2,0.07,0.88,0.81,11,224,213,0,776,776,44.0,0.0,-44.0,0.0,1600000.0,1600000.0
moscg001,Guillermo Moscoso (Corredor),Texas Rangers,RNGRS,2,2,2,4,2011,2013,2,1.84,-0.3,-2.14,24,10,-14,3,19,16,384.0,0.0,-384.0,0.0,0.0,0.0
moscg001,Guillermo Moscoso (Corredor),Oakland Athletics,ATLTCS,2,3,2,5,2012,2014,2,3.45,4.02,0.57,352,317,-35,551,851,300,434.0,217.0,-217.0,3675000.0,3200000.0,-475000.0
mosea101,Arnie Moser,Brooklyn Dodgers,DOGRS,1,3,1,4,1941,1946,5,0.0,0.04,0.04,0,2,2,0,5,5,0.0,0.0,0.0,0.0,0.0,0.0
mosed001,Dustin Moseley,Cincinnati Reds,REDS,1,1,1,2,2004,2005,1,0.56,-0.5,-1.06,69,60,-9,0,61,61,504.0,514.0,10.0,0.0,3266667.0,3266667.0
mosej101,Jerry Moses,Boston Red Sox,RSOX,6,13,11,24,1970,1987,17,23.72,33.07,9.35,1247,1904,657,3411,5540,2129,3997.0,6601.0,2604.0,192500.0,125000.0,-67500.0
mosej101,Jerry Moses,California Angels,ANGELS,2,3,5,8,1971,1974,3,-0.38,1.97,2.35,378,289,-89,1313,1028,-285,0.0,88.0,88.0,15000.0,86500.0,71500.0
mosej101,Jerry Moses,Cleveland Indians,INDINS,6,9,10,19,1972,1984,12,43.46,8.37,-35.09,2118,2287,169,7743,7713,-30,0.0,317.0,317.0,82750.0,271600.0,188850.0
mosej101,Jerry Moses,New York Yankees,YANKS,2,2,4,6,1974,1976,2,0.35,-1.55,-1.9,212,143,-69,273,290,17,578.0,23.0,-555.0,0.0,0.0,0.0
mosew101,Wally Moses,Philadelphia Athletics,ATLTCS,1,1,1,2,1939,1946,7,0.0,4.33,4.33,0,275,275,0,1183,1183,0.0,0.0,0.0,12500.0,4200.0,-8300.0
mosew101,Wally Moses,Philadelphia Athletics,ATLTCS,1,1,2,3,1941,1942,1,12.57,0.52,-12.05,628,116,-512,2724,494,-2230,0.0,0.0,0.0,12500.0,13900.0,1400.0
moskp101,Paul Moskau,Cincinnati Reds,REDS,2,2,2,4,1982,1983,1,0.75,0.87,0.12,59,145,86,149,292,143,0.0,0.0,0.0,0.0,0.0,0.0
mosoj101,Jim Mosolf,KansasCity,KansasCity,1,1,1,2,1933,1933,0,0.17,0.0,-0.17,31,0,-31,92,0,-92,0.0,0.0,0.0,0.0,0.0,0.0
mossb001,Brandon Moss,Boston Red Sox,RSOX,1,3,1,4,2008,2009,1,-1.7,7.17,8.87,237,200,-37,628,849,221,66.0,0.0,-66.0,18929923.0,6000000.0,-12929923.0
mossb001,Brandon Moss,Oakland Athletics,ATLTCS,3,5,5,10,2014,2021,7,9.97,0.89,-9.08,598,227,-371,2214,794,-1420,0.0,0.0,0.0,4635000.0,0.0,-4635000.0
mossb001,Brandon Moss,Cleveland Indians,INDINS,1,1,1,2,2015,2019,4,0.63,0.0,-0.63,179,0,-179,615,0,-615,0.0,0.0,0.0,6500000.0,0.0,-6500000.0
mossb001,Brandon Moss,Kansas City Royals,ROYALS,1,3,2,5,2018,2021,3,1.28,0.62,-0.66,124,62,-62,0,5,5,254.0,390.0,136.0,0.0,0.0,0.0
mossd001,Damian Moss,Atlanta Braves,BRAVES,1,2,1,3,2002,2004,2,0.14,4.84,4.7,172,133,-39,38,153,115,546.0,1251.0,705.0,215000.0,2862500.0,2647500.0
mossd001,Damian Moss,San Francisco Giants,GIANTS,1,3,1,4,2003,2003,0,-1.54,0.88,2.42,20,20,0,0,25,25,251.0,204.0,-47.0,1852000.0,4250000.0,2398000.0
mossd101,Don Mossi,Cleveland Indians,INDINS,4,8,7,15,1958,1965,7,18.0,1.46,-16.54,1595,479,-1116,4009,1716,-2293,3556.0,132.0,-3424.0,7500.0,10500.0,3000.0
mossl101,Les Moss,St.Louis Browns,ORLS,23,51,55,106,1951,1988,37,66.54,161.01,94.47,4927,9843,4916,9616,27828,18212,17528.0,17136.0,-392.0,829333.0,144400.0,-684933.0
mossl101,Les Moss,Boston Red Sox,RSOX,2,3,3,6,1951,1954,3,0.76,-1.3,-2.06,327,78,-249,1005,178,-827,0.0,0.0,0.0,0.0,0.0,0.0
mossl101,Les Moss,Baltimore Orioles,ORLS,1,1,1,2,1955,1956,1,1.01,1.53,0.52,132,96,-36,354,11,-343,0.0,256.0,256.0,0.0,0.0,0.0
mossm101,Mal Moss,Chicago Cubs,CUBS,1,2,1,3,1930,1931,1,0.0,0.38,0.38,0,39,39,0,178,178,0.0,0.0,0.0,10500.0,0.0,-10500.0
motad001,Danny Mota,New York Yankees,YANKS,1,5,1,6,1998,2001,3,22.8,7.48,-15.32,1163,539,-624,4014,2478,-1536,2978.0,0.0,-2978.0,0.0,0.0,0.0
motag001,Guillermo Mota,Montreal Expos,NATEX,4,7,10,17,2002,2004,2,14.79,-4.81,-19.6,572,445,-127,87,268,181,2398.0,643.0,-1755.0,370000.0,0.0,-370000.0
motag001,Guillermo Mota,Los Angeles Dodgers,DOGRS,2,6,5,11,2004,2008,4,2.71,12.71,10.0,623,499,-124,1632,1049,-583,321.0,2036.0,1715.0,9106667.0,11835000.0,2728333.0
motag001,Guillermo Mota,Florida Marlins,MARLNS,7,14,19,33,2005,2019,14,61.63,50.29,-11.34,1841,2297,456,4569,6863,2294,8636.0,5082.0,-3554.0,29867000.0,14191425.0,-15675575.0
motag001,Guillermo Mota,Boston Red Sox,RSOX,6,12,8,20,2006,2011,5,15.42,8.9,-6.52,1619,794,-825,3010,1778,-1232,1235.0,750.0,-485.0,8391733.0,1897000.0,-6494733.0
motag001,Guillermo Mota,New York Mets,METS,1,1,1,2,2007,2007,0,0.21,0.0,-0.21,115,0,-115,0,0,0,171.0,0.0,-171.0,1800000.0,3400000.0,1600000.0
motaj001,Jose Mota,Chicago White Sox,WSOX,2,6,5,11,1985,1991,6,14.64,2.56,-12.08,1223,446,-777,4038,1366,-2672,817.0,277.0,-540.0,640000.0,879873.0,239873.0
motaj001,Jose Mota,Texas Rangers,RNGRS,1,1,1,2,1987,1988,1,0.0,-0.44,-0.44,0,13,13,0,25,25,0.0,0.0,0.0,0.0,0.0,0.0
motaj001,Jose Mota,Oakland Athletics,ATLTCS,1,1,1,2,1989,1989,0,-0.39,0.0,0.39,17,0,-17,41,0,-41,0.0,0.0,0.0,0.0,0.0,0.0
motam101,Manny Mota,San Francisco Giants,GIANTS,1,2,1,3,1962,1964,2,0.0,-0.41,-0.41,0,54,54,0,153,153,0.0,0.0,0.0,0.0,0.0,0.0
motam101,Manny Mota,Houston Astros,ASTROS,1,1,2,3,1963,1963,0,6.61,0.36,-6.25,642,133,-509,1858,448,-1410,0.0,0.0,0.0,0.0,0.0,0.0
motam101,Manny Mota,Montreal Expos,NATEX,4,5,7,12,1969,1978,9,18.8,19.12,0.32,1836,868,-968,5544,3116,-2428,0.0,0.0,0.0,0.0,0.0,0.0
motld001,Darryl Motley,Kansas City Royals,ROYALS,3,6,5,11,1986,1991,5,17.01,13.58,-3.43,597,812,215,858,3196,2338,3709.0,97.0,-3612.0,1438000.0,747500.0,-690500.0
mottc101,Curt Motton,Baltimore Orioles,ORLS,4,4,5,9,1971,1979,8,-0.08,4.3,4.38,77,137,60,22,2,-20,299.0,750.0,451.0,0.0,0.0,0.0
mottc101,Curt Motton,Milwaukee Brewers,BREWRS,1,1,1,2,1972,1972,0,0.01,-0.86,-0.87,42,10,-32,44,4,-40,0.0,56.0,56.0,20500.0,0.0,-20500.0
mottt001,Taylor Motter,Tampa Bay Devil Rays,RAYS,1,2,3,5,2016,2021,5,-0.63,1.91,2.54,100,161,61,297,1,-296,3.0,549.0,546.0,0.0,0.0,0.0
moulg101,Glen Moulder,Brooklyn Dodgers,DOGRS,1,1,1,2,1950,1951,1,0.0,0.0,0.0,0,0,0,0,0,0,0.0,0.0,0.0,0.0,0.0,0.0
mousm001,Mike Moustakas,Kansas City Royals,ROYALS,2,2,3,5,2018,2020,2,5.78,-0.83,-6.61,333,134,-199,1119,238,-881,3.0,475.0,472.0,0.0,0.0,0.0
moutj001,James Mouton,Houston Astros,ASTROS,1,1,1,2,1998,1999,1,-1.01,1.9,2.91,55,98,43,71,97,26,0.0,813.0,813.0,0.0,0.0,0.0
moutl001,Lyle Mouton,New York Yankees,YANKS,1,2,1,3,1995,1995,0,1.86,4.02,2.16,233,30,-203,702,0,-702,0.0,653.0,653.0,0.0,0.0,0.0
moutl001,Lyle Mouton,Baltimore Orioles,ORLS,1,1,1,2,1999,1999,0,0.16,0.0,-0.16,56,0,-56,128,0,-128,0.0,0.0,0.0,0.0,0.0,0.0
moutl001,Lyle Mouton,Philadelphia Phillies,PHILS,1,1,1,2,2003,2003,0,0.0,0.0,0.0,0,0,0,0,0,0,0.0,0.0,0.0,0.0,307500.0,307500.0
mowrj101,Joe Mowry,Minneapolis,Minneapolis,1,1,3,4,1933,1933,0,-0.78,0.0,0.78,192,0,-192,511,0,-511,0.0,0.0,0.0,0.0,0.0,0.0
mowrj101,Joe Mowry,Boston Braves,BRAVES,1,2,1,3,1936,1940,4,0.0,8.2,8.2,0,205,205,0,253,253,0.0,2031.0,2031.0,0.0,0.0,0.0
mowrm101,Mike Mowrey,Cincinnati Reds,REDS,1,1,1,2,1909,1909,0,10.32,0.19,-10.13,538,13,-525,2171,49,-2122,0.0,0.0,0.0,0.0,0.0,0.0
mowrm101,Mike Mowrey,St. Louis Cardinals,CARDS,1,3,5,8,1913,1920,7,9.94,10.5,0.56,493,813,320,1225,2891,1666,2306.0,795.0,-1511.0,13500.0,11400.0,-2100.0
moyag001,Gabriel Moya,Arizona Diamondbacks,DBACKS,1,1,1,2,2017,2019,2,0.14,-0.48,-0.62,43,119,76,0,299,299,128.0,9.0,-119.0,0.0,0.0,0.0
moyej001,Jamie Moyer,Chicago Cubs,CUBS,6,8,15,23,1988,1995,7,50.51,3.13,-47.38,2529,1449,-1080,6791,543,-6248,2650.0,3110.0,460.0,1193000.0,707500.0,-485500.0
moyej001,Jamie Moyer,Boston Red Sox,RSOX,1,1,1,2,1996,1998,2,34.44,6.2,-28.24,337,340,3,31,1315,1284,6279.0,0.0,-6279.0,825000.0,130000.0,-695000.0
moyej001,Jamie Moyer,Seattle Mariners,MARNRS,1,1,2,3,2006,2006,0,4.31,0.0,-4.31,239,0,-239,269,0,-269,2162.0,0.0,-2162.0,5500000.0,0.0,-5500000.0
muelb001,Bill Mueller,San Francisco Giants,GIANTS,1,1,1,2,2000,2003,3,3.59,2.59,-1.0,173,451,278,670,9,-661,0.0,686.0,686.0,1325000.0,0.0,-1325000.0
muelb001,Bill Mueller,Chicago Cubs,CUBS,1,2,1,3,2002,2002,0,-0.13,0.0,0.13,8,0,-8,14,0,-14,0.0,0.0,0.0,3450000.0,0.0,-3450000.0
muelh102,Heinie Mueller,St. Louis Cardinals,CARDS,1,1,1,2,1926,1926,0,0.3,3.22,2.92,169,99,-70,554,439,-115,0.0,0.0,0.0,4875.0,8000.0,3125.0
muelh102,Heinie Mueller,Toledo,Toledo,1,2,1,3,1928,1928,0,-1.24,0.0,1.24,94,0,-94,291,0,-291,20.0,0.0,-20.0,0.0,0.0,0.0
muelr101,Ray Mueller,Boston Braves,BRAVES,2,2,4,6,1938,1946,8,1.07,0.29,-0.78,243,210,-33,646,200,-446,0.0,1618.0,1618.0,0.0,0.0,0.0
muelr101,Ray Mueller,Cincinnati Reds,REDS,10,18,24,42,1949,1965,16,91.56,26.25,-65.31,5002,2400,-2602,16123,6124,-9999,2749.0,1025.0,-1724.0,63000.0,63000.0,0.0
muffb101,Billy Muffett,St. Louis Cardinals,CARDS,2,6,5,11,1958,1965,7,0.78,23.86,23.08,573,513,-60,1253,888,-365,694.0,3387.0,2693.0,0.0,12000.0,12000.0
muffb101,Billy Muffett,San Francisco Giants,GIANTS,1,2,1,3,1959,1959,0,1.57,0.59,-0.98,124,22,-102,73,0,-73,725.0,39.0,-686.0,0.0,0.0,0.0
mujie001,Edward Mujica,San Diego Padres,PADRS,7,19,13,32,2010,2021,11,21.8,17.69,-4.11,1883,1364,-519,3716,4253,537,2638.0,362.0,-2276.0,9990300.0,405000.0,-9585300.0
mujie001,Edward Mujica,Miami Marlins,MARLNS,1,1,1,2,2012,2012,0,2.77,0.0,-2.77,183,0,-183,2,0,-2,273.0,0.0,-273.0,1625000.0,0.0,-1625000.0
mujie001,Edward Mujica,Boston Red Sox,RSOX,1,2,1,3,2015,2015,0,-0.49,0.0,0.49,41,0,-41,0,0,0,101.0,0.0,-101.0,0.0,0.0,0.0
muldm001,Mark Mulder,Oakland Athletics,ATLTCS,16,29,29,58,2004,2018,14,108.62,49.4,-59.22,6127,2964,-3163,18338,8301,-10037,6576.0,6023.0,-553.0,37067500.0,22707333.0,-14360167.0
mulht001,Terry Mulholland,San Francisco Giants,GIANTS,2,4,4,8,1989,1995,6,14.97,0.18,-14.79,1080,283,-797,2467,146,-2321,4215.0,391.0,-3824.0,1545000.0,1450000.0,-95000.0
mulht001,Terry Mulholland,Philadelphia Phillies,PHILS,1,2,3,5,1994,2002,8,-0.95,-1.6,-0.65,27,666,639,0,1569,1569,372.0,587.0,215.0,0.0,0.0,0.0
mulht001,Terry Mulholland,Philadelphia Phillies,PHILS,2,2,2,4,1996,2001,5,0.74,-1.66,-2.4,57,337,280,189,1216,1027,208.0,0.0,-208.0,1045000.0,203000.0,-842000.0
mulht001,Terry Mulholland,Chicago Cubs,CUBS,2,4,5,9,1999,2001,2,0.04,-3.17,-3.21,294,120,-174,362,46,-316,1366.0,490.0,-876.0,5325000.0,1200000.0,-4125000.0
mulht001,Terry Mulholland,Pittsburgh Pirates,PIRATS,4,5,5,10,2001,2006,5,-2.39,-0.22,2.17,239,214,-25,117,329,212,377.0,169.0,-208.0,6500000.0,2015000.0,-4485000.0
mulht001,Terry Mulholland,Los Angeles Dodgers,DOGRS,1,3,1,4,2002,2004,2,-0.33,0.6,0.93,92,177,85,4,5,1,830.0,299.0,-531.0,3250000.0,3250000.0,0.0
mullb101,Billy Mullen,Detroit Tigers,TIGRS,2,5,4,9,1927,1934,7,25.64,16.62,-9.02,1182,957,-225,3618,3579,-39,3712.0,0.0,-3712.0,12500.0,10000.0,-2500.0
mullb101,Billy Mullen,Brooklyn Dodgers,DOGRS,1,2,1,3,1925,1927,2,0.0,0.0,0.0,0,40,40,0,13,13,0.0,139.0,139.0,0.0,0.0,0.0
mullb101,Billy Mullen,FortWorth,FortWorth,1,2,2,4,1925,1925,0,-0.54,0.0,0.54,83,0,-83,54,0,-54,341.0,0.0,-341.0,0.0,0.0,0.0
mullc101,Charlie Mullen,Lincoln,Lincoln,1,1,2,3,1914,1914,0,0.94,0.0,-0.94,192,0,-192,644,0,-644,0.0,0.0,0.0,0.0,0.0,0.0
mullf001,Fran Mullins,Chicago White Sox,WSOX,1,1,1,2,1983,1984,1,0.0,0.18,0.18,0,12,12,0,11,11,0.0,0.0,0.0,0.0,0.0,0.0
mullf101,Freddie Muller,Boston Red Sox,RSOX,2,4,2,6,1934,1946,12,-0.53,28.3,28.83,39,1263,1224,121,5085,4964,0.0,0.0,0.0,0.0,29500.0,29500.0
mullg101,Greg Mulleavy,Toledo,Toledo,1,1,2,3,1930,1934,4,-0.54,0.0,0.54,78,0,-78,324,0,-324,0.0,0.0,0.0,0.0,11000.0,11000.0
mullg101,Greg Mulleavy,Chicago White Sox,WSOX,2,7,3,10,1932,1936,4,0.81,-0.11,-0.92,234,49,-185,748,93,-655,0.0,39.0,39.0,8600.0,12500.0,3900.0
mullj103,Eddie Mulligan,Chicago White Sox,WSOX,2,5,2,7,1922,1931,9,8.34,28.43,20.09,522,1292,770,2094,5360,3266,0.0,0.0,0.0,22100.0,10000.0,-12100.0
mullj103,Eddie Mulligan,Chicago Cubs,CUBS,1,1,2,3,1916,1916,0,0.0,-0.68,-0.68,0,69,69,0,256,256,0.0,0.0,0.0,1350.0,0.0,-1350.0
mullr001,Rance Mulliniks,California Angels,ANGELS,4,5,7,12,1979,1983,4,17.81,3.93,-13.88,1525,241,-1284,5870,846,-5024,0.0,43.0,43.0,0.0,0.0,0.0
mullr001,Rance Mulliniks,Kansas City Royals,ROYALS,1,1,1,2,1982,1983,1,15.83,0.0,-15.83,1115,0,-1115,3470,0,-3470,0.0,0.0,0.0,0.0,0.0,0.0
mulls002,Scott Mullen,Kansas City Royals,ROYALS,2,3,2,5,2003,2004,1,-0.09,-0.19,-0.1,2,17,15,1,19,18,9.0,0.0,-9.0,0.0,0.0,0.0
mullt101,Tony Mullane,Cincinnati Reds,REDS,1,1,2,3,1893,1893,0,3.4,0.84,-2.56,114,42,-72,180,193,13,1102.0,0.0,-1102.0,2100.0,0.0,-2100.0
mullt101,Tony Mullane,Baltimore Orioles,BLN,1,1,1,2,1894,1894,0,-0.28,0.0,0.28,8,0,-8,18,0,-18,99.0,0.0,-99.0,0.0,0.0,0.0
mulrf101,Frank Mulroney,Boston Red Sox,RSOX,2,6,4,10,1930,1937,7,1.87,7.56,5.69,361,744,383,1356,1842,486,119.0,1357.0,1238.0,15100.0,31000.0,15900.0
mulvk001,Kevin Mulvey,New York Mets,METS,1,4,1,5,2008,2013,5,2.31,15.63,13.32,305,210,-95,963,247,-716,66.0,2151.0,2085.0,0.0,0.0,0.0
mulvk001,Kevin Mulvey,Minnesota Twins,TWINS,1,1,1,2,2009,2010,1,-0.41,1.94,2.35,16,78,62,7,1,-6,78.0,220.0,142.0,0.0,2525000.0,2525000.0
mumpj001,Jerry Mumphrey,St. Louis Cardinals,CARDS,1,2,1,3,1979,1980,1,5.72,-0.43,-6.15,56,86,30,0,270,270,1178.0,0.0,-1178.0,0.0,0.0,0.0
mumpj001,Jerry Mumphrey,Cleveland Indians,INDINS,6,11,12,23,1980,2004,24,38.83,53.45,14.62,1690,2550,860,6276,9198,2922,2682.0,4119.0,1437.0,1767500.0,1412500.0,-355000.0
mumpj001,Jerry Mumphrey,San Diego Padres,PADRS,4,9,9,18,1981,1989,8,31.59,14.9,-16.69,2540,1181,-1359,8500,2380,-6120,1963.0,4252.0,2289.0,0.0,300000.0,300000.0
mumpj001,Jerry Mumphrey,New York Yankees,YANKS,1,1,1,2,1983,1985,2,4.93,0.17,-4.76,325,199,-126,1241,613,-628,0.0,0.0,0.0,0.0,700000.0,700000.0
mumpj001,Jerry Mumphrey,Houston Astros,ASTROS,2,2,3,5,1985,1990,5,1.33,6.01,4.68,319,667,348,845,2612,1767,0.0,0.0,0.0,0.0,750000.0,750000.0
muncb101,Bob Muncrief,St.Louis Browns,ORLS,6,12,14,26,1947,1960,13,15.93,14.55,-1.38,866,1429,563,1976,4545,2569,2508.0,1208.0,-1300.0,30000.0,0.0,-30000.0
mungr101,Red Munger,St. Louis Cardinals,CARDS,1,1,1,2,1952,1952,0,0.21,-0.28,-0.49,80,38,-42,41,9,-32,400.0,117.0,-283.0,0.0,0.0,0.0
mungv101,Van Mungo,Brooklyn Dodgers,DOGRS,4,8,8,16,1941,1958,17,4.28,10.97,6.69,1667,1086,-581,5534,2416,-3118,435.0,3148.0,2713.0,50000.0,61500.0,11500.0
munnl101,Les Munns,StPaul,StPaul,1,1,4,5,1933,1933,0,-1.36,0.0,1.36,110,0,-110,47,0,-47,473.0,0.0,-473.0,0.0,0.0,0.0
munns101,Scott Munninghoff,Philadelphia Phillies,PHILS,5,9,9,18,1981,1988,7,7.67,6.22,-1.45,1238,579,-659,3588,1540,-2048,737.0,444.0,-293.0,1380000.0,532500.0,-847500.0
munoa002,Andres Munoz,San Diego Padres,PADRS,1,4,3,7,2020,2021,1,5.43,0.42,-5.01,353,36,-317,1365,75,-1290,2.0,42.0,40.0,0.0,0.0,0.0
munob001,Bobby Munoz,New York Yankees,YANKS,1,3,2,5,1994,1995,1,-1.6,-0.95,0.65,666,27,-639,1569,0,-1569,587.0,372.0,-215.0,0.0,0.0,0.0
munom001,Mike Munoz,Los Angeles Dodgers,DOGRS,1,1,1,2,1990,1990,0,0.81,0.0,-0.81,80,0,-80,0,0,0,181.0,0.0,-181.0,0.0,0.0,0.0
munoo001,Oscar Munoz,Cleveland Indians,INDINS,1,2,1,3,1992,1995,3,-0.31,3.9,4.21,10,487,477,0,1779,1779,106.0,0.0,-106.0,0.0,0.0,0.0
munop001,Pedro Munoz,Toronto Blue Jays,BJAYS,1,2,1,3,1990,1990,0,0.48,-0.21,-0.69,536,13,-523,1913,0,-1913,0.0,64.0,64.0,255000.0,500000.0,245000.0
munoy001,Yairo Munoz,Oakland Athletics,ATLTCS,1,2,1,3,2017,2017,0,-0.26,0.0,0.26,208,0,-208,527,0,-527,3.0,0.0,-3.0,0.0,1333333.0,1333333.0
munrp001,Peter Munro,Boston Red Sox,RSOX,1,2,1,3,1998,2000,2,-0.36,2.97,3.33,41,241,200,1,918,917,243.0,0.0,-243.0,0.0,1800000.0,1800000.0
munrp001,Peter Munro,Toronto Blue Jays,BJAYS,1,1,1,2,2000,2000,0,0.0,0.81,0.81,0,47,47,0,206,206,0.0,0.0,0.0,220000.0,0.0,-220000.0
munsj101,Joe Munson,Chicago Cubs,CUBS,2,4,3,7,1926,1934,8,0.0,24.0,24.0,0,988,988,0,3984,3984,0.0,0.0,0.0,12967.0,0.0,-12967.0
muras001,Steve Mura,San Diego Padres,PADRS,6,11,12,23,1981,1993,12,64.79,33.72,-31.07,2384,3112,728,8892,7842,-1050,1163.0,2653.0,1490.0,905000.0,3605833.0,2700833.0
murcb101,Bobby Murcer,New York Yankees,YANKS,18,38,37,75,1974,1995,21,40.05,80.77,40.72,3573,4606,1033,9500,13249,3749,6440.0,7138.0,698.0,3804706.0,6035000.0,2230294.0
murcb101,Bobby Murcer,San Francisco Giants,GIANTS,13,28,29,57,1977,1998,21,51.57,71.65,20.08,3606,5145,1539,8805,7807,-998,5201.0,15628.0,10427.0,10487778.0,6966667.0,-3521111.0
murcb101,Bobby Murcer,Chicago Cubs,CUBS,2,4,2,6,1979,1982,3,0.19,0.93,0.74,338,128,-210,948,477,-471,152.0,0.0,-152.0,320000.0,0.0,-320000.0
murct101,Tim Murchison,St. Louis Cardinals,CARDS,1,4,1,5,1918,1918,0,0.0,0.57,0.57,0,80,80,0,312,312,0.0,0.0,0.0,0.0,0.0,0.0
murfr101,Red Murff,New York Giants,GIANTS,1,1,1,2,1955,1957,2,-0.36,0.0,0.36,52,0,-52,12,0,-12,151.0,0.0,-151.0,0.0,0.0,0.0
murpb001,Bill Murphy,Oakland Athletics,ATLTCS,6,10,8,18,2003,2017,14,-1.4,14.82,16.22,291,1017,726,344,2748,2404,719.0,1374.0,655.0,18058194.0,10721429.0,-7336765.0
murpb001,Bill Murphy,Florida Marlins,MARLNS,10,19,25,44,2004,2019,15,75.87,54.29,-21.58,2478,2882,404,6294,8326,2032,10672.0,5424.0,-5248.0,38568667.0,23298092.0,-15270575.0
murpb001,Bill Murphy,Los Angeles Dodgers,DOGRS,1,3,2,5,2004,2004,0,-0.45,1.02,1.47,67,105,38,129,363,234,19.0,0.0,-19.0,0.0,7800000.0,7800000.0
murpd001,Dale Murphy,Atlanta Braves,BRAVES,3,4,5,9,1990,1991,1,7.07,0.22,-6.85,460,126,-334,1122,43,-1079,1808.0,218.0,-1590.0,2100000.0,1400000.0,-700000.0
murpd003,Dan Murphy,Milwaukee Brewers,BREWRS,2,3,4,7,1989,1993,4,-0.17,2.11,2.28,14,83,69,0,0,0,19.0,300.0,281.0,0.0,0.0,0.0
murpd005,David Murphy,Boston Red Sox,RSOX,1,3,2,5,2007,2007,0,10.71,-0.24,-10.95,871,20,-851,3012,0,-3012,292.0,56.0,-236.0,0.0,6000000.0,6000000.0
murpd005,David Murphy,Cleveland Indians,INDINS,1,1,1,2,2015,2019,4,-0.3,-0.71,-0.41,48,15,-33,162,48,-114,0.0,0.0,0.0,0.0,0.0,0.0
murpd006,Daniel Murphy,Washington Nationals,NATEX,3,7,6,13,2018,2021,3,0.11,4.3,4.19,169,190,21,579,712,133,140.0,0.0,-140.0,24500000.0,6033333.0,-18466667.0
murpd105,Danny Murphy,Chicago Cubs,CUBS,6,9,11,20,1963,1968,5,-0.05,-1.18,-1.13,253,592,339,665,1006,341,220.0,727.0,507.0,0.0,33000.0,33000.0
murpd105,Danny Murphy,Houston Astros,ASTROS,1,3,1,4,1963,1964,1,0.82,1.37,0.55,136,133,-3,10,502,492,336.0,0.0,-336.0,0.0,0.0,0.0
murpd105,Danny Murphy,Chicago White Sox,WSOX,5,7,6,13,1971,1976,5,-2.36,0.03,2.39,667,792,125,1044,1819,775,489.0,881.0,392.0,27000.0,17000.0,-10000.0
murpe102,Eddie Murphy,Baltimore,Baltimore,2,3,5,8,1912,1914,2,9.51,0.0,-9.51,886,0,-886,3679,0,-3679,0.0,0.0,0.0,0.0,0.0,0.0
murpj001,John Ryan Murphy,New York Yankees,YANKS,1,1,1,2,2015,2015,0,-0.53,0.0,0.53,26,0,-26,90,0,-90,0.0,0.0,0.0,518700.0,0.0,-518700.0
murpj001,John Ryan Murphy,Minnesota Twins,TWINS,1,1,1,2,2017,2019,2,-0.48,0.14,0.62,119,43,-76,299,0,-299,9.0,128.0,119.0,0.0,0.0,0.0
murpj103,Johnny Murphy,StPaul,StPaul,1,2,5,7,1931,1932,1,15.3,0.0,-15.3,992,0,-992,1098,0,-1098,2971.0,0.0,-2971.0,0.0,19500.0,19500.0
murpm101,Morgan Murphy,Cincinnati Reds,REDS,4,11,5,16,1895,1906,11,8.81,24.47,15.66,1114,1079,-35,4520,3525,-995,393.0,2208.0,1815.0,1500.0,0.0,-1500.0
murpm101,Morgan Murphy,St. Louis Cardinals,CARDS,1,1,1,2,1897,1899,2,-0.06,0.64,0.7,5,89,84,18,320,302,0.0,0.0,0.0,0.0,0.0,0.0
murpr001,Rob Murphy,Cincinnati Reds,REDS,2,3,4,7,1988,1991,3,5.15,-2.88,-8.03,374,383,9,948,1386,438,486.0,0.0,-486.0,1340000.0,220000.0,-1120000.0
murpr001,Rob Murphy,Boston Red Sox,RSOX,2,3,2,5,1991,1993,2,0.62,0.09,-0.53,106,123,17,5,239,234,258.0,782.0,524.0,177000.0,2600000.0,2423000.0
murpt002,Tom Murphy,San Francisco Giants,GIANTS,1,1,1,2,2019,2019,0,3.56,0.0,-3.56,175,0,-175,606,0,-606,9.0,0.0,-9.0,0.0,0.0,0.0
murpt101,Tom Murphy,California Angels,ANGELS,3,3,4,7,1972,1978,6,0.67,2.83,2.16,48,493,445,39,1512,1473,211.0,370.0,159.0,55000.0,27500.0,-27500.0
murpt101,Tom Murphy,Kansas City Royals,ROYALS,1,1,1,2,1973,1973,0,0.89,0.0,-0.89,38,0,-38,27,0,-27,266.0,0.0,-266.0,0.0,0.0,0.0
murpt101,Tom Murphy,St. Louis Cardinals,CARDS,3,3,3,6,1973,1976,3,2.97,-0.18,-3.15,208,36,-172,184,81,-103,641.0,0.0,-641.0,34000.0,12500.0,-21500.0
murpt101,Tom Murphy,Milwaukee Brewers,BREWRS,2,4,2,6,1976,1976,0,3.64,0.57,-3.07,542,69,-473,1808,219,-1589,335.0,0.0,-335.0,150000.0,0.0,-150000.0
murrd001,Dale Murray,Montreal Expos,NATEX,2,3,3,6,1976,1979,3,-2.11,6.75,8.86,198,572,374,45,1769,1724,656.0,260.0,-396.0,0.0,0.0,0.0
murrd001,Dale Murray,Cincinnati Reds,REDS,1,1,1,2,1978,1979,1,-0.76,-1.12,-0.36,222,74,-148,17,182,165,550.0,0.0,-550.0,0.0,0.0,0.0
murrd001,Dale Murray,Toronto Blue Jays,BJAYS,3,7,7,14,1982,1997,15,19.48,55.53,36.05,1330,2691,1361,5190,10864,5674,360.0,453.0,93.0,3600000.0,2906667.0,-693333.0
murrd002,Dan Murray,New York Mets,METS,12,25,27,52,1999,2021,22,23.9,25.99,2.09,988,1828,840,1624,4624,3000,6089.0,4666.0,-1423.0,30731467.0,4325000.0,-26406467.0
murre001,Eddie Murray,Baltimore Orioles,ORLS,5,6,7,13,1988,1993,5,13.19,1.07,-12.12,985,444,-541,3313,1296,-2017,944.0,523.0,-421.0,3292904.0,1760000.0,-1532904.0
murre001,Eddie Murray,Cleveland Indians,INDINS,1,1,1,2,1996,1996,0,0.17,0.32,0.15,64,10,-54,263,0,-263,0.0,35.0,35.0,2000000.0,2825000.0,825000.0
murrg001,Glenn Murray,Montreal Expos,NATEX,1,1,1,2,1994,1994,0,0.0,0.0,0.0,0,0,0,0,0,0,0.0,0.0,0.0,0.0,0.0,0.0
murrg001,Glenn Murray,Boston Red Sox,RSOX,2,4,5,9,1996,2011,15,0.04,46.15,46.11,391,2084,1693,170,5862,5692,732.0,3501.0,2769.0,2300000.0,0.0,-2300000.0
murrg101,George Murray,New York Yankees,YANKS,1,4,1,5,1923,1934,11,-1.25,33.68,34.93,272,692,420,598,908,310,765.0,6610.0,5845.0,0.0,0.0,0.0
murrg101,George Murray,Boston Braves,BRAVES,2,5,2,7,1933,1940,7,0.0,7.42,7.42,0,397,397,0,764,764,0.0,2031.0,2031.0,0.0,0.0,0.0
murrj102,Joe Murray,New York Yankees,YANKS,1,4,1,5,1947,1947,0,0.0,0.0,0.0,0,0,0,0,0,0,0.0,0.0,0.0,0.0,0.0,0.0
murrl101,Larry Murray,New York Yankees,YANKS,1,3,1,4,1977,1977,0,-3.76,2.42,6.18,344,31,-313,885,0,-885,78.0,651.0,573.0,0.0,100000.0,100000.0
murrm001,Matt Murray,Atlanta Braves,BRAVES,2,3,3,6,1995,1997,2,1.44,0.0,-1.44,84,28,-56,0,58,58,245.0,0.0,-245.0,1500000.0,750000.0,-750000.0
murrr102,Ray Murray,Cleveland Indians,INDINS,1,3,1,4,1951,1951,0,2.32,1.96,-0.36,252,108,-144,644,24,-620,610.0,338.0,-272.0,0.0,15200.0,15200.0
murrr103,Red Murray,St. Louis Cardinals,CARDS,1,3,1,4,1908,1912,4,13.84,10.02,-3.82,1179,290,-889,3934,993,-2941,1350.0,10.0,-1340.0,0.0,0.0,0.0
murtd101,Danny Murtaugh,Boston Braves,BRAVES,3,8,5,13,1947,1952,5,11.92,5.66,-6.26,840,490,-350,2908,1370,-1538,0.0,414.0,414.0,0.0,0.0,0.0
murtm001,Matt Murton,Boston Red Sox,RSOX,2,4,3,7,2004,2005,1,6.28,1.43,-4.85,500,107,-393,1716,367,-1349,0.0,0.0,0.0,11500000.0,0.0,-11500000.0
murtm001,Matt Murton,Chicago Cubs,CUBS,1,4,2,6,2008,2009,1,13.08,4.54,-8.54,545,124,-421,2047,74,-1973,213.0,718.0,505.0,0.0,6525000.0,6525000.0
murtm001,Matt Murton,Oakland Athletics,ATLTCS,5,6,5,11,2009,2014,5,3.4,5.86,2.46,381,341,-40,607,854,247,434.0,601.0,167.0,3675000.0,3200000.0,-475000.0
muset101,Tony Muser,Boston Red Sox,RSOX,1,2,2,4,1971,1971,0,2.81,0.28,-2.53,456,91,-365,786,331,-455,371.0,0.0,-371.0,0.0,0.0,0.0
muset101,Tony Muser,Chicago White Sox,WSOX,1,1,1,2,1975,1976,1,-1.06,-2.47,-1.41,336,41,-295,581,0,-581,0.0,510.0,510.0,0.0,0.0,0.0
musgj001,Joe Musgrove,Toronto Blue Jays,BJAYS,4,12,6,18,2012,2016,4,10.83,2.99,-7.84,1068,309,-759,3494,605,-2889,904.0,1431.0,527.0,11237500.0,12316000.0,1078500.0
musgj001,Joe Musgrove,Houston Astros,ASTROS,1,4,1,5,2018,2019,1,3.26,12.09,8.83,813,71,-742,1676,16,-1660,1316.0,1238.0,-78.0,0.0,0.0,0.0
musgj001,Joe Musgrove,Pittsburgh Pirates,PIRATS,1,1,5,6,2021,2021,0,3.49,2.1,-1.39,68,119,51,57,1,-56,544.0,182.0,-362.0,0.0,0.0,0.0
mussj001,Jeff Musselman,Toronto Blue Jays,BJAYS,1,2,1,3,1989,1991,2,-0.46,1.54,2.0,96,287,191,2,1134,1132,175.0,0.0,-175.0,200000.0,1000000.0,800000.0
mussr001,Ron Musselman,Seattle Mariners,MARNRS,2,2,2,4,1982,1984,2,-0.7,-0.23,0.47,14,208,194,43,686,643,0.0,0.0,0.0,280000.0,0.0,-280000.0
mussr001,Ron Musselman,Minnesota Twins,TWINS,1,1,1,2,1987,1987,0,0.0,0.0,0.0,0,0,0,0,0,0,0.0,0.0,0.0,0.0,0.0,0.0
myatg101,Glenn Myatt,Philadelphia Athletics,ATLTCS,1,5,1,6,1922,1929,7,0.0,12.22,12.22,0,592,592,0,2318,2318,0.0,0.0,0.0,0.0,0.0,0.0
myatg101,Glenn Myatt,Milwaukee,Milwaukee,1,1,5,6,1922,1938,16,5.93,0.0,-5.93,850,0,-850,2604,0,-2604,0.0,0.0,0.0,0.0,0.0,0.0
myatg101,Glenn Myatt,Montreal,Montreal,1,1,0,1,1936,1936,0,-0.36,0.0,0.36,27,0,-27,89,0,-89,0.0,0.0,0.0,0.0,0.0,0.0
myerb001,Brett Myers,Houston Astros,ASTROS,1,2,3,5,2012,2020,8,0.83,4.38,3.55,35,242,207,0,1,1,104.0,927.0,823.0,0.0,0.0,0.0
myerb101,Billy Myers,New York Giants,GIANTS,1,2,2,4,1934,1943,9,13.89,0.64,-13.25,714,229,-485,2652,503,-2149,0.0,264.0,264.0,0.0,13500.0,13500.0
myerb101,Billy Myers,Cincinnati Reds,REDS,2,2,3,5,1940,1942,2,0.14,0.55,0.41,24,242,218,74,956,882,0.0,0.0,0.0,9500.0,0.0,-9500.0
myerb102,Bert Myers,St. Louis Cardinals,CARDS,3,5,6,11,1897,1899,2,11.69,3.06,-8.63,688,394,-294,2803,1695,-1108,0.0,0.0,0.0,0.0,0.0,0.0
myerb103,Buddy Myer,Washington Senators,TWINS,1,1,1,2,1927,1927,0,6.06,0.71,-5.35,280,45,-235,1161,157,-1004,0.0,0.0,0.0,6000.0,8000.0,2000.0
myerb103,Buddy Myer,Boston Red Sox,RSOX,6,12,13,25,1928,1945,17,68.04,54.79,-13.25,3392,1677,-1715,12887,3868,-9019,4146.0,8828.0,4682.0,58000.0,71500.0,13500.0
myere101,Elmer Myers,Philadelphia Athletics,ATLTCS,2,5,4,9,1919,1920,1,39.26,1.89,-37.37,2383,166,-2217,9666,676,-8990,678.0,0.0,-678.0,2400.0,0.0,-2400.0
myerg001,Greg Myers,Toronto Blue Jays,BJAYS,1,2,1,3,1992,1993,1,0.36,1.7,1.34,277,77,-200,834,0,-834,0.0,311.0,311.0,725000.0,1805000.0,1080000.0
myerg001,Greg Myers,Minnesota Twins,TWINS,1,1,1,2,1997,1997,0,0.09,0.0,-0.09,43,0,-43,96,0,-96,0.0,0.0,0.0,575000.0,0.0,-575000.0
myerg001,Greg Myers,San Diego Padres,PADRS,1,1,1,2,1999,1999,0,0.21,0.0,-0.21,34,0,-34,86,0,-86,0.0,0.0,0.0,850000.0,0.0,-850000.0
myerh101,Hap Myers,Boston Red Sox,RSOX,9,25,23,48,1912,1935,23,51.77,27.05,-24.72,3792,3039,-753,15081,11185,-3896,0.0,1203.0,1203.0,45050.0,29350.0,-15700.0
myerh102,Hi Myers,Brooklyn Dodgers,DOGRS,1,2,1,3,1923,1926,3,0.02,18.82,18.8,141,519,378,488,2176,1688,0.0,0.0,0.0,0.0,0.0,0.0
myerm001,Mike Myers,Florida Marlins,MARLNS,1,1,1,2,1995,1995,0,-0.09,-0.36,-0.27,186,28,-158,0,0,0,374.0,45.0,-329.0,109000.0,190000.0,81000.0
myerm001,Mike Myers,Detroit Tigers,TIGRS,3,5,3,8,1997,2009,12,-1.75,6.44,8.19,380,244,-136,75,32,-43,652.0,3275.0,2623.0,4485000.0,215000.0,-4270000.0
myerm001,Mike Myers,Milwaukee Brewers,BREWRS,3,3,4,7,1999,2006,7,4.5,4.26,-0.24,345,551,206,0,86,86,381.0,1411.0,1030.0,4842000.0,4450000.0,-392000.0
myerm001,Mike Myers,Colorado Rockies,ROCKS,2,2,3,5,2002,2006,4,1.19,-0.89,-2.08,286,214,-72,85,616,531,220.0,0.0,-220.0,0.0,0.0,0.0
myerm001,Mike Myers,St. Louis Cardinals,CARDS,1,1,2,3,2005,2005,0,1.03,0.0,-1.03,68,0,-68,0,0,0,112.0,0.0,-112.0,0.0,0.0,0.0
myerr001,Randy Myers,New York Mets,METS,1,2,2,4,1989,2004,15,4.69,11.0,6.31,316,1372,1056,62,15,-47,932.0,2108.0,1176.0,300000.0,1067500.0,767500.0
myerr001,Randy Myers,Cincinnati Reds,REDS,1,1,2,3,1991,1993,2,-1.3,4.78,6.08,174,230,56,8,937,929,282.0,0.0,-282.0,2000000.0,675000.0,-1325000.0
myerr001,Randy Myers,Toronto Blue Jays,BJAYS,1,1,1,2,1998,1998,0,-0.33,0.0,0.33,42,0,-42,0,0,0,43.0,0.0,-43.0,4416667.0,0.0,-4416667.0
myerr002,Rodney Myers,Chicago Cubs,CUBS,1,1,1,2,2000,2001,1,-1.1,-0.01,1.09,104,186,82,3,477,474,212.0,0.0,-212.0,0.0,0.0,0.0
myerr101,Richie Myers,Sacramento,Sacramento,1,2,3,5,1955,1959,4,0.4,0.0,-0.4,56,0,-56,37,0,-37,317.0,0.0,-317.0,0.0,0.0,0.0
myerw001,Wil Myers,Kansas City Royals,ROYALS,3,6,5,11,2012,2021,9,12.05,17.51,5.46,480,779,299,994,1767,773,2270.0,2321.0,51.0,16050000.0,12652767.0,-3397233.0
myerw001,Wil Myers,Tampa Bay Devil Rays,RAYS,4,8,12,20,2014,2020,6,10.52,4.14,-6.38,1388,617,-771,4818,2218,-2600,195.0,136.0,-59.0,3254200.0,506400.0,-2747800.0
myeta001,Aaron Myette,Chicago White Sox,WSOX,1,2,1,3,2000,2002,2,-2.48,2.74,5.22,35,247,212,0,861,861,387.0,0.0,-387.0,200000.0,4500000.0,4300000.0
myeta001,Aaron Myette,Texas Rangers,RNGRS,3,7,7,14,2002,2007,5,52.47,11.45,-41.02,2261,315,-1946,8496,371,-8125,1660.0,2044.0,384.0,0.0,1294000.0,1294000.0
myeta001,Aaron Myette,Cleveland Indians,INDINS,1,1,1,2,2003,2003,0,0.0,0.0,0.0,0,0,0,0,0,0,0.0,0.0,0.0,307500.0,0.0,-307500.0
myrib101,Bob Myrick,New York Mets,METS,1,2,1,3,1979,1979,0,0.0,-1.27,-1.27,0,34,34,0,28,28,0.0,255.0,255.0,0.0,0.0,0.0
myrob001,Brian Myrow,New York Yankees,YANKS,1,1,1,2,2004,2006,2,0.01,0.61,0.6,19,117,98,25,3,-22,0.0,498.0,498.0,0.0,0.0,0.0
nabhc001,Chris Nabholz,Montreal Expos,NATEX,1,1,2,3,1994,1995,1,-0.65,-0.08,0.57,6,8,2,0,0,0,33.0,12.0,-21.0,0.0,0.0,0.0
nabhc001,Chris Nabholz,Cleveland Indians,INDINS,1,2,1,3,1994,1994,0,-0.23,-0.01,0.22,19,13,-6,0,0,0,165.0,38.0,-127.0,1850000.0,2975000.0,1125000.0
naboj101,Jack Nabors,Philadelphia Athletics,ATLTCS,1,2,1,3,1917,1917,0,0.0,-1.12,-1.12,0,30,30,0,29,29,0.0,242.0,242.0,0.0,0.0,0.0
nadyx001,Xavier Nady,San Diego Padres,PADRS,1,1,1,2,2005,2007,2,0.61,7.59,6.98,75,292,217,292,1285,993,0.0,0.0,0.0,488000.0,7333333.0,6845333.0
nadyx001,Xavier Nady,New York Mets,METS,1,1,2,3,2006,2011,5,2.89,1.45,-1.44,269,242,-27,1050,179,-871,0.0,1622.0,1622.0,427000.0,4650000.0,4223000.0
nadyx001,Xavier Nady,Pittsburgh Pirates,PIRATS,2,3,6,9,2008,2016,8,0.52,7.02,6.5,146,1139,993,276,2174,1898,148.0,3210.0,3062.0,9500000.0,391425.0,-9108575.0
nageb101,Bill Nagel,Chicago White Sox,WSOX,1,3,1,4,1943,1943,0,0.0,0.0,0.0,0,0,0,0,0,0,0.0,0.0,0.0,8600.0,0.0,-8600.0
nageb101,Bill Nagel,Milwaukee,Milwaukee,1,1,1,2,1944,1944,0,-0.85,0.0,0.85,67,0,-67,241,0,-241,0.0,0.0,0.0,0.0,0.0,0.0
nager101,Russ Nagelson,Cleveland Indians,INDINS,1,2,1,3,1970,1970,0,-0.16,-0.64,-0.48,28,86,58,38,9,-29,0.0,173.0,173.0,8070.0,0.0,-8070.0
nagym101,Mike Nagy,Boston Red Sox,RSOX,1,1,1,2,1973,1973,0,-0.07,0.0,0.07,18,0,-18,11,0,-11,122.0,0.0,-122.0,0.0,0.0,0.0
nagym101,Mike Nagy,St. Louis Cardinals,CARDS,1,2,1,3,1973,1974,1,0.06,-0.23,-0.29,25,42,17,0,9,9,187.0,127.0,-60.0,0.0,0.0,0.0
nagym101,Mike Nagy,Texas Rangers,RNGRS,3,7,4,11,1973,1978,5,27.61,17.12,-10.49,555,168,-387,197,0,-197,7626.0,3555.0,-4071.0,60000.0,160000.0,100000.0
nagym101,Mike Nagy,St. Louis Cardinals,CARDS,1,1,1,2,1973,1974,1,-0.56,0.0,0.56,18,0,-18,1,0,-1,38.0,0.0,-38.0,0.0,0.0,0.0
nagys101,Steve Nagy,Washington Senators,TWINS,1,1,1,2,1950,1950,0,0.0,0.3,0.3,0,42,42,0,8,8,0.0,109.0,109.0,0.0,0.0,0.0
nagys101,Steve Nagy,Pittsburgh Pirates,PIRATS,2,4,2,6,1948,1956,8,-0.28,3.82,4.1,38,374,336,9,242,233,117.0,2170.0,2053.0,0.0,0.0,0.0
nahes101,Sam Nahem,Brooklyn Dodgers,DOGRS,1,5,2,7,1940,1946,6,2.24,22.24,20.0,200,770,570,485,2187,1702,487.0,3020.0,2533.0,0.0,0.0,0.0
nahob001,Bill Nahorodny,Chicago White Sox,WSOX,1,1,1,2,1979,1979,0,-0.03,0.0,0.03,73,0,-73,181,0,-181,0.0,0.0,0.0,0.0,0.0,0.0
nancs001,Shane Nance,Los Angeles Dodgers,DOGRS,1,2,2,4,2002,2003,1,-0.76,-0.63,0.13,70,35,-35,11,67,56,164.0,0.0,-164.0,0.0,1625000.0,1625000.0
nancs001,Shane Nance,Milwaukee Brewers,BREWRS,6,12,13,25,2003,2012,9,37.27,23.81,-13.46,2463,1970,-493,9279,4716,-4563,883.0,6330.0,5447.0,8747000.0,19975667.0,11228667.0
napod101,Danny Napoleon,New York Mets,METS,2,4,4,8,1967,1969,2,-0.9,-0.52,0.38,52,197,145,76,651,575,0.0,0.0,0.0,0.0,0.0,0.0
napom001,Mike Napoli,Anaheim Angels,ANGELS,2,3,3,6,2011,2013,2,-0.32,-0.07,0.25,200,208,8,733,791,58,0.0,0.0,0.0,0.0,0.0,0.0
napom001,Mike Napoli,Toronto Blue Jays,BJAYS,1,1,1,2,2011,2011,0,7.43,1.11,-6.32,380,58,-322,1425,0,-1425,0.0,152.0,152.0,0.0,0.0,0.0
napom001,Mike Napoli,Boston Red Sox,RSOX,1,2,1,3,2015,2015,0,0.14,0.0,-0.14,159,0,-159,576,0,-576,0.0,0.0,0.0,16000000.0,0.0,-16000000.0
narah101,Hal Naragon,Cleveland Indians,INDINS,1,2,1,3,1959,1960,1,-2.61,0.95,3.56,330,49,-281,541,143,-398,528.0,0.0,-528.0,0.0,0.0,0.0
narlb101,Bill Narleski,Boston Red Sox,RSOX,2,6,4,10,1930,1937,7,1.87,7.56,5.69,361,744,383,1356,1842,486,119.0,1357.0,1238.0,15100.0,31000.0,15900.0
narlr101,Ray Narleski,Cleveland Indians,INDINS,4,8,7,15,1958,1965,7,18.0,1.46,-16.54,1595,479,-1116,4009,1716,-2293,3556.0,132.0,-3424.0,7500.0,10500.0,3000.0
narrj001,Jerry Narron,New York Yankees,YANKS,7,17,13,30,1979,1992,13,39.2,19.95,-19.25,2768,1137,-1631,6569,3883,-2686,8301.0,701.0,-7600.0,913333.0,1745000.0,831667.0
narub101,Buster Narum,Baltimore Orioles,ORLS,2,2,2,4,1964,1966,2,-1.06,0.23,1.29,184,8,-176,136,13,-123,1163.0,0.0,-1163.0,0.0,0.0,0.0
narub101,Buster Narum,Washington Senators,RNGRS,12,27,21,48,1968,1988,20,46.51,51.95,5.44,2991,4295,1304,9420,12528,3108,3885.0,6824.0,2939.0,527000.0,241500.0,-285500.0
narvc001,Chris Narveson,St. Louis Cardinals,CARDS,1,3,1,4,2004,2005,1,0.0,3.28,3.28,0,144,144,0,545,545,0.0,0.0,0.0,0.0,12666667.0,12666667.0
narvc001,Chris Narveson,Colorado Rockies,ROCKS,2,3,3,6,2005,2007,2,-0.15,1.77,1.92,44,250,206,39,105,66,329.0,1085.0,756.0,2500000.0,3600000.0,1100000.0
narvo001,Omar Narvaez,Chicago White Sox,WSOX,1,1,1,2,2018,2020,2,2.23,2.06,-0.17,132,88,-44,482,0,-482,0.0,250.0,250.0,560000.0,0.0,-560000.0
narvo001,Omar Narvaez,Seattle Mariners,MARNRS,1,1,2,3,2019,2019,0,1.34,0.0,-1.34,163,0,-163,571,0,-571,0.0,0.0,0.0,581200.0,0.0,-581200.0
nashb101,Billy Nash,Boston Braves,BRAVES,1,1,1,2,1895,1902,7,2.12,23.74,21.62,189,690,501,760,3208,2448,0.0,0.0,0.0,0.0,0.0,0.0
nashc101,Cotton Nash,California Angels,ANGELS,1,2,1,3,1967,1967,0,-0.11,-0.88,-0.77,3,62,59,4,131,127,0.0,0.0,0.0,0.0,36000.0,36000.0
nashc101,Cotton Nash,Chicago White Sox,WSOX,1,1,1,2,1969,1969,0,0.0,0.0,0.0,0,0,0,0,0,0,0.0,0.0,0.0,0.0,0.0,0.0
nashc101,Cotton Nash,Chicago White Sox,WSOX,1,1,1,2,1969,1970,1,0.07,0.19,0.12,10,64,54,15,26,11,0.0,273.0,273.0,0.0,0.0,0.0
nashj101,Jim Nash,Oakland Athletics,ATLTCS,4,7,5,12,1969,1972,3,1.75,3.32,1.57,627,294,-333,1441,825,-616,1443.0,159.0,-1284.0,54250.0,96000.0,41750.0
nashj101,Jim Nash,Atlanta Braves,BRAVES,2,3,3,6,1972,1973,1,3.67,-1.47,-5.14,307,93,-214,995,16,-979,168.0,108.0,-60.0,0.0,0.0,0.0
nastp101,Phil Nastu,San Francisco Giants,GIANTS,5,7,8,15,1980,1986,6,-0.94,5.74,6.68,341,455,114,825,812,-13,372.0,2489.0,2117.0,552000.0,0.0,-552000.0
nathj001,Joe Nathan,San Francisco Giants,GIANTS,1,3,2,5,2003,2004,1,27.51,0.25,-27.26,760,131,-629,32,510,478,4915.0,0.0,-4915.0,300000.0,365000.0,65000.0
natij001,Joey Nation,Atlanta Braves,BRAVES,1,3,2,5,1999,2000,1,-3.84,1.92,5.76,68,186,118,50,245,195,440.0,651.0,211.0,0.0,5325000.0,5325000.0
naugp001,Packy Naughton,Cincinnati Reds,REDS,1,2,1,3,2020,2020,0,-0.21,-0.49,-0.28,9,20,11,1,55,54,68.0,0.0,-68.0,0.0,2200000.0,2200000.0
nauld001,Dan Naulty,Minnesota Twins,TWINS,1,1,1,2,1998,1998,0,0.58,0.0,-0.58,36,0,-36,0,0,0,148.0,0.0,-148.0,185000.0,0.0,-185000.0
nauld001,Dan Naulty,New York Yankees,YANKS,1,1,1,2,1999,1999,0,0.0,0.0,0.0,0,0,0,0,0,0,0.0,0.0,0.0,300000.0,0.0,-300000.0
navad001,Dioner Navarro,New York Yankees,YANKS,5,14,10,24,2005,2012,7,13.28,19.25,5.97,1549,974,-575,2912,2867,-45,5079.0,1808.0,-3271.0,1556425.0,9100000.0,7543575.0
navad001,Dioner Navarro,Arizona Diamondbacks,DBACKS,2,6,2,8,2005,2009,4,0.95,0.24,-0.71,303,273,-30,1104,1118,14,0.0,0.0,0.0,10213898.0,0.0,-10213898.0
navad001,Dioner Navarro,Los Angeles Dodgers,DOGRS,1,3,3,6,2006,2007,1,1.99,-0.07,-2.06,586,130,-456,1881,113,-1768,426.0,593.0,167.0,682000.0,4200000.0,3518000.0
navad001,Dioner Navarro,Chicago White Sox,WSOX,1,1,1,2,2016,2016,0,-0.17,0.0,0.17,16,0,-16,36,0,-36,0.0,0.0,0.0,0.0,0.0,0.0
navad002,Daniel Nava,Anaheim Angels,ANGELS,1,1,1,2,2016,2016,0,-0.12,0.0,0.12,9,0,-9,12,0,-12,0.0,0.0,0.0,0.0,0.0,0.0
navaj001,Jaime Navarro,Chicago White Sox,WSOX,1,2,2,4,2000,2004,4,-2.6,18.62,21.22,55,696,641,47,2756,2709,437.0,354.0,-83.0,0.0,0.0,0.0
navaj101,Julio Navarro,Los Angeles Angels,ANGELS,2,2,2,4,1964,1966,2,-1.19,2.44,3.63,140,359,219,90,1087,997,228.0,95.0,-133.0,28500.0,9500.0,-19000.0
navaj101,Julio Navarro,Detroit Tigers,TIGRS,1,2,2,4,1966,1970,4,1.01,15.29,14.28,93,323,230,284,412,128,0.0,2887.0,2887.0,0.0,0.0,0.0
navaj101,Julio Navarro,Boston Red Sox,RSOX,1,2,2,4,1966,1967,1,-0.2,0.0,0.2,68,0,-68,16,0,-16,197.0,0.0,-197.0,0.0,0.0,0.0
navar001,Rey Navarro,Arizona Diamondbacks,DBACKS,1,1,1,2,2010,2011,1,0.0,0.06,0.06,0,44,44,0,0,0,0.0,60.0,60.0,0.0,0.0,0.0
navay001,Yamaico Navarro,Boston Red Sox,RSOX,2,3,3,6,2011,2012,1,0.07,2.71,2.64,6,174,168,26,653,627,0.0,0.0,0.0,1200000.0,640000.0,-560000.0
navay001,Yamaico Navarro,Pittsburgh Pirates,PIRATS,1,1,1,2,2012,2012,0,0.15,0.0,-0.15,8,0,-8,31,0,-31,0.0,0.0,0.0,483000.0,0.0,-483000.0
navay001,Yamaico Navarro,Kansas City Royals,ROYALS,2,2,3,5,2011,2016,5,-0.55,-0.58,-0.03,40,13,-27,56,0,-56,31.0,38.0,7.0,0.0,0.0,0.0
nayle101,Earl Naylor,Philadelphia Phillies,PHILS,3,4,6,10,1943,1946,3,9.8,8.3,-1.5,880,637,-243,3396,2656,-740,0.0,0.0,0.0,0.0,0.0,0.0
naylj001,Josh Naylor,Miami Marlins,MARLNS,3,8,6,14,2016,2019,3,12.29,-0.08,-12.37,540,354,-186,600,126,-474,2851.0,1392.0,-1459.0,550000.0,7660200.0,7110200.0
naylj001,Josh Naylor,San Diego Padres,PADRS,2,7,4,11,2020,2021,1,3.34,0.62,-2.72,311,5,-306,892,4,-888,493.0,57.0,-436.0,3000000.0,4100000.0,1100000.0
naylr101,Rollie Naylor,Philadelphia Athletics,ATLTCS,1,3,1,4,1924,1927,3,0.0,4.07,4.07,0,425,425,0,1818,1818,0.0,0.0,0.0,12000.0,0.0,-12000.0
neagd001,Denny Neagle,Minnesota Twins,TWINS,1,2,1,3,1992,1992,0,7.13,5.07,-2.06,551,34,-517,733,0,-733,2091.0,723.0,-1368.0,0.0,0.0,0.0
neagd001,Denny Neagle,Pittsburgh Pirates,PIRATS,2,3,5,8,1996,2006,10,29.65,7.0,-22.65,505,530,25,727,585,-142,4656.0,3240.0,-1416.0,7350000.0,421500.0,-6928500.0
neagd001,Denny Neagle,Atlanta Braves,BRAVES,2,6,5,11,1998,2002,4,23.0,11.12,-11.88,1472,1098,-374,4934,1979,-2955,1246.0,898.0,-348.0,12520000.0,11751680.0,-768320.0
neagd001,Denny Neagle,Cincinnati Reds,REDS,3,5,7,12,2000,2013,13,-0.66,18.6,19.26,193,851,658,524,1522,998,274.0,5192.0,4918.0,4750000.0,0.0,-4750000.0
nealb001,Blaine Neal,Florida Marlins,MARLNS,1,1,1,2,2004,2005,1,0.26,-0.35,-0.61,79,60,-19,0,3,3,126.0,113.0,-13.0,0.0,0.0,0.0
nealb001,Blaine Neal,San Diego Padres,PADRS,2,2,2,4,2005,2007,2,0.0,-0.35,-0.35,20,119,99,18,28,10,24.0,165.0,141.0,375000.0,0.0,-375000.0
nealc101,Charlie Neal,Los Angeles Dodgers,DOGRS,1,2,2,4,1961,1964,3,2.26,0.33,-1.93,344,161,-183,877,245,-632,336.0,0.0,-336.0,26000.0,0.0,-26000.0
nealc101,Charlie Neal,New York Mets,METS,3,5,4,9,1963,1970,7,0.13,2.94,2.81,256,564,308,368,1104,736,516.0,1427.0,911.0,0.0,26000.0,26000.0
nealg101,Greasy Neale,Cincinnati Reds,REDS,1,2,1,3,1920,1920,0,12.54,0.0,-12.54,460,0,-460,635,0,-635,4385.0,0.0,-4385.0,11000.0,5000.0,-6000.0
nealt001,Thomas Neal,San Francisco Giants,GIANTS,1,1,1,2,2011,2011,0,-0.32,-0.03,0.29,9,39,30,24,133,109,0.0,0.0,0.0,0.0,1000000.0,1000000.0
nealz001,Zach Neal,Los Angeles Dodgers,DOGRS,1,2,1,3,2018,2018,0,0.0,0.0,0.0,0,0,0,0,0,0,0.0,0.0,0.0,0.0,0.0,0.0
nealz001,Zach Neal,Cincinnati Reds,REDS,1,3,2,5,2018,2018,0,1.09,0.0,-1.09,176,0,-176,2,0,-2,299.0,0.0,-299.0,0.0,0.0,0.0
needt101,Tom Needham,Boston Braves,BRAVES,2,4,6,10,1907,1911,4,19.52,11.83,-7.69,821,855,34,3252,2714,-538,0.0,1733.0,1733.0,0.0,0.0,0.0
needt101,Tom Needham,StPaul,StPaul,1,1,1,2,1909,1909,0,0.4,0.0,-0.4,133,0,-133,367,0,-367,0.0,0.0,0.0,0.0,0.0,0.0
neelt001,Troy Neel,Cleveland Indians,INDINS,1,1,1,2,1991,1991,0,3.73,0.0,-3.73,230,0,-230,861,0,-861,0.0,0.0,0.0,0.0,0.0,0.0
neemc101,Cal Neeman,Chicago Cubs,CUBS,17,29,28,57,1960,1982,22,71.82,137.22,65.4,4054,6789,2735,10993,16906,5913,10563.0,17980.0,7417.0,552500.0,88500.0,-464000.0
neemc101,Cal Neeman,Pittsburgh Pirates,PIRATS,2,3,2,5,1963,1965,2,0.03,0.41,0.38,287,60,-227,312,157,-155,304.0,0.0,-304.0,0.0,0.0,0.0
negrk001,Kristopher Negron,Boston Red Sox,RSOX,1,1,2,3,2009,2009,0,1.65,0.3,-1.35,96,44,-52,270,159,-111,0.0,0.0,0.0,0.0,5375000.0,5375000.0
negrk001,Kristopher Negron,Seattle Mariners,MARNRS,1,1,1,2,2019,2019,0,0.14,0.0,-0.14,30,0,-30,57,0,-57,0.0,0.0,0.0,0.0,0.0,0.0
negrr101,Ron Negray,Brooklyn Dodgers,DOGRS,1,1,2,3,1955,1955,0,1.27,0.0,-1.27,116,0,-116,36,0,-36,415.0,0.0,-415.0,0.0,0.0,0.0
negrr101,Ron Negray,Philadelphia Phillies,PHILS,2,8,4,12,1957,1962,5,1.07,-3.22,-4.29,707,621,-86,1985,2063,78,115.0,0.0,-115.0,9000.0,0.0,-9000.0
nehfa101,Art Nehf,Boston Braves,BRAVES,10,19,22,41,1919,1938,19,31.15,38.82,7.67,2310,4271,1961,5947,14932,8985,8433.0,4626.0,-3807.0,58026.0,50512.0,-7514.0
neibg101,Gary Neibauer,Atlanta Braves,BRAVES,2,3,3,6,1972,1973,1,3.67,-1.47,-5.14,307,93,-214,995,16,-979,168.0,108.0,-60.0,0.0,0.0,0.0
neidj001,Jim Neidlinger,Pittsburgh Pirates,PIRATS,1,1,1,2,1988,1989,1,1.19,0.0,-1.19,24,0,-24,27,0,-27,222.0,0.0,-222.0,0.0,0.0,0.0
neidn001,Nick Neidert,Seattle Mariners,MARNRS,1,3,2,5,2017,2020,3,-0.89,1.81,2.7,38,291,253,23,1091,1068,267.0,0.0,-267.0,0.0,7800000.0,7800000.0
neilt101,Tommy Neill,Boston Braves,BRAVES,1,3,1,4,1948,1952,4,0.0,-0.21,-0.21,0,104,104,0,35,35,0.0,376.0,376.0,0.0,0.0,0.0
neisb101,Bernie Neis,Brooklyn Dodgers,DOGRS,4,10,4,14,1925,1934,9,1.75,8.14,6.39,236,915,679,602,3320,2718,677.0,0.0,-677.0,30000.0,12000.0,-18000.0
nelsb001,Bry Nelson,Arizona Diamondbacks,DBACKS,1,1,1,2,2001,2001,0,0.0,0.0,0.0,0,0,0,0,0,0,0.0,0.0,0.0,0.0,0.0,0.0
nelsd101,Dave Nelson,Cleveland Indians,INDINS,5,8,7,15,1969,1974,5,5.0,-0.41,-5.41,1218,311,-907,2882,450,-2432,1036.0,482.0,-554.0,104000.0,86000.0,-18000.0
nelsd101,Dave Nelson,Texas Rangers,RNGRS,1,1,1,2,1975,1977,2,-0.07,3.4,3.47,105,60,-45,226,0,-226,0.0,955.0,955.0,0.0,0.0,0.0
nelsg001,Gene Nelson,Texas Rangers,RNGRS,1,4,4,8,1979,1985,6,12.8,8.35,-4.45,488,521,33,1323,2076,753,918.0,0.0,-918.0,475000.0,133333.0,-341667.0
nelsg001,Gene Nelson,New York Yankees,YANKS,3,6,4,10,1982,1987,5,15.14,5.21,-9.93,593,176,-417,734,188,-546,3682.0,1574.0,-2108.0,62500.0,700000.0,637500.0
nelsg001,Gene Nelson,Seattle Mariners,MARNRS,1,2,1,3,1984,1985,1,2.78,0.75,-2.03,163,36,-127,1,0,-1,1149.0,444.0,-705.0,0.0,200000.0,200000.0
nelsg001,Gene Nelson,Chicago White Sox,WSOX,1,2,1,3,1986,1989,3,3.34,0.37,-2.97,291,194,-97,0,702,702,1471.0,0.0,-1471.0,240000.0,218200.0,-21800.0
nelsj001,Jeff Nelson,Seattle Mariners,MARNRS,3,7,5,12,1995,1999,4,28.82,-1.18,-30.0,1743,533,-1210,4473,1676,-2797,3491.0,1076.0,-2415.0,2835000.0,1944000.0,-891000.0
nelsj001,Jeff Nelson,Seattle Mariners,MARNRS,1,1,1,2,2003,2003,0,0.18,0.32,0.14,24,15,-9,0,0,0,53.0,43.0,-10.0,3983333.0,0.0,-3983333.0
nelsl101,Lynn Nelson,Memphis,Memphis,1,1,4,5,1937,1939,2,6.28,0.0,-6.28,278,0,-278,321,0,-321,1514.0,0.0,-1514.0,0.0,0.0,0.0
nelsm101,Mel Nelson,St. Louis Cardinals,CARDS,1,2,1,3,1969,1969,0,0.0,0.0,0.0,0,0,0,0,0,0,0.0,0.0,0.0,0.0,0.0,0.0
nelsn001,Nick Nelson,New York Yankees,YANKS,1,2,2,4,2021,2021,0,0.0,0.0,0.0,0,0,0,0,0,0,0.0,0.0,0.0,0.0,0.0,0.0
nelsr001,Ricky Nelson,Seattle Mariners,MARNRS,1,1,1,2,1986,1986,0,0.0,0.0,0.0,0,0,0,0,0,0,0.0,0.0,0.0,0.0,0.0,0.0
nelsr001,Ricky Nelson,New York Mets,METS,1,1,1,2,1987,1987,0,0.0,-0.25,-0.25,0,10,10,0,5,5,0.0,65.0,65.0,0.0,0.0,0.0
nelsr002,Rob Nelson,Oakland Athletics,ATLTCS,1,2,1,3,1987,1989,2,0.04,3.46,3.42,202,69,-133,145,0,-145,296.0,1204.0,908.0,73133.0,605000.0,531867.0
nelsr101,Roger Nelson,Chicago White Sox,WSOX,6,9,10,19,1967,1977,10,29.24,13.29,-15.95,1920,1924,4,6795,7037,242,306.0,62.0,-244.0,134800.0,182000.0,47200.0
nelsr101,Roger Nelson,Kansas City Royals,ROYALS,2,3,3,6,1972,1986,14,0.89,27.33,26.44,85,1835,1750,116,7325,7209,420.0,179.0,-241.0,31000.0,41000.0,10000.0
nelsr103,Rocky Nelson,St. Louis Cardinals,CARDS,1,2,1,3,1951,1952,1,2.13,0.47,-1.66,381,51,-330,862,202,-660,20.0,0.0,-20.0,0.0,0.0,0.0
nelsr103,Rocky Nelson,Chicago White Sox,WSOX,31,58,57,115,1951,1971,20,64.42,124.88,60.46,7701,8470,769,20774,20512,-262,7158.0,13944.0,6786.0,248750.0,225500.0,-23250.0
nelsr103,Rocky Nelson,Brooklyn Dodgers,DOGRS,1,1,2,3,1953,1953,0,-0.16,0.0,0.16,4,0,-4,4,0,-4,0.0,0.0,0.0,0.0,0.0,0.0
nelsr103,Rocky Nelson,St. Louis Cardinals,CARDS,1,3,1,4,1957,1960,3,0.0,-0.55,-0.55,0,36,36,0,11,11,0.0,110.0,110.0,0.0,0.0,0.0
nelst101,Tommy Nelson,Milwaukee,Milwaukee,1,2,2,4,1944,1945,1,2.0,0.0,-2.0,395,0,-395,1542,0,-1542,0.0,0.0,0.0,0.0,0.0,0.0
nen-d101,Dick Nen,Los Angeles Dodgers,DOGRS,4,12,9,21,1964,1984,20,57.0,60.48,3.48,4290,2463,-1827,14544,7259,-7285,4034.0,7191.0,3157.0,163000.0,22000.0,-141000.0
nen-r001,Robb Nen,Texas Rangers,RNGRS,1,2,1,3,1993,1994,1,2.51,0.73,-1.78,607,75,-532,25,0,-25,1163.0,273.0,-890.0,109000.0,725000.0,616000.0
nen-r001,Robb Nen,Florida Marlins,MARLNS,1,1,3,4,1997,1997,0,10.35,0.0,-10.35,712,0,-712,6,0,-6,1135.0,0.0,-1135.0,3080000.0,0.0,-3080000.0
neshp001,Pat Neshek,Houston Astros,ASTROS,1,1,1,2,2016,2016,0,2.83,0.0,-2.83,183,0,-183,0,0,0,248.0,0.0,-248.0,6500000.0,0.0,-6500000.0
neshp001,Pat Neshek,Philadelphia Phillies,PHILS,1,1,3,4,2017,2017,0,0.69,0.0,-0.69,53,0,-53,0,0,0,66.0,0.0,-66.0,6500000.0,0.0,-6500000.0
nessj101,Jack Ness,Detroit Tigers,TIGRS,1,2,1,3,1911,1915,4,0.0,0.64,0.64,0,95,95,0,385,385,0.0,0.0,0.0,0.0,0.0,0.0
nettg001,Graig Nettles,Minnesota Twins,TWINS,2,5,4,9,1969,1971,2,19.42,3.86,-15.56,887,264,-623,3069,67,-3002,587.0,852.0,265.0,120000.0,70000.0,-50000.0
nettg001,Graig Nettles,Cleveland Indians,INDINS,6,9,10,19,1972,1984,12,43.46,8.37,-35.09,2118,2287,169,7743,7713,-30,0.0,317.0,317.0,82750.0,271600.0,188850.0
nettg001,Graig Nettles,New York Yankees,YANKS,2,2,3,5,1984,1987,3,5.7,5.8,0.1,423,111,-312,1418,0,-1418,305.0,1936.0,1631.0,175000.0,900000.0,725000.0
nettj101,Jim Nettles,Minnesota Twins,TWINS,1,1,1,2,1973,1973,0,0.28,0.0,-0.28,43,0,-43,159,0,-159,0.0,0.0,0.0,0.0,0.0,0.0
nettm101,Morris Nettles,California Angels,ANGELS,2,3,4,7,1975,1977,2,-0.12,-0.47,-0.35,328,122,-206,1247,392,-855,0.0,18.0,18.0,0.0,0.0,0.0
neu-m001,Michael Neu,Oakland Athletics,ATLTCS,6,10,8,18,2003,2017,14,-1.4,14.82,16.22,291,1017,726,344,2748,2404,719.0,1374.0,655.0,18058194.0,10721429.0,-7336765.0
neumd101,Dan Neumeier,Chicago White Sox,WSOX,1,1,1,2,1973,1975,2,0.0,0.0,0.0,0,0,0,0,0,0,0.0,0.0,0.0,0.0,16000.0,16000.0
neuss001,Sheldon Neuse,Washington Nationals,NATEX,2,4,3,7,2017,2020,3,5.92,4.82,-1.1,246,410,164,62,3,-59,883.0,620.0,-263.0,8230366.0,0.0,-8230366.0
neuss001,Sheldon Neuse,Oakland Athletics,ATLTCS,1,2,2,4,2021,2021,0,-0.48,-0.38,0.1,33,13,-20,66,0,-66,0.0,27.0,27.0,0.0,0.0,0.0
nevee102,Ernie Nevel,New York Yankees,YANKS,1,5,1,6,1952,1955,3,5.35,0.52,-4.83,390,26,-364,1419,10,-1409,46.0,107.0,61.0,0.0,13500.0,13500.0
nevee102,Ernie Nevel,Detroit Tigers,TIGRS,5,14,10,24,1954,1961,7,12.9,0.88,-12.02,615,749,134,406,2092,1686,3228.0,40.0,-3188.0,13200.0,8000.0,-5200.0
nevip001,Phil Nevin,Houston Astros,ASTROS,1,1,1,2,1995,1995,0,0.07,0.49,0.42,160,42,-118,518,0,-518,0.0,63.0,63.0,109000.0,4833334.0,4724334.0
nevip001,Phil Nevin,Detroit Tigers,TIGRS,1,2,1,3,1997,1997,0,-0.94,0.0,0.94,337,0,-337,1117,0,-1117,0.0,0.0,0.0,728000.0,0.0,-728000.0
nevip001,Phil Nevin,Anaheim Angels,ANGELS,1,2,2,4,1999,1999,0,17.78,-1.12,-18.9,806,87,-719,3297,269,-3028,0.0,0.0,0.0,0.0,0.0,0.0
nevip001,Phil Nevin,San Diego Padres,PADRS,1,1,2,3,2005,2006,1,-0.87,-0.78,0.09,75,68,-7,307,66,-241,0.0,547.0,547.0,9625000.0,15000000.0,5375000.0
nevip001,Phil Nevin,Texas Rangers,RNGRS,1,2,1,3,2006,2007,1,0.09,-0.23,-0.32,67,136,69,197,284,87,0.0,0.0,0.0,10472409.0,2300000.0,-8172409.0
nevip001,Phil Nevin,Chicago Cubs,CUBS,1,2,1,3,2006,2006,0,-0.1,0.0,0.1,16,0,-16,54,0,-54,0.0,0.0,0.0,0.0,0.0,0.0
nevit001,Tyler Nevin,Colorado Rockies,ROCKS,2,4,3,7,2020,2021,1,0.45,0.91,0.46,52,72,20,18,0,-18,64.0,117.0,53.0,4050000.0,3225000.0,-825000.0
newcd101,Don Newcombe,Los Angeles Dodgers,DOGRS,1,1,4,5,1958,1961,3,9.64,0.85,-8.79,190,265,75,233,151,-82,1314.0,590.0,-724.0,30000.0,14000.0,-16000.0
newcs001,Sean Newcomb,Anaheim Angels,ANGELS,1,4,2,6,2015,2020,5,2.92,20.49,17.57,366,607,241,466,2409,1943,1135.0,0.0,-1135.0,8500000.0,3000000.0,-5500000.0
newfm001,Marc Newfield,Seattle Mariners,MARNRS,1,2,2,4,1995,1995,0,0.73,0.19,-0.54,185,12,-173,270,0,-270,132.0,189.0,57.0,224000.0,3400000.0,3176000.0
newfm001,Marc Newfield,San Diego Padres,PADRS,4,10,10,20,1996,2006,10,7.75,31.03,23.28,1053,1823,770,3065,7183,4118,514.0,4.0,-510.0,9096680.0,13525000.0,4428320.0
newhd001,David Newhan,Oakland Athletics,ATLTCS,3,5,4,9,1997,2006,9,-1.08,-1.24,-0.16,199,140,-59,175,236,61,192.0,0.0,-192.0,392000.0,633333.0,241333.0
newhd001,David Newhan,San Diego Padres,PADRS,1,1,1,2,2000,2000,0,0.11,-0.07,-0.18,17,45,28,27,189,162,0.0,0.0,0.0,203000.0,345000.0,142000.0
newkf101,Floyd Newkirk,New York Yankees,YANKS,1,5,1,6,1934,1934,0,0.0,0.0,0.0,0,0,0,0,0,0,0.0,0.0,0.0,2000.0,0.0,-2000.0
newma001,Al Newman,Montreal Expos,NATEX,2,3,3,6,1983,1986,3,0.47,0.58,0.11,75,208,133,0,9,9,360.0,362.0,2.0,513500.0,570000.0,56500.0
newma001,Al Newman,San Diego Padres,PADRS,1,1,1,2,1984,1985,1,-0.67,0.44,1.11,120,38,-82,244,8,-236,0.0,110.0,110.0,0.0,0.0,0.0
newma001,Al Newman,Montreal Expos,NATEX,1,1,1,2,1987,1987,0,2.06,0.0,-2.06,618,0,-618,1876,0,-1876,0.0,0.0,0.0,0.0,0.0,0.0
newma002,Alan Newman,Minnesota Twins,TWINS,1,2,1,3,1993,1993,0,0.0,0.0,0.0,0,0,0,0,0,0,0.0,0.0,0.0,0.0,0.0,0.0
newmj001,Jeff Newman,Oakland Athletics,ATLTCS,2,3,4,7,1982,1991,9,1.92,23.98,22.06,609,1229,620,2373,4812,2439,0.0,48.0,48.0,0.0,440000.0,440000.0
newmr101,Ray Newman,Chicago Cubs,CUBS,1,1,2,3,1972,1972,0,0.87,0.0,-0.87,19,0,-19,1,0,-1,76.0,0.0,-76.0,0.0,0.0,0.0
newmr101,Ray Newman,Milwaukee Brewers,BREWRS,1,1,1,2,1973,1974,1,0.0,0.0,0.0,0,0,0,0,0,0,0.0,0.0,0.0,0.0,0.0,0.0
newsb101,Bobo Newsom,Washington Senators,TWINS,3,4,5,9,1937,1942,5,10.77,13.4,2.63,718,1031,313,2678,3529,851,623.0,1269.0,646.0,39500.0,26000.0,-13500.0
newsb101,Bobo Newsom,Boston Red Sox,RSOX,1,3,1,4,1937,1940,3,5.49,2.22,-3.27,408,291,-117,1388,1330,-58,1283.0,0.0,-1283.0,4000.0,12000.0,8000.0
newsb101,Bobo Newsom,St.Louis Browns,ORLS,6,10,14,24,1939,1952,13,23.39,27.61,4.22,1164,2723,1559,2963,7190,4227,3417.0,6493.0,3076.0,67500.0,49800.0,-17700.0
newsb101,Bobo Newsom,Brooklyn Dodgers,DOGRS,2,4,3,7,1943,1946,3,-1.79,7.1,8.89,24,273,249,16,997,981,162.0,207.0,45.0,15000.0,12000.0,-3000.0
newsb101,Bobo Newsom,Washington Senators,TWINS,2,2,2,4,1943,1947,4,7.32,4.34,-2.98,242,210,-32,242,289,47,2049.0,1581.0,-468.0,15000.0,5000.0,-10000.0
newss101,Skeeter Newsome,Philadelphia Phillies,PHILS,1,1,2,3,1940,1940,0,4.64,0.0,-4.64,497,0,-497,1845,0,-1845,0.0,0.0,0.0,0.0,0.0,0.0
newsw001,Warren Newson,San Diego Padres,PADRS,2,4,3,7,1991,1994,3,4.76,-1.77,-6.53,685,201,-484,2072,489,-1583,0.0,199.0,199.0,130000.0,0.0,-130000.0
newsw001,Warren Newson,Chicago White Sox,WSOX,1,1,1,2,1995,1997,2,0.36,0.71,0.35,33,38,5,88,0,-88,0.0,133.0,133.0,200000.0,0.0,-200000.0
niarg101,Gus Niarhos,Chicago White Sox,WSOX,2,6,4,10,1951,1963,12,1.43,25.02,23.59,363,1422,1059,910,5079,4169,614.0,0.0,-614.0,0.0,0.0,0.0
niarg101,Gus Niarhos,St.Louis Browns,ORLS,3,5,5,10,1951,1956,5,0.5,2.1,1.6,348,405,57,823,914,91,0.0,256.0,256.0,0.0,20000.0,20000.0
nicaj001,Juan Nicasio,Colorado Rockies,ROCKS,1,1,1,2,2014,2019,5,0.28,-1.35,-1.63,105,76,-29,1,155,154,175.0,0.0,-175.0,2025000.0,0.0,-2025000.0
nicaj001,Juan Nicasio,Philadelphia Phillies,PHILS,1,1,1,2,2017,2017,0,0.44,0.0,-0.44,18,0,-18,1,0,-1,33.0,0.0,-33.0,0.0,0.0,0.0
nicaj001,Juan Nicasio,Seattle Mariners,MARNRS,3,7,5,12,2018,2019,1,12.9,2.05,-10.85,683,65,-618,2542,289,-2253,142.0,0.0,-142.0,17350000.0,37545833.0,20195833.0
nichb001,Brett Nicholas,Texas Rangers,RNGRS,2,3,3,6,2018,2020,2,2.79,0.96,-1.83,113,23,-90,120,0,-120,209.0,73.0,-136.0,1400000.0,17000000.0,15600000.0
nichb101,Bill Nicholson,Chicago Cubs,CUBS,5,9,8,17,1948,1958,10,14.64,25.44,10.8,1431,1747,316,4282,6565,2283,130.0,197.0,67.0,0.0,10000.0,10000.0
nichb101,Bill Nicholson,Philadelphia Athletics,ATLTCS,2,3,2,5,1938,1944,6,0.0,1.46,1.46,0,597,597,0,2016,2016,0.0,0.0,0.0,6000.0,0.0,-6000.0
nichc001,Carl Nichols,Baltimore Orioles,ORLS,1,1,2,3,1989,1991,2,-0.34,0.47,0.81,60,66,6,130,0,-130,0.0,1060.0,1060.0,0.0,0.0,0.0
nichd101,Dave Nicholson,Baltimore Orioles,ORLS,4,10,7,17,1963,1973,10,64.06,37.52,-26.54,3307,1677,-1630,9685,6745,-2940,2176.0,306.0,-1870.0,108500.0,40300.0,-68200.0
nichd101,Dave Nicholson,Chicago White Sox,WSOX,1,2,3,5,1965,1967,2,2.05,-0.33,-2.38,164,74,-90,481,40,-441,0.0,379.0,379.0,13000.0,0.0,-13000.0
nichd101,Dave Nicholson,Houston Astros,ASTROS,4,6,8,14,1966,1973,7,0.01,-1.36,-1.37,310,801,491,266,544,278,544.0,2019.0,1475.0,57500.0,75500.0,18000.0
nichd102,Dolan Nichols,Cleveland Indians,INDINS,1,1,1,2,1957,1957,0,-0.48,-0.32,0.16,48,10,-38,5,1,-4,124.0,21.0,-103.0,0.0,0.0,0.0
nichf101,Fred Nicholson,Pittsburgh Pirates,PIRATS,5,10,8,18,1921,1932,11,20.59,54.57,33.98,2344,1948,-396,9152,7061,-2091,1307.0,3847.0,2540.0,22300.0,13500.0,-8800.0
nichr001,Reid Nichols,Boston Red Sox,RSOX,1,1,1,2,1985,1987,2,0.29,-0.43,-0.72,125,50,-75,286,2,-284,0.0,330.0,330.0,260000.0,463000.0,203000.0
nichs101,Simon Nicholls,Philadelphia Athletics,ATLTCS,1,1,1,2,1909,1910,1,0.0,0.0,0.0,3,0,-3,0,0,0,0.0,0.0,0.0,0.0,0.0,0.0
nickd001,Doug Nickle,Anaheim Angels,ANGELS,1,1,1,2,1998,1998,0,-0.13,0.36,0.49,19,19,0,1,72,71,27.0,0.0,-27.0,0.0,6000000.0,6000000.0
nickd001,Doug Nickle,Philadelphia Phillies,PHILS,2,4,5,9,2002,2005,3,45.06,10.26,-34.8,1293,547,-746,5556,1575,-3981,0.0,264.0,264.0,13200000.0,12025000.0,-1175000.0
nickd001,Doug Nickle,Anaheim Angels,ANGELS,1,2,3,5,2003,2006,3,0.32,0.04,-0.28,41,21,-20,2,0,-2,416.0,90.0,-326.0,1425000.0,330000.0,-1095000.0
nickm001,Mike Nickeas,Texas Rangers,RNGRS,1,1,1,2,2006,2007,1,-0.93,0.26,1.19,73,37,-36,191,108,-83,0.0,0.0,0.0,0.0,335000.0,335000.0
nickm001,Mike Nickeas,New York Mets,METS,5,10,9,19,2012,2021,9,5.89,21.61,15.72,446,1069,623,898,3007,2109,2473.0,2300.0,-173.0,18229800.0,3500000.0,-14729800.0
nicog101,George Nicol,Pittsburgh Pirates,PIRATS,1,2,1,3,1894,1894,0,-0.65,0.82,1.47,30,26,-4,117,52,-65,51.0,335.0,284.0,0.0,0.0,0.0
nicoh101,Hugh Nicol,St.Louis Cardinals,CARDS,1,1,2,3,1886,1898,12,1.51,1.15,-0.36,432,379,-53,1926,1510,-416,0.0,0.0,0.0,1800.0,0.0,-1800.0
nicoj001,Justin Nicolino,Toronto Blue Jays,BJAYS,3,15,11,26,2012,2018,6,24.75,21.38,-3.37,2099,1087,-1012,5739,3162,-2577,4668.0,4579.0,-89.0,8732900.0,43179800.0,34446900.0
nicos001,Steve Nicosia,Pittsburgh Pirates,PIRATS,1,1,2,3,1983,1984,1,0.32,-0.33,-0.65,63,57,-6,181,120,-61,0.0,0.0,0.0,0.0,280000.0,280000.0
niedt001,Tom Niedenfuer,Los Angeles Dodgers,DOGRS,1,1,2,3,1987,1990,3,0.79,3.02,2.23,97,473,376,0,1461,1461,334.0,135.0,-199.0,731250.0,300000.0,-431250.0
nieha101,Al Niehaus,Chicago Cubs,CUBS,1,3,3,6,1924,1926,2,29.39,2.01,-27.38,1120,155,-965,4097,410,-3687,1929.0,802.0,-1127.0,13500.0,18700.0,5200.0
nieha101,Al Niehaus,Pittsburgh Pirates,PIRATS,1,1,1,2,1925,1925,0,0.21,0.98,0.77,51,47,-4,164,21,-143,0.0,172.0,172.0,3600.0,0.0,-3600.0
nieha101,Al Niehaus,Cincinnati Reds,REDS,1,2,1,3,1925,1925,0,0.0,0.0,0.0,0,0,0,0,0,0,0.0,0.0,0.0,0.0,0.0,0.0
niehb101,Bert Niehoff,Cincinnati Reds,REDS,1,1,1,2,1915,1915,0,3.34,-0.14,-3.48,408,10,-398,1592,33,-1559,0.0,0.0,0.0,0.0,0.0,0.0
niehb101,Bert Niehoff,Philadelphia Phillies,PHILS,1,2,1,3,1918,1918,0,-0.43,0.37,0.8,22,46,24,90,41,-49,0.0,338.0,338.0,0.0,0.0,0.0
niehd101,Dick Niehaus,StPaul,StPaul,1,2,1,3,1920,1920,0,0.73,0.0,-0.73,38,0,-38,11,0,-11,127.0,0.0,-127.0,0.0,0.0,0.0
niehd101,Dick Niehaus,Cleveland Indians,INDINS,1,3,1,4,1920,1922,2,0.0,4.21,4.21,0,138,138,0,140,140,0.0,1087.0,1087.0,0.0,0.0,0.0
niekj001,Joe Niekro,Chicago Cubs,CUBS,3,6,4,10,1969,1974,5,4.19,2.65,-1.54,1200,512,-688,1393,950,-443,2550.0,898.0,-1652.0,19000.0,24000.0,5000.0
niekj001,Joe Niekro,San Diego Padres,PADRS,5,6,9,15,1969,1978,9,9.09,3.38,-5.71,399,1422,1023,375,4203,3828,2914.0,1444.0,-1470.0,35500.0,54000.0,18500.0
niekj001,Joe Niekro,Houston Astros,ASTROS,1,1,3,4,1985,1991,6,0.05,10.61,10.56,36,363,327,0,398,398,566.0,3306.0,2740.0,825000.0,0.0,-825000.0
niekj001,Joe Niekro,New York Yankees,YANKS,3,5,4,9,1987,1989,2,5.79,-1.58,-7.37,806,113,-693,2351,144,-2207,918.0,729.0,-189.0,1022000.0,1140000.0,118000.0
niekp001,Phil Niekro,Cleveland Indians,INDINS,1,1,2,3,1987,1987,0,-0.32,-0.49,-0.17,3,21,18,0,0,0,36.0,119.0,83.0,0.0,71500.0,71500.0
nielj001,Jerry Nielsen,New York Yankees,YANKS,1,3,1,4,1992,1994,2,-1.97,3.42,5.39,549,56,-493,1984,0,-1984,509.0,1123.0,614.0,0.0,1850000.0,1850000.0
niels001,Scott Nielsen,Seattle Mariners,MARNRS,1,2,1,3,1984,1985,1,0.07,-0.68,-0.75,20,79,59,0,235,235,229.0,0.0,-229.0,0.0,0.0,0.0
niels001,Scott Nielsen,New York Yankees,YANKS,1,2,2,4,1987,1995,8,-0.86,11.75,12.61,19,665,646,0,2177,2177,199.0,66.0,-133.0,0.0,0.0,0.0
niels001,Scott Nielsen,Chicago White Sox,WSOX,3,5,7,12,1987,1997,10,-1.68,12.63,14.31,132,1505,1373,105,4423,4318,928.0,727.0,-201.0,1340000.0,247000.0,-1093000.0
niels001,Scott Nielsen,New York Yankees,YANKS,1,1,1,2,1989,1989,0,0.0,-0.46,-0.46,0,10,10,0,14,14,0.0,0.0,0.0,0.0,0.0,0.0
niema101,Al Niemiec,Boston Red Sox,RSOX,7,17,15,32,1936,1956,20,19.89,33.66,13.77,2712,2773,61,8706,8806,100,4863.0,6247.0,1384.0,147000.0,69122.0,-77878.0
niema101,Al Niemiec,Boston Red Sox,RSOX,1,4,1,5,1937,1937,0,0.0,0.0,0.0,0,0,0,0,0,0,0.0,0.0,0.0,3000.0,0.0,-3000.0
niemb101,Bob Nieman,St.Louis Browns,ORLS,23,54,54,108,1952,1988,36,77.35,153.48,76.13,5159,9163,4004,10679,26116,15437,18423.0,15654.0,-2769.0,825833.0,138400.0,-687433.0
niemb101,Bob Nieman,Detroit Tigers,TIGRS,6,11,11,22,1954,1964,10,2.44,17.09,14.65,689,625,-64,1873,996,-877,460.0,3101.0,2641.0,37500.0,0.0,-37500.0
niemb101,Bob Nieman,Chicago White Sox,WSOX,2,5,3,8,1956,1961,5,20.82,6.19,-14.63,1000,561,-439,2990,1443,-1547,2136.0,479.0,-1657.0,62000.0,42500.0,-19500.0
niemb101,Bob Nieman,Baltimore Orioles,ORLS,1,1,2,3,1959,1960,1,1.14,-0.1,-1.24,87,1,-86,232,4,-228,0.0,0.0,0.0,0.0,0.0,0.0
niemb101,Bob Nieman,St. Louis Cardinals,CARDS,1,1,3,4,1961,1962,1,0.7,0.0,-0.7,41,0,-41,74,0,-74,0.0,0.0,0.0,0.0,0.0,0.0
niemr001,Randy Niemann,New York Yankees,YANKS,2,4,2,6,1977,1979,2,-0.57,3.2,3.77,493,187,-306,951,449,-502,300.0,202.0,-98.0,0.0,0.0,0.0
niemr001,Randy Niemann,Houston Astros,ASTROS,2,4,2,6,1981,1987,6,18.26,12.31,-5.95,1057,753,-304,4016,2821,-1195,147.0,0.0,-147.0,450000.0,0.0,-450000.0
niemr001,Randy Niemann,Pittsburgh Pirates,PIRATS,1,1,2,3,1983,1983,0,0.15,0.0,-0.15,5,7,2,0,0,0,16.0,0.0,-16.0,0.0,0.0,0.0
niemr001,Randy Niemann,Chicago White Sox,WSOX,1,1,2,3,1985,1985,0,0.33,0.0,-0.33,70,0,-70,7,0,-7,121.0,0.0,-121.0,0.0,0.0,0.0
niesj001,Jon Niese,New York Mets,METS,2,3,2,5,2015,2019,4,0.99,3.46,2.47,82,192,110,182,757,575,330.0,7.0,-323.0,24200000.0,8000000.0,-16200000.0
niesj001,Jon Niese,Pittsburgh Pirates,PIRATS,1,1,2,3,2016,2017,1,-0.56,-0.74,-0.18,11,73,62,1,1,0,33.0,99.0,66.0,0.0,0.0,0.0
niett001,Tom Nieto,St. Louis Cardinals,CARDS,2,2,2,4,1986,1987,1,0.8,0.35,-0.45,350,133,-217,991,33,-958,0.0,290.0,290.0,0.0,0.0,0.0
niett001,Tom Nieto,Montreal Expos,NATEX,9,14,16,30,1987,1996,9,5.9,1.65,-4.25,1311,1101,-210,2173,1393,-780,2901.0,1691.0,-1210.0,955000.0,1022500.0,67500.0
niett001,Tom Nieto,Minnesota Twins,TWINS,1,3,2,5,1988,1989,1,2.78,0.41,-2.37,304,27,-277,1185,0,-1185,0.0,435.0,435.0,103500.0,900000.0,796500.0
nievj002,Jose Nieves,Chicago Cubs,CUBS,2,2,3,5,2001,2001,0,0.57,0.08,-0.49,94,30,-64,159,2,-157,161.0,45.0,-116.0,240000.0,0.0,-240000.0
nievm001,Melvin Nieves,Atlanta Braves,BRAVES,1,3,1,4,1993,1997,4,-0.25,11.08,11.33,189,636,447,337,2705,2368,105.0,0.0,-105.0,0.0,4300000.0,4300000.0
nievm001,Melvin Nieves,San Diego Padres,PADRS,2,4,4,8,1996,1998,2,1.67,-1.26,-2.93,549,225,-324,1460,118,-1342,1084.0,637.0,-447.0,0.0,0.0,0.0
nievm001,Melvin Nieves,Detroit Tigers,TIGRS,6,16,11,27,1997,2002,5,8.91,7.34,-1.57,2198,844,-1354,4138,2268,-1870,1884.0,1349.0,-535.0,8560000.0,6675000.0,-1885000.0
nievw001,Wil Nieves,Anaheim Angels,ANGELS,1,1,1,2,2005,2005,0,-0.56,0.04,0.6,35,3,-32,76,0,-76,0.0,9.0,9.0,0.0,0.0,0.0
niggj101,Johnny Niggeling,St.Louis Browns,ORLS,1,2,3,5,1943,1943,0,8.73,-0.17,-8.9,267,27,-240,710,82,-628,1415.0,18.0,-1397.0,19000.0,3000.0,-16000.0
nileh101,Harry Niles,St.Louis Browns,ORLS,1,3,3,6,1907,1907,0,6.22,0.0,-6.22,491,0,-491,1891,0,-1891,92.0,0.0,-92.0,0.0,0.0,0.0
nileh101,Harry Niles,New York Yankees,YANKS,2,3,3,6,1908,1911,3,25.79,7.0,-18.79,1708,396,-1312,6883,1614,-5269,0.0,0.0,0.0,0.0,0.0,0.0
nillr101,Rabbit Nill,Washington Senators,TWINS,1,1,2,3,1907,1907,0,-0.19,-0.05,0.14,23,39,16,74,151,77,0.0,0.0,0.0,0.0,0.0,0.0
nippa001,Al Nipper,Boston Red Sox,RSOX,2,3,2,5,1987,1992,5,5.91,6.0,0.09,700,548,-152,106,1578,1472,1775.0,506.0,-1269.0,1675000.0,2340000.0,665000.0
nippd001,Dustin Nippert,Arizona Diamondbacks,DBACKS,1,1,1,2,2008,2008,0,1.4,0.0,-1.4,80,0,-80,1,0,-1,594.0,0.0,-594.0,0.0,0.0,0.0
niscr101,Ron Nischwitz,Detroit Tigers,TIGRS,1,2,1,3,1962,1965,3,-0.2,-1.2,-1.0,38,174,136,3,601,598,79.0,0.0,-79.0,0.0,0.0,0.0
nitkc001,C.J. Nitkowski,Cincinnati Reds,REDS,3,5,4,9,1995,1998,3,1.13,-0.21,-1.34,524,176,-348,786,483,-303,1638.0,269.0,-1369.0,299000.0,2300667.0,2001667.0
nitkc001,C.J. Nitkowski,Detroit Tigers,TIGRS,5,12,14,26,1996,2010,14,13.89,24.32,10.43,4127,1434,-2693,10052,2196,-7856,4562.0,6757.0,2195.0,11529000.0,4780000.0,-6749000.0
nitkc001,C.J. Nitkowski,Houston Astros,ASTROS,1,2,5,7,1999,2001,2,6.68,0.38,-6.3,481,94,-387,1132,260,-872,710.0,103.0,-607.0,0.0,0.0,0.0
nitkc001,C.J. Nitkowski,Detroit Tigers,TIGRS,1,2,1,3,2001,2001,0,0.22,0.0,-0.22,10,0,-10,0,0,0,17.0,0.0,-17.0,1200000.0,0.0,-1200000.0
nivar001,Ramon Nivar,Texas Rangers,RNGRS,1,1,1,2,2005,2005,0,0.16,-0.55,-0.71,7,7,0,15,0,-15,0.0,38.0,38.0,0.0,0.0,0.0
nix-l001,Laynce Nix,Texas Rangers,RNGRS,1,4,2,6,2006,2013,7,2.6,12.97,10.37,354,855,501,502,3435,2933,270.0,0.0,-270.0,7270260.0,8500000.0,1229740.0
nixoa101,Al Nixon,Beaumont,Beaumont,1,1,2,3,1921,1921,0,-0.51,0.0,0.51,229,0,-229,841,0,-841,0.0,0.0,0.0,0.0,0.0,0.0
nixod001,Donell Nixon,Seattle Mariners,MARNRS,1,1,1,2,1988,1988,0,1.05,0.23,-0.82,154,39,-115,266,0,-266,0.0,94.0,94.0,0.0,0.0,0.0
nixoo001,Otis Nixon,New York Yankees,YANKS,3,5,5,10,1984,1985,1,4.69,0.8,-3.89,612,147,-465,1490,453,-1037,133.0,0.0,-133.0,435000.0,0.0,-435000.0
nixoo001,Otis Nixon,Montreal Expos,NATEX,1,2,2,4,1991,1993,2,8.18,0.0,-8.18,462,0,-462,1670,0,-1670,0.0,0.0,0.0,0.0,0.0,0.0
nixoo001,Otis Nixon,Boston Red Sox,RSOX,4,8,8,16,1994,2002,8,1.6,9.74,8.14,416,630,214,1358,1420,62,371.0,1801.0,1430.0,6625000.0,11675000.0,5050000.0
nixoo001,Otis Nixon,Toronto Blue Jays,BJAYS,1,1,1,2,1997,1997,0,0.16,0.0,-0.16,42,0,-42,191,0,-191,0.0,0.0,0.0,2500000.0,0.0,-2500000.0
nixor101,Russ Nixon,Cleveland Indians,INDINS,1,1,2,3,1960,1962,2,-1.37,0.0,1.37,499,0,-499,1450,0,-1450,0.0,0.0,0.0,0.0,0.0,0.0
nixor101,Russ Nixon,Cleveland Indians,INDINS,1,2,2,4,1960,1960,0,-2.2,-1.2,1.0,772,87,-685,2350,176,-2174,0.0,122.0,122.0,0.0,0.0,0.0
nixor101,Russ Nixon,Boston Red Sox,RSOX,2,5,3,8,1966,1966,0,-0.53,-0.7,-0.17,125,80,-45,299,29,-270,0.0,336.0,336.0,18500.0,0.0,-18500.0
noblr101,Ray Noble,Oakland,Oakland,1,3,5,8,1950,1951,1,-0.44,0.0,0.44,186,0,-186,308,0,-308,172.0,0.0,-172.0,0.0,0.0,0.0
noblr101,Ray Noble,Cincinnati Reds,REDS,1,1,1,2,1955,1955,0,0.0,0.0,0.0,0,0,0,0,0,0,0.0,0.0,0.0,0.0,7000.0,7000.0
noboj001,Junior Noboa,Cleveland Indians,INDINS,1,1,1,2,1988,1988,0,-0.33,0.0,0.33,21,0,-21,16,0,-16,0.0,0.0,0.0,0.0,0.0,0.0
nocep001,Paul Noce,San Diego Padres,PADRS,1,1,1,2,1984,1984,0,-0.24,0.0,0.24,70,0,-70,192,0,-192,0.0,0.0,0.0,0.0,0.0,0.0
nocep001,Paul Noce,Chicago Cubs,CUBS,1,1,1,2,1988,1988,0,0.0,0.0,0.0,0,0,0,0,0,0,0.0,0.0,0.0,0.0,0.0,0.0
noesh001,Hector Noesi,New York Yankees,YANKS,3,7,6,13,2012,2020,8,-1.73,11.1,12.83,260,478,218,802,248,-554,452.0,2363.0,1911.0,6150000.0,12535000.0,6385000.0
nogos001,Stephen Nogosek,Boston Red Sox,RSOX,1,3,1,4,2017,2017,0,-0.57,0.56,1.13,43,31,-12,1,0,-1,62.0,81.0,19.0,0.0,7750000.0,7750000.0
nokem001,Matt Nokes,San Francisco Giants,GIANTS,3,6,5,11,1985,1991,6,8.16,14.64,6.48,1129,850,-279,2301,1999,-302,2390.0,2023.0,-367.0,0.0,990000.0,990000.0
nokem001,Matt Nokes,Detroit Tigers,TIGRS,1,1,2,3,1990,1991,1,4.46,1.65,-2.81,452,34,-418,1510,0,-1510,0.0,242.0,242.0,650000.0,800000.0,150000.0
nolaa002,Austin Nola,Seattle Mariners,MARNRS,1,3,4,7,2020,2020,0,1.48,0.43,-1.05,218,41,-177,269,159,-110,200.0,0.0,-200.0,0.0,0.0,0.0
nolag101,Gary Nolan,Cincinnati Reds,REDS,1,1,1,2,1977,1977,0,-0.62,0.0,0.62,6,0,-6,0,0,0,55.0,0.0,-55.0,52000.0,0.0,-52000.0
nolaj001,Joe Nolan,New York Mets,METS,2,2,2,4,1975,1978,3,-0.77,-0.05,0.72,267,60,-207,635,148,-487,0.0,0.0,0.0,0.0,0.0,0.0
nolaj001,Joe Nolan,Cincinnati Reds,REDS,2,2,3,5,1982,1984,2,0.87,-0.67,-1.54,216,18,-198,563,41,-522,0.0,0.0,0.0,0.0,0.0,0.0
nolar001,Ricky Nolasco,Chicago Cubs,CUBS,1,3,1,4,2005,2006,1,14.84,1.99,-12.85,973,162,-811,493,750,257,4940.0,0.0,-4940.0,0.0,3700000.0,3700000.0
nolar001,Ricky Nolasco,Miami Marlins,MARLNS,1,2,3,5,2013,2015,2,0.91,0.0,-0.91,31,8,-23,30,0,-30,261.0,12.0,-249.0,0.0,0.0,0.0
nolar001,Ricky Nolasco,Minnesota Twins,TWINS,1,3,2,5,2016,2018,2,3.27,-0.15,-3.42,67,80,13,11,0,-11,1029.0,566.0,-463.0,0.0,0.0,0.0
noled001,Dickie Noles,Chicago Cubs,CUBS,1,1,1,2,1987,1987,0,0.07,0.0,-0.07,5,0,-5,0,0,0,6.0,0.0,-6.0,75000.0,0.0,-75000.0
noled001,Dickie Noles,Philadelphia Phillies,PHILS,3,8,5,13,1981,1988,7,16.51,17.82,1.31,2071,1049,-1022,4347,608,-3739,6629.0,2308.0,-4321.0,0.0,1330000.0,1330000.0
noled001,Dickie Noles,Chicago Cubs,CUBS,1,1,2,3,1984,1984,0,0.08,0.0,-0.08,46,0,-46,0,0,0,504.0,0.0,-504.0,0.0,0.0,0.0
nolis001,Sean Nolin,Toronto Blue Jays,BJAYS,2,6,2,8,2014,2018,4,6.54,19.48,12.94,350,462,112,887,2066,1179,1411.0,0.0,-1411.0,23516100.0,500000.0,-23016100.0
nomoh001,Hideo Nomo,Los Angeles Dodgers,DOGRS,3,6,6,12,1998,1999,1,0.28,3.05,2.77,258,110,-148,43,85,42,1690.0,777.0,-913.0,9633334.0,3500000.0,-6133334.0
noonp101,Pete Noonan,Chicago Cubs,CUBS,1,3,1,4,1906,1906,0,1.84,2.12,0.28,366,34,-332,716,57,-659,2561.0,440.0,-2121.0,0.0,0.0,0.0
nopsj101,Jerry Nops,Baltimore Orioles,BLN,1,2,1,3,1899,1906,7,-0.36,0.13,0.49,87,2,-85,281,8,-273,204.0,0.0,-204.0,0.0,0.0,0.0
norbj001,Jordan Norberto,Arizona Diamondbacks,DBACKS,2,3,3,6,2011,2016,5,1.57,7.2,5.63,125,680,555,165,7,-158,265.0,1007.0,742.0,0.0,1250000.0,1250000.0
nordt101,Tim Nordbrook,Toronto Blue Jays,BJAYS,1,1,1,2,1978,1979,1,-0.07,-0.35,-0.28,4,111,107,10,188,178,0.0,0.0,0.0,0.0,92500.0,92500.0
nordw101,Wayne Nordhagen,New York Yankees,YANKS,6,12,9,21,1973,1983,10,29.7,21.37,-8.33,2028,936,-1092,2549,2957,408,5698.0,1893.0,-3805.0,79000.0,458000.0,379000.0
nordw101,Wayne Nordhagen,Atlanta Braves,BRAVES,3,6,6,12,1975,1977,2,7.21,1.02,-6.19,424,370,-54,701,70,-631,842.0,1041.0,199.0,0.0,187000.0,187000.0
nordw101,Wayne Nordhagen,Philadelphia Phillies,PHILS,1,1,1,2,1976,1976,0,0.39,0.0,-0.39,408,0,-408,1262,0,-1262,6.0,0.0,-6.0,0.0,0.0,0.0
nordw101,Wayne Nordhagen,Chicago White Sox,WSOX,1,1,1,2,1982,1982,0,-1.26,0.28,1.54,72,118,46,197,277,80,0.0,0.0,0.0,0.0,0.0,0.0
nordw101,Wayne Nordhagen,Toronto Blue Jays,BJAYS,2,2,2,4,1982,1982,0,-0.62,-1.18,-0.56,39,75,36,86,205,119,0.0,0.0,0.0,0.0,160000.0,160000.0
nordw101,Wayne Nordhagen,Philadelphia Phillies,PHILS,1,1,1,2,1982,1983,1,0.04,-0.15,-0.19,1,45,44,4,86,82,0.0,0.0,0.0,0.0,0.0,0.0
nordw101,Wayne Nordhagen,Pittsburgh Pirates,PIRATS,1,1,1,2,1982,1983,1,-1.26,-0.62,0.64,72,39,-33,197,86,-111,0.0,0.0,0.0,0.0,0.0,0.0
norei101,Irv Noren,Washington Senators,TWINS,17,30,33,63,1952,1963,11,45.18,4.68,-40.5,3039,4336,1297,10601,11469,868,1213.0,4683.0,3470.0,38500.0,14000.0,-24500.0
norei101,Irv Noren,New York Yankees,YANKS,6,15,13,28,1957,1970,13,5.72,32.98,27.26,1633,2423,790,4235,5558,1323,2553.0,4978.0,2425.0,115500.0,43000.0,-72500.0
norei101,Irv Noren,St. Louis Cardinals,CARDS,1,1,1,2,1959,1959,0,1.9,0.02,-1.88,77,5,-72,186,8,-178,0.0,0.0,0.0,0.0,0.0,0.0
normd101,Dan Norman,Cincinnati Reds,REDS,3,6,5,11,1977,1990,13,13.19,18.54,5.35,1751,636,-1115,5361,1105,-4256,2918.0,3754.0,836.0,450000.0,287500.0,-162500.0
normd101,Dan Norman,New York Mets,METS,1,2,1,3,1981,1982,1,8.04,-0.11,-8.15,771,159,-612,125,526,401,1519.0,0.0,-1519.0,0.0,0.0,0.0
normf101,Fred Norman,Kansas City Athletics,ATLTCS,1,1,1,2,1963,1963,0,-0.74,0.0,0.74,22,0,-22,11,0,-11,110.0,0.0,-110.0,0.0,0.0,0.0
normf101,Fred Norman,Chicago Cubs,CUBS,1,1,1,2,1967,1967,0,-0.47,-0.13,0.34,60,2,-58,11,2,-9,186.0,13.0,-173.0,0.0,0.0,0.0
normf101,Fred Norman,St. Louis Cardinals,CARDS,5,6,5,11,1971,1976,5,12.13,1.76,-10.37,660,184,-476,1378,165,-1213,1880.0,841.0,-1039.0,34000.0,12500.0,-21500.0
normf101,Fred Norman,San Diego Padres,PADRS,2,2,4,6,1973,1977,4,11.55,2.33,-9.22,476,387,-89,523,651,128,3945.0,578.0,-3367.0,0.0,0.0,0.0
normn001,Nelson Norman,Pittsburgh Pirates,PIRATS,6,9,12,21,1977,1984,7,35.51,9.96,-25.55,1400,772,-628,4253,1476,-2777,2781.0,2392.0,-389.0,465000.0,140000.0,-325000.0
normn001,Nelson Norman,Texas Rangers,RNGRS,1,1,1,2,1982,1982,0,-0.08,0.0,0.08,3,0,-3,3,0,-3,0.0,0.0,0.0,0.0,0.0,0.0
normn001,Nelson Norman,Baltimore Orioles,ORLS,1,1,1,2,1985,1985,0,-0.2,0.0,0.2,1,0,-1,4,0,-4,0.0,0.0,0.0,0.0,0.0,0.0
norrb001,Bud Norris,Houston Astros,ASTROS,2,5,6,11,2013,2017,4,19.5,0.29,-19.21,1049,307,-742,1482,820,-662,2670.0,1153.0,-1517.0,0.0,512500.0,512500.0
norrb001,Bud Norris,Atlanta Braves,BRAVES,1,4,2,6,2016,2016,0,-0.57,0.0,0.57,26,0,-26,16,0,-16,128.0,0.0,-128.0,0.0,0.0,0.0
norrd001,Derek Norris,Washington Nationals,NATEX,2,6,4,10,2011,2018,7,12.32,19.68,7.36,414,407,-7,1035,430,-605,1666.0,3760.0,2094.0,12000000.0,420000.0,-11580000.0
norrd001,Derek Norris,Oakland Athletics,ATLTCS,2,5,5,10,2014,2019,5,3.37,0.99,-2.38,334,186,-148,1020,4,-1016,390.0,952.0,562.0,505000.0,0.0,-505000.0
norrd001,Derek Norris,San Diego Padres,PADRS,1,1,1,2,2016,2019,3,0.0,0.26,0.26,0,2,2,0,2,2,0.0,16.0,16.0,2925000.0,0.0,-2925000.0
norrd002,Daniel Norris,Toronto Blue Jays,BJAYS,1,3,1,4,2015,2015,0,13.77,2.5,-11.27,310,12,-298,26,4,-22,3733.0,223.0,-3510.0,508700.0,19750000.0,19241300.0
norrd002,Daniel Norris,Detroit Tigers,TIGRS,1,1,1,2,2021,2021,0,-0.35,0.0,0.35,34,0,-34,2,0,-2,61.0,0.0,-61.0,3475000.0,0.0,-3475000.0
norrj101,Jim Norris,Cleveland Indians,INDINS,1,2,3,5,1980,1980,0,-1.43,-0.55,0.88,119,28,-91,205,57,-148,0.0,0.0,0.0,0.0,0.0,0.0
norrl101,Leo Norris,Minneapolis,Minneapolis,1,1,1,2,1935,1936,1,-0.66,0.0,0.66,270,0,-270,1055,0,-1055,0.0,0.0,0.0,0.0,0.0,0.0
norta001,Aaron Northcraft,Atlanta Braves,BRAVES,2,4,6,10,2014,2019,5,3.78,1.55,-2.23,316,457,141,1233,1449,216,47.0,147.0,100.0,14250000.0,0.0,-14250000.0
nortb101,Bill North,Chicago Cubs,CUBS,4,4,4,8,1972,1978,6,20.43,3.49,-16.94,680,219,-461,2859,77,-2782,35.0,461.0,426.0,80000.0,59000.0,-21000.0
nortb101,Bill North,Oakland Athletics,ATLTCS,1,1,1,2,1978,1978,0,1.8,-0.59,-2.39,110,78,-32,377,217,-160,0.0,0.0,0.0,0.0,0.0,0.0
nortg001,Greg Norton,Seattle Mariners,MARNRS,1,1,1,2,2008,2008,0,-0.37,0.0,0.37,206,0,-206,299,0,-299,0.0,0.0,0.0,0.0,0.0,0.0
north101,Hub Northen,Brooklyn Dodgers,DOGRS,1,1,1,2,1912,1914,2,0.0,-0.42,-0.42,0,38,38,0,102,102,0.0,0.0,0.0,2150.0,0.0,-2150.0
nortl101,Lou North,St. Louis Cardinals,CARDS,1,5,1,6,1917,1917,0,0.0,0.36,0.36,0,28,28,0,29,29,0.0,256.0,256.0,9800.0,0.0,-9800.0
nortp001,Phil Norton,Chicago Cubs,CUBS,5,8,8,16,2003,2013,10,13.93,0.71,-13.22,1338,461,-877,3303,226,-3077,1366.0,1109.0,-257.0,732500.0,2300000.0,1567500.0
nortr101,Ron Northey,Philadelphia Phillies,PHILS,2,2,3,5,1947,1953,6,4.66,11.24,6.58,338,617,279,1118,1748,630,0.0,230.0,230.0,0.0,0.0,0.0
nortr101,Ron Northey,St. Louis Cardinals,CARDS,1,2,1,3,1949,1952,3,0.18,-0.58,-0.76,27,68,41,92,195,103,0.0,0.0,0.0,9000.0,0.0,-9000.0
nortr101,Ron Northey,Cincinnati Reds,REDS,1,1,1,2,1950,1951,1,0.35,0.02,-0.33,54,68,14,126,190,64,0.0,0.0,0.0,0.0,0.0,0.0
nortr101,Ron Northey,Detroit Tigers,TIGRS,1,1,2,3,1955,1955,0,0.0,0.0,0.0,0,0,0,0,0,0,0.0,0.0,0.0,0.0,0.0,0.0
nortr101,Ron Northey,Charleston,Charleston,1,2,1,3,1955,1955,0,0.0,0.0,0.0,0,0,0,0,0,0,0.0,0.0,0.0,0.0,0.0,0.0
nortr101,Ron Northey,New York Giants,GIANTS,1,1,1,2,1955,1955,0,0.73,-0.19,-0.92,107,9,-98,116,13,-103,0.0,0.0,0.0,0.0,0.0,0.0
norwj001,James Norwood,Chicago Cubs,CUBS,1,1,1,2,2021,2021,0,0.22,0.0,-0.22,10,0,-10,0,0,0,15.0,0.0,-15.0,0.0,0.0,0.0
norww101,Willie Norwood,Minnesota Twins,TWINS,1,1,1,2,1980,1981,1,0.0,0.0,0.0,0,0,0,0,0,0,0.0,0.0,0.0,0.0,0.0,0.0
nossj101,Joe Nossek,Oakland Athletics,ATLTCS,1,1,1,2,1969,1970,1,0.02,0.47,0.45,10,81,71,6,123,117,0.0,0.0,0.0,0.0,0.0,0.0
nottd101,Don Nottebart,Milwaukee Braves,BRAVES,1,3,1,4,1962,1963,1,3.88,-0.09,-3.97,176,64,-112,179,177,-2,1524.0,0.0,-1524.0,0.0,0.0,0.0
nottd101,Don Nottebart,Cincinnati Reds,REDS,1,1,2,3,1969,1969,0,-0.25,0.0,0.25,32,0,-32,2,0,-2,54.0,0.0,-54.0,0.0,0.0,0.0
nottj001,Jacob Nottingham,Houston Astros,ASTROS,1,2,1,3,2015,2015,0,2.02,-0.15,-2.17,65,14,-51,15,2,-13,908.0,220.0,-688.0,0.0,0.0,0.0
nottj001,Jacob Nottingham,Oakland Athletics,ATLTCS,2,5,4,9,2016,2021,5,0.49,7.5,7.01,147,815,668,445,3236,2791,0.0,0.0,0.0,0.0,0.0,0.0
novai001,Ivan Nova,New York Yankees,YANKS,3,6,7,13,2016,2020,4,3.17,4.11,0.94,162,341,179,140,241,101,1301.0,752.0,-549.0,6150000.0,12535000.0,6385000.0
novai001,Ivan Nova,Pittsburgh Pirates,PIRATS,1,1,2,3,2018,2018,0,2.34,0.0,-2.34,37,0,-37,5,0,-5,561.0,0.0,-561.0,9167000.0,0.0,-9167000.0
novor001,Rafael Novoa,Milwaukee Brewers,BREWRS,1,2,1,3,1993,1995,2,0.0,1.19,1.19,0,47,47,0,0,0,0.0,559.0,559.0,0.0,245000.0,245000.0
novor002,Roberto Novoa,Pittsburgh Pirates,PIRATS,2,3,2,5,2002,2006,4,0.18,-0.22,-0.4,49,94,45,110,329,219,63.0,0.0,-63.0,1475000.0,290000.0,-1185000.0
novor002,Roberto Novoa,Detroit Tigers,TIGRS,3,5,4,9,2005,2010,5,1.05,4.48,3.43,399,254,-145,54,7,-47,685.0,1390.0,705.0,1975000.0,318500.0,-1656500.0
nunal101,Les Nunamaker,New York Yankees,YANKS,5,14,12,26,1918,1931,13,64.97,61.9,-3.07,2396,2093,-303,7435,5797,-1638,6303.0,6917.0,614.0,44500.0,41500.0,-3000.0
nunal101,Les Nunamaker,St.Louis Browns,ORLS,1,1,1,2,1919,1919,0,0.22,-0.15,-0.37,131,38,-93,316,82,-234,0.0,0.0,0.0,0.0,0.0,0.0
nunea001,Abraham Nunez,Toronto Blue Jays,BJAYS,2,7,5,12,1996,2001,5,5.42,8.51,3.09,1726,826,-900,3923,2165,-1758,1392.0,748.0,-644.0,1500000.0,5870000.0,4370000.0
nunea002,Abraham Nunez,Arizona Diamondbacks,DBACKS,1,3,1,4,1999,2004,5,6.5,2.69,-3.81,696,350,-346,447,0,-447,3453.0,521.0,-2932.0,0.0,735000.0,735000.0
nunea002,Abraham Nunez,Florida Marlins,MARLNS,1,1,1,2,2004,2004,0,-0.52,0.52,1.04,59,46,-13,247,0,-247,0.0,69.0,69.0,300000.0,0.0,-300000.0
nunee001,Ed Nunez,Seattle Mariners,MARNRS,1,1,1,2,1988,1988,0,0.04,-0.1,-0.14,20,16,-4,0,0,0,42.0,79.0,37.0,320000.0,111600.0,-208400.0
nunee001,Ed Nunez,Milwaukee Brewers,BREWRS,1,1,1,2,1992,1992,0,-0.49,0.0,0.49,39,0,-39,0,0,0,137.0,0.0,-137.0,1075000.0,0.0,-1075000.0
nunee002,Eduardo Nunez,New York Yankees,YANKS,1,1,1,2,2014,2014,0,1.91,0.0,-1.91,235,0,-235,813,0,-813,0.0,0.0,0.0,0.0,0.0,0.0
nunee002,Eduardo Nunez,Minnesota Twins,TWINS,1,1,1,2,2016,2019,3,1.23,1.18,-0.05,126,44,-82,517,1,-516,0.0,414.0,414.0,0.0,0.0,0.0
nunee002,Eduardo Nunez,San Francisco Giants,GIANTS,2,2,3,5,2017,2021,4,-2.01,0.94,2.95,230,180,-50,849,409,-440,29.0,334.0,305.0,4200000.0,0.0,-4200000.0
nunef001,Franklin Nunez,Boston Red Sox,RSOX,1,1,1,2,2006,2006,0,0.0,0.0,0.0,0,0,0,0,0,0,0.0,0.0,0.0,0.0,0.0,0.0
nunej001,Jose Nunez,Toronto Blue Jays,BJAYS,2,2,2,4,1989,1991,2,-1.64,-0.11,1.53,80,13,-67,15,0,-15,368.0,55.0,-313.0,417500.0,234500.0,-183000.0
nunej003,Jhonny Nunez,Los Angeles Dodgers,DOGRS,1,1,1,2,2006,2007,1,0.0,0.64,0.64,0,48,48,0,102,102,0.0,0.0,0.0,0.0,925000.0,925000.0
nunej003,Jhonny Nunez,Washington Nationals,NATEX,2,2,3,5,2008,2016,8,-0.13,0.37,0.5,102,256,154,267,568,301,0.0,26.0,26.0,0.0,0.0,0.0
nunej003,Jhonny Nunez,New York Yankees,YANKS,1,3,2,5,2008,2012,4,-0.72,11.97,12.69,28,599,571,50,2501,2451,20.0,3.0,-17.0,1165000.0,3600000.0,2435000.0
nunel001,Leo Nunez,Pittsburgh Pirates,PIRATS,1,1,2,3,2004,2005,1,1.16,-0.14,-1.3,112,6,-106,0,23,23,477.0,0.0,-477.0,0.0,2150000.0,2150000.0
nunel001,Leo Nunez,Kansas City Royals,ROYALS,1,1,1,2,2008,2009,1,2.33,-0.34,-2.67,412,128,-284,1,478,477,594.0,0.0,-594.0,405000.0,395000.0,-10000.0
nunev001,Vladimir Nunez,Arizona Diamondbacks,DBACKS,1,3,1,4,1999,2004,5,6.5,2.69,-3.81,696,350,-346,447,0,-447,3453.0,521.0,-2932.0,0.0,735000.0,735000.0
nunnj001,Jon Nunnally,Kansas City Royals,ROYALS,1,2,2,4,1997,1999,2,7.45,1.22,-6.23,503,193,-310,1598,1,-1597,0.0,629.0,629.0,0.0,0.0,0.0
nunnj001,Jon Nunnally,Cincinnati Reds,REDS,1,1,1,2,1999,1999,0,-0.13,0.0,0.13,10,0,-10,14,0,-14,0.0,0.0,0.0,0.0,0.0,0.0
nunnj001,Jon Nunnally,Boston Red Sox,RSOX,1,1,1,2,1999,1999,0,-0.02,0.0,0.02,48,0,-48,92,0,-92,0.0,0.0,0.0,0.0,284000.0,284000.0
nunov001,Vidal Nuno,New York Yankees,YANKS,1,1,2,3,2014,2014,0,1.46,1.56,0.1,32,14,-18,30,0,-30,294.0,271.0,-23.0,0.0,0.0,0.0
nunov001,Vidal Nuno,Arizona Diamondbacks,DBACKS,1,2,4,6,2015,2018,3,2.85,2.85,0.0,190,248,58,363,765,402,400.0,92.0,-308.0,0.0,2100000.0,2100000.0
nunov001,Vidal Nuno,Seattle Mariners,MARNRS,1,1,1,2,2016,2017,1,0.0,0.48,0.48,0,54,54,0,145,145,0.0,3.0,3.0,532900.0,8500000.0,7967100.0
nunov001,Vidal Nuno,Los Angeles Dodgers,DOGRS,1,1,1,2,2017,2017,0,-0.53,0.0,0.53,13,0,-13,1,0,-1,44.0,0.0,-44.0,0.0,0.0,0.0
nuxhj101,Joe Nuxhall,Cincinnati Reds,REDS,1,1,2,3,1961,1961,0,1.04,0.0,-1.04,93,0,-93,76,0,-76,384.0,0.0,-384.0,0.0,0.0,0.0
nye-r101,Rich Nye,Chicago Cubs,CUBS,2,2,2,4,1969,1970,1,1.99,0.27,-1.72,461,77,-384,1277,223,-1054,24.0,0.0,-24.0,0.0,0.0,0.0
nymaj101,Jerry Nyman,Chicago White Sox,WSOX,4,5,5,10,1970,1971,1,1.79,-1.3,-3.09,451,113,-338,1303,52,-1251,16.0,522.0,506.0,40000.0,53000.0,13000.0
nyman101,Nyls Nyman,Chicago White Sox,WSOX,1,3,1,4,1977,1978,1,1.03,-0.14,-1.17,221,8,-213,205,0,-205,1727.0,34.0,-1693.0,0.0,0.0,0.0
oaker101,Rebel Oakes,LosAngeles,LosAngeles,1,1,2,3,1909,1914,5,1.62,0.0,-1.62,120,0,-120,478,0,-478,0.0,0.0,0.0,0.0,0.0,0.0
oaker101,Rebel Oakes,Cincinnati Reds,REDS,3,9,7,16,1910,1914,4,44.03,8.35,-35.68,2926,785,-2141,11991,2646,-9345,753.0,872.0,119.0,0.0,0.0,0.0
oakst001,Trevor Oaks,Los Angeles Dodgers,DOGRS,1,4,2,6,2018,2021,3,-0.68,0.86,1.54,21,242,221,43,6,-37,41.0,333.0,292.0,0.0,0.0,0.0
oanap101,Prince Oana,Portland,Portland,1,1,3,4,1933,1933,0,-0.02,0.0,0.02,6,0,-6,21,0,-21,0.0,0.0,0.0,0.0,0.0,0.0
oatej101,Johnny Oates,Baltimore Orioles,ORLS,6,18,15,33,1972,1988,16,21.6,72.74,51.14,1757,3477,1720,3464,7736,4272,7768.0,11016.0,3248.0,691833.0,37000.0,-654833.0
oatej101,Johnny Oates,Atlanta Braves,BRAVES,3,7,6,13,1975,1986,11,13.14,5.38,-7.76,1203,1387,184,3551,4502,951,1023.0,3.0,-1020.0,0.0,0.0,0.0
oatej101,Johnny Oates,Philadelphia Phillies,PHILS,8,19,14,33,1976,1999,23,25.71,38.98,13.27,2933,3822,889,10288,10555,267,522.0,1259.0,737.0,2950000.0,165000.0,-2785000.0
obans001,Sherman Obando,Baltimore Orioles,ORLS,1,1,1,2,1996,1998,2,-0.47,-0.19,0.28,130,131,1,256,285,29,0.0,0.0,0.0,0.0,0.0,0.0
oberb001,Brett Oberholtzer,Atlanta Braves,BRAVES,1,4,2,6,2011,2012,1,1.07,6.78,5.71,249,208,-41,481,952,471,1075.0,0.0,-1075.0,0.0,4400000.0,4400000.0
oberb001,Brett Oberholtzer,Houston Astros,ASTROS,2,8,3,11,2015,2020,5,7.89,4.62,-3.27,397,276,-121,183,0,-183,2153.0,753.0,-1400.0,5115800.0,5819000.0,703200.0
oberk001,Ken Oberkfell,St. Louis Cardinals,CARDS,1,1,2,3,1984,1986,2,5.5,-0.25,-5.75,590,314,-276,2296,266,-2030,0.0,327.0,327.0,0.0,0.0,0.0
oberk001,Ken Oberkfell,Atlanta Braves,BRAVES,1,2,1,3,1988,1992,4,-0.67,-0.18,0.49,34,327,293,104,730,626,0.0,0.0,0.0,725000.0,0.0,-725000.0
oberk001,Ken Oberkfell,Pittsburgh Pirates,PIRATS,1,1,1,2,1989,1989,0,0.91,-0.32,-1.23,83,10,-73,129,0,-129,0.0,11.0,11.0,725000.0,0.0,-725000.0
oberm001,Mike O'Berry,Boston Red Sox,RSOX,1,2,1,3,1979,1980,1,0.0,-0.08,-0.08,19,35,16,57,116,59,0.0,0.0,0.0,0.0,0.0,0.0
oberm001,Mike O'Berry,Chicago Cubs,CUBS,5,9,8,17,1980,1990,10,12.61,11.46,-1.15,911,675,-236,2475,406,-2069,1070.0,3095.0,2025.0,890000.0,85000.0,-805000.0
oberm001,Mike O'Berry,Cincinnati Reds,REDS,1,1,1,2,1983,1983,0,-0.21,0.0,0.21,26,0,-26,65,0,-65,0.0,0.0,0.0,0.0,0.0,0.0
oberw001,Wes Obermueller,Kansas City Royals,ROYALS,1,2,1,3,2003,2004,1,0.42,0.53,0.11,118,46,-72,83,0,-83,746.0,125.0,-621.0,0.0,3700000.0,3700000.0
oberw001,Wes Obermueller,Milwaukee Brewers,BREWRS,1,1,1,2,2005,2006,1,0.0,-0.04,-0.04,0,105,105,0,0,0,0.0,145.0,145.0,342000.0,3400000.0,3058000.0
obrib103,Bob O'Brien,Los Angeles Dodgers,DOGRS,3,10,5,15,1971,1976,5,18.58,22.72,4.14,838,611,-227,2013,960,-1053,3623.0,2900.0,-723.0,259900.0,282000.0,22100.0
obric001,Charlie O'Brien,Oakland Athletics,ATLTCS,1,4,1,5,1986,1987,1,2.24,1.63,-0.61,195,21,-174,688,0,-688,0.0,339.0,339.0,0.0,0.0,0.0
obric001,Charlie O'Brien,Milwaukee Brewers,BREWRS,1,2,2,4,1990,1992,2,2.24,1.3,-0.94,232,30,-202,659,0,-659,0.0,293.0,293.0,150000.0,200000.0,50000.0
obric001,Charlie O'Brien,Chicago White Sox,WSOX,1,1,2,3,1998,1998,0,-0.83,0.0,0.83,32,0,-32,79,0,-79,0.0,0.0,0.0,700000.0,0.0,-700000.0
obrij101,Johnny O'Brien,Pittsburgh Pirates,PIRATS,2,3,3,6,1958,1972,14,-0.99,11.73,12.72,187,1201,1014,644,3448,2804,6.0,0.0,-6.0,0.0,0.0,0.0
obrij101,Johnny O'Brien,Philadelphia Phillies,PHILS,9,18,19,37,1959,1979,20,39.51,86.58,47.07,2824,3643,819,7602,10419,2817,7676.0,11796.0,4120.0,74500.0,159800.0,85300.0
obrij103,Jack O'Brien,Pittsburgh Pirates,PIRATS,2,4,2,6,1898,1901,3,1.28,0.36,-0.92,408,35,-373,1684,149,-1535,0.0,0.0,0.0,0.0,0.0,0.0
obrij104,John O'Brien,Louisville Colonels,LS3,1,1,3,4,1896,1897,1,0.18,-1.24,-1.42,159,153,-6,662,636,-26,0.0,0.0,0.0,0.0,0.0,0.0
obrij104,John O'Brien,Pittsburgh Pirates,PIRATS,4,11,16,27,1899,1914,15,23.91,73.99,50.08,1271,3182,1911,4723,12859,8136,1693.0,797.0,-896.0,5000.0,11750.0,6750.0
obrip001,Pete O'Brien,Texas Rangers,RNGRS,1,3,1,4,1988,1993,5,6.72,20.24,13.52,624,632,8,2545,2680,135,0.0,0.0,0.0,930000.0,975000.0,45000.0
obrip002,Peter O'Brien,New York Yankees,YANKS,2,5,4,9,2014,2016,2,8.2,5.08,-3.12,772,152,-620,1958,301,-1657,737.0,839.0,102.0,11541425.0,3267000.0,-8274425.0
obrip002,Peter O'Brien,Arizona Diamondbacks,DBACKS,1,1,1,2,2017,2017,0,0.0,0.0,0.0,0,0,0,0,0,0,0.0,0.0,0.0,0.0,0.0,0.0
obrip102,Pete O'Brien,St.Louis Browns,ORLS,1,1,1,2,1907,1907,0,0.52,0.13,-0.39,43,26,-17,159,78,-81,0.0,0.0,0.0,0.0,0.0,0.0
obrip102,Pete O'Brien,Cleveland Indians,INDINS,1,2,1,3,1907,1907,0,-0.05,-0.01,0.04,39,12,-27,151,47,-104,0.0,0.0,0.0,0.0,0.0,0.0
obrir001,Riley O'Brien,Tampa Bay Devil Rays,RAYS,1,1,1,2,2020,2021,1,-0.1,0.1,0.2,1,14,13,0,0,0,4.0,37.0,33.0,0.0,0.0,0.0
obris101,Syd O'Brien,Kansas City Athletics,ATLTCS,1,3,2,5,1966,1966,0,0.6,0.0,-0.6,100,0,-100,283,0,-283,0.0,0.0,0.0,0.0,0.0,0.0
obris101,Syd O'Brien,Boston Red Sox,RSOX,6,12,12,24,1969,1977,8,34.7,14.03,-20.67,1690,1006,-684,5095,2431,-2664,3846.0,3907.0,61.0,155000.0,163750.0,8750.0
obris101,Syd O'Brien,Chicago White Sox,WSOX,5,12,9,21,1970,1979,9,24.46,26.69,2.23,2016,1630,-386,4784,5459,675,4690.0,2166.0,-2524.0,87700.0,263100.0,175400.0
obris101,Syd O'Brien,California Angels,ANGELS,4,7,6,13,1972,1976,4,1.77,3.03,1.26,444,170,-274,1491,564,-927,0.0,90.0,90.0,63500.0,54000.0,-9500.0
obrit101,Tom O'Brien,Pittsburgh Pirates,PIRATS,1,4,2,6,1896,1898,2,3.6,0.48,-3.12,234,186,-48,984,763,-221,0.0,0.0,0.0,0.0,0.0,0.0
obrit103,Tommy O'Brien,Boston Red Sox,RSOX,1,2,1,3,1950,1953,3,0.17,2.98,2.81,40,263,223,137,929,792,0.0,0.0,0.0,0.0,0.0,0.0
ochoa001,Alex Ochoa,Baltimore Orioles,ORLS,1,2,2,4,1995,1996,1,2.13,2.23,0.1,250,220,-30,767,956,189,0.0,0.0,0.0,0.0,5300000.0,5300000.0
ochoa001,Alex Ochoa,New York Mets,METS,1,1,1,2,1997,1998,1,-1.81,0.1,1.91,94,49,-45,260,123,-137,0.0,0.0,0.0,152000.0,260000.0,108000.0
ochoa001,Alex Ochoa,Minnesota Twins,TWINS,1,1,1,2,1998,1998,0,3.11,0.0,-3.11,204,0,-204,579,0,-579,0.0,0.0,0.0,182500.0,0.0,-182500.0
ochoa001,Alex Ochoa,Milwaukee Brewers,BREWRS,3,8,8,16,2000,2004,4,4.53,1.77,-2.76,522,512,-10,1583,851,-732,437.0,1049.0,612.0,2750000.0,500000.0,-2250000.0
ochoa001,Alex Ochoa,Cincinnati Reds,REDS,2,2,4,6,2001,2004,3,0.61,2.43,1.82,202,248,46,861,1046,185,0.0,0.0,0.0,3650000.0,1050000.0,-2600000.0
ochoa001,Alex Ochoa,Colorado Rockies,ROCKS,1,3,3,6,2002,2002,0,1.08,0.1,-0.98,85,193,108,250,708,458,0.0,3.0,3.0,0.0,0.0,0.0
ochoa001,Alex Ochoa,Milwaukee Brewers,BREWRS,1,2,3,5,2002,2004,2,0.27,-0.5,-0.77,39,52,13,76,74,-2,0.0,47.0,47.0,2750000.0,500000.0,-2250000.0
ocond101,Danny O'Connell,Brooklyn Dodgers,DOGRS,1,1,2,3,1949,1949,0,3.87,0.0,-3.87,228,0,-228,999,0,-999,0.0,0.0,0.0,0.0,0.0,0.0
ocond101,Danny O'Connell,Pittsburgh Pirates,PIRATS,3,3,9,12,1953,1958,5,6.64,2.5,-4.14,487,431,-56,1903,671,-1232,58.0,1608.0,1550.0,0.0,0.0,0.0
ocond101,Danny O'Connell,Milwaukee Braves,BRAVES,1,3,1,4,1957,1960,3,3.25,5.66,2.41,395,272,-123,1122,1140,18,434.0,0.0,-434.0,0.0,42000.0,42000.0
oconj001,Jack O'Connor,Minnesota Twins,TWINS,2,2,2,4,1985,1985,0,-0.43,0.02,0.45,61,81,20,34,209,175,71.0,0.0,-71.0,0.0,0.0,0.0
oconj104,Jack O'Connor,New York Yankees,YANKS,1,1,1,2,1903,1905,2,-0.78,3.02,3.8,95,175,80,330,705,375,0.0,0.0,0.0,0.0,0.0,0.0
oconp101,Pat O'Connell,Lawrence,Lawrence,1,3,1,4,1886,1886,0,0.0,0.0,0.0,0,0,0,0,0,0,0.0,0.0,0.0,0.0,0.0,0.0
odayd001,Darren O'Day,Baltimore Orioles,ORLS,1,2,5,7,2018,2021,3,0.72,-0.48,-1.2,86,45,-41,50,0,-50,484.0,143.0,-341.0,5600000.0,0.0,-5600000.0
odeak101,Ken O'Dea,St. Louis Cardinals,CARDS,1,1,2,3,1934,1935,1,3.55,0.0,-3.55,325,0,-325,971,0,-971,0.0,0.0,0.0,0.0,0.0,0.0
odeak101,Ken O'Dea,Chicago Cubs,CUBS,4,7,6,13,1938,1943,5,18.58,4.9,-13.68,1563,631,-932,5453,2299,-3154,405.0,0.0,-405.0,33000.0,21000.0,-12000.0
odeak101,Ken O'Dea,New York Giants,GIANTS,1,4,1,5,1941,1949,8,5.95,28.96,23.01,346,655,309,1181,2815,1634,38.0,0.0,-38.0,0.0,0.0,0.0
odelb101,Billy O'Dell,Baltimore Orioles,ORLS,8,21,21,42,1959,1988,29,33.15,113.26,80.11,2390,5136,2746,2159,13379,11220,12056.0,12975.0,919.0,785333.0,99400.0,-685933.0
odelb101,Billy O'Dell,San Francisco Giants,GIANTS,4,6,5,11,1965,1968,3,2.15,-0.27,-2.42,446,274,-172,431,733,302,950.0,0.0,-950.0,33000.0,30000.0,-3000.0
odelb101,Billy O'Dell,Atlanta Braves,BRAVES,1,1,1,2,1966,1967,1,-0.39,0.04,0.43,129,24,-105,46,13,-33,474.0,138.0,-336.0,0.0,0.0,0.0
odomj101,Blue Moon Odom,Oakland Athletics,ATLTCS,1,2,2,4,1975,1977,2,0.33,1.23,0.9,3,66,63,0,0,0,31.0,907.0,876.0,35000.0,68000.0,33000.0
odomj101,Blue Moon Odom,Cleveland Indians,INDINS,2,3,2,5,1975,1976,1,-3.18,0.49,3.67,111,22,-89,203,0,-203,168.0,399.0,231.0,0.0,0.0,0.0
odomj101,Blue Moon Odom,Atlanta Braves,BRAVES,1,1,1,2,1976,1976,0,-0.38,-0.29,0.09,8,5,-3,0,10,10,84.0,0.0,-84.0,0.0,0.0,0.0
odonh101,Harry O'Donnell,Philadelphia Phillies,PHILS,1,3,1,4,1928,1928,0,0.0,1.31,1.31,0,96,96,0,292,292,0.0,0.0,0.0,0.0,0.0,0.0
odonj001,John O'Donoghue,Baltimore Orioles,ORLS,1,1,1,2,1994,1995,1,0.0,-0.12,-0.12,0,2,2,0,0,0,0.0,26.0,26.0,0.0,0.0,0.0
odonj101,John O'Donoghue,Kansas City Athletics,ATLTCS,1,2,1,3,1966,1966,0,2.7,-0.09,-2.79,130,30,-100,77,17,-60,716.0,192.0,-524.0,0.0,0.0,0.0
odonj101,John O'Donoghue,Cleveland Indians,INDINS,3,4,5,9,1967,1969,2,0.08,0.41,0.33,486,148,-338,67,15,-52,1385.0,377.0,-1008.0,75600.0,66000.0,-9600.0
odonj101,John O'Donoghue,Baltimore Orioles,ORLS,3,6,5,11,1969,1973,4,0.65,-0.01,-0.66,284,47,-237,424,80,-344,279.0,0.0,-279.0,0.0,18000.0,18000.0
odonj101,John O'Donoghue,Milwaukee Brewers,BREWRS,2,3,2,5,1970,1971,1,-0.36,-0.75,-0.39,44,42,-2,5,3,-2,119.0,97.0,-22.0,17500.0,26500.0,9000.0
odorj001,Jake Odorizzi,Milwaukee Brewers,BREWRS,8,16,16,32,2010,2020,10,33.31,23.99,-9.32,2772,1309,-1463,10420,3997,-6423,777.0,2948.0,2171.0,20405500.0,10550000.0,-9855500.0
odorj001,Jake Odorizzi,Kansas City Royals,ROYALS,3,6,5,11,2012,2021,9,12.05,17.51,5.46,480,779,299,994,1767,773,2270.0,2321.0,51.0,16050000.0,12652767.0,-3397233.0
odorj001,Jake Odorizzi,Tampa Bay Devil Rays,RAYS,1,1,1,2,2018,2018,0,4.28,0.0,-4.28,73,0,-73,11,0,-11,1011.0,0.0,-1011.0,0.0,0.0,0.0
odorr001,Rougned Odor,Texas Rangers,RNGRS,1,2,2,4,2021,2021,0,0.33,0.0,-0.33,102,0,-102,361,0,-361,0.0,0.0,0.0,0.0,0.0,0.0
odoul101,Lefty O'Doul,New York Yankees,YANKS,2,7,3,10,1922,1928,6,-3.56,9.12,12.68,367,900,533,1242,3603,2361,159.0,0.0,-159.0,15750.0,13000.0,-2750.0
odoul101,Lefty O'Doul,New York Giants,GIANTS,1,2,1,3,1928,1932,4,12.12,3.02,-9.1,294,368,74,1338,1574,236,0.0,0.0,0.0,7500.0,7000.0,-500.0
odoul101,Lefty O'Doul,Philadelphia Phillies,PHILS,5,12,10,22,1930,1941,11,17.23,29.97,12.74,1414,1700,286,5405,4168,-1237,324.0,4825.0,4501.0,17000.0,18200.0,1200.0
odoul101,Lefty O'Doul,Brooklyn Dodgers,DOGRS,1,2,1,3,1933,1936,3,2.63,7.41,4.78,203,384,181,478,1597,1119,188.0,0.0,-188.0,0.0,0.0,0.0
odwef101,Fred Odwell,Cincinnati Reds,REDS,1,2,1,3,1906,1906,0,0.0,-1.63,-1.63,0,80,80,0,329,329,0.0,0.0,0.0,0.0,0.0,0.0
oelkb001,Bryan Oelkers,Minnesota Twins,TWINS,1,2,2,4,1986,1986,0,-0.02,-0.18,-0.16,101,5,-96,0,0,0,1286.0,31.0,-1255.0,0.0,0.0,0.0
oelkb001,Bryan Oelkers,Montreal Expos,NATEX,1,1,1,2,1988,1988,0,0.0,0.0,0.0,0,0,0,0,0,0,0.0,0.0,0.0,0.0,0.0,0.0
oescj101,Joe Oeschger,Philadelphia Phillies,PHILS,2,2,3,5,1919,1928,9,-0.05,9.95,10.0,80,742,662,35,917,882,384.0,4915.0,4531.0,3429.0,5030.0,1601.0
oescj101,Joe Oeschger,New York Giants,GIANTS,1,5,1,6,1919,1926,7,8.66,14.34,5.68,964,460,-504,2314,555,-1759,3291.0,4306.0,1015.0,5412.0,6226.0,814.0
oescj101,Joe Oeschger,Boston Braves,BRAVES,1,2,3,5,1923,1927,4,1.22,11.01,9.79,273,702,429,996,2898,1902,87.0,0.0,-87.0,5000.0,17500.0,12500.0
ofarb101,Bob O'Farrell,Chicago Cubs,CUBS,1,1,2,3,1925,1928,3,4.96,2.73,-2.23,387,357,-30,1394,1405,11,0.0,0.0,0.0,10500.0,5500.0,-5000.0
ofarb101,Bob O'Farrell,St. Louis Cardinals,CARDS,1,1,1,2,1928,1928,0,1.73,2.57,0.84,395,99,-296,1022,337,-685,0.0,0.0,0.0,25000.0,10500.0,-14500.0
ofarb101,Bob O'Farrell,New York Giants,GIANTS,3,11,6,17,1932,1949,17,15.21,55.77,40.56,1303,2528,1225,3690,9780,6090,2269.0,40.0,-2229.0,0.0,0.0,0.0
ofarb101,Bob O'Farrell,St. Louis Cardinals,CARDS,1,2,1,3,1934,1934,0,0.4,0.0,-0.4,48,0,-48,141,0,-141,20.0,0.0,-20.0,0.0,0.0,0.0
offej001,Jose Offerman,Los Angeles Dodgers,DOGRS,2,2,2,4,1995,2001,6,9.56,-0.91,-10.47,419,32,-387,1825,13,-1812,17.0,138.0,121.0,1600000.0,220000.0,-1380000.0
oflae001,Eric O'Flaherty,Oakland Athletics,ATLTCS,1,2,1,3,2015,2015,0,-0.66,0.0,0.66,30,0,-30,0,0,0,26.0,0.0,-26.0,5500000.0,0.0,-5500000.0
ogann001,Nefi Ogando,Boston Red Sox,RSOX,1,1,1,2,2013,2013,0,-0.15,-0.08,0.07,8,6,-2,0,9,9,12.0,0.0,-12.0,0.0,0.0,0.0
ogdej101,Jack Ogden,New York Giants,GIANTS,2,8,3,11,1919,1923,4,10.49,7.89,-2.6,305,402,97,539,1094,555,2035.0,323.0,-1712.0,12500.0,9600.0,-2900.0
ogdej101,Jack Ogden,Cincinnati Reds,REDS,4,7,8,15,1933,1943,10,2.09,48.62,46.53,936,2007,1071,3163,5265,2102,264.0,8479.0,8215.0,23000.0,0.0,-23000.0
ogeac001,Chad Ogea,Cleveland Indians,INDINS,2,2,3,5,1998,1999,1,0.06,-0.21,-0.27,184,4,-180,56,0,-56,678.0,9.0,-669.0,1720833.0,235000.0,-1485833.0
oglib001,Ben Oglivie,Boston Red Sox,RSOX,1,1,1,2,1973,1974,1,5.4,0.36,-5.04,439,100,-339,1468,316,-1152,0.0,0.0,0.0,16500.0,0.0,-16500.0
oglib001,Ben Oglivie,Detroit Tigers,TIGRS,1,1,2,3,1977,1978,1,21.52,1.83,-19.69,1149,35,-1114,4658,0,-4658,0.0,701.0,701.0,60000.0,45000.0,-15000.0
ograb001,Brian O'Grady,Cincinnati Reds,REDS,1,1,1,2,2019,2019,0,0.09,0.0,-0.09,2,0,-2,5,0,-5,0.0,0.0,0.0,0.0,0.0,0.0
oh--s001,Seung Hwan Oh,Toronto Blue Jays,BJAYS,2,2,4,6,2018,2021,3,0.16,-0.4,-0.56,90,11,-79,0,0,0,119.0,104.0,-15.0,0.0,6500000.0,6500000.0
ohkat001,Tomo Ohka,Boston Red Sox,RSOX,1,2,1,3,2001,2002,1,9.01,2.21,-6.8,198,82,-116,193,0,-193,1755.0,240.0,-1515.0,225000.0,4200000.0,3975000.0
ohkat001,Tomo Ohka,Washington Nationals,NATEX,1,1,1,2,2005,2005,0,1.34,0.61,-0.73,79,28,-51,78,91,13,670.0,0.0,-670.0,2750000.0,2125000.0,-625000.0
ohler001,Ross Ohlendorf,Arizona Diamondbacks,DBACKS,1,4,2,6,2007,2008,1,-0.71,4.28,4.99,171,78,-93,110,78,-32,366.0,722.0,356.0,0.0,0.0,0.0
ohler001,Ross Ohlendorf,New York Yankees,YANKS,1,4,2,6,2008,2011,3,7.23,0.52,-6.71,1088,146,-942,2084,276,-1808,3210.0,148.0,-3062.0,391425.0,5500000.0,5108575.0
ohmaw001,Will Ohman,Chicago Cubs,CUBS,3,6,6,12,2007,2013,6,21.27,0.88,-20.39,1494,347,-1147,4156,61,-4095,895.0,926.0,31.0,1305000.0,2300000.0,995000.0
ohmaw001,Will Ohman,Baltimore Orioles,ORLS,1,1,1,2,2010,2012,2,0.05,-0.24,-0.29,34,11,-23,0,0,0,36.0,76.0,40.0,1350000.0,0.0,-1350000.0
ojeda001,Augie Ojeda,Baltimore Orioles,ORLS,1,1,1,2,1999,1999,0,-0.39,0.0,0.39,148,0,-148,359,0,-359,0.0,0.0,0.0,0.0,0.0,0.0
ojedb001,Bob Ojeda,Boston Red Sox,RSOX,7,15,13,28,1985,1993,8,20.97,19.79,-1.18,2048,1909,-139,3771,4732,961,4874.0,3574.0,-1300.0,3550000.0,2472500.0,-1077500.0
ojedb001,Bob Ojeda,New York Mets,METS,3,4,3,7,1990,1994,4,2.55,1.07,-1.48,331,342,11,618,888,270,1125.0,394.0,-731.0,4116666.0,2749167.0,-1367499.0
ojedm001,Miguel Ojeda,San Diego Padres,PADRS,1,2,1,3,2005,2005,0,0.04,0.91,0.87,16,37,21,37,124,87,0.0,0.0,0.0,325000.0,400000.0,75000.0
okril101,Len Okrie,Washington Senators,TWINS,1,2,1,3,1951,1951,0,-0.03,-1.31,-1.28,1,72,71,1,231,230,0.0,0.0,0.0,0.0,0.0,0.0
olerj001,John Olerud,Toronto Blue Jays,BJAYS,5,8,10,18,1996,2001,5,26.41,-1.92,-28.33,768,398,-370,2308,479,-1829,2704.0,1150.0,-1554.0,15479000.0,1584000.0,-13895000.0
oliva001,Al Oliver,Pittsburgh Pirates,PIRATS,6,9,12,21,1977,1984,7,35.51,9.96,-25.55,1400,772,-628,4253,1476,-2777,2781.0,2392.0,-389.0,465000.0,140000.0,-325000.0
oliva001,Al Oliver,Texas Rangers,RNGRS,2,2,3,5,1982,1988,6,6.69,5.48,-1.21,317,1141,824,1351,4462,3111,0.0,229.0,229.0,0.0,0.0,0.0
oliva001,Al Oliver,Montreal Expos,NATEX,3,4,5,9,1984,1992,8,-0.33,3.06,3.39,385,762,377,699,1970,1271,201.0,164.0,-37.0,415000.0,210000.0,-205000.0
oliva001,Al Oliver,San Francisco Giants,GIANTS,2,4,3,7,1984,1992,8,-0.69,5.26,5.95,80,443,363,148,292,144,73.0,2798.0,2725.0,0.0,0.0,0.0
oliva001,Al Oliver,Philadelphia Phillies,PHILS,1,1,1,2,1985,1985,0,-0.47,-0.03,0.44,35,20,-15,85,1,-84,0.0,38.0,38.0,0.0,0.0,0.0
oliva001,Al Oliver,Los Angeles Dodgers,DOGRS,1,1,1,2,1985,1985,0,-0.63,0.62,1.25,61,43,-18,195,76,-119,0.0,0.0,0.0,750000.0,185000.0,-565000.0
oliva002,Andy Oliver,Detroit Tigers,TIGRS,1,1,1,2,2012,2014,2,0.0,0.0,0.0,0,0,0,0,0,0,0.0,0.0,0.0,0.0,0.0,0.0
olivb101,Bob Oliver,Pittsburgh Pirates,PIRATS,2,2,2,4,1967,1970,3,-0.01,1.87,1.88,14,304,290,0,34,34,33.0,708.0,675.0,0.0,35000.0,35000.0
olivb101,Bob Oliver,Kansas City Royals,ROYALS,2,2,2,4,1972,1973,1,3.99,0.78,-3.21,433,39,-394,1539,19,-1520,266.0,211.0,-55.0,27500.0,0.0,-27500.0
olivb101,Bob Oliver,California Angels,ANGELS,2,2,3,5,1974,1978,4,-0.11,-0.27,-0.16,9,98,89,20,0,-20,0.0,370.0,370.0,55000.0,0.0,-55000.0
olivc101,Chi-Chi Olivo,Atlanta Braves,BRAVES,1,2,1,3,1966,1971,5,-2.04,8.56,10.6,310,533,223,998,2105,1107,0.0,0.0,0.0,5500.0,31500.0,26000.0
olivd001,Darren Oliver,Texas Rangers,RNGRS,5,11,11,22,1998,2007,9,64.71,14.02,-50.69,2900,693,-2207,10742,1670,-9072,2420.0,2612.0,192.0,7720000.0,9894000.0,2174000.0
olivd001,Darren Oliver,Texas Rangers,RNGRS,3,3,5,8,2001,2012,11,3.77,14.53,10.76,325,775,450,1006,1580,574,326.0,1248.0,922.0,16150000.0,7333333.0,-8816667.0
olivd101,Diomedes Olivo,Pittsburgh Pirates,PIRATS,4,6,6,12,1962,1968,6,15.1,3.94,-11.16,878,326,-552,2528,282,-2246,1540.0,2303.0,763.0,46000.0,24500.0,-21500.0
olivd102,Dave Oliver,Cleveland Indians,INDINS,1,1,1,2,1980,1981,1,0.0,-1.41,-1.41,0,14,14,0,0,0,0.0,224.0,224.0,0.0,229167.0,229167.0
olive001,Edward Olivares,Toronto Blue Jays,BJAYS,1,2,1,3,2018,2018,0,-0.5,-0.25,0.25,13,122,109,36,506,470,0.0,0.0,0.0,0.0,0.0,0.0
olive001,Edward Olivares,San Diego Padres,PADRS,1,2,1,3,2020,2020,0,0.01,0.64,0.63,62,10,-52,176,0,-176,19.0,30.0,11.0,0.0,100000.0,100000.0
olivf001,Francisco Oliveras,Minnesota Twins,TWINS,1,1,1,2,1990,1990,0,0.88,0.0,-0.88,208,0,-208,23,0,-23,538.0,0.0,-538.0,0.0,0.0,0.0
olivg101,Gene Oliver,St. Louis Cardinals,CARDS,3,6,4,10,1963,1965,2,5.52,0.29,-5.23,682,84,-598,1519,49,-1470,1673.0,458.0,-1215.0,0.0,0.0,0.0
olivg101,Gene Oliver,Atlanta Braves,BRAVES,1,1,1,2,1967,1967,0,0.69,-2.01,-2.7,85,62,-23,298,180,-118,0.0,0.0,0.0,0.0,0.0,0.0
olivg101,Gene Oliver,Philadelphia Phillies,PHILS,2,3,3,6,1967,1974,7,0.86,0.9,0.04,97,392,295,157,1287,1130,624.0,0.0,-624.0,32000.0,15000.0,-17000.0
olivh001,Hector Olivera,Los Angeles Dodgers,DOGRS,9,31,24,55,2015,2021,6,13.41,18.97,5.56,1905,1113,-792,5768,1311,-4457,2200.0,3323.0,1123.0,37486500.0,75153480.0,37666980.0
olivh001,Hector Olivera,Atlanta Braves,BRAVES,2,2,7,9,2016,2020,4,1.15,-0.95,-2.1,146,435,289,506,1212,706,0.0,246.0,246.0,21750000.0,34407000.0,12657000.0
olivj001,Joe Oliver,Tampa Bay Devil Rays,RAYS,1,2,2,4,1999,2001,2,-1.06,1.13,2.19,241,216,-25,708,680,-28,0.0,91.0,91.0,0.0,375000.0,375000.0
olivj002,Jose Oliva,Texas Rangers,RNGRS,2,2,3,5,1992,1993,1,0.04,1.17,1.13,122,26,-96,187,0,-187,95.0,451.0,356.0,0.0,3183333.0,3183333.0
olivj002,Jose Oliva,Atlanta Braves,BRAVES,2,2,2,4,1995,1999,4,-0.86,0.37,1.23,22,163,141,82,291,209,0.0,0.0,0.0,111500.0,185000.0,73500.0
olivl001,Lester Oliveros,Detroit Tigers,TIGRS,1,2,1,3,2011,2012,1,0.02,-0.57,-0.59,18,191,173,0,786,786,64.0,0.0,-64.0,0.0,5375000.0,5375000.0
olivm001,Miguel Olivo,Oakland Athletics,ATLTCS,2,2,3,5,2000,2006,6,2.64,8.41,5.77,197,479,282,523,879,356,70.0,744.0,674.0,0.0,3500000.0,3500000.0
olivm001,Miguel Olivo,Chicago White Sox,WSOX,4,9,8,17,2004,2013,9,26.28,24.52,-1.76,2038,506,-1532,7101,844,-6257,1892.0,4790.0,2898.0,12920000.0,9770000.0,-3150000.0
olivm001,Miguel Olivo,Seattle Mariners,MARNRS,1,1,2,3,2005,2005,0,0.91,0.04,-0.87,37,16,-21,124,37,-87,0.0,0.0,0.0,400000.0,325000.0,-75000.0
olivn101,Nate Oliver,Los Angeles Dodgers,DOGRS,2,3,4,7,1968,1972,4,9.28,10.09,0.81,488,474,-14,1876,1637,-239,0.0,0.0,0.0,55000.0,0.0,-55000.0
olivn101,Nate Oliver,San Francisco Giants,GIANTS,1,1,1,2,1968,1969,1,0.0,0.0,0.0,1,0,-1,1,0,-1,0.0,0.0,0.0,16000.0,23000.0,7000.0
olivn101,Nate Oliver,New York Yankees,YANKS,1,1,1,2,1969,1969,0,-0.33,0.0,0.33,44,0,-44,49,0,-49,0.0,0.0,0.0,18000.0,0.0,-18000.0
olivo001,Omar Olivares,San Diego Padres,PADRS,2,2,3,5,1990,1993,3,7.2,0.15,-7.05,514,73,-441,1026,152,-874,1818.0,0.0,-1818.0,0.0,0.0,0.0
olivo001,Omar Olivares,Detroit Tigers,TIGRS,6,18,12,30,1997,2002,5,3.14,14.72,11.58,1662,1186,-476,4060,2874,-1186,1346.0,2263.0,917.0,9860000.0,4940000.0,-4920000.0
olivo001,Omar Olivares,Anaheim Angels,ANGELS,1,2,3,5,1999,2005,6,5.25,4.59,-0.66,273,402,129,988,1145,157,548.0,0.0,-548.0,3425000.0,0.0,-3425000.0
olmer001,Ray Olmedo,Texas Rangers,RNGRS,1,1,1,2,2010,2011,1,0.0,-0.58,-0.58,0,89,89,0,284,284,0.0,0.0,0.0,0.0,0.0,0.0
olmoe001,Edgar Olmos,Chicago Cubs,CUBS,1,1,1,2,2016,2016,0,0.0,0.0,0.0,0,0,0,0,0,0,0.0,0.0,0.0,0.0,0.0,0.0
olmol101,Luis Olmo,Brooklyn Dodgers,DOGRS,1,1,3,4,1949,1949,0,-0.88,0.0,0.88,90,0,-90,233,0,-233,0.0,0.0,0.0,0.0,0.0,0.0
olmsa101,Al Olmsted,St. Louis Cardinals,CARDS,9,26,18,44,1980,1992,12,83.63,101.91,18.28,6733,4351,-2382,20851,14642,-6209,6532.0,3025.0,-3507.0,1533333.0,576667.0,-956666.0
olmsa101,Al Olmsted,San Diego Padres,PADRS,6,11,12,23,1982,1993,11,64.79,33.72,-31.07,2384,3112,728,8892,7842,-1050,1163.0,2653.0,1490.0,905000.0,2812500.0,1907500.0
olseb101,Barney Olsen,Chicago Cubs,CUBS,1,1,1,2,1947,1949,2,0.0,0.0,0.0,0,0,0,0,0,0,0.0,0.0,0.0,0.0,0.0,0.0
olses001,Scott Olsen,Florida Marlins,MARLNS,13,35,35,70,2008,2020,12,62.26,28.41,-33.85,4300,3021,-1279,10993,9069,-1924,7970.0,4278.0,-3692.0,67010000.0,34658100.0,-32351900.0
olsog001,Gregg Olson,Cincinnati Reds,REDS,2,2,2,4,1996,1998,2,0.5,0.52,0.02,43,34,-9,0,79,79,129.0,0.0,-129.0,0.0,0.0,0.0
olsog001,Gregg Olson,Detroit Tigers,TIGRS,1,1,2,3,1996,2001,5,-0.01,0.0,0.01,18,1,-17,0,0,0,28.0,0.0,-28.0,400000.0,0.0,-400000.0
olsog003,Garrett Olson,Baltimore Orioles,ORLS,1,2,1,3,2009,2011,2,0.0,-1.12,-1.12,0,268,268,0,764,764,0.0,0.0,0.0,0.0,0.0,0.0
olsog003,Garrett Olson,Chicago Cubs,CUBS,2,3,3,6,2009,2012,3,-3.45,0.86,4.31,326,217,-109,212,3,-209,676.0,339.0,-337.0,1625000.0,0.0,-1625000.0
olsok101,Karl Olson,Boston Red Sox,RSOX,2,7,5,12,1955,1963,8,0.69,2.88,2.19,731,424,-307,812,1170,358,1712.0,707.0,-1005.0,7000.0,0.0,-7000.0
olsok101,Karl Olson,Boston Red Sox,RSOX,1,1,1,2,1957,1957,0,-0.28,0.0,0.28,8,0,-8,15,0,-15,0.0,0.0,0.0,0.0,0.0,0.0
olsom101,Marv Olson,Boston Red Sox,RSOX,1,3,1,4,1933,1937,4,0.0,5.56,5.56,0,404,404,0,1495,1495,0.0,0.0,0.0,8250.0,0.0,-8250.0
olsom101,Marv Olson,New York Yankees,YANKS,3,7,3,10,1933,1948,15,-3.37,1.52,4.89,613,291,-322,2436,971,-1465,0.0,0.0,0.0,9000.0,3000.0,-6000.0
olsot001,Tim Olson,Texas Rangers,RNGRS,1,1,1,2,2006,2006,0,0.0,0.0,0.0,0,0,0,0,0,0,0.0,0.0,0.0,0.0,0.0,0.0
olsot002,Tyler Olson,Seattle Mariners,MARNRS,1,1,1,2,2015,2015,0,0.0,0.0,0.0,0,0,0,0,0,0,0.0,0.0,0.0,0.0,0.0,0.0
olsot002,Tyler Olson,Los Angeles Dodgers,DOGRS,1,2,2,4,2016,2016,0,1.39,0.0,-1.39,222,40,-182,607,83,-524,8.0,0.0,-8.0,0.0,0.0,0.0
olt-m001,Mike Olt,Texas Rangers,RNGRS,1,4,1,5,2013,2013,0,4.33,-0.09,-4.42,1129,13,-1116,283,0,-283,1426.0,253.0,-1173.0,0.0,0.0,0.0
olwie001,Ed Olwine,New York Mets,METS,2,3,4,7,1986,1988,2,-0.58,0.0,0.58,247,0,-247,342,0,-342,269.0,0.0,-269.0,650000.0,0.0,-650000.0
omalt001,Tom O'Malley,San Francisco Giants,GIANTS,1,1,2,3,1984,1984,0,-0.28,0.0,0.28,12,0,-12,16,0,-16,0.0,0.0,0.0,0.0,0.0,0.0
omalt001,Tom O'Malley,Detroit Tigers,TIGRS,1,1,1,2,1985,1985,0,0.22,0.0,-0.22,64,0,-64,214,0,-214,0.0,0.0,0.0,0.0,0.0,0.0
omalt001,Tom O'Malley,Texas Rangers,RNGRS,1,1,1,2,1988,1992,4,0.08,0.89,0.81,14,294,280,31,775,744,0.0,0.0,0.0,0.0,0.0,0.0
omalt001,Tom O'Malley,Montreal Expos,NATEX,1,2,1,3,1989,1992,3,0.25,-0.1,-0.35,91,204,113,144,4,-140,0.0,350.0,350.0,0.0,0.0,0.0
onear001,Randy O'Neal,Detroit Tigers,TIGRS,2,3,4,7,1987,1987,0,-0.06,-0.17,-0.11,109,31,-78,95,74,-21,258.0,0.0,-258.0,425000.0,0.0,-425000.0
onear001,Randy O'Neal,Atlanta Braves,BRAVES,2,2,2,4,1987,1993,6,1.72,1.87,0.15,226,502,276,25,16,-9,607.0,945.0,338.0,215000.0,0.0,-215000.0
oneas101,Skinny O'Neal,Beaumont,Beaumont,1,2,1,3,1924,1924,0,-0.96,0.0,0.96,36,0,-36,13,0,-13,104.0,0.0,-104.0,0.0,0.0,0.0
oneib101,John O'Neill,Boston Red Sox,RSOX,1,1,1,2,1904,1904,0,-1.37,2.29,3.66,95,98,3,397,437,40,0.0,0.0,0.0,0.0,0.0,0.0
oneih101,Harry O'Neill,Philadelphia Athletics,ATLTCS,2,7,2,9,1923,1927,4,0.0,2.68,2.68,0,472,472,0,1997,1997,0.0,0.0,0.0,12000.0,0.0,-12000.0
oneij102,Jack O'Neill,St. Louis Cardinals,CARDS,4,6,9,15,1903,1914,11,50.1,19.67,-30.43,1069,1341,272,1762,4083,2321,8426.0,5469.0,-2957.0,2400.0,3300.0,900.0
oneij102,Jack O'Neill,Chicago Cubs,CUBS,1,2,1,3,1905,1910,5,1.88,3.49,1.61,264,262,-2,476,905,429,1653.0,0.0,-1653.0,0.0,0.0,0.0
oneij104,Jim O'Neill,Washington Senators,TWINS,2,4,2,6,1924,1927,3,1.24,9.31,8.07,60,188,128,31,206,175,281.0,1671.0,1390.0,2100.0,7500.0,5400.0
oneim102,Mickey O'Neil,New York Giants,GIANTS,1,5,1,6,1919,1926,7,8.66,14.34,5.68,964,460,-504,2314,555,-1759,3291.0,4306.0,1015.0,5412.0,6226.0,814.0
oneim102,Mickey O'Neil,Boston Braves,BRAVES,8,16,14,30,1925,1938,13,15.59,19.03,3.44,1577,2611,1034,4396,9724,5328,4040.0,1364.0,-2676.0,46800.0,27600.0,-19200.0
oneip001,Paul O'Neill,Cincinnati Reds,REDS,7,15,9,24,1992,2010,18,38.5,29.57,-8.93,1755,1640,-115,6377,5925,-452,2595.0,2089.0,-506.0,19233333.0,12345291.0,-6888042.0
oneis101,Steve O'Neill,Cleveland Indians,INDINS,1,4,3,7,1924,1928,4,0.12,9.37,9.25,387,855,468,1555,3344,1789,0.0,0.0,0.0,0.0,0.0,0.0
oneit001,Tyler O'Neill,Seattle Mariners,MARNRS,1,1,1,2,2017,2017,0,8.58,0.0,-8.58,309,11,-298,987,2,-985,0.0,110.0,110.0,0.0,0.0,0.0
ontis001,Steve Ontiveros,Minnesota Twins,TWINS,1,1,1,2,1993,1993,0,0.82,0.0,-0.82,14,0,-14,0,0,0,54.0,0.0,-54.0,0.0,0.0,0.0
ontis101,Steve Ontiveros,San Francisco Giants,GIANTS,13,28,29,57,1977,1998,21,51.57,71.65,20.08,3606,5145,1539,8805,7807,-998,5201.0,15628.0,10427.0,10487778.0,6966667.0,-3521111.0
oquej001,Jose Oquendo,New York Mets,METS,2,3,3,6,1985,1986,1,15.41,0.0,-15.41,1225,0,-1225,3818,0,-3818,18.0,0.0,-18.0,0.0,0.0,0.0
orave101,Ernie Oravetz,Minnesota Twins,TWINS,1,2,2,4,1961,1961,0,0.0,-0.97,-0.97,0,59,59,0,114,114,0.0,63.0,63.0,0.0,0.0,0.0
ordal001,Luis Ordaz,Cincinnati Reds,REDS,1,2,1,3,1995,1995,0,-0.85,0.0,0.85,79,0,-79,203,0,-203,0.0,0.0,0.0,0.0,0.0,0.0
ordal001,Luis Ordaz,St. Louis Cardinals,CARDS,1,1,1,2,1999,2000,1,0.0,0.0,0.0,0,0,0,0,0,0,0.0,0.0,0.0,210000.0,200000.0,-10000.0
ordor001,Rey Ordonez,New York Mets,METS,1,1,2,3,2002,2003,1,0.68,0.0,-0.68,34,0,-34,124,0,-124,0.0,0.0,0.0,6250000.0,575000.0,-5675000.0
orenj101,Joe Orengo,New York Giants,GIANTS,2,4,3,7,1943,1945,2,-0.25,-0.04,0.21,36,72,36,28,39,11,123.0,375.0,252.0,0.0,0.0,0.0
orenj101,Joe Orengo,Detroit Tigers,TIGRS,1,1,1,2,1944,1947,3,-0.17,-0.96,-0.79,17,232,215,19,719,700,0.0,0.0,0.0,3600.0,6000.0,2400.0
orenj101,Joe Orengo,Brooklyn Dodgers,DOGRS,1,2,1,3,1943,1947,4,0.0,0.43,0.43,0,314,314,0,1177,1177,0.0,0.0,0.0,0.0,0.0,0.0
oriek001,Kevin Orie,Chicago Cubs,CUBS,4,13,7,20,1998,2009,11,13.03,10.6,-2.43,859,1301,442,2754,2788,34,471.0,1208.0,737.0,7140000.0,11000000.0,3860000.0
orild101,Don O'Riley,Kansas City Royals,ROYALS,1,2,2,4,1970,1974,4,5.15,1.5,-3.65,692,230,-462,2721,588,-2133,0.0,0.0,0.0,26000.0,15000.0,-11000.0
orlap001,Paulo Orlando,Chicago White Sox,WSOX,1,1,1,2,2008,2008,0,1.69,-0.27,-1.96,278,17,-261,918,0,-918,0.0,39.0,39.0,0.0,0.0,0.0
orosj001,Jesse Orosco,Minnesota Twins,TWINS,4,6,7,13,1979,1985,6,15.63,11.86,-3.77,831,317,-514,71,727,656,2897.0,1804.0,-1093.0,0.0,0.0,0.0
orosj001,Jesse Orosco,New York Mets,METS,5,15,7,22,1987,1993,6,82.7,21.53,-61.17,2390,667,-1723,1638,781,-857,14501.0,4350.0,-10151.0,4216000.0,9733332.0,5517332.0
orosj001,Jesse Orosco,Baltimore Orioles,ORLS,1,1,1,2,1999,2001,2,0.0,0.55,0.55,0,65,65,0,0,0,0.0,326.0,326.0,800000.0,0.0,-800000.0
orosj001,Jesse Orosco,New York Mets,METS,1,1,1,2,2000,2005,5,-0.25,0.53,0.78,12,502,490,0,1169,1169,7.0,0.0,-7.0,0.0,0.0,0.0
orosj001,Jesse Orosco,New York Yankees,YANKS,1,1,1,2,2003,2004,1,-0.03,0.23,0.26,8,6,-2,0,0,0,14.0,34.0,20.0,0.0,0.0,0.0
orouf101,Frank O'Rourke,Toronto,Toronto,1,1,3,4,1920,1920,0,-1.21,0.0,1.21,137,0,-137,546,0,-546,0.0,0.0,0.0,0.0,2000.0,2000.0
orouf101,Frank O'Rourke,Washington Senators,TWINS,2,3,3,6,1922,1933,11,2.2,14.57,12.37,219,710,491,852,2665,1813,0.0,616.0,616.0,0.0,0.0,0.0
orouf101,Frank O'Rourke,Detroit Tigers,TIGRS,2,5,4,9,1927,1934,7,25.64,16.62,-9.02,1182,957,-225,3618,3579,-39,3712.0,0.0,-3712.0,12500.0,10000.0,-2500.0
orout101,Tim O'Rourke,Baltimore Orioles,BLN,1,1,2,3,1893,1899,6,1.66,35.58,33.92,147,755,608,687,3472,2785,0.0,0.0,0.0,0.0,0.0,0.0
orsij101,John Orsino,San Francisco Giants,GIANTS,10,18,16,34,1962,1972,10,36.27,10.66,-25.61,2635,1445,-1190,6319,1774,-4545,3135.0,5237.0,2102.0,50000.0,108000.0,58000.0
orsij101,John Orsino,Baltimore Orioles,ORLS,9,21,20,41,1965,1988,23,20.17,76.44,56.27,1928,3751,1823,3725,7941,4216,7971.0,11741.0,3770.0,706833.0,57000.0,-649833.0
orsij101,John Orsino,New York Yankees,YANKS,2,3,2,5,1969,1973,4,0.33,1.09,0.76,63,350,287,8,1148,1140,181.0,31.0,-150.0,0.0,0.0,0.0
orsuj001,Joe Orsulak,Pittsburgh Pirates,PIRATS,2,2,3,5,1987,1992,5,7.97,0.0,-7.97,637,0,-637,2277,0,-2277,0.0,0.0,0.0,0.0,0.0,0.0
orsuj001,Joe Orsulak,Florida Marlins,MARLNS,3,8,7,15,1997,2005,8,8.19,25.16,16.97,569,1378,809,623,4089,3466,3020.0,1719.0,-1301.0,6500000.0,9062500.0,2562500.0
ortaj001,Jorge Orta,Cleveland Indians,INDINS,17,30,35,65,1981,2001,20,116.55,78.96,-37.59,6988,5496,-1492,21431,20127,-1304,7765.0,4126.0,-3639.0,20493332.0,19210000.0,-1283332.0
ortaj001,Jorge Orta,Los Angeles Dodgers,DOGRS,3,3,3,6,1982,1985,3,-0.66,1.56,2.22,81,274,193,196,171,-25,38.0,432.0,394.0,1000000.0,185000.0,-815000.0
ortaj001,Jorge Orta,New York Mets,METS,2,3,3,6,1983,1984,1,-2.31,-1.63,0.68,463,108,-355,1748,288,-1460,0.0,0.0,0.0,0.0,0.0,0.0
ortaj001,Jorge Orta,Toronto Blue Jays,BJAYS,1,1,1,2,1983,1985,2,1.28,-0.87,-2.15,359,105,-254,1182,289,-893,0.0,0.0,0.0,250000.0,0.0,-250000.0
ortef101,Frank Ortenzio,Kansas City Royals,ROYALS,1,1,1,2,1976,1976,0,0.0,0.0,0.0,0,0,0,0,0,0,0.0,0.0,0.0,0.0,0.0,0.0
ortep101,Phil Ortega,Los Angeles Dodgers,DOGRS,4,12,9,21,1964,1984,20,57.0,60.48,3.48,4290,2463,-1827,14544,7259,-7285,4034.0,7191.0,3157.0,163000.0,22000.0,-141000.0
ortha101,Al Orth,Washington Senators,TWINS,1,1,2,3,1904,1909,5,20.8,10.94,-9.86,393,470,77,575,592,17,3508.0,4615.0,1107.0,0.0,0.0,0.0
ortid001,David Ortiz,Seattle Mariners,MARNRS,1,1,1,2,1996,1996,0,2.59,1.11,-1.48,455,28,-427,1693,113,-1580,0.0,0.0,0.0,0.0,1350000.0,1350000.0
ortij001,Junior Ortiz,Pittsburgh Pirates,PIRATS,2,3,3,6,1983,1992,9,-1.54,-0.56,0.98,576,774,198,1492,1540,48,0.0,993.0,993.0,0.0,0.0,0.0
ortij001,Junior Ortiz,Pittsburgh Pirates,PIRATS,2,3,2,5,1990,1994,4,1.68,0.42,-1.26,132,312,180,338,714,376,0.0,0.0,0.0,0.0,210000.0,210000.0
ortij001,Junior Ortiz,Cleveland Indians,INDINS,1,1,2,3,1994,1994,0,0.29,0.0,-0.29,29,0,-29,86,0,-86,0.0,0.0,0.0,0.0,0.0,0.0
ortij002,Javier Ortiz,Texas Rangers,RNGRS,2,3,3,6,1987,1989,2,0.0,-0.18,-0.18,0,3,3,0,0,0,0.0,22.0,22.0,0.0,0.0,0.0
ortij002,Javier Ortiz,Los Angeles Dodgers,DOGRS,1,1,1,2,1989,1989,0,0.57,0.0,-0.57,77,0,-77,187,0,-187,0.0,0.0,0.0,0.0,0.0,0.0
ortij003,Jose Ortiz,Oakland Athletics,ATLTCS,1,3,1,4,2001,2004,3,0.03,2.82,2.79,154,394,240,507,1663,1156,28.0,0.0,-28.0,201000.0,0.0,-201000.0
ortij101,Jose Ortiz,Chicago White Sox,WSOX,4,5,7,12,1970,1975,5,0.12,0.95,0.83,86,167,81,189,439,250,0.0,6.0,6.0,9500.0,0.0,-9500.0
ortil001,Luis Ortiz,Boston Red Sox,RSOX,4,8,8,16,1994,2002,8,1.6,9.74,8.14,416,630,214,1358,1420,62,371.0,1801.0,1430.0,6625000.0,11675000.0,5050000.0
ortil002,Luis Ortiz,Texas Rangers,RNGRS,3,5,4,9,2016,2018,2,3.83,1.66,-2.17,343,178,-165,233,474,241,460.0,162.0,-298.0,7350000.0,0.0,-7350000.0
ortil002,Luis Ortiz,Milwaukee Brewers,BREWRS,1,3,1,4,2018,2018,0,5.49,-0.04,-5.53,219,46,-173,950,134,-816,17.0,0.0,-17.0,2550000.0,8500000.0,5950000.0
ortir001,Russ Ortiz,San Francisco Giants,GIANTS,2,4,3,7,2002,2010,8,3.3,1.02,-2.28,153,192,39,153,63,-90,1502.0,750.0,-752.0,4714500.0,4465000.0,-249500.0
ortir002,Ramon Ortiz,Anaheim Angels,ANGELS,1,1,1,2,2004,2009,5,-0.5,0.56,1.06,60,69,9,61,0,-61,514.0,504.0,-10.0,3266667.0,0.0,-3266667.0
ortir002,Ramon Ortiz,Minnesota Twins,TWINS,1,1,1,2,2007,2010,3,-0.05,-0.07,-0.02,20,18,-2,2,36,34,39.0,0.0,-39.0,3100000.0,0.0,-3100000.0
ortir101,Roberto Ortiz,Washington Senators,TWINS,1,1,2,3,1942,1946,4,0.0,0.0,0.0,0,0,0,0,0,0,0.0,0.0,0.0,0.0,0.0,0.0
ortir101,Roberto Ortiz,Brooklyn Dodgers,DOGRS,1,1,1,2,1943,1945,2,-0.38,-0.33,0.05,165,56,-109,573,126,-447,0.0,0.0,0.0,0.0,0.0,0.0
orwoo101,Ossie Orwoll,Milwaukee,Milwaukee,2,2,4,6,1927,1929,2,0.9,0.0,-0.9,133,0,-133,244,0,-244,407.0,0.0,-407.0,0.0,13000.0,13000.0
orwoo101,Ossie Orwoll,Philadelphia Athletics,ATLTCS,1,2,1,3,1930,1930,0,0.0,0.0,0.0,0,0,0,0,0,0,0.0,0.0,0.0,0.0,0.0,0.0
osbob101,Bobo Osborne,Detroit Tigers,TIGRS,1,1,1,2,1963,1968,5,-0.15,-0.6,-0.45,125,52,-73,416,54,-362,0.0,0.0,0.0,0.0,0.0,0.0
osbob102,Bob Osborn,Pittsburgh Pirates,PIRATS,2,4,2,6,1932,1940,8,-0.39,22.08,22.47,8,680,672,3,632,629,28.0,4937.0,4909.0,7000.0,10000.0,3000.0
osboo101,Ozzie Osborn,Cincinnati Reds,REDS,1,1,1,2,1974,1974,0,0.41,0.0,-0.41,24,0,-24,0,0,0,174.0,0.0,-174.0,0.0,0.0,0.0
osboo101,Ozzie Osborn,Chicago White Sox,WSOX,2,4,3,7,1975,1979,4,12.32,5.83,-6.49,561,668,107,1607,2532,925,1417.0,0.0,-1417.0,0.0,114500.0,114500.0
osbop101,Pat Osburn,Cincinnati Reds,REDS,4,4,4,8,1974,1979,5,3.77,-0.17,-3.94,356,130,-226,980,246,-734,35.0,0.0,-35.0,0.0,18000.0,18000.0
osbop101,Pat Osburn,Milwaukee Brewers,BREWRS,1,1,1,2,1975,1975,0,0.0,0.0,0.0,0,0,0,0,0,0,0.0,0.0,0.0,16000.0,0.0,-16000.0
osicj001,Josh Osich,Boston Red Sox,RSOX,1,1,1,2,2020,2021,1,-0.47,0.0,0.47,4,0,-4,0,0,0,8.0,0.0,-8.0,850000.0,0.0,-850000.0
osind101,Dan Osinski,Kansas City Athletics,ATLTCS,1,1,2,3,1962,1962,0,2.17,0.0,-2.17,254,0,-254,84,0,-84,920.0,0.0,-920.0,0.0,0.0,0.0
osind101,Dan Osinski,California Angels,ANGELS,2,2,4,6,1964,1965,1,1.41,-0.88,-2.29,165,37,-128,66,24,-42,250.0,59.0,-191.0,12500.0,0.0,-12500.0
osind101,Dan Osinski,Atlanta Braves,BRAVES,5,10,8,18,1965,1968,3,-0.38,-0.18,0.2,622,407,-215,842,564,-278,716.0,549.0,-167.0,15000.0,12500.0,-2500.0
ostec103,Claude Osteen,Cincinnati Reds,REDS,1,1,2,3,1961,1961,0,9.22,0.0,-9.22,237,0,-237,239,0,-239,1914.0,0.0,-1914.0,0.0,15750.0,15750.0
ostec103,Claude Osteen,Washington Senators,RNGRS,25,44,50,94,1964,1986,22,142.7,105.14,-37.56,8431,6596,-1835,19421,19306,-115,25577.0,10905.0,-14672.0,342900.0,824500.0,481600.0
ostec103,Claude Osteen,Los Angeles Dodgers,DOGRS,2,6,3,9,1973,1984,11,-0.05,31.52,31.57,1550,1541,-9,5211,5934,723,415.0,0.0,-415.0,100000.0,0.0,-100000.0
ostec103,Claude Osteen,Houston Astros,ASTROS,3,3,4,7,1974,1979,5,0.06,-0.71,-0.77,58,102,44,39,65,26,349.0,602.0,253.0,100000.0,0.0,-100000.0
osted101,Darrell Osteen,Cincinnati Reds,REDS,1,2,1,3,1967,1968,1,0.17,0.0,-0.17,59,0,-59,90,0,-90,17.0,0.0,-17.0,0.0,0.0,0.0
osted101,Darrell Osteen,Oakland Athletics,ATLTCS,2,5,2,7,1971,1972,1,-0.2,0.7,0.9,128,78,-50,155,190,35,313.0,0.0,-313.0,33250.0,36000.0,2750.0
ostef101,Fritz Ostermueller,St.Louis Browns,ORLS,1,2,1,3,1943,1943,0,0.96,-1.44,-2.4,36,20,-16,28,16,-12,207.0,157.0,-50.0,12000.0,15000.0,3000.0
ostef101,Fritz Ostermueller,Brooklyn Dodgers,DOGRS,1,3,1,4,1944,1946,2,-0.35,6.14,6.49,4,237,233,0,969,969,5.0,0.0,-5.0,0.0,0.0,0.0
oster101,Red Ostergard,Chicago White Sox,WSOX,1,4,1,5,1924,1924,0,0.0,-0.04,-0.04,0,6,6,0,5,5,0.0,0.0,0.0,0.0,0.0,0.0
ostij001,Jimmy Osting,Atlanta Braves,BRAVES,1,2,1,3,2000,2000,0,1.66,1.18,-0.48,60,31,-29,62,37,-25,542.0,294.0,-248.0,207500.0,5900000.0,5692500.0
ostrb101,Brian Ostrosser,New York Mets,METS,1,1,1,2,1974,1974,0,0.0,0.0,0.0,0,0,0,0,0,0,0.0,0.0,0.0,0.0,0.0,0.0
ostrj101,Joe Ostrowski,Boston Red Sox,RSOX,2,8,5,13,1947,1955,8,6.5,21.93,15.43,835,962,127,1487,3127,1640,2844.0,2066.0,-778.0,10000.0,32000.0,22000.0
ostrj101,Joe Ostrowski,St.Louis Browns,ORLS,11,21,24,45,1950,1960,10,30.8,26.53,-4.27,2470,2935,465,5868,7663,1795,6528.0,5672.0,-856.0,55500.0,57800.0,2300.0
ostrj102,Johnny Ostrowski,Chicago Cubs,CUBS,1,1,2,3,1949,1949,0,0.26,0.0,-0.26,71,0,-71,235,0,-235,0.0,0.0,0.0,0.0,0.0,0.0
ostrj102,Johnny Ostrowski,Chicago White Sox,WSOX,10,25,21,46,1950,1963,13,23.73,52.01,28.28,4184,3652,-532,12734,11891,-843,4692.0,2309.0,-2383.0,109500.0,111000.0,1500.0
osuls001,Sean O'Sullivan,Anaheim Angels,ANGELS,2,3,2,5,2010,2015,5,-1.93,6.97,8.9,238,527,289,631,1904,1273,756.0,0.0,-756.0,0.0,460000.0,460000.0
osuna001,Al Osuna,Houston Astros,ASTROS,1,1,1,2,1994,1994,0,-0.08,0.0,0.08,30,0,-30,0,0,0,26.0,0.0,-26.0,0.0,0.0,0.0
osuna002,Antonio Osuna,Los Angeles Dodgers,DOGRS,2,5,5,10,2001,2001,0,0.16,0.96,0.8,66,24,-42,0,27,27,216.0,238.0,22.0,0.0,5950000.0,5950000.0
osuna002,Antonio Osuna,Chicago White Sox,WSOX,2,6,3,9,2003,2003,0,-3.34,5.0,8.34,321,36,-285,107,7,-100,601.0,726.0,125.0,0.0,0.0,0.0
osunr001,Roberto Osuna,Toronto Blue Jays,BJAYS,2,2,4,6,2018,2021,3,2.96,2.45,-0.51,98,92,-6,0,0,0,276.0,254.0,-22.0,5300000.0,4600000.0,-700000.0
oswar001,Roy Oswalt,Houston Astros,ASTROS,7,13,15,28,2010,2020,10,28.48,11.63,-16.85,1879,903,-976,4452,2193,-2259,4887.0,2930.0,-1957.0,23335000.0,7025000.0,-16310000.0
otanw001,Willis Otanez,Los Angeles Dodgers,DOGRS,1,2,1,3,1995,1996,1,0.25,-0.12,-0.37,108,92,-16,250,358,108,0.0,0.0,0.0,0.0,694445.0,694445.0
oterr001,Ricky Otero,New York Mets,METS,1,1,1,2,1995,1995,0,-0.42,0.0,0.42,154,0,-154,623,0,-623,0.0,0.0,0.0,109000.0,0.0,-109000.0
otisa001,Amos Otis,New York Mets,METS,1,2,1,3,1969,1970,1,49.09,1.86,-47.23,1971,99,-1872,8041,399,-7642,642.0,0.0,-642.0,0.0,25000.0,25000.0
otood101,Denny O'Toole,Chicago White Sox,WSOX,2,5,2,7,1973,1973,0,6.5,0.0,-6.5,800,0,-800,1477,0,-1477,2061.0,0.0,-2061.0,32700.0,110000.0,77300.0
otood101,Denny O'Toole,St. Louis Cardinals,CARDS,1,1,1,2,1973,1973,0,0.0,0.0,0.0,0,0,0,0,0,0,0.0,0.0,0.0,0.0,0.0,0.0
otooj101,Jim O'Toole,Cincinnati Reds,REDS,2,3,2,5,1966,1968,2,0.22,-0.72,-0.94,89,55,-34,104,145,41,180.0,0.0,-180.0,29000.0,26000.0,-3000.0
otsua001,Akinori Otsuka,San Diego Padres,PADRS,9,21,20,41,2006,2021,15,51.12,29.32,-21.8,2292,1830,-462,7839,5012,-2827,1512.0,4191.0,2679.0,15535200.0,5157500.0,-10377700.0
ott-e101,Ed Ott,Pittsburgh Pirates,PIRATS,2,3,3,6,1981,1986,5,0.66,9.75,9.09,117,671,554,351,2696,2345,43.0,0.0,-43.0,0.0,0.0,0.0
ottaa001,Adam Ottavino,New York Yankees,YANKS,1,2,1,3,2021,2021,0,0.83,0.0,-0.83,75,0,-75,0,0,0,186.0,0.0,-186.0,0.0,0.0,0.0
ottej101,Jim Otten,Chicago White Sox,WSOX,1,1,1,2,1977,1977,0,-1.69,0.0,1.69,110,0,-110,8,0,-8,273.0,0.0,-273.0,0.0,0.0,0.0
ottog001,Glenn Otto,New York Yankees,YANKS,1,4,3,7,2021,2021,0,-0.87,0.78,1.65,6,82,76,0,228,228,70.0,57.0,-13.0,0.0,8700000.0,8700000.0
outlj101,Jimmy Outlaw,St. Louis Cardinals,CARDS,1,1,2,3,1938,1938,0,0.0,0.0,0.0,0,0,0,0,0,0,0.0,0.0,0.0,0.0,0.0,0.0
outlj101,Jimmy Outlaw,Brooklyn Dodgers,DOGRS,1,2,2,4,1938,1940,2,2.67,-0.72,-3.39,454,199,-255,1715,406,-1309,0.0,317.0,317.0,0.0,0.0,0.0
outmj001,Josh Outman,Philadelphia Phillies,PHILS,2,4,2,6,2008,2012,4,4.22,2.37,-1.85,203,206,3,28,216,188,867.0,1849.0,982.0,8500000.0,3700000.0,-4800000.0
outmj001,Josh Outman,Oakland Athletics,ATLTCS,2,3,2,5,2012,2014,2,3.45,4.02,0.57,352,317,-35,551,851,300,434.0,217.0,-217.0,3675000.0,3200000.0,-475000.0
outmj001,Josh Outman,Colorado Rockies,ROCKS,1,1,1,2,2013,2015,2,0.36,2.15,1.79,33,183,150,0,538,538,74.0,0.0,-74.0,675000.0,2825000.0,2150000.0
outmj001,Josh Outman,Cleveland Indians,INDINS,1,1,1,2,2014,2014,0,0.24,0.0,-0.24,9,0,-9,0,0,0,11.0,0.0,-11.0,1250000.0,0.0,-1250000.0
overd001,Dillon Overton,Oakland Athletics,ATLTCS,1,1,1,2,2017,2017,0,-0.27,0.0,0.27,10,0,-10,0,0,0,55.0,0.0,-55.0,0.0,0.0,0.0
overl001,Lyle Overbay,Arizona Diamondbacks,DBACKS,1,6,3,9,2003,2005,2,15.82,-0.12,-15.94,1881,61,-1820,5048,104,-4944,2593.0,37.0,-2556.0,3548667.0,5425000.0,1876333.0
overl001,Lyle Overbay,Milwaukee Brewers,BREWRS,3,7,5,12,2005,2012,7,36.63,9.25,-27.38,2335,589,-1746,9079,878,-8201,310.0,3140.0,2830.0,860000.0,11627000.0,10767000.0
overo101,Orval Overall,Cincinnati Reds,REDS,1,2,1,3,1906,1906,0,19.28,0.58,-18.7,329,40,-289,440,54,-386,3405.0,448.0,-2957.0,0.0,0.0,0.0
overs101,Stubby Overmire,St.Louis Browns,ORLS,2,3,4,7,1951,1954,3,-1.09,2.85,3.94,54,211,157,29,293,264,182.0,956.0,774.0,19250.0,18000.0,-1250.0
owchb001,Bob Owchinko,San Diego Padres,PADRS,5,11,10,21,1980,1989,9,32.03,18.53,-13.5,2570,1341,-1229,8500,3002,-5498,2306.0,4252.0,1946.0,0.0,300000.0,300000.0
owchb001,Bob Owchinko,Cleveland Indians,INDINS,5,10,10,20,1980,2004,24,35.2,53.01,17.81,1530,2520,990,5654,9198,3544,2682.0,3776.0,1094.0,1767500.0,1412500.0,-355000.0
owchb001,Bob Owchinko,Pittsburgh Pirates,PIRATS,2,3,4,7,1981,1983,2,3.29,-0.91,-4.2,493,38,-455,1402,17,-1385,424.0,197.0,-227.0,0.0,0.0,0.0
owend001,Dave Owen,Chicago Cubs,CUBS,1,1,1,2,1985,1988,3,0.0,0.74,0.74,0,265,265,0,593,593,0.0,0.0,0.0,0.0,709714.0,709714.0
owend001,Dave Owen,Texas Rangers,RNGRS,1,1,1,2,1987,1987,0,-0.22,0.0,0.22,7,0,-7,5,0,-5,0.0,0.0,0.0,0.0,0.0,0.0
owene001,Eric Owens,Cincinnati Reds,REDS,1,1,1,2,1998,1998,0,0.6,0.0,-0.6,250,0,-250,860,0,-860,0.0,0.0,0.0,0.0,0.0,0.0
owene001,Eric Owens,San Diego Padres,PADRS,5,11,8,19,2001,2007,6,6.69,14.89,8.2,976,910,-66,3576,3007,-569,532.0,273.0,-259.0,12000000.0,8812500.0,-3187500.0
owenh001,Henry Owens,New York Mets,METS,2,9,5,14,2006,2010,4,11.2,-1.8,-13.0,974,362,-612,1347,182,-1165,2746.0,356.0,-2390.0,3398000.0,5132000.0,1734000.0
owenj002,Jerry Owens,Washington Nationals,NATEX,1,1,1,2,2005,2008,3,0.79,0.37,-0.42,129,33,-96,430,99,-331,0.0,0.0,0.0,0.0,0.0,0.0
owenj101,Jim Owens,Philadelphia Phillies,PHILS,6,10,12,22,1962,1977,15,1.53,9.25,7.72,412,1621,1209,897,4956,4059,448.0,628.0,180.0,70000.0,163500.0,93500.0
owenm101,Mickey Owen,St. Louis Cardinals,CARDS,1,1,3,4,1940,1942,2,3.28,0.16,-3.12,521,111,-410,1916,388,-1528,0.0,0.0,0.0,0.0,0.0,0.0
owenm102,Marv Owen,Detroit Tigers,TIGRS,5,17,11,28,1937,1952,15,24.1,51.38,27.28,3640,2564,-1076,12152,7653,-4499,3951.0,7313.0,3362.0,74300.0,79500.0,5200.0
owenr001,Rudy Owens,Pittsburgh Pirates,PIRATS,1,3,1,4,2012,2014,2,1.62,0.18,-1.44,191,63,-128,764,59,-705,17.0,493.0,476.0,0.0,0.0,0.0
owens001,Spike Owen,Boston Red Sox,RSOX,1,2,2,4,1988,1993,5,6.42,6.16,-0.26,552,597,45,1976,1669,-307,0.0,1455.0,1455.0,525000.0,132500.0,-392500.0
owens001,Spike Owen,New York Yankees,YANKS,1,2,1,3,1993,1993,0,1.15,0.0,-1.15,164,0,-164,558,0,-558,0.0,0.0,0.0,2250000.0,0.0,-2250000.0
owens001,Spike Owen,Seattle Mariners,MARNRS,3,5,8,13,1986,1989,3,0.54,-0.06,-0.6,445,432,-13,1461,1346,-115,0.0,625.0,625.0,215000.0,447500.0,232500.0
owinm001,Micah Owings,Arizona Diamondbacks,DBACKS,1,3,2,5,2008,2008,0,-0.17,-0.36,-0.19,138,44,-94,113,187,74,459.0,0.0,-459.0,402000.0,13000000.0,12598000.0
ownbr001,Rick Ownbey,New York Mets,METS,1,2,1,3,1983,1989,6,-0.78,26.61,27.39,253,880,627,88,3684,3596,994.0,0.0,-994.0,0.0,0.0,0.0
oyler101,Ray Oyler,Milwaukee Brewers,BREWRS,16,29,31,60,1969,1986,17,56.11,55.7,-0.41,3782,3364,-418,9776,9018,-758,7371.0,9266.0,1895.0,829901.0,70000.0,-759901.0
ozunm001,Marcell Ozuna,Miami Marlins,MARLNS,2,2,5,7,2017,2021,4,10.61,0.21,-10.4,351,224,-127,1232,487,-745,711.0,109.0,-602.0,3500000.0,0.0,-3500000.0
ozunp001,Pablo Ozuna,St. Louis Cardinals,CARDS,1,3,1,4,1998,2004,6,3.02,16.68,13.66,1222,903,-319,88,3759,3671,1761.0,0.0,-1761.0,170000.0,255000.0,85000.0
ozunp001,Pablo Ozuna,Florida Marlins,MARLNS,4,9,11,20,2002,2015,13,11.51,22.72,11.21,893,1533,640,2983,2710,-273,1797.0,5078.0,3281.0,13177000.0,10303543.0,-2873457.0
pacej001,John Pacella,New York Mets,METS,1,2,1,3,1980,1982,2,-0.04,-2.0,-1.96,34,82,48,50,50,0,0.0,501.0,501.0,0.0,0.0,0.0
pacej001,John Pacella,San Diego Padres,PADRS,4,9,9,18,1981,1989,8,31.59,14.9,-16.69,2540,1181,-1359,8500,2380,-6120,1963.0,4252.0,2289.0,0.0,300000.0,300000.0
pacej001,John Pacella,New York Yankees,YANKS,4,8,8,16,1982,1992,10,8.27,12.89,4.62,1161,565,-596,2474,1712,-762,2564.0,669.0,-1895.0,913333.0,1045000.0,131667.0
pacej001,John Pacella,Minnesota Twins,TWINS,1,1,1,2,1982,1985,3,0.0,0.93,0.93,0,95,95,0,0,0,0.0,337.0,337.0,0.0,0.0,0.0
pacha001,Alex Pacheco,Montreal Expos,NATEX,3,6,6,12,1996,2006,10,7.51,7.37,-0.14,330,796,466,781,2734,1953,1820.0,309.0,-1511.0,7545000.0,7500000.0,-45000.0
pacip001,Pat Pacillo,Cincinnati Reds,REDS,1,2,3,5,1988,1992,4,0.54,1.86,1.32,53,699,646,157,1778,1621,0.0,41.0,41.0,157500.0,330000.0,172500.0
pacip001,Pat Pacillo,Montreal Expos,NATEX,1,1,1,2,1990,1992,2,0.0,-0.62,-0.62,0,55,55,0,144,144,0.0,0.0,0.0,0.0,0.0,0.0
pacit001,Tom Paciorek,Los Angeles Dodgers,DOGRS,1,4,2,6,1975,1984,9,-0.88,19.14,20.02,1504,1261,-243,5163,4749,-414,0.0,0.0,0.0,0.0,0.0,0.0
pacit001,Tom Paciorek,Seattle Mariners,MARNRS,2,2,4,6,1981,1983,2,2.36,-0.03,-2.39,424,260,-164,1520,924,-596,0.0,0.0,0.0,85000.0,250000.0,165000.0
pacit001,Tom Paciorek,Chicago White Sox,WSOX,5,8,8,16,1985,1994,9,14.44,7.13,-7.31,431,523,92,125,827,702,4103.0,4503.0,400.0,1263333.0,62500.0,-1200833.0
packg101,Gene Packard,St. Louis Cardinals,CARDS,4,7,6,13,1919,1928,9,6.49,22.08,15.59,1385,1345,-40,4793,5431,638,403.0,0.0,-403.0,33500.0,21000.0,-12500.0
paddc001,Chris Paddack,Miami Marlins,MARLNS,1,1,1,2,2016,2016,0,1.91,-0.78,-2.69,109,77,-32,88,0,-88,924.0,110.0,-814.0,0.0,0.0,0.0
paddd102,Dick Padden,Pittsburgh Pirates,PIRATS,2,4,2,6,1898,1901,3,1.28,0.36,-0.92,408,35,-373,1684,149,-1535,0.0,0.0,0.0,0.0,0.0,0.0
paddt101,Tom Padden,Baltimore,Baltimore,1,2,3,5,1930,1930,0,-0.48,0.0,0.48,34,0,-34,24,0,-24,173.0,0.0,-173.0,0.0,6500.0,6500.0
paddt101,Tom Padden,Pittsburgh Pirates,PIRATS,4,7,4,11,1937,1946,9,3.24,18.29,15.05,164,1051,887,641,3703,3062,0.0,666.0,666.0,0.0,0.0,0.0
paddt101,Tom Padden,New York Giants,GIANTS,3,10,6,16,1939,1954,15,0.0,7.09,7.09,0,765,765,0,2631,2631,0.0,172.0,172.0,6000.0,0.0,-6000.0
padgd101,Don Padgett,St. Louis Cardinals,CARDS,1,1,3,4,1941,1941,0,-0.17,0.0,0.17,19,0,-19,34,0,-34,0.0,0.0,0.0,8000.0,0.0,-8000.0
padgd101,Don Padgett,Boston Braves,BRAVES,1,1,1,2,1947,1947,0,-0.21,0.26,0.47,111,54,-57,254,6,-248,0.0,105.0,105.0,0.0,0.0,0.0
padij001,Juan Padilla,Minnesota Twins,TWINS,1,1,1,2,2003,2003,0,0.23,-0.03,-0.26,6,8,2,0,0,0,34.0,14.0,-20.0,0.0,0.0,0.0
padij002,Jorge Padilla,Toronto Blue Jays,BJAYS,1,1,1,2,2010,2010,0,0.0,0.0,0.0,0,0,0,0,0,0,0.0,0.0,0.0,0.0,0.0,0.0
padiv001,Vicente Padilla,Arizona Diamondbacks,DBACKS,5,14,12,26,2000,2008,8,42.79,24.27,-18.52,2947,854,-2093,6888,689,-6199,9063.0,3504.0,-5559.0,23673667.0,11709000.0,-11964667.0
padiv001,Vicente Padilla,Philadelphia Phillies,PHILS,1,1,1,2,2005,2006,1,4.08,0.0,-4.08,107,0,-107,10,0,-10,1798.0,0.0,-1798.0,3200000.0,0.0,-3200000.0
padlk001,Kevin Padlo,Colorado Rockies,ROCKS,1,2,2,4,2016,2020,4,4.27,1.19,-3.08,307,448,141,1191,8,-1183,0.0,649.0,649.0,0.0,0.0,0.0
paepd101,Dennis Paepke,California Angels,ANGELS,4,9,7,16,1968,1990,22,52.18,61.82,9.64,2063,2537,474,5135,9859,4724,8249.0,1533.0,-6716.0,230000.0,50000.0,-180000.0
pafka101,Andy Pafko,Chicago Cubs,CUBS,9,26,24,50,1951,1965,14,14.31,21.74,7.43,2452,2862,410,6527,5620,-907,3090.0,5461.0,2371.0,143500.0,125000.0,-18500.0
pafka101,Andy Pafko,Brooklyn Dodgers,DOGRS,1,1,2,3,1953,1953,0,4.62,0.0,-4.62,658,0,-658,2087,0,-2087,0.0,0.0,0.0,0.0,0.0,0.0
pagaa001,Angel Pagan,Chicago Cubs,CUBS,1,1,2,3,2008,2008,0,10.81,0.0,-10.81,393,0,-393,1646,0,-1646,0.0,0.0,0.0,0.0,0.0,0.0
pagaa001,Angel Pagan,New York Mets,METS,1,1,2,3,2011,2012,1,6.46,1.51,-4.95,583,247,-336,2471,434,-2037,0.0,191.0,191.0,3500000.0,3850000.0,350000.0
pagad101,Dave Pagan,New York Yankees,YANKS,12,22,23,45,1976,1997,21,98.9,27.78,-71.12,5024,1689,-3335,9897,2906,-6991,18250.0,6192.0,-12058.0,4415000.0,2812500.0,-1602500.0
pagad101,Dave Pagan,Seattle Mariners,MARNRS,3,8,8,16,1977,1985,8,8.88,8.95,0.07,491,533,42,632,1358,726,2632.0,2699.0,67.0,175000.0,512500.0,337500.0
pagae001,Emilio Pagan,Seattle Mariners,MARNRS,1,2,1,3,2017,2019,2,0.24,-0.47,-0.71,59,180,121,0,711,711,186.0,0.0,-186.0,0.0,537500.0,537500.0
pagae001,Emilio Pagan,Oakland Athletics,ATLTCS,2,4,3,7,2018,2019,1,3.56,-0.15,-3.71,264,139,-125,615,518,-97,210.0,0.0,-210.0,4147500.0,0.0,-4147500.0
pagae001,Emilio Pagan,Tampa Bay Devil Rays,RAYS,1,1,2,3,2020,2020,0,-0.32,1.05,1.37,154,47,-107,2,159,157,256.0,0.0,-256.0,0.0,0.0,0.0
pagaj101,Jose Pagan,San Francisco Giants,GIANTS,1,1,1,2,1965,1966,1,3.44,-0.4,-3.84,625,112,-513,1710,439,-1271,0.0,0.0,0.0,0.0,0.0,0.0
pagek101,Karl Pagel,Chicago Cubs,CUBS,3,5,3,8,1980,1982,2,1.93,-0.08,-2.01,233,68,-165,710,227,-483,0.0,0.0,0.0,0.0,0.0,0.0
pagem001,Mitchell Page,Pittsburgh Pirates,PIRATS,5,10,11,21,1977,1988,11,53.71,31.99,-21.72,2929,1675,-1254,9660,6568,-3092,5429.0,149.0,-5280.0,807000.0,0.0,-807000.0
pagep101,Phil Page,Seattle,Seattle,1,1,1,2,1934,1934,0,-0.05,0.0,0.05,12,0,-12,1,0,-1,30.0,0.0,-30.0,0.0,0.0,0.0
pages101,Sam Page,Philadelphia Athletics,ATLTCS,1,4,1,5,1939,1939,0,0.0,0.0,0.0,0,0,0,0,0,0,0.0,0.0,0.0,3000.0,0.0,-3000.0
pagev101,Vance Page,Washington Senators,TWINS,1,1,2,3,1938,1945,7,1.28,0.0,-1.28,191,0,-191,103,0,-103,947.0,0.0,-947.0,0.0,0.0,0.0
paglj101,Jim Pagliaroni,Boston Red Sox,RSOX,5,6,7,13,1962,1974,12,12.31,8.2,-4.11,890,1047,157,2393,1626,-767,1125.0,3389.0,2264.0,80500.0,77000.0,-3500.0
paglm001,Mike Pagliarulo,New York Yankees,YANKS,1,2,2,4,1989,1990,1,-0.39,-0.36,0.03,192,13,-179,619,0,-619,73.0,249.0,176.0,575000.0,775000.0,200000.0
paglm001,Mike Pagliarulo,Minnesota Twins,TWINS,1,1,1,2,1993,1995,2,1.35,-0.25,-1.6,33,46,13,126,0,-126,0.0,180.0,180.0,450000.0,0.0,-450000.0
painl001,Lance Painter,St. Louis Cardinals,CARDS,1,3,2,5,1999,2000,1,0.12,1.62,1.5,212,64,-148,357,72,-285,353.0,583.0,230.0,1025000.0,8600000.0,7575000.0
painp101,Phil Paine,St. Louis Cardinals,CARDS,2,4,2,6,1958,1961,3,12.54,-1.35,-13.89,901,211,-690,3090,605,-2485,156.0,353.0,197.0,0.0,15000.0,15000.0
painp101,Phil Paine,Los Angeles Dodgers,DOGRS,1,3,2,5,1959,1959,0,0.0,0.0,0.0,0,0,0,0,0,0,0.0,0.0,0.0,0.0,0.0,0.0
palar001,Rey Palacios,Detroit Tigers,TIGRS,1,2,1,3,1988,1989,1,-0.33,-0.3,0.03,105,4,-101,125,0,-125,15.0,56.0,41.0,0.0,575000.0,575000.0
palie101,Erv Palica,Brooklyn Dodgers,DOGRS,1,1,2,3,1955,1955,0,2.14,0.69,-1.45,125,39,-86,93,91,-2,858.0,0.0,-858.0,0.0,0.0,0.0
palie101,Erv Palica,Baltimore Orioles,ORLS,1,2,1,3,1960,1961,1,0.0,0.0,0.0,0,0,0,0,0,0,0.0,0.0,0.0,0.0,0.0,0.0
palkd001,Daniel Palka,Arizona Diamondbacks,DBACKS,1,1,1,2,2015,2018,3,0.0,0.47,0.47,0,162,162,0,422,422,0.0,0.0,0.0,0.0,510000.0,510000.0
palld001,Donn Pall,Chicago White Sox,WSOX,1,1,1,2,1993,1993,0,0.28,-0.03,-0.31,16,2,-14,0,1,1,53.0,0.0,-53.0,500000.0,0.0,-500000.0
palmd002,Dean Palmer,Texas Rangers,RNGRS,1,1,1,2,1997,1999,2,2.36,3.01,0.65,201,316,115,845,1298,453,0.0,0.0,0.0,4800000.0,1050000.0,-3750000.0
palme101,Ed Palmquist,Los Angeles Dodgers,DOGRS,1,2,2,4,1961,1961,0,-0.97,0.0,0.97,59,0,-59,114,0,-114,63.0,0.0,-63.0,0.0,0.0,0.0
palme102,Emilio Palmero,Toledo,Toledo,1,2,1,3,1928,1928,0,-1.24,0.0,1.24,94,0,-94,291,0,-291,20.0,0.0,-20.0,0.0,0.0,0.0
palme102,Emilio Palmero,St.Louis Browns,ORLS,1,6,1,7,1921,1921,0,0.0,0.0,0.0,0,0,0,0,0,0,0.0,0.0,0.0,6600.0,0.0,-6600.0
palmj101,Joe Palmisano,Philadelphia Athletics,ATLTCS,3,6,4,10,1931,1936,5,2.31,4.79,2.48,270,523,253,676,1095,419,552.0,1925.0,1373.0,12000.0,6000.0,-6000.0
palml101,Lowell Palmer,Chicago White Sox,WSOX,1,1,1,2,1972,1972,0,0.08,0.0,-0.08,33,0,-33,5,0,-5,104.0,0.0,-104.0,0.0,0.0,0.0
palml101,Lowell Palmer,Cleveland Indians,INDINS,1,1,1,2,1973,1974,1,0.0,-1.15,-1.15,0,19,19,0,0,0,0.0,150.0,150.0,0.0,0.0,0.0
palml101,Lowell Palmer,Philadelphia Phillies,PHILS,1,1,2,3,1971,1971,0,0.0,0.0,0.0,0,0,0,0,0,0,0.0,0.0,0.0,0.0,0.0,0.0
palmm101,Mike Palm,Boston Red Sox,RSOX,1,2,1,3,1950,1950,0,0.0,0.0,0.0,0,0,0,0,0,0,0.0,0.0,0.0,0.0,0.0,0.0
palmr001,Rafael Palmeiro,Chicago Cubs,CUBS,6,8,15,23,1988,1995,7,50.51,3.13,-47.38,2529,1449,-1080,6791,543,-6248,2650.0,3110.0,460.0,1193000.0,707500.0,-485500.0
palys101,Stan Palys,Philadelphia Phillies,PHILS,2,4,4,8,1955,1957,2,8.43,2.22,-6.21,540,413,-127,1547,1258,-289,90.0,0.0,-90.0,15500.0,13500.0,-2000.0
panij001,Jose Paniagua,Seattle Mariners,MARNRS,3,7,6,13,2001,2008,7,8.61,1.58,-7.03,1096,337,-759,200,984,784,2142.0,123.0,-2019.0,1587500.0,4850000.0,3262500.0
panij001,Jose Paniagua,Colorado Rockies,ROCKS,1,1,2,3,2002,2002,0,-0.52,-1.27,-0.75,45,48,3,0,2,2,125.0,78.0,-47.0,0.0,0.0,0.0
panij002,Joe Panik,Toronto Blue Jays,BJAYS,1,2,3,5,2021,2021,0,-1.03,1.51,2.54,53,88,35,134,140,6,0.0,112.0,112.0,100000.0,9675000.0,9575000.0
pankj001,Jim Pankovits,Houston Astros,ASTROS,1,1,1,2,1982,1982,0,0.0,0.0,0.0,0,0,0,0,0,0,0.0,0.0,0.0,0.0,0.0,0.0
pannt001,Thomas Pannone,Cleveland Indians,INDINS,1,2,1,3,2017,2017,0,0.5,0.32,-0.18,52,21,-31,0,0,0,348.0,55.0,-293.0,0.0,3000000.0,3000000.0
pantj101,Jim Panther,Oakland Athletics,ATLTCS,2,3,2,5,1972,1972,0,-1.73,-0.85,0.88,237,13,-224,63,9,-54,1061.0,67.0,-994.0,75000.0,0.0,-75000.0
pantj101,Jim Panther,Texas Rangers,RNGRS,1,1,1,2,1972,1973,1,-1.0,-0.76,0.24,46,86,40,0,347,347,92.0,0.0,-92.0,9900.0,50000.0,40100.0
papej001,Jonathan Papelbon,Philadelphia Phillies,PHILS,2,4,3,7,2015,2020,5,3.07,-0.27,-3.34,151,202,51,2,120,118,680.0,1256.0,576.0,0.0,5113000.0,5113000.0
papif101,Frank Papish,Chicago White Sox,WSOX,11,26,23,49,1948,1963,15,24.59,52.66,28.07,4234,3736,-498,12747,11973,-774,4878.0,2927.0,-1951.0,119500.0,111000.0,-8500.0
papis101,Stan Papi,Houston Astros,ASTROS,1,1,1,2,1973,1973,0,-0.05,-0.29,-0.24,8,15,7,4,18,14,0.0,0.0,0.0,0.0,0.0,0.0
papis101,Stan Papi,St. Louis Cardinals,CARDS,1,1,1,2,1975,1975,0,-0.67,0.0,0.67,80,0,-80,211,0,-211,0.0,0.0,0.0,0.0,0.0,0.0
papis101,Stan Papi,Montreal Expos,NATEX,1,1,1,2,1978,1982,4,-0.34,3.39,3.73,51,191,140,126,144,18,0.0,1323.0,1323.0,0.0,0.0,0.0
papis101,Stan Papi,Boston Red Sox,RSOX,1,2,1,3,1980,1980,0,0.0,1.12,1.12,0,50,50,0,152,152,0.0,0.0,0.0,0.0,0.0,0.0
pappe001,Erik Pappas,Kansas City Royals,ROYALS,1,1,1,2,1992,1992,0,0.0,0.0,0.0,0,0,0,0,0,0,0.0,0.0,0.0,0.0,0.0,0.0
pappm101,Milt Pappas,Baltimore Orioles,ORLS,6,17,17,34,1965,1988,23,25.25,102.26,77.01,1580,4270,2690,1563,10311,8748,8511.0,12795.0,4284.0,757833.0,65400.0,-692433.0
pappm101,Milt Pappas,Cincinnati Reds,REDS,3,5,6,11,1968,1977,9,4.56,11.78,7.22,256,1321,1065,307,585,278,1267.0,4200.0,2933.0,0.0,0.0,0.0
paquc001,Craig Paquette,New York Mets,METS,1,1,1,2,1999,1999,0,0.85,0.26,-0.59,305,42,-263,956,97,-859,0.0,0.0,0.0,0.0,610000.0,610000.0
paref101,Freddy Parent,Boston Red Sox,RSOX,2,2,2,4,1907,1910,3,12.48,1.49,-10.99,591,243,-348,2337,883,-1454,0.0,0.0,0.0,4250.0,0.0,-4250.0
parei001,Isaac Paredes,Chicago Cubs,CUBS,1,3,2,5,2017,2018,1,6.56,1.19,-5.37,523,218,-305,2136,113,-2023,0.0,217.0,217.0,0.0,4700000.0,4700000.0
parej002,Jimmy Paredes,New York Yankees,YANKS,1,2,1,3,2010,2010,0,-0.72,-0.33,0.39,296,37,-259,397,123,-274,275.0,0.0,-275.0,0.0,14500000.0,14500000.0
parem001,Mark Parent,San Diego Padres,PADRS,2,2,2,4,1990,1992,2,-0.03,-0.69,-0.66,3,60,57,1,205,204,0.0,0.0,0.0,190000.0,100000.0,-90000.0
parik001,Kelly Paris,St. Louis Cardinals,CARDS,2,3,2,5,1983,1985,2,-0.43,0.1,0.53,60,16,-44,138,0,-138,19.0,30.0,11.0,0.0,0.0,0.0
parka101,Art Parks,Brooklyn Dodgers,DOGRS,1,3,1,4,1938,1938,0,0.0,-0.02,-0.02,0,54,54,0,147,147,0.0,0.0,0.0,0.0,0.0,0.0
parka101,Art Parks,Brooklyn Dodgers,DOGRS,1,3,1,4,1940,1958,18,0.0,68.5,68.5,0,2166,2166,0,9470,9470,0.0,0.0,0.0,0.0,0.0,0.0
parka102,Ace Parker,Philadelphia Athletics,ATLTCS,1,2,1,3,1938,1939,1,0.0,-0.27,-0.27,0,16,16,0,15,15,0.0,119.0,119.0,1500.0,0.0,-1500.0
parkc001,Clay Parker,Seattle Mariners,MARNRS,4,7,6,13,1987,1995,8,7.57,0.25,-7.32,518,728,210,671,2089,1418,1950.0,271.0,-1679.0,982500.0,1100000.0,117500.0
parkc001,Clay Parker,New York Yankees,YANKS,1,2,1,3,1990,1994,4,1.65,4.46,2.81,34,452,418,0,1510,1510,242.0,0.0,-242.0,800000.0,650000.0,-150000.0
parkc002,Chan Ho Park,Texas Rangers,RNGRS,2,4,2,6,2005,2007,2,-0.69,-1.1,-0.41,135,211,76,263,591,328,547.0,0.0,-547.0,25472409.0,11925000.0,-13547409.0
parkc003,Christian Parker,Montreal Expos,NATEX,1,3,1,4,2000,2001,1,1.49,-0.32,-1.81,57,27,-30,6,21,15,645.0,214.0,-431.0,0.0,0.0,0.0
parkd001,Dave Parker,Cincinnati Reds,REDS,1,1,2,3,1987,2003,16,0.55,38.12,37.57,245,775,530,1011,532,-479,0.0,4990.0,4990.0,1100000.0,0.0,-1100000.0
parkd001,Dave Parker,Milwaukee Brewers,BREWRS,2,2,2,4,1991,1993,2,3.53,-0.67,-4.2,1137,371,-766,4853,1363,-3490,0.0,0.0,0.0,230000.0,0.0,-230000.0
parkf101,Frank Parkinson,Philadelphia Phillies,PHILS,1,2,1,3,1924,1924,0,0.0,0.0,0.0,0,0,0,0,0,0,0.0,0.0,0.0,3000.0,0.0,-3000.0
parkh001,Hoy Jun Park,New York Yankees,YANKS,1,2,1,3,2021,2021,0,-0.22,1.27,1.49,44,30,-14,149,0,-149,0.0,84.0,84.0,0.0,0.0,0.0
parkh101,Harry Parker,St. Louis Cardinals,CARDS,9,16,14,30,1971,1976,5,14.55,3.01,-11.54,1564,430,-1134,3017,530,-2487,3834.0,1012.0,-2822.0,0.0,0.0,0.0
parkh101,Harry Parker,St. Louis Cardinals,CARDS,1,1,1,2,1976,1977,1,0.27,0.0,-0.27,3,0,-3,0,0,0,21.0,0.0,-21.0,0.0,0.0,0.0
parkj001,Jarrod Parker,Arizona Diamondbacks,DBACKS,6,12,12,24,2011,2021,10,55.85,12.58,-43.27,1986,909,-1077,2819,1176,-1643,7668.0,4077.0,-3591.0,13397833.0,3419900.0,-9977933.0
parkr001,Rick Parker,Philadelphia Phillies,PHILS,5,8,9,17,1989,2002,13,6.14,8.58,2.44,1265,1614,349,3340,3565,225,859.0,4310.0,3451.0,1570000.0,1070000.0,-500000.0
parks102,Salty Parker,Detroit Tigers,TIGRS,19,44,45,89,1936,1964,28,49.33,102.41,53.08,4601,5659,1058,11266,13498,2232,8483.0,17035.0,8552.0,157700.0,102900.0,-54800.0
parmr101,Roy Parmelee,New York Giants,GIANTS,1,3,1,4,1935,1947,12,0.93,6.58,5.65,74,650,576,80,2704,2624,660.0,0.0,-660.0,0.0,0.0,0.0
parmr101,Roy Parmelee,St. Louis Cardinals,CARDS,1,2,1,3,1936,1942,6,2.86,15.14,12.28,328,366,38,1111,461,-650,437.0,3473.0,3036.0,0.0,15500.0,15500.0
parnr101,Rube Parnham,Philadelphia Athletics,ATLTCS,2,7,4,11,1917,1920,3,0.98,1.52,0.54,143,229,86,582,916,334,0.0,0.0,0.0,2400.0,0.0,-2400.0
parra001,Andy Parrino,San Diego Padres,PADRS,1,2,2,4,2012,2016,4,-0.78,7.91,8.69,52,195,143,95,168,73,0.0,1566.0,1566.0,481000.0,0.0,-481000.0
parrg001,Gerardo Parra,Arizona Diamondbacks,DBACKS,3,8,6,14,2014,2019,5,22.93,2.58,-20.35,956,182,-774,3750,459,-3291,246.0,591.0,345.0,7450000.0,1044000.0,-6406000.0
parrg001,Gerardo Parra,Milwaukee Brewers,BREWRS,2,3,4,7,2015,2019,4,6.67,8.07,1.4,258,223,-35,1017,218,-799,208.0,1843.0,1635.0,8837500.0,1118900.0,-7718600.0
parrj001,Jeff Parrett,Montreal Expos,NATEX,1,2,1,3,1988,1990,2,-0.06,1.75,1.81,294,125,-169,31,135,104,762.0,1094.0,332.0,250000.0,450000.0,200000.0
parrj001,Jeff Parrett,Philadelphia Phillies,PHILS,1,3,2,5,1990,1996,6,0.28,7.71,7.43,106,447,341,38,1122,1084,145.0,1741.0,1596.0,750000.0,2100000.0,1350000.0
parrj002,Jose Parra,Los Angeles Dodgers,DOGRS,1,4,2,6,1995,1998,3,-0.49,1.39,1.88,829,429,-400,2713,30,-2683,618.0,819.0,201.0,218000.0,4410000.0,4192000.0
parrj003,John Parrish,Baltimore Orioles,ORLS,1,1,1,2,2007,2007,0,-0.07,0.0,0.07,8,0,-8,0,0,0,31.0,0.0,-31.0,575000.0,0.0,-575000.0
parrl001,Lance Parrish,Philadelphia Phillies,PHILS,1,1,1,2,1988,1991,3,7.6,0.0,-7.6,400,0,-400,1540,0,-1540,0.0,0.0,0.0,1000000.0,0.0,-1000000.0
parrl002,Larry Parrish,Montreal Expos,NATEX,4,6,6,12,1982,1992,10,4.42,9.75,5.33,1501,1079,-422,5161,3321,-1840,201.0,164.0,-37.0,415000.0,210000.0,-205000.0
parrm101,Mike Parrott,Baltimore Orioles,ORLS,1,1,2,3,1977,1978,1,1.92,0.0,-1.92,116,0,-116,0,0,0,1472.0,0.0,-1472.0,0.0,0.0,0.0
parrm101,Mike Parrott,Seattle Mariners,MARNRS,1,1,1,2,1982,1982,0,0.0,-0.91,-0.91,0,22,22,0,50,50,0.0,0.0,0.0,0.0,0.0,0.0
parrs001,Steve Parris,Cincinnati Reds,REDS,1,1,2,3,2000,2003,3,0.91,0.0,-0.91,36,0,-36,6,0,-6,543.0,0.0,-543.0,1400000.0,0.0,-1400000.0
parrs101,Sam Parrilla,Philadelphia Phillies,PHILS,4,9,7,16,1970,1984,14,35.07,12.55,-22.52,1678,1480,-198,5343,1739,-3604,1000.0,2166.0,1166.0,0.0,123000.0,123000.0
parrt101,Tom Parrott,Cincinnati Reds,REDS,4,11,5,16,1895,1906,11,8.81,24.47,15.66,1114,1079,-35,4520,3525,-995,393.0,2208.0,1815.0,1500.0,0.0,-1500.0
parsb101,Bill Parsons,Milwaukee Brewers,BREWRS,1,2,1,3,1974,1974,0,0.11,-0.96,-1.07,4,49,45,0,174,174,6.0,0.0,-6.0,0.0,75000.0,75000.0
parsb101,Bill Parsons,St. Louis Cardinals,CARDS,2,4,2,6,1975,1976,1,0.63,-0.25,-0.88,80,116,36,258,190,-68,0.0,0.0,0.0,0.0,0.0,0.0
parst101,Tom Parsons,Pittsburgh Pirates,PIRATS,1,1,1,2,1964,1964,0,0.0,0.0,0.0,0,0,0,0,0,0,0.0,0.0,0.0,0.0,0.0,0.0
parst101,Tom Parsons,New York Mets,METS,3,5,4,9,1965,1983,18,-0.2,16.37,16.57,61,1252,1191,115,4388,4273,0.0,0.0,0.0,0.0,0.0,0.0
partr101,Roy Partee,Boston Red Sox,RSOX,2,8,5,13,1947,1955,8,6.5,21.93,15.43,835,962,127,1487,3127,1640,2844.0,2066.0,-778.0,10000.0,32000.0,22000.0
partr101,Roy Partee,St.Louis Browns,ORLS,38,97,102,199,1948,1988,40,142.11,203.49,61.38,10392,17810,7418,23657,52919,29262,31054.0,19600.0,-11454.0,899583.0,209900.0,-689683.0
parts101,Stan Partenheimer,Boston Red Sox,RSOX,1,1,1,2,1944,1946,2,-0.16,1.31,1.47,16,150,134,3,51,48,40.0,529.0,489.0,0.0,0.0,0.0
pascb102,Ben Paschal,New York Yankees,YANKS,1,3,1,4,1929,1930,1,0.0,0.05,0.05,0,45,45,0,121,121,0.0,0.0,0.0,15000.0,0.0,-15000.0
pascc102,Camilo Pascual,Minnesota Twins,TWINS,2,3,2,5,1966,1968,2,10.51,0.41,-10.1,831,108,-723,1841,6,-1835,1694.0,215.0,-1479.0,90000.0,0.0,-90000.0
pasej101,Johnny Pasek,Detroit Tigers,TIGRS,1,2,1,3,1933,1933,0,0.0,0.0,0.0,0,0,0,0,0,0,0.0,0.0,0.0,2400.0,18667.0,16267.0
pasej101,Johnny Pasek,Philadelphia Athletics,ATLTCS,1,2,2,4,1933,1935,2,3.62,0.35,-3.27,76,161,85,105,502,397,735.0,0.0,-735.0,7500.0,8000.0,500.0
pashl001,Larry Pashnick,Detroit Tigers,TIGRS,1,1,1,2,1983,1985,2,0.1,-0.24,-0.34,13,89,76,0,175,175,115.0,0.0,-115.0,0.0,0.0,0.0
paskd101,Dode Paskert,Cincinnati Reds,REDS,2,6,5,11,1910,1914,4,23.79,7.43,-16.36,1495,715,-780,6220,2571,-3649,283.0,231.0,-52.0,0.0,0.0,0.0
paskd101,Dode Paskert,Philadelphia Phillies,PHILS,1,1,1,2,1917,1931,14,4.03,30.63,26.6,354,1463,1109,1419,5786,4367,0.0,0.0,0.0,4000.0,4000.0,0.0
pasqd001,Dan Pasqua,New York Yankees,YANKS,2,4,3,7,1987,1989,2,7.16,-1.48,-8.64,782,63,-719,2351,14,-2337,594.0,729.0,135.0,247000.0,1140000.0,893000.0
passc101,Claude Passeau,Pittsburgh Pirates,PIRATS,2,5,2,7,1935,1941,6,11.48,3.57,-7.91,470,432,-38,813,1543,730,2406.0,0.0,-2406.0,0.0,0.0,0.0
passc101,Claude Passeau,Philadelphia Phillies,PHILS,4,4,9,13,1939,1946,7,44.18,9.02,-35.16,1135,1038,-97,1735,2532,797,8600.0,3353.0,-5247.0,8000.0,9500.0,1500.0
pastt001,Tyler Pastornicky,Toronto Blue Jays,BJAYS,4,18,13,31,2010,2018,8,25.98,29.42,3.44,2444,1447,-997,6892,4630,-2262,4668.0,4909.0,241.0,11482900.0,44024800.0,32541900.0
patef101,Freddie Patek,Pittsburgh Pirates,PIRATS,3,5,5,10,1970,1974,4,25.46,1.32,-24.14,1582,453,-1129,5382,666,-4716,1881.0,1147.0,-734.0,76500.0,34500.0,-42000.0
patil001,Luis Patino,San Diego Padres,PADRS,1,4,1,5,2020,2020,0,1.51,0.0,-1.51,105,0,-105,277,0,-277,238.0,0.0,-238.0,0.0,7600000.0,7600000.0
pattb001,Bob Patterson,San Diego Padres,PADRS,9,19,22,41,1986,2006,20,12.51,49.91,37.4,3627,4748,1121,10702,15908,5206,1705.0,1706.0,1.0,13757500.0,22894000.0,9136500.0
pattc001,Corey Patterson,Chicago Cubs,CUBS,1,1,2,3,2006,2006,0,7.19,0.0,-7.19,357,0,-357,1343,0,-1343,0.0,0.0,0.0,0.0,0.0,0.0
pattc001,Corey Patterson,Toronto Blue Jays,BJAYS,1,4,4,8,2011,2014,3,0.4,6.43,6.03,344,416,72,89,1599,1510,547.0,15.0,-532.0,4329600.0,3193000.0,-1136600.0
pattc101,Casey Patten,Washington Senators,TWINS,1,1,1,2,1908,1911,3,-0.31,0.2,0.51,2,55,53,1,87,86,9.0,278.0,269.0,0.0,0.0,0.0
pattd001,Danny Patterson,Texas Rangers,RNGRS,3,10,10,20,1999,2013,14,7.41,32.82,25.41,760,2098,1338,1243,6477,5234,821.0,1323.0,502.0,18360260.0,14087500.0,-4272760.0
pattd102,Daryl Patterson,Detroit Tigers,TIGRS,2,2,2,4,1971,1972,1,-0.15,0.0,0.15,8,0,-8,1,0,-1,17.0,0.0,-17.0,18200.0,0.0,-18200.0
patte001,Eric Patterson,Chicago Cubs,CUBS,1,4,2,6,2008,2009,1,13.08,4.54,-8.54,545,124,-421,2047,74,-1973,213.0,718.0,505.0,0.0,6525000.0,6525000.0
patte001,Eric Patterson,Oakland Athletics,ATLTCS,1,1,1,2,2010,2010,0,0.49,0.0,-0.49,45,0,-45,93,0,-93,0.0,0.0,0.0,405000.0,0.0,-405000.0
patte001,Eric Patterson,Boston Red Sox,RSOX,8,26,15,41,2010,2019,9,35.43,29.06,-6.37,2876,1721,-1155,5076,5808,732,4841.0,1908.0,-2933.0,4708000.0,21460000.0,16752000.0
pattj002,Jeff Patterson,Philadelphia Phillies,PHILS,1,2,3,5,1994,2002,8,-0.95,-1.6,-0.65,27,666,639,0,1569,1569,372.0,587.0,215.0,0.0,0.0,0.0
pattj003,Jarrod Patterson,Pittsburgh Pirates,PIRATS,1,1,1,2,2000,2000,0,0.0,-0.6,-0.6,0,16,16,0,2,2,0.0,28.0,28.0,0.0,0.0,0.0
pattj004,John Patterson,Arizona Diamondbacks,DBACKS,1,1,1,2,2004,2005,1,4.39,0.16,-4.23,127,159,32,127,1,-126,1106.0,173.0,-933.0,0.0,0.0,0.0
pattk001,Ken Patterson,New York Yankees,YANKS,1,2,2,4,1987,1988,1,1.62,0.02,-1.6,145,18,-127,0,47,47,649.0,0.0,-649.0,0.0,260000.0,260000.0
pattk001,Ken Patterson,Chicago White Sox,WSOX,1,2,1,3,1992,1993,1,58.16,-2.67,-60.83,1875,257,-1618,7900,1106,-6794,125.0,0.0,-125.0,0.0,0.0,0.0
pattm101,Marty Pattin,Milwaukee Brewers,BREWRS,9,23,22,45,1971,1984,13,35.91,84.88,48.97,2475,4171,1696,6161,14852,8691,10247.0,5331.0,-4916.0,466901.0,45000.0,-421901.0
pattm101,Marty Pattin,Boston Red Sox,RSOX,3,3,5,8,1973,1977,4,7.69,3.41,-4.28,316,73,-243,25,0,-25,2778.0,745.0,-2033.0,65000.0,37500.0,-27500.0
pattm102,Mike Patterson,Oakland Athletics,ATLTCS,1,3,2,5,1981,1983,2,-0.62,1.11,1.73,74,210,136,201,288,87,0.0,1046.0,1046.0,0.0,0.0,0.0
pattr001,Reggie Patterson,Chicago White Sox,WSOX,1,1,1,2,1982,1983,1,0.79,0.0,-0.79,32,0,-32,23,0,-23,191.0,0.0,-191.0,0.0,0.0,0.0
patts002,Spencer Patton,Kansas City Royals,ROYALS,1,1,1,2,2014,2015,1,-0.24,1.35,1.59,83,53,-30,0,0,0,227.0,123.0,-104.0,0.0,1750000.0,1750000.0
patts002,Spencer Patton,Texas Rangers,RNGRS,1,1,1,2,2015,2015,0,-0.48,0.0,0.48,32,0,-32,2,0,-2,64.0,0.0,-64.0,0.0,0.0,0.0
pattt001,Troy Patton,Houston Astros,ASTROS,1,5,1,6,2007,2009,2,11.62,3.81,-7.81,860,316,-544,1797,1340,-457,1330.0,0.0,-1330.0,382000.0,13811415.0,13429415.0
pattt001,Troy Patton,Baltimore Orioles,ORLS,1,1,2,3,2014,2014,0,0.1,0.16,0.06,16,50,34,0,174,174,22.0,0.0,-22.0,0.0,0.0,0.0
pauld001,David Pauley,San Diego Padres,PADRS,1,4,1,5,2004,2006,2,-1.11,5.11,6.22,91,244,153,210,1047,837,85.0,0.0,-85.0,1842500.0,0.0,-1842500.0
pauld001,David Pauley,Boston Red Sox,RSOX,1,1,1,2,2009,2010,1,0.0,0.0,0.0,0,0,0,0,0,0,0.0,0.0,0.0,0.0,0.0,0.0
pauld001,David Pauley,Seattle Mariners,MARNRS,1,2,4,6,2011,2016,5,9.61,3.11,-6.5,89,386,297,9,432,423,1381.0,727.0,-654.0,858500.0,418000.0,-440500.0
pauld002,David Paulino,Detroit Tigers,TIGRS,1,2,1,3,2013,2013,0,-0.35,0.29,0.64,9,28,19,0,0,0,108.0,59.0,-49.0,0.0,0.0,0.0
pauld002,David Paulino,Houston Astros,ASTROS,1,3,1,4,2018,2020,2,2.45,2.96,0.51,92,98,6,0,0,0,254.0,276.0,22.0,4600000.0,5300000.0,700000.0
paulf001,Felipe Paulino,Houston Astros,ASTROS,1,1,1,2,2010,2011,1,-0.44,3.38,3.82,36,123,87,0,495,495,44.0,0.0,-44.0,415000.0,3325000.0,2910000.0
paulg102,Gene Paulette,St. Louis Cardinals,CARDS,1,2,3,5,1919,1926,7,13.87,-0.32,-14.19,461,130,-331,1191,116,-1075,2559.0,705.0,-1854.0,6650.0,3000.0,-3650.0
paulg102,Gene Paulette,Nashville,Nashville,1,1,3,4,1915,1915,0,-0.08,0.0,0.08,17,0,-17,34,0,-34,0.0,0.0,0.0,0.0,1800.0,1800.0
paulj001,Josh Paul,Anaheim Angels,ANGELS,1,1,1,2,2005,2007,2,0.21,0.0,-0.21,93,0,-93,280,0,-280,0.0,0.0,0.0,450000.0,0.0,-450000.0
paulm101,Mike Paul,Cleveland Indians,INDINS,6,11,10,21,1971,1978,7,26.06,8.28,-17.78,1542,586,-956,3690,1786,-1904,2427.0,1183.0,-1244.0,83000.0,120000.0,37000.0
paulm101,Mike Paul,Texas Rangers,RNGRS,2,3,2,5,1973,1975,2,2.88,-0.38,-3.26,60,39,-21,4,118,114,681.0,0.0,-681.0,30000.0,65000.0,35000.0
paulr001,Ronny Paulino,Pittsburgh Pirates,PIRATS,1,1,1,2,2008,2011,3,0.0,-0.81,-0.81,0,119,119,0,366,366,0.0,0.0,0.0,423500.0,0.0,-423500.0
paulr001,Ronny Paulino,Philadelphia Phillies,PHILS,1,1,1,2,2009,2009,0,0.0,-0.18,-0.18,0,47,47,0,2,2,0.0,88.0,88.0,0.0,0.0,0.0
paulr001,Ronny Paulino,San Francisco Giants,GIANTS,1,1,1,2,2009,2009,0,2.09,0.0,-2.09,171,0,-171,610,0,-610,0.0,0.0,0.0,0.0,0.0,0.0
pavac001,Carl Pavano,Boston Red Sox,RSOX,1,2,1,3,1997,2004,7,9.91,53.51,43.6,450,211,-239,430,21,-409,3819.0,4151.0,332.0,0.0,3615000.0,3615000.0
pavac001,Carl Pavano,Montreal Expos,NATEX,2,6,6,12,2002,2005,3,7.25,0.27,-6.98,492,319,-173,648,239,-409,1719.0,1333.0,-386.0,4812500.0,6500000.0,1687500.0
pavac001,Carl Pavano,Cleveland Indians,INDINS,1,1,1,2,2009,2011,2,5.79,0.0,-5.79,93,0,-93,16,0,-16,1739.0,0.0,-1739.0,1500000.0,0.0,-1500000.0
pavld001,Dave Pavlas,Chicago Cubs,CUBS,1,1,1,2,1987,1988,1,0.0,0.17,0.17,0,35,35,0,13,13,0.0,114.0,114.0,0.0,0.0,0.0
pavld101,Don Pavletich,Cincinnati Reds,REDS,2,3,3,6,1968,1970,2,-0.45,-1.78,-1.33,134,68,-66,227,36,-191,164.0,339.0,175.0,21500.0,31000.0,9500.0
pavld101,Don Pavletich,Chicago White Sox,WSOX,6,14,11,25,1969,1979,10,26.57,25.97,-0.6,2286,1751,-535,5123,5926,803,6253.0,2166.0,-4087.0,150950.0,263100.0,112150.0
pavld101,Don Pavletich,Boston Red Sox,RSOX,5,10,10,20,1971,1977,6,35.42,11.92,-23.5,1569,736,-833,4628,2092,-2536,3846.0,2344.0,-1502.0,155000.0,100500.0,-54500.0
paxtj001,James Paxton,Seattle Mariners,MARNRS,1,1,3,4,2018,2018,0,1.84,0.0,-1.84,37,0,-37,8,0,-8,513.0,0.0,-513.0,4900000.0,0.0,-4900000.0
paxtm101,Mike Paxton,Boston Red Sox,RSOX,2,6,3,9,1978,1987,9,14.86,20.93,6.07,699,715,16,1362,2220,858,3997.0,3996.0,-1.0,0.0,0.0,0.0
paytj001,Jay Payton,New York Mets,METS,2,4,3,7,2002,2002,0,4.04,-0.58,-4.62,267,21,-246,904,25,-879,36.0,163.0,127.0,362500.0,1350000.0,987500.0
paytj001,Jay Payton,San Diego Padres,PADRS,1,4,1,5,2004,2006,2,-1.11,5.11,6.22,91,244,153,210,1047,837,85.0,0.0,-85.0,1842500.0,0.0,-1842500.0
paytj001,Jay Payton,Boston Red Sox,RSOX,1,2,1,3,2005,2005,0,3.53,0.44,-3.09,211,31,-180,879,0,-879,0.0,70.0,70.0,3500000.0,0.0,-3500000.0
paytm001,Mark Payton,Oakland Athletics,ATLTCS,1,1,1,2,2020,2020,0,-0.51,0.0,0.51,32,0,-32,44,0,-44,0.0,0.0,0.0,0.0,0.0,0.0
pazim101,Mike Pazik,New York Yankees,YANKS,2,3,2,5,1974,1975,1,-0.48,-0.46,0.02,13,8,-5,0,0,0,140.0,84.0,-56.0,0.0,29000.0,29000.0
pazoj001,James Pazos,New York Yankees,YANKS,2,3,2,5,2016,2017,1,0.79,-0.11,-0.9,173,9,-164,2,2,0,514.0,112.0,-402.0,0.0,0.0,0.0
pazoj001,James Pazos,Seattle Mariners,MARNRS,3,7,5,12,2018,2019,1,12.9,2.05,-10.85,683,65,-618,2542,289,-2253,142.0,0.0,-142.0,17350000.0,37545833.0,20195833.0
pazoj001,James Pazos,Philadelphia Phillies,PHILS,1,1,1,2,2019,2019,0,0.18,0.0,-0.18,30,0,-30,0,0,0,47.0,0.0,-47.0,0.0,0.0,0.0
peacb001,Brad Peacock,Washington Nationals,NATEX,2,6,4,10,2011,2018,7,12.32,19.68,7.36,414,407,-7,1035,430,-605,1666.0,3760.0,2094.0,12000000.0,420000.0,-11580000.0
peacb001,Brad Peacock,Oakland Athletics,ATLTCS,1,3,2,5,2013,2016,3,8.06,4.16,-3.9,776,397,-379,2069,1228,-841,1629.0,325.0,-1304.0,0.0,0.0,0.0
peacj101,Johnny Peacock,Philadelphia Phillies,PHILS,1,1,1,2,1945,1946,1,0.41,-0.26,-0.67,48,29,-19,134,54,-80,0.0,26.0,26.0,0.0,0.0,0.0
peara102,Albie Pearson,Boston Red Sox,RSOX,2,3,2,5,1958,1962,4,0.48,20.28,19.8,432,732,300,1643,3004,1361,0.0,0.0,0.0,0.0,0.0,0.0
peara102,Albie Pearson,Washington Senators,TWINS,2,3,3,6,1959,1966,7,-1.09,5.54,6.63,359,946,587,803,3000,2197,0.0,0.0,0.0,15000.0,0.0,-15000.0
pearf101,Frank Pearce,Nashville,Nashville,1,1,2,3,1933,1934,1,0.43,0.0,-0.43,64,0,-64,38,0,-38,345.0,0.0,-345.0,0.0,0.0,0.0
peari101,Ike Pearson,Chicago White Sox,WSOX,3,5,3,8,1949,1955,6,0.66,10.32,9.66,71,314,243,61,435,374,448.0,2293.0,1845.0,7000.0,0.0,-7000.0
pearj101,Jim Pearce,St. Louis Cardinals,CARDS,1,3,1,4,1956,1960,4,0.0,-0.55,-0.55,0,36,36,0,11,11,0.0,110.0,110.0,0.0,0.0,0.0
pearm101,Monte Pearson,Cleveland Indians,INDINS,1,2,1,3,1935,1940,5,14.33,18.91,4.58,396,307,-89,481,384,-97,3424.0,2789.0,-635.0,0.0,0.0,0.0
pearm101,Monte Pearson,New York Yankees,YANKS,1,1,2,3,1940,1942,2,-0.31,0.0,0.31,15,0,-15,6,0,-6,73.0,0.0,-73.0,13500.0,0.0,-13500.0
pears001,Steve Pearce,Tampa Bay Devil Rays,RAYS,2,2,2,4,2016,2017,1,0.04,0.0,-0.04,38,0,-38,111,0,-111,0.0,0.0,0.0,0.0,535000.0,535000.0
pears001,Steve Pearce,Toronto Blue Jays,BJAYS,1,2,1,3,2018,2018,0,0.48,0.0,-0.48,79,0,-79,264,0,-264,0.0,0.0,0.0,0.0,0.0,0.0
peavj001,Jake Peavy,San Diego Padres,PADRS,2,5,5,10,2009,2013,4,10.78,-0.73,-11.51,527,446,-81,73,939,866,2883.0,2001.0,-882.0,11401300.0,4805000.0,-6596300.0
peavj001,Jake Peavy,Chicago White Sox,WSOX,5,10,11,21,2013,2018,5,6.26,13.31,7.05,575,937,362,573,3743,3170,1595.0,75.0,-1520.0,12535000.0,8075000.0,-4460000.0
peavj001,Jake Peavy,Boston Red Sox,RSOX,2,4,4,8,2014,2020,6,1.72,2.68,0.96,145,269,124,96,1,-95,991.0,809.0,-182.0,5113000.0,0.0,-5113000.0
peckh101,Hal Peck,Chicago Cubs,CUBS,1,2,1,3,1943,1949,6,0.0,5.51,5.51,0,511,511,0,2102,2102,0.0,0.0,0.0,0.0,0.0,0.0
peckh101,Hal Peck,New York Yankees,YANKS,3,10,5,15,1946,1954,8,30.84,1.34,-29.5,1405,374,-1031,2470,260,-2210,6379.0,1746.0,-4633.0,11500.0,10000.0,-1500.0
peckh101,Hal Peck,Milwaukee,Milwaukee,1,1,5,6,1944,1944,0,1.19,0.0,-1.19,162,0,-162,669,0,-669,0.0,0.0,0.0,0.0,3000.0,3000.0
peckr101,Roger Peckinpaugh,Cleveland Indians,INDINS,1,1,2,3,1913,1913,0,32.06,0.21,-31.85,1219,23,-1196,5262,23,-5239,0.0,0.0,0.0,0.0,0.0,0.0
peckr101,Roger Peckinpaugh,New York Yankees,YANKS,4,11,7,18,1921,1946,25,28.58,81.31,52.73,995,2473,1478,1312,4729,3417,7730.0,15194.0,7464.0,42500.0,38450.0,-4050.0
peckr101,Roger Peckinpaugh,Boston Red Sox,RSOX,4,8,12,20,1922,1935,13,30.52,-2.46,-32.98,2375,905,-1470,9488,3403,-6085,0.0,159.0,159.0,16300.0,15750.0,-550.0
peckr101,Roger Peckinpaugh,Washington Senators,TWINS,1,1,2,3,1927,1933,6,1.22,2.1,0.88,68,71,3,246,101,-145,0.0,616.0,616.0,0.0,0.0,0.0
pecob001,Bill Pecota,Kansas City Royals,ROYALS,4,6,8,14,1991,1997,6,19.59,4.26,-15.33,606,997,391,1939,3941,2002,1576.0,52.0,-1524.0,3507500.0,3066667.0,-440833.0
pedej001,Joc Pederson,Chicago Cubs,CUBS,1,1,1,2,2021,2021,0,0.24,0.0,-0.24,64,0,-64,194,0,-194,0.0,0.0,0.0,4500000.0,0.0,-4500000.0
pedra001,Al Pedrique,New York Mets,METS,2,3,3,6,1987,1990,3,0.91,0.12,-0.79,161,49,-112,446,62,-384,0.0,0.0,0.0,0.0,250000.0,250000.0
peelh101,Homer Peel,St. Louis Cardinals,CARDS,2,4,5,9,1928,1936,8,28.36,11.55,-16.81,2032,988,-1044,7440,3573,-3867,0.0,0.0,0.0,0.0,15000.0,15000.0
peelh101,Homer Peel,Philadelphia Phillies,PHILS,1,2,2,4,1929,1933,4,-1.21,0.77,1.98,26,281,255,77,572,495,0.0,0.0,0.0,6000.0,7500.0,1500.0
peerj101,Jack Peerson,Philadelphia Athletics,ATLTCS,1,4,1,5,1937,1940,3,0.0,6.28,6.28,0,278,278,0,321,321,0.0,1514.0,1514.0,0.0,0.0,0.0
pegue001,Elvis Peguero,New York Yankees,YANKS,1,2,2,4,2021,2021,0,-0.41,-0.59,-0.18,7,14,7,0,1,1,56.0,107.0,51.0,0.0,6750000.0,6750000.0
peguj001,Julio Peguero,Pittsburgh Pirates,PIRATS,2,4,2,6,1990,1991,1,3.0,-0.21,-3.21,512,23,-489,1575,37,-1538,0.0,0.0,0.0,925000.0,700000.0,-225000.0
peguj001,Julio Peguero,Philadelphia Phillies,PHILS,1,2,1,3,1992,1992,0,0.0,1.64,1.64,0,74,74,0,313,313,0.0,0.0,0.0,175000.0,715000.0,540000.0
peith101,Heinie Peitz,St. Louis Cardinals,CARDS,5,8,13,21,1895,1899,4,45.5,0.55,-44.95,2073,759,-1314,7733,2872,-4861,1422.0,668.0,-754.0,0.0,1500.0,1500.0
peith101,Heinie Peitz,Cincinnati Reds,REDS,1,1,1,2,1905,1906,1,1.33,-0.05,-1.38,128,56,-72,454,217,-237,0.0,0.0,0.0,0.0,0.0,0.0
pelle101,Eddie Pellagrini,Boston Red Sox,RSOX,2,8,5,13,1947,1955,8,6.5,21.93,15.43,835,962,127,1487,3127,1640,2844.0,2066.0,-778.0,10000.0,32000.0,22000.0
pelle101,Eddie Pellagrini,Philadelphia Phillies,PHILS,3,8,7,15,1951,1957,6,12.59,16.8,4.21,922,1010,88,2813,3409,596,109.0,186.0,77.0,63000.0,37500.0,-25500.0
pembb101,Brock Pemberton,New York Mets,METS,1,2,1,3,1976,1976,0,0.0,0.0,0.0,0,0,0,0,0,0,0.0,0.0,0.0,0.0,0.0,0.0
pembr001,Rudy Pemberton,Texas Rangers,RNGRS,1,1,1,2,1996,1996,0,0.72,0.0,-0.72,40,0,-40,115,0,-115,0.0,0.0,0.0,0.0,0.0,0.0
penaa001,Alejandro Pena,Los Angeles Dodgers,DOGRS,1,2,1,3,1989,1992,3,2.0,2.55,0.55,245,343,98,183,1353,1170,417.0,0.0,-417.0,1975000.0,0.0,-1975000.0
penaa001,Alejandro Pena,New York Mets,METS,7,12,14,26,1991,1999,8,9.37,7.83,-1.54,988,1076,88,691,303,-388,2432.0,3919.0,1487.0,7823000.0,6805000.0,-1018000.0
penaa001,Alejandro Pena,Florida Marlins,MARLNS,1,1,1,2,1995,1997,2,0.1,0.0,-0.1,28,0,-28,0,0,0,39.0,0.0,-39.0,0.0,0.0,0.0
penaa003,Ariel Pena,Anaheim Angels,ANGELS,1,3,1,4,2012,2012,0,4.26,1.47,-2.79,508,13,-495,1945,0,-1945,179.0,268.0,89.0,0.0,13500000.0,13500000.0
penac001,Carlos Pena,Texas Rangers,RNGRS,6,7,11,18,2002,2013,11,4.52,9.79,5.27,476,622,146,1358,1735,377,495.0,2132.0,1637.0,1600000.0,4102400.0,2502400.0
penac001,Carlos Pena,Oakland Athletics,ATLTCS,6,8,9,17,2002,2009,7,16.13,13.6,-2.53,956,906,-50,1909,3247,1338,5469.0,605.0,-4864.0,947000.0,0.0,-947000.0
penae001,Elvis Pena,Colorado Rockies,ROCKS,3,5,5,10,2001,2002,1,3.56,0.31,-3.25,524,189,-335,63,5,-58,907.0,301.0,-606.0,0.0,0.0,0.0
penaf002,Felix Pena,Chicago Cubs,CUBS,1,1,1,2,2017,2017,0,1.79,0.0,-1.79,74,0,-74,8,0,-8,652.0,0.0,-652.0,0.0,0.0,0.0
penah001,Hipolito Pena,Pittsburgh Pirates,PIRATS,1,1,1,2,1988,1989,1,-0.06,-0.23,-0.17,16,36,20,0,53,53,43.0,0.0,-43.0,0.0,0.0,0.0
penaj001,Jim Pena,San Francisco Giants,GIANTS,1,1,1,2,1992,1992,0,0.0,0.0,0.0,0,0,0,0,0,0,0.0,0.0,0.0,0.0,122500.0,122500.0
penaj003,Jesus Pena,Chicago White Sox,WSOX,1,1,1,2,2000,2001,1,0.08,0.0,-0.08,2,0,-2,0,0,0,9.0,0.0,-9.0,0.0,0.0,0.0
penaj003,Jesus Pena,Milwaukee Brewers,BREWRS,3,6,6,12,2002,2008,6,16.9,7.44,-9.46,1386,1058,-328,5417,1627,-3790,210.0,916.0,706.0,9450000.0,13770260.0,4320260.0
penao101,Orlando Pena,Cincinnati Reds,REDS,1,2,1,3,1961,1961,0,0.0,1.5,1.5,0,30,30,0,26,26,0.0,249.0,249.0,0.0,0.0,0.0
penao101,Orlando Pena,Milwaukee Braves,BRAVES,1,1,2,3,1962,1962,0,6.11,0.0,-6.11,202,0,-202,205,0,-205,1684.0,0.0,-1684.0,0.0,0.0,0.0
penao101,Orlando Pena,St. Louis Cardinals,CARDS,1,1,1,2,1974,1974,0,1.0,0.0,-1.0,11,0,-11,0,0,0,62.0,0.0,-62.0,26000.0,0.0,-26000.0
penar101,Roberto Pena,Pittsburgh Pirates,PIRATS,1,2,1,3,1964,1964,0,-0.6,0.0,0.6,57,0,-57,209,0,-209,0.0,0.0,0.0,0.0,0.0,0.0
penar101,Roberto Pena,San Diego Padres,PADRS,1,1,1,2,1970,1970,0,-0.16,-0.13,0.03,19,95,76,62,128,66,0.0,0.0,0.0,0.0,0.0,0.0
penar101,Roberto Pena,Oakland Athletics,ATLTCS,2,2,2,4,1970,1971,1,-0.53,0.26,0.79,234,49,-185,746,99,-647,0.0,17.0,17.0,17000.0,18200.0,1200.0
penat001,Tony Pena,Pittsburgh Pirates,PIRATS,2,4,5,9,1987,1994,7,0.96,41.8,40.84,426,1853,1427,1435,6899,5464,300.0,1043.0,743.0,222500.0,215000.0,-7500.0
penat001,Tony Pena,Chicago White Sox,WSOX,1,1,1,2,1997,1997,0,-0.12,0.0,0.12,9,0,-9,22,0,-22,0.0,0.0,0.0,425000.0,0.0,-425000.0
penat002,Tony Pena,Atlanta Braves,BRAVES,1,1,1,2,2007,2012,5,-1.12,0.0,1.12,288,0,-288,824,0,-824,3.0,0.0,-3.0,0.0,0.0,0.0
penat003,Tony Pena,Arizona Diamondbacks,DBACKS,3,4,4,8,2009,2016,7,1.96,6.64,4.68,231,745,514,165,216,51,736.0,1007.0,271.0,430000.0,1250000.0,820000.0
penaw001,Wily Mo Pena,New York Yankees,YANKS,1,1,2,3,2001,2001,0,-0.57,-0.57,0.0,302,12,-290,898,39,-859,0.0,0.0,0.0,0.0,0.0,0.0
penaw001,Wily Mo Pena,Cincinnati Reds,REDS,1,1,2,3,2006,2013,7,-0.3,19.81,20.11,157,531,374,476,612,136,0.0,5071.0,5071.0,0.0,0.0,0.0
penaw001,Wily Mo Pena,Boston Red Sox,RSOX,2,4,2,6,2007,2009,2,-0.56,0.21,0.77,201,28,-173,531,26,-505,0.0,41.0,41.0,2275000.0,10500000.0,8225000.0
pench001,Hunter Pence,Houston Astros,ASTROS,5,14,14,28,2011,2019,8,28.03,24.13,-3.9,2041,1132,-909,3948,2705,-1243,3599.0,3065.0,-534.0,9612000.0,1012500.0,-8599500.0
pench001,Hunter Pence,Philadelphia Phillies,PHILS,1,1,3,4,2012,2018,6,9.8,-0.71,-10.51,789,286,-503,3151,953,-2198,0.0,0.0,0.0,10400000.0,1300000.0,-9100000.0
pendj101,Jim Pendleton,Brooklyn Dodgers,DOGRS,3,6,5,11,1953,1961,8,18.08,1.43,-16.65,1862,372,-1490,3448,742,-2706,2426.0,1360.0,-1066.0,0.0,0.0,0.0
pendj101,Jim Pendleton,Milwaukee Braves,BRAVES,1,1,1,2,1957,1957,0,0.09,-0.52,-0.61,49,15,-34,75,19,-56,0.0,0.0,0.0,0.0,0.0,0.0
pendj101,Jim Pendleton,Pittsburgh Pirates,PIRATS,9,16,18,34,1959,1973,14,-0.94,37.67,38.61,564,1623,1059,1204,4862,3658,386.0,2327.0,1941.0,17500.0,0.0,-17500.0
pendt001,Terry Pendleton,Florida Marlins,MARLNS,1,1,1,2,1996,1997,1,-1.29,0.0,1.29,42,0,-42,177,0,-177,0.0,0.0,0.0,1625000.0,0.0,-1625000.0
pennb001,Brad Pennington,Baltimore Orioles,ORLS,2,3,3,6,1995,2003,8,-0.43,3.97,4.4,40,156,116,91,49,-42,29.0,2220.0,2191.0,0.0,0.0,0.0
pennb002,Brad Penny,Arizona Diamondbacks,DBACKS,1,3,1,4,1999,2004,5,6.5,2.69,-3.81,696,350,-346,447,0,-447,3453.0,521.0,-2932.0,0.0,735000.0,735000.0
pennb002,Brad Penny,Florida Marlins,MARLNS,10,19,25,44,2004,2019,15,75.87,54.29,-21.58,2478,2882,404,6294,8326,2032,10672.0,5424.0,-5248.0,38568667.0,23298092.0,-15270575.0
pennc001,Cliff Pennington,Oakland Athletics,ATLTCS,1,2,2,4,2012,2013,1,3.02,-0.37,-3.39,236,107,-129,657,375,-282,0.0,0.0,0.0,490000.0,7000000.0,6510000.0
pennc001,Cliff Pennington,Arizona Diamondbacks,DBACKS,2,5,2,7,2015,2017,2,-1.71,2.41,4.12,156,62,-94,515,257,-258,0.0,0.0,0.0,3275000.0,0.0,-3275000.0
pennh001,Hayden Penn,Baltimore Orioles,ORLS,2,2,2,4,2009,2013,4,-1.46,3.07,4.53,61,360,299,87,1223,1136,66.0,0.0,-66.0,1300000.0,0.0,-1300000.0
pennh101,Herb Pennock,Boston Red Sox,RSOX,3,4,6,10,1923,1933,10,33.57,1.13,-32.44,768,605,-163,1134,1820,686,6610.0,765.0,-5845.0,7200.0,7000.0,-200.0
pennw001,Will Pennyfeather,Cincinnati Reds,REDS,1,1,1,2,1996,1998,2,0.0,0.57,0.57,0,208,208,0,569,569,0.0,0.0,0.0,0.0,0.0,0.0
pentg101,Gene Pentz,Detroit Tigers,TIGRS,1,4,3,7,1975,1979,4,4.11,5.38,1.27,431,290,-141,467,862,395,1859.0,1144.0,-715.0,16500.0,0.0,-16500.0
pepij101,Joe Pepitone,New York Yankees,YANKS,3,4,4,8,1969,1973,4,-0.75,-0.45,0.3,283,287,4,735,928,193,22.0,300.0,278.0,70500.0,112750.0,42250.0
pepij101,Joe Pepitone,Chicago Cubs,CUBS,4,4,6,10,1973,1980,7,1.09,6.54,5.45,80,953,873,231,2812,2581,160.0,648.0,488.0,0.0,0.0,0.0
peraf001,Freddy Peralta,Seattle Mariners,MARNRS,1,3,1,4,2015,2016,1,3.41,-0.26,-3.67,178,126,-52,88,430,342,1011.0,0.0,-1011.0,0.0,7500000.0,7500000.0
peraj001,Jhonny Peralta,Cleveland Indians,INDINS,1,2,1,3,2010,2016,6,8.67,0.15,-8.52,460,6,-454,1851,0,-1851,0.0,10.0,10.0,4850000.0,0.0,-4850000.0
peraj002,Joel Peralta,Tampa Bay Devil Rays,RAYS,1,2,2,4,2014,2015,1,0.98,0.23,-0.75,298,5,-293,4,0,-4,353.0,17.0,-336.0,3000000.0,501000.0,-2499000.0
peraj003,Jose Peraza,Atlanta Braves,BRAVES,3,7,11,18,2015,2020,5,4.88,-1.29,-6.17,588,465,-123,687,1320,633,1642.0,246.0,-1396.0,24400000.0,34929500.0,10529500.0
peraj003,Jose Peraza,Los Angeles Dodgers,DOGRS,3,7,6,13,2015,2019,4,7.85,6.19,-1.66,1100,293,-807,3346,616,-2730,1782.0,1084.0,-698.0,0.0,0.0,0.0
perao001,Oswaldo Peraza,Toronto Blue Jays,BJAYS,1,2,1,3,1987,1990,3,-2.03,4.09,6.12,69,76,7,0,0,0,1066.0,1357.0,291.0,0.0,625000.0,625000.0
peraw002,Wandy Peralta,San Francisco Giants,GIANTS,1,2,1,3,2021,2021,0,0.95,0.0,-0.95,52,65,13,0,175,175,128.0,3.0,-125.0,925000.0,0.0,-925000.0
percj001,Jack Perconte,Los Angeles Dodgers,DOGRS,4,5,6,11,1981,1986,5,8.2,1.95,-6.25,273,439,166,478,515,37,1699.0,432.0,-1267.0,1085000.0,435000.0,-650000.0
percj001,Jack Perconte,Cleveland Indians,INDINS,3,4,4,8,1983,1989,6,6.14,3.15,-2.99,575,539,-36,2408,2048,-360,0.0,224.0,224.0,630000.0,0.0,-630000.0
perdh101,Hub Perdue,Boston Braves,BRAVES,2,4,3,7,1914,1917,3,5.43,7.31,1.88,759,506,-253,2372,1961,-411,801.0,0.0,-801.0,0.0,2300.0,2300.0
perdl001,Luis Perdomo,Cleveland Indians,INDINS,1,1,1,2,2008,2011,3,0.0,0.94,0.94,0,15,15,0,1,1,0.0,218.0,218.0,0.0,392500.0,392500.0
perea001,Antonio Perez,Cincinnati Reds,REDS,2,6,3,9,2000,2013,13,18.66,15.9,-2.76,696,1440,744,2678,3953,1275,381.0,721.0,340.0,8282695.0,396000.0,-7886695.0
perea001,Antonio Perez,Seattle Mariners,MARNRS,4,5,5,10,2002,2007,5,13.67,8.92,-4.75,1087,458,-629,4329,1918,-2411,0.0,0.0,0.0,3750000.0,1991000.0,-1759000.0
perea001,Antonio Perez,Tampa Bay Devil Rays,RAYS,1,1,1,2,2004,2004,0,1.24,-0.03,-1.27,111,4,-107,301,8,-293,0.0,0.0,0.0,0.0,0.0,0.0
perea001,Antonio Perez,Los Angeles Dodgers,DOGRS,1,2,1,3,2005,2017,12,0.96,21.5,20.54,172,1455,1283,589,5425,4836,0.0,0.0,0.0,2830000.0,0.0,-2830000.0
pereb001,Beltran Perez,Arizona Diamondbacks,DBACKS,2,6,2,8,2005,2009,4,0.95,0.24,-0.71,303,273,-30,1104,1118,14,0.0,0.0,0.0,10213898.0,0.0,-10213898.0
perec001,Carlos Perez,Montreal Expos,NATEX,3,8,7,15,1998,2004,6,7.97,-4.29,-12.26,909,664,-245,2909,2173,-736,1579.0,285.0,-1294.0,2150000.0,265000.0,-1885000.0
perec002,Chris Perez,St. Louis Cardinals,CARDS,1,2,1,3,2009,2009,0,4.0,0.42,-3.58,311,68,-243,0,262,262,883.0,0.0,-883.0,0.0,5500000.0,5500000.0
perec003,Carlos Perez,Toronto Blue Jays,BJAYS,4,12,6,18,2012,2016,4,10.83,2.99,-7.84,1068,309,-759,3494,605,-2889,904.0,1431.0,527.0,11237500.0,12316000.0,1078500.0
perec003,Carlos Perez,Houston Astros,ASTROS,1,2,1,3,2014,2015,1,3.0,0.42,-2.58,223,73,-150,597,229,-368,587.0,0.0,-587.0,0.0,517500.0,517500.0
perec003,Carlos Perez,Anaheim Angels,ANGELS,1,1,1,2,2018,2018,0,-0.36,0.14,0.5,8,5,-3,22,7,-15,0.0,0.0,0.0,0.0,0.0,0.0
perec004,Cionel Perez,Houston Astros,ASTROS,1,1,1,2,2021,2021,0,-0.48,0.0,0.48,48,0,-48,2,0,-2,72.0,0.0,-72.0,0.0,0.0,0.0
peree001,Eduardo Perez,California Angels,ANGELS,1,1,1,2,1996,1996,0,0.57,0.0,-0.57,208,0,-208,569,0,-569,0.0,0.0,0.0,0.0,0.0,0.0
peree001,Eduardo Perez,Cleveland Indians,INDINS,2,3,2,5,2006,2016,10,0.62,20.22,19.6,182,956,774,661,3995,3334,0.0,0.0,0.0,11750000.0,0.0,-11750000.0
peree002,Eddie Perez,Atlanta Braves,BRAVES,1,1,1,2,2002,2002,0,-0.36,0.0,0.36,42,0,-42,125,0,-125,0.0,0.0,0.0,0.0,0.0,0.0
peref001,Fernando Perez,Tampa Bay Devil Rays,RAYS,3,5,10,15,2011,2018,7,7.14,19.57,12.43,511,809,298,692,1746,1054,1779.0,3357.0,1578.0,0.0,556500.0,556500.0
pereh002,Hector Perez,Houston Astros,ASTROS,1,3,1,4,2018,2020,2,2.45,2.96,0.51,92,98,6,0,0,0,254.0,276.0,22.0,4600000.0,5300000.0,700000.0
pereh002,Hector Perez,Toronto Blue Jays,BJAYS,1,1,1,2,2021,2021,0,0.0,0.0,0.0,0,0,0,0,0,0,0.0,0.0,0.0,0.0,0.0,0.0
perem001,Melido Perez,Kansas City Royals,ROYALS,2,5,3,8,1987,1989,2,6.71,1.86,-4.85,503,45,-458,494,0,-494,4503.0,794.0,-3709.0,62500.0,930000.0,867500.0
perem001,Melido Perez,Chicago White Sox,WSOX,1,3,1,4,1992,1994,2,12.77,-0.22,-12.99,326,200,-126,0,759,759,3273.0,0.0,-3273.0,0.0,0.0,0.0
perem005,Michael Perez,Arizona Diamondbacks,DBACKS,2,3,2,5,2018,2021,3,1.28,-0.96,-2.24,100,134,34,228,7,-221,96.0,270.0,174.0,0.0,0.0,0.0
perem101,Marty Perez,California Angels,ANGELS,1,1,1,2,1970,1970,0,-0.67,0.0,0.67,690,0,-690,2639,0,-2639,0.0,0.0,0.0,7200.0,0.0,-7200.0
perem101,Marty Perez,Atlanta Braves,BRAVES,5,7,13,20,1976,1983,7,20.68,4.17,-16.51,1646,914,-732,6239,1922,-4317,541.0,2701.0,2160.0,480000.0,150000.0,-330000.0
perem101,Marty Perez,San Francisco Giants,GIANTS,1,1,1,2,1977,1981,4,0.02,5.55,5.53,1,514,513,4,1688,1684,0.0,0.0,0.0,0.0,0.0,0.0
perem101,Marty Perez,New York Yankees,YANKS,1,3,1,4,1977,1977,0,-3.76,2.42,6.18,344,31,-313,885,0,-885,78.0,651.0,573.0,0.0,100000.0,100000.0
peren001,Neifi Perez,Colorado Rockies,ROCKS,2,2,4,6,2001,2003,2,0.54,0.24,-0.3,588,89,-499,2468,292,-2176,0.0,28.0,28.0,3550000.0,4001000.0,451000.0
peren001,Neifi Perez,Chicago Cubs,CUBS,1,1,1,2,2006,2011,5,-0.51,0.0,0.51,54,0,-54,141,0,-141,0.0,0.0,0.0,2500000.0,0.0,-2500000.0
pereo001,Odalis Perez,Atlanta Braves,BRAVES,1,3,1,4,2002,2003,1,12.57,11.23,-1.34,452,290,-162,1035,1257,222,2316.0,0.0,-2316.0,0.0,0.0,0.0
pereo001,Odalis Perez,Los Angeles Dodgers,DOGRS,2,5,3,8,2006,2007,1,-0.56,-0.24,0.32,64,85,21,5,67,62,658.0,69.0,-589.0,8750000.0,1700000.0,-7050000.0
pereo002,Oliver Perez,San Diego Padres,PADRS,1,3,1,4,2003,2009,6,19.18,17.35,-1.83,859,833,-26,3184,3689,505,1194.0,0.0,-1194.0,305000.0,8833333.0,8528333.0
pereo002,Oliver Perez,Pittsburgh Pirates,PIRATS,3,5,7,12,2006,2016,10,1.97,9.91,7.94,388,1408,1020,455,3224,2769,1770.0,3210.0,1440.0,14150000.0,818425.0,-13331575.0
pereo002,Oliver Perez,Arizona Diamondbacks,DBACKS,1,1,1,2,2015,2015,0,-0.72,0.0,0.72,25,0,-25,0,0,0,36.0,0.0,-36.0,2500000.0,0.0,-2500000.0
perep001,Pascual Perez,Pittsburgh Pirates,PIRATS,1,2,1,3,1982,1987,5,6.94,8.17,1.23,204,340,136,222,296,74,1805.0,2507.0,702.0,0.0,90000.0,90000.0
perer001,Robert Perez,Seattle Mariners,MARNRS,1,1,1,2,1998,1999,1,-0.92,-0.03,0.89,52,1,-51,110,1,-109,0.0,0.0,0.0,215000.0,0.0,-215000.0
peres001,Santiago Perez,Detroit Tigers,TIGRS,3,5,3,8,1997,2009,12,-1.75,6.44,8.19,380,244,-136,75,32,-43,652.0,3275.0,2623.0,4485000.0,215000.0,-4270000.0
peres001,Santiago Perez,Milwaukee Brewers,BREWRS,1,2,2,4,2000,2001,1,-0.17,-1.16,-0.99,43,82,39,97,8,-89,0.0,184.0,184.0,0.0,230000.0,230000.0
peret001,Tony Perez,Cincinnati Reds,REDS,3,5,4,9,1976,1981,5,8.77,1.11,-7.66,1082,372,-710,1854,353,-1501,1843.0,1635.0,-208.0,85000.0,0.0,-85000.0
peret003,Tomas Perez,Toronto Blue Jays,BJAYS,1,1,2,3,1999,1999,0,0.0,-0.47,-0.47,0,27,27,0,104,104,0.0,0.0,0.0,0.0,0.0,0.0
peret003,Tomas Perez,Los Angeles Dodgers,DOGRS,1,1,1,2,2007,2007,0,0.0,0.0,0.0,0,0,0,0,0,0,0.0,0.0,0.0,0.0,0.0,0.0
peret004,Timo Perez,New York Mets,METS,2,2,2,4,2004,2005,1,-1.71,0.76,2.47,193,28,-165,517,19,-498,105.0,208.0,103.0,0.0,0.0,0.0
perey001,Yorkis Perez,Minnesota Twins,TWINS,2,7,4,11,1987,1989,2,2.19,3.46,1.27,550,289,-261,1650,183,-1467,872.0,1114.0,242.0,103500.0,900000.0,796500.0
perey001,Yorkis Perez,Atlanta Braves,BRAVES,1,2,2,4,1991,1993,2,0.81,1.0,0.19,361,259,-102,26,720,694,723.0,247.0,-476.0,0.0,1040000.0,1040000.0
perey001,Yorkis Perez,Florida Marlins,MARLNS,1,1,1,2,1996,1996,0,0.0,0.0,0.0,0,0,0,0,0,0,0.0,0.0,0.0,187500.0,0.0,-187500.0
perey001,Yorkis Perez,Philadelphia Phillies,PHILS,1,1,1,2,2000,2000,0,-0.27,-0.49,-0.22,65,28,-37,1,0,-1,68.0,42.0,-26.0,0.0,0.0,0.0
perim001,Matt Perisho,Anaheim Angels,ANGELS,1,1,1,2,1997,1997,0,-1.83,0.0,1.83,42,0,-42,4,0,-4,361.0,0.0,-361.0,0.0,0.0,0.0
perim001,Matt Perisho,Texas Rangers,RNGRS,1,1,2,3,2000,2001,1,-0.7,-0.26,0.44,35,6,-29,0,0,0,149.0,17.0,-132.0,220000.0,0.0,-220000.0
perkb001,Broderick Perkins,San Diego Padres,PADRS,1,2,1,3,1982,1984,2,-0.69,2.23,2.92,165,129,-36,273,116,-157,402.0,1000.0,598.0,0.0,0.0,0.0
perkh101,Harry Perkowski,Cincinnati Reds,REDS,2,7,3,10,1954,1960,6,0.48,13.19,12.71,599,458,-141,824,407,-417,733.0,2898.0,2165.0,18000.0,30000.0,12000.0
perrb102,Boyd Perry,Detroit Tigers,TIGRS,1,2,1,3,1941,1946,5,-0.12,-1.38,-1.26,211,88,-123,687,313,-374,0.0,0.0,0.0,0.0,0.0,0.0
perrb103,Bob Perry,California Angels,ANGELS,4,5,4,9,1965,1968,3,0.31,0.94,0.63,412,135,-277,701,312,-389,443.0,0.0,-443.0,0.0,0.0,0.0
perrg001,Gerald Perry,Atlanta Braves,BRAVES,4,6,5,11,1989,1999,10,0.53,8.7,8.17,181,486,305,594,687,93,451.0,1914.0,1463.0,3957333.0,1503000.0,-2454333.0
perrg101,Gaylord Perry,San Francisco Giants,GIANTS,1,2,1,3,1971,1973,2,40.19,-0.73,-40.92,981,92,-889,2877,77,-2800,3392.0,613.0,-2779.0,84000.0,72000.0,-12000.0
perrg101,Gaylord Perry,Cleveland Indians,INDINS,6,8,12,20,1975,1989,14,21.49,50.63,29.14,1345,2557,1212,3843,7581,3738,3489.0,7610.0,4121.0,1675000.0,660000.0,-1015000.0
perrg101,Gaylord Perry,Texas Rangers,RNGRS,1,1,2,3,1978,1978,0,6.57,0.0,-6.57,138,0,-138,186,0,-186,1480.0,0.0,-1480.0,0.0,0.0,0.0
perrg101,Gaylord Perry,San Diego Padres,PADRS,4,8,6,14,1980,1984,4,16.75,2.24,-14.51,1038,424,-614,3623,1747,-1876,529.0,0.0,-529.0,0.0,0.0,0.0
perrg101,Gaylord Perry,Texas Rangers,RNGRS,5,11,12,23,1980,1987,7,9.05,9.46,0.41,696,433,-263,1581,631,-950,2873.0,2813.0,-60.0,1017500.0,331000.0,-686500.0
perrh001,Herbert Perry,Chicago White Sox,WSOX,1,1,1,2,2001,2002,1,1.52,0.0,-1.52,192,0,-192,673,0,-673,0.0,0.0,0.0,975000.0,0.0,-975000.0
perrj001,Jason Perry,Toronto Blue Jays,BJAYS,1,1,1,2,2003,2007,4,0.0,0.24,0.24,0,13,13,0,27,27,0.0,0.0,0.0,0.0,0.0,0.0
perrj001,Jason Perry,Oakland Athletics,ATLTCS,2,2,2,4,2007,2009,2,0.6,3.82,3.22,51,236,185,167,804,637,0.0,0.0,0.0,410000.0,0.0,-410000.0
perrj102,Jim Perry,Cleveland Indians,INDINS,1,1,1,2,1963,1967,4,28.75,6.39,-22.36,756,234,-522,681,180,-501,5649.0,1633.0,-4016.0,0.0,0.0,0.0
perrj102,Jim Perry,Minnesota Twins,TWINS,1,1,2,3,1973,1973,0,3.47,0.39,-3.08,35,10,-25,0,0,0,609.0,155.0,-454.0,0.0,0.0,0.0
perrj102,Jim Perry,Detroit Tigers,TIGRS,1,2,1,3,1974,1975,1,3.2,-0.06,-3.26,44,74,30,0,215,215,869.0,0.0,-869.0,0.0,0.0,0.0
perrj102,Jim Perry,Cleveland Indians,INDINS,3,5,4,9,1975,1976,1,-1.95,0.82,2.77,177,25,-152,203,0,-203,1075.0,430.0,-645.0,68000.0,35000.0,-33000.0
perrp001,Pat Perry,St. Louis Cardinals,CARDS,1,1,1,2,1987,1992,5,0.2,3.8,3.6,48,420,372,2,106,104,108.0,1331.0,1223.0,80000.0,0.0,-80000.0
perrp001,Pat Perry,Cincinnati Reds,REDS,1,2,1,3,1988,1988,0,1.9,-0.23,-2.13,108,21,-87,7,56,49,221.0,0.0,-221.0,132500.0,1383333.0,1250833.0
perrp101,Pol Perritt,St. Louis Cardinals,CARDS,2,6,3,9,1915,1917,2,6.22,3.34,-2.88,339,351,12,336,1359,1023,2915.0,256.0,-2659.0,9800.0,0.0,-9800.0
perrr001,Ryan Perry,Detroit Tigers,TIGRS,1,1,1,2,2011,2012,1,-0.38,-0.24,0.14,14,11,-3,0,0,0,24.0,54.0,30.0,430000.0,0.0,-430000.0
perrr101,Ron Perranoski,Chicago Cubs,CUBS,1,4,1,5,1960,1961,1,14.78,2.04,-12.74,914,260,-654,121,914,793,2300.0,0.0,-2300.0,0.0,0.0,0.0
perrr101,Ron Perranoski,Los Angeles Dodgers,DOGRS,1,3,2,5,1967,1968,1,7.85,0.27,-7.58,924,202,-722,948,467,-481,1656.0,285.0,-1371.0,122000.0,73000.0,-49000.0
perrs101,Scott Perry,Atlanta,Atlanta,1,1,2,3,1918,1933,15,13.2,0.0,-13.2,246,0,-246,312,0,-312,2543.0,0.0,-2543.0,0.0,0.0,0.0
persr001,Robert Person,Cleveland Indians,INDINS,1,1,1,2,1991,1991,0,0.0,0.0,0.0,0,0,0,0,0,0,0.0,0.0,0.0,0.0,0.0,0.0
persr001,Robert Person,Florida Marlins,MARLNS,1,1,1,2,1994,1994,0,0.35,0.0,-0.35,62,0,-62,29,0,-29,305.0,0.0,-305.0,0.0,0.0,0.0
persr001,Robert Person,New York Mets,METS,1,1,2,3,1996,1999,3,-1.7,17.29,18.99,66,476,410,5,2018,2013,533.0,0.0,-533.0,109000.0,6500000.0,6391000.0
persr001,Robert Person,Toronto Blue Jays,BJAYS,4,6,9,15,1999,2001,2,9.12,-0.22,-9.34,292,332,40,290,474,184,2704.0,617.0,-2087.0,8979000.0,1475000.0,-7504000.0
pertb101,Bill Pertica,LosAngeles,LosAngeles,1,1,3,4,1921,1924,3,-0.82,0.0,0.82,147,0,-147,111,0,-111,984.0,0.0,-984.0,0.0,0.0,0.0
perzs101,Stan Perzanowski,Chicago White Sox,WSOX,3,6,6,12,1975,1978,3,1.91,-0.17,-2.08,438,278,-160,1261,1093,-168,251.0,0.0,-251.0,70000.0,0.0,-70000.0
perzs101,Stan Perzanowski,Texas Rangers,RNGRS,1,2,1,3,1976,1977,1,0.0,0.1,0.1,0,4,4,0,0,0,0.0,45.0,45.0,0.0,0.0,0.0
perzs101,Stan Perzanowski,Cleveland Indians,INDINS,1,2,1,3,1977,1977,0,0.0,0.05,0.05,0,50,50,0,154,154,0.0,0.0,0.0,0.0,0.0,0.0
peskj101,Johnny Pesky,Boston Red Sox,RSOX,2,6,6,12,1952,1956,4,8.2,10.1,1.9,1335,867,-468,4777,3045,-1732,507.0,401.0,-106.0,80000.0,40000.0,-40000.0
peskj101,Johnny Pesky,Detroit Tigers,TIGRS,1,1,1,2,1954,1954,0,-0.31,0.0,0.31,49,0,-49,171,0,-171,0.0,0.0,0.0,15000.0,0.0,-15000.0
pestv001,Vinnie Pestano,Cleveland Indians,INDINS,2,4,7,11,2014,2020,6,0.74,12.54,11.8,37,143,106,4,89,85,121.0,1614.0,1493.0,4100000.0,3000000.0,-1100000.0
petar001,Roberto Petagine,Houston Astros,ASTROS,14,30,36,66,1994,2008,14,59.26,31.82,-27.44,4671,6059,1388,11202,15757,4555,6620.0,5977.0,-643.0,31714000.0,14229000.0,-17485000.0
petar001,Roberto Petagine,San Diego Padres,PADRS,1,2,2,4,1996,1996,0,-0.29,0.02,0.31,62,2,-60,131,0,-131,0.0,2.0,2.0,0.0,0.0,0.0
petar001,Roberto Petagine,New York Mets,METS,1,1,1,2,1998,1998,0,0.52,0.0,-0.52,34,0,-34,79,0,-79,0.0,0.0,0.0,0.0,0.0,0.0
petea001,Adam Peterson,Chicago White Sox,WSOX,2,3,4,7,1991,1997,6,-0.66,5.47,6.13,79,723,644,105,2072,1967,199.0,133.0,-66.0,200000.0,0.0,-200000.0
petea002,Adam Peterson,Toronto Blue Jays,BJAYS,2,3,2,5,2005,2010,5,0.24,4.38,4.14,281,377,96,251,964,713,321.0,419.0,98.0,6148500.0,330000.0,-5818500.0
petec002,Chris Petersen,Pittsburgh Pirates,PIRATS,1,1,1,2,2001,2001,0,0.0,0.0,0.0,0,0,0,0,0,0,0.0,0.0,0.0,0.0,0.0,0.0
petec101,Cap Peterson,San Francisco Giants,GIANTS,3,4,3,7,1966,1972,6,-2.2,6.95,9.15,357,389,32,728,341,-387,457.0,2870.0,2413.0,17000.0,24000.0,7000.0
petec101,Cap Peterson,Washington Senators,RNGRS,1,1,1,2,1969,1969,0,-0.29,0.0,0.29,76,0,-76,137,0,-137,0.0,0.0,0.0,0.0,0.0,0.0
peted001,Dillon Peters,Miami Marlins,MARLNS,1,1,1,2,2018,2018,0,-0.28,0.0,0.28,18,0,-18,0,0,0,221.0,0.0,-221.0,1090000.0,0.0,-1090000.0
peted002,Dustin Peterson,San Diego Padres,PADRS,1,4,2,6,2014,2016,2,14.14,4.21,-9.93,618,150,-468,1586,620,-966,1341.0,0.0,-1341.0,0.0,14250000.0,14250000.0
petef101,Fritz Peterson,New York Yankees,YANKS,16,29,28,57,1974,1997,23,45.9,36.13,-9.77,3504,2957,-547,6462,7155,693,12175.0,7546.0,-4629.0,4780000.0,3079500.0,-1700500.0
petef101,Fritz Peterson,Cleveland Indians,INDINS,2,3,3,6,1976,1977,1,0.1,0.05,-0.05,4,50,46,0,154,154,45.0,0.0,-45.0,0.0,0.0,0.0
peteg101,Gary Peters,Chicago White Sox,WSOX,6,14,11,25,1969,1979,10,26.57,25.97,-0.6,2286,1751,-535,5123,5926,803,6253.0,2166.0,-4087.0,150950.0,263100.0,112150.0
petej002,Jace Peterson,San Diego Padres,PADRS,1,4,2,6,2014,2016,2,14.14,4.21,-9.93,618,150,-468,1586,620,-966,1341.0,0.0,-1341.0,0.0,14250000.0,14250000.0
petej101,Jim Peterson,Philadelphia Athletics,ATLTCS,2,4,4,8,1933,1936,3,40.03,8.42,-31.61,1089,278,-811,4170,340,-3830,1354.0,2184.0,830.0,8500.0,7000.0,-1500.0
petej102,John Peters,Philadelphia Phillies,PHILS,4,9,8,17,1922,1936,14,25.37,3.27,-22.1,1352,2052,700,5364,8721,3357,77.0,0.0,-77.0,43100.0,12250.0,-30850.0
petek101,Kent Peterson,Cincinnati Reds,REDS,3,4,4,8,1952,1958,6,0.93,3.9,2.97,451,195,-256,1172,136,-1036,552.0,1210.0,658.0,0.0,0.0,0.0
peter101,Rusty Peters,Albany,Albany,1,1,2,3,1935,1935,0,-0.88,0.0,0.88,163,0,-163,516,0,-516,0.0,0.0,0.0,0.0,0.0,0.0
peter103,Ray Peters,Milwaukee Brewers,BREWRS,4,7,4,11,1971,1976,5,4.46,14.89,10.43,682,733,51,2218,2738,520,335.0,0.0,-335.0,159600.0,25000.0,-134600.0
petes001,Steve Peters,St. Louis Cardinals,CARDS,1,2,1,3,1990,1995,5,0.0,4.64,4.64,0,288,288,0,209,209,0.0,1818.0,1818.0,0.0,0.0,0.0
petes002,Shane Peterson,St. Louis Cardinals,CARDS,1,3,1,4,2009,2016,7,-0.87,23.07,23.94,9,982,973,8,4121,4113,101.0,0.0,-101.0,0.0,13500000.0,13500000.0
petig001,Gregorio Petit,Oakland Athletics,ATLTCS,1,1,1,2,2010,2010,0,0.0,-0.13,-0.13,0,7,7,0,0,0,0.0,33.0,33.0,0.0,0.0,0.0
petig001,Gregorio Petit,Houston Astros,ASTROS,1,1,1,2,2015,2015,0,-0.62,0.0,0.62,20,0,-20,47,0,-47,0.0,0.0,0.0,0.0,0.0,0.0
petiy001,Yusmeiro Petit,New York Mets,METS,1,3,2,5,2005,2009,4,-3.72,4.84,8.56,420,468,48,1504,2023,519,79.0,0.0,-79.0,0.0,4000000.0,4000000.0
petiy001,Yusmeiro Petit,Florida Marlins,MARLNS,2,2,3,5,2007,2007,0,0.94,-1.05,-1.99,224,64,-160,62,40,-22,767.0,357.0,-410.0,3600000.0,2500000.0,-1100000.0
petkm001,Mark Petkovsek,St. Louis Cardinals,CARDS,1,1,1,2,1998,1998,0,2.17,0.0,-2.17,139,0,-139,0,0,0,492.0,0.0,-492.0,475000.0,0.0,-475000.0
petrb001,Ben Petrick,Colorado Rockies,ROCKS,1,1,1,2,2003,2004,1,0.19,0.08,-0.11,43,94,51,129,8,-121,0.0,195.0,195.0,0.0,314000.0,314000.0
petrd001,Dan Petry,Detroit Tigers,TIGRS,1,1,1,2,1987,1989,2,0.47,4.72,4.25,41,248,207,0,1048,1048,572.0,0.0,-572.0,975000.0,400000.0,-575000.0
petrd001,Dan Petry,Detroit Tigers,TIGRS,1,1,1,2,1991,1991,0,-0.06,0.0,0.06,20,0,-20,5,0,-5,73.0,0.0,-73.0,650000.0,0.0,-650000.0
petrd001,Dan Petry,Atlanta Braves,BRAVES,1,1,1,2,1991,1991,0,-0.64,0.0,0.64,13,0,-13,0,0,0,67.0,0.0,-67.0,0.0,0.0,0.0
petrj001,Jake Petricka,Milwaukee Brewers,BREWRS,1,1,1,2,2019,2019,0,0.0,0.0,0.0,0,0,0,0,0,0,0.0,0.0,0.0,0.0,0.0,0.0
pettc101,Charlie Petty,New York Giants,GIANTS,2,6,3,9,1894,1899,5,4.47,33.12,28.65,259,755,496,879,2015,1136,369.0,5250.0,4881.0,0.0,0.0,0.0
pettg001,Gary Pettis,California Angels,ANGELS,1,1,1,2,1987,1989,2,6.22,0.47,-5.75,296,41,-255,1208,0,-1208,0.0,572.0,572.0,400000.0,975000.0,575000.0
pettj101,Joe Pettini,Montreal Expos,NATEX,1,2,1,3,1980,1981,1,-1.01,-0.09,0.92,188,37,-151,392,58,-334,0.0,0.0,0.0,0.0,0.0,0.0
pettj102,Jay Pettibone,Minnesota Twins,TWINS,1,2,1,3,1984,1984,0,0.0,-0.19,-0.19,0,12,12,0,37,37,0.0,0.0,0.0,0.0,0.0,0.0
pettj103,Jesse Petty,Brooklyn Dodgers,DOGRS,1,2,1,3,1928,1934,6,0.53,8.54,8.01,100,434,334,99,1570,1471,677.0,0.0,-677.0,21000.0,12000.0,-9000.0
pevem001,Marty Pevey,St. Louis Cardinals,CARDS,1,1,1,2,1988,1988,0,-0.24,0.0,0.24,13,0,-13,42,0,-42,0.0,0.0,0.0,0.0,0.0,0.0
pezzp101,Pretzel Pezzullo,New York Giants,GIANTS,3,12,5,17,1934,1949,15,8.76,66.74,57.98,1268,2382,1114,4502,9585,5083,296.0,0.0,-296.0,0.0,10500.0,10500.0
pfeff101,Fred Pfeffer,Chicago Cubs,CUBS,1,1,2,3,1892,1892,0,5.85,-0.83,-6.68,367,118,-249,1608,487,-1121,36.0,0.0,-36.0,0.0,0.0,0.0
pfeff102,Big Jeff Pfeffer,Chicago Cubs,CUBS,1,2,1,3,1905,1910,5,1.88,3.49,1.61,264,262,-2,476,905,429,1653.0,0.0,-1653.0,0.0,0.0,0.0
pfeff102,Big Jeff Pfeffer,Chicago Cubs,CUBS,1,2,1,3,1911,1912,1,-1.23,-0.64,0.59,195,54,-141,626,160,-466,292.0,0.0,-292.0,0.0,0.0,0.0
pfefj101,Jeff Pfeffer,Brooklyn Dodgers,DOGRS,1,1,2,3,1921,1921,0,4.34,-0.35,-4.69,209,84,-125,222,117,-105,1768.0,183.0,-1585.0,7500.0,5000.0,-2500.0
pfeib101,Bobby Pfeil,Chicago Cubs,CUBS,2,3,2,5,1965,1966,1,2.3,1.05,-1.25,454,82,-372,65,4,-61,1253.0,197.0,-1056.0,0.0,0.0,0.0
pfeib101,Bobby Pfeil,New York Mets,METS,2,2,2,4,1970,1971,1,0.07,0.0,-0.07,51,0,-51,91,0,-91,0.0,0.0,0.0,0.0,0.0,0.0
pfeib101,Bobby Pfeil,Philadelphia Phillies,PHILS,1,1,1,2,1972,1972,0,0.0,0.0,0.0,0,0,0,0,0,0,0.0,0.0,0.0,0.0,0.0,0.0
pfiej101,Jack Pfiester,Chicago Cubs,CUBS,1,1,1,2,1911,1911,0,0.0,-0.33,-0.33,0,44,44,0,10,10,0.0,161.0,161.0,0.0,0.0,0.0
phamt001,Tommy Pham,St. Louis Cardinals,CARDS,1,2,3,5,2018,2021,3,6.49,-1.04,-7.53,184,57,-127,828,143,-685,0.0,3.0,3.0,570100.0,0.0,-570100.0
phamt001,Tommy Pham,Tampa Bay Devil Rays,RAYS,1,2,3,5,2019,2020,1,7.81,-0.02,-7.83,393,42,-351,1521,139,-1382,2.0,0.0,-2.0,4100000.0,582100.0,-3517900.0
phegj001,Josh Phegley,Chicago White Sox,WSOX,1,4,2,6,2014,2018,4,32.02,0.52,-31.5,1179,80,-1099,4237,2,-4235,1580.0,819.0,-761.0,500000.0,5345000.0,4845000.0
phela101,Art Phelan,Cincinnati Reds,REDS,3,8,5,13,1912,1913,1,9.38,6.71,-2.67,842,270,-572,2287,704,-1583,1567.0,500.0,-1067.0,11280.0,7925.0,-3355.0
phelb101,Babe Phelps,Brooklyn Dodgers,DOGRS,1,4,1,5,1941,1948,7,4.25,10.42,6.17,798,406,-392,2943,1540,-1403,336.0,0.0,-336.0,0.0,0.0,0.0
phelb101,Babe Phelps,Pittsburgh Pirates,PIRATS,1,2,1,3,1943,1946,3,0.0,1.71,1.71,0,302,302,0,1252,1252,0.0,0.0,0.0,0.0,0.0,0.0
pheld001,David Phelps,New York Yankees,YANKS,1,3,3,6,2014,2016,2,8.73,2.98,-5.75,736,115,-621,1879,164,-1715,737.0,839.0,102.0,11541425.0,3267000.0,-8274425.0
pheld001,David Phelps,Miami Marlins,MARLNS,1,1,4,5,2017,2017,0,0.23,0.0,-0.23,11,0,-11,0,0,0,26.0,0.0,-26.0,4600000.0,0.0,-4600000.0
pheld001,David Phelps,Toronto Blue Jays,BJAYS,1,2,1,3,2019,2019,0,0.37,0.0,-0.37,48,0,-48,0,0,0,51.0,0.0,-51.0,2500000.0,0.0,-2500000.0
pheld001,David Phelps,Milwaukee Brewers,BREWRS,1,1,3,4,2020,2020,0,-0.6,0.0,0.6,10,0,-10,0,0,0,23.0,0.0,-23.0,1250000.0,0.0,-1250000.0
phele101,Ed Phelps,Pittsburgh Pirates,PIRATS,1,1,1,2,1905,1905,0,-0.05,0.66,0.71,56,88,32,217,316,99,0.0,0.0,0.0,0.0,0.0,0.0
phelj001,Josh Phelps,Toronto Blue Jays,BJAYS,1,1,1,2,2004,2005,1,0.37,0.08,-0.29,24,14,-10,80,39,-41,0.0,0.0,0.0,342000.0,0.0,-342000.0
phelk001,Ken Phelps,Kansas City Royals,ROYALS,1,1,1,2,1982,1982,0,0.0,-0.75,-0.75,10,20,10,9,0,-9,0.0,115.0,115.0,0.0,0.0,0.0
phelk001,Ken Phelps,Seattle Mariners,MARNRS,1,1,3,4,1988,2001,13,1.01,23.05,22.04,131,1440,1309,342,5828,5486,0.0,0.0,0.0,670000.0,67000.0,-603000.0
phelk001,Ken Phelps,New York Yankees,YANKS,1,1,1,2,1989,1989,0,-0.13,0.0,0.13,43,0,-43,85,0,-85,0.0,0.0,0.0,655000.0,0.0,-655000.0
phelr101,Ray Phelps,Brooklyn Dodgers,DOGRS,1,4,1,5,1933,1933,0,0.0,0.0,0.0,0,0,0,0,0,0,0.0,0.0,0.0,0.0,0.0,0.0
phila001,Andy Phillips,Pittsburgh Pirates,PIRATS,1,1,1,2,2009,2009,0,0.0,0.0,0.0,0,0,0,0,0,0,0.0,0.0,0.0,0.0,0.0,0.0
phila101,Adolfo Phillips,Philadelphia Phillies,PHILS,1,3,2,5,1966,1968,2,66.82,10.77,-56.05,1243,294,-949,2604,327,-2277,8021.0,2661.0,-5360.0,0.0,0.0,0.0
phila101,Adolfo Phillips,Chicago Cubs,CUBS,2,3,3,6,1969,1976,7,1.26,-2.01,-3.27,234,496,262,608,1128,520,0.0,471.0,471.0,0.0,0.0,0.0
philb001,Brandon Phillips,Montreal Expos,NATEX,2,6,6,12,2002,2004,2,48.64,-2.57,-51.21,1323,330,-993,4723,156,-4567,4264.0,874.0,-3390.0,4000000.0,4925000.0,925000.0
philb001,Brandon Phillips,Cleveland Indians,INDINS,3,5,4,9,2006,2013,7,27.67,5.27,-22.4,1754,382,-1372,7163,314,-6849,120.0,883.0,763.0,5500000.0,4750000.0,-750000.0
philb001,Brandon Phillips,Cincinnati Reds,REDS,1,2,2,4,2017,2017,0,1.0,0.0,-1.0,120,0,-120,499,0,-499,0.0,0.0,0.0,0.0,0.0,0.0
philb001,Brandon Phillips,Atlanta Braves,BRAVES,1,1,1,2,2017,2017,0,-0.1,0.0,0.1,24,1,-23,105,1,-104,0.0,0.0,0.0,0.0,0.0,0.0
philb002,Brett Phillips,Houston Astros,ASTROS,1,4,3,7,2015,2017,2,18.89,0.28,-18.61,984,198,-786,1471,487,-984,1823.0,1153.0,-670.0,0.0,512500.0,512500.0
philb002,Brett Phillips,Milwaukee Brewers,BREWRS,1,2,1,3,2018,2019,1,-0.83,3.09,3.92,134,197,63,238,802,564,475.0,0.0,-475.0,0.0,0.0,0.0
philb002,Brett Phillips,Kansas City Royals,ROYALS,1,1,1,2,2020,2020,0,2.69,0.0,-2.69,136,0,-136,317,0,-317,3.0,0.0,-3.0,0.0,0.0,0.0
philb102,Bubba Phillips,Detroit Tigers,TIGRS,5,11,10,21,1955,1961,6,18.52,2.11,-16.41,991,623,-368,1633,1663,30,3228.0,400.0,-2828.0,13200.0,0.0,-13200.0
philb102,Bubba Phillips,Chicago White Sox,WSOX,5,8,10,18,1959,1969,10,11.6,14.81,3.21,1350,938,-412,4415,3667,-748,492.0,12.0,-480.0,77250.0,45000.0,-32250.0
philb102,Bubba Phillips,Cleveland Indians,INDINS,1,1,2,3,1962,1965,3,-1.2,-0.48,0.72,174,28,-146,601,1,-600,0.0,50.0,50.0,0.0,0.0,0.0
phild101,Deacon Phillippe,Louisville Colonels,LS3,1,12,5,17,1899,1900,1,267.1,0.0,-267.1,7388,0,-7388,29004,0,-29004,7568.0,0.0,-7568.0,4350.0,0.0,-4350.0
phild102,Dave Philley,Chicago White Sox,WSOX,37,70,65,135,1951,1971,20,135.72,175.24,39.52,11342,10596,-746,33371,28350,-5021,13927.0,15729.0,1802.0,374250.0,340500.0,-33750.0
phild102,Dave Philley,Philadelphia Athletics,ATLTCS,33,66,65,131,1954,1976,22,95.8,55.95,-39.85,9769,6842,-2927,23736,19563,-4173,12004.0,6285.0,-5719.0,476100.0,606500.0,130400.0
phild102,Dave Philley,Baltimore Orioles,ORLS,20,39,43,82,1956,1988,32,49.21,127.79,78.58,4349,6653,2304,7582,14604,7022,16102.0,17161.0,1059.0,768333.0,153000.0,-615333.0
phild102,Dave Philley,Chicago White Sox,WSOX,1,1,1,2,1957,1961,4,0.01,4.81,4.8,65,397,332,181,984,803,0.0,0.0,0.0,22000.0,0.0,-22000.0
phild102,Dave Philley,Houston Astros,ASTROS,1,1,1,2,1962,1962,0,-0.33,0.0,0.33,38,0,-38,48,0,-48,0.0,0.0,0.0,0.0,0.0,0.0
phild103,Dick Phillips,Milwaukee Braves,BRAVES,1,1,1,2,1960,1960,0,-0.1,0.0,0.1,5,0,-5,4,0,-4,0.0,0.0,0.0,0.0,0.0,0.0
phild104,Dee Phillips,Boston Braves,BRAVES,4,14,5,19,1949,1960,11,7.36,21.56,14.2,1117,1270,153,2487,5255,2768,2162.0,0.0,-2162.0,6600.0,46800.0,40200.0
phile001,Evan Phillips,Atlanta Braves,BRAVES,1,5,2,7,2018,2020,2,0.09,0.72,0.63,63,86,23,4,50,46,357.0,484.0,127.0,0.0,5600000.0,5600000.0
phile102,Eddie Phillips,Pittsburgh Pirates,PIRATS,2,4,2,6,1932,1940,8,-0.39,22.08,22.47,8,680,672,3,632,629,28.0,4937.0,4909.0,7000.0,10000.0,3000.0
philj003,Jason Phillips,New York Mets,METS,1,1,1,2,2005,2005,0,-1.38,-0.11,1.27,121,37,-84,434,30,-404,0.0,273.0,273.0,0.0,0.0,0.0
philj101,Jack Phillips,Pittsburgh Pirates,PIRATS,1,1,2,3,1954,1960,6,0.0,0.0,0.0,0,0,0,0,0,0,0.0,0.0,0.0,0.0,0.0,0.0
philj101,Jack Phillips,Chicago White Sox,WSOX,3,8,6,14,1954,1961,7,23.22,8.09,-15.13,1221,1065,-156,3572,3021,-551,2246.0,488.0,-1758.0,62000.0,80000.0,18000.0
philj101,Jack Phillips,Detroit Tigers,TIGRS,1,1,1,2,1957,1957,0,0.0,-0.28,-0.28,0,8,8,0,15,15,0.0,0.0,0.0,0.0,0.0,0.0
philm101,Mike Phillips,New York Mets,METS,2,2,2,4,1977,1986,9,-0.48,9.55,10.03,271,806,535,634,2119,1485,0.0,507.0,507.0,366667.0,0.0,-366667.0
philm101,Mike Phillips,St. Louis Cardinals,CARDS,9,26,18,44,1980,1992,12,83.63,101.91,18.28,6733,4351,-2382,20851,14642,-6209,6532.0,3025.0,-3507.0,1533333.0,576667.0,-956666.0
philr101,Red Phillips,Detroit Tigers,TIGRS,19,44,45,89,1936,1964,28,49.33,102.41,53.08,4601,5659,1058,11266,13498,2232,8483.0,17035.0,8552.0,157700.0,102900.0,-54800.0
philt001,Tony Phillips,Montreal Expos,NATEX,2,3,2,5,1980,1982,2,-0.4,-0.54,-0.14,65,97,32,74,209,135,0.0,0.0,0.0,0.0,0.0,0.0
philt001,Tony Phillips,San Diego Padres,PADRS,2,4,3,7,1981,1984,3,15.21,2.85,-12.36,959,296,-663,3500,1221,-2279,64.0,0.0,-64.0,0.0,0.0,0.0
philt001,Tony Phillips,Detroit Tigers,TIGRS,4,5,6,11,1995,1998,3,7.72,5.9,-1.82,442,395,-47,1798,1299,-499,0.0,769.0,769.0,2600000.0,1376500.0,-1223500.0
philt001,Tony Phillips,Chicago White Sox,WSOX,1,2,2,4,1997,1997,0,1.15,1.16,0.01,178,151,-27,735,342,-393,0.0,178.0,178.0,2847500.0,1092000.0,-1755500.0
philt001,Tony Phillips,Toronto Blue Jays,BJAYS,2,3,2,5,1998,2002,4,-0.32,0.93,1.25,52,38,-14,229,6,-223,0.0,557.0,557.0,0.0,1400000.0,1400000.0
philt101,Taylor Phillips,Milwaukee Braves,BRAVES,2,5,5,10,1957,1961,4,-0.24,3.65,3.89,692,187,-505,1842,252,-1590,561.0,791.0,230.0,0.0,0.0,0.0
philt101,Taylor Phillips,Chicago Cubs,CUBS,8,14,12,26,1959,1977,18,12.27,42.05,29.78,1026,3112,2086,728,8458,7730,3868.0,5672.0,1804.0,122500.0,47500.0,-75000.0
philt101,Taylor Phillips,Philadelphia Phillies,PHILS,1,2,2,4,1961,1962,1,-0.26,0.0,0.26,97,0,-97,147,0,-147,42.0,0.0,-42.0,0.0,0.0,0.0
philz001,Zach Phillips,Texas Rangers,RNGRS,1,1,2,3,2011,2011,0,0.4,0.0,-0.4,16,0,-16,0,0,0,42.0,0.0,-42.0,0.0,0.0,0.0
philz001,Zach Phillips,Baltimore Orioles,ORLS,1,1,1,2,2016,2016,0,0.18,0.0,-0.18,16,0,-16,0,0,0,20.0,0.0,-20.0,0.0,520000.0,520000.0
phoet101,Tom Phoebus,Baltimore Orioles,ORLS,10,29,24,53,1970,1988,18,23.09,129.53,106.44,2838,6114,3276,6187,12778,6591,10078.0,22814.0,12736.0,733833.0,72500.0,-661333.0
phoet101,Tom Phoebus,Chicago Cubs,CUBS,1,1,1,2,1972,1974,2,0.0,0.0,0.0,0,1,1,0,0,0,0.0,0.0,0.0,0.0,0.0,0.0
phylb101,Bill Phyle,St.Paul,St.Paul,1,1,1,2,1898,1898,0,-0.47,0.0,0.47,27,0,-27,45,0,-45,320.0,0.0,-320.0,0.0,0.0,0.0
phylb101,Bill Phyle,Chicago Cubs,CUBS,2,6,2,8,1900,1902,2,10.49,0.81,-9.68,648,153,-495,2353,607,-1746,0.0,0.0,0.0,0.0,0.0,0.0
phylb101,Bill Phyle,KansasCity,KansasCity,1,1,2,3,1906,1908,2,-0.14,0.0,0.14,22,0,-22,79,0,-79,0.0,0.0,0.0,0.0,0.0,0.0
piatd001,Doug Piatt,Cleveland Indians,INDINS,1,1,1,2,1989,1989,0,0.59,0.0,-0.59,42,0,-42,1,0,-1,104.0,0.0,-104.0,0.0,0.0,0.0
piatd001,Doug Piatt,Montreal Expos,NATEX,2,3,3,6,1992,1996,4,-0.47,0.96,1.43,26,525,499,0,267,267,304.0,701.0,397.0,625000.0,705000.0,80000.0
piazm001,Mike Piazza,Los Angeles Dodgers,DOGRS,9,17,19,36,1998,2017,19,17.97,55.2,37.23,1483,3217,1734,4788,11288,6500,1883.0,2450.0,567.0,29893334.0,36745000.0,6851666.0
piazm001,Mike Piazza,Florida Marlins,MARLNS,13,27,34,61,1998,2019,21,97.88,93.37,-4.51,3713,5399,1686,11493,15928,4435,10493.0,10160.0,-333.0,43044000.0,24494968.0,-18549032.0
piccr001,Rob Picciolo,Oakland Athletics,ATLTCS,1,1,2,3,1982,1985,3,-0.28,-0.85,-0.57,36,52,16,52,0,-52,0.0,614.0,614.0,0.0,0.0,0.0
pichr101,Ron Piche,Milwaukee Braves,BRAVES,6,12,9,21,1964,1968,4,-1.26,1.32,2.58,659,529,-130,866,569,-297,775.0,799.0,24.0,15000.0,25000.0,10000.0
pichr101,Ron Piche,St. Louis Cardinals,CARDS,3,5,6,11,1968,1972,4,-0.84,1.08,1.92,394,109,-285,40,207,167,1007.0,64.0,-943.0,17500.0,12000.0,-5500.0
piciv101,Val Picinich,Philadelphia Athletics,ATLTCS,1,2,1,3,1918,1918,0,0.0,7.48,7.48,0,88,88,0,123,123,0.0,995.0,995.0,0.0,0.0,0.0
piciv101,Val Picinich,Washington Senators,TWINS,1,3,2,5,1923,1930,7,1.13,22.03,20.9,449,1009,560,1547,3473,1926,0.0,543.0,543.0,0.0,0.0,0.0
piciv101,Val Picinich,Cincinnati Reds,REDS,2,2,3,5,1929,1945,16,-0.43,1.02,1.45,187,222,35,496,631,135,0.0,148.0,148.0,0.0,0.0,0.0
pickc101,Clarence Pickrel,Boston Braves,BRAVES,2,5,2,7,1934,1940,6,0.0,6.69,6.69,0,395,395,0,958,958,0.0,2031.0,2031.0,0.0,0.0,0.0
pickc103,Charlie Pick,Philadelphia Athletics,ATLTCS,2,3,2,5,1917,1920,3,3.65,11.88,8.23,385,426,41,1524,1760,236,0.0,0.0,0.0,0.0,0.0,0.0
pickc103,Charlie Pick,Chicago Cubs,CUBS,1,2,1,3,1919,1921,2,5.35,-0.19,-5.54,455,143,-312,1719,569,-1150,0.0,0.0,0.0,4800.0,0.0,-4800.0
picke101,Eddie Pick,Chicago Cubs,CUBS,1,2,1,3,1927,1927,0,0.0,0.0,0.0,0,0,0,0,0,0,0.0,0.0,0.0,3300.0,0.0,-3300.0
picko101,Ollie Pickering,St.Louis Browns,ORLS,1,1,1,2,1907,1907,0,0.17,0.0,-0.17,113,0,-113,408,0,-408,0.0,0.0,0.0,0.0,0.0,0.0
pickr001,Ricky Pickett,Cincinnati Reds,REDS,5,11,7,18,1995,2010,15,11.19,26.95,15.76,438,1436,998,728,5040,4312,2595.0,2089.0,-506.0,13266667.0,6562778.0,-6703889.0
pickr001,Ricky Pickett,San Francisco Giants,GIANTS,1,1,1,2,1998,1998,0,-0.22,-0.44,-0.22,4,43,39,0,100,100,2.0,0.0,-2.0,0.0,450000.0,450000.0
pie-f001,Felix Pie,Chicago Cubs,CUBS,3,4,5,9,2009,2012,3,-4.57,0.86,5.43,594,217,-377,976,3,-973,676.0,339.0,-337.0,1625000.0,0.0,-1625000.0
pieca101,Al Piechota,New York Yankees,YANKS,1,1,1,2,1939,1940,1,-0.83,0.0,0.83,44,0,-44,24,0,-24,186.0,0.0,-186.0,0.0,900.0,900.0
piedj001,Jorge Piedra,Los Angeles Dodgers,DOGRS,1,3,1,4,2000,2000,0,-0.56,-0.49,0.07,24,18,-6,10,13,3,98.0,120.0,22.0,0.0,5737500.0,5737500.0
piera001,A.J. Pierzynski,Minnesota Twins,TWINS,4,5,9,14,2003,2018,15,5.9,32.55,26.65,509,1446,937,2054,2455,401,176.0,5088.0,4912.0,10715000.0,780000.0,-9935000.0
pierb101,Billy Pierce,Detroit Tigers,TIGRS,1,2,1,3,1948,1951,3,48.75,3.7,-45.05,943,253,-690,1127,868,-259,8793.0,0.0,-8793.0,0.0,0.0,0.0
pierb101,Billy Pierce,Chicago White Sox,WSOX,6,7,11,18,1961,1968,7,9.19,14.32,5.13,984,1200,216,811,1186,375,2300.0,2896.0,596.0,31250.0,52000.0,20750.0
pierb103,Bill Piercy,New York Yankees,YANKS,4,11,7,18,1921,1946,25,28.58,81.31,52.73,995,2473,1478,1312,4729,3417,7730.0,15194.0,7464.0,42500.0,38450.0,-4050.0
pierj001,Jeff Pierce,Chicago White Sox,WSOX,1,2,1,3,1993,1993,0,1.84,0.47,-1.37,262,12,-250,17,0,-17,550.0,215.0,-335.0,0.0,3825000.0,3825000.0
pierj002,Juan Pierre,Colorado Rockies,ROCKS,4,7,10,17,2002,2007,5,7.86,3.55,-4.31,711,790,79,2863,2114,-749,329.0,1166.0,837.0,25103543.0,13751000.0,-11352543.0
pierj002,Juan Pierre,Florida Marlins,MARLNS,2,3,6,9,2005,2015,10,2.9,14.84,11.94,193,981,788,780,493,-287,261.0,4952.0,4691.0,3700000.0,0.0,-3700000.0
pierj002,Juan Pierre,Los Angeles Dodgers,DOGRS,3,3,5,8,2009,2013,4,-0.64,-1.32,-0.68,318,88,-230,1445,89,-1356,0.0,372.0,372.0,10000000.0,0.0,-10000000.0
pierj101,Jack Pierce,Atlanta Braves,BRAVES,1,1,1,2,1975,1975,0,-0.17,0.0,0.17,53,0,-53,194,0,-194,0.0,0.0,0.0,0.0,0.0,0.0
pierj102,Jim Piersall,Boston Red Sox,RSOX,1,1,2,3,1958,1965,7,9.68,10.51,0.83,359,942,583,1413,3414,2001,0.0,0.0,0.0,0.0,0.0,0.0
pierj102,Jim Piersall,Cleveland Indians,INDINS,2,2,4,6,1961,1965,4,-1.44,5.39,6.83,179,368,189,651,571,-80,0.0,1913.0,1913.0,0.0,0.0,0.0
pierj102,Jim Piersall,Washington Senators,RNGRS,3,4,4,8,1963,1970,7,-1.02,1.46,2.48,40,173,133,140,535,395,0.0,6.0,6.0,0.0,8000.0,8000.0
pierm101,Marino Pieretti,Washington Senators,TWINS,1,1,1,2,1948,1948,0,-1.13,0.33,1.46,140,46,-94,85,18,-67,708.0,182.0,-526.0,0.0,0.0,0.0
piett101,Tony Piet,Pittsburgh Pirates,PIRATS,1,2,2,4,1933,1939,6,-1.61,11.63,13.24,298,385,87,1097,447,-650,0.0,2051.0,2051.0,0.0,0.0,0.0
piett101,Tony Piet,Chicago White Sox,WSOX,2,4,5,9,1937,1950,13,5.83,16.69,10.86,429,2282,1853,1515,8577,7062,633.0,270.0,-363.0,37500.0,31250.0,-6250.0
piett101,Tony Piet,Detroit Tigers,TIGRS,1,5,1,6,1938,1952,14,0.0,25.69,25.69,0,589,589,0,728,728,0.0,4363.0,4363.0,11000.0,0.0,-11000.0
pignj101,Joe Pignatano,Kansas City Athletics,ATLTCS,11,24,16,40,1961,1976,15,27.21,18.41,-8.8,4303,2226,-2077,9008,5907,-3101,5181.0,1373.0,-3808.0,355600.0,427500.0,71900.0
pilaa101,Al Pilarcik,Kansas City Athletics,ATLTCS,52,112,116,228,1956,1976,20,250.68,149.14,-101.54,20796,15499,-5297,51279,47670,-3609,28842.0,13383.0,-15459.0,673600.0,839000.0,165400.0
pilaa101,Al Pilarcik,Baltimore Orioles,ORLS,4,11,7,18,1961,1973,12,20.55,30.35,9.8,1602,1797,195,5528,6131,603,845.0,306.0,-539.0,72000.0,40300.0,-31700.0
pilaa101,Al Pilarcik,Kansas City Athletics,ATLTCS,19,40,34,74,1961,1976,15,67.84,34.29,-33.55,6835,3922,-2913,16048,11060,-4988,8728.0,3414.0,-5314.0,393100.0,483000.0,89900.0
pilld101,Duane Pillette,New York Yankees,YANKS,2,8,4,12,1950,1954,4,21.38,0.72,-20.66,1235,437,-798,2252,180,-2072,6559.0,1785.0,-4774.0,29000.0,8500.0,-20500.0
pilld101,Duane Pillette,Buffalo,Buffalo,1,1,2,3,1956,1956,0,-0.48,0.0,0.48,40,0,-40,1,0,-1,70.0,0.0,-70.0,0.0,0.0,0.0
pillh101,Herman Pillette,Portland,Portland,4,6,14,20,1921,1926,5,21.37,0.0,-21.37,1173,0,-1173,3235,0,-3235,2921.0,0.0,-2921.0,0.0,9050.0,9050.0
pillk001,Kevin Pillar,Toronto Blue Jays,BJAYS,1,1,3,4,2019,2019,0,0.77,-0.38,-1.15,156,80,-76,628,48,-580,0.0,182.0,182.0,0.0,0.0,0.0
pillk001,Kevin Pillar,Boston Red Sox,RSOX,1,1,1,2,2020,2020,0,0.19,0.0,-0.19,24,0,-24,97,0,-97,0.0,0.0,0.0,4250000.0,0.0,-4250000.0
pimes001,Stolmy Pimentel,Boston Red Sox,RSOX,1,4,2,6,2012,2019,7,7.63,8.07,0.44,566,624,58,6,2223,2217,907.0,22.0,-885.0,521000.0,4100000.0,3579000.0
pinah101,Horacio Pina,Cleveland Indians,INDINS,5,8,7,15,1969,1974,5,5.0,-0.41,-5.41,1218,311,-907,2882,450,-2432,1036.0,482.0,-554.0,104000.0,86000.0,-18000.0
pinah101,Horacio Pina,Texas Rangers,RNGRS,8,20,13,33,1972,1988,16,44.28,39.14,-5.14,2462,2571,109,8647,8729,82,3037.0,4668.0,1631.0,475000.0,205000.0,-270000.0
pinah101,Horacio Pina,Oakland Athletics,ATLTCS,2,4,2,6,1973,1976,3,2.13,1.92,-0.21,1225,275,-950,3070,1015,-2055,720.0,0.0,-720.0,93800.0,195000.0,101200.0
pinah101,Horacio Pina,Chicago Cubs,CUBS,2,2,2,4,1974,1978,4,0.43,0.19,-0.24,11,25,14,0,56,56,35.0,0.0,-35.0,24000.0,0.0,-24000.0
pinam001,Manny Pina,Texas Rangers,RNGRS,1,2,1,3,2009,2009,0,-0.11,0.0,0.11,5,0,-5,17,0,-17,0.0,0.0,0.0,0.0,0.0,0.0
pinam001,Manny Pina,Seattle Mariners,MARNRS,1,1,1,2,2014,2014,0,0.0,0.0,0.0,0,0,0,0,0,0,0.0,0.0,0.0,0.0,0.0,0.0
pinam001,Manny Pina,Detroit Tigers,TIGRS,1,2,1,3,2015,2017,2,6.56,0.31,-6.25,404,95,-309,1209,0,-1209,0.0,251.0,251.0,0.0,3500000.0,3500000.0
pinej001,Joel Pineiro,Boston Red Sox,RSOX,1,2,1,3,2007,2007,0,2.56,0.0,-2.56,145,0,-145,160,0,-160,1279.0,0.0,-1279.0,4000000.0,0.0,-4000000.0
pinel001,Luis Pineda,Detroit Tigers,TIGRS,1,2,1,3,2001,2006,5,1.7,6.8,5.1,135,487,352,357,1976,1619,97.0,0.0,-97.0,4400000.0,3500000.0,-900000.0
pinem001,Michael Pineda,Seattle Mariners,MARNRS,1,2,2,4,2012,2016,4,6.28,-2.3,-8.58,93,246,153,7,800,793,1527.0,405.0,-1122.0,0.0,0.0,0.0
pinil001,Lou Piniella,Washington Senators,RNGRS,13,28,22,50,1964,1988,24,46.51,50.92,4.41,2995,4473,1478,9421,12658,3237,3885.0,7987.0,4102.0,527000.0,241500.0,-285500.0
pinil001,Lou Piniella,Baltimore Orioles,ORLS,1,1,1,2,1966,1966,0,-0.03,0.23,0.26,6,4,-2,6,12,6,0.0,0.0,0.0,0.0,0.0,0.0
pinil001,Lou Piniella,Seattle Pilots,BREWRS,4,6,5,11,1969,1971,2,5.62,1.3,-4.32,913,364,-549,2823,214,-2609,485.0,1100.0,615.0,65500.0,59500.0,-6000.0
pinil001,Lou Piniella,Kansas City Royals,ROYALS,1,2,1,3,1973,1977,4,9.36,0.87,-8.49,1040,79,-961,3577,0,-3577,17.0,554.0,537.0,65000.0,48000.0,-17000.0
pinil001,Lou Piniella,Seattle Mariners,MARNRS,4,5,5,10,2002,2007,5,13.67,8.92,-4.75,1087,458,-629,4329,1918,-2411,0.0,0.0,0.0,3750000.0,1991000.0,-1759000.0
pinoy001,Yohan Pino,Minnesota Twins,TWINS,1,1,1,2,2009,2012,3,0.0,5.79,5.79,0,93,93,0,16,16,0.0,1739.0,1739.0,0.0,1500000.0,1500000.0
pinsv101,Vada Pinson,Cincinnati Reds,REDS,6,7,8,15,1968,1977,9,-0.92,17.59,18.51,1168,1565,397,1712,3004,1292,1648.0,2894.0,1246.0,40000.0,16000.0,-24000.0
pinsv101,Vada Pinson,St. Louis Cardinals,CARDS,3,5,4,9,1969,1971,2,3.51,1.65,-1.86,422,269,-153,1591,1022,-569,18.0,0.0,-18.0,87500.0,15000.0,-72500.0
pinsv101,Vada Pinson,Cleveland Indians,INDINS,8,13,14,27,1971,1984,13,47.87,7.93,-39.94,2666,2447,-219,9920,8254,-1666,38.0,317.0,279.0,169250.0,286600.0,117350.0
pinsv101,Vada Pinson,California Angels,ANGELS,1,1,2,3,1974,1974,0,0.06,-0.65,-0.71,218,13,-205,772,0,-772,0.0,50.0,50.0,0.0,0.0,0.0
pintl101,Lerton Pinto,Philadelphia Phillies,PHILS,1,2,1,3,1924,1924,0,0.0,0.0,0.0,0,0,0,0,0,0,0.0,0.0,0.0,4800.0,0.0,-4800.0
pintr001,Renyel Pinto,Chicago Cubs,CUBS,1,3,1,4,2005,2006,1,14.84,1.99,-12.85,973,162,-811,493,750,257,4940.0,0.0,-4940.0,0.0,3700000.0,3700000.0
pintr002,Ricardo Pinto,Philadelphia Phillies,PHILS,1,1,1,2,2018,2018,0,0.0,0.0,0.0,0,0,0,0,0,0,0.0,0.0,0.0,0.0,0.0,0.0
pipgg101,George Pipgras,Boston Red Sox,RSOX,1,2,2,4,1923,1927,4,9.14,-0.1,-9.24,571,74,-497,688,223,-465,4054.0,0.0,-4054.0,0.0,0.0,0.0
pirej001,Jose Pirela,New York Yankees,YANKS,5,7,7,14,2015,2021,6,10.9,0.28,-10.62,484,104,-380,1389,361,-1028,1135.0,9.0,-1126.0,510000.0,0.0,-510000.0
pirtg101,Gerry Pirtle,New York Yankees,YANKS,1,1,1,2,1976,1976,0,0.0,0.0,0.0,0,0,0,0,0,0,0.0,0.0,0.0,0.0,0.0,0.0
piscm001,Marc Pisciotta,Atlanta Braves,BRAVES,1,1,1,2,1999,1999,0,-0.15,0.0,0.15,8,0,-8,0,0,0,25.0,0.0,-25.0,0.0,0.0,0.0
piscs001,Stephen Piscotty,St. Louis Cardinals,CARDS,1,1,2,3,2017,2020,3,3.05,-0.26,-3.31,361,208,-153,1357,527,-830,0.0,3.0,3.0,1333333.0,0.0,-1333333.0
pisoj101,Jim Pisoni,Baltimore Orioles,ORLS,6,15,10,25,1956,1973,17,20.81,32.2,11.39,1684,2354,670,5686,7591,1905,973.0,480.0,-493.0,72000.0,40300.0,-31700.0
pisoj101,Jim Pisoni,Kansas City Athletics,ATLTCS,50,107,110,217,1957,1976,19,243.41,144.18,-99.23,19841,14910,-4931,49436,46172,-3264,28049.0,12074.0,-15975.0,661100.0,839000.0,177900.0
pitlj101,Jake Pitler,Chattanooga,Chattanooga,1,1,2,3,1917,1921,4,-1.02,0.0,1.02,111,0,-111,439,0,-439,0.0,0.0,0.0,0.0,1200.0,1200.0
pitls101,Skip Pitlock,San Francisco Giants,GIANTS,1,1,2,3,1973,1975,2,0.06,0.0,-0.06,43,0,-43,0,0,0,317.0,0.0,-317.0,0.0,0.0,0.0
pitls101,Skip Pitlock,Chicago White Sox,WSOX,3,6,4,10,1975,1982,7,34.65,31.64,-3.01,1494,1083,-411,4882,3877,-1005,2522.0,716.0,-1806.0,0.0,600000.0,600000.0
pittc001,Chris Pittaro,Detroit Tigers,TIGRS,1,2,1,3,1986,1986,0,-0.73,-0.07,0.66,33,35,2,51,93,42,0.0,0.0,0.0,0.0,0.0,0.0
pittg101,Gaylen Pitts,St. Louis Cardinals,CARDS,1,1,1,2,1971,1972,1,0.3,-0.18,-0.48,28,36,8,50,2,-48,0.0,89.0,89.0,0.0,0.0,0.0
pittg101,Gaylen Pitts,Oakland Athletics,ATLTCS,1,1,1,2,1977,1977,0,0.0,0.27,0.27,0,96,96,0,328,328,0.0,0.0,0.0,0.0,0.0,0.0
pittj001,Joe Pittman,Houston Astros,ASTROS,1,1,1,2,1982,1983,1,0.97,-0.08,-1.05,55,20,-35,129,1,-128,0.0,38.0,38.0,0.0,0.0,0.0
pittj001,Joe Pittman,San Diego Padres,PADRS,1,2,1,3,1983,1984,1,-0.3,-0.1,0.2,17,47,30,23,59,36,0.0,0.0,0.0,0.0,0.0,0.0
pittp101,Pinky Pittenger,Philadelphia Athletics,ATLTCS,2,7,2,9,1923,1927,4,0.0,2.68,2.68,0,472,472,0,1997,1997,0.0,0.0,0.0,12000.0,0.0,-12000.0
pittp101,Pinky Pittenger,Chicago Cubs,CUBS,3,6,4,10,1925,1934,9,0.0,24.69,24.69,0,1007,1007,0,4044,4044,0.0,0.0,0.0,16467.0,0.0,-16467.0
pittp101,Pinky Pittenger,SaltLakeCity,SaltLakeCity,1,1,1,2,1924,1924,0,0.75,0.0,-0.75,59,0,-59,195,0,-195,0.0,0.0,0.0,0.0,0.0,0.0
pittt101,Togie Pittinger,Boston Braves,BRAVES,2,2,3,5,1904,1909,5,4.09,0.38,-3.71,226,435,209,311,954,643,2411.0,3355.0,944.0,0.0,0.0,0.0
piven001,Nick Pivetta,Washington Nationals,NATEX,1,1,2,3,2015,2016,1,0.6,-0.12,-0.72,177,115,-62,120,0,-120,1189.0,176.0,-1013.0,0.0,0.0,0.0
piven001,Nick Pivetta,Philadelphia Phillies,PHILS,1,2,2,4,2020,2020,0,3.19,-0.87,-4.06,36,25,-11,2,0,-2,504.0,67.0,-437.0,0.0,5113000.0,5113000.0
pizaj101,Juan Pizarro,Milwaukee Braves,BRAVES,2,3,3,6,1960,1969,9,11.93,7.0,-4.93,718,403,-315,1624,1494,-130,3308.0,0.0,-3308.0,0.0,14000.0,14000.0
pizaj101,Juan Pizarro,Cincinnati Reds,REDS,1,2,1,3,1960,1963,3,15.36,2.72,-12.64,449,236,-213,454,894,440,3599.0,0.0,-3599.0,0.0,0.0,0.0
pizaj101,Juan Pizarro,Chicago White Sox,WSOX,1,1,1,2,1966,1978,12,-1.1,50.06,51.16,139,965,826,36,349,313,426.0,7574.0,7148.0,26000.0,0.0,-26000.0
pizaj101,Juan Pizarro,Boston Red Sox,RSOX,3,6,6,12,1969,1973,4,5.38,12.96,7.58,1093,699,-394,2374,1115,-1259,1155.0,3166.0,2011.0,26500.0,34500.0,8000.0
pizaj101,Juan Pizarro,California Angels,ANGELS,2,2,2,4,1970,1973,3,0.98,-0.3,-1.28,102,72,-30,70,46,-24,597.0,82.0,-515.0,0.0,30500.0,30500.0
plane101,Eddie Plank,St.Louis Browns,ORLS,31,58,69,127,1918,1952,34,180.6,188.06,7.46,8263,12092,3829,24970,33212,8242,20858.0,35942.0,15084.0,281100.0,235650.0,-45450.0
planp001,Phil Plantier,Boston Red Sox,RSOX,1,1,1,2,1992,1994,2,1.24,0.66,-0.58,298,19,-279,1096,0,-1096,0.0,97.0,97.0,200000.0,150000.0,-50000.0
planp001,Phil Plantier,San Diego Padres,PADRS,6,15,16,31,1994,2006,12,12.56,40.19,27.63,2713,3390,677,9058,12055,2997,712.0,1324.0,612.0,13007500.0,22494000.0,9486500.0
planp001,Phil Plantier,Houston Astros,ASTROS,2,2,3,5,1995,1996,1,2.3,-0.95,-3.25,461,114,-347,186,15,-171,672.0,261.0,-411.0,2000000.0,690000.0,-1310000.0
planp001,Phil Plantier,Detroit Tigers,TIGRS,1,1,2,3,1996,1996,0,-1.09,-0.36,0.73,73,14,-59,263,40,-223,0.0,0.0,0.0,0.0,0.0,0.0
planp001,Phil Plantier,San Diego Padres,PADRS,4,10,11,21,1997,2006,9,5.86,22.51,16.65,827,1744,917,2661,6285,3624,68.0,189.0,121.0,10901680.0,12592500.0,1690820.0
plawk001,Kevin Plawecki,New York Mets,METS,1,1,2,3,2019,2020,1,-0.04,-0.48,-0.44,61,31,-30,174,11,-163,6.0,92.0,86.0,0.0,0.0,0.0
pleib101,Bill Pleis,Orlando,Orlando,1,1,1,2,1956,1956,0,-0.49,0.0,0.49,380,0,-380,58,0,-58,842.0,0.0,-842.0,0.0,0.0,0.0
plesd001,Dan Plesac,Pittsburgh Pirates,PIRATS,3,5,8,13,1996,2007,11,2.44,5.98,3.54,539,1682,1143,911,3950,3039,615.0,1633.0,1018.0,9245000.0,3600000.0,-5645000.0
plesd001,Dan Plesac,Toronto Blue Jays,BJAYS,1,1,2,3,1999,2001,2,0.84,6.98,6.14,187,434,247,1,1364,1363,185.0,379.0,194.0,1500000.0,720000.0,-780000.0
plesd001,Dan Plesac,Toronto Blue Jays,BJAYS,1,1,1,2,2002,2003,1,0.47,1.18,0.71,193,117,-76,0,0,0,169.0,320.0,151.0,2200000.0,245000.0,-1955000.0
plewh101,Herb Plews,New York Yankees,YANKS,7,20,15,35,1956,1970,14,3.04,33.17,30.13,2442,2492,50,6615,5619,-996,2999.0,5239.0,2240.0,115500.0,43000.0,-72500.0
plewh101,Herb Plews,Washington Senators,TWINS,2,3,3,6,1959,1962,3,-0.17,-0.01,0.16,13,300,287,12,852,840,0.0,4.0,4.0,13000.0,0.0,-13000.0
plout001,Trevor Plouffe,Oakland Athletics,ATLTCS,1,2,1,3,2017,2017,0,-0.74,0.0,0.74,42,0,-42,114,0,-114,0.0,0.0,0.0,0.0,0.0,0.0
plumb101,Bill Plummer,Chicago Cubs,CUBS,3,5,3,8,1969,1974,5,-2.15,0.81,2.96,445,387,-58,1077,715,-362,55.0,283.0,228.0,0.0,25000.0,25000.0
plune001,Eric Plunk,New York Yankees,YANKS,3,7,8,15,1984,1993,9,53.43,36.99,-16.44,2484,1135,-1349,8455,3089,-5366,3002.0,2795.0,-207.0,2415000.0,2187766.0,-227234.0
plune001,Eric Plunk,Oakland Athletics,ATLTCS,3,5,4,9,1989,1998,9,13.62,32.12,18.5,801,794,-7,1223,2883,1660,2766.0,771.0,-1995.0,4272766.0,2120000.0,-2152766.0
plune001,Eric Plunk,Cleveland Indians,INDINS,1,1,1,2,1998,1998,0,0.36,0.68,0.32,184,23,-161,2,0,-2,321.0,94.0,-227.0,1800000.0,2500000.0,700000.0
poatr101,Ray Poat,New York Giants,GIANTS,1,2,1,3,1949,1949,0,-0.71,0.46,1.17,25,74,49,18,18,0,108.0,241.0,133.0,0.0,0.0,0.0
pochc001,Colin Poche,Arizona Diamondbacks,DBACKS,1,4,2,6,2018,2019,1,-0.39,-0.4,-0.01,65,72,7,0,272,272,232.0,0.0,-232.0,0.0,0.0,0.0
podbb101,Bud Podbielan,Brooklyn Dodgers,DOGRS,2,2,3,5,1952,1953,1,2.7,0.0,-2.7,278,0,-278,152,0,-152,1491.0,0.0,-1491.0,0.0,6000.0,6000.0
podgj101,Johnny Podgajny,Philadelphia Phillies,PHILS,1,1,1,2,1943,1943,0,-1.01,-1.01,0.0,36,42,6,7,7,0,103.0,108.0,5.0,0.0,0.0,0.0
podgj101,Johnny Podgajny,Pittsburgh Pirates,PIRATS,2,6,4,10,1943,1950,7,26.56,10.14,-16.42,1156,549,-607,3340,925,-2415,3832.0,2198.0,-1634.0,0.0,0.0,0.0
podss001,Scott Podsednik,Texas Rangers,RNGRS,1,2,1,3,1995,1998,3,0.0,3.86,3.86,0,95,95,0,7,7,0.0,1618.0,1618.0,109000.0,1800000.0,1691000.0
podss001,Scott Podsednik,Milwaukee Brewers,BREWRS,2,5,5,10,2004,2008,4,16.9,5.78,-11.12,1386,618,-768,5417,1625,-3792,210.0,270.0,60.0,9450000.0,13770260.0,4320260.0
podss001,Scott Podsednik,Kansas City Royals,ROYALS,2,2,3,5,2010,2011,1,-0.69,-0.45,0.24,39,12,-27,160,39,-121,0.0,0.0,0.0,1650000.0,0.0,-1650000.0
podss001,Scott Podsednik,Boston Red Sox,RSOX,1,2,1,3,2012,2015,3,0.39,1.0,0.61,46,199,153,0,0,0,63.0,597.0,534.0,1075000.0,1795000.0,720000.0
pofaj101,Jimmy Pofahl,Washington Senators,TWINS,1,3,1,4,1943,1943,0,7.97,3.2,-4.77,391,117,-274,1546,505,-1041,0.0,0.0,0.0,0.0,0.0,0.0
pofaj101,Jimmy Pofahl,Minneapolis,Minneapolis,1,1,4,5,1939,1946,7,-2.62,0.0,2.62,225,0,-225,849,0,-849,0.0,0.0,0.0,0.0,2750.0,2750.0
poffj101,John Poff,Milwaukee Brewers,BREWRS,2,2,2,4,1981,1982,1,-0.91,-0.41,0.5,22,42,20,50,112,62,0.0,0.0,0.0,0.0,0.0,0.0
pohot101,Tom Poholsky,St. Louis Cardinals,CARDS,15,35,30,65,1956,1972,16,38.58,60.99,22.41,4144,2647,-1497,9926,7589,-2337,4766.0,5429.0,663.0,32500.0,36000.0,3500.0
pohot101,Tom Poholsky,Chicago Cubs,CUBS,2,2,2,4,1957,1958,1,0.0,-0.27,-0.27,0,14,14,0,1,1,0.0,22.0,22.0,0.0,0.0,0.0
poina101,Aaron Pointer,Houston Astros,ASTROS,1,1,1,2,1968,1969,1,0.0,0.08,0.08,0,10,10,0,17,17,0.0,0.0,0.0,0.0,0.0,0.0
poinj101,Jennings Poindexter,Philadelphia Phillies,PHILS,1,2,1,3,1939,1940,1,0.0,0.32,0.32,0,69,69,0,222,222,0.0,0.0,0.0,3000.0,0.0,-3000.0
polah101,Hugh Poland,New York Giants,GIANTS,1,2,1,3,1943,1947,4,7.61,8.14,0.53,725,472,-253,2750,1521,-1229,0.0,0.0,0.0,0.0,0.0,0.0
polah101,Hugh Poland,Philadelphia Phillies,PHILS,1,2,1,3,1947,1949,2,23.82,-2.12,-25.94,519,88,-431,570,262,-308,4467.0,2.0,-4465.0,0.0,0.0,0.0
polap001,Placido Polanco,St. Louis Cardinals,CARDS,2,4,4,8,2002,2009,7,23.28,30.12,6.84,951,826,-125,3803,3406,-397,107.0,0.0,-107.0,7000000.0,8600000.0,1600000.0
polap001,Placido Polanco,Philadelphia Phillies,PHILS,1,1,2,3,2005,2005,0,19.15,-0.18,-19.33,632,143,-489,2819,65,-2754,0.0,157.0,157.0,4600000.0,5025000.0,425000.0
polic001,Cliff Politte,St. Louis Cardinals,CARDS,1,3,2,5,1998,1999,1,3.97,-0.62,-4.59,475,133,-342,1012,3,-1009,549.0,220.0,-329.0,8470000.0,2385000.0,-6085000.0
polic001,Cliff Politte,Philadelphia Phillies,PHILS,1,1,1,2,2002,2002,0,1.18,-0.14,-1.32,117,78,-39,0,0,0,320.0,69.0,-251.0,245000.0,2200000.0,1955000.0
polig001,Gus Polidor,California Angels,ANGELS,1,1,1,2,1988,1990,2,-0.54,-0.07,0.47,97,59,-38,201,203,2,0.0,0.0,0.0,97000.0,372500.0,275500.0
polig001,Gus Polidor,Milwaukee Brewers,BREWRS,1,1,1,2,1991,1991,0,0.0,0.0,0.0,0,0,0,0,0,0,0.0,0.0,0.0,0.0,0.0,0.0
pollh101,Howie Pollet,St. Louis Cardinals,CARDS,3,10,5,15,1951,1954,3,10.75,2.71,-8.04,1144,382,-762,2713,1234,-1479,1601.0,388.0,-1213.0,41500.0,63500.0,22000.0
pollh101,Howie Pollet,Pittsburgh Pirates,PIRATS,7,12,15,27,1953,1962,9,9.43,3.47,-5.96,1075,1271,196,3095,3842,747,1449.0,56.0,-1393.0,86000.0,33500.0,-52500.0
poloj101,John Poloni,Texas Rangers,RNGRS,1,2,1,3,1977,1981,4,0.0,11.05,11.05,0,121,121,0,0,0,0.0,2436.0,2436.0,0.0,200000.0,200000.0
polol001,Luis Polonia,Oakland Athletics,ATLTCS,3,5,4,9,1989,1998,9,13.62,32.12,18.5,801,794,-7,1223,2883,1660,2766.0,771.0,-1995.0,4272766.0,2120000.0,-2152766.0
polol001,Luis Polonia,New York Yankees,YANKS,1,1,2,3,1990,1993,3,2.38,0.54,-1.84,560,153,-407,2347,83,-2264,0.0,698.0,698.0,200000.0,675000.0,475000.0
polol001,Luis Polonia,New York Yankees,YANKS,1,1,1,2,1995,1995,0,-0.18,0.0,0.18,50,0,-50,90,0,-90,0.0,0.0,0.0,1500000.0,0.0,-1500000.0
pomed001,Drew Pomeranz,Cleveland Indians,INDINS,1,4,1,5,2011,2013,2,-0.32,1.97,2.29,204,79,-125,247,10,-237,813.0,1274.0,461.0,0.0,2800000.0,2800000.0
pomed001,Drew Pomeranz,Colorado Rockies,ROCKS,1,2,2,4,2013,2014,1,1.75,1.05,-0.7,79,16,-63,0,15,15,465.0,130.0,-335.0,0.0,5750000.0,5750000.0
pomed001,Drew Pomeranz,Oakland Athletics,ATLTCS,4,8,5,13,2015,2018,3,5.93,2.94,-2.99,610,354,-256,992,1020,28,691.0,108.0,-583.0,4517500.0,2983333.0,-1534167.0
pomed001,Drew Pomeranz,San Diego Padres,PADRS,2,2,2,4,2016,2021,5,3.84,-0.19,-4.03,77,34,-43,3,54,51,949.0,0.0,-949.0,0.0,1000000.0,1000000.0
pomed001,Drew Pomeranz,San Francisco Giants,GIANTS,1,2,1,3,2019,2019,0,0.99,0.61,-0.38,83,28,-55,2,109,107,130.0,0.0,-130.0,1500000.0,0.0,-1500000.0
pomoj101,John Pomorski,Montreal,Montreal,1,1,2,3,1933,1939,6,-0.02,0.0,0.02,6,0,-6,0,0,0,5.0,0.0,-5.0,0.0,6000.0,6000.0
poncc002,Cody Ponce,Milwaukee Brewers,BREWRS,1,1,1,2,2019,2019,0,-0.72,1.85,2.57,35,21,-14,7,22,15,166.0,176.0,10.0,0.0,2050000.0,2050000.0
ponde101,Elmer Ponder,Pittsburgh Pirates,PIRATS,1,1,1,2,1921,1922,1,-0.64,1.12,1.76,32,60,28,35,252,217,268.0,0.0,-268.0,4250.0,5086.0,836.0
ponde101,Elmer Ponder,Chicago Cubs,CUBS,2,8,5,13,1921,1926,5,29.39,11.6,-17.79,1120,351,-769,4097,694,-3403,1929.0,2961.0,1032.0,13500.0,18700.0,5200.0
ponss001,Sidney Ponson,Baltimore Orioles,ORLS,1,1,3,4,2003,2005,2,0.88,-1.54,-2.42,20,20,0,25,0,-25,204.0,251.0,47.0,4250000.0,1852000.0,-2398000.0
poolh101,Harlin Pool,Oakland,Oakland,1,1,2,3,1934,1934,0,0.38,0.0,-0.38,127,0,-127,457,0,-457,0.0,0.0,0.0,0.0,0.0,0.0
poolj001,Jim Poole,Los Angeles Dodgers,DOGRS,1,2,2,4,1990,1990,0,-0.03,0.0,0.03,6,0,-6,0,0,0,18.0,0.0,-18.0,0.0,0.0,0.0
poolj001,Jim Poole,Cleveland Indians,INDINS,1,2,1,3,1996,1996,0,-1.36,0.64,2.0,243,38,-205,9,156,147,316.0,0.0,-316.0,500000.0,1000000.0,500000.0
poolj101,Jim Poole,Portland,Portland,2,3,5,8,1925,1926,1,0.46,0.0,-0.46,300,0,-300,1041,0,-1041,63.0,0.0,-63.0,0.0,4850.0,4850.0
pop-z001,Zach Pop,Los Angeles Dodgers,DOGRS,1,5,1,6,2018,2018,0,-0.21,2.49,2.7,29,66,37,41,296,255,217.0,0.0,-217.0,0.0,16000000.0,16000000.0
pop-z001,Zach Pop,Arizona Diamondbacks,DBACKS,1,1,1,2,2020,2021,1,0.06,0.0,-0.06,95,0,-95,2,0,-2,164.0,0.0,-164.0,0.0,0.0,0.0
poped101,Dave Pope,Cleveland Indians,INDINS,9,17,16,33,1955,1968,13,100.62,38.17,-62.45,4524,2758,-1766,15556,10180,-5376,4502.0,562.0,-3940.0,0.0,32000.0,32000.0
poped101,Dave Pope,Baltimore Orioles,ORLS,1,1,1,2,1956,1956,0,-0.47,0.41,0.88,25,48,23,72,138,66,0.0,0.0,0.0,0.0,0.0,0.0
poped101,Dave Pope,Cleveland Indians,INDINS,1,2,1,3,1958,1960,2,0.0,0.48,0.48,0,12,12,0,2,2,0.0,27.0,27.0,0.0,0.0,0.0
popop101,Paul Popovich,Chicago Cubs,CUBS,3,4,3,7,1967,1973,6,1.48,-0.34,-1.82,258,333,75,792,861,69,0.0,8.0,8.0,37250.0,0.0,-37250.0
popop101,Paul Popovich,Los Angeles Dodgers,DOGRS,1,2,2,4,1969,1979,10,17.55,18.66,1.11,718,1264,546,2642,4042,1400,0.0,0.0,0.0,0.0,0.0,0.0
popop101,Paul Popovich,Montreal Expos,NATEX,1,1,2,3,1969,1971,2,-1.66,1.57,3.23,384,150,-234,1079,474,-605,0.0,0.0,0.0,0.0,0.0,0.0
popop101,Paul Popovich,Chicago Cubs,CUBS,1,1,2,3,1974,1976,2,-0.31,-0.35,-0.04,84,112,28,134,49,-85,0.0,471.0,471.0,0.0,0.0,0.0
poqut101,Tom Poquette,Kansas City Royals,ROYALS,1,1,1,2,1979,1979,0,0.0,0.0,0.0,66,44,-22,172,162,-10,0.0,0.0,0.0,0.0,200000.0,200000.0
porcr001,Rick Porcello,Detroit Tigers,TIGRS,6,9,11,20,2014,2019,5,30.16,14.63,-15.53,1425,689,-736,1837,924,-913,5391.0,1331.0,-4060.0,32215000.0,18056000.0,-14159000.0
porea001,Aaron Poreda,Chicago White Sox,WSOX,6,14,12,26,2009,2018,9,7.16,22.73,15.57,991,1029,38,935,3763,2828,4825.0,1688.0,-3137.0,13340000.0,19075000.0,5735000.0
porta101,Arnie Portocarrero,Kansas City Athletics,ATLTCS,2,2,3,5,1958,1963,5,1.35,5.09,3.74,304,388,84,195,561,366,1819.0,1969.0,150.0,0.0,0.0,0.0
portb102,Bob Porterfield,New York Yankees,YANKS,1,3,1,4,1951,1954,3,18.48,1.84,-16.64,407,209,-198,444,108,-336,3513.0,1042.0,-2471.0,11500.0,0.0,-11500.0
portb102,Bob Porterfield,Washington Senators,TWINS,7,16,14,30,1955,1963,8,11.54,-1.9,-13.44,1150,1625,475,3478,3777,299,832.0,1792.0,960.0,17500.0,14000.0,-3500.0
portd001,Darrell Porter,Milwaukee Brewers,BREWRS,3,4,6,10,1976,1986,10,23.16,4.69,-18.47,1350,684,-666,3618,973,-2645,1204.0,2526.0,1322.0,487500.0,0.0,-487500.0
portd101,Dick Porter,Baltimore,Baltimore,1,1,1,2,1928,1928,0,7.88,0.0,-7.88,596,0,-596,2556,0,-2556,0.0,0.0,0.0,0.0,0.0,0.0
portd101,Dick Porter,Cleveland Indians,INDINS,3,6,5,11,1934,1940,6,24.33,10.74,-13.59,727,766,39,1921,2878,957,2729.0,210.0,-2519.0,10500.0,14250.0,3750.0
portj101,JW Porter,Chicago White Sox,WSOX,8,14,15,29,1952,1969,17,11.54,36.17,24.63,1591,2618,1027,4750,8911,4161,1710.0,1860.0,150.0,87250.0,45000.0,-42250.0
portj101,JW Porter,St.Louis Browns,ORLS,23,54,54,108,1952,1988,36,77.35,153.48,76.13,5159,9163,4004,10679,26116,15437,18423.0,15654.0,-2769.0,825833.0,138400.0,-687433.0
portj101,JW Porter,Detroit Tigers,TIGRS,3,4,5,9,1958,1968,10,1.32,14.68,13.36,168,713,545,243,528,285,332.0,3536.0,3204.0,0.0,0.0,0.0
portj101,JW Porter,Cleveland Indians,INDINS,5,9,8,17,1958,1965,7,17.68,1.46,-16.22,1632,479,-1153,4130,1716,-2414,3556.0,132.0,-3424.0,7500.0,10500.0,3000.0
portm001,Mark Portugal,Minnesota Twins,TWINS,1,1,1,2,1988,1988,0,10.65,0.0,-10.65,271,0,-271,282,0,-282,2347.0,0.0,-2347.0,68800.0,0.0,-68800.0
portm001,Mark Portugal,San Francisco Giants,GIANTS,3,5,8,13,1995,1998,3,9.99,0.74,-9.25,311,256,-55,447,555,108,1958.0,96.0,-1862.0,5827778.0,4116667.0,-1711111.0
porzm001,Mike Porzio,Atlanta Braves,BRAVES,1,2,1,3,1998,1998,0,1.03,0.19,-0.84,187,28,-159,2,49,47,290.0,0.0,-290.0,0.0,735000.0,735000.0
posal101,Leo Posada,Kansas City Athletics,ATLTCS,1,2,1,3,1962,1965,3,0.0,6.11,6.11,0,202,202,0,205,205,0.0,1684.0,1684.0,0.0,0.0,0.0
poseb102,Bill Posedel,Brooklyn Dodgers,DOGRS,3,5,4,9,1939,1949,10,0.18,4.06,3.88,452,709,257,1041,2346,1305,1618.0,101.0,-1517.0,10000.0,12500.0,2500.0
poseb102,Bill Posedel,Portland,Portland,1,1,1,2,1936,1936,0,0.0,0.0,0.0,0,0,0,0,0,0,0.0,0.0,0.0,0.0,0.0,0.0
poses001,Scott Pose,Cleveland Indians,INDINS,1,1,1,2,1996,1996,0,0.0,0.0,0.0,0,0,0,0,0,0,0.0,0.0,0.0,0.0,0.0,0.0
postw101,Wally Post,Cincinnati Reds,REDS,5,8,12,20,1957,1965,8,66.28,13.33,-52.95,3412,1144,-2268,10935,1792,-9143,2563.0,1487.0,-1076.0,0.0,0.0,0.0
postw101,Wally Post,Philadelphia Phillies,PHILS,1,3,2,5,1960,1968,8,5.52,24.2,18.68,336,1274,938,998,4678,3680,0.0,0.0,0.0,0.0,0.0,0.0
potel001,Lou Pote,San Francisco Giants,GIANTS,1,1,1,2,1995,1995,0,0.0,-0.63,-0.63,0,10,10,0,1,1,0.0,15.0,15.0,0.0,420000.0,420000.0
pottm101,Mike Potter,St. Louis Cardinals,CARDS,1,1,1,2,1978,1979,1,0.0,0.0,0.0,0,0,0,0,0,0,0.0,0.0,0.0,0.0,0.0,0.0
pottn101,Nellie Pott,Cleveland Indians,INDINS,1,5,1,6,1922,1935,13,0.0,5.93,5.93,0,850,850,0,2604,2604,0.0,0.0,0.0,0.0,0.0,0.0
pounb001,Brooks Pounders,Pittsburgh Pirates,PIRATS,2,3,2,5,2011,2012,1,-0.43,-0.15,0.28,21,29,8,31,56,25,38.0,0.0,-38.0,483000.0,0.0,-483000.0
pounb001,Brooks Pounders,Kansas City Royals,ROYALS,1,1,1,2,2016,2016,0,-0.4,0.0,0.4,11,0,-11,0,0,0,31.0,0.0,-31.0,0.0,0.0,0.0
pounb101,Bill Pounds,Brooklyn Dodgers,DOGRS,1,4,1,5,1903,1908,5,0.0,0.0,0.0,0,0,0,0,0,0,0.0,0.0,0.0,0.0,0.0,0.0
povsm001,Max Povse,Atlanta Braves,BRAVES,2,3,3,6,2016,2021,5,-0.2,0.58,0.78,48,74,26,123,266,143,45.0,0.0,-45.0,0.0,0.0,0.0
powea001,Alonzo Powell,San Francisco Giants,GIANTS,1,2,1,3,1985,1986,1,-0.44,0.85,1.29,34,78,44,46,40,-6,26.0,424.0,398.0,0.0,0.0,0.0
powea001,Alonzo Powell,Montreal Expos,NATEX,2,2,2,4,1989,1990,1,-0.44,0.0,0.44,37,13,-24,75,11,-64,0.0,0.0,0.0,0.0,200000.0,200000.0
poweb001,Brian Powell,Detroit Tigers,TIGRS,3,10,6,16,1999,2002,3,3.62,7.62,4.0,1493,652,-841,3797,1742,-2055,861.0,1164.0,303.0,6750000.0,3640000.0,-3110000.0
poweb002,Boog Powell,Oakland Athletics,ATLTCS,7,12,9,21,2015,2018,3,7.5,-0.52,-8.02,615,193,-422,2031,464,-1567,103.0,312.0,209.0,8300001.0,4800000.0,-3500001.0
poweb002,Boog Powell,Tampa Bay Devil Rays,RAYS,2,5,4,9,2015,2018,3,-0.11,7.04,7.15,74,689,615,124,2370,2246,283.0,211.0,-72.0,508800.0,3779600.0,3270800.0
poweb002,Boog Powell,Seattle Mariners,MARNRS,1,1,1,2,2017,2017,0,0.63,0.38,-0.25,36,42,6,117,150,33,0.0,0.0,0.0,0.0,4000000.0,4000000.0
poweb101,Boog Powell,Baltimore Orioles,ORLS,2,3,3,6,1975,1980,5,6.5,4.24,-2.26,389,566,177,845,1795,950,1484.0,0.0,-1484.0,0.0,0.0,0.0
powed001,Dennis Powell,Los Angeles Dodgers,DOGRS,2,5,4,9,1986,1992,6,10.4,9.71,-0.69,399,1157,758,1,1800,1799,4543.0,1247.0,-3296.0,1249500.0,1342653.0,93153.0
powed002,Dante Powell,San Francisco Giants,GIANTS,2,3,2,5,1998,2001,3,-0.48,0.32,0.8,61,300,239,28,1,-27,102.0,416.0,314.0,2400000.0,0.0,-2400000.0
powed002,Dante Powell,Arizona Diamondbacks,DBACKS,1,1,1,2,1999,2000,1,0.0,0.0,0.0,0,0,0,0,0,0,0.0,0.0,0.0,200000.0,210000.0,10000.0
poweg101,Grover Powell,Cincinnati Reds,REDS,1,1,1,2,1969,1969,0,0.0,0.0,0.0,0,1,1,0,1,1,0.0,0.0,0.0,0.0,0.0,0.0
poweh101,Hosken Powell,Minnesota Twins,TWINS,1,1,1,2,1981,1983,2,-0.81,-0.5,0.31,152,15,-137,369,57,-312,0.0,0.0,0.0,0.0,0.0,0.0
powej001,Jay Powell,Baltimore Orioles,ORLS,1,1,1,2,1994,1995,1,0.41,1.09,0.68,359,90,-269,10,288,278,587.0,0.0,-587.0,0.0,302500.0,302500.0
powej001,Jay Powell,Florida Marlins,MARLNS,1,2,1,3,1998,2004,6,1.89,0.02,-1.87,314,207,-107,3,531,528,517.0,0.0,-517.0,320000.0,0.0,-320000.0
powej001,Jay Powell,Houston Astros,ASTROS,1,1,1,2,2001,2001,0,0.67,-0.38,-1.05,75,60,-15,0,15,15,116.0,204.0,88.0,1600000.0,2800000.0,1200000.0
powej103,John Powers,Pittsburgh Pirates,PIRATS,9,16,18,34,1959,1973,14,-0.94,37.67,38.61,564,1623,1059,1204,4862,3658,386.0,2327.0,1941.0,17500.0,0.0,-17500.0
powej103,John Powers,Cleveland Indians,INDINS,2,2,3,5,1960,1960,0,0.09,0.16,0.07,26,66,40,61,203,142,0.0,0.0,0.0,0.0,0.0,0.0
powej105,Jack Powell,St.Louis Browns,ORLS,1,1,2,3,1904,1904,0,2.89,6.7,3.81,168,70,-98,224,122,-102,1776.0,899.0,-877.0,0.0,0.0,0.0
powej106,Jake Powell,Washington Senators,TWINS,4,5,6,11,1936,1942,6,11.3,17.7,6.4,990,1163,173,3744,4158,414,623.0,1269.0,646.0,39500.0,36000.0,-3500.0
powem103,Mike Powers,Cleveland Indians,INDINS,1,1,1,2,1931,1934,3,0.0,-0.09,-0.09,0,30,30,0,3,3,0.0,69.0,69.0,0.0,0.0,0.0
powep102,Paul Powell,Minnesota Twins,TWINS,2,2,2,4,1971,1976,5,-0.13,7.05,7.18,90,577,487,294,2325,2031,0.0,0.0,0.0,0.0,9600.0,9600.0
power001,Ross Powell,Cincinnati Reds,REDS,3,4,4,8,1994,2003,9,-0.82,7.3,8.12,166,906,740,133,2361,2228,172.0,625.0,453.0,1650000.0,275000.0,-1375000.0
power101,Ray Powell,Boston Braves,BRAVES,2,3,2,5,1923,1926,3,-0.57,0.9,1.47,238,272,34,860,1042,182,0.0,0.0,0.0,6000.0,0.0,-6000.0
powet001,Ted Power,Los Angeles Dodgers,DOGRS,1,1,2,3,1982,1982,0,7.16,0.0,-7.16,699,0,-699,134,0,-134,2159.0,0.0,-2159.0,0.0,0.0,0.0
powet001,Ted Power,Cincinnati Reds,REDS,1,2,2,4,1987,1990,3,6.27,5.43,-0.84,546,156,-390,2022,182,-1840,241.0,1481.0,1240.0,580000.0,325000.0,-255000.0
powet001,Ted Power,Kansas City Royals,ROYALS,1,1,2,3,1988,1990,2,-0.3,-0.33,-0.03,4,105,101,0,125,125,56.0,15.0,-41.0,575000.0,0.0,-575000.0
powev101,Vic Power,New York Yankees,YANKS,16,45,38,83,1953,1970,17,48.62,78.17,29.55,7017,4726,-2291,22732,11340,-11392,3607.0,11554.0,7947.0,313000.0,125500.0,-187500.0
powev101,Vic Power,Kansas City Athletics,ATLTCS,24,48,46,94,1958,1976,18,124.94,48.67,-76.27,9659,5527,-4132,26702,16658,-10044,8728.0,3973.0,-4755.0,440600.0,542000.0,101400.0
powev101,Vic Power,Cleveland Indians,INDINS,6,8,11,19,1962,1969,7,9.88,8.16,-1.72,1353,584,-769,1625,332,-1293,4119.0,3147.0,-972.0,97100.0,125000.0,27900.0
powev101,Vic Power,Minnesota Twins,TWINS,1,2,2,4,1964,1966,2,-1.17,-1.3,-0.13,231,246,15,550,644,94,0.0,0.0,0.0,15000.0,0.0,-15000.0
powev101,Vic Power,Los Angeles Angels,ANGELS,3,4,4,8,1964,1968,4,0.22,4.09,3.87,228,285,57,232,375,143,443.0,1270.0,827.0,24000.0,0.0,-24000.0
pozoa001,Arquimedez Pozo,Seattle Mariners,MARNRS,1,1,1,2,1996,1996,0,-0.49,-0.31,0.18,25,21,-4,79,63,-16,0.0,0.0,0.0,0.0,200000.0,200000.0
pradm001,Martin Prado,Atlanta Braves,BRAVES,4,10,11,21,2013,2019,6,22.68,8.16,-14.52,2194,1203,-991,6430,4358,-2072,1394.0,147.0,-1247.0,14250000.0,0.0,-14250000.0
pradm001,Martin Prado,Arizona Diamondbacks,DBACKS,2,2,3,5,2014,2017,3,2.1,-0.53,-2.63,37,36,-1,137,79,-58,0.0,0.0,0.0,0.0,0.0,0.0
pradm001,Martin Prado,New York Yankees,YANKS,1,3,3,6,2014,2016,2,8.73,2.98,-5.75,736,115,-621,1879,164,-1715,737.0,839.0,102.0,11541425.0,3267000.0,-8274425.0
pralw101,Willie Prall,San Francisco Giants,GIANTS,2,3,2,5,1974,1980,6,-1.53,2.73,4.26,105,488,383,148,1551,1403,126.0,0.0,-126.0,0.0,0.0,0.0
pramj101,Johnny Pramesa,Cincinnati Reds,REDS,10,20,25,45,1951,1965,14,82.49,29.43,-53.06,4608,2904,-1704,14725,6918,-7807,2749.0,1517.0,-1232.0,76250.0,75500.0,-750.0
prata001,Andy Pratt,Texas Rangers,RNGRS,1,1,1,2,2002,2004,2,-0.03,0.02,0.05,2,2,0,0,0,0,4.0,30.0,26.0,0.0,0.0,0.0
prata001,Andy Pratt,Atlanta Braves,BRAVES,2,5,3,8,2004,2013,9,-3.3,26.82,30.12,86,573,487,55,584,529,235.0,4935.0,4700.0,370000.0,5000000.0,4630000.0
prata001,Andy Pratt,Chicago Cubs,CUBS,1,2,1,3,2004,2004,0,0.0,0.08,0.08,0,15,15,0,19,19,0.0,0.0,0.0,300000.0,700000.0,400000.0
pratd101,Del Pratt,St.Louis Browns,ORLS,31,58,69,127,1918,1952,34,180.6,188.06,7.46,8263,12092,3829,24970,33212,8242,20858.0,35942.0,15084.0,281100.0,235650.0,-45450.0
pratd101,Del Pratt,New York Yankees,YANKS,4,8,10,18,1920,1931,11,18.87,48.71,29.84,1297,1673,376,4337,4022,-315,1020.0,6917.0,5897.0,44500.0,41500.0,-3000.0
pratd101,Del Pratt,Boston Red Sox,RSOX,5,10,13,23,1922,1937,15,16.16,24.39,8.23,675,750,75,1305,1574,269,3851.0,4650.0,799.0,45550.0,18500.0,-27050.0
pratt001,Todd Pratt,New York Mets,METS,2,2,2,4,2001,2001,0,1.8,0.0,-1.8,331,1,-330,1126,1,-1125,0.0,0.0,0.0,600000.0,237500.0,-362500.0
prenm101,Mike Prendergast,Chicago Cubs,CUBS,1,3,2,5,1917,1926,9,1.4,43.04,41.64,84,484,400,105,724,619,802.0,5642.0,4840.0,5000.0,12500.0,7500.0
presa001,Alex Presley,Pittsburgh Pirates,PIRATS,1,2,1,3,2013,2013,0,-0.24,-0.03,0.21,28,25,-3,122,92,-30,0.0,0.0,0.0,0.0,0.0,0.0
presb101,Bobby Prescott,San Francisco Giants,GIANTS,1,1,1,2,1961,1961,0,-0.31,0.0,0.31,10,0,-10,14,0,-14,0.0,0.0,0.0,0.0,0.0,0.0
presb101,Bobby Prescott,Kansas City Athletics,ATLTCS,2,4,3,7,1961,1962,1,-0.07,-0.09,-0.02,40,20,-20,51,37,-14,0.0,0.0,0.0,0.0,0.0,0.0
presj001,Jim Presley,Seattle Mariners,MARNRS,2,2,3,5,1990,1993,3,-1.77,0.78,2.55,140,160,20,577,0,-577,0.0,839.0,839.0,0.0,100000.0,100000.0
presr001,Ryan Pressly,Minnesota Twins,TWINS,1,1,2,3,2018,2018,0,5.2,0.0,-5.2,176,0,-176,0,0,0,488.0,0.0,-488.0,1600000.0,0.0,-1600000.0
pricb001,Bryan Price,Boston Red Sox,RSOX,1,3,1,4,2009,2010,1,7.47,4.91,-2.56,325,183,-142,19,775,756,3215.0,0.0,-3215.0,415500.0,5900000.0,5484500.0
pricd001,David Price,Tampa Bay Devil Rays,RAYS,5,7,13,20,2014,2021,7,9.45,17.77,8.32,408,1015,607,1367,3027,1660,730.0,1247.0,517.0,14000000.0,4645000.0,-9355000.0
pricd001,David Price,Detroit Tigers,TIGRS,2,2,4,6,2015,2021,6,2.15,4.87,2.72,46,167,121,6,14,8,284.0,1552.0,1268.0,23225000.0,508700.0,-22716300.0
pricd001,David Price,Boston Red Sox,RSOX,1,3,3,6,2020,2020,0,8.46,2.13,-6.33,253,53,-200,814,221,-593,221.0,0.0,-221.0,0.0,0.0,0.0
pridb101,Bob Priddy,Pittsburgh Pirates,PIRATS,1,2,1,3,1965,1965,0,0.03,0.41,0.38,287,60,-227,312,157,-155,304.0,0.0,-304.0,0.0,0.0,0.0
pridb101,Bob Priddy,San Francisco Giants,GIANTS,3,4,3,7,1966,1972,6,-2.2,6.95,9.15,357,389,32,728,341,-387,457.0,2870.0,2413.0,17000.0,24000.0,7000.0
pridb101,Bob Priddy,Washington Senators,RNGRS,12,27,21,48,1968,1988,20,46.51,51.95,5.44,2991,4295,1304,9420,12528,3108,3885.0,6824.0,2939.0,527000.0,241500.0,-285500.0
pridb101,Bob Priddy,Chicago White Sox,WSOX,2,3,3,6,1969,1971,2,9.0,0.38,-8.62,941,234,-707,3605,831,-2774,79.0,0.0,-79.0,15500.0,0.0,-15500.0
pridb101,Bob Priddy,California Angels,ANGELS,3,7,6,13,1969,1990,21,44.93,60.7,15.77,1370,2449,1079,2746,9851,7105,8249.0,1336.0,-6913.0,212000.0,50000.0,-162000.0
pridj001,Jason Pridie,Tampa Bay Devil Rays,RAYS,6,10,18,28,2007,2018,11,7.31,39.77,32.46,1554,1744,190,4454,3404,-1050,1936.0,6404.0,4468.0,6476100.0,1362800.0,-5113300.0
pridj101,Jerry Priddy,New York Yankees,YANKS,1,2,2,4,1943,1946,3,9.48,0.6,-8.88,716,132,-584,1943,129,-1814,1434.0,1073.0,-361.0,0.0,0.0,0.0
pridj101,Jerry Priddy,Washington Senators,TWINS,1,1,1,2,1947,1952,5,5.67,0.0,-5.67,296,0,-296,1291,0,-1291,0.0,0.0,0.0,0.0,14000.0,14000.0
pridj101,Jerry Priddy,St.Louis Browns,ORLS,1,1,2,3,1949,1950,1,6.81,-0.58,-7.39,451,19,-432,1933,3,-1930,0.0,43.0,43.0,0.0,6000.0,6000.0
priee001,Eddie Priest,Cincinnati Reds,REDS,1,2,1,3,1998,1998,0,0.0,-1.7,-1.7,0,31,31,0,4,4,0.0,79.0,79.0,0.0,205000.0,205000.0
primr101,Ray Prim,Washington Senators,TWINS,1,3,1,4,1935,1935,0,-0.51,0.0,0.51,66,0,-66,27,0,-27,256.0,0.0,-256.0,0.0,0.0,0.0
primr101,Ray Prim,Philadelphia Phillies,PHILS,1,1,1,2,1935,1938,3,0.0,-0.66,-0.66,0,270,270,0,1055,1055,0.0,0.0,0.0,0.0,0.0,0.0
prinb001,Bret Prinz,Arizona Diamondbacks,DBACKS,1,3,2,5,2003,2003,0,-0.2,0.48,0.68,53,45,-8,58,183,125,91.0,0.0,-91.0,1200000.0,13000000.0,11800000.0
prinb001,Bret Prinz,New York Yankees,YANKS,1,1,1,2,2005,2007,2,0.04,-0.56,-0.6,3,35,32,0,76,76,9.0,0.0,-9.0,0.0,0.0,0.0
procs001,Scott Proctor,Los Angeles Dodgers,DOGRS,1,2,1,3,2003,2004,1,0.65,0.19,-0.46,406,152,-254,260,302,42,712.0,3.0,-709.0,0.0,5000000.0,5000000.0
procs001,Scott Proctor,New York Yankees,YANKS,2,4,3,7,2007,2012,5,-1.13,11.61,12.74,169,723,554,50,2791,2741,232.0,3.0,-229.0,1620923.0,4005000.0,2384077.0
profj001,Jurickson Profar,Texas Rangers,RNGRS,1,2,5,7,2018,2020,2,-0.15,-0.13,0.02,139,13,-126,518,0,-518,0.0,38.0,38.0,1050000.0,0.0,-1050000.0
profj001,Jurickson Profar,Oakland Athletics,ATLTCS,1,1,2,3,2019,2019,0,1.34,0.0,-1.34,193,0,-193,614,0,-614,0.0,0.0,0.0,3600000.0,0.0,-3600000.0
prokl001,Luke Prokopec,Los Angeles Dodgers,DOGRS,2,3,3,6,2001,2006,5,-1.54,8.97,10.51,109,957,848,286,2429,2143,215.0,683.0,468.0,3400000.0,10800000.0,7400000.0
prolm101,Mike Proly,Chicago White Sox,WSOX,1,1,1,2,1981,1982,1,0.31,-0.79,-1.1,70,29,-41,7,49,42,189.0,0.0,-189.0,0.0,0.0,0.0
protd101,Doc Prothro,Washington Senators,TWINS,5,12,6,18,1924,1941,17,16.54,43.93,27.39,920,1700,780,2170,6848,4678,3390.0,1035.0,-2355.0,30400.0,6000.0,-24400.0
protd101,Doc Prothro,Washington Senators,TWINS,1,1,1,2,1924,1924,0,2.0,0.0,-2.0,119,0,-119,474,0,-474,0.0,0.0,0.0,3200.0,0.0,-3200.0
protd101,Doc Prothro,Boston Red Sox,RSOX,1,2,1,3,1925,1925,0,0.0,0.0,0.0,0,0,0,0,0,0,0.0,0.0,0.0,4250.0,0.0,-4250.0
protd101,Doc Prothro,Portland,Portland,1,2,1,3,1926,1926,0,-0.58,0.0,0.58,17,0,-17,12,0,-12,63.0,0.0,-63.0,0.0,0.0,0.0
protd101,Doc Prothro,Memphis,Memphis,1,2,2,4,1924,1924,0,0.97,0.0,-0.97,178,0,-178,257,0,-257,684.0,0.0,-684.0,0.0,0.0,0.0
pruda101,Augie Prudhomme,Toronto,Toronto,1,2,3,5,1928,1933,5,9.1,0.0,-9.1,535,0,-535,1990,0,-1990,281.0,0.0,-281.0,0.0,8000.0,8000.0
pruej101,Jim Pruett,Milwaukee,Milwaukee,1,1,2,3,1944,1944,0,-0.08,0.0,0.08,9,0,-9,16,0,-16,0.0,0.0,0.0,0.0,0.0,0.0
pruia001,Austin Pruitt,Tampa Bay Devil Rays,RAYS,2,2,4,6,2020,2021,1,-0.05,0.29,0.34,2,29,27,0,72,72,8.0,11.0,3.0,0.0,0.0,0.0
pruia001,Austin Pruitt,Houston Astros,ASTROS,1,2,1,3,2021,2021,0,1.08,-0.33,-1.41,66,26,-40,219,0,-219,14.0,64.0,50.0,0.0,1900000.0,1900000.0
pruir101,Ron Pruitt,Texas Rangers,RNGRS,1,2,1,3,1975,1982,7,2.82,-1.21,-4.03,325,301,-24,802,863,61,317.0,0.0,-317.0,0.0,0.0,0.0
pruir101,Ron Pruitt,Cleveland Indians,INDINS,1,1,1,2,1980,1984,4,0.07,2.72,2.65,33,367,334,79,1367,1288,0.0,0.0,0.0,0.0,0.0,0.0
pruit101,Tex Pruiett,Boston Red Sox,RSOX,1,1,1,2,1908,1908,0,0.0,-0.3,-0.3,0,2,2,0,0,0,0.0,2.0,2.0,0.0,0.0,0.0
pruit101,Tex Pruiett,Cleveland Indians,INDINS,1,2,1,3,1908,1914,6,0.0,-1.58,-1.58,0,95,95,0,309,309,0.0,0.0,0.0,0.0,0.0,0.0
pryog001,Greg Pryor,Texas Rangers,RNGRS,1,3,1,4,1977,1978,1,-0.74,-0.56,0.18,93,93,0,171,128,-43,0.0,0.0,0.0,0.0,0.0,0.0
pryog001,Greg Pryor,Chicago White Sox,WSOX,1,1,1,2,1982,1982,0,-0.57,0.0,0.57,390,0,-390,821,0,-821,0.0,0.0,0.0,0.0,0.0,0.0
pryos001,Stephen Pryor,Seattle Mariners,MARNRS,1,1,1,2,2014,2014,0,0.0,-0.22,-0.22,0,59,59,0,239,239,0.0,0.0,0.0,0.0,0.0,0.0
puigy001,Yasiel Puig,Los Angeles Dodgers,DOGRS,3,12,8,20,2018,2021,3,5.8,8.33,2.53,663,133,-530,2223,501,-1722,299.0,229.0,-70.0,36964000.0,68503480.0,31539480.0
puigy001,Yasiel Puig,Cincinnati Reds,REDS,1,3,1,4,2019,2020,1,0.49,2.49,2.0,49,30,-19,207,16,-191,0.0,388.0,388.0,9700000.0,13000000.0,3300000.0
pujol001,Luis Pujols,Houston Astros,ASTROS,1,1,1,2,1984,1984,0,-0.04,0.0,0.04,4,0,-4,5,0,-5,0.0,0.0,0.0,0.0,0.0,0.0
pulec001,Charlie Puleo,Toronto Blue Jays,BJAYS,1,2,1,3,1981,1981,0,0.67,1.04,0.37,80,21,-59,58,0,-58,553.0,271.0,-282.0,0.0,0.0,0.0
pulec001,Charlie Puleo,New York Mets,METS,1,3,1,4,1982,1984,2,-1.57,2.55,4.12,181,68,-113,297,77,-220,497.0,693.0,196.0,0.0,375000.0,375000.0
pulia001,Alfonso Pulido,Pittsburgh Pirates,PIRATS,1,3,3,6,1984,1986,2,0.69,0.08,-0.61,132,124,-8,338,327,-11,92.0,0.0,-92.0,0.0,1340000.0,1340000.0
pullh001,Harvey Pulliam,Colorado Rockies,ROCKS,3,4,5,9,1997,2000,3,0.73,3.3,2.57,211,265,54,561,37,-524,40.0,364.0,324.0,4813333.0,3750000.0,-1063333.0
pulsb001,Bill Pulsipher,New York Mets,METS,2,5,2,7,1998,2000,2,28.2,0.13,-28.07,1389,89,-1300,5622,266,-5356,469.0,0.0,-469.0,210000.0,3000000.0,2790000.0
pulsb001,Bill Pulsipher,Milwaukee Brewers,BREWRS,1,1,1,2,2000,2002,2,-0.39,0.37,0.76,4,176,172,2,482,480,20.0,0.0,-20.0,0.0,0.0,0.0
pulsb001,Bill Pulsipher,New York Mets,METS,12,25,27,52,2000,2021,21,23.92,23.66,-0.26,974,1888,914,1624,4806,3182,6006.0,3554.0,-2452.0,30731467.0,5425000.0,-25306467.0
puntn001,Nick Punto,Philadelphia Phillies,PHILS,1,3,1,4,2003,2004,1,19.34,1.44,-17.9,901,67,-834,2722,75,-2647,2374.0,603.0,-1771.0,610000.0,6000000.0,5390000.0
puntn001,Nick Punto,Boston Red Sox,RSOX,7,22,14,36,2012,2019,7,37.54,19.18,-18.36,2738,1439,-1299,4768,4566,-202,4720.0,1908.0,-2812.0,4708000.0,16585000.0,11877000.0
purcd001,David Purcey,Toronto Blue Jays,BJAYS,1,1,1,2,2011,2012,1,0.31,-0.13,-0.44,9,3,-6,0,0,0,38.0,6.0,-32.0,436400.0,0.0,-436400.0
purcd001,David Purcey,Oakland Athletics,ATLTCS,1,1,1,2,2011,2013,2,-0.41,1.13,1.54,21,95,74,0,361,361,56.0,0.0,-56.0,0.0,0.0,0.0
purdj101,John Purdin,California Angels,ANGELS,1,1,1,2,1970,1970,0,0.0,0.0,0.0,0,0,0,0,0,0,0.0,0.0,0.0,0.0,0.0,0.0
purkb101,Bob Purkey,Pittsburgh Pirates,PIRATS,1,1,1,2,1957,1957,0,22.16,0.0,-22.16,488,0,-488,594,0,-594,4764.0,0.0,-4764.0,0.0,0.0,0.0
purkb101,Bob Purkey,Cincinnati Reds,REDS,1,1,2,3,1964,1966,2,-2.37,0.11,2.48,64,80,16,43,13,-30,373.0,193.0,-180.0,0.0,0.0,0.0
purtb101,Billy Purtell,Chicago White Sox,WSOX,1,2,2,4,1910,1915,5,0.0,10.22,10.22,86,540,454,299,2308,2009,88.0,0.0,-88.0,0.0,0.0,0.0
purtb101,Billy Purtell,Boston Red Sox,RSOX,9,25,23,48,1912,1935,23,51.77,27.05,-24.72,3792,3039,-753,15081,11185,-3896,0.0,1203.0,1203.0,45050.0,29350.0,-15700.0
putme101,Ed Putman,Chicago Cubs,CUBS,1,1,1,2,1979,1981,2,0.0,0.12,0.12,21,242,221,43,584,541,0.0,0.0,0.0,0.0,0.0,0.0
putme101,Ed Putman,Detroit Tigers,TIGRS,1,2,3,5,1980,1980,0,0.0,0.0,0.0,0,0,0,0,0,0,0.0,0.0,0.0,0.0,0.0,0.0
putnd001,Danny Putnam,Oakland Athletics,ATLTCS,1,1,1,2,2009,2009,0,0.0,-0.06,-0.06,0,1,1,0,0,0,0.0,15.0,15.0,0.0,0.0,0.0
putnp001,Pat Putnam,Texas Rangers,RNGRS,1,1,1,2,1982,1984,2,-0.23,0.0,0.23,208,0,-208,686,0,-686,0.0,0.0,0.0,0.0,0.0,0.0
putnp001,Pat Putnam,Seattle Mariners,MARNRS,1,1,1,2,1984,1984,0,-0.7,0.0,0.7,14,0,-14,43,0,-43,0.0,0.0,0.0,280000.0,0.0,-280000.0
putnz001,Zach Putnam,Cleveland Indians,INDINS,1,1,2,3,2012,2012,0,0.09,0.0,-0.09,4,0,-4,0,0,0,6.0,0.0,-6.0,0.0,0.0,0.0
putzj001,J.J. Putz,Seattle Mariners,MARNRS,8,16,16,32,2008,2015,7,0.83,32.43,31.6,1230,1763,533,2304,5784,3480,1045.0,2794.0,1749.0,18727500.0,18500000.0,-227500.0
pylee101,Ewald Pyle,St.Louis Browns,ORLS,1,1,2,3,1942,1942,0,-0.53,0.0,0.53,36,0,-36,22,0,-22,218.0,0.0,-218.0,0.0,0.0,0.0
pylee101,Ewald Pyle,New York Giants,GIANTS,2,3,2,5,1945,1946,1,-0.4,0.68,1.08,74,93,19,237,277,40,41.0,0.0,-41.0,0.0,0.0,0.0
pylee101,Ewald Pyle,Washington Senators,TWINS,1,1,1,2,1943,1943,0,0.0,-0.06,-0.06,0,13,13,0,15,15,0.0,97.0,97.0,0.0,0.0,0.0
pylee101,Ewald Pyle,Boston Braves,BRAVES,1,2,1,3,1945,1945,0,0.0,-0.56,-0.56,0,74,74,0,19,19,0.0,220.0,220.0,0.0,0.0,0.0
pytlf101,Frankie Pytlak,Cleveland Indians,INDINS,2,4,5,9,1940,1945,5,20.77,6.72,-14.05,691,626,-65,1095,1460,365,4952.0,2948.0,-2004.0,22322.0,17000.0,-5322.0
pyznt001,Tim Pyznarski,Oakland Athletics,ATLTCS,1,1,1,2,1985,1985,0,-0.05,0.0,0.05,15,0,-15,47,0,-47,0.0,0.0,0.0,0.0,0.0,0.0
pyznt001,Tim Pyznarski,San Diego Padres,PADRS,9,17,18,35,1986,1998,12,97.76,19.41,-78.35,6640,1856,-4784,25821,5410,-20411,1355.0,1888.0,533.0,9476667.0,5045000.0,-4431667.0
pyznt001,Tim Pyznarski,Milwaukee Brewers,BREWRS,1,1,2,3,1988,1988,0,0.0,0.0,0.0,0,0,0,0,0,0,0.0,0.0,0.0,0.0,0.0,0.0
qualc001,Chad Qualls,Houston Astros,ASTROS,1,3,1,4,2007,2009,2,-1.01,2.95,3.96,701,243,-458,203,1,-202,929.0,378.0,-551.0,856000.0,2000000.0,1144000.0
qualc001,Chad Qualls,Arizona Diamondbacks,DBACKS,1,1,1,2,2010,2010,0,-0.67,0.0,0.67,27,0,-27,0,0,0,63.0,0.0,-63.0,4185000.0,0.0,-4185000.0
qualc001,Chad Qualls,New York Yankees,YANKS,1,1,1,2,2012,2012,0,-0.3,-0.66,-0.36,34,22,-12,0,59,59,41.0,0.0,-41.0,0.0,2537500.0,2537500.0
qualj101,Jim Qualls,Chicago Cubs,CUBS,2,2,2,4,1970,1971,1,-0.14,-0.04,0.1,176,74,-102,493,237,-256,0.0,0.0,0.0,0.0,0.0,0.0
qualj101,Jim Qualls,Montreal Expos,NATEX,1,1,1,2,1971,1971,0,0.0,0.29,0.29,0,49,49,0,118,118,0.0,0.0,0.0,0.0,0.0,0.0
qualj101,Jim Qualls,Cincinnati Reds,REDS,2,2,2,4,1971,1972,1,-0.21,0.0,0.21,11,0,-11,11,0,-11,0.0,0.0,0.0,0.0,9500.0,9500.0
quanc001,Cal Quantrill,San Diego Padres,PADRS,2,7,4,11,2020,2021,1,3.34,0.62,-2.72,311,5,-306,892,4,-888,493.0,57.0,-436.0,3000000.0,4100000.0,1100000.0
quanp001,Paul Quantrill,Boston Red Sox,RSOX,2,3,3,6,1994,1995,1,-0.06,-1.0,-0.94,145,86,-59,216,248,32,628.0,0.0,-628.0,885000.0,660000.0,-225000.0
quanp001,Paul Quantrill,Philadelphia Phillies,PHILS,2,3,3,6,1995,2000,5,10.73,-2.09,-12.82,473,553,80,4,2028,2024,1674.0,75.0,-1599.0,526500.0,434000.0,-92500.0
quanp001,Paul Quantrill,Toronto Blue Jays,BJAYS,1,2,2,4,2001,2002,1,7.04,-0.73,-7.77,933,22,-911,2400,0,-2400,462.0,215.0,-247.0,1800000.0,200000.0,-1600000.0
quanp001,Paul Quantrill,New York Yankees,YANKS,1,1,3,4,2005,2005,0,0.3,-0.82,-1.12,44,3,-41,1,0,-1,95.0,24.0,-71.0,3000000.0,3975000.0,975000.0
quelg101,George Quellich,New York Yankees,YANKS,2,5,3,8,1932,1940,8,1.79,6.34,4.55,337,462,125,641,986,345,1980.0,2260.0,280.0,0.0,0.0,0.0
quenc001,Carlos Quentin,Arizona Diamondbacks,DBACKS,7,15,17,32,2007,2018,11,32.57,30.17,-2.4,1333,1190,-143,3297,2038,-1259,6760.0,6326.0,-434.0,15122000.0,15790000.0,668000.0
quenc001,Carlos Quentin,Chicago White Sox,WSOX,2,3,3,6,2011,2013,2,8.07,0.05,-8.02,904,18,-886,3238,0,-3238,173.0,202.0,29.0,5530000.0,5500000.0,-30000.0
quenc001,Carlos Quentin,San Diego Padres,PADRS,6,17,12,29,2015,2021,6,17.57,11.2,-6.37,1317,971,-346,3711,2795,-916,1719.0,362.0,-1357.0,9570500.0,0.0,-9570500.0
quevr001,Ruben Quevedo,Atlanta Braves,BRAVES,1,3,2,5,1999,2000,1,-3.84,1.92,5.76,68,186,118,50,245,195,440.0,651.0,211.0,0.0,5325000.0,5325000.0
quevr001,Ruben Quevedo,Chicago Cubs,CUBS,1,2,2,4,2001,2001,0,-1.88,0.61,2.49,108,56,-52,117,0,-117,715.0,85.0,-630.0,0.0,1200000.0,1200000.0
quice101,Eddie Quick,New York Yankees,YANKS,1,2,1,3,1904,1910,6,0.0,5.04,5.04,0,522,522,0,1684,1684,0.0,0.0,0.0,0.0,0.0,0.0
quinh001,Humberto Quintero,Chicago White Sox,WSOX,3,6,4,10,2002,2004,2,5.66,1.21,-4.45,316,141,-175,1204,435,-769,90.0,416.0,326.0,675000.0,1665000.0,990000.0
quinh001,Humberto Quintero,San Diego Padres,PADRS,2,4,3,7,2005,2005,0,0.13,-1.36,-1.49,347,62,-285,1035,10,-1025,24.0,184.0,160.0,3975000.0,3000000.0,-975000.0
quinh001,Humberto Quintero,Houston Astros,ASTROS,1,2,2,4,2012,2017,5,-0.3,0.42,0.72,73,60,-13,210,0,-210,0.0,165.0,165.0,0.0,0.0,0.0
quinj001,Jose Quintana,Chicago White Sox,WSOX,1,1,4,5,2017,2017,0,3.51,0.0,-3.51,156,0,-156,150,0,-150,1319.0,0.0,-1319.0,0.0,0.0,0.0
quinj102,Jack Quinn,New York Yankees,YANKS,1,2,1,3,1912,1912,0,0.0,-0.21,-0.21,0,41,41,0,175,175,0.0,0.0,0.0,0.0,0.0,0.0
quinj102,Jack Quinn,New York Yankees,YANKS,4,11,7,18,1921,1946,25,28.58,81.31,52.73,995,2473,1478,1312,4729,3417,7730.0,15194.0,7464.0,42500.0,38450.0,-4050.0
quinj102,Jack Quinn,Vernon,Vernon,1,1,3,4,1918,1919,1,9.35,0.0,-9.35,224,0,-224,251,0,-251,1919.0,0.0,-1919.0,0.0,2100.0,2100.0
quinj103,Joe Quinn,Boston Braves,BRAVES,1,1,1,2,1893,1894,1,-0.45,-0.24,0.21,549,120,-429,2339,531,-1808,0.0,0.0,0.0,0.0,0.0,0.0
quinj103,Joe Quinn,Baltimore Orioles,BLN,1,2,2,4,1898,1903,5,2.47,4.06,1.59,268,251,-17,1122,1106,-16,0.0,0.0,0.0,0.0,0.0,0.0
quinl001,Luis Quinones,Oakland Athletics,ATLTCS,1,1,1,2,1983,1985,2,0.0,1.58,1.58,0,63,63,0,162,162,0.0,0.0,0.0,0.0,250000.0,250000.0
quinl001,Luis Quinones,Cleveland Indians,INDINS,3,4,4,8,1985,1991,6,-3.07,1.08,4.15,232,262,30,182,266,84,443.0,1475.0,1032.0,0.0,500000.0,500000.0
quinl001,Luis Quinones,Oakland Athletics,ATLTCS,1,1,1,2,1987,1987,0,-0.28,-0.02,0.26,49,45,-4,111,128,17,0.0,0.0,0.0,0.0,0.0,0.0
quinl001,Luis Quinones,Chicago Cubs,CUBS,1,1,1,2,1988,1988,0,1.81,-0.14,-1.95,300,14,-286,836,2,-834,0.0,37.0,37.0,0.0,0.0,0.0
quino001,Omar Quintanilla,Oakland Athletics,ATLTCS,1,2,2,4,2005,2007,2,0.29,2.31,2.02,231,152,-79,619,3,-616,0.0,786.0,786.0,2200000.0,2200000.0,0.0
quinr001,Rey Quinones,Seattle Mariners,MARNRS,1,2,3,5,1989,1989,0,-1.21,-0.79,0.42,71,15,-56,253,0,-253,0.0,256.0,256.0,215000.0,222500.0,7500.0
quinr001,Rey Quinones,Boston Red Sox,RSOX,3,7,5,12,1986,1993,7,7.37,8.49,1.12,984,1130,146,3351,3154,-197,369.0,1455.0,1086.0,1275000.0,132500.0,-1142500.0
quint102,Tad Quinn,Philadelphia Athletics,ATLTCS,1,2,1,3,1903,1903,0,0.0,0.0,0.0,0,0,0,0,0,0,0.0,0.0,0.0,0.0,0.0,0.0
quira101,Art Quirk,Baltimore Orioles,ORLS,1,3,2,5,1962,1967,5,0.29,3.01,2.72,74,349,275,211,975,764,63.0,22.0,-41.0,7000.0,0.0,-7000.0
quirj001,Jamie Quirk,Kansas City Royals,ROYALS,2,4,3,7,1976,1980,4,4.07,20.62,16.55,704,736,32,973,2593,1620,2869.0,802.0,-2067.0,0.0,0.0,0.0
quirj001,Jamie Quirk,Milwaukee Brewers,BREWRS,1,1,2,3,1978,1978,0,1.99,0.0,-1.99,504,0,-504,1348,0,-1348,0.0,0.0,0.0,0.0,0.0,0.0
raabb001,Brian Raabe,Seattle Mariners,MARNRS,1,1,1,2,1997,1997,0,0.04,0.0,-0.04,2,0,-2,4,0,-4,0.0,0.0,0.0,160000.0,0.0,-160000.0
rabbj001,John Rabb,San Francisco Giants,GIANTS,2,2,2,4,1985,1989,4,1.65,5.38,3.73,164,579,415,391,2041,1650,0.0,0.0,0.0,462500.0,140000.0,-322500.0
rabbj101,Joe Rabbitt,Chicago White Sox,WSOX,1,4,1,5,1924,1924,0,0.0,-0.04,-0.04,0,6,6,0,5,5,0.0,0.0,0.0,0.0,0.0,0.0
rabec101,Charlie Rabe,Cincinnati Reds,REDS,1,4,1,5,1958,1960,2,0.85,9.64,8.79,265,190,-75,151,233,82,590.0,1314.0,724.0,14000.0,30000.0,16000.0
rabem001,Mike Rabelo,Detroit Tigers,TIGRS,2,8,3,11,2007,2010,3,-0.1,-1.19,-1.09,705,27,-678,1077,3,-1074,1506.0,303.0,-1203.0,12380000.0,13850000.0,1470000.0
rabur001,Ryan Raburn,Chicago White Sox,WSOX,1,1,1,2,2017,2017,0,0.04,0.0,-0.04,25,0,-25,69,0,-69,0.0,0.0,0.0,0.0,0.0,0.0
rackm101,Marv Rackley,Brooklyn Dodgers,DOGRS,1,1,2,3,1949,1952,3,0.16,-0.35,-0.51,11,8,-3,37,14,-23,0.0,0.0,0.0,0.0,0.0,0.0
radad101,Dick Radatz,Boston Red Sox,RSOX,2,3,3,6,1966,1970,4,3.1,6.39,3.29,238,631,393,23,758,735,592.0,2094.0,1502.0,0.0,31250.0,31250.0
radad101,Dick Radatz,Cleveland Indians,INDINS,2,4,3,7,1967,1968,1,0.01,0.99,0.98,356,130,-226,391,265,-126,1052.0,0.0,-1052.0,27000.0,25000.0,-2000.0
radcr101,Rip Radcliff,StPaul,StPaul,2,2,6,8,1933,1934,1,1.84,0.0,-1.84,131,0,-131,110,0,-110,910.0,0.0,-910.0,0.0,10600.0,10600.0
radcr101,Rip Radcliff,Philadelphia Athletics,ATLTCS,1,2,1,3,1934,1934,0,0.0,0.0,0.0,0,0,0,0,0,0,0.0,0.0,0.0,0.0,0.0,0.0
radcr101,Rip Radcliff,Chicago White Sox,WSOX,1,1,1,2,1939,1944,5,3.93,0.5,-3.43,169,234,65,717,833,116,0.0,0.0,0.0,10000.0,0.0,-10000.0
radcr101,Rip Radcliff,Detroit Tigers,TIGRS,1,1,2,3,1943,1952,9,0.0,0.03,0.03,0,640,640,0,1953,1953,0.0,0.0,0.0,7000.0,6000.0,-1000.0
raded101,Dave Rader,San Francisco Giants,GIANTS,2,5,5,10,1976,1979,3,0.11,-0.39,-0.5,172,638,466,406,1241,835,25.0,782.0,757.0,0.0,0.0,0.0
raded101,Dave Rader,St. Louis Cardinals,CARDS,14,34,29,63,1977,1994,17,91.47,138.33,46.86,7749,6510,-1239,23063,22802,-261,8671.0,3716.0,-4955.0,3088333.0,809167.0,-2279166.0
raded101,Dave Rader,Chicago Cubs,CUBS,9,17,19,36,1979,1990,11,20.77,12.9,-7.87,2689,1303,-1386,6948,2680,-4268,1072.0,3217.0,2145.0,890000.0,85000.0,-805000.0
raded101,Dave Rader,Philadelphia Phillies,PHILS,1,1,2,3,1980,1980,0,1.12,0.0,-1.12,50,0,-50,152,0,-152,0.0,0.0,0.0,0.0,0.0,0.0
raded103,Doug Rader,Houston Astros,ASTROS,1,1,2,3,1975,1975,0,4.82,0.0,-4.82,191,0,-191,745,0,-745,0.0,0.0,0.0,0.0,0.0,0.0
radfp101,Paul Radford,Cleveland Spiders,CL4,1,2,1,3,1891,1899,8,0.0,34.84,34.84,0,1004,1004,0,4749,4749,0.0,0.0,0.0,0.0,0.0,0.0
radtj101,Jack Radtke,Brooklyn Dodgers,DOGRS,1,2,1,3,1937,1941,4,0.0,0.0,0.0,0,0,0,0,0,0,0.0,0.0,0.0,0.0,0.0,0.0
raffk101,Ken Raffensberger,St. Louis Cardinals,CARDS,1,1,3,4,1939,1942,3,0.94,-0.63,-1.57,106,24,-82,37,76,39,395.0,0.0,-395.0,2400.0,7800.0,5400.0
raffk101,Ken Raffensberger,Philadelphia Phillies,PHILS,1,2,1,3,1947,1949,2,23.82,-2.12,-25.94,519,88,-431,570,262,-308,4467.0,2.0,-4465.0,0.0,0.0,0.0
raffk101,Ken Raffensberger,Chicago Cubs,CUBS,1,1,2,3,1943,1947,4,6.07,0.0,-6.07,185,0,-185,192,0,-192,1585.0,0.0,-1585.0,0.0,0.0,0.0
raftt101,Tom Raftery,Pittsburgh Pirates,PIRATS,1,3,1,4,1910,1910,0,0.0,0.0,0.0,0,0,0,0,0,0,0.0,0.0,0.0,0.0,0.0,0.0
ragap101,Pat Ragan,Boston Braves,BRAVES,1,1,1,2,1919,1919,0,0.42,0.58,0.16,14,60,46,8,168,160,68.0,0.0,-68.0,3000.0,3913.0,913.0
raglf101,Frank Ragland,Philadelphia Phillies,PHILS,1,3,1,4,1933,1934,1,0.0,-0.02,-0.02,0,6,6,0,21,21,0.0,0.0,0.0,0.0,0.0,0.0
raglf101,Frank Ragland,Albany,Albany,1,1,2,3,1933,1934,1,-0.68,0.0,0.68,22,0,-22,11,0,-11,115.0,0.0,-115.0,0.0,0.0,0.0
raglt101,Tom Ragland,Texas Rangers,RNGRS,2,3,2,5,1972,1974,2,-0.28,1.79,2.07,67,272,205,198,1149,951,0.0,0.0,0.0,9900.0,0.0,-9900.0
rainc001,Chuck Rainey,Boston Red Sox,RSOX,1,1,1,2,1982,1983,1,0.09,-1.02,-1.11,102,22,-80,106,0,-106,838.0,203.0,-635.0,0.0,0.0,0.0
rainc001,Chuck Rainey,Chicago Cubs,CUBS,2,3,2,5,1984,1988,4,-0.39,4.78,5.17,100,498,398,169,554,385,92.0,631.0,539.0,490000.0,730000.0,240000.0
rainl101,Larry Raines,Cleveland Indians,INDINS,1,2,1,3,1958,1960,2,0.0,0.48,0.48,0,12,12,0,2,2,0.0,27.0,27.0,0.0,0.0,0.0
raint001,Tim Raines,Montreal Expos,NATEX,3,5,6,11,1990,1997,7,15.54,6.93,-8.61,814,1027,213,3114,2899,-215,199.0,380.0,181.0,5530555.0,1307000.0,-4223555.0
raint001,Tim Raines,Chicago White Sox,WSOX,1,1,1,2,1995,1996,1,3.29,0.0,-3.29,242,0,-242,940,0,-940,0.0,0.0,0.0,3700000.0,0.0,-3700000.0
raint003,Tanner Rainey,Cincinnati Reds,REDS,4,7,5,12,2018,2021,3,1.73,2.06,0.33,296,86,-210,1,34,33,604.0,395.0,-209.0,10000000.0,10525000.0,525000.0
rajsd101,Dave Rajsich,New York Yankees,YANKS,22,49,42,91,1978,1997,19,81.62,59.61,-22.01,5721,3574,-2147,13100,7561,-5539,18451.0,9704.0,-8747.0,5628333.0,4757500.0,-870833.0
rajsd101,Dave Rajsich,Texas Rangers,RNGRS,1,1,1,2,1981,1981,0,0.0,0.0,0.0,0,0,0,0,0,0,0.0,0.0,0.0,0.0,0.0,0.0
rajsg001,Gary Rajsich,Houston Astros,ASTROS,1,1,1,2,1981,1981,0,0.0,0.0,0.0,91,0,-91,222,0,-222,0.0,0.0,0.0,0.0,0.0,0.0
rajsg001,Gary Rajsich,St. Louis Cardinals,CARDS,1,4,1,5,1985,1987,2,10.04,9.7,-0.34,1204,322,-882,3785,1371,-2414,620.0,0.0,-620.0,0.0,0.0,0.0
rakoe101,Ed Rakow,Los Angeles Dodgers,DOGRS,2,2,4,6,1961,1966,5,2.83,1.64,-1.19,280,130,-150,193,39,-154,1732.0,509.0,-1223.0,17000.0,8500.0,-8500.0
rakoe101,Ed Rakow,Kansas City Athletics,ATLTCS,15,33,27,60,1963,1976,13,55.99,46.74,-9.25,6677,4175,-2502,14870,13661,-1209,10290.0,2197.0,-8093.0,387100.0,512500.0,125400.0
rakoe101,Ed Rakow,Boston Red Sox,RSOX,1,2,2,4,1966,1967,1,-0.2,0.0,0.2,68,0,-68,16,0,-16,197.0,0.0,-197.0,0.0,0.0,0.0
raleb001,Brooks Raley,Cincinnati Reds,REDS,1,1,1,2,2020,2020,0,-0.16,0.0,0.16,79,0,-79,0,0,0,195.0,0.0,-195.0,0.0,0.0,0.0
ralel001,Luke Raley,Los Angeles Dodgers,DOGRS,1,3,1,4,2018,2018,0,0.86,0.11,-0.75,69,47,-22,205,170,-35,209.0,0.0,-209.0,9000000.0,9000000.0,0.0
ralel001,Luke Raley,Minnesota Twins,TWINS,1,3,3,6,2020,2020,0,-0.29,1.55,1.84,124,11,-113,74,0,-74,170.0,200.0,30.0,0.0,0.0,0.0
ramab101,Bob Ramazzotti,Brooklyn Dodgers,DOGRS,1,1,1,2,1949,1949,0,-1.16,0.0,1.16,275,0,-275,764,0,-764,0.0,0.0,0.0,0.0,0.0,0.0
ramia001,Aramis Ramirez,Pittsburgh Pirates,PIRATS,2,4,4,8,2003,2005,2,25.85,-0.22,-26.07,1180,243,-937,4941,589,-4352,0.0,0.0,0.0,4351000.0,0.0,-4351000.0
ramia001,Aramis Ramirez,Milwaukee Brewers,BREWRS,1,2,1,3,2015,2017,2,-0.29,0.3,0.59,56,10,-46,214,0,-214,0.0,20.0,20.0,0.0,0.0,0.0
ramia002,Alex Ramirez,Cleveland Indians,INDINS,1,2,1,3,2000,2002,2,-2.57,-1.33,1.24,129,133,4,392,475,83,0.0,0.0,0.0,450000.0,2166667.0,1716667.0
ramie001,Erasmo Ramirez,San Francisco Giants,GIANTS,1,3,1,4,2001,2001,0,1.58,0.17,-1.41,103,49,-54,31,174,143,323.0,0.0,-323.0,0.0,6000000.0,6000000.0
ramie002,Elizardo Ramirez,Philadelphia Phillies,PHILS,2,5,5,10,2004,2009,5,6.82,2.03,-4.79,443,166,-277,1673,131,-1542,564.0,1155.0,591.0,16900000.0,2750000.0,-14150000.0
ramie003,Edwar Ramirez,Texas Rangers,RNGRS,1,1,1,2,2010,2010,0,-0.13,0.0,0.13,7,0,-7,0,0,0,33.0,0.0,-33.0,0.0,0.0,0.0
ramie004,Erasmo Ramirez,Seattle Mariners,MARNRS,3,4,4,8,2015,2020,5,5.78,2.81,-2.97,393,406,13,88,1271,1183,2344.0,455.0,-1889.0,0.0,3150000.0,3150000.0
ramie004,Erasmo Ramirez,Tampa Bay Devil Rays,RAYS,1,1,2,3,2017,2017,0,0.29,1.07,0.78,24,28,4,6,0,-6,323.0,74.0,-249.0,3125000.0,6000000.0,2875000.0
ramih001,Hector Ramirez,New York Mets,METS,8,16,15,31,1997,2005,8,5.2,5.8,0.6,1347,2001,654,1609,3149,1540,2422.0,1675.0,-747.0,19588333.0,14951666.0,-4636667.0
ramih002,Horacio Ramirez,Atlanta Braves,BRAVES,3,5,4,9,2006,2010,4,2.69,3.12,0.43,410,466,56,204,140,-64,1215.0,655.0,-560.0,8965000.0,7700000.0,-1265000.0
ramih002,Horacio Ramirez,Kansas City Royals,ROYALS,1,1,1,2,2008,2018,10,-0.27,1.69,1.96,17,278,261,0,918,918,39.0,0.0,-39.0,0.0,0.0,0.0
ramih003,Hanley Ramirez,Boston Red Sox,RSOX,14,38,25,63,2005,2019,14,93.01,61.11,-31.9,5581,3052,-2529,12204,8864,-3340,8381.0,6378.0,-2003.0,13099733.0,30982000.0,17882267.0
ramih003,Hanley Ramirez,Miami Marlins,MARLNS,3,6,9,15,2012,2019,7,16.03,11.46,-4.57,560,873,313,1297,2000,703,1929.0,1864.0,-65.0,9367000.0,11541425.0,2174425.0
ramih004,Harold Ramirez,Pittsburgh Pirates,PIRATS,1,3,1,4,2016,2017,1,1.56,-0.04,-1.6,169,12,-157,400,1,-399,396.0,34.0,-362.0,0.0,2200000.0,2200000.0
ramij001,Julio Ramirez,Florida Marlins,MARLNS,1,1,1,2,2000,2001,1,-0.49,0.03,0.52,22,28,6,39,46,7,0.0,0.0,0.0,0.0,255000.0,255000.0
ramij002,J.C. Ramirez,Seattle Mariners,MARNRS,6,11,9,20,2009,2014,5,2.34,8.64,6.3,470,811,341,626,2617,1991,956.0,1416.0,460.0,10564000.0,427200.0,-10136800.0
ramij004,Jose Ramirez,New York Yankees,YANKS,1,2,1,3,2015,2016,1,-0.41,-0.02,0.39,5,51,46,0,127,127,14.0,0.0,-14.0,0.0,2600000.0,2600000.0
ramij004,Jose Ramirez,Seattle Mariners,MARNRS,1,1,1,2,2015,2017,2,0.33,0.0,-0.33,212,0,-212,0,0,0,303.0,0.0,-303.0,0.0,0.0,0.0
ramim002,Manny Ramirez,Boston Red Sox,RSOX,1,3,1,4,2008,2009,1,6.26,7.17,0.91,223,200,-23,892,849,-43,0.0,0.0,0.0,18929923.0,0.0,-18929923.0
ramim003,Max Ramirez,Atlanta Braves,BRAVES,1,1,1,2,2006,2007,1,0.0,0.94,0.94,0,152,152,0,0,0,0.0,209.0,209.0,0.0,5000000.0,5000000.0
ramim003,Max Ramirez,Cleveland Indians,INDINS,1,1,1,2,2007,2007,0,0.29,0.74,0.45,45,52,7,140,196,56,0.0,0.0,0.0,0.0,6000000.0,6000000.0
ramim101,Milt Ramirez,St. Louis Cardinals,CARDS,3,4,4,8,1972,1975,3,-4.47,-0.62,3.85,305,37,-268,783,86,-697,0.0,0.0,0.0,0.0,0.0,0.0
ramin001,Neil Ramirez,Texas Rangers,RNGRS,1,4,1,5,2013,2013,0,4.33,-0.09,-4.42,1129,13,-1116,283,0,-283,1426.0,253.0,-1173.0,0.0,0.0,0.0
ramin002,Noe Ramirez,Anaheim Angels,ANGELS,1,2,1,3,2020,2021,1,0.0,2.81,2.81,0,81,81,0,0,0,0.0,210.0,210.0,900000.0,5714285.0,4814285.0
ramir001,Rafael Ramirez,Atlanta Braves,BRAVES,1,2,2,4,1987,1987,0,-1.14,0.0,1.14,612,0,-612,2086,0,-2086,0.0,0.0,0.0,875000.0,0.0,-875000.0
ramir003,Ramon Ramirez,New York Yankees,YANKS,2,3,2,5,2005,2006,1,2.28,1.29,-0.99,307,72,-235,33,112,79,681.0,426.0,-255.0,3600000.0,5650000.0,2050000.0
ramir003,Ramon Ramirez,Colorado Rockies,ROCKS,1,1,1,2,2008,2016,8,2.4,14.02,11.62,76,407,331,0,398,398,215.0,3424.0,3209.0,0.0,0.0,0.0
ramir003,Ramon Ramirez,Kansas City Royals,ROYALS,1,1,1,2,2008,2009,1,2.03,1.4,-0.63,122,49,-73,1,215,214,336.0,0.0,-336.0,397000.0,5083333.0,4686333.0
ramir003,Ramon Ramirez,Boston Red Sox,RSOX,2,2,2,4,2010,2011,1,1.23,0.0,-1.23,193,0,-193,1,0,-1,304.0,0.0,-304.0,1155000.0,0.0,-1155000.0
ramir003,Ramon Ramirez,San Francisco Giants,GIANTS,1,2,1,3,2011,2016,5,1.51,6.46,4.95,247,583,336,434,2471,2037,191.0,0.0,-191.0,3850000.0,3500000.0,-350000.0
ramir005,Roel Ramirez,Tampa Bay Devil Rays,RAYS,2,5,5,10,2018,2020,2,6.49,6.47,-0.02,634,226,-408,1668,967,-701,343.0,0.0,-343.0,4100000.0,1152200.0,-2947800.0
ramiy001,Yefry Ramirez,Baltimore Orioles,ORLS,1,1,1,2,2019,2019,0,-0.36,0.0,0.36,18,0,-18,2,0,-2,42.0,0.0,-42.0,0.0,0.0,0.0
ramoa001,A.J. Ramos,Miami Marlins,MARLNS,1,1,2,3,2017,2019,2,-0.36,-0.15,0.21,96,15,-81,0,4,4,116.0,66.0,-50.0,6550000.0,0.0,-6550000.0
ramoc001,Cesar Ramos,San Diego Padres,PADRS,1,4,1,5,2010,2012,2,1.36,-1.01,-2.37,435,168,-267,53,716,663,1270.0,0.0,-1270.0,401300.0,4000000.0,3598700.0
ramoc001,Cesar Ramos,Tampa Bay Devil Rays,RAYS,1,1,1,2,2014,2014,0,0.96,0.0,-0.96,71,0,-71,0,0,0,157.0,0.0,-157.0,750000.0,0.0,-750000.0
ramod001,Domingo Ramos,New York Yankees,YANKS,22,49,42,91,1978,1997,19,81.62,59.61,-22.01,5721,3574,-2147,13100,7561,-5539,18451.0,9704.0,-8747.0,5628333.0,4757500.0,-870833.0
ramok001,Ken Ramos,Cleveland Indians,INDINS,1,1,1,2,1994,1994,0,0.0,-0.27,-0.27,0,4,4,0,13,13,0.0,0.0,0.0,0.0,0.0,0.0
ramom001,Mario Ramos,Oakland Athletics,ATLTCS,7,12,11,23,2002,2009,7,21.2,14.17,-7.03,1375,998,-377,3394,3388,-6,5508.0,716.0,-4792.0,947000.0,0.0,-947000.0
ramop101,Pedro Ramos,Minnesota Twins,TWINS,3,5,6,11,1962,1968,6,1.21,5.47,4.26,545,948,403,745,2451,1706,1800.0,1931.0,131.0,15000.0,0.0,-15000.0
ramop101,Pedro Ramos,Cleveland Indians,INDINS,5,6,10,16,1964,1969,5,2.58,4.48,1.9,776,338,-438,117,156,39,2188.0,1590.0,-598.0,97100.0,125000.0,27900.0
ramop101,Pedro Ramos,New York Yankees,YANKS,1,1,2,3,1966,1966,0,-0.25,0.0,0.25,12,0,-12,1,0,-1,24.0,0.0,-24.0,25000.0,6000.0,-19000.0
ramor001,Bobby Ramos,Montreal Expos,NATEX,1,1,1,2,1982,1982,0,-0.07,-0.12,-0.05,4,5,1,11,7,-4,0.0,0.0,0.0,0.0,0.0,0.0
ramow001,Wilson Ramos,Minnesota Twins,TWINS,1,2,1,3,2010,2012,2,10.47,1.92,-8.55,578,130,-448,2276,0,-2276,0.0,366.0,366.0,0.0,3500000.0,3500000.0
ramow001,Wilson Ramos,Tampa Bay Devil Rays,RAYS,1,1,1,2,2018,2018,0,0.79,0.0,-0.79,33,0,-33,101,0,-101,0.0,0.0,0.0,8500000.0,0.0,-8500000.0
ramsb101,Bill Ramsey,Boston Braves,BRAVES,6,10,11,21,1946,1966,20,4.65,47.8,43.15,447,2538,2091,1596,8887,7291,15.0,0.0,-15.0,0.0,0.0,0.0
ramsm001,Mike Ramsey,St. Louis Cardinals,CARDS,2,2,4,6,1984,1984,0,-0.12,0.34,0.46,49,38,-11,107,129,22,0.0,0.0,0.0,0.0,0.0,0.0
ramsm002,Mike Ramsey,Cincinnati Reds,REDS,2,4,3,7,1982,1990,8,5.51,11.79,6.28,594,719,125,2160,312,-1848,241.0,3379.0,3138.0,580000.0,325000.0,-255000.0
ramsm003,Matt Ramsey,Tampa Bay Devil Rays,RAYS,1,1,1,2,2014,2014,0,0.0,0.0,0.0,0,0,0,0,0,0,0.0,0.0,0.0,0.0,0.0,0.0
ramsr001,Robert Ramsay,Boston Red Sox,RSOX,1,1,1,2,1999,1999,0,0.77,-0.18,-0.95,44,45,1,0,131,131,206.0,0.0,-206.0,0.0,1500000.0,1500000.0
ramst101,Toad Ramsey,Chattanooga,Chattanooga,1,1,2,3,1885,1885,0,0.0,0.0,0.0,0,0,0,0,0,0,0.0,0.0,0.0,0.0,0.0,0.0
ramst101,Toad Ramsey,Louisville Colonels,LS2,1,1,1,2,1889,1889,0,4.44,0.0,-4.44,98,0,-98,171,0,-171,1169.0,0.0,-1169.0,0.0,0.0,0.0
ramsw101,Willie Ramsdell,Cincinnati Reds,REDS,3,5,3,8,1952,1961,9,2.75,13.56,10.81,226,1292,1066,624,5151,4527,302.0,373.0,71.0,11000.0,10500.0,-500.0
ranaa001,Anthony Ranaudo,Boston Red Sox,RSOX,1,1,1,2,2015,2017,2,-0.8,1.35,2.15,7,126,119,2,0,-2,57.0,375.0,318.0,0.0,0.0,0.0
ranaa001,Anthony Ranaudo,Texas Rangers,RNGRS,1,1,1,2,2016,2016,0,-0.57,0.0,0.57,9,0,-9,3,0,-3,83.0,0.0,-83.0,0.0,0.0,0.0
randb101,Bob Randall,Los Angeles Dodgers,DOGRS,2,2,3,5,1975,1978,3,3.43,0.0,-3.43,473,18,-455,1512,17,-1495,0.0,0.0,0.0,0.0,0.0,0.0
randd101,Dick Rand,St. Louis Cardinals,CARDS,1,2,1,3,1956,1956,0,-0.23,0.0,0.23,60,0,-60,122,0,-122,0.0,0.0,0.0,0.0,11000.0,11000.0
randd101,Dick Rand,Pittsburgh Pirates,PIRATS,3,3,4,7,1959,1962,3,-0.33,0.65,0.98,123,67,-56,369,216,-153,0.0,0.0,0.0,0.0,0.0,0.0
randj002,Joe Randa,Kansas City Royals,ROYALS,1,4,2,6,1996,1997,1,2.49,5.44,2.95,410,153,-257,728,660,-68,275.0,0.0,-275.0,120000.0,7200000.0,7080000.0
randj002,Joe Randa,Arizona Diamondbacks,DBACKS,2,6,2,8,1997,2003,6,6.66,8.29,1.63,875,595,-280,3219,2462,-757,172.0,0.0,-172.0,0.0,13550000.0,13550000.0
randj002,Joe Randa,Detroit Tigers,TIGRS,1,1,1,2,1998,2000,2,0.0,0.18,0.18,0,94,94,0,4,4,0.0,872.0,872.0,375000.0,0.0,-375000.0
randj002,Joe Randa,New York Mets,METS,1,1,1,2,1998,1998,0,14.18,0.0,-14.18,875,0,-875,3712,0,-3712,0.0,0.0,0.0,0.0,0.0,0.0
randj002,Joe Randa,Cincinnati Reds,REDS,3,3,5,8,2005,2007,2,0.32,0.28,-0.04,61,118,57,241,3,-238,15.0,154.0,139.0,2150000.0,8750000.0,6600000.0
randl101,Lenny Randle,Texas Rangers,RNGRS,1,1,2,3,1977,1977,0,5.03,0.0,-5.03,268,0,-268,1093,0,-1093,0.0,0.0,0.0,0.0,0.0,0.0
randl101,Lenny Randle,San Francisco Giants,GIANTS,11,23,25,48,1979,1998,19,47.48,66.07,18.59,2727,4533,1806,5432,5570,138,5201.0,15628.0,10427.0,10487778.0,6966667.0,-3521111.0
randn101,Newt Randall,Chicago Cubs,CUBS,1,2,1,3,1907,1907,0,11.38,-0.4,-11.78,977,51,-926,4014,159,-3855,0.0,0.0,0.0,0.0,0.0,0.0
rands002,Scott Randall,Colorado Rockies,ROCKS,1,1,1,2,1999,2000,1,0.0,0.0,0.0,0,0,0,0,0,0,0.0,0.0,0.0,0.0,202500.0,202500.0
rands002,Scott Randall,Montreal Expos,NATEX,1,1,1,2,2004,2005,1,0.0,0.32,0.32,0,11,11,0,17,17,0.0,0.0,0.0,0.0,0.0,0.0
randw001,Willie Randolph,Pittsburgh Pirates,PIRATS,6,13,12,25,1975,1988,13,109.3,32.91,-76.39,4660,1733,-2927,17124,6632,-10492,6130.0,687.0,-5443.0,807000.0,0.0,-807000.0
randw001,Willie Randolph,Los Angeles Dodgers,DOGRS,2,2,3,5,1990,1992,2,3.97,3.33,-0.64,167,281,114,646,584,-62,0.0,0.0,0.0,1590000.0,485000.0,-1105000.0
ranem101,Merritt Ranew,Houston Astros,ASTROS,3,7,4,11,1963,1965,2,1.38,1.37,-0.01,248,133,-115,214,502,288,382.0,0.0,-382.0,0.0,0.0,0.0
ranem101,Merritt Ranew,Chicago Cubs,CUBS,4,6,7,13,1964,1968,4,-0.05,-1.91,-1.86,253,450,197,665,786,121,220.0,627.0,407.0,0.0,33000.0,33000.0
ranem101,Merritt Ranew,Milwaukee Brewers,BREWRS,2,4,3,7,1969,1971,2,1.89,-2.52,-4.41,337,186,-151,1153,421,-732,0.0,0.0,0.0,12000.0,0.0,-12000.0
rapac001,Clay Rapada,Chicago Cubs,CUBS,1,1,2,3,2007,2007,0,0.16,-0.36,-0.52,33,23,-10,0,55,55,81.0,0.0,-81.0,0.0,4775000.0,4775000.0
rappe101,Earl Rapp,Detroit Tigers,TIGRS,2,2,2,4,1949,1953,4,-0.13,-0.55,-0.42,21,416,395,60,1501,1441,0.0,0.0,0.0,0.0,10000.0,10000.0
rappe101,Earl Rapp,Chicago White Sox,WSOX,1,2,1,3,1949,1950,1,0.0,-0.16,-0.16,0,93,93,0,381,381,0.0,0.0,0.0,0.0,0.0,0.0
rappe101,Earl Rapp,Oakland,Oakland,1,1,2,3,1951,1951,0,0.0,0.0,0.0,13,0,-13,13,0,-13,0.0,0.0,0.0,0.0,0.0,0.0
rappe101,Earl Rapp,St.Louis Browns,ORLS,2,2,3,5,1952,1953,1,1.26,0.88,-0.38,175,96,-79,294,287,-7,0.0,0.0,0.0,0.0,0.0,0.0
rappg101,Goldie Rapp,New York Giants,GIANTS,3,7,5,12,1921,1927,6,10.96,8.57,-2.39,1223,793,-430,4975,2790,-2185,0.0,87.0,87.0,29500.0,14875.0,-14625.0
rappg101,Goldie Rapp,StPaul,StPaul,1,1,1,2,1921,1921,0,-0.7,0.0,0.7,58,0,-58,203,0,-203,0.0,0.0,0.0,0.0,0.0,0.0
rappp001,Pat Rapp,Florida Marlins,MARLNS,1,1,2,3,1997,1997,0,-0.56,0.0,0.56,16,0,-16,12,0,-12,99.0,0.0,-99.0,1125000.0,0.0,-1125000.0
rarib101,Bill Rariden,New York Giants,GIANTS,1,2,1,3,1919,1919,0,0.24,1.26,1.02,178,110,-68,609,443,-166,0.0,0.0,0.0,0.0,0.0,0.0
rasmc001,Colby Rasmus,St. Louis Cardinals,CARDS,2,5,5,10,2011,2013,2,7.58,0.4,-7.18,577,344,-233,1599,89,-1510,283.0,547.0,264.0,3193000.0,4329600.0,1136600.0
rasmc002,Cory Rasmus,Atlanta Braves,BRAVES,1,1,1,2,2013,2013,0,0.69,0.07,-0.62,89,50,-39,1,0,-1,349.0,42.0,-307.0,0.0,0.0,0.0
rasmd001,Dennis Rasmussen,California Angels,ANGELS,1,1,1,2,1982,1985,3,5.62,3.76,-1.86,103,85,-18,0,0,0,1792.0,1468.0,-324.0,0.0,0.0,0.0
rasmd001,Dennis Rasmussen,New York Yankees,YANKS,1,3,1,4,1983,1985,2,4.84,1.45,-3.39,236,20,-216,270,0,-270,2040.0,301.0,-1739.0,0.0,0.0,0.0
rasmd001,Dennis Rasmussen,San Diego Padres,PADRS,1,2,1,3,1984,1986,2,5.62,5.89,0.27,103,387,284,0,1380,1380,1792.0,0.0,-1792.0,0.0,0.0,0.0
rasmd001,Dennis Rasmussen,New York Yankees,YANKS,1,1,1,2,1987,1987,0,-0.19,0.18,0.37,36,8,-28,38,0,-38,305.0,144.0,-161.0,175000.0,900000.0,725000.0
rasmd001,Dennis Rasmussen,Cincinnati Reds,REDS,1,1,1,2,1988,1988,0,4.68,-0.02,-4.7,220,2,-218,252,1,-251,1999.0,12.0,-1987.0,457500.0,62500.0,-395000.0
rasmd002,Drew Rasmussen,Milwaukee Brewers,BREWRS,2,4,3,7,2021,2021,0,2.75,4.04,1.29,94,185,91,3,588,585,385.0,59.0,-326.0,0.0,0.0,0.0
rasme101,Eric Rasmussen,St. Louis Cardinals,CARDS,3,4,4,8,1978,1992,14,1.63,36.02,34.39,324,1646,1322,421,6032,5611,1443.0,2206.0,763.0,1100000.0,1720000.0,620000.0
rasmr001,Rob Rasmussen,Miami Marlins,MARLNS,1,2,1,3,2012,2012,0,1.76,-0.39,-2.15,340,81,-259,1309,338,-971,0.0,0.0,0.0,0.0,18500000.0,18500000.0
rasmr001,Rob Rasmussen,Houston Astros,ASTROS,1,1,1,2,2012,2013,1,0.0,0.0,0.0,0,0,0,0,0,0,0.0,0.0,0.0,0.0,0.0,0.0
rasmr001,Rob Rasmussen,Los Angeles Dodgers,DOGRS,1,1,2,3,2013,2013,0,0.0,-0.1,-0.1,0,21,21,0,53,53,0.0,0.0,0.0,0.0,0.0,0.0
rasmr001,Rob Rasmussen,Philadelphia Phillies,PHILS,1,2,1,3,2013,2014,1,0.38,-0.1,-0.48,46,4,-42,84,0,-84,37.0,7.0,-30.0,496000.0,0.0,-496000.0
rasmr001,Rob Rasmussen,Toronto Blue Jays,BJAYS,1,3,1,4,2015,2015,0,-1.1,0.06,1.16,24,25,1,0,0,0,43.0,57.0,14.0,0.0,0.0,0.0
rathf101,Fred Rath,Chicago White Sox,WSOX,1,1,1,2,1970,1970,0,0.0,0.0,0.0,0,0,0,0,0,0,0.0,0.0,0.0,0.0,0.0,0.0
rathm101,Morrie Rath,Philadelphia Athletics,ATLTCS,3,7,4,11,1910,1916,6,36.05,17.77,-18.28,769,1148,379,3166,4931,1765,0.0,0.0,0.0,0.0,0.0,0.0
rathm101,Morrie Rath,Cincinnati Reds,REDS,1,3,1,4,1921,1926,5,0.0,8.24,8.24,0,602,602,0,2409,2409,0.0,0.0,0.0,0.0,0.0,0.0
ratlg101,Gene Ratliff,Houston Astros,ASTROS,1,3,3,6,1966,1968,2,0.0,-0.84,-0.84,0,120,120,0,7,7,0.0,229.0,229.0,0.0,0.0,0.0
ratlj001,Jon Ratliff,Chicago Cubs,CUBS,2,2,2,4,1998,2000,2,3.16,-0.18,-3.34,406,19,-387,2,1,-1,464.0,32.0,-432.0,0.0,0.0,0.0
ratlp101,Paul Ratliff,Minnesota Twins,TWINS,1,1,1,2,1971,1976,5,-0.46,2.17,2.63,45,264,219,92,684,592,0.0,0.0,0.0,14000.0,0.0,-14000.0
ratlp101,Paul Ratliff,Milwaukee Brewers,BREWRS,1,2,2,4,1972,1972,0,0.0,-0.49,-0.49,0,42,42,0,79,79,0.0,0.0,0.0,14000.0,25000.0,11000.0
ratzs101,Steve Ratzer,Montreal Expos,NATEX,1,2,1,3,1981,1982,1,0.0,-0.53,-0.53,0,48,48,0,98,98,0.0,0.0,0.0,0.0,195000.0,195000.0
raubt101,Tommy Raub,Chicago Cubs,CUBS,2,9,2,11,1903,1913,10,5.14,24.13,18.99,814,1109,295,3290,4566,1276,0.0,1329.0,1329.0,0.0,0.0,0.0
raucb101,Bob Rauch,New York Mets,METS,1,2,1,3,1972,1972,0,0.32,0.0,-0.32,27,0,-27,0,0,0,369.0,0.0,-369.0,6000.0,19000.0,13000.0
raucj001,Jon Rauch,Chicago White Sox,WSOX,1,2,1,3,2004,2005,1,7.36,0.15,-7.21,749,178,-571,35,716,681,1328.0,0.0,-1328.0,0.0,3000000.0,3000000.0
raucj001,Jon Rauch,Washington Nationals,NATEX,4,6,6,12,2008,2013,5,5.52,4.37,-1.15,727,597,-130,2188,1224,-964,245.0,770.0,525.0,6301000.0,810000.0,-5491000.0
raucj001,Jon Rauch,Arizona Diamondbacks,DBACKS,1,1,1,2,2009,2012,3,1.94,-0.41,-2.35,78,16,-62,1,7,6,220.0,78.0,-142.0,2525000.0,0.0,-2525000.0
raudb101,Bob Raudman,Chicago Cubs,CUBS,1,2,1,3,1967,1968,1,0.0,-1.37,-1.37,0,40,40,0,4,4,0.0,70.0,70.0,0.0,0.0,0.0
raudb101,Bob Raudman,Cleveland Indians,INDINS,1,3,1,4,1967,1968,1,1.38,0.99,-0.39,316,130,-186,387,265,-122,982.0,0.0,-982.0,27000.0,25000.0,-2000.0
rautl101,Lance Rautzhan,Milwaukee Brewers,BREWRS,1,1,1,2,1979,1979,0,0.0,0.0,0.0,0,0,0,0,0,0,0.0,0.0,0.0,0.0,0.0,0.0
raver001,Rangel Ravelo,Chicago White Sox,WSOX,1,4,2,6,2014,2018,4,32.02,0.52,-31.5,1179,80,-1099,4237,2,-4235,1580.0,819.0,-761.0,500000.0,5345000.0,4845000.0
rawlj101,Johnny Rawlings,Philadelphia Phillies,PHILS,2,4,4,8,1921,1923,2,7.05,-3.87,-10.92,351,317,-34,1240,1284,44,0.0,0.0,0.0,5000.0,4000.0,-1000.0
rawlj101,Johnny Rawlings,Philadelphia Phillies,PHILS,2,3,5,8,1923,1925,2,15.64,3.41,-12.23,721,322,-399,1877,1147,-730,3746.0,484.0,-3262.0,5500.0,10200.0,4700.0
rawlj101,Johnny Rawlings,Cincinnati Reds,REDS,3,6,6,12,1914,1930,16,6.12,48.22,42.1,494,2027,1533,2101,8451,6350,0.0,27.0,27.0,0.0,3300.0,3300.0
rawls001,Shane Rawley,Montreal Expos,NATEX,1,2,1,3,1977,1978,1,0.21,-0.44,-0.65,10,62,52,0,27,27,25.0,305.0,280.0,0.0,0.0,0.0
rawls001,Shane Rawley,Cincinnati Reds,REDS,1,1,1,2,1977,1981,4,4.9,6.49,1.59,208,463,255,0,1574,1574,1133.0,0.0,-1133.0,0.0,0.0,0.0
rawls001,Shane Rawley,Seattle Mariners,MARNRS,3,5,6,11,1982,1987,5,10.18,6.88,-3.3,334,673,339,2,1334,1332,2811.0,1641.0,-1170.0,0.0,200000.0,200000.0
rawls001,Shane Rawley,New York Yankees,YANKS,2,3,3,6,1984,1987,3,9.85,0.11,-9.74,347,84,-263,467,188,-279,2713.0,241.0,-2472.0,62500.0,700000.0,637500.0
rawls001,Shane Rawley,Philadelphia Phillies,PHILS,2,3,5,8,1988,1990,2,0.05,2.78,2.73,124,304,180,306,1185,879,435.0,0.0,-435.0,1725000.0,103500.0,-1621500.0
ray-c001,Chris Ray,Baltimore Orioles,ORLS,1,2,2,4,2009,2010,1,0.65,0.2,-0.45,41,33,-8,0,5,5,95.0,572.0,477.0,850000.0,12868892.0,12018892.0
ray-c001,Chris Ray,Texas Rangers,RNGRS,1,2,1,3,2010,2010,0,0.12,-0.8,-0.92,56,57,1,0,195,195,72.0,0.0,-72.0,975000.0,4500000.0,3525000.0
ray-j001,Johnny Ray,Houston Astros,ASTROS,2,4,2,6,1981,1987,6,18.26,12.31,-5.95,1057,753,-304,4016,2821,-1195,147.0,0.0,-147.0,450000.0,0.0,-450000.0
ray-j001,Johnny Ray,Pittsburgh Pirates,PIRATS,2,2,3,5,1987,1988,1,4.86,0.02,-4.84,422,2,-420,1802,0,-1802,0.0,2.0,2.0,807000.0,0.0,-807000.0
ray-j101,Jim Ray,Houston Astros,ASTROS,1,2,2,4,1973,1975,2,0.24,-0.75,-0.99,348,138,-210,1336,4,-1332,157.0,233.0,76.0,66000.0,32000.0,-34000.0
ray-k001,Ken Ray,Kansas City Royals,ROYALS,1,1,1,2,2000,2000,0,0.0,-0.22,-0.22,0,53,53,0,0,0,0.0,225.0,225.0,0.0,0.0,0.0
ray-r002,Robbie Ray,Washington Nationals,NATEX,1,3,1,4,2013,2015,2,-1.71,4.39,6.1,114,103,-11,3,101,98,324.0,801.0,477.0,501250.0,4000000.0,3498750.0
ray-r002,Robbie Ray,Detroit Tigers,TIGRS,2,3,3,6,2014,2021,7,9.39,0.09,-9.3,428,326,-102,315,226,-89,2587.0,942.0,-1645.0,4000000.0,0.0,-4000000.0
ray-r002,Robbie Ray,Arizona Diamondbacks,DBACKS,1,2,1,3,2020,2021,1,6.89,0.07,-6.82,39,7,-32,5,0,-5,642.0,20.0,-622.0,9430000.0,0.0,-9430000.0
raydc101,Curt Raydon,Milwaukee Braves,BRAVES,2,10,2,12,1953,1960,7,8.19,12.74,4.55,794,729,-65,1824,3040,1216,2135.0,0.0,-2135.0,0.0,42000.0,42000.0
rayff001,Floyd Rayford,California Angels,ANGELS,1,2,1,3,1979,1982,3,1.32,0.49,-0.83,334,214,-120,998,642,-356,0.0,0.0,0.0,0.0,0.0,0.0
rayff001,Floyd Rayford,Baltimore Orioles,ORLS,2,2,2,4,1983,1984,1,0.74,0.26,-0.48,372,26,-346,772,44,-728,0.0,0.0,0.0,0.0,0.0,0.0
raymb101,Bugs Raymond,St. Louis Cardinals,CARDS,1,3,1,4,1908,1912,4,13.84,10.02,-3.82,1179,290,-889,3934,993,-2941,1350.0,10.0,-1340.0,0.0,0.0,0.0
raymc101,Claude Raymond,Houston Astros,ASTROS,1,2,2,4,1967,1972,5,0.31,-3.37,-3.68,194,234,40,17,135,118,428.0,1228.0,800.0,0.0,0.0,0.0
razib101,Barry Raziano,New York Mets,METS,2,2,2,4,1973,1976,3,-0.04,0.95,0.99,6,28,22,0,3,3,28.0,82.0,54.0,0.0,0.0,0.0
razib101,Barry Raziano,Kansas City Royals,ROYALS,1,2,1,3,1974,1975,1,-0.65,0.06,0.71,13,218,205,0,772,772,50.0,0.0,-50.0,0.0,0.0,0.0
rea-c001,Colin Rea,San Diego Padres,PADRS,4,12,9,21,2016,2021,5,1.39,-0.63,-2.02,553,209,-344,911,376,-535,973.0,576.0,-397.0,10660200.0,4650000.0,-6010200.0
rea-c001,Colin Rea,Miami Marlins,MARLNS,2,4,2,6,2016,2019,3,13.02,1.87,-11.15,374,112,-262,266,107,-159,2630.0,912.0,-1718.0,0.0,0.0,0.0
readr001,Randy Ready,Milwaukee Brewers,BREWRS,2,2,3,5,1986,1988,2,7.86,0.0,-7.86,267,0,-267,886,0,-886,0.0,0.0,0.0,0.0,0.0,0.0
readr001,Randy Ready,San Diego Padres,PADRS,8,16,17,33,1989,1998,9,97.76,11.55,-86.21,6640,1589,-5051,25821,4524,-21297,1355.0,1888.0,533.0,9476667.0,5045000.0,-4431667.0
realj001,J.T. Realmuto,Miami Marlins,MARLNS,1,1,4,5,2019,2019,0,9.39,1.01,-8.38,326,130,-196,1325,465,-860,0.0,0.0,0.0,0.0,0.0,0.0
reamb001,Britt Reames,St. Louis Cardinals,CARDS,4,6,7,13,2000,2004,4,4.8,5.31,0.51,823,756,-67,2678,110,-2568,559.0,1705.0,1146.0,6083333.0,13400281.0,7316948.0
rearc001,Chris Rearick,Tampa Bay Devil Rays,RAYS,1,1,1,2,2012,2015,3,-0.16,-0.13,0.03,10,4,-6,0,14,14,9.0,0.0,-9.0,0.0,0.0,0.0
rearj001,Jeff Reardon,New York Mets,METS,1,2,1,3,1981,1982,1,8.04,-0.11,-8.15,771,159,-612,125,526,401,1519.0,0.0,-1519.0,0.0,0.0,0.0
rearj001,Jeff Reardon,Montreal Expos,NATEX,9,14,16,30,1987,1996,9,5.9,1.65,-4.25,1311,1101,-210,2173,1393,-780,2901.0,1691.0,-1210.0,955000.0,1022500.0,67500.0
rearj001,Jeff Reardon,Boston Red Sox,RSOX,2,3,3,6,1992,1996,4,0.67,2.21,1.54,28,143,115,0,511,511,47.0,168.0,121.0,2755334.0,650000.0,-2105334.0
rebea101,Art Rebel,Boston Red Sox,RSOX,1,1,1,2,1943,1945,2,0.0,-1.41,-1.41,0,97,97,0,115,115,0.0,540.0,540.0,0.0,0.0,0.0
rebef101,Frank Reberger,San Diego Padres,PADRS,3,3,5,8,1969,1974,5,0.34,-0.06,-0.4,191,412,221,101,939,838,924.0,333.0,-591.0,0.0,0.0,0.0
recka001,Anthony Recker,Oakland Athletics,ATLTCS,1,1,1,2,2012,2012,0,0.12,0.0,-0.12,9,0,-9,21,0,-21,0.0,0.0,0.0,480000.0,0.0,-480000.0
recka001,Anthony Recker,Atlanta Braves,BRAVES,1,3,1,4,2017,2017,0,0.09,0.0,-0.09,1,0,-1,0,0,0,20.0,0.0,-20.0,12800000.0,0.0,-12800000.0
reddj001,Josh Reddick,Boston Red Sox,RSOX,1,3,2,5,2011,2013,2,15.82,0.39,-15.43,609,113,-496,2364,219,-2145,139.0,132.0,-7.0,0.0,1865000.0,1865000.0
reddj001,Josh Reddick,Oakland Athletics,ATLTCS,1,2,3,5,2016,2019,3,5.89,0.29,-5.6,179,30,-149,293,2,-291,1084.0,475.0,-609.0,0.0,0.0,0.0
reddt001,Tim Redding,Houston Astros,ASTROS,2,4,3,7,2005,2017,12,-1.96,1.37,3.33,91,404,313,219,1035,816,89.0,165.0,76.0,0.0,0.0,0.0
reddt001,Tim Redding,San Diego Padres,PADRS,1,3,1,4,2005,2005,0,-0.82,0.3,1.12,3,44,41,0,1,1,24.0,95.0,71.0,3975000.0,3000000.0,-975000.0
redfb101,Buck Redfern,Detroit Tigers,TIGRS,2,6,2,8,1925,1928,3,0.0,1.07,1.07,0,324,324,0,1271,1271,0.0,0.0,0.0,0.0,30000.0,30000.0
redfj001,Joe Redfield,New York Mets,METS,1,1,1,2,1986,1986,0,0.0,0.0,0.0,0,0,0,0,0,0,0.0,0.0,0.0,0.0,0.0,0.0
redfj001,Joe Redfield,Atlanta Braves,BRAVES,1,1,1,2,1987,1987,0,-0.02,0.0,0.02,1,0,-1,2,0,-2,0.0,0.0,0.0,0.0,0.0,0.0
redmg101,Glenn Redmon,Chicago White Sox,WSOX,4,8,5,13,1973,1982,9,34.62,31.7,-2.92,1501,1126,-375,4901,3877,-1024,2522.0,1033.0,-1489.0,0.0,600000.0,600000.0
redmm002,Mark Redman,Minnesota Twins,TWINS,1,1,1,2,2001,2001,0,2.76,0.29,-2.47,34,24,-10,5,0,-5,636.0,58.0,-578.0,235000.0,3975000.0,3740000.0
redmm002,Mark Redman,Detroit Tigers,TIGRS,1,2,3,5,2003,2010,7,2.96,5.55,2.59,57,267,210,66,23,-43,572.0,3820.0,3248.0,0.0,0.0,0.0
redmm002,Mark Redman,Florida Marlins,MARLNS,11,20,27,47,2003,2019,16,77.53,54.32,-23.21,2512,2883,371,6299,8326,2027,11245.0,5436.0,-5809.0,40718667.0,23598092.0,-17120575.0
redmm002,Mark Redman,Oakland Athletics,ATLTCS,5,8,7,15,2004,2017,13,-1.43,13.16,14.59,290,983,693,344,2743,2399,707.0,801.0,94.0,17758194.0,8571429.0,-9186765.0
redmm002,Mark Redman,Pittsburgh Pirates,PIRATS,1,1,2,3,2005,2008,3,0.11,-1.27,-1.38,30,95,65,3,0,-3,501.0,157.0,-344.0,4500000.0,0.0,-4500000.0
redmt002,Todd Redmond,Pittsburgh Pirates,PIRATS,1,1,1,2,2008,2011,3,0.0,-0.49,-0.49,0,172,172,0,0,0,0.0,256.0,256.0,0.0,0.0,0.0
redmt002,Todd Redmond,Atlanta Braves,BRAVES,1,1,1,2,2012,2013,1,-0.2,-0.57,-0.37,2,107,105,1,231,230,10.0,0.0,-10.0,0.0,0.0,0.0
redug001,Gary Redus,Cincinnati Reds,REDS,3,5,5,10,1985,1992,7,5.33,4.06,-1.27,304,351,47,423,887,464,1092.0,605.0,-487.0,1560833.0,1784333.0,223500.0
redug001,Gary Redus,Philadelphia Phillies,PHILS,1,1,2,3,1987,1987,0,3.47,-1.22,-4.69,207,10,-197,858,3,-855,0.0,35.0,35.0,0.0,0.0,0.0
redug001,Gary Redus,Chicago White Sox,WSOX,1,1,1,2,1988,1988,0,4.39,-0.59,-4.98,398,40,-358,1161,158,-1003,0.0,0.0,0.0,460000.0,172500.0,-287500.0
reeda001,Addison Reed,Chicago White Sox,WSOX,1,1,1,2,2013,2018,5,-0.62,-0.05,0.57,195,245,50,2,941,939,300.0,9.0,-291.0,520000.0,0.0,-520000.0
reeda001,Addison Reed,Arizona Diamondbacks,DBACKS,1,1,2,3,2015,2019,4,5.08,0.63,-4.45,283,69,-214,0,35,35,426.0,376.0,-50.0,4875000.0,0.0,-4875000.0
reeda001,Addison Reed,New York Mets,METS,2,6,6,12,2017,2018,1,0.07,-0.3,-0.37,222,27,-195,565,0,-565,457.0,33.0,-424.0,24250000.0,12258065.0,-11991935.0
reedc001,Chris Reed,Los Angeles Dodgers,DOGRS,1,1,1,2,2015,2017,2,0.0,0.57,0.57,4,103,99,0,1,1,12.0,150.0,138.0,0.0,0.0,0.0
reedc002,Cody Reed,Kansas City Royals,ROYALS,1,3,2,5,2015,2015,0,-1.23,0.27,1.5,231,13,-218,147,0,-147,1419.0,244.0,-1175.0,0.0,10000000.0,10000000.0
reedc002,Cody Reed,Cincinnati Reds,REDS,1,1,1,2,2020,2020,0,0.1,0.0,-0.1,14,0,-14,0,0,0,37.0,0.0,-37.0,0.0,0.0,0.0
reedd001,Darren Reed,New York Yankees,YANKS,1,3,2,5,1987,1989,2,0.13,-0.61,-0.74,44,148,104,95,521,426,0.0,0.0,0.0,0.0,250000.0,250000.0
reedd001,Darren Reed,New York Mets,METS,1,2,2,4,1991,1991,0,-0.75,0.0,0.75,42,0,-42,88,0,-88,0.0,0.0,0.0,0.0,0.0,0.0
reedd001,Darren Reed,Montreal Expos,NATEX,1,1,1,2,1992,1992,0,-0.28,-0.51,-0.23,14,18,4,37,4,-33,0.0,52.0,52.0,119000.0,920000.0,801000.0
reedd001,Darren Reed,Minnesota Twins,TWINS,1,1,1,2,1992,1992,0,0.0,0.0,0.0,0,0,0,0,0,0,0.0,0.0,0.0,0.0,0.0,0.0
reede002,Evan Reed,Texas Rangers,RNGRS,1,2,1,3,2010,2010,0,0.0,-0.56,-0.56,0,30,30,0,105,105,0.0,0.0,0.0,0.0,6000000.0,6000000.0
reedh102,Howie Reed,Kansas City Athletics,ATLTCS,16,35,28,63,1961,1976,15,57.63,48.82,-8.81,6807,4417,-2390,14909,13848,-1061,10799.0,3800.0,-6999.0,387100.0,512500.0,125400.0
reedh102,Howie Reed,Los Angeles Dodgers,DOGRS,1,1,2,3,1966,1966,0,0.75,0.0,-0.75,38,0,-38,6,0,-6,129.0,0.0,-129.0,17000.0,8500.0,-8500.0
reedh102,Howie Reed,California Angels,ANGELS,1,1,1,2,1966,1966,0,0.09,0.0,-0.09,8,0,-8,4,0,-4,55.0,0.0,-55.0,0.0,0.0,0.0
reedj001,Jeff Reed,Minnesota Twins,TWINS,2,7,4,11,1987,1989,2,2.19,3.46,1.27,550,289,-261,1650,183,-1467,872.0,1114.0,242.0,103500.0,900000.0,796500.0
reedj001,Jeff Reed,Montreal Expos,NATEX,3,5,4,9,1988,1992,4,1.15,0.52,-0.63,739,280,-459,1881,660,-1221,41.0,0.0,-41.0,330000.0,317500.0,-12500.0
reedj002,Jerry Reed,Philadelphia Phillies,PHILS,3,6,5,11,1982,1987,5,5.02,15.9,10.88,358,462,104,942,672,-270,1316.0,2480.0,1164.0,1109333.0,1060833.0,-48500.0
reedj003,Jody Reed,Colorado Rockies,ROCKS,1,1,1,2,1992,1993,1,0.37,0.0,-0.37,132,0,-132,504,0,-504,0.0,0.0,0.0,0.0,0.0,0.0
reedj003,Jody Reed,San Diego Padres,PADRS,1,1,2,3,1997,1999,2,-0.37,0.0,0.37,52,0,-52,129,0,-129,0.0,0.0,0.0,0.0,0.0,0.0
reedj004,Jeremy Reed,Chicago White Sox,WSOX,4,9,8,17,2004,2013,9,26.28,24.52,-1.76,2038,506,-1532,7101,844,-6257,1892.0,4790.0,2898.0,12920000.0,9770000.0,-3150000.0
reedj004,Jeremy Reed,Seattle Mariners,MARNRS,8,16,16,32,2008,2015,7,0.83,32.43,31.6,1230,1763,533,2304,5784,3480,1045.0,2794.0,1749.0,18727500.0,18500000.0,-227500.0
reedm001,Michael Reed,Minnesota Twins,TWINS,1,1,2,3,2019,2019,0,-0.32,0.0,0.32,4,0,-4,8,0,-8,0.0,0.0,0.0,0.0,0.0,0.0
reedr001,Ron Reed,Atlanta Braves,BRAVES,3,6,6,12,1975,1977,2,7.21,1.02,-6.19,424,370,-54,701,70,-631,842.0,1041.0,199.0,0.0,187000.0,187000.0
reedr001,Ron Reed,St. Louis Cardinals,CARDS,1,1,1,2,1975,1978,3,10.43,1.24,-9.19,916,180,-736,105,399,294,2427.0,0.0,-2427.0,0.0,0.0,0.0
reedr001,Ron Reed,Philadelphia Phillies,PHILS,1,1,1,2,1983,1985,2,1.34,2.71,1.37,53,110,57,1,126,125,219.0,970.0,751.0,0.0,0.0,0.0
reedr002,Rick Reed,New York Mets,METS,4,10,9,19,2001,2008,7,16.08,-0.18,-16.26,1408,384,-1024,2315,1225,-1090,2785.0,327.0,-2458.0,14750000.0,11977500.0,-2772500.0
reeds001,Steve Reed,San Francisco Giants,GIANTS,1,2,3,5,1998,1998,0,1.81,-0.51,-2.32,252,118,-134,209,56,-153,512.0,113.0,-399.0,1172500.0,2920000.0,1747500.0
reeds001,Steve Reed,Cleveland Indians,INDINS,2,3,3,6,2001,2003,2,-0.19,-0.02,0.17,198,59,-139,2,0,-2,300.0,180.0,-120.0,4300000.0,1900000.0,-2400000.0
reeds001,Steve Reed,San Diego Padres,PADRS,2,5,4,9,2002,2009,7,20.01,17.43,-2.58,923,844,-79,3191,3702,511,1341.0,29.0,-1312.0,805000.0,8833333.0,8028333.0
reesj101,Jimmie Reese,Oakland,Oakland,1,2,1,3,1927,1927,0,12.23,0.0,-12.23,638,0,-638,2477,0,-2477,0.0,0.0,0.0,0.0,0.0,0.0
reesj101,Jimmie Reese,New York Yankees,YANKS,1,5,2,7,1931,1947,16,0.0,15.3,15.3,0,992,992,0,1098,1098,0.0,2971.0,2971.0,19500.0,0.0,-19500.0
reesk001,Kevin Reese,San Diego Padres,PADRS,1,1,1,2,2001,2004,3,0.18,0.0,-0.18,12,0,-12,16,0,-16,0.0,0.0,0.0,0.0,0.0,0.0
reesp001,Pokey Reese,Cincinnati Reds,REDS,1,2,2,4,2001,2006,5,0.51,2.6,2.09,83,248,165,0,53,53,121.0,683.0,562.0,3825000.0,1166667.0,-2658333.0
reesp001,Pokey Reese,Colorado Rockies,ROCKS,1,1,1,2,2001,2001,0,1.26,0.0,-1.26,96,0,-96,268,0,-268,0.0,0.0,0.0,0.0,1050000.0,1050000.0
reesp101,Pee Wee Reese,Boston Red Sox,RSOX,2,3,6,9,1939,1947,8,68.5,1.66,-66.84,2166,64,-2102,9470,50,-9420,0.0,452.0,452.0,0.0,3000.0,3000.0
reevb101,Bobby Reeves,Washington Senators,TWINS,1,5,1,6,1928,1941,13,14.54,41.49,26.95,801,1492,691,1696,6460,4764,3390.0,0.0,-3390.0,20500.0,6000.0,-14500.0
refsr001,Rob Refsnyder,New York Yankees,YANKS,1,1,1,2,2017,2019,2,-0.2,0.0,0.2,32,0,-32,58,0,-58,0.0,0.0,0.0,0.0,0.0,0.0
regap101,Phil Regan,Detroit Tigers,TIGRS,1,1,1,2,1965,1965,0,6.0,0.0,-6.0,250,0,-250,37,0,-37,662.0,0.0,-662.0,17500.0,0.0,-17500.0
regap101,Phil Regan,Los Angeles Dodgers,DOGRS,3,4,4,8,1968,1970,2,15.48,-0.58,-16.06,1246,61,-1185,2529,137,-2392,1193.0,0.0,-1193.0,36500.0,0.0,-36500.0
rehgw101,Wally Rehg,StPaul,StPaul,1,1,1,2,1913,1913,0,-0.91,0.0,0.91,123,0,-123,287,0,-287,0.0,0.0,0.0,0.0,0.0,0.0
rehgw101,Wally Rehg,Boston Braves,BRAVES,1,1,1,2,1919,1919,0,-0.11,0.14,0.25,5,31,26,14,92,78,0.0,0.0,0.0,0.0,0.0,0.0
reicr101,Rick Reichardt,California Angels,ANGELS,10,16,20,36,1970,1977,7,30.4,30.36,-0.04,1555,1533,-22,4572,5092,520,3213.0,1843.0,-1370.0,333500.0,358250.0,24750.0
reicr101,Rick Reichardt,Washington Senators,RNGRS,1,1,1,2,1971,1971,0,1.62,-0.56,-2.18,285,46,-239,1036,17,-1019,0.0,185.0,185.0,0.0,0.0,0.0
reids001,Sean Reid-Foley,Toronto Blue Jays,BJAYS,1,3,1,4,2021,2021,0,-0.51,2.02,2.53,63,30,-33,3,2,-1,137.0,452.0,315.0,0.0,0.0,0.0
reilt101,Tom Reilly,DesMoines,DesMoines,1,1,2,3,1914,1914,0,0.0,0.0,0.0,1,0,-1,1,0,-1,0.0,0.0,0.0,0.0,0.0,0.0
reimk001,Kevin Reimer,Colorado Rockies,ROCKS,2,3,3,6,1992,2000,8,0.09,6.28,6.19,250,1232,982,991,4864,3873,0.0,107.0,107.0,7250000.0,3548333.0,-3701667.0
reinc001,Chad Reineke,Houston Astros,ASTROS,1,1,1,2,2008,2008,0,-0.01,1.18,1.19,8,24,16,6,26,20,54.0,212.0,158.0,0.0,4750000.0,4750000.0
reinc001,Chad Reineke,San Diego Padres,PADRS,1,1,1,2,2009,2009,0,-0.06,0.0,0.06,1,0,-1,0,0,0,15.0,0.0,-15.0,0.0,0.0,0.0
reinj001,Jack Reinheimer,Seattle Mariners,MARNRS,3,7,4,11,2015,2017,2,4.57,3.33,-1.24,655,244,-411,2424,508,-1916,92.0,403.0,311.0,9532900.0,9014000.0,-518900.0
reisa101,Al Reiss,Philadelphia Athletics,ATLTCS,1,2,1,3,1932,1936,4,0.0,1.11,1.11,0,224,224,0,182,182,0.0,1445.0,1445.0,2500.0,0.0,-2500.0
reisb102,Bobby Reis,Brooklyn Dodgers,DOGRS,5,10,8,18,1935,1948,13,23.18,15.94,-7.24,1423,1121,-302,4586,3821,-765,1769.0,791.0,-978.0,0.0,0.0,0.0
reisb102,Bobby Reis,Boston Braves,BRAVES,6,18,10,28,1938,1952,14,22.0,33.53,11.53,1506,1625,119,5516,5420,-96,0.0,2449.0,2449.0,12500.0,0.0,-12500.0
reisp101,Pete Reiser,Brooklyn Dodgers,DOGRS,2,2,4,6,1948,1949,1,1.99,-0.55,-2.54,202,55,-147,574,158,-416,0.0,0.0,0.0,0.0,0.0,0.0
reist101,Tommy Reis,Boston Braves,BRAVES,6,18,10,28,1938,1952,14,22.0,33.53,11.53,1506,1625,119,5516,5420,-96,0.0,2449.0,2449.0,12500.0,0.0,-12500.0
reitb001,Brian Reith,New York Yankees,YANKS,1,4,2,6,2000,2000,0,-1.35,0.26,1.61,143,16,-127,19,0,-19,383.0,274.0,-109.0,0.0,4750000.0,4750000.0
reitc001,Chris Reitsma,Boston Red Sox,RSOX,1,2,1,3,2000,2001,1,1.86,0.82,-1.04,246,137,-109,104,537,433,1213.0,0.0,-1213.0,0.0,7000000.0,7000000.0
reitc001,Chris Reitsma,Cincinnati Reds,REDS,1,1,2,3,2004,2006,2,-0.6,-0.35,0.25,368,5,-363,1,4,3,543.0,46.0,-497.0,0.0,0.0,0.0
reith101,Heinie Reitz,Baltimore Orioles,BLN,2,4,4,8,1897,1899,2,2.28,18.6,16.32,271,446,175,1095,1688,593,148.0,1122.0,974.0,0.0,0.0,0.0
reith101,Heinie Reitz,Washington Senators,WSN,1,1,3,4,1898,1900,2,0.36,1.28,0.92,35,408,373,149,1684,1535,0.0,0.0,0.0,0.0,0.0,0.0
reith101,Heinie Reitz,Pittsburgh Pirates,PIRATS,1,1,1,2,1900,1901,1,0.0,0.0,0.0,0,0,0,0,0,0,0.0,0.0,0.0,0.0,0.0,0.0
reitk101,Ken Reitz,St. Louis Cardinals,CARDS,11,28,21,49,1975,1992,17,88.37,102.91,14.54,7178,4570,-2608,21650,14808,-6842,8355.0,4335.0,-4020.0,1533333.0,576667.0,-956666.0
reitk101,Ken Reitz,San Francisco Giants,GIANTS,3,3,3,6,1976,1980,4,8.05,-2.42,-10.47,1045,207,-838,2865,275,-2590,1587.0,416.0,-1171.0,0.0,0.0,0.0
reitk101,Ken Reitz,St. Louis Cardinals,CARDS,1,3,1,4,1980,1984,4,14.5,6.0,-8.5,1050,498,-552,4046,39,-4007,0.0,1190.0,1190.0,0.0,700000.0,700000.0
rekab001,Bryan Rekar,Kansas City Royals,ROYALS,1,1,1,2,2002,2004,2,0.0,-0.19,-0.19,0,1,1,0,0,0,0.0,10.0,10.0,0.0,0.0,0.0
relad001,Desi Relaford,Seattle Mariners,MARNRS,1,1,1,2,1996,1996,0,-1.77,0.81,2.58,320,12,-308,1189,0,-1189,0.0,208.0,208.0,0.0,700000.0,700000.0
relad001,Desi Relaford,Philadelphia Phillies,PHILS,1,1,1,2,2000,2001,1,-0.07,0.11,0.18,45,17,-28,189,27,-162,0.0,0.0,0.0,345000.0,203000.0,-142000.0
relad001,Desi Relaford,New York Mets,METS,2,4,5,9,2001,2003,2,1.23,0.97,-0.26,130,205,75,408,385,-23,84.0,416.0,332.0,7175000.0,4958000.0,-2217000.0
relad001,Desi Relaford,San Francisco Giants,GIANTS,1,2,1,3,2002,2002,0,1.16,3.15,1.99,112,154,42,376,628,252,0.0,0.0,0.0,0.0,0.0,0.0
remlm001,Mike Remlinger,San Francisco Giants,GIANTS,4,7,11,18,1991,1998,7,10.32,12.82,2.5,410,1133,723,849,798,-51,1958.0,3071.0,1113.0,9577778.0,5766667.0,-3811111.0
remlm001,Mike Remlinger,New York Mets,METS,1,1,1,2,1995,1995,0,1.81,0.0,-1.81,250,0,-250,90,0,-90,950.0,0.0,-950.0,118500.0,0.0,-118500.0
remlm001,Mike Remlinger,Cincinnati Reds,REDS,1,2,1,3,1995,1995,0,-1.55,0.0,1.55,126,0,-126,291,0,-291,0.0,0.0,0.0,0.0,0.0,0.0
remlm001,Mike Remlinger,Cincinnati Reds,REDS,8,13,16,29,1998,2013,15,32.31,35.48,3.17,2118,2354,236,5649,6223,574,1997.0,6510.0,4513.0,12325000.0,17590000.0,5265000.0
remlm001,Mike Remlinger,Chicago Cubs,CUBS,1,2,1,3,2005,2005,0,-0.55,0.0,0.55,8,0,-8,0,0,0,20.0,0.0,-20.0,4233333.0,0.0,-4233333.0
remyj001,Jerry Remy,California Angels,ANGELS,1,1,2,3,1977,1984,7,6.5,10.47,3.97,710,192,-518,3118,0,-3118,0.0,2086.0,2086.0,80000.0,0.0,-80000.0
rendt001,Tony Renda,Washington Nationals,NATEX,1,1,1,2,2015,2015,0,0.0,0.22,0.22,0,15,15,0,0,0,0.0,18.0,18.0,0.0,1300000.0,1300000.0
rendt001,Tony Renda,New York Yankees,YANKS,4,8,7,15,2015,2020,5,-1.49,8.03,9.52,440,197,-243,1007,8,-999,290.0,1270.0,980.0,3936900.0,21050000.0,17113100.0
renfh001,Hunter Renfroe,San Diego Padres,PADRS,1,3,2,5,2019,2021,2,-0.02,1.32,1.34,42,186,144,139,686,547,0.0,0.0,0.0,582100.0,4100000.0,3517900.0
rengl001,Luis Rengifo,Seattle Mariners,MARNRS,1,3,2,5,2017,2019,2,0.0,0.36,0.36,0,30,30,0,38,38,0.0,44.0,44.0,0.0,0.0,0.0
rengl001,Luis Rengifo,Tampa Bay Devil Rays,RAYS,1,1,1,2,2018,2018,0,0.32,2.33,2.01,195,140,-55,702,560,-142,0.0,0.0,0.0,0.0,0.0,0.0
renij101,Jim Reninger,Baltimore,Baltimore,1,1,2,3,1938,1938,0,-0.27,0.0,0.27,16,0,-16,15,0,-15,119.0,0.0,-119.0,0.0,1500.0,1500.0
renks101,Steve Renko,New York Mets,METS,1,5,1,6,1969,1971,2,11.34,3.37,-7.97,538,281,-257,615,957,342,4078.0,0.0,-4078.0,0.0,50000.0,50000.0
renks101,Steve Renko,Montreal Expos,NATEX,2,3,2,5,1976,1978,2,19.9,-0.47,-20.37,1883,153,-1730,6872,280,-6592,648.0,557.0,-91.0,0.0,0.0,0.0
renks101,Steve Renko,Chicago Cubs,CUBS,2,2,3,5,1977,1978,1,1.3,0.52,-0.78,8,24,16,0,56,56,160.0,0.0,-160.0,0.0,0.0,0.0
renks101,Steve Renko,Chicago White Sox,WSOX,1,2,1,3,1978,1979,1,6.89,-0.37,-7.26,401,28,-373,1175,0,-1175,453.0,189.0,-264.0,0.0,0.0,0.0
renks101,Steve Renko,Boston Red Sox,RSOX,1,2,3,5,1981,1985,4,12.81,0.12,-12.69,526,77,-449,1947,135,-1812,774.0,448.0,-326.0,0.0,0.0,0.0
rennb101,Bill Renna,New York Yankees,YANKS,16,45,38,83,1953,1970,17,48.62,78.17,29.55,7017,4726,-2291,22732,11340,-11392,3607.0,11554.0,7947.0,313000.0,125500.0,-187500.0
rennb101,Bill Renna,Kansas City Athletics,ATLTCS,42,95,97,192,1956,1976,20,133.5,78.63,-54.87,13774,10527,-3247,30995,29007,-1988,20345.0,13097.0,-7248.0,522100.0,676700.0,154600.0
rennb101,Bill Renna,New York Yankees,YANKS,2,3,3,6,1957,1960,3,0.23,-2.55,-2.78,87,104,17,126,53,-73,0.0,406.0,406.0,0.0,0.0,0.0
renst101,Tony Rensa,Chicago White Sox,WSOX,3,6,3,9,1939,1950,11,-0.26,2.54,2.8,394,795,401,1460,3225,1765,0.0,0.0,0.0,14200.0,0.0,-14200.0
renst101,Tony Rensa,Dallas,Dallas,1,1,3,4,1936,1936,0,0.61,0.0,-0.61,99,0,-99,283,0,-283,0.0,0.0,0.0,0.0,6700.0,6700.0
rente001,Edgar Renteria,Florida Marlins,MARLNS,5,10,14,24,1998,2015,17,28.19,25.74,-2.45,1796,2755,959,6742,2798,-3944,1797.0,6839.0,5042.0,13432000.0,10473543.0,-2958457.0
rente001,Edgar Renteria,Boston Red Sox,RSOX,7,14,9,23,2005,2011,6,23.71,8.9,-14.81,1892,794,-1098,4226,1778,-2448,1235.0,750.0,-485.0,16391733.0,1897000.0,-14494733.0
rente001,Edgar Renteria,Atlanta Braves,BRAVES,2,4,3,7,2007,2012,5,-0.89,9.81,10.7,691,493,-198,1061,1274,213,4336.0,2160.0,-2176.0,9000000.0,2500000.0,-6500000.0
rentr001,Rich Renteria,Pittsburgh Pirates,PIRATS,1,1,1,2,1986,1986,0,-0.79,0.0,0.79,43,0,-43,102,0,-102,0.0,0.0,0.0,0.0,0.0,0.0
repor101,Roger Repoz,New York Yankees,YANKS,3,5,4,9,1966,1973,7,1.66,4.77,3.11,451,607,156,554,678,124,1018.0,1714.0,696.0,17000.0,41500.0,24500.0
repor101,Roger Repoz,Kansas City Athletics,ATLTCS,1,1,2,3,1967,1967,0,5.22,-0.69,-5.91,563,20,-543,1705,4,-1701,0.0,66.0,66.0,0.0,30000.0,30000.0
repor101,Roger Repoz,California Angels,ANGELS,3,3,4,7,1972,1974,2,-0.01,-0.28,-0.27,245,41,-204,776,52,-724,0.0,0.0,0.0,27000.0,0.0,-27000.0
repur101,Rip Repulski,St. Louis Cardinals,CARDS,3,7,6,13,1956,1963,7,8.24,1.4,-6.84,1198,700,-498,4161,1883,-2278,89.0,111.0,22.0,0.0,0.0,0.0
repur101,Rip Repulski,Philadelphia Phillies,PHILS,1,3,1,4,1958,1958,0,-0.86,0.0,0.86,137,0,-137,129,0,-129,226.0,0.0,-226.0,0.0,0.0,0.0
repur101,Rip Repulski,Los Angeles Dodgers,DOGRS,1,1,1,2,1960,1960,0,-0.17,0.0,0.17,88,0,-88,177,0,-177,0.0,0.0,0.0,17000.0,0.0,-17000.0
resoc001,Chris Resop,Florida Marlins,MARLNS,2,2,2,4,2006,2013,7,0.65,2.68,2.03,266,333,67,0,5,5,405.0,545.0,140.0,2827000.0,0.0,-2827000.0
resoc001,Chris Resop,Pittsburgh Pirates,PIRATS,2,3,2,5,2012,2014,2,-0.32,-0.07,0.25,19,131,112,0,397,397,54.0,0.0,-54.0,850000.0,0.0,-850000.0
restd101,Dino Restelli,SanFrancisco,SanFrancisco,1,1,2,3,1949,1949,0,1.3,0.0,-1.3,93,0,-93,314,0,-314,0.0,0.0,0.0,0.0,0.0,0.0
restd101,Dino Restelli,Cleveland Indians,INDINS,1,2,1,3,1952,1952,0,0.0,0.05,0.05,0,44,44,0,98,98,0.0,0.0,0.0,0.0,0.0,0.0
rettm101,Merv Rettenmund,Baltimore Orioles,ORLS,1,3,2,5,1973,1977,4,4.01,5.74,1.73,498,137,-361,1375,0,-1375,0.0,2543.0,2543.0,40000.0,29000.0,-11000.0
rettm101,Merv Rettenmund,Cincinnati Reds,REDS,1,1,1,2,1976,1977,1,2.31,0.0,-2.31,193,0,-193,338,0,-338,0.0,0.0,0.0,0.0,0.0,0.0
retzk101,Ken Retzer,Cleveland Indians,INDINS,1,1,1,2,1961,1961,0,1.36,0.0,-1.36,237,0,-237,754,0,-754,0.0,0.0,0.0,0.0,0.0,0.0
retzk101,Ken Retzer,Washington Senators,RNGRS,1,1,1,2,1964,1964,0,0.0,0.0,0.0,0,0,0,0,0,0,0.0,0.0,0.0,13000.0,7000.0,-6000.0
retzk101,Ken Retzer,Minnesota Twins,TWINS,1,1,1,2,1966,1967,1,0.0,0.11,0.11,0,10,10,0,20,20,0.0,0.0,0.0,0.0,0.0,0.0
retzk101,Ken Retzer,Houston Astros,ASTROS,4,5,6,11,1967,1978,11,2.92,1.17,-1.75,377,1322,945,888,4912,4024,159.0,122.0,-37.0,0.0,29000.0,29000.0
reule101,Ed Reulbach,Chicago Cubs,CUBS,1,1,2,3,1913,1915,2,5.81,-0.82,-6.63,118,36,-82,128,23,-105,1107.0,201.0,-906.0,3500.0,2600.0,-900.0
reusj001,Jerry Reuss,St. Louis Cardinals,CARDS,4,5,5,10,1972,1974,2,2.19,2.3,0.11,180,169,-11,181,146,-35,1620.0,735.0,-885.0,0.0,0.0,0.0
reusj001,Jerry Reuss,Houston Astros,ASTROS,7,12,10,22,1973,1989,16,20.84,15.66,-5.18,1770,1925,155,3774,5378,1604,6401.0,1859.0,-4542.0,22500.0,16500.0,-6000.0
reusj001,Jerry Reuss,Pittsburgh Pirates,PIRATS,2,4,4,8,1979,1992,13,25.61,45.02,19.41,708,1040,332,498,1195,697,5981.0,9557.0,3576.0,1030000.0,180000.0,-850000.0
reusj001,Jerry Reuss,Chicago White Sox,WSOX,1,1,1,2,1989,1993,4,-0.25,0.65,0.9,7,38,31,0,0,0,101.0,129.0,28.0,590000.0,0.0,-590000.0
reusp101,Paul Reuschel,Chicago Cubs,CUBS,1,1,1,2,1978,1978,0,0.9,0.0,-0.9,36,0,-36,0,0,0,405.0,0.0,-405.0,0.0,0.0,0.0
reusr001,Rick Reuschel,Chicago Cubs,CUBS,5,6,7,13,1981,1988,7,0.14,5.19,5.05,134,774,640,169,808,639,507.0,2424.0,1917.0,490000.0,730000.0,240000.0
reusr001,Rick Reuschel,Pittsburgh Pirates,PIRATS,2,3,3,6,1987,1995,8,8.61,9.74,1.13,246,761,515,229,1691,1462,2069.0,878.0,-1191.0,1500000.0,650000.0,-850000.0
reveb001,Ben Revere,Minnesota Twins,TWINS,1,1,2,3,2012,2020,8,4.92,1.09,-3.83,335,236,-99,1350,4,-1346,0.0,1094.0,1094.0,492500.0,495000.0,2500.0
reveb001,Ben Revere,Philadelphia Phillies,PHILS,2,2,3,5,2015,2016,1,0.5,0.0,-0.5,100,0,-100,246,0,-246,57.0,0.0,-57.0,4100000.0,0.0,-4100000.0
reveb001,Ben Revere,Toronto Blue Jays,BJAYS,2,4,3,7,2016,2016,0,-0.69,0.9,1.59,124,68,-56,375,0,-375,55.0,171.0,116.0,0.0,0.0,0.0
reved101,Dave Revering,Cincinnati Reds,REDS,2,3,3,6,1978,1981,3,9.19,3.21,-5.98,618,452,-166,1598,32,-1566,417.0,994.0,577.0,0.0,0.0,0.0
reved101,Dave Revering,Oakland Athletics,ATLTCS,1,3,2,5,1981,1983,2,-0.62,1.11,1.73,74,210,136,201,288,87,0.0,1046.0,1046.0,0.0,0.0,0.0
reved101,Dave Revering,New York Yankees,YANKS,1,3,1,4,1982,1983,1,-0.79,-0.41,0.38,55,69,14,159,249,90,0.0,0.0,0.0,250000.0,800000.0,550000.0
reyea001,Alberto Reyes,Milwaukee Brewers,BREWRS,1,1,1,2,1999,2001,2,-0.07,0.31,0.38,43,74,31,0,8,8,128.0,178.0,50.0,0.0,0.0,0.0
reyea001,Alberto Reyes,Baltimore Orioles,ORLS,1,1,2,3,2000,2001,1,0.51,-0.89,-1.4,48,42,-6,4,0,-4,97.0,113.0,16.0,620000.0,2250000.0,1630000.0
reyea002,Anthony Reyes,St. Louis Cardinals,CARDS,1,1,1,2,2008,2008,0,0.94,0.0,-0.94,15,0,-15,1,0,-1,218.0,0.0,-218.0,392500.0,0.0,-392500.0
reyec001,Carlos Reyes,San Diego Padres,PADRS,4,8,7,15,1998,2002,4,4.23,0.82,-3.41,472,389,-83,1448,834,-614,139.0,215.0,76.0,3650000.0,3850000.0,200000.0
reyed001,Dennys Reyes,Los Angeles Dodgers,DOGRS,1,2,1,3,1998,2001,3,-0.12,3.63,3.75,362,466,104,111,0,-111,591.0,706.0,115.0,170000.0,650000.0,480000.0
reyed001,Dennys Reyes,Cincinnati Reds,REDS,1,2,2,4,2001,2006,5,0.51,2.6,2.09,83,248,165,0,53,53,121.0,683.0,562.0,3825000.0,1166667.0,-2658333.0
reyed001,Dennys Reyes,Colorado Rockies,ROCKS,2,3,4,7,2002,2003,1,-0.86,0.5,1.36,91,99,8,186,247,61,127.0,0.0,-127.0,3650000.0,1850000.0,-1800000.0
reyef001,Franmil Reyes,San Diego Padres,PADRS,2,7,4,11,2019,2021,2,6.96,0.42,-6.54,597,36,-561,2267,75,-2192,192.0,42.0,-150.0,570500.0,0.0,-570500.0
reyeg001,Gil Reyes,Los Angeles Dodgers,DOGRS,1,1,1,2,1989,1989,0,0.98,-0.18,-1.16,87,4,-83,234,0,-234,0.0,10.0,10.0,0.0,0.0,0.0
reyeg002,Gerardo Reyes,Tampa Bay Devil Rays,RAYS,4,8,12,20,2014,2020,6,10.52,4.14,-6.38,1388,617,-771,4818,2218,-2600,195.0,136.0,-59.0,3254200.0,506400.0,-2747800.0
reyeg002,Gerardo Reyes,San Diego Padres,PADRS,1,1,1,2,2020,2020,0,0.0,-0.16,-0.16,0,9,9,0,30,30,0.0,0.0,0.0,0.0,6850000.0,6850000.0
reyej001,Jose Reyes,Miami Marlins,MARLNS,12,33,32,65,2012,2020,8,57.99,24.95,-33.04,3997,2605,-1392,9990,7444,-2546,7539.0,4278.0,-3261.0,66200000.0,34658100.0,-31541900.0
reyej001,Jose Reyes,Toronto Blue Jays,BJAYS,1,4,2,6,2015,2018,3,-2.36,5.17,7.53,267,257,-10,284,987,703,875.0,49.0,-826.0,0.0,0.0,0.0
reyej003,Jo-Jo Reyes,Atlanta Braves,BRAVES,2,5,5,10,2010,2015,5,10.05,1.22,-8.83,679,438,-241,1672,1292,-380,1064.0,60.0,-1004.0,1260000.0,10000000.0,8740000.0
reyev001,Victor Reyes,Atlanta Braves,BRAVES,1,1,1,2,2015,2015,0,0.0,0.0,0.0,0,0,0,0,0,0,0.0,0.0,0.0,0.0,0.0,0.0
reyna001,Armando Reynoso,Colorado Rockies,ROCKS,1,1,1,2,1996,1999,3,1.87,5.31,3.44,53,402,349,63,17,-46,479.0,761.0,282.0,440000.0,225000.0,-215000.0
reyna101,Archie Reynolds,Chicago Cubs,CUBS,1,1,1,2,1970,1973,3,-0.31,1.84,2.15,30,92,62,2,66,64,82.0,541.0,459.0,10000.0,0.0,-10000.0
reyna101,Archie Reynolds,California Angels,ANGELS,1,1,1,2,1972,1973,1,-0.86,0.01,0.87,10,42,32,4,44,40,56.0,0.0,-56.0,0.0,20500.0,20500.0
reyna102,Allie Reynolds,Cleveland Indians,INDINS,1,1,1,2,1946,1950,4,20.32,19.02,-1.3,609,566,-43,677,2321,1644,5099.0,0.0,-5099.0,0.0,0.0,0.0
reynb001,Bryan Reynolds,San Francisco Giants,GIANTS,3,8,5,13,2018,2020,2,12.26,2.28,-9.98,738,296,-442,1562,1215,-347,600.0,0.0,-600.0,14750000.0,0.0,-14750000.0
reynb102,Bob Reynolds,Montreal Expos,NATEX,2,3,4,7,1971,1976,5,33.25,2.72,-30.53,1490,246,-1244,6073,305,-5768,833.0,2154.0,1321.0,98500.0,147000.0,48500.0
reynb102,Bob Reynolds,St. Louis Cardinals,CARDS,2,4,3,7,1971,1971,0,0.65,0.42,-0.23,128,32,-96,382,84,-298,18.0,0.0,-18.0,27000.0,15000.0,-12000.0
reynb102,Bob Reynolds,Milwaukee Brewers,BREWRS,2,3,2,5,1972,1972,0,3.49,-0.76,-4.25,151,16,-135,46,11,-35,588.0,56.0,-532.0,20500.0,0.0,-20500.0
reynb102,Bob Reynolds,Baltimore Orioles,ORLS,3,3,3,6,1975,1979,4,-0.18,0.82,1.0,71,28,-43,15,0,-15,299.0,162.0,-137.0,0.0,0.0,0.0
reync001,Craig Reynolds,Pittsburgh Pirates,PIRATS,1,2,1,3,1976,1981,5,3.27,4.64,1.37,297,554,257,1099,51,-1048,0.0,1061.0,1061.0,0.0,0.0,0.0
reync001,Craig Reynolds,Seattle Mariners,MARNRS,1,1,1,2,1978,1982,4,9.7,13.11,3.41,1172,118,-1054,3721,0,-3721,6.0,2305.0,2299.0,0.0,26000.0,26000.0
reync102,Carl Reynolds,Chicago White Sox,WSOX,3,5,5,10,1931,1940,9,20.15,15.13,-5.02,1226,1402,176,4055,5150,1095,2296.0,2157.0,-139.0,35600.0,36500.0,900.0
reync102,Carl Reynolds,Washington Senators,TWINS,3,6,5,11,1932,1936,4,25.58,12.35,-13.23,1434,628,-806,5873,2235,-3638,390.0,1249.0,859.0,38000.0,36200.0,-1800.0
reync102,Carl Reynolds,St.Louis Browns,ORLS,16,31,40,71,1933,1952,19,66.46,76.95,10.49,3547,7518,3971,11156,22870,11714,6968.0,15393.0,8425.0,147000.0,141600.0,-5400.0
reync102,Carl Reynolds,Boston Red Sox,RSOX,1,2,1,3,1935,1936,1,0.2,-0.88,-1.08,89,82,-7,318,334,16,0.0,0.0,0.0,16500.0,12000.0,-4500.0
reync102,Carl Reynolds,Washington Senators,TWINS,1,3,1,4,1937,1940,3,0.0,-1.14,-1.14,0,124,124,0,429,429,0.0,0.0,0.0,0.0,0.0,0.0
reyng001,Greg Reynolds,Colorado Rockies,ROCKS,1,1,1,2,2012,2012,0,0.0,0.0,0.0,0,0,0,0,0,0,0.0,0.0,0.0,0.0,0.0,0.0
reynh001,Harold Reynolds,San Diego Padres,PADRS,1,1,1,2,1994,1994,0,-0.84,0.0,0.84,74,0,-74,235,0,-235,0.0,0.0,0.0,0.0,0.0,0.0
reynk101,Ken Reynolds,Philadelphia Phillies,PHILS,1,3,1,4,1972,1973,1,-1.38,0.91,2.29,154,97,-57,334,364,30,133.0,0.0,-133.0,14500.0,55000.0,40500.0
reynk101,Ken Reynolds,Minnesota Twins,TWINS,1,1,1,2,1973,1973,0,-0.16,0.0,0.16,2,0,-2,0,0,0,22.0,0.0,-22.0,0.0,0.0,0.0
reynk101,Ken Reynolds,St. Louis Cardinals,CARDS,9,13,13,26,1976,1992,16,18.06,16.92,-1.14,1525,1431,-94,2979,3196,217,3633.0,4989.0,1356.0,1943333.0,497500.0,-1445833.0
reynm001,Mark Reynolds,Arizona Diamondbacks,DBACKS,1,2,2,4,2010,2015,5,1.04,1.11,0.07,290,493,203,1158,2,-1156,0.0,721.0,721.0,833333.0,402500.0,-430833.0
reynm002,Matt Reynolds,Colorado Rockies,ROCKS,1,1,1,2,2012,2014,2,0.75,-1.06,-1.81,93,59,-34,0,106,106,123.0,0.0,-123.0,481000.0,0.0,-481000.0
reynr001,R.J. Reynolds,Los Angeles Dodgers,DOGRS,1,3,1,4,1985,1987,2,13.58,2.02,-11.56,1414,166,-1248,4553,618,-3935,0.0,0.0,0.0,0.0,975500.0,975500.0
reynr002,Ronn Reynolds,New York Mets,METS,2,4,3,7,1986,1986,0,-0.05,0.0,0.05,49,0,-49,136,0,-136,44.0,0.0,-44.0,0.0,0.0,0.0
reynr002,Ronn Reynolds,Philadelphia Phillies,PHILS,1,1,1,2,1987,1988,1,-0.99,1.02,2.01,38,90,52,107,1,-106,0.0,135.0,135.0,0.0,0.0,0.0
reynt101,Tommie Reynolds,California Angels,ANGELS,4,6,5,11,1972,1976,4,2.71,3.85,1.14,491,218,-273,1603,746,-857,0.0,0.0,0.0,65500.0,40000.0,-25500.0
rhamj001,Jacob Rhame,Los Angeles Dodgers,DOGRS,1,1,2,3,2017,2017,0,-0.54,-0.24,0.3,86,36,-50,1,132,131,143.0,0.0,-143.0,0.0,15000000.0,15000000.0
rhawr101,Bobby Rhawn,New York Giants,GIANTS,1,2,1,3,1949,1949,0,-0.71,0.46,1.17,25,74,49,18,18,0,108.0,241.0,133.0,0.0,0.0,0.0
rhawr101,Bobby Rhawn,Chicago White Sox,WSOX,11,27,22,49,1949,1963,14,23.73,52.27,28.54,4184,3723,-461,12734,12126,-608,4692.0,2309.0,-2383.0,109500.0,111000.0,1500.0
rheij001,John Rheinecker,Oakland Athletics,ATLTCS,1,2,1,3,2006,2006,0,-0.32,0.0,0.32,45,0,-45,1,0,-1,363.0,0.0,-363.0,0.0,0.0,0.0
rhinb101,Billy Rhines,Cincinnati Reds,REDS,1,5,3,8,1897,1900,3,8.1,12.35,4.25,718,395,-323,2747,1335,-1412,936.0,1747.0,811.0,0.0,0.0,0.0
rhoab101,Bob Rhoads,Chicago Cubs,CUBS,2,2,3,5,1903,1913,10,-0.22,27.97,28.19,75,540,465,106,821,715,831.0,5582.0,4751.0,0.0,0.0,0.0
rhoda001,Arthur Rhodes,Oakland Athletics,ATLTCS,5,8,7,15,2004,2017,13,-1.43,13.16,14.59,290,983,693,344,2743,2399,707.0,801.0,94.0,17758194.0,8571429.0,-9186765.0
rhoda001,Arthur Rhodes,Pittsburgh Pirates,PIRATS,2,2,3,5,2004,2007,3,0.53,0.68,0.15,68,105,37,83,463,380,130.0,0.0,-130.0,7750000.0,7250000.0,-500000.0
rhoda001,Arthur Rhodes,Cleveland Indians,INDINS,1,1,1,2,2006,2008,2,0.06,1.3,1.24,107,249,142,0,910,910,137.0,0.0,-137.0,0.0,0.0,0.0
rhoda001,Arthur Rhodes,Seattle Mariners,MARNRS,1,1,1,2,2008,2008,0,0.89,0.0,-0.89,50,0,-50,0,0,0,40.0,0.0,-40.0,0.0,0.0,0.0
rhodg101,Gordon Rhodes,New York Yankees,YANKS,1,1,1,2,1932,1934,2,6.06,-0.97,-7.03,251,90,-161,247,25,-222,2030.0,261.0,-1769.0,6000.0,6500.0,500.0
rhodg101,Gordon Rhodes,Boston Red Sox,RSOX,2,4,3,7,1935,1946,11,-0.22,39.77,39.99,98,1215,1117,100,4433,4333,792.0,1354.0,562.0,15500.0,5500.0,-10000.0
rhodk001,Tuffy Rhodes,Kansas City Royals,ROYALS,1,1,1,2,1993,1993,0,0.73,0.12,-0.61,123,12,-111,388,0,-388,0.0,42.0,42.0,0.0,0.0,0.0
rhodr001,Rick Rhoden,Los Angeles Dodgers,DOGRS,1,1,1,2,1979,1987,8,24.56,20.0,-4.56,442,506,64,546,496,-50,4344.0,4223.0,-121.0,0.0,0.0,0.0
rhodr001,Rick Rhoden,Pittsburgh Pirates,PIRATS,1,3,3,6,1986,1992,6,5.61,20.46,14.85,202,598,396,2,649,647,1758.0,5213.0,3455.0,1030000.0,180000.0,-850000.0
rhodr001,Rick Rhoden,New York Yankees,YANKS,1,1,3,4,1989,1990,1,-0.25,0.0,0.25,40,0,-40,31,0,-31,290.0,0.0,-290.0,0.0,0.0,0.0
rhynh101,Hal Rhyne,Boston Red Sox,RSOX,5,12,11,23,1932,1940,8,26.52,36.5,9.98,1813,1321,-492,6379,4051,-2328,2979.0,4057.0,1078.0,56000.0,56600.0,600.0
rhynh101,Hal Rhyne,Chicago White Sox,WSOX,1,3,1,4,1934,1936,2,0.0,-0.14,-0.14,0,10,10,0,2,2,0.0,39.0,39.0,0.0,0.0,0.0
ribad101,Dennis Ribant,Milwaukee Braves,BRAVES,1,2,1,3,1964,1965,1,3.71,-0.1,-3.81,148,10,-138,93,3,-90,844.0,37.0,-807.0,0.0,30000.0,30000.0
ribad101,Dennis Ribant,New York Mets,METS,1,2,2,4,1966,1970,4,1.41,1.94,0.53,188,298,110,235,385,150,516.0,1427.0,911.0,0.0,26000.0,26000.0
ribad101,Dennis Ribant,Pittsburgh Pirates,PIRATS,1,1,1,2,1967,1968,1,0.35,-0.31,-0.66,30,22,-8,6,4,-2,73.0,62.0,-11.0,20000.0,24500.0,4500.0
ribad101,Dennis Ribant,Detroit Tigers,TIGRS,2,2,2,4,1968,1972,4,4.04,-1.09,-5.13,454,298,-156,42,558,516,1009.0,218.0,-791.0,24500.0,9000.0,-15500.0
ribad101,Dennis Ribant,St. Louis Cardinals,CARDS,1,1,1,2,1969,1969,0,-0.04,0.0,0.04,14,0,-14,0,0,0,25.0,0.0,-25.0,0.0,0.0,0.0
ribad101,Dennis Ribant,Cincinnati Reds,REDS,1,1,1,2,1970,1970,0,0.0,0.04,0.04,0,6,6,0,2,2,0.0,24.0,24.0,0.0,0.0,0.0
riccf101,Frank Riccelli,San Francisco Giants,GIANTS,1,1,1,2,1977,1979,2,0.0,-0.04,-0.04,0,73,73,0,208,208,0.0,0.0,0.0,0.0,0.0,0.0
riccf101,Frank Riccelli,St. Louis Cardinals,CARDS,2,2,2,4,1978,1979,1,0.27,-0.06,-0.33,26,5,-21,6,4,-2,75.0,0.0,-75.0,0.0,0.0,0.0
riced101,Del Rice,St. Louis Cardinals,CARDS,2,2,2,4,1955,1956,1,0.26,0.16,-0.1,311,133,-178,959,303,-656,0.0,0.0,0.0,0.0,0.0,0.0
riceh101,Harry Rice,St.Louis Browns,ORLS,22,44,51,95,1927,1952,25,139.77,131.99,-7.78,6854,9855,3001,22708,32907,10199,12609.0,15510.0,2901.0,213500.0,207450.0,-6050.0
riceh101,Harry Rice,Detroit Tigers,TIGRS,1,3,2,5,1930,1932,2,0.55,-1.14,-1.69,146,271,125,467,761,294,97.0,731.0,634.0,18000.0,25000.0,7000.0
riceh101,Harry Rice,Washington Senators,TWINS,1,5,1,6,1931,1939,8,0.0,8.51,8.51,0,385,385,0,407,407,0.0,3095.0,3095.0,6500.0,0.0,-6500.0
riceh102,Hal Rice,St. Louis Cardinals,CARDS,1,2,1,3,1953,1953,0,1.16,-0.38,-1.54,106,67,-39,401,55,-346,0.0,0.0,0.0,0.0,10000.0,10000.0
riceh102,Hal Rice,Pittsburgh Pirates,PIRATS,1,1,1,2,1954,1954,0,-1.31,0.02,1.33,51,14,-37,81,14,-67,0.0,0.0,0.0,0.0,0.0,0.0
richc001,Chris Richard,St. Louis Cardinals,CARDS,3,6,6,12,2000,2009,9,25.91,31.82,5.91,1193,1089,-104,4738,3413,-1325,107.0,490.0,383.0,7200000.0,12850000.0,5650000.0
richc001,Chris Richard,Baltimore Orioles,ORLS,1,1,1,2,2003,2004,1,-0.18,0.41,0.59,19,28,9,30,85,55,0.0,0.0,0.0,0.0,0.0,0.0
richc002,Clayton Richard,Chicago White Sox,WSOX,6,14,12,26,2009,2018,9,7.16,22.73,15.57,991,1029,38,935,3763,2828,4825.0,1688.0,-3137.0,13340000.0,19075000.0,5735000.0
richc002,Clayton Richard,San Diego Padres,PADRS,1,2,1,3,2018,2018,0,-0.17,0.0,0.17,10,0,-10,0,0,0,136.0,0.0,-136.0,3000000.0,0.0,-3000000.0
richd001,Danny Richar,Arizona Diamondbacks,DBACKS,7,15,17,32,2007,2018,11,24.64,30.17,5.53,911,1190,279,1525,2038,513,6760.0,6326.0,-434.0,14741000.0,15790000.0,1049000.0
richd001,Danny Richar,Chicago White Sox,WSOX,1,2,2,4,2008,2008,0,3.05,0.44,-2.61,495,41,-454,49,150,101,721.0,0.0,-721.0,396000.0,8282695.0,7886695.0
richd002,Dustin Richardson,Boston Red Sox,RSOX,2,2,2,4,2010,2021,11,0.96,16.82,15.86,24,336,312,0,33,33,60.0,3105.0,3045.0,1900000.0,1790219.0,-109781.0
richd101,Danny Richardson,Washington Senators,WSN,3,4,9,13,1893,1905,12,19.9,18.4,-1.5,1093,647,-446,4528,2564,-1964,0.0,695.0,695.0,0.0,0.0,0.0
richd103,Don Richmond,St.Louis Browns,ORLS,2,2,2,4,1949,1955,6,-0.09,-2.29,-2.2,31,649,618,84,2646,2562,0.0,0.0,0.0,0.0,0.0,0.0
richg101,Gordie Richardson,St. Louis Cardinals,CARDS,1,2,2,4,1964,1964,0,0.92,0.0,-0.92,326,0,-326,777,0,-777,213.0,0.0,-213.0,0.0,0.0,0.0
richj001,Jeff Richardson,Cincinnati Reds,REDS,2,3,2,5,1990,1992,2,-1.08,-0.05,1.03,271,352,81,1090,1144,54,18.0,139.0,121.0,1600000.0,525000.0,-1075000.0
richj001,Jeff Richardson,Pittsburgh Pirates,PIRATS,1,1,1,2,1993,1993,0,0.44,0.0,-0.44,15,0,-15,27,0,-27,0.0,0.0,0.0,0.0,0.0,0.0
richj002,Jeff Richardson,New York Mets,METS,1,2,1,3,1987,1987,0,0.01,-0.06,-0.07,1,6,5,0,5,5,1.0,37.0,36.0,0.0,800000.0,800000.0
richk101,Ken Richardson,Pittsburgh Pirates,PIRATS,1,1,2,3,1945,1947,2,-0.34,0.0,0.34,6,0,-6,20,0,-20,0.0,0.0,0.0,0.0,0.0,0.0
richl101,Lee Richard,Chicago White Sox,WSOX,1,1,2,3,1975,1976,1,-0.55,0.63,1.18,66,80,14,97,258,161,0.0,0.0,0.0,0.0,0.0,0.0
richl102,Lew Richie,Philadelphia Phillies,PHILS,13,27,30,57,1909,1931,22,110.35,96.74,-13.61,5407,5417,10,17248,19665,2417,13600.0,6282.0,-7318.0,25000.0,31850.0,6850.0
richl102,Lew Richie,Boston Braves,BRAVES,2,2,2,4,1910,1913,3,7.44,6.1,-1.34,378,510,132,532,2125,1593,2058.0,0.0,-2058.0,3600.0,0.0,-3600.0
richl102,Lew Richie,Chicago Cubs,CUBS,1,1,1,2,1913,1913,0,0.0,1.6,1.6,0,14,14,0,21,21,0.0,168.0,168.0,2500.0,0.0,-2500.0
richl103,Lance Richbourg,New York Giants,GIANTS,3,7,5,12,1921,1927,6,10.96,8.57,-2.39,1223,793,-430,4975,2790,-2185,0.0,87.0,87.0,29500.0,14875.0,-14625.0
richl103,Lance Richbourg,Washington Senators,TWINS,8,20,12,32,1924,1941,17,54.71,71.12,16.41,4079,3032,-1047,12814,11321,-1493,8820.0,3821.0,-4999.0,95600.0,78200.0,-17400.0
richl103,Lance Richbourg,Chicago Cubs,CUBS,2,7,3,10,1932,1941,9,3.2,27.52,24.32,621,896,275,1233,2014,781,2473.0,4458.0,1985.0,0.0,0.0,0.0
richl103,Lance Richbourg,Milwaukee,Milwaukee,3,3,7,10,1926,1927,1,6.43,0.0,-6.43,783,0,-783,3175,0,-3175,0.0,0.0,0.0,0.0,21000.0,21000.0
richl103,Lance Richbourg,Philadelphia Phillies,PHILS,1,2,1,3,1922,1922,0,0.0,-0.19,-0.19,0,6,6,0,21,21,0.0,0.0,0.0,0.0,0.0,0.0
richm001,Mike Richardt,Texas Rangers,RNGRS,1,1,1,2,1984,1985,1,0.0,0.56,0.56,16,104,88,15,272,257,0.0,0.0,0.0,0.0,0.0,0.0
richn101,Nolen Richardson,Baltimore,Baltimore,1,1,1,2,1938,1938,0,0.61,0.0,-0.61,36,0,-36,109,0,-109,0.0,0.0,0.0,0.0,0.0,0.0
richp101,Paul Richards,Philadelphia Athletics,ATLTCS,1,2,1,3,1935,1938,3,0.0,-2.17,-2.17,0,92,92,0,56,56,0.0,506.0,506.0,0.0,0.0,0.0
richp102,Pete Richert,Los Angeles Dodgers,DOGRS,4,12,9,21,1964,1984,20,57.0,60.48,3.48,4290,2463,-1827,14544,7259,-7285,4034.0,7191.0,3157.0,163000.0,22000.0,-141000.0
richp102,Pete Richert,Washington Senators,RNGRS,16,29,31,60,1967,1986,19,71.79,41.42,-30.37,4013,2811,-1202,6770,7538,768,12905.0,5489.0,-7416.0,245000.0,424400.0,179400.0
richp102,Pete Richert,Baltimore Orioles,ORLS,5,14,16,30,1971,1988,17,20.93,69.89,48.96,1174,3443,2269,1219,6819,5600,6830.0,12795.0,5965.0,725333.0,8400.0,-716933.0
richp102,Pete Richert,Los Angeles Dodgers,DOGRS,1,1,1,2,1973,1974,1,-0.11,0.0,0.11,26,0,-26,0,0,0,34.0,0.0,-34.0,0.0,0.0,0.0
richr101,Reggie Richter,Louisville,Louisville,1,1,1,2,1911,1911,0,-0.33,0.0,0.33,44,0,-44,10,0,-10,161.0,0.0,-161.0,0.0,0.0,0.0
richr102,Ray Richmond,St.Louis Browns,ORLS,1,1,1,2,1921,1921,0,0.0,-0.35,-0.35,0,6,6,0,1,1,0.0,17.0,17.0,0.0,0.0,0.0
richt001,Trevor Richards,Miami Marlins,MARLNS,1,2,2,4,2019,2020,1,1.9,-0.48,-2.38,73,53,-20,0,0,0,333.0,94.0,-239.0,1125000.0,564200.0,-560800.0
richt001,Trevor Richards,Tampa Bay Devil Rays,RAYS,1,2,2,4,2021,2021,0,3.81,2.17,-1.64,129,60,-69,414,3,-411,59.0,287.0,228.0,0.0,0.0,0.0
richt001,Trevor Richards,Milwaukee Brewers,BREWRS,1,2,1,3,2021,2021,0,0.58,0.23,-0.35,34,56,22,0,174,174,98.0,0.0,-98.0,0.0,0.0,0.0
rickb101,Branch Rickey,St.Louis Browns,ORLS,1,1,1,2,1907,1907,0,-1.04,2.43,3.47,52,123,71,153,474,321,0.0,0.0,0.0,0.0,0.0,0.0
rickb101,Branch Rickey,Milwaukee,Milwaukee,1,2,1,3,1906,1906,0,1.69,0.0,-1.69,67,0,-67,223,0,-223,0.0,0.0,0.0,0.0,0.0,0.0
rickd101,Dick Ricketts,St. Louis Cardinals,CARDS,2,7,3,10,1960,1963,3,1.56,-0.35,-1.91,364,164,-200,1157,310,-847,0.0,0.0,0.0,0.0,0.0,0.0
rickd102,Dave Ricketts,St. Louis Cardinals,CARDS,2,4,5,9,1969,1972,3,8.31,1.34,-6.97,834,199,-635,108,492,384,1854.0,0.0,-1854.0,17500.0,24000.0,6500.0
rickm101,Marv Rickert,Cincinnati Reds,REDS,1,1,1,2,1948,1950,2,1.4,4.55,3.15,103,262,159,314,860,546,0.0,0.0,0.0,0.0,0.0,0.0
ricof101,Fred Rico,Kansas City Royals,ROYALS,1,1,1,2,1970,1977,7,0.0,7.18,7.18,0,880,880,0,3354,3354,0.0,0.0,0.0,0.0,0.0,0.0
ricof101,Fred Rico,St. Louis Cardinals,CARDS,1,2,1,3,1971,1972,1,0.0,0.65,0.65,0,20,20,0,1,1,0.0,38.0,38.0,0.0,40000.0,40000.0
ricoh101,Harry Riconda,Philadelphia Athletics,ATLTCS,3,9,5,14,1924,1935,11,15.67,38.22,22.55,391,1328,937,1453,5363,3910,735.0,0.0,-735.0,39667.0,10400.0,-29267.0
ricoh101,Harry Riconda,Brooklyn Dodgers,DOGRS,1,2,1,3,1928,1934,6,0.53,8.54,8.01,100,434,334,99,1570,1471,677.0,0.0,-677.0,21000.0,12000.0,-9000.0
ricoh101,Harry Riconda,Milwaukee,Milwaukee,2,2,4,6,1927,1927,0,-0.17,0.0,0.17,154,0,-154,514,0,-514,0.0,0.0,0.0,0.0,12300.0,12300.0
ricoh101,Harry Riconda,Boston Braves,BRAVES,1,3,1,4,1926,1931,5,0.0,6.6,6.6,0,629,629,0,2661,2661,0.0,0.0,0.0,8700.0,0.0,-8700.0
riddd102,Denny Riddleberger,Pittsburgh Pirates,PIRATS,5,8,9,17,1970,1978,8,5.84,10.38,4.54,523,878,355,1285,1838,553,910.0,1701.0,791.0,94500.0,80500.0,-14000.0
riddd102,Denny Riddleberger,Texas Rangers,RNGRS,15,34,23,57,1971,1988,17,48.57,49.18,0.61,3015,3170,155,9911,9907,-4,4375.0,6620.0,2245.0,528000.0,301000.0,-227000.0
riddj101,Johnny Riddle,Indianapolis,Indianapolis,1,1,1,2,1937,1937,0,-0.01,0.0,0.01,8,0,-8,28,0,-28,0.0,0.0,0.0,0.0,0.0,0.0
riddj101,Johnny Riddle,Boston Braves,BRAVES,6,18,10,28,1938,1952,14,22.0,33.53,11.53,1506,1625,119,5516,5420,-96,0.0,2449.0,2449.0,12500.0,0.0,-12500.0
ridgj001,Jeff Ridgway,Tampa Bay Devil Rays,RAYS,1,1,2,3,2008,2010,2,0.21,1.25,1.04,18,300,282,0,1007,1007,29.0,0.0,-29.0,0.0,0.0,0.0
ridis001,Stephen Ridings,Chicago Cubs,CUBS,1,1,1,2,2019,2019,0,0.0,0.0,0.0,0,0,0,0,0,0,0.0,0.0,0.0,0.0,0.0,0.0
ridzs101,Steve Ridzik,Philadelphia Phillies,PHILS,2,4,4,8,1955,1957,2,8.43,2.22,-6.21,540,413,-127,1547,1258,-289,90.0,0.0,-90.0,15500.0,13500.0,-2000.0
riefc001,C.J. Riefenhauser,Tampa Bay Devil Rays,RAYS,2,5,4,9,2015,2018,3,-0.11,7.04,7.15,74,689,615,124,2370,2246,283.0,211.0,-72.0,508800.0,3779600.0,3270800.0
riefc001,C.J. Riefenhauser,Seattle Mariners,MARNRS,1,2,1,3,2015,2015,0,1.72,0.0,-1.72,407,0,-407,1659,0,-1659,0.0,0.0,0.0,6900000.0,514000.0,-6386000.0
riena001,Andre Rienzo,Chicago White Sox,WSOX,2,2,2,4,2014,2017,3,-0.03,2.32,2.35,59,173,114,2,0,-2,114.0,484.0,370.0,1400000.0,501500.0,-898500.0
riesn001,Nikco Riesgo,San Diego Padres,PADRS,1,1,1,2,1990,1990,0,0.0,0.0,0.0,0,0,0,0,0,0,0.0,0.0,0.0,0.0,0.0,0.0
riesn001,Nikco Riesgo,New York Mets,METS,1,2,1,3,1990,1991,1,0.0,-0.36,-0.36,0,97,97,0,306,306,0.0,0.0,0.0,0.0,825000.0,825000.0
riesn001,Nikco Riesgo,Milwaukee Brewers,BREWRS,1,1,1,2,1993,1995,2,0.0,0.07,0.07,0,34,34,0,0,0,0.0,110.0,110.0,0.0,0.0,0.0
rigbb001,Brad Rigby,Oakland Athletics,ATLTCS,1,3,1,4,1999,2000,1,2.09,2.63,0.54,130,45,-85,4,6,2,1197.0,792.0,-405.0,201500.0,4800000.0,4598500.0
rigbb001,Brad Rigby,Kansas City Royals,ROYALS,1,1,1,2,2000,2000,0,-0.18,-0.99,-0.81,12,16,4,1,3,2,16.0,171.0,155.0,220000.0,325000.0,105000.0
rigdp001,Paul Rigdon,Cleveland Indians,INDINS,3,6,5,11,2000,2007,7,13.63,7.12,-6.51,820,378,-442,2478,197,-2281,718.0,1361.0,643.0,5247000.0,9550000.0,4303000.0
riggj001,Jerrod Riggan,New York Mets,METS,3,9,8,17,2001,2008,7,12.43,-0.5,-12.93,1334,336,-998,2309,1012,-1297,1613.0,327.0,-1286.0,8000000.0,8077500.0,77500.0
riggl101,Lew Riggs,Cincinnati Reds,REDS,1,1,1,2,1940,1941,1,2.1,-0.08,-2.18,148,4,-144,423,13,-410,0.0,0.0,0.0,5000.0,0.0,-5000.0
righd001,Dave Righetti,Texas Rangers,RNGRS,8,18,14,32,1978,1986,8,37.88,13.97,-23.91,1966,931,-1035,3128,2213,-915,8593.0,2102.0,-6491.0,0.0,250000.0,250000.0
righr001,Ron Rightnowar,Detroit Tigers,TIGRS,1,1,1,2,1993,1993,0,0.07,0.0,-0.07,34,0,-34,0,0,0,110.0,0.0,-110.0,0.0,0.0,0.0
rignb101,Bill Rigney,Oakland,Oakland,1,1,1,2,1943,1945,2,7.72,0.0,-7.72,654,0,-654,2217,0,-2217,0.0,0.0,0.0,0.0,0.0,0.0
rignt101,Topper Rigney,Boston Red Sox,RSOX,7,13,14,27,1927,1945,18,68.75,60.85,-7.9,3437,1957,-1480,13044,5029,-8015,4146.0,8828.0,4682.0,66000.0,77500.0,11500.0
rijoj001,Jose Rijo,New York Yankees,YANKS,3,7,8,15,1984,1993,9,53.43,36.99,-16.44,2484,1135,-1349,8455,3089,-5366,3002.0,2795.0,-207.0,2415000.0,2187766.0,-227234.0
rijoj001,Jose Rijo,Oakland Athletics,ATLTCS,1,2,1,3,1987,1989,2,38.12,0.55,-37.57,775,245,-530,532,1011,479,4990.0,0.0,-4990.0,0.0,1100000.0,1100000.0
rikac101,Culley Rikard,Pittsburgh Pirates,PIRATS,1,2,1,3,1949,1951,2,0.0,1.3,1.3,0,93,93,0,314,314,0.0,0.0,0.0,0.0,0.0,0.0
rilee001,Ernie Riles,Milwaukee Brewers,BREWRS,1,1,1,2,1988,1988,0,4.5,-1.09,-5.59,293,94,-199,722,398,-324,0.0,0.0,0.0,250000.0,900000.0,650000.0
rilee001,Ernie Riles,San Francisco Giants,GIANTS,4,6,10,16,1990,1998,8,10.4,5.31,-5.09,419,752,333,768,2609,1841,1958.0,96.0,-1862.0,6502778.0,4216667.0,-2286111.0
rileg001,George Riley,Philadelphia Phillies,PHILS,2,3,3,6,1984,1985,1,3.94,-0.28,-4.22,400,66,-334,337,103,-234,2374.0,85.0,-2289.0,0.0,0.0,0.0
rileg001,George Riley,San Francisco Giants,GIANTS,1,2,1,3,1985,1986,1,-0.44,0.85,1.29,34,78,44,46,40,-6,26.0,424.0,398.0,0.0,0.0,0.0
rilem001,Matt Riley,Baltimore Orioles,ORLS,1,1,1,2,2005,2005,0,-0.55,0.16,0.71,7,7,0,0,15,15,38.0,0.0,-38.0,0.0,0.0,0.0
rincr001,Ricardo Rincon,Pittsburgh Pirates,PIRATS,7,9,16,25,1998,2016,18,32.02,54.18,22.16,1891,3677,1786,4995,11200,6205,2597.0,4751.0,2154.0,29739833.0,1423425.0,-28316408.0
rincr001,Ricardo Rincon,Cleveland Indians,INDINS,1,1,1,2,2002,2002,0,2.72,0.0,-2.72,233,0,-233,0,0,0,471.0,0.0,-471.0,1500000.0,0.0,-1500000.0
ringj101,Jimmy Ring,Cincinnati Reds,REDS,1,2,1,3,1920,1920,0,12.54,0.0,-12.54,460,0,-460,635,0,-635,4385.0,0.0,-4385.0,11000.0,5000.0,-6000.0
ringj101,Jimmy Ring,Philadelphia Phillies,PHILS,1,1,2,3,1925,1927,2,-1.47,-0.68,0.79,78,183,105,60,367,307,550.0,696.0,146.0,7000.0,3600.0,-3400.0
ringj101,Jimmy Ring,New York Giants,GIANTS,4,6,5,11,1926,1932,6,44.88,18.94,-25.94,1758,1119,-639,7309,4215,-3094,99.0,0.0,-99.0,24000.0,37000.0,13000.0
ringj101,Jimmy Ring,St. Louis Cardinals,CARDS,1,2,3,5,1927,1928,1,-1.19,0.0,1.19,135,0,-135,192,0,-192,529.0,0.0,-529.0,13300.0,8850.0,-4450.0
ringr001,Royce Ring,Chicago White Sox,WSOX,1,3,2,5,2003,2003,0,-0.24,0.07,0.31,72,67,-5,1,296,295,104.0,0.0,-104.0,0.0,8000000.0,8000000.0
ringr001,Royce Ring,New York Mets,METS,1,2,2,4,2006,2008,2,8.55,-0.17,-8.72,723,11,-712,2,30,28,1167.0,3.0,-1164.0,0.0,327500.0,327500.0
ringr001,Royce Ring,San Diego Padres,PADRS,1,1,2,3,2007,2008,1,-1.08,-0.32,0.76,103,68,-35,0,14,14,82.0,206.0,124.0,0.0,0.0,0.0
riosa001,Armando Rios,San Francisco Giants,GIANTS,2,3,3,6,2001,2006,5,-2.21,23.96,26.17,411,451,40,569,556,-13,1088.0,3414.0,2326.0,310000.0,5050000.0,4740000.0
riosa002,Alex Rios,Chicago White Sox,WSOX,1,1,1,2,2013,2021,8,1.24,5.21,3.97,178,581,403,718,2030,1312,0.0,6.0,6.0,0.0,490000.0,490000.0
ripla101,Allen Ripley,San Francisco Giants,GIANTS,1,1,1,2,1981,1982,1,0.62,0.0,-0.62,56,0,-56,40,0,-40,368.0,0.0,-368.0,0.0,0.0,0.0
rippj101,Jimmy Ripple,New York Giants,GIANTS,1,1,1,2,1939,1940,1,0.6,-0.08,-0.68,35,5,-30,135,14,-121,0.0,0.0,0.0,8000.0,6000.0,-2000.0
rippj101,Jimmy Ripple,St. Louis Cardinals,CARDS,2,2,3,5,1942,1944,2,-0.32,0.32,0.64,66,4,-62,303,2,-301,0.0,21.0,21.0,0.0,0.0,0.0
rippj101,Jimmy Ripple,Toronto,Toronto,1,1,1,2,1943,1943,0,-0.63,0.0,0.63,32,0,-32,138,0,-138,0.0,0.0,0.0,0.0,3500.0,3500.0
rippj101,Jimmy Ripple,Pittsburgh Pirates,PIRATS,1,1,1,2,1943,1943,0,-0.63,0.0,0.63,32,0,-32,138,0,-138,0.0,0.0,0.0,0.0,3500.0,3500.0
riskd001,David Riske,Cleveland Indians,INDINS,2,4,6,10,2006,2011,5,6.08,6.32,0.24,533,659,126,1913,1893,-20,29.0,785.0,756.0,1950000.0,0.0,-1950000.0
riskd001,David Riske,Boston Red Sox,RSOX,1,1,1,2,2006,2009,3,0.55,2.51,1.96,37,182,145,0,1,1,103.0,385.0,282.0,1800000.0,0.0,-1800000.0
rislb001,Bill Risley,Cincinnati Reds,REDS,5,7,10,17,1991,2006,15,8.76,8.38,-0.38,1127,1227,100,1121,3011,1890,1371.0,1423.0,52.0,12068333.0,8870833.0,-3197500.0
rislb001,Bill Risley,Seattle Mariners,MARNRS,2,3,3,6,1995,1997,2,0.75,-0.72,-1.47,99,11,-88,44,0,-44,434.0,126.0,-308.0,135000.0,218000.0,83000.0
ritcc101,Claude Ritchey,Cincinnati Reds,REDS,2,5,2,7,1898,1898,0,7.73,2.21,-5.52,627,66,-561,2681,105,-2576,267.0,786.0,519.0,0.0,0.0,0.0
ritcc101,Claude Ritchey,Louisville Colonels,LS3,1,12,5,17,1899,1900,1,267.1,0.0,-267.1,7388,0,-7388,29004,0,-29004,7568.0,0.0,-7568.0,4350.0,0.0,-4350.0
ritcc101,Claude Ritchey,Pittsburgh Pirates,PIRATS,1,3,1,4,1906,1910,4,14.38,6.11,-8.27,866,332,-534,3143,1286,-1857,1417.0,0.0,-1417.0,0.0,0.0,0.0
ritcj101,Jay Ritchie,Boston Red Sox,RSOX,1,3,2,5,1965,1968,3,0.78,1.64,0.86,187,156,-31,154,15,-139,353.0,393.0,40.0,0.0,0.0,0.0
ritcj101,Jay Ritchie,Atlanta Braves,BRAVES,1,3,1,4,1967,1968,1,0.5,-0.77,-1.27,233,127,-106,406,383,-23,170.0,0.0,-170.0,0.0,0.0,0.0
ritct001,Todd Ritchie,Pittsburgh Pirates,PIRATS,3,4,5,9,2001,2010,9,-1.67,7.92,9.59,31,815,784,5,714,709,425.0,4763.0,4338.0,6485333.0,3550000.0,-2935333.0
rittj101,Jim Rittwage,Kansas City Athletics,ATLTCS,10,22,14,36,1965,1976,11,26.85,38.2,11.35,3876,2816,-1060,8514,9189,675,4493.0,1098.0,-3395.0,362100.0,428500.0,66400.0
rittj101,Jim Rittwage,Cleveland Indians,INDINS,1,1,1,2,1973,1973,0,0.0,0.0,0.0,0,0,0,0,0,0,0.0,0.0,0.0,0.0,0.0,0.0
rivaa001,Alfonso Rivas,Oakland Athletics,ATLTCS,1,1,1,2,2020,2020,0,0.09,-0.21,-0.3,18,49,31,49,114,65,0.0,0.0,0.0,0.0,0.0,0.0
riveb001,Ben Rivera,Atlanta Braves,BRAVES,2,4,2,6,1992,1997,5,1.53,11.08,9.55,307,636,329,453,2705,2252,1014.0,0.0,-1014.0,109000.0,4300000.0,4191000.0
rivef001,Felipe Vazquez,Tampa Bay Devil Rays,RAYS,3,8,5,13,2014,2018,4,0.49,9.21,8.72,459,720,261,782,2375,1593,577.0,688.0,111.0,508800.0,3779600.0,3270800.0
rivef001,Felipe Vazquez,Washington Nationals,NATEX,1,2,1,3,2016,2016,0,7.25,1.19,-6.06,436,60,-376,3,0,-3,698.0,89.0,-609.0,0.0,0.0,0.0
riveg001,German Rivera,Los Angeles Dodgers,DOGRS,1,2,1,3,1985,1986,1,-0.17,0.39,0.56,15,164,149,41,506,465,3.0,0.0,-3.0,0.0,291667.0,291667.0
rivej001,Juan Rivera,New York Yankees,YANKS,6,17,11,28,2003,2012,9,26.42,21.86,-4.56,2170,1008,-1162,5379,2872,-2507,5079.0,2402.0,-2677.0,1920525.0,15100000.0,13179475.0
rivej001,Juan Rivera,Washington Nationals,NATEX,1,2,1,3,2004,2006,2,19.76,2.71,-17.05,1354,217,-1137,5013,879,-4134,0.0,0.0,0.0,312000.0,2200000.0,1888000.0
rivej001,Juan Rivera,Anaheim Angels,ANGELS,2,3,3,6,2011,2013,2,-0.32,-0.07,0.25,200,208,8,733,791,58,0.0,0.0,0.0,0.0,0.0,0.0
rivej101,Jim Rivera,Chicago White Sox,WSOX,2,6,4,10,1951,1963,12,1.43,25.02,23.59,363,1422,1059,910,5079,4169,614.0,0.0,-614.0,0.0,0.0,0.0
rivej101,Jim Rivera,St.Louis Browns,ORLS,26,67,67,134,1952,1988,36,99.12,172.68,73.56,7104,11773,4669,15396,35136,19740,24196.0,16005.0,-8191.0,841333.0,150400.0,-690933.0
rivel001,Luis Rivera,Montreal Expos,NATEX,1,2,2,4,1988,1992,4,6.16,6.42,0.26,597,552,-45,1669,1976,307,1455.0,0.0,-1455.0,132500.0,525000.0,392500.0
rivel002,Luis Rivera,Atlanta Braves,BRAVES,1,3,2,5,2000,2002,2,-0.42,1.16,1.58,107,214,107,224,759,535,2.0,6.0,4.0,800000.0,4146789.0,3346789.0
rivem001,Mickey Rivers,Atlanta Braves,BRAVES,1,2,2,4,1969,1970,1,9.24,2.87,-6.37,457,118,-339,1833,14,-1819,0.0,278.0,278.0,0.0,37000.0,37000.0
rivem001,Mickey Rivers,California Angels,ANGELS,2,5,4,9,1975,1990,15,42.88,51.46,8.58,1084,1992,908,2703,8018,5315,7553.0,1336.0,-6217.0,175000.0,50000.0,-125000.0
rivem001,Mickey Rivers,New York Yankees,YANKS,16,36,34,70,1979,1995,16,29.43,51.07,21.64,3022,3837,815,7138,10506,3368,6440.0,4403.0,-2037.0,3694706.0,5935000.0,2240294.0
rivem003,Mike Rivera,Detroit Tigers,TIGRS,1,1,1,2,2002,2003,1,-0.41,-0.58,-0.17,19,39,20,58,140,82,0.0,0.0,0.0,200000.0,0.0,-200000.0
river002,Ruben Rivera,New York Yankees,YANKS,10,23,17,40,1997,2012,15,32.6,51.23,18.63,1993,1981,-12,3061,4822,1761,8275.0,6854.0,-1421.0,22173073.0,34719286.0,12546213.0
river003,Rene Rivera,San Diego Padres,PADRS,3,7,6,13,2014,2020,6,-1.53,-1.48,0.05,295,146,-149,1021,301,-720,0.0,78.0,78.0,506400.0,10644200.0,10137800.0
rives001,Saul Rivera,New York Mets,METS,1,4,3,7,2002,2005,3,2.12,1.12,-1.0,505,185,-320,25,27,2,939.0,263.0,-676.0,300000.0,355000.0,55000.0
rives001,Saul Rivera,Montreal Expos,NATEX,1,2,2,4,2004,2004,0,0.0,0.0,0.0,0,0,0,0,0,0,0.0,0.0,0.0,300000.0,0.0,-300000.0
rixee101,Eppa Rixey,Philadelphia Phillies,PHILS,2,2,4,6,1920,1927,7,38.6,13.39,-25.21,958,573,-385,1160,941,-219,9219.0,4552.0,-4667.0,12000.0,14600.0,2600.0
rizza001,Anthony Rizzo,San Diego Padres,PADRS,5,14,11,25,2012,2021,9,38.08,3.36,-34.72,1863,479,-1384,6550,569,-5981,976.0,2402.0,1426.0,10660200.0,4650000.0,-6010200.0
rizza001,Anthony Rizzo,Boston Red Sox,RSOX,8,26,15,41,2010,2019,9,35.43,29.06,-6.37,2876,1721,-1155,5076,5808,732,4841.0,1908.0,-2933.0,4708000.0,21460000.0,16752000.0
rizza001,Anthony Rizzo,Chicago Cubs,CUBS,1,2,2,4,2021,2021,0,0.5,0.0,-0.5,49,0,-49,200,0,-200,0.0,0.0,0.0,16500000.0,0.0,-16500000.0
rizzj101,Johnny Rizzo,St. Louis Cardinals,CARDS,1,1,4,5,1937,1943,6,4.23,0.0,-4.23,246,0,-246,1035,0,-1035,0.0,0.0,0.0,0.0,0.0,0.0
rizzj101,Johnny Rizzo,Pittsburgh Pirates,PIRATS,3,3,3,6,1940,1946,6,3.24,14.06,10.82,164,805,641,641,2668,2027,0.0,666.0,666.0,0.0,0.0,0.0
rizzj101,Johnny Rizzo,Cincinnati Reds,REDS,1,1,1,2,1940,1940,0,2.66,0.41,-2.25,202,62,-140,672,226,-446,0.0,0.0,0.0,0.0,0.0,0.0
roa-j001,Joe Roa,Atlanta Braves,BRAVES,1,2,1,3,1991,1992,1,0.78,0.88,0.1,20,112,92,6,3,-3,71.0,184.0,113.0,165000.0,1000000.0,835000.0
roa-j001,Joe Roa,New York Mets,METS,5,9,10,19,1994,1999,5,9.6,7.76,-1.84,747,954,207,324,289,-35,2209.0,3636.0,1427.0,6823000.0,6640000.0,-183000.0
roa-j001,Joe Roa,Cleveland Indians,INDINS,3,6,6,12,1996,2001,5,40.02,3.44,-36.58,2173,212,-1961,7166,649,-6517,933.0,172.0,-761.0,7541666.0,6600000.0,-941666.0
roacd001,Donn Roach,Anaheim Angels,ANGELS,2,3,2,5,2012,2014,2,0.27,1.16,0.89,644,214,-430,1673,0,-1673,125.0,563.0,438.0,481000.0,489100.0,8100.0
roacm101,Mel Roach,Milwaukee Braves,BRAVES,2,3,3,6,1961,1964,3,3.27,3.41,0.14,400,209,-191,1398,698,-700,0.0,0.0,0.0,0.0,0.0,0.0
roacm101,Mel Roach,Chicago Cubs,CUBS,1,1,2,3,1961,1961,0,0.0,0.0,0.0,0,0,0,0,0,0,0.0,0.0,0.0,0.0,0.0,0.0
roacm101,Mel Roach,Cleveland Indians,INDINS,2,2,3,5,1962,1966,4,-1.42,-0.53,0.89,65,52,-13,111,71,-40,0.0,0.0,0.0,0.0,0.0,0.0
roacr101,Roxey Roach,JerseyCity,JerseyCity,2,2,3,5,1912,1916,4,0.41,0.0,-0.41,72,0,-72,284,0,-284,0.0,0.0,0.0,0.0,4000.0,4000.0
roarm101,Mike Roarke,Milwaukee Braves,BRAVES,1,3,2,5,1959,1961,2,-0.44,0.34,0.78,224,49,-175,615,163,-452,0.0,0.0,0.0,0.0,0.0,0.0
roart001,Tanner Roark,Texas Rangers,RNGRS,1,2,1,3,2010,2010,0,17.02,-0.67,-17.69,353,15,-338,317,50,-267,2805.0,0.0,-2805.0,0.0,8000000.0,8000000.0
roart001,Tanner Roark,Washington Nationals,NATEX,1,1,1,2,2018,2018,0,1.75,0.0,-1.75,40,0,-40,34,0,-34,331.0,0.0,-331.0,6475000.0,0.0,-6475000.0
roart001,Tanner Roark,Cincinnati Reds,REDS,3,6,4,10,2019,2021,2,1.28,0.31,-0.97,105,46,-59,0,0,0,303.0,64.0,-239.0,10000000.0,4050000.0,-5950000.0
robea001,Andre Robertson,New York Yankees,YANKS,1,2,2,4,1986,1988,2,1.46,3.1,1.64,271,317,46,976,1061,85,0.0,0.0,0.0,1050000.0,750000.0,-300000.0
robeb001,Bert Roberge,Chicago White Sox,WSOX,1,1,1,2,1984,1986,2,-0.28,1.15,1.43,126,93,-33,3,262,259,290.0,0.0,-290.0,0.0,0.0,0.0
robeb002,Bip Roberts,San Diego Padres,PADRS,1,2,1,3,1991,1992,1,4.78,-0.97,-5.75,230,132,-98,937,8,-929,0.0,239.0,239.0,675000.0,2000000.0,1325000.0
robeb002,Bip Roberts,San Diego Padres,PADRS,2,5,5,10,1995,2006,11,5.59,24.83,19.24,564,1458,894,2040,5766,3726,0.0,4.0,4.0,10951680.0,12450000.0,1498320.0
robeb002,Bip Roberts,Kansas City Royals,ROYALS,1,1,1,2,1997,1997,0,0.19,0.01,-0.18,23,1,-22,96,0,-96,0.0,6.0,6.0,1950000.0,0.0,-1950000.0
robeb002,Bip Roberts,Detroit Tigers,TIGRS,1,1,1,2,1998,1999,1,1.23,-0.21,-1.44,61,37,-24,201,73,-128,0.0,0.0,0.0,2300000.0,170000.0,-2130000.0
robec002,Connor Robertson,Oakland Athletics,ATLTCS,15,28,26,54,2007,2018,11,108.14,27.37,-80.77,6020,2116,-3904,18233,6199,-12034,5643.0,3558.0,-2085.0,32617500.0,22402333.0,-10215167.0
robec002,Connor Robertson,Arizona Diamondbacks,DBACKS,1,1,1,2,2008,2009,1,0.0,-0.7,-0.7,0,87,87,0,0,0,0.0,72.0,72.0,0.0,3600000.0,3600000.0
robec102,Curt Roberts,Pittsburgh Pirates,PIRATS,1,2,1,3,1956,1956,0,-0.27,-0.37,-0.1,46,11,-35,14,41,27,185.0,0.0,-185.0,0.0,0.0,0.0
robec102,Curt Roberts,Kansas City Athletics,ATLTCS,38,80,81,161,1957,1976,19,137.3,59.64,-77.66,12943,8836,-4107,29783,24655,-5128,18720.0,9434.0,-9286.0,506100.0,626500.0,120400.0
robed001,Dave Roberts,Detroit Tigers,TIGRS,1,2,1,3,1998,1998,0,0.14,-0.51,-0.65,78,52,-26,182,145,-37,16.0,0.0,-16.0,1000000.0,2200000.0,1200000.0
robed001,Dave Roberts,Cleveland Indians,INDINS,1,1,2,3,2001,2001,0,4.7,0.0,-4.7,302,0,-302,1189,0,-1189,0.0,0.0,0.0,212000.0,0.0,-212000.0
robed001,Dave Roberts,Los Angeles Dodgers,DOGRS,1,1,1,2,2004,2004,0,0.31,0.0,-0.31,45,0,-45,101,0,-101,0.0,0.0,0.0,975000.0,0.0,-975000.0
robed001,Dave Roberts,Boston Red Sox,RSOX,4,5,7,12,2004,2010,6,7.49,1.65,-5.84,501,423,-78,2029,1001,-1028,0.0,155.0,155.0,4200000.0,3142500.0,-1057500.0
robed002,David Robertson,Chicago White Sox,WSOX,2,4,5,9,2017,2017,0,4.16,0.5,-3.66,327,12,-315,241,0,-241,693.0,30.0,-663.0,12535000.0,6150000.0,-6385000.0
robed003,Daniel Robertson,Texas Rangers,RNGRS,1,1,1,2,2014,2014,0,0.62,0.0,-0.62,37,0,-37,80,0,-80,0.0,0.0,0.0,0.0,0.0,0.0
robed004,Daniel Robertson,Oakland Athletics,ATLTCS,7,12,9,21,2015,2018,3,7.5,-0.52,-8.02,615,193,-422,2031,464,-1567,103.0,312.0,209.0,8300001.0,4800000.0,-3500001.0
robed101,Dave Roberts,San Diego Padres,PADRS,5,6,9,15,1971,1982,11,11.48,-0.86,-12.34,888,1750,862,1831,3554,1723,3035.0,3400.0,365.0,0.0,0.0,0.0
robed101,Dave Roberts,Houston Astros,ASTROS,6,11,9,20,1975,1989,14,10.73,12.05,1.32,1452,1687,235,3403,4505,1102,3386.0,1859.0,-1527.0,22500.0,16500.0,-6000.0
robed101,Dave Roberts,San Francisco Giants,GIANTS,11,23,25,48,1979,1998,19,47.48,66.07,18.59,2727,4533,1806,5432,5570,138,5201.0,15628.0,10427.0,10487778.0,6966667.0,-3521111.0
robed102,Dave Roberts,Toronto Blue Jays,BJAYS,1,1,1,2,1977,1978,1,0.33,-0.06,-0.39,136,43,-93,314,0,-314,0.0,258.0,258.0,0.0,0.0,0.0
robed102,Dave Roberts,San Diego Padres,PADRS,5,12,10,22,1978,1989,11,40.51,8.43,-32.08,3264,1226,-2038,10982,3533,-7449,2009.0,1127.0,-882.0,475000.0,0.0,-475000.0
robed102,Dave Roberts,Houston Astros,ASTROS,1,1,1,2,1982,1982,0,-0.44,0.0,0.44,28,0,-28,36,0,-36,0.0,0.0,0.0,0.0,0.0,0.0
robed103,Dave Robertson,New York Giants,GIANTS,1,1,1,2,1919,1919,0,1.13,-0.26,-1.39,183,16,-167,691,16,-675,0.0,154.0,154.0,4968.0,3420.0,-1548.0
robed103,Dave Robertson,Chicago Cubs,CUBS,3,9,6,15,1921,1926,5,30.51,10.96,-19.55,1180,383,-797,4349,729,-3620,1929.0,3229.0,1300.0,18586.0,22950.0,4364.0
robed105,Daryl Robertson,Milwaukee Braves,BRAVES,1,2,2,4,1961,1961,0,3.31,-0.59,-3.9,499,56,-443,1886,5,-1881,0.0,122.0,122.0,0.0,0.0,0.0
robed105,Daryl Robertson,Chicago Cubs,CUBS,5,10,7,17,1962,1977,15,11.99,38.79,26.8,728,2444,1716,383,6330,5947,3515.0,5246.0,1731.0,122500.0,47500.0,-75000.0
robed107,Dale Roberts,New York Yankees,YANKS,1,2,1,3,1967,1970,3,0.07,0.93,0.86,226,220,-6,711,719,8,0.0,0.0,0.0,6000.0,0.0,-6000.0
robeg101,Gene Robertson,StPaul,StPaul,1,1,1,2,1927,1927,0,1.2,0.0,-1.2,173,0,-173,624,0,-624,0.0,0.0,0.0,0.0,0.0,0.0
robeg101,Gene Robertson,Boston Braves,BRAVES,1,2,1,3,1930,1932,2,0.0,-0.08,-0.08,0,129,129,0,512,512,0.0,0.0,0.0,5000.0,0.0,-5000.0
robeg101,Gene Robertson,St.Louis Browns,ORLS,21,42,49,91,1926,1952,26,96.01,107.81,11.8,5218,9406,4188,17109,30707,13598,8613.0,15510.0,6897.0,200300.0,179450.0,-20850.0
robej001,Jeriome Robertson,Houston Astros,ASTROS,2,6,2,8,2004,2009,5,10.31,7.34,-2.97,870,547,-323,1797,2103,306,1372.0,0.0,-1372.0,382000.0,13811415.0,13429415.0
robej001,Jeriome Robertson,Cleveland Indians,INDINS,1,1,1,2,2004,2004,0,0.0,0.0,0.0,0,0,0,0,0,0,0.0,0.0,0.0,0.0,0.0,0.0
robej101,Jim Roberts,LittleRock,LittleRock,1,1,2,3,1924,1925,1,-1.03,0.0,1.03,24,0,-24,8,0,-8,79.0,0.0,-79.0,0.0,2100.0,2100.0
robej102,Jerry Robertson,Montreal Expos,NATEX,1,1,1,2,1969,1969,0,0.06,0.0,-0.06,22,0,-22,0,0,0,44.0,0.0,-44.0,0.0,23500.0,23500.0
robej102,Jerry Robertson,Detroit Tigers,TIGRS,5,5,6,11,1971,1973,2,0.39,2.41,2.02,72,196,124,148,31,-117,36.0,772.0,736.0,0.0,0.0,0.0
robej103,Jim Robertson,New York Yankees,YANKS,16,45,38,83,1953,1970,17,48.62,78.17,29.55,7017,4726,-2291,22732,11340,-11392,3607.0,11554.0,7947.0,313000.0,125500.0,-187500.0
robej103,Jim Robertson,Detroit Tigers,TIGRS,1,2,2,4,1956,1956,0,0.0,0.0,0.0,0,0,0,0,0,0,0.0,0.0,0.0,0.0,0.0,0.0
robel001,Leon Roberts,Detroit Tigers,TIGRS,1,4,3,7,1975,1979,4,4.11,5.38,1.27,431,290,-141,467,862,395,1859.0,1144.0,-715.0,16500.0,0.0,-16500.0
robel001,Leon Roberts,Houston Astros,ASTROS,3,3,3,6,1977,1983,6,10.17,0.2,-9.97,601,140,-461,1630,205,-1425,728.0,0.0,-728.0,0.0,0.0,0.0
robel001,Leon Roberts,Seattle Mariners,MARNRS,2,7,7,14,1980,1985,5,8.79,3.61,-5.18,489,434,-55,632,1358,726,2623.0,1017.0,-1606.0,175000.0,512500.0,337500.0
robel001,Leon Roberts,Toronto Blue Jays,BJAYS,1,1,1,2,1983,1988,5,0.46,0.26,-0.2,113,220,107,284,558,274,3.0,0.0,-3.0,0.0,0.0,0.0
robem001,Mike Robertson,Chicago White Sox,WSOX,1,1,1,2,1997,1997,0,-0.33,0.0,0.33,22,0,-22,41,0,-41,0.0,0.0,0.0,0.0,0.0,0.0
roben001,Nate Robertson,Florida Marlins,MARLNS,12,23,29,52,2003,2019,16,83.08,57.28,-25.8,2779,2940,161,6322,8392,2070,15065.0,6008.0,-9057.0,40718667.0,23598092.0,-17120575.0
rober002,Ryan Roberts,Arizona Diamondbacks,DBACKS,1,1,1,2,2012,2012,0,0.9,0.0,-0.9,120,0,-120,382,0,-382,0.0,0.0,0.0,2012500.0,0.0,-2012500.0
robia101,Aaron Robinson,New York Yankees,YANKS,2,4,2,6,1948,1956,8,8.14,18.41,10.27,334,437,103,647,602,-45,2224.0,4492.0,2268.0,0.0,0.0,0.0
robia101,Aaron Robinson,Chicago White Sox,WSOX,7,8,13,21,1948,1968,20,12.89,63.07,50.18,1237,2143,906,1679,2313,634,2300.0,11689.0,9389.0,31250.0,52000.0,20750.0
robib101,Bill Robinson,Atlanta Braves,BRAVES,1,2,1,3,1966,1971,5,-2.04,8.56,10.6,310,533,223,998,2105,1107,0.0,0.0,0.0,5500.0,31500.0,26000.0
robib101,Bill Robinson,New York Yankees,YANKS,1,1,1,2,1970,1970,0,0.0,0.0,0.0,0,0,0,0,0,0,0.0,0.0,0.0,0.0,0.0,0.0
robib101,Bill Robinson,Chicago White Sox,WSOX,1,1,1,2,1971,1971,0,2.12,0.0,-2.12,351,0,-351,1072,0,-1072,0.0,0.0,0.0,0.0,0.0,0.0
robib101,Bill Robinson,Philadelphia Phillies,PHILS,1,1,1,2,1975,1976,1,7.46,0.56,-6.9,805,14,-791,2649,10,-2639,0.0,92.0,92.0,0.0,0.0,0.0
robib101,Bill Robinson,Pittsburgh Pirates,PIRATS,2,2,2,4,1982,1983,1,-1.41,-0.58,0.83,117,40,-77,283,90,-193,0.0,0.0,0.0,0.0,0.0,0.0
robic001,Clint Robinson,Kansas City Royals,ROYALS,1,2,2,4,2012,2015,3,1.15,0.0,-1.15,120,0,-120,7,0,-7,252.0,0.0,-252.0,0.0,0.0,0.0
robic002,Chris Robinson,Detroit Tigers,TIGRS,1,1,1,2,2006,2007,1,0.0,-0.51,-0.51,0,54,54,0,141,141,0.0,0.0,0.0,0.0,2500000.0,2500000.0
robic101,Craig Robinson,Philadelphia Phillies,PHILS,1,2,1,3,1973,1977,4,-0.85,1.42,2.27,197,250,53,576,78,-498,0.0,1037.0,1037.0,0.0,0.0,0.0
robic101,Craig Robinson,Atlanta Braves,BRAVES,3,5,6,11,1975,1984,9,22.71,-0.2,-22.91,1673,1539,-134,5437,5141,-296,292.0,128.0,-164.0,0.0,135000.0,135000.0
robic101,Craig Robinson,San Francisco Giants,GIANTS,2,5,3,8,1976,1983,7,-0.82,27.35,28.17,287,1701,1414,1089,6469,5380,0.0,0.0,0.0,0.0,0.0,0.0
robid001,Don Robinson,Pittsburgh Pirates,PIRATS,3,4,5,9,1987,1988,1,18.64,0.05,-18.59,1284,52,-1232,3306,126,-3180,2086.0,0.0,-2086.0,857500.0,0.0,-857500.0
robid003,Drew Robinson,Texas Rangers,RNGRS,1,1,1,2,2018,2019,1,-0.09,-0.25,-0.16,5,9,4,7,28,21,0.0,0.0,0.0,0.0,0.0,0.0
robid101,Dewey Robinson,Chicago White Sox,WSOX,1,2,1,3,1981,2007,26,0.0,0.0,0.0,0,0,0,0,0,0,0.0,0.0,0.0,0.0,0.0,0.0
robie101,Eddie Robinson,Cleveland Indians,INDINS,14,26,24,50,1948,1968,20,162.56,72.5,-90.06,7462,3103,-4359,23911,8852,-15059,13186.0,8500.0,-4686.0,30900.0,42000.0,11100.0
robie101,Eddie Robinson,Washington Senators,TWINS,12,23,24,47,1950,1963,13,21.31,19.51,-1.8,2117,2519,402,6320,5694,-626,2404.0,6282.0,3878.0,32000.0,59000.0,27000.0
robie101,Eddie Robinson,Chicago White Sox,WSOX,4,11,8,19,1953,1961,8,18.88,11.66,-7.22,2482,1258,-1224,8241,3866,-4375,2246.0,488.0,-1758.0,62000.0,80000.0,18000.0
robie101,Eddie Robinson,Philadelphia Athletics,ATLTCS,46,109,116,225,1953,1976,23,189.08,109.39,-79.69,16486,13560,-2926,40867,38903,-1964,20759.0,16429.0,-4330.0,546100.0,754900.0,208800.0
robie101,Eddie Robinson,New York Yankees,YANKS,3,5,6,11,1956,1960,4,1.84,-2.55,-4.39,364,104,-260,1055,53,-1002,0.0,406.0,406.0,4500.0,7000.0,2500.0
robie101,Eddie Robinson,Kansas City Athletics,ATLTCS,40,86,88,174,1956,1976,20,134.11,73.29,-60.82,13270,9412,-3858,30102,25264,-4838,19786.0,12575.0,-7211.0,506100.0,652200.0,146100.0
robif102,Floyd Robinson,Chicago White Sox,WSOX,1,1,1,2,1966,1966,0,-0.72,0.0,0.72,55,0,-55,145,0,-145,0.0,0.0,0.0,26000.0,29000.0,3000.0
robif102,Floyd Robinson,Cincinnati Reds,REDS,1,2,1,3,1967,1968,1,0.17,0.0,-0.17,59,0,-59,90,0,-90,17.0,0.0,-17.0,0.0,0.0,0.0
robif103,Frank Robinson,Cincinnati Reds,REDS,14,18,24,42,1965,1988,23,43.19,71.71,28.52,2283,5415,3132,7779,8902,1123,1546.0,11662.0,10116.0,75500.0,32500.0,-43000.0
robif103,Frank Robinson,Baltimore Orioles,ORLS,5,14,16,30,1971,1988,17,20.93,69.89,48.96,1174,3443,2269,1219,6819,5600,6830.0,12795.0,5965.0,725333.0,8400.0,-716933.0
robif103,Frank Robinson,Los Angeles Dodgers,DOGRS,1,5,2,7,1972,1976,4,16.6,19.03,2.43,596,356,-240,1923,542,-1381,1810.0,2591.0,781.0,251500.0,115000.0,-136500.0
robif103,Frank Robinson,California Angels,ANGELS,1,1,3,4,1974,1977,3,0.94,0.32,-0.62,100,178,78,289,399,110,0.0,0.0,0.0,160000.0,19750.0,-140250.0
robih101,Humberto Robinson,Milwaukee Braves,BRAVES,1,1,1,2,1959,1959,0,0.01,0.07,0.06,10,74,64,0,99,99,26.0,0.0,-26.0,0.0,0.0,0.0
robih101,Humberto Robinson,Cleveland Indians,INDINS,1,1,1,2,1959,1959,0,1.68,-0.35,-2.03,128,27,-101,23,69,46,368.0,0.0,-368.0,0.0,0.0,0.0
robih102,Hank Robinson,Pittsburgh Pirates,PIRATS,1,5,3,8,1913,1915,2,18.03,3.31,-14.72,1733,233,-1500,6155,938,-5217,795.0,0.0,-795.0,11400.0,13500.0,2100.0
robij001,Jeff Robinson,San Francisco Giants,GIANTS,1,2,1,3,1987,1991,4,-1.33,7.08,8.41,332,192,-140,71,229,158,980.0,1803.0,823.0,0.0,750000.0,750000.0
robij001,Jeff Robinson,Pittsburgh Pirates,PIRATS,1,2,1,3,1989,1995,6,1.53,10.25,8.72,54,475,421,0,1624,1624,266.0,0.0,-266.0,750000.0,650000.0,-100000.0
robij002,Jeff Robinson,Detroit Tigers,TIGRS,1,1,1,2,1991,1994,3,-0.4,14.83,15.23,21,570,549,0,2343,2343,313.0,0.0,-313.0,0.0,0.0,0.0
robij101,Jack Robinson,New York Yankees,YANKS,1,2,2,4,1948,1948,0,0.1,0.0,-0.1,6,0,-6,0,0,0,12.0,0.0,-12.0,0.0,0.0,0.0
robij103,Jackie Robinson,Brooklyn Dodgers,DOGRS,1,1,2,3,1956,1958,2,0.0,0.0,0.0,0,0,0,0,0,0,0.0,0.0,0.0,31500.0,0.0,-31500.0
robik002,Kerry Robinson,Seattle Mariners,MARNRS,1,1,1,2,1999,2000,1,-0.06,0.16,0.22,9,13,4,1,0,-1,0.0,29.0,29.0,0.0,0.0,0.0
robik002,Kerry Robinson,St. Louis Cardinals,CARDS,1,1,1,2,2004,2004,0,-0.31,0.0,0.31,80,0,-80,101,0,-101,0.0,0.0,0.0,0.0,0.0,0.0
robir001,Ron Robinson,Cincinnati Reds,REDS,1,2,2,4,1990,1992,2,2.39,3.07,0.68,42,257,215,0,822,822,597.0,0.0,-597.0,500000.0,675000.0,175000.0
robir101,Rabbit Robinson,Cincinnati Reds,REDS,1,2,1,3,1910,1910,0,0.0,-0.59,-0.59,0,21,21,0,69,69,0.0,0.0,0.0,0.0,0.0,0.0
robit001,Trayvon Robinson,Los Angeles Dodgers,DOGRS,5,11,11,22,2011,2021,10,5.98,11.71,5.73,566,1023,457,1625,2754,1129,1807.0,632.0,-1175.0,21000000.0,12293600.0,-8706400.0
robit001,Trayvon Robinson,Seattle Mariners,MARNRS,2,2,2,4,2012,2013,1,0.0,-0.4,-0.4,0,29,29,0,85,85,0.0,0.0,0.0,0.0,1300000.0,1300000.0
roblh001,Hansel Robles,Minnesota Twins,TWINS,1,1,1,2,2021,2021,0,0.49,0.0,-0.49,29,0,-29,0,0,0,75.0,0.0,-75.0,2000000.0,0.0,-2000000.0
roblm001,Mauricio Robles,Detroit Tigers,TIGRS,1,2,1,3,2009,2009,0,-0.44,-0.68,-0.24,25,8,-17,1,0,-1,377.0,129.0,-248.0,0.0,9850000.0,9850000.0
roblr101,Rafael Robles,San Diego Padres,PADRS,1,1,2,3,1972,1972,0,0.0,0.0,0.0,0,7,7,0,7,7,0.0,0.0,0.0,0.0,24000.0,24000.0
robls101,Sergio Robles,Los Angeles Dodgers,DOGRS,3,10,5,15,1971,1976,5,18.58,22.72,4.14,838,611,-227,2013,960,-1053,3623.0,2900.0,-723.0,259900.0,282000.0,22100.0
roccm101,Mickey Rocco,Nashville,Nashville,1,3,1,4,1940,1954,14,0.0,0.0,0.0,0,0,0,0,0,0,0.0,0.0,0.0,0.0,0.0,0.0
roccm101,Mickey Rocco,Cleveland Indians,INDINS,1,2,1,3,1946,1947,1,0.0,0.89,0.89,0,52,52,0,174,174,0.0,0.0,0.0,0.0,8500.0,8500.0
rockj001,John Rocker,Atlanta Braves,BRAVES,1,2,2,4,2001,2001,0,-0.15,0.35,0.5,40,162,122,0,2,2,104.0,227.0,123.0,1900000.0,4300000.0,2400000.0
rockj001,John Rocker,Cleveland Indians,INDINS,1,1,1,2,2001,2003,2,-0.54,0.13,0.67,36,19,-17,0,0,0,73.0,76.0,3.0,0.0,0.0,0.0
rockp101,Pat Rockett,Atlanta Braves,BRAVES,1,3,2,5,1979,1986,7,6.25,5.96,-0.29,653,1043,390,1647,3360,1713,1023.0,3.0,-1020.0,0.0,0.0,0.0
rodga101,Andre Rodgers,San Francisco Giants,GIANTS,1,1,1,2,1960,1960,0,0.0,0.0,0.0,0,0,0,0,0,0,0.0,0.0,0.0,0.0,0.0,0.0
rodga101,Andre Rodgers,Milwaukee Braves,BRAVES,1,2,2,4,1961,1961,0,3.31,-0.59,-3.9,499,56,-443,1886,5,-1881,0.0,122.0,122.0,0.0,0.0,0.0
rodga101,Andre Rodgers,Chicago Cubs,CUBS,1,1,2,3,1964,1966,2,0.82,-0.6,-1.42,158,57,-101,328,209,-119,0.0,0.0,0.0,0.0,0.0,0.0
rodnf001,Fernando Rodney,Seattle Mariners,MARNRS,1,1,1,2,2015,2015,0,0.2,0.0,-0.2,28,0,-28,0,0,0,36.0,0.0,-36.0,7000000.0,0.0,-7000000.0
rodnf001,Fernando Rodney,San Diego Padres,PADRS,1,1,1,2,2016,2016,0,-0.78,0.0,0.78,77,0,-77,0,0,0,110.0,0.0,-110.0,0.0,0.0,0.0
rodnf001,Fernando Rodney,Minnesota Twins,TWINS,1,1,1,2,2018,2018,0,-0.42,0.0,0.42,41,0,-41,0,0,0,105.0,0.0,-105.0,0.0,0.0,0.0
rodra001,Alex Rodriguez,Texas Rangers,RNGRS,5,8,11,19,2004,2010,6,93.01,8.2,-84.81,2905,738,-2167,11217,2392,-8825,3052.0,497.0,-2555.0,7902000.0,8395000.0,493000.0
rodra002,Aneury Rodriguez,Colorado Rockies,ROCKS,3,4,3,7,2009,2012,3,6.7,2.79,-3.91,199,236,37,28,217,189,2842.0,1880.0,-962.0,8200000.0,5600000.0,-2600000.0
rodra101,Aurelio Rodriguez,California Angels,ANGELS,10,16,20,36,1970,1977,7,30.4,30.36,-0.04,1555,1533,-22,4572,5092,520,3213.0,1843.0,-1370.0,333500.0,358250.0,24750.0
rodra101,Aurelio Rodriguez,Washington Senators,RNGRS,6,10,11,21,1970,1976,6,30.0,-0.41,-30.41,2790,834,-1956,8622,1724,-6898,5481.0,1612.0,-3869.0,75900.0,317100.0,241200.0
rodra101,Aurelio Rodriguez,New York Yankees,YANKS,1,1,1,2,1981,1981,0,0.0,0.0,0.0,0,0,0,0,0,0,0.0,0.0,0.0,0.0,0.0,0.0
rodra101,Aurelio Rodriguez,Toronto Blue Jays,BJAYS,3,3,3,6,1982,1982,0,-0.11,-2.44,-2.33,179,147,-32,384,402,18,0.0,0.0,0.0,0.0,160000.0,160000.0
rodre001,Edwin Rodriguez,New York Yankees,YANKS,1,3,1,4,1983,1985,2,4.84,1.45,-3.39,236,20,-216,270,0,-270,2040.0,301.0,-1739.0,0.0,0.0,0.0
rodre004,Eduardo Rodriguez,Baltimore Orioles,ORLS,1,1,1,2,2014,2014,0,15.37,0.96,-14.41,172,24,-148,29,0,-29,2570.0,60.0,-2510.0,0.0,1900000.0,1900000.0
rodre101,Ellie Rodriguez,Kansas City Royals,ROYALS,1,1,1,2,1971,1971,0,7.99,-0.11,-8.1,325,20,-305,1152,46,-1106,0.0,0.0,0.0,0.0,0.0,0.0
rodre101,Ellie Rodriguez,Milwaukee Brewers,BREWRS,3,7,7,14,1973,1978,5,7.23,1.8,-5.43,546,209,-337,1533,327,-1206,524.0,1634.0,1110.0,168301.0,15000.0,-153301.0
rodre101,Ellie Rodriguez,California Angels,ANGELS,1,1,2,3,1976,1976,0,0.1,-0.34,-0.44,36,15,-21,90,42,-48,0.0,0.0,0.0,0.0,0.0,0.0
rodrf001,Frankie Rodriguez,Boston Red Sox,RSOX,1,2,1,3,1995,1995,0,2.15,1.05,-1.1,120,30,-90,1,0,-1,1528.0,91.0,-1437.0,109000.0,4350000.0,4241000.0
rodrf002,Felix Rodriguez,Cincinnati Reds,REDS,1,1,1,2,1997,1997,0,-0.7,-0.07,0.63,85,10,-75,0,0,0,132.0,18.0,-114.0,175000.0,0.0,-175000.0
rodrf002,Felix Rodriguez,Arizona Diamondbacks,DBACKS,1,1,2,3,1998,2002,4,8.33,0.24,-8.09,765,116,-649,15,1,-14,1209.0,148.0,-1061.0,210000.0,0.0,-210000.0
rodrf002,Felix Rodriguez,San Francisco Giants,GIANTS,1,1,2,3,2004,2006,2,0.54,-0.41,-0.95,46,31,-15,0,60,60,63.0,0.0,-63.0,3050000.0,1225000.0,-1825000.0
rodrf002,Felix Rodriguez,Philadelphia Phillies,PHILS,1,1,1,2,2004,2005,1,0.31,3.55,3.24,35,110,75,0,406,406,97.0,0.0,-97.0,0.0,3100000.0,3100000.0
rodrf003,Francisco Rodriguez,New York Mets,METS,1,2,2,4,2011,2013,2,5.0,0.38,-4.62,513,32,-481,1,0,-1,752.0,24.0,-728.0,12166666.0,0.0,-12166666.0
rodrf003,Francisco Rodriguez,Milwaukee Brewers,BREWRS,1,1,1,2,2013,2015,2,0.01,0.0,-0.01,29,0,-29,0,0,0,66.0,0.0,-66.0,0.0,0.0,0.0
rodrf003,Francisco Rodriguez,Milwaukee Brewers,BREWRS,1,1,2,3,2015,2021,6,0.31,6.56,6.25,95,404,309,0,1209,1209,251.0,0.0,-251.0,3500000.0,0.0,-3500000.0
rodrf004,Fernando Rodriguez,Houston Astros,ASTROS,2,3,5,8,2013,2020,7,13.46,8.06,-5.4,1071,776,-295,3907,2069,-1838,325.0,1629.0,1304.0,590100.0,0.0,-590100.0
rodrf101,Freddy Rodriguez,San Francisco Giants,GIANTS,1,1,1,2,1957,1957,0,-0.27,0.0,0.27,14,0,-14,1,0,-1,22.0,0.0,-22.0,0.0,0.0,0.0
rodrf101,Freddy Rodriguez,Chicago Cubs,CUBS,1,1,1,2,1958,1958,0,0.0,0.0,0.0,0,0,0,0,0,0,0.0,0.0,0.0,0.0,0.0,0.0
rodrh001,Henry Rodriguez,Los Angeles Dodgers,DOGRS,2,4,3,7,1995,1996,1,1.62,-0.16,-1.78,426,245,-181,1244,564,-680,244.0,191.0,-53.0,305000.0,2000000.0,1695000.0
rodrh001,Henry Rodriguez,Montreal Expos,NATEX,2,2,2,4,1997,2000,3,2.84,0.22,-2.62,350,203,-147,1267,78,-1189,171.0,850.0,679.0,2625000.0,373000.0,-2252000.0
rodrh001,Henry Rodriguez,Chicago Cubs,CUBS,5,9,8,17,2000,2007,7,3.59,5.03,1.44,575,630,55,961,2305,1344,801.0,0.0,-801.0,11833333.0,15890494.0,4057161.0
rodrh002,Henry Rodriguez,Oakland Athletics,ATLTCS,1,2,1,3,2010,2011,1,-0.11,2.27,2.38,253,136,-117,47,563,516,339.0,0.0,-339.0,0.0,4600000.0,4600000.0
rodrh002,Henry Rodriguez,Washington Nationals,NATEX,1,1,1,2,2013,2013,0,-0.1,0.0,0.1,10,0,-10,0,0,0,12.0,0.0,-12.0,501000.0,0.0,-501000.0
rodrh101,Hector Rodriguez,Brooklyn Dodgers,DOGRS,2,2,3,5,1951,1953,2,0.83,0.03,-0.8,128,37,-91,466,46,-420,0.0,0.0,0.0,0.0,0.0,0.0
rodrh101,Hector Rodriguez,Chicago White Sox,WSOX,30,57,56,113,1953,1971,18,64.71,123.89,59.18,7633,8346,713,20626,20050,-576,7158.0,13944.0,6786.0,248750.0,225500.0,-23250.0
rodri001,Ivan Rodriguez,Detroit Tigers,TIGRS,1,1,1,2,2008,2008,0,-0.8,-0.51,0.29,33,16,-17,101,0,-101,0.0,48.0,48.0,12379883.0,5916666.0,-6463217.0
rodri001,Ivan Rodriguez,Houston Astros,ASTROS,1,1,2,3,2009,2009,0,-0.43,0.0,0.43,28,0,-28,104,0,-104,0.0,0.0,0.0,1500000.0,0.0,-1500000.0
rodrj002,John Rodriguez,Cleveland Indians,INDINS,1,1,1,2,2005,2005,0,0.63,0.0,-0.63,158,0,-158,388,0,-388,0.0,0.0,0.0,0.0,0.0,0.0
rodrj004,Joely Rodriguez,Pittsburgh Pirates,PIRATS,1,1,1,2,2014,2015,1,-0.74,0.91,1.65,76,127,51,0,2,2,110.0,172.0,62.0,0.0,2000000.0,2000000.0
rodrj004,Joely Rodriguez,Philadelphia Phillies,PHILS,1,1,1,2,2017,2017,0,-0.19,0.0,0.19,46,0,-46,0,0,0,120.0,0.0,-120.0,535000.0,0.0,-535000.0
rodrj004,Joely Rodriguez,Texas Rangers,RNGRS,1,3,4,7,2021,2021,0,0.78,-0.87,-1.65,82,6,-76,228,0,-228,57.0,70.0,13.0,8700000.0,0.0,-8700000.0
rodrj005,Jefry Rodriguez,Washington Nationals,NATEX,2,6,4,10,2018,2021,3,-0.4,4.3,4.7,134,190,56,433,712,279,140.0,0.0,-140.0,7000000.0,6033333.0,-966667.0
rodrj101,Jose Rodriguez,New York Giants,GIANTS,2,8,3,11,1919,1923,4,10.49,7.89,-2.6,305,402,97,539,1094,555,2035.0,323.0,-1712.0,12500.0,9600.0,-2900.0
rodrn001,Nerio Rodriguez,Baltimore Orioles,ORLS,2,4,3,7,1998,2005,7,0.36,10.59,10.23,33,461,428,30,8,-22,263.0,1704.0,1441.0,5250000.0,5000000.0,-250000.0
rodrn001,Nerio Rodriguez,Cleveland Indians,INDINS,1,1,1,2,2002,2002,0,-0.05,0.0,0.05,4,0,-4,1,0,-1,13.0,0.0,-13.0,0.0,0.0,0.0
rodrp001,Paco Rodriguez,Los Angeles Dodgers,DOGRS,9,31,24,55,2015,2021,6,13.41,18.97,5.56,1905,1113,-792,5768,1311,-4457,2200.0,3323.0,1123.0,37486500.0,75153480.0,37666980.0
rodrr002,Ruben Rodriguez,Pittsburgh Pirates,PIRATS,1,1,1,2,1989,1989,0,0.0,0.0,0.0,0,0,0,0,0,0,0.0,0.0,0.0,0.0,0.0,0.0
rodrr004,Rich Rodriguez,New York Mets,METS,1,1,2,3,1989,1989,0,3.38,0.0,-3.38,383,0,-383,18,0,-18,746.0,0.0,-746.0,0.0,0.0,0.0
rodrr004,Rich Rodriguez,San Diego Padres,PADRS,2,3,4,7,1993,2008,15,13.46,26.09,12.63,630,1877,1247,2360,48,-2312,138.0,3132.0,2994.0,3375000.0,109000.0,-3266000.0
rodrr005,Ricardo Rodriguez,Los Angeles Dodgers,DOGRS,1,3,1,4,2002,2004,2,-0.33,0.6,0.93,92,177,85,4,5,1,830.0,299.0,-531.0,3250000.0,3250000.0,0.0
rodrr005,Ricardo Rodriguez,Cleveland Indians,INDINS,1,2,1,3,2003,2005,2,0.87,1.1,0.23,75,73,-2,221,247,26,251.0,0.0,-251.0,902400.0,0.0,-902400.0
rodrr005,Ricardo Rodriguez,Texas Rangers,RNGRS,1,1,1,2,2005,2009,4,0.0,4.08,4.08,0,107,107,0,10,10,0.0,1798.0,1798.0,0.0,3200000.0,3200000.0
rodrr006,Rafael Rodriguez,Anaheim Angels,ANGELS,1,4,1,5,2010,2012,2,13.1,6.5,-6.6,498,84,-414,497,11,-486,4323.0,1527.0,-2796.0,3700000.0,8250000.0,4550000.0
rodrr008,Richard Rodriguez,Pittsburgh Pirates,PIRATS,1,1,2,3,2021,2021,0,0.61,0.25,-0.36,53,15,-38,0,12,12,78.0,121.0,43.0,1700000.0,0.0,-1700000.0
rodrr101,Roberto Rodriguez,Oakland Athletics,ATLTCS,1,1,1,2,1970,1970,0,-0.82,0.0,0.82,52,0,-52,9,0,-9,130.0,0.0,-130.0,0.0,0.0,0.0
rodrs002,Sean Rodriguez,Anaheim Angels,ANGELS,1,3,1,4,2009,2011,2,9.82,-0.01,-9.83,598,38,-560,1637,7,-1630,198.0,564.0,366.0,405000.0,6000000.0,5595000.0
rodrs002,Sean Rodriguez,Tampa Bay Devil Rays,RAYS,1,1,1,2,2014,2014,0,1.1,0.0,-1.1,384,0,-384,861,0,-861,0.0,0.0,0.0,1475000.0,0.0,-1475000.0
rodrs002,Sean Rodriguez,Atlanta Braves,BRAVES,2,2,2,4,2017,2017,0,-0.61,0.0,0.61,105,0,-105,279,0,-279,0.0,0.0,0.0,0.0,0.0,0.0
rodrv001,Vic Rodriguez,Baltimore Orioles,ORLS,1,1,1,2,1985,1985,0,0.0,0.35,0.35,0,50,50,0,135,135,0.0,0.0,0.0,0.0,0.0,0.0
rodrw002,Wandy Rodriguez,Houston Astros,ASTROS,1,1,3,4,2012,2015,3,0.18,1.62,1.44,63,191,128,59,764,705,493.0,17.0,-476.0,0.0,0.0,0.0
roe-c001,Chaz Roe,Colorado Rockies,ROCKS,1,1,1,2,2010,2011,1,0.0,-0.43,-0.43,0,38,38,0,129,129,0.0,0.0,0.0,0.0,3000000.0,3000000.0
roe-p101,Preacher Roe,St. Louis Cardinals,CARDS,1,1,3,4,1943,1946,3,8.3,0.0,-8.3,262,0,-262,215,0,-215,1903.0,0.0,-1903.0,0.0,0.0,0.0
roe-p101,Preacher Roe,Pittsburgh Pirates,PIRATS,1,3,3,6,1947,1950,3,26.56,1.84,-24.72,1156,287,-869,3340,710,-2630,3832.0,295.0,-3537.0,0.0,0.0,0.0
roe-p101,Preacher Roe,Brooklyn Dodgers,DOGRS,1,2,3,5,1954,1954,0,0.54,0.0,-0.54,53,0,-53,213,0,-213,0.0,0.0,0.0,19000.0,0.0,-19000.0
roebe101,Ed Roebuck,Los Angeles Dodgers,DOGRS,1,1,1,2,1963,1964,1,0.54,-0.38,-0.92,56,20,-36,13,40,27,175.0,0.0,-175.0,0.0,0.0,0.0
roeng001,Gary Roenicke,Montreal Expos,NATEX,1,3,3,6,1977,1986,9,17.04,9.91,-7.13,1002,506,-496,2634,346,-2288,744.0,3222.0,2478.0,0.0,0.0,0.0
roeng001,Gary Roenicke,Baltimore Orioles,ORLS,1,2,2,4,1985,1987,2,-0.33,0.34,0.67,76,66,-10,188,1,-187,0.0,321.0,321.0,558333.0,0.0,-558333.0
roenj001,Josh Roenicke,Cincinnati Reds,REDS,1,3,1,4,2009,2012,3,24.68,7.61,-17.07,1033,330,-703,4205,1298,-2907,160.0,0.0,-160.0,2425000.0,11625000.0,9200000.0
roesm001,Mike Roesler,Cincinnati Reds,REDS,2,3,2,5,1990,1992,2,-1.08,-0.05,1.03,271,352,81,1090,1144,54,18.0,139.0,121.0,1600000.0,525000.0,-1075000.0
roeto101,Oscar Roettger,New York Yankees,YANKS,2,6,4,10,1925,1931,6,-1.14,6.67,7.81,271,713,442,761,2895,2134,731.0,97.0,-634.0,31500.0,18000.0,-13500.0
roeto101,Oscar Roettger,StPaul,StPaul,1,1,2,3,1931,1931,0,-0.33,0.0,0.33,26,0,-26,66,0,-66,0.0,0.0,0.0,0.0,0.0,0.0
roeto101,Oscar Roettger,Philadelphia Athletics,ATLTCS,3,6,3,9,1932,1934,2,0.0,-0.52,-0.52,0,16,16,0,5,5,0.0,34.0,34.0,7600.0,0.0,-7600.0
roetw101,Wally Roettger,St. Louis Cardinals,CARDS,2,2,3,5,1930,1932,2,-0.8,1.35,2.15,139,115,-24,481,352,-129,0.0,0.0,0.0,0.0,4000.0,4000.0
roetw101,Wally Roettger,Cincinnati Reds,REDS,1,1,1,2,1931,1933,2,-0.24,-0.27,-0.03,45,192,147,169,798,629,0.0,0.0,0.0,0.0,0.0,0.0
roetw101,Wally Roettger,Cincinnati Reds,REDS,1,2,2,4,1933,1935,2,11.2,-0.59,-11.79,432,112,-320,556,459,-97,2051.0,0.0,-2051.0,0.0,0.0,0.0
rogeb001,Brian Rogers,Detroit Tigers,TIGRS,1,1,1,2,2006,2007,1,-0.33,-0.09,0.24,26,196,170,0,692,692,32.0,0.0,-32.0,0.0,8500000.0,8500000.0
rogeb102,Billy Rogell,Boston Red Sox,RSOX,1,2,2,4,1928,1928,0,0.0,0.0,0.0,0,0,0,0,0,0,0.0,0.0,0.0,3000.0,0.0,-3000.0
rogeb102,Billy Rogell,Detroit Tigers,TIGRS,1,1,1,2,1939,1941,2,-0.57,-0.5,0.07,33,144,111,63,635,572,0.0,0.0,0.0,11000.0,20500.0,9500.0
rogee002,Esmil Rogers,Cleveland Indians,INDINS,2,2,5,7,2012,2020,8,4.29,11.72,7.43,256,955,699,719,3396,2677,475.0,140.0,-335.0,6514333.0,0.0,-6514333.0
rogej002,Jason Rogers,Milwaukee Brewers,BREWRS,3,4,6,10,2015,2021,6,-0.63,4.1,4.73,57,272,215,86,796,710,0.0,7.0,7.0,507500.0,581200.0,73700.0
rogej003,Josh Rogers,New York Yankees,YANKS,1,3,1,4,2018,2019,1,-0.19,2.71,2.9,121,97,-24,0,0,0,451.0,259.0,-192.0,0.0,12000000.0,12000000.0
rogej004,Jake Rogers,Houston Astros,ASTROS,1,3,3,6,2017,2021,4,-0.1,16.16,16.26,126,77,-49,429,7,-422,3.0,1431.0,1428.0,0.0,0.0,0.0
rogej102,Jim Rogers,Washington Senators,WSN,1,3,1,4,1896,1897,1,-1.24,0.18,1.42,153,159,6,636,662,26,0.0,0.0,0.0,0.0,0.0,0.0
rogek001,Kenny Rogers,New York Yankees,YANKS,1,2,1,3,1997,2001,4,9.23,8.3,-0.93,56,540,484,7,2129,2122,1074.0,0.0,-1074.0,5000000.0,2550000.0,-2450000.0
rogek001,Kenny Rogers,Oakland Athletics,ATLTCS,3,4,5,9,1999,2012,13,8.62,14.48,5.86,458,1147,689,1512,4567,3055,228.0,206.0,-22.0,9062500.0,4650000.0,-4412500.0
rogel101,Lee Rogers,Boston Red Sox,RSOX,1,1,1,2,1938,1939,1,-0.08,0.0,0.08,26,0,-26,4,0,-4,71.0,0.0,-71.0,0.0,0.0,0.0
rogos101,Saul Rogovin,Detroit Tigers,TIGRS,12,27,25,52,1951,1961,10,27.97,16.36,-11.61,2275,2285,10,4156,6502,2346,7305.0,2805.0,-4500.0,45200.0,43000.0,-2200.0
rogos101,Saul Rogovin,Chicago White Sox,WSOX,1,3,1,4,1953,1955,2,0.0,-0.06,-0.06,1,69,68,1,138,137,0.0,0.0,0.0,0.0,0.0,0.0
rohdd001,Dave Rohde,Houston Astros,ASTROS,2,3,4,7,1991,1995,4,53.38,-0.45,-53.83,1975,315,-1660,8100,672,-7428,0.0,285.0,285.0,375000.0,100000.0,-275000.0
rohnd001,Dan Rohn,Chicago Cubs,CUBS,1,1,1,2,1985,1987,2,-0.05,-0.27,-0.22,6,158,152,11,16,5,0.0,405.0,405.0,0.0,0.0,0.0
rohnd001,Dan Rohn,Chicago Cubs,CUBS,1,2,3,5,1987,1987,0,15.94,0.0,-15.94,542,0,-542,0,0,0,1911.0,0.0,-1911.0,0.0,0.0,0.0
rohrb101,Billy Rohr,Cleveland Indians,INDINS,1,2,1,3,1970,1970,0,-0.16,-0.64,-0.48,28,86,58,38,9,-29,0.0,173.0,173.0,8070.0,0.0,-8070.0
rohwr101,Ray Rohwer,Pittsburgh Pirates,PIRATS,1,3,1,4,1922,1927,5,0.0,-0.21,-0.21,0,25,25,0,62,62,0.0,0.0,0.0,3600.0,0.0,-3600.0
rojac101,Cookie Rojas,Cincinnati Reds,REDS,1,1,1,2,1962,1963,1,3.63,-0.74,-4.37,881,38,-843,3369,8,-3361,3.0,127.0,124.0,0.0,0.0,0.0
rojac101,Cookie Rojas,Philadelphia Phillies,PHILS,5,9,11,20,1969,1977,8,2.27,5.62,3.35,374,740,366,889,1587,698,321.0,625.0,304.0,70000.0,163500.0,93500.0
rojac101,Cookie Rojas,St. Louis Cardinals,CARDS,2,3,2,5,1970,1972,2,7.18,0.65,-6.53,880,20,-860,3354,1,-3353,0.0,38.0,38.0,0.0,40000.0,40000.0
rojaj001,Josh Rojas,Houston Astros,ASTROS,1,4,2,6,2019,2021,2,-0.93,3.35,4.28,254,54,-200,791,4,-787,100.0,902.0,802.0,0.0,34500000.0,34500000.0
rojam001,Mel Rojas,Chicago Cubs,CUBS,2,4,4,8,1997,2001,4,3.27,3.1,-0.17,1097,717,-380,1379,2198,819,1191.0,830.0,-361.0,9308333.0,6555000.0,-2753333.0
rojam001,Mel Rojas,New York Mets,METS,1,1,1,2,1998,2000,2,-0.23,-1.41,-1.18,10,60,50,0,141,141,15.0,0.0,-15.0,4583333.0,0.0,-4583333.0
rojam001,Mel Rojas,Los Angeles Dodgers,DOGRS,1,2,3,5,1999,1999,0,0.03,-0.71,-0.74,81,18,-63,9,4,-5,1195.0,47.0,-1148.0,6833334.0,0.0,-6833334.0
rojam002,Miguel Rojas,Los Angeles Dodgers,DOGRS,4,7,8,15,2014,2020,6,27.35,10.53,-16.82,1361,1127,-234,4322,2916,-1406,2273.0,350.0,-1923.0,21765000.0,9877000.0,-11888000.0
rojes101,Stan Rojek,Pittsburgh Pirates,PIRATS,1,1,2,3,1951,1951,0,0.47,-0.43,-0.9,51,95,44,202,249,47,0.0,20.0,20.0,0.0,0.0,0.0
rojes101,Stan Rojek,St.Louis Browns,ORLS,16,41,37,78,1952,1988,36,52.13,131.97,79.84,3638,7667,4029,6759,21898,15139,14284.0,13293.0,-991.0,815833.0,128400.0,-687433.0
rolaj101,Jim Roland,New York Yankees,YANKS,1,1,1,2,1972,1973,1,-0.11,-0.07,0.04,10,11,1,0,1,1,10.0,44.0,34.0,0.0,22500.0,22500.0
roles001,Scott Rolen,Philadelphia Phillies,PHILS,2,4,5,9,2002,2005,3,45.06,10.26,-34.8,1293,547,-746,5556,1575,-3981,0.0,264.0,264.0,13200000.0,12025000.0,-1175000.0
roles001,Scott Rolen,St. Louis Cardinals,CARDS,1,1,1,2,2008,2009,1,7.36,4.21,-3.15,203,165,-38,840,669,-171,0.0,0.0,0.0,0.0,0.0,0.0
roles001,Scott Rolen,Toronto Blue Jays,BJAYS,3,7,9,16,2009,2014,5,6.88,8.45,1.57,726,615,-111,1387,2188,801,842.0,175.0,-667.0,19454600.0,19118000.0,-336600.0
rolld002,David Rollins,Toronto Blue Jays,BJAYS,4,12,6,18,2012,2016,4,10.83,2.99,-7.84,1068,309,-759,3494,605,-2889,904.0,1431.0,527.0,11237500.0,12316000.0,1078500.0
rollj001,Jimmy Rollins,Philadelphia Phillies,PHILS,1,2,2,4,2014,2014,0,0.44,0.0,-0.44,144,0,-144,563,0,-563,0.0,0.0,0.0,11000000.0,0.0,-11000000.0
romaj001,Jose Roman,Cleveland Indians,INDINS,1,1,1,2,1987,1987,0,0.0,0.0,0.0,0,0,0,0,0,0,0.0,0.0,0.0,0.0,0.0,0.0
romaj002,Jason Romano,Texas Rangers,RNGRS,1,3,2,5,2002,2002,0,0.5,-0.12,-0.62,97,54,-43,245,149,-96,0.0,127.0,127.0,1850000.0,3650000.0,1800000.0
romaj002,Jason Romano,Colorado Rockies,ROCKS,1,1,1,2,2003,2003,0,-0.74,0.0,0.74,37,2,-35,37,2,-35,0.0,0.0,0.0,0.0,0.0,0.0
romaj002,Jason Romano,Los Angeles Dodgers,DOGRS,2,3,2,5,2004,2017,13,0.93,22.74,21.81,176,1566,1390,597,5726,5129,0.0,0.0,0.0,2830000.0,0.0,-2830000.0
romaj003,Jamie Romak,Atlanta Braves,BRAVES,6,14,16,30,2007,2014,7,20.02,10.31,-9.71,2739,1550,-1189,4450,3506,-944,3035.0,1968.0,-1067.0,26080000.0,24455000.0,-1625000.0
romaj101,John Romano,Chicago White Sox,WSOX,5,8,10,18,1959,1969,10,11.6,14.81,3.21,1350,938,-412,4415,3667,-748,492.0,12.0,-480.0,77250.0,45000.0,-32250.0
romaj101,John Romano,Cleveland Indians,INDINS,3,5,5,10,1965,1968,3,40.72,5.22,-35.5,1111,420,-691,2880,1615,-1265,4479.0,0.0,-4479.0,0.0,25000.0,25000.0
romaj101,John Romano,Chicago White Sox,WSOX,3,4,4,8,1966,1976,10,0.79,1.71,0.92,129,790,661,442,2422,1980,0.0,142.0,142.0,83000.0,31500.0,-51500.0
romam001,Mike Romano,Toronto Blue Jays,BJAYS,1,1,1,2,2000,2000,0,0.0,0.0,0.0,0,0,0,0,0,0,0.0,0.0,0.0,0.0,0.0,0.0
romar001,Ron Romanick,California Angels,ANGELS,1,2,1,3,1986,1988,2,0.09,0.46,0.37,42,58,16,0,167,167,174.0,0.0,-174.0,425000.0,733333.0,308333.0
romat001,Tom Romano,Oakland Athletics,ATLTCS,1,1,1,2,1986,1986,0,-0.06,0.0,0.06,7,0,-7,3,0,-3,0.0,0.0,0.0,0.0,0.0,0.0
romee001,Ed Romero,Milwaukee Brewers,BREWRS,1,1,1,2,1985,1988,3,-3.59,3.24,6.83,265,142,-123,727,0,-727,0.0,543.0,543.0,290000.0,580000.0,290000.0
romee001,Ed Romero,Atlanta Braves,BRAVES,1,1,1,2,1989,1989,0,-0.38,0.03,0.41,15,16,1,50,1,-49,0.0,37.0,37.0,0.0,0.0,0.0
romee002,Enny Romero,Tampa Bay Devil Rays,RAYS,1,1,1,2,2017,2017,0,0.48,0.0,-0.48,107,0,-107,1,0,-1,173.0,0.0,-173.0,0.0,0.0,0.0
romej001,J.C. Romero,Minnesota Twins,TWINS,1,1,1,2,2005,2012,7,-0.95,3.58,4.53,71,515,444,0,1764,1764,145.0,0.0,-145.0,1250000.0,0.0,-1250000.0
romej001,J.C. Romero,Cleveland Indians,INDINS,1,1,1,2,2012,2012,0,-0.12,0.0,0.12,5,0,-5,0,0,0,12.0,0.0,-12.0,0.0,0.0,0.0
romej003,Jhon Romero,Chicago Cubs,CUBS,1,1,1,2,2018,2019,1,0.02,1.17,1.15,10,168,158,0,1,1,12.0,225.0,213.0,0.0,5000000.0,5000000.0
romem001,Mandy Romero,San Diego Padres,PADRS,4,8,7,15,1998,2002,4,4.23,0.82,-3.41,472,389,-83,1448,834,-614,139.0,215.0,76.0,3650000.0,3850000.0,200000.0
romem001,Mandy Romero,Boston Red Sox,RSOX,1,1,1,2,1999,1999,0,0.0,0.0,0.0,0,0,0,0,0,0,0.0,0.0,0.0,0.0,0.0,0.0
romer001,Ramon Romero,Cleveland Indians,INDINS,1,2,2,4,1986,1988,2,3.92,1.63,-2.29,86,69,-17,0,0,0,1168.0,825.0,-343.0,0.0,0.0,0.0
romia001,Andrew Romine,Anaheim Angels,ANGELS,2,2,2,4,2014,2019,5,1.94,2.53,0.59,576,355,-221,1018,1,-1017,204.0,896.0,692.0,1050000.0,1200000.0,150000.0
romoe101,Enrique Romo,Seattle Mariners,MARNRS,5,14,13,27,1978,1985,7,13.7,0.35,-13.35,1053,894,-159,693,2333,1640,4377.0,1863.0,-2514.0,175000.0,512500.0,337500.0
romos001,Sergio Romo,Los Angeles Dodgers,DOGRS,1,1,1,2,2017,2017,0,1.17,0.0,-1.17,105,0,-105,1,0,-1,294.0,0.0,-294.0,3000000.0,0.0,-3000000.0
romos001,Sergio Romo,Miami Marlins,MARLNS,1,3,1,4,2019,2019,0,0.34,0.0,-0.34,55,0,-55,0,0,0,128.0,0.0,-128.0,2500000.0,0.0,-2500000.0
romov101,Vicente Romo,Cleveland Indians,INDINS,1,3,3,6,1969,1970,1,13.72,3.96,-9.76,502,371,-131,436,691,255,3166.0,784.0,-2382.0,34500.0,0.0,-34500.0
romov101,Vicente Romo,Boston Red Sox,RSOX,1,2,2,4,1971,1971,0,2.81,0.28,-2.53,456,91,-365,786,331,-455,371.0,0.0,-371.0,0.0,0.0,0.0
romov101,Vicente Romo,Chicago White Sox,WSOX,3,4,3,7,1972,1976,4,-1.53,-0.31,1.22,214,295,81,44,1033,989,489.0,0.0,-489.0,27000.0,17000.0,-10000.0
ronam001,Marc Ronan,St. Louis Cardinals,CARDS,1,1,1,2,1995,1995,0,0.0,0.0,0.0,0,0,0,0,0,0,0.0,0.0,0.0,0.0,0.0,0.0
rondh101,Henri Rondeau,Minneapolis,Minneapolis,1,1,1,2,1915,1927,12,0.51,0.0,-0.51,64,0,-64,241,0,-241,0.0,0.0,0.0,0.0,0.0,0.0
rondj002,Jose Rondon,Anaheim Angels,ANGELS,2,6,4,10,2014,2017,3,-0.93,3.94,4.87,94,402,308,26,948,922,108.0,488.0,380.0,0.0,12000000.0,12000000.0
roofp101,Phil Roof,Milwaukee Braves,BRAVES,6,12,9,21,1964,1968,4,-1.26,1.32,2.58,659,529,-130,866,569,-297,775.0,799.0,24.0,15000.0,25000.0,10000.0
roofp101,Phil Roof,California Angels,ANGELS,1,1,2,3,1965,1965,0,-0.09,0.0,0.09,43,0,-43,61,0,-61,0.0,0.0,0.0,0.0,0.0,0.0
roofp101,Phil Roof,Cleveland Indians,INDINS,4,7,7,14,1965,1973,8,23.16,3.29,-19.87,1705,368,-1337,6211,949,-5262,0.0,78.0,78.0,7000.0,21500.0,14500.0
roofp101,Phil Roof,Oakland Athletics,ATLTCS,9,20,12,32,1970,1976,6,26.16,16.01,-10.15,3775,1399,-2376,8326,3903,-4423,4415.0,1098.0,-3317.0,340600.0,421500.0,80900.0
roofp101,Phil Roof,Milwaukee Brewers,BREWRS,2,3,3,6,1971,1972,1,2.17,-0.95,-3.12,264,87,-177,684,171,-513,0.0,0.0,0.0,14000.0,39000.0,25000.0
roofp101,Phil Roof,Chicago White Sox,WSOX,3,5,3,8,1976,1979,3,6.78,0.35,-6.43,404,42,-362,1180,0,-1180,453.0,375.0,-78.0,0.0,0.0,0.0
rookj101,Jim Rooker,Detroit Tigers,TIGRS,1,1,1,2,1968,1969,1,0.0,0.35,0.35,0,44,44,0,2,2,0.0,91.0,91.0,8000.0,0.0,-8000.0
rookj101,Jim Rooker,Kansas City Royals,ROYALS,1,1,1,2,1972,1974,2,17.06,0.82,-16.24,434,70,-364,496,0,-496,3953.0,542.0,-3411.0,0.0,0.0,0.0
roomr001,Rolando Roomes,Chicago Cubs,CUBS,2,2,2,4,1988,1990,2,1.03,-0.43,-1.46,449,141,-308,1109,427,-682,0.0,0.0,0.0,272500.0,75000.0,-197500.0
roonp101,Pat Rooney,Montreal Expos,NATEX,3,3,5,8,1983,1991,8,3.57,11.27,7.7,227,856,629,6,53,47,2384.0,1852.0,-532.0,0.0,1966667.0,1966667.0
ropej001,John Roper,Cincinnati Reds,REDS,5,11,7,18,1995,2010,15,11.19,26.95,15.76,438,1436,998,728,5040,4312,2595.0,2089.0,-506.0,13266667.0,6562778.0,-6703889.0
roquj101,Jorge Roque,St. Louis Cardinals,CARDS,1,1,1,2,1972,1974,2,-0.69,0.03,0.72,25,204,179,66,518,452,0.0,0.0,0.0,0.0,0.0,0.0
rosaa001,Adam Rosales,Cincinnati Reds,REDS,1,2,2,4,2010,2010,0,1.98,0.0,-1.98,268,0,-268,835,0,-835,0.0,0.0,0.0,0.0,0.0,0.0
rosaa001,Adam Rosales,Oakland Athletics,ATLTCS,1,1,1,2,2017,2017,0,-0.56,0.0,0.56,34,0,-34,89,0,-89,0.0,0.0,0.0,1250000.0,0.0,-1250000.0
rosaa003,Amed Rosario,New York Mets,METS,1,4,2,6,2021,2021,0,2.78,2.19,-0.59,209,149,-60,798,543,-255,0.0,161.0,161.0,0.0,0.0,0.0
rosab101,Buddy Rosar,New York Yankees,YANKS,1,2,2,4,1942,1946,4,14.72,6.82,-7.9,514,360,-154,2082,1425,-657,0.0,0.0,0.0,17500.0,6500.0,-11000.0
rosab101,Buddy Rosar,Cleveland Indians,INDINS,2,2,2,4,1945,1946,1,5.07,1.73,-3.34,490,184,-306,1872,669,-1203,0.0,0.0,0.0,13000.0,16800.0,3800.0
rosab101,Buddy Rosar,Philadelphia Athletics,ATLTCS,2,2,2,4,1949,1953,4,-0.27,0.54,0.81,107,313,206,323,1157,834,0.0,0.0,0.0,12000.0,0.0,-12000.0
rosac001,Carlos Rosa,Kansas City Royals,ROYALS,1,1,1,2,2010,2013,3,0.06,0.0,-0.06,44,0,-44,0,0,0,60.0,0.0,-60.0,0.0,0.0,0.0
rosae001,Eddie Rosario,Cleveland Indians,INDINS,1,2,1,3,2021,2021,0,0.51,0.0,-0.51,33,0,-33,106,0,-106,0.0,0.0,0.0,8000000.0,1000000.0,-7000000.0
rosal001,Leo Rosales,San Diego Padres,PADRS,9,21,17,38,2007,2021,14,21.52,23.86,2.34,2094,1770,-324,3969,4930,961,2913.0,702.0,-2211.0,11240300.0,1204000.0,-10036300.0
rosal101,Luis Rosado,Baltimore Orioles,ORLS,1,1,1,2,1985,1986,1,0.0,0.0,0.0,0,0,0,0,0,0,0.0,0.0,0.0,0.0,0.0,0.0
rosam001,Melvin Rosario,San Diego Padres,PADRS,1,1,1,2,1996,1996,0,-0.14,0.0,0.14,4,0,-4,3,0,-3,0.0,0.0,0.0,0.0,0.0,0.0
rosas001,Sandy Rosario,Boston Red Sox,RSOX,1,1,1,2,2012,2013,1,0.0,0.0,0.0,0,0,0,0,0,0,0.0,0.0,0.0,0.0,480000.0,480000.0
rosav001,Victor Rosario,Boston Red Sox,RSOX,1,1,1,2,1988,1988,0,0.0,-0.61,-0.61,0,9,9,0,0,0,0.0,48.0,48.0,0.0,0.0,0.0
rosav001,Victor Rosario,Montreal Expos,NATEX,1,1,1,2,1989,1989,0,0.0,0.0,0.0,0,0,0,0,0,0,0.0,0.0,0.0,0.0,0.0,0.0
rosav001,Victor Rosario,Philadelphia Phillies,PHILS,1,3,2,5,1990,1996,6,0.28,7.71,7.43,106,447,341,38,1122,1084,145.0,1741.0,1596.0,750000.0,2100000.0,1350000.0
rosav001,Victor Rosario,Atlanta Braves,BRAVES,2,2,2,4,1991,1991,0,-0.64,-0.06,0.58,13,20,7,0,5,5,67.0,73.0,6.0,0.0,650000.0,650000.0
roseb002,Brian Rose,Boston Red Sox,RSOX,2,5,5,10,2000,2002,2,0.87,1.83,0.96,125,248,123,134,537,403,371.0,782.0,411.0,3375000.0,6575000.0,3200000.0
roseb002,Brian Rose,Colorado Rockies,ROCKS,4,6,6,12,2001,2002,1,3.66,0.31,-3.35,530,189,-341,64,5,-59,933.0,301.0,-632.0,0.0,0.0,0.0
rosed101,Dave Rosello,Chicago Cubs,CUBS,1,1,2,3,1977,1977,0,-0.15,0.0,0.15,173,0,-173,361,0,-361,0.0,0.0,0.0,0.0,0.0,0.0
rosed102,Don Rose,New York Mets,METS,1,4,1,5,1971,1973,2,45.16,0.14,-45.02,957,146,-811,2120,526,-1594,6672.0,0.0,-6672.0,45950.0,80000.0,34050.0
rosed102,Don Rose,California Angels,ANGELS,3,7,5,12,1973,1990,17,42.82,58.13,15.31,1088,2050,962,2703,8018,5315,7556.0,2386.0,-5170.0,175000.0,50000.0,-125000.0
roseg101,Goody Rosen,Cincinnati Reds,REDS,1,1,3,4,1944,1944,0,6.14,-0.35,-6.49,237,4,-233,969,0,-969,0.0,5.0,5.0,0.0,0.0,0.0
roseh101,Harry Rosenberg,New York Giants,GIANTS,1,4,1,5,1931,1931,0,0.0,0.0,0.0,0,0,0,0,0,0,0.0,0.0,0.0,0.0,0.0,0.0
rosej101,John Roseboro,Los Angeles Dodgers,DOGRS,1,3,2,5,1967,1968,1,7.85,0.27,-7.58,924,202,-722,948,467,-481,1656.0,285.0,-1371.0,122000.0,73000.0,-49000.0
rosel101,Larry Rosenthal,Cleveland Indians,INDINS,1,1,1,2,1942,1946,4,-0.23,0.66,0.89,36,89,53,120,246,126,0.0,0.0,0.0,0.0,0.0,0.0
rosep001,Pete Rose,Montreal Expos,NATEX,2,2,2,4,1984,1985,1,0.38,0.14,-0.24,383,29,-354,1097,34,-1063,0.0,145.0,145.0,700000.0,0.0,-700000.0
rosep002,Pete Rose,Baltimore Orioles,ORLS,3,4,3,7,1991,1996,5,0.29,-0.56,-0.85,94,84,-10,3,263,260,185.0,196.0,11.0,2934000.0,4250000.0,1316000.0
roses001,Steve Rosenberg,New York Yankees,YANKS,2,4,3,7,1987,1989,2,7.16,-1.48,-8.64,782,63,-719,2351,14,-2337,594.0,729.0,135.0,247000.0,1140000.0,893000.0
roses001,Steve Rosenberg,Chicago White Sox,WSOX,2,3,4,7,1991,1997,6,-0.66,5.47,6.13,79,723,644,105,2072,1967,199.0,133.0,-66.0,200000.0,0.0,-200000.0
roses001,Steve Rosenberg,San Diego Padres,PADRS,1,1,1,2,1991,1994,3,0.0,-0.75,-0.75,0,155,155,0,472,472,0.0,0.0,0.0,130000.0,0.0,-130000.0
roset001,Trevor Rosenthal,Kansas City Royals,ROYALS,1,1,2,3,2020,2020,0,0.64,-0.26,-0.9,10,18,8,0,65,65,30.0,0.0,-30.0,100000.0,0.0,-100000.0
rosis001,Seth Rosin,San Francisco Giants,GIANTS,1,3,1,4,2012,2018,6,-0.86,10.45,11.31,288,772,484,953,3095,2142,6.0,0.0,-6.0,1300000.0,10400000.0,9100000.0
rossb102,Buck Ross,Williamsport,Williamsport,1,1,1,2,1936,1936,0,1.07,0.0,-1.07,282,0,-282,328,0,-328,2600.0,0.0,-2600.0,0.0,0.0,0.0
rossb103,Buster Ross,Boston Red Sox,RSOX,1,3,1,4,1926,1926,0,0.0,-0.79,-0.79,0,31,31,0,103,103,0.0,0.0,0.0,7100.0,0.0,-7100.0
rossc001,Cody Ross,Detroit Tigers,TIGRS,2,2,2,4,2004,2005,1,0.28,-0.78,-1.06,22,59,37,40,0,-40,0.0,201.0,201.0,0.0,0.0,0.0
rossc001,Cody Ross,Los Angeles Dodgers,DOGRS,1,1,1,2,2006,2006,0,-0.15,0.0,0.15,2,0,-2,5,0,-5,0.0,0.0,0.0,327500.0,0.0,-327500.0
rossc101,Claude Rossman,Detroit Tigers,TIGRS,1,1,1,2,1909,1909,0,-0.1,0.92,1.02,2,44,42,8,165,157,0.0,0.0,0.0,0.0,0.0,0.0
rossd001,David Ross,Pittsburgh Pirates,PIRATS,1,1,1,2,2005,2006,1,0.15,0.16,0.01,11,13,2,19,30,11,0.0,0.0,0.0,338500.0,0.0,-338500.0
rossd001,David Ross,San Diego Padres,PADRS,1,1,1,2,2006,2006,0,2.33,0.0,-2.33,254,0,-254,817,0,-817,0.0,0.0,0.0,0.0,0.0,0.0
rossd101,Don Ross,Detroit Tigers,TIGRS,1,2,1,3,1945,1947,2,5.36,14.82,9.46,363,401,38,1392,1659,267,0.0,0.0,0.0,0.0,9500.0,9500.0
rossg102,Gary Ross,Chicago Cubs,CUBS,3,6,4,10,1969,1974,5,4.19,2.65,-1.54,1200,512,-688,1393,950,-443,2550.0,898.0,-1652.0,19000.0,24000.0,5000.0
rossg102,Gary Ross,San Diego Padres,PADRS,3,4,4,8,1975,1977,2,2.16,3.04,0.88,264,315,51,280,677,397,1033.0,0.0,-1033.0,0.0,95000.0,95000.0
rossj002,Joe Ross,San Diego Padres,PADRS,3,7,6,13,2014,2020,6,27.39,-1.48,-28.87,938,146,-792,3307,301,-3006,1330.0,78.0,-1252.0,506400.0,7390000.0,6883600.0
rossj101,Joe Rossi,Cincinnati Reds,REDS,1,3,1,4,1952,1961,9,1.64,13.15,11.51,150,1235,1085,601,5109,4508,0.0,0.0,0.0,0.0,10500.0,10500.0
rossr001,Rico Rossy,Baltimore Orioles,ORLS,1,2,1,3,1987,1992,5,0.0,8.01,8.01,0,632,632,0,2276,2276,0.0,0.0,0.0,0.0,0.0,0.0
rossr001,Rico Rossy,Pittsburgh Pirates,PIRATS,1,1,1,2,1990,1992,2,-0.04,0.0,0.04,5,0,-5,1,0,-1,0.0,0.0,0.0,0.0,0.0,0.0
rossr001,Rico Rossy,Atlanta Braves,BRAVES,1,1,1,2,1991,1991,0,1.07,0.0,-1.07,105,0,-105,275,0,-275,0.0,0.0,0.0,0.0,0.0,0.0
rossr002,Robbie Ross,Texas Rangers,RNGRS,2,2,2,4,2015,2016,1,0.78,-0.8,-1.58,135,7,-128,3,2,-1,458.0,57.0,-401.0,0.0,0.0,0.0
rosst001,Tyson Ross,Oakland Athletics,ATLTCS,1,2,2,4,2012,2014,2,8.33,-0.72,-9.05,240,35,-205,210,87,-123,1936.0,0.0,-1936.0,0.0,481000.0,481000.0
rossz001,Zac Rosscup,Tampa Bay Devil Rays,RAYS,3,5,10,15,2011,2018,7,7.14,19.57,12.43,511,809,298,692,1746,1054,1779.0,3357.0,1578.0,0.0,556500.0,556500.0
rossz001,Zac Rosscup,Chicago Cubs,CUBS,1,1,1,2,2017,2017,0,0.07,0.0,-0.07,24,0,-24,0,0,0,30.0,0.0,-30.0,0.0,0.0,0.0
rotbm101,Marv Rotblatt,Chicago White Sox,WSOX,3,10,4,14,1951,1953,2,2.36,0.32,-2.04,404,226,-178,236,372,136,2232.0,741.0,-1491.0,0.0,0.0,0.0
rothb102,Braggo Roth,Chicago White Sox,WSOX,1,4,1,5,1915,1915,0,12.78,0.79,-11.99,588,45,-543,1793,193,-1600,1219.0,0.0,-1219.0,0.0,0.0,0.0
rothb102,Braggo Roth,Cleveland Indians,INDINS,1,2,3,5,1919,1932,13,1.85,28.0,26.15,48,1706,1658,214,7031,6817,0.0,678.0,678.0,0.0,0.0,0.0
rothb102,Braggo Roth,Philadelphia Athletics,ATLTCS,1,2,2,4,1919,1920,1,0.98,0.04,-0.94,143,118,-25,582,462,-120,0.0,0.0,0.0,2400.0,0.0,-2400.0
rothb102,Braggo Roth,Boston Red Sox,RSOX,12,23,27,50,1919,1937,18,88.36,56.94,-31.42,3577,3010,-567,9223,10199,976,11819.0,5427.0,-6392.0,73300.0,54000.0,-19300.0
rothb102,Braggo Roth,Washington Senators,TWINS,2,3,3,6,1920,1926,6,2.6,17.64,15.04,206,362,156,681,558,-123,46.0,3052.0,3006.0,8600.0,11500.0,2900.0
rothf101,Frank Roth,Milwaukee,Milwaukee,1,1,2,3,1909,1909,0,-0.12,0.0,0.12,82,0,-82,193,0,-193,0.0,0.0,0.0,0.0,0.0,0.0
rothf101,Frank Roth,St.Louis Browns,ORLS,2,2,3,5,1906,1907,1,-1.04,4.12,5.16,52,188,136,153,695,542,0.0,0.0,0.0,0.0,0.0,0.0
rothf101,Frank Roth,Indianapolis,Indianapolis,1,1,2,3,1905,1913,8,0.06,0.0,-0.06,35,0,-35,115,0,-115,0.0,0.0,0.0,0.0,0.0,0.0
rothf101,Frank Roth,Philadelphia Phillies,PHILS,1,2,1,3,1905,1905,0,0.0,0.2,0.2,0,16,16,0,52,52,0.0,0.0,0.0,0.0,0.0,0.0
rothj101,Jack Rothrock,Boston Red Sox,RSOX,4,10,7,17,1932,1937,5,13.6,8.5,-5.1,544,1121,577,1112,4164,3052,1631.0,0.0,-1631.0,49250.0,42500.0,-6750.0
rothj101,Jack Rothrock,Chicago White Sox,WSOX,1,2,1,3,1932,1932,0,1.87,0.41,-1.46,283,14,-269,1288,61,-1227,0.0,0.0,0.0,5000.0,0.0,-5000.0
rottv001,Vinny Rottino,Milwaukee Brewers,BREWRS,1,1,1,2,2009,2010,1,0.0,0.64,0.64,0,89,89,0,3,3,0.0,150.0,150.0,0.0,400000.0,400000.0
rouse101,Edd Roush,New York Giants,GIANTS,3,6,6,12,1916,1923,7,51.71,19.99,-31.72,1982,727,-1255,7625,1751,-5874,2062.0,3773.0,1711.0,15800.0,9600.0,-6200.0
rouse101,Edd Roush,Cincinnati Reds,REDS,1,1,2,3,1927,1930,3,2.72,3.25,0.53,301,375,74,1302,1523,221,0.0,0.0,0.0,0.0,0.0,0.0
rousm001,Mike Rouse,Toronto Blue Jays,BJAYS,1,2,1,3,2002,2003,1,0.04,0.58,0.54,8,33,25,26,6,-20,0.0,578.0,578.0,0.0,2550000.0,2550000.0
rousm001,Mike Rouse,Chicago White Sox,WSOX,1,1,1,2,2008,2008,0,0.0,0.0,0.0,0,0,0,0,0,0,0.0,0.0,0.0,0.0,0.0,0.0
rowaa001,Aaron Rowand,Chicago White Sox,WSOX,2,5,3,8,2005,2009,4,5.6,12.08,6.48,287,529,242,1146,2165,1019,0.0,0.0,0.0,15000000.0,13166667.0,-1833333.0
rowaj101,Jack Rowan,Cincinnati Reds,REDS,2,6,5,11,1910,1914,4,23.79,7.43,-16.36,1495,715,-780,6220,2571,-3649,283.0,231.0,-52.0,0.0,0.0,0.0
rowaj101,Jack Rowan,Philadelphia Phillies,PHILS,1,1,1,2,1911,1912,1,-0.25,0.3,0.55,2,36,34,1,32,31,6.0,285.0,279.0,0.0,0.0,0.0
rowdw001,Wade Rowdon,Chicago White Sox,WSOX,1,2,1,3,1982,1984,2,-0.41,-0.13,0.28,101,14,-87,177,0,-177,0.0,86.0,86.0,0.0,0.0,0.0
rowdw001,Wade Rowdon,Cincinnati Reds,REDS,1,1,1,2,1987,1988,1,-0.21,1.39,1.6,11,72,61,34,48,14,0.0,476.0,476.0,0.0,0.0,0.0
rowdw001,Wade Rowdon,Chicago Cubs,CUBS,1,1,2,3,1988,1988,0,-0.57,0.0,0.57,20,0,-20,30,0,-30,0.0,0.0,0.0,0.0,0.0,0.0
roweb001,Ben Rowen,Los Angeles Dodgers,DOGRS,1,2,3,5,2015,2015,0,0.0,0.0,0.0,0,0,0,0,0,0,0.0,0.0,0.0,0.0,0.0,0.0
roweb101,Bama Rowell,Boston Braves,BRAVES,4,15,8,23,1948,1960,12,49.35,41.77,-7.58,2025,1769,-256,7279,7265,-14,2138.0,0.0,-2138.0,0.0,42000.0,42000.0
rowlr001,Rich Rowland,Detroit Tigers,TIGRS,7,15,18,33,1994,2010,16,12.99,23.4,10.41,4921,1754,-3167,12902,3237,-9665,4562.0,6757.0,2195.0,12079000.0,5630000.0,-6449000.0
roy-l101,Luther Roy,Philadelphia Phillies,PHILS,1,1,1,2,1929,1937,8,0.03,0.08,0.05,4,56,52,1,46,45,11.0,373.0,362.0,4500.0,5500.0,1000.0
royes001,Stan Royer,Oakland Athletics,ATLTCS,1,3,1,4,1990,1990,0,4.87,0.81,-4.06,395,29,-366,1429,123,-1306,0.0,0.0,0.0,102500.0,1500000.0,1397500.0
roysj001,Jerry Royster,Los Angeles Dodgers,DOGRS,1,4,2,6,1975,1984,9,-0.88,19.14,20.02,1504,1261,-243,5163,4749,-414,0.0,0.0,0.0,0.0,0.0,0.0
roysj001,Jerry Royster,Chicago White Sox,WSOX,2,4,3,7,1987,1993,6,58.18,-1.05,-59.23,1893,402,-1491,7947,1106,-6841,125.0,649.0,524.0,260000.0,0.0,-260000.0
rozed101,Dick Rozek,Cleveland Indians,INDINS,1,2,1,3,1952,1955,3,0.19,-0.65,-0.84,8,120,112,3,17,14,36.0,312.0,276.0,0.0,10000.0,10000.0
roznv101,Vic Roznovsky,Chicago Cubs,CUBS,1,1,1,2,1966,1966,0,-0.4,-0.09,0.31,86,16,-70,210,22,-188,0.0,0.0,0.0,0.0,0.0,0.0
roznv101,Vic Roznovsky,Baltimore Orioles,ORLS,1,1,2,3,1969,1970,1,-0.07,0.0,0.07,13,0,-13,14,0,-14,0.0,0.0,0.0,0.0,0.0,0.0
ruanw001,Wilkin Ruan,Montreal Expos,NATEX,4,7,10,17,2002,2004,2,14.79,-4.81,-19.6,572,445,-127,87,268,181,2398.0,643.0,-1755.0,370000.0,0.0,-370000.0
rubes101,Sonny Ruberto,St. Louis Cardinals,CARDS,3,5,4,9,1969,1972,3,0.79,1.88,1.09,125,189,64,357,73,-284,0.0,264.0,264.0,10000.0,7500.0,-2500.0
rubij101,Jorge Rubio,California Angels,ANGELS,3,4,4,8,1967,1971,4,-0.47,-0.05,0.42,214,297,83,361,652,291,251.0,492.0,241.0,20000.0,26500.0,6500.0
rubla101,Art Ruble,Philadelphia Phillies,PHILS,1,3,2,5,1934,1941,7,-1.11,22.67,23.78,139,911,772,269,2270,2001,324.0,2379.0,2055.0,0.0,0.0,0.0
rubla101,Art Ruble,Cincinnati Reds,REDS,1,2,1,3,1934,1934,0,0.0,1.09,1.09,0,99,99,0,387,387,0.0,0.0,0.0,0.0,0.0,0.0
ruckd001,Dave Rucker,Detroit Tigers,TIGRS,1,1,1,2,1983,1985,2,1.7,-0.91,-2.61,168,97,-71,11,0,-11,330.0,595.0,265.0,0.0,450000.0,450000.0
ruckd001,Dave Rucker,St. Louis Cardinals,CARDS,1,1,2,3,1985,1985,0,-0.15,-0.41,-0.26,118,159,41,15,87,72,313.0,193.0,-120.0,0.0,0.0,0.0
rudij101,Joe Rudi,Cleveland Indians,INDINS,4,7,7,14,1965,1973,8,23.16,3.29,-19.87,1705,368,-1337,6211,949,-5262,0.0,78.0,78.0,7000.0,21500.0,14500.0
rudij101,Joe Rudi,California Angels,ANGELS,1,3,2,5,1981,1984,3,0.12,12.81,12.69,77,526,449,135,1947,1812,448.0,774.0,326.0,0.0,0.0,0.0
rudod101,Dick Rudolph,Toronto,Toronto,1,1,2,3,1913,1913,0,23.58,0.0,-23.58,555,0,-555,778,0,-778,6096.0,0.0,-6096.0,0.0,2400.0,2400.0
rudod103,Don Rudolph,Chicago White Sox,WSOX,1,2,1,3,1959,1959,0,0.02,-0.82,-0.84,10,26,16,1,100,99,22.0,0.0,-22.0,10500.0,0.0,-10500.0
rudod103,Don Rudolph,Cleveland Indians,INDINS,1,2,1,3,1962,1962,0,3.15,-0.76,-3.91,294,75,-219,163,225,62,1590.0,0.0,-1590.0,0.0,0.0,0.0
rudok101,Ken Rudolph,Chicago Cubs,CUBS,1,1,1,2,1974,1974,0,0.14,0.0,-0.14,68,0,-68,197,0,-197,0.0,0.0,0.0,0.0,0.0,0.0
rudok101,Ken Rudolph,San Francisco Giants,GIANTS,1,2,1,3,1974,1980,6,-1.06,2.57,3.63,99,431,332,142,1370,1228,82.0,0.0,-82.0,0.0,0.0,0.0
ruelm101,Muddy Ruel,New York Yankees,YANKS,4,8,10,18,1920,1931,11,18.87,48.71,29.84,1297,1673,376,4337,4022,-315,1020.0,6917.0,5897.0,44500.0,41500.0,-3000.0
ruelm101,Muddy Ruel,Boston Red Sox,RSOX,5,7,7,14,1923,1929,6,20.64,17.92,-2.72,1225,1357,132,3718,5420,1702,990.0,0.0,-990.0,10750.0,13700.0,2950.0
ruelm101,Muddy Ruel,Boston Red Sox,RSOX,1,1,1,2,1931,1933,2,-0.44,3.49,3.93,65,216,151,211,840,629,0.0,0.0,0.0,10000.0,12500.0,2500.0
ruetd101,Dutch Ruether,Cincinnati Reds,REDS,2,3,2,5,1920,1922,2,11.63,2.48,-9.15,717,80,-637,1324,100,-1224,4403.0,797.0,-3606.0,7500.0,0.0,-7500.0
ruetd101,Dutch Ruether,Washington Senators,TWINS,2,3,3,6,1926,1931,5,3.59,10.98,7.39,317,349,32,724,316,-408,1075.0,1748.0,673.0,23500.0,10000.0,-13500.0
ruetk001,Kirk Rueter,Montreal Expos,NATEX,1,2,1,3,1996,1996,0,12.18,0.67,-11.51,598,24,-574,619,29,-590,4901.0,209.0,-4692.0,860000.0,1850000.0,990000.0
ruf-d001,Darin Ruf,Philadelphia Phillies,PHILS,3,5,5,10,2016,2018,2,3.05,1.06,-1.99,238,68,-170,808,210,-598,0.0,0.0,0.0,10527000.0,13400000.0,2873000.0
rufer101,Rudy Rufer,Cincinnati Reds,REDS,2,5,2,7,1952,1961,9,1.64,13.96,12.32,150,1306,1156,601,5286,4685,0.0,0.0,0.0,0.0,20000.0,20000.0
ruffb001,Bruce Ruffin,Philadelphia Phillies,PHILS,2,2,2,4,1991,1992,1,-1.01,-1.02,-0.01,65,78,13,131,153,22,174.0,66.0,-108.0,375000.0,0.0,-375000.0
ruffc001,Chance Ruffin,Detroit Tigers,TIGRS,7,12,11,23,2011,2021,10,17.56,10.21,-7.35,1262,701,-561,1311,661,-650,4444.0,2831.0,-1613.0,16933000.0,8359750.0,-8573250.0
ruffj001,Johnny Ruffin,Chicago White Sox,WSOX,1,2,1,3,1993,1993,0,1.84,0.47,-1.37,262,12,-250,17,0,-17,550.0,215.0,-335.0,0.0,3825000.0,3825000.0
ruffr101,Red Ruffing,Danville,Danville,1,1,1,2,1923,1923,0,12.63,0.0,-12.63,426,0,-426,469,0,-469,3359.0,0.0,-3359.0,0.0,0.0,0.0
ruffr101,Red Ruffing,Boston Red Sox,RSOX,1,1,2,3,1930,1930,0,56.84,-0.48,-57.32,1057,102,-955,1589,330,-1259,9506.0,0.0,-9506.0,6750.0,6000.0,-750.0
ruggj001,Justin Ruggiano,Los Angeles Dodgers,DOGRS,1,3,3,6,2006,2007,1,1.99,-0.07,-2.06,586,130,-456,1881,113,-1768,426.0,593.0,167.0,682000.0,4200000.0,3518000.0
ruggj001,Justin Ruggiano,Houston Astros,ASTROS,1,1,1,2,2012,2012,0,2.67,0.0,-2.67,219,0,-219,792,0,-792,0.0,0.0,0.0,0.0,0.0,0.0
ruggj001,Justin Ruggiano,Miami Marlins,MARLNS,1,1,1,2,2013,2014,1,-0.37,0.0,0.37,81,0,-81,250,0,-250,0.0,0.0,0.0,494500.0,0.0,-494500.0
ruggj001,Justin Ruggiano,Chicago Cubs,CUBS,1,1,1,2,2014,2014,0,-0.53,0.0,0.53,36,0,-36,81,0,-81,0.0,0.0,0.0,2000000.0,0.0,-2000000.0
ruggj001,Justin Ruggiano,Seattle Mariners,MARNRS,1,2,1,3,2015,2015,0,0.64,0.0,-0.64,21,0,-21,60,0,-60,0.0,0.0,0.0,2505000.0,0.0,-2505000.0
ruizc001,Carlos Ruiz,Philadelphia Phillies,PHILS,2,3,4,7,2016,2017,1,0.23,0.19,-0.04,14,11,-3,40,35,-5,0.0,0.0,0.0,0.0,0.0,0.0
ruizc001,Carlos Ruiz,Los Angeles Dodgers,DOGRS,2,2,2,4,2016,2017,1,-0.05,0.0,0.05,67,0,-67,146,0,-146,47.0,0.0,-47.0,8500000.0,532900.0,-7967100.0
ruizc102,Chico Ruiz,Cincinnati Reds,REDS,9,11,14,25,1969,1988,19,6.47,49.11,42.64,1174,3400,2226,3915,6767,2852,279.0,5781.0,5502.0,18500.0,0.0,-18500.0
ruizk001,Keibert Ruiz,Los Angeles Dodgers,DOGRS,1,4,2,6,2021,2021,0,0.24,4.89,4.65,47,74,27,110,252,142,188.0,205.0,17.0,0.0,47503480.0,47503480.0
ruizr002,Rio Ruiz,Houston Astros,ASTROS,2,4,3,7,2015,2018,3,4.87,5.33,0.46,316,563,247,420,1880,1460,2027.0,215.0,-1812.0,0.0,0.0,0.0
rullj101,Joe Rullo,Philadelphia Athletics,ATLTCS,1,5,1,6,1944,1946,2,0.0,1.19,1.19,0,162,162,0,669,669,0.0,0.0,0.0,3000.0,0.0,-3000.0
rumbn001,Nick Rumbelow,New York Yankees,YANKS,2,2,4,6,2017,2019,2,-0.4,0.67,1.07,16,44,28,0,197,197,57.0,0.0,-57.0,0.0,0.0,0.0
rumlw101,William Rumler,LittleRock,LittleRock,1,1,3,4,1916,1916,0,0.66,0.0,-0.66,105,0,-105,140,0,-140,0.0,0.0,0.0,0.0,4200.0,4200.0
rumlw101,William Rumler,St.Louis Browns,ORLS,1,4,2,6,1915,1924,9,0.0,-0.32,-0.32,0,2,2,0,1,1,0.0,10.0,10.0,0.0,0.0,0.0
rundr001,Rich Rundles,Boston Red Sox,RSOX,1,2,1,3,2001,2002,1,9.01,2.21,-6.8,198,82,-116,193,0,-193,1755.0,240.0,-1515.0,225000.0,4200000.0,3975000.0
runnp101,Pete Runnels,Washington Senators,TWINS,3,4,5,9,1958,1966,8,19.19,5.56,-13.63,1091,1232,141,3807,4135,328,0.0,0.0,0.0,15000.0,0.0,-15000.0
runnp101,Pete Runnels,Boston Red Sox,RSOX,1,1,1,2,1962,1962,0,0.46,0.0,-0.46,146,0,-146,508,0,-508,0.0,0.0,0.0,0.0,0.0,0.0
runys001,Sean Runyan,Houston Astros,ASTROS,2,2,2,4,1997,2000,3,-0.04,0.72,0.76,263,394,131,612,1149,537,0.0,6.0,6.0,0.0,0.0,0.0
rupej001,Josh Rupe,Chicago White Sox,WSOX,1,3,1,4,2003,2003,0,5.54,2.04,-3.5,375,73,-302,0,289,289,1248.0,0.0,-1248.0,0.0,9150000.0,9150000.0
ruscg001,Glendon Rusch,Kansas City Royals,ROYALS,1,1,1,2,1999,1999,0,2.31,-0.28,-2.59,126,4,-122,118,0,-118,1112.0,25.0,-1087.0,0.0,0.0,0.0
ruscg001,Glendon Rusch,New York Mets,METS,11,24,26,50,2002,2021,19,23.92,23.68,-0.24,974,1702,728,1624,4506,2882,6006.0,3554.0,-2452.0,30731467.0,4325000.0,-26406467.0
rushb101,Bob Rush,Chicago Cubs,CUBS,11,20,17,37,1957,1977,20,15.71,44.12,28.41,1386,3941,2555,1236,10815,9579,4659.0,6233.0,1574.0,122500.0,58000.0,-64500.0
rusia101,Amos Rusie,New York Giants,GIANTS,4,7,7,14,1900,1923,23,51.02,126.6,75.58,1988,2008,20,7634,3637,-3997,2128.0,18112.0,15984.0,15800.0,9600.0,-6200.0
rusks001,Scott Ruskin,Pittsburgh Pirates,PIRATS,1,3,1,4,1990,1994,4,13.0,10.16,-2.84,782,221,-561,2388,261,-2127,274.0,2055.0,1781.0,200000.0,860000.0,660000.0
rusks001,Scott Ruskin,Montreal Expos,NATEX,2,4,4,8,1991,2001,10,7.84,6.46,-1.38,825,557,-268,1993,412,-1581,539.0,721.0,182.0,287500.0,0.0,-287500.0
russa001,Adam Russell,Chicago White Sox,WSOX,6,14,12,26,2009,2018,9,7.16,22.73,15.57,991,1029,38,935,3763,2828,4825.0,1688.0,-3137.0,13340000.0,19075000.0,5735000.0
russa001,Adam Russell,San Diego Padres,PADRS,1,4,1,5,2010,2012,2,1.36,-1.01,-2.37,435,168,-267,53,716,663,1270.0,0.0,-1270.0,401300.0,4000000.0,3598700.0
russa002,Addison Russell,Oakland Athletics,ATLTCS,2,6,6,12,2014,2020,6,10.93,24.37,13.44,708,1106,398,2216,4232,2016,860.0,540.0,-320.0,5345000.0,500000.0,-4845000.0
russa101,Allen Russell,New York Yankees,YANKS,1,3,1,4,1919,1923,4,4.53,19.1,14.57,242,331,89,205,452,247,1664.0,3271.0,1607.0,4800.0,0.0,-4800.0
russa101,Allen Russell,Boston Red Sox,RSOX,5,7,7,14,1923,1929,6,20.64,17.92,-2.72,1225,1357,132,3718,5420,1702,990.0,0.0,-990.0,10750.0,13700.0,2950.0
russj001,Jeff Russell,Cincinnati Reds,REDS,2,3,2,5,1985,1988,3,10.64,5.16,-5.48,575,386,-189,438,1599,1161,2258.0,0.0,-2258.0,790909.0,0.0,-790909.0
russj001,Jeff Russell,Texas Rangers,RNGRS,2,5,3,8,1992,1996,4,8.49,4.09,-4.4,638,377,-261,2442,1627,-815,1191.0,3.0,-1188.0,15083333.0,7550000.0,-7533333.0
russj001,Jeff Russell,Boston Red Sox,RSOX,1,1,2,3,1994,1994,0,-0.01,-0.23,-0.22,13,19,6,0,0,0,38.0,165.0,127.0,2975000.0,1850000.0,-1125000.0
russj003,James Russell,Chicago Cubs,CUBS,2,5,6,11,2014,2021,7,0.58,0.03,-0.55,319,313,-6,628,721,93,572.0,456.0,-116.0,26275000.0,5250000.0,-21025000.0
russj102,Jim Russell,Pittsburgh Pirates,PIRATS,2,5,3,8,1947,1949,2,5.52,3.82,-1.7,394,236,-158,1349,883,-466,38.0,0.0,-38.0,0.0,0.0,0.0
russj102,Jim Russell,Boston Braves,BRAVES,1,3,1,4,1949,1949,0,0.73,0.0,-0.73,93,0,-93,264,0,-264,0.0,0.0,0.0,0.0,0.0,0.0
russj103,Jack Russell,Boston Red Sox,RSOX,1,1,1,2,1932,1946,14,1.94,-0.21,-2.15,36,22,-14,43,17,-26,339.0,138.0,-201.0,5500.0,4500.0,-1000.0
russj103,Jack Russell,Cleveland Indians,INDINS,1,2,1,3,1932,1932,0,3.72,0.0,-3.72,330,0,-330,151,0,-151,1373.0,0.0,-1373.0,0.0,0.0,0.0
russj103,Jack Russell,Washington Senators,TWINS,1,1,1,2,1936,1937,1,0.35,0.62,0.27,46,64,18,7,64,57,120.0,515.0,395.0,7000.0,5500.0,-1500.0
russr101,Rip Russell,Chicago Cubs,CUBS,1,1,2,3,1945,1949,4,-1.34,0.0,1.34,106,0,-106,357,0,-357,0.0,0.0,0.0,0.0,5000.0,5000.0
russr102,Reb Russell,Minneapolis,Minneapolis,1,1,2,3,1922,1928,6,4.2,0.0,-4.2,154,0,-154,568,0,-568,0.0,0.0,0.0,0.0,3000.0,3000.0
ruthd001,Dick Ruthven,Philadelphia Phillies,PHILS,1,3,2,5,1975,1979,4,0.71,0.93,0.22,442,215,-227,1620,199,-1421,0.0,1610.0,1610.0,0.0,0.0,0.0
ruthd001,Dick Ruthven,Chicago White Sox,WSOX,2,4,3,7,1975,1979,4,12.32,5.83,-6.49,561,668,107,1607,2532,925,1417.0,0.0,-1417.0,0.0,114500.0,114500.0
ruthd001,Dick Ruthven,Atlanta Braves,BRAVES,2,2,2,4,1978,1987,9,7.23,9.52,2.29,313,1116,803,332,94,-238,2784.0,2568.0,-216.0,851667.0,0.0,-851667.0
ruthd001,Dick Ruthven,Philadelphia Phillies,PHILS,4,8,7,15,1983,1989,6,22.89,10.28,-12.61,2046,1011,-1035,3682,3184,-498,3936.0,302.0,-3634.0,1629900.0,750000.0,-879900.0
rutlj001,Josh Rutledge,Colorado Rockies,ROCKS,1,1,1,2,2014,2018,4,0.0,0.51,0.51,0,48,48,0,0,0,0.0,72.0,72.0,501000.0,0.0,-501000.0
rutlj001,Josh Rutledge,Anaheim Angels,ANGELS,1,1,2,3,2015,2015,0,-0.13,-0.33,-0.2,104,38,-66,259,98,-161,0.0,0.0,0.0,0.0,13000000.0,13000000.0
ryanb001,B.J. Ryan,Cincinnati Reds,REDS,1,2,2,4,1999,1999,0,7.79,0.88,-6.91,427,24,-403,2,30,28,1138.0,232.0,-906.0,0.0,5250000.0,5250000.0
ryanb002,Brendan Ryan,St. Louis Cardinals,CARDS,1,1,1,2,2010,2013,3,7.49,-0.77,-8.26,351,26,-325,1251,3,-1248,0.0,47.0,47.0,425000.0,0.0,-425000.0
ryanb002,Brendan Ryan,Seattle Mariners,MARNRS,1,1,1,2,2013,2013,0,-0.3,0.0,0.3,114,0,-114,289,0,-289,6.0,0.0,-6.0,3250000.0,0.0,-3250000.0
ryanb002,Brendan Ryan,New York Yankees,YANKS,2,5,2,7,2015,2017,2,1.29,3.2,1.91,400,263,-137,1373,1083,-290,113.0,0.0,-113.0,12429743.0,21357143.0,8927400.0
ryanb002,Brendan Ryan,Washington Nationals,NATEX,1,1,1,2,2016,2016,0,-0.23,0.0,0.23,17,0,-17,14,0,-14,0.0,0.0,0.0,0.0,0.0,0.0
ryanb101,Blondy Ryan,Buffalo,Buffalo,1,1,2,3,1932,1937,5,2.15,0.0,-2.15,289,0,-289,1068,0,-1068,0.0,0.0,0.0,0.0,0.0,0.0
ryanb101,Blondy Ryan,New York Giants,GIANTS,3,12,5,17,1934,1949,15,8.76,66.74,57.98,1268,2382,1114,4502,9585,5083,296.0,0.0,-296.0,0.0,10500.0,10500.0
ryanb101,Blondy Ryan,Cleveland Indians,INDINS,1,1,1,2,1937,1937,0,0.11,0.0,-0.11,33,0,-33,108,0,-108,0.0,0.0,0.0,0.0,0.0,0.0
ryanb101,Blondy Ryan,New York Giants,GIANTS,1,2,1,3,1938,1938,0,0.0,0.62,0.62,0,38,38,0,155,155,0.0,0.0,0.0,0.0,0.0,0.0
ryanc102,Connie Ryan,New York Giants,GIANTS,1,2,1,3,1943,1947,4,7.61,8.14,0.53,725,472,-253,2750,1521,-1229,0.0,0.0,0.0,0.0,0.0,0.0
ryanc102,Connie Ryan,Boston Braves,BRAVES,1,1,1,2,1950,1954,4,2.86,8.65,5.79,243,366,123,987,1272,285,0.0,0.0,0.0,0.0,0.0,0.0
ryanc102,Connie Ryan,Cincinnati Reds,REDS,8,16,22,38,1951,1965,14,82.9,22.04,-60.86,4576,2061,-2515,14654,4760,-9894,2749.0,1025.0,-1724.0,63000.0,63000.0,0.0
ryanc102,Connie Ryan,Chicago White Sox,WSOX,1,3,1,4,1953,1955,2,0.0,-0.06,-0.06,1,69,68,1,138,137,0.0,0.0,0.0,0.0,0.0,0.0
ryanj001,Jason Ryan,Pittsburgh Pirates,PIRATS,1,1,1,2,2001,2006,5,0.0,0.0,0.0,0,0,0,0,0,0,0.0,0.0,0.0,0.0,0.0,0.0
ryanj001,Jason Ryan,Chicago Cubs,CUBS,2,3,3,6,1999,2001,2,5.9,3.0,-2.9,235,338,103,49,464,415,3132.0,564.0,-2568.0,0.0,8300000.0,8300000.0
ryanj002,Joe Ryan,Tampa Bay Devil Rays,RAYS,1,2,2,4,2021,2021,0,0.33,0.48,0.15,6,55,49,2,238,236,80.0,0.0,-80.0,0.0,13000000.0,13000000.0
ryanj102,Jack Ryan,Cleveland Indians,INDINS,1,3,1,4,1909,1911,2,-0.98,5.53,6.51,61,126,65,61,191,130,504.0,1513.0,1009.0,0.0,0.0,0.0
ryanj102,Jack Ryan,Boston Red Sox,RSOX,1,3,2,5,1909,1913,4,0.0,7.22,7.22,0,337,337,0,348,348,0.0,2273.0,2273.0,0.0,0.0,0.0
ryank001,Ken Ryan,Boston Red Sox,RSOX,2,4,5,9,1996,2011,15,0.04,46.15,46.11,391,2084,1693,170,5862,5692,732.0,3501.0,2769.0,2300000.0,0.0,-2300000.0
ryanm101,Mike Ryan,Boston Red Sox,RSOX,4,8,8,16,1967,1973,6,6.28,14.11,7.83,1485,781,-704,3661,1238,-2423,1155.0,3790.0,2635.0,41500.0,66500.0,25000.0
ryanm101,Mike Ryan,Philadelphia Phillies,PHILS,1,1,1,2,1974,1974,0,-0.29,0.0,0.29,15,0,-15,34,0,-34,0.0,0.0,0.0,0.0,0.0,0.0
ryann001,Nolan Ryan,New York Mets,METS,1,4,1,5,1971,1973,2,45.16,0.14,-45.02,957,146,-811,2120,526,-1594,6672.0,0.0,-6672.0,45950.0,80000.0,34050.0
ryanr001,Rob Ryan,Arizona Diamondbacks,DBACKS,1,1,1,2,2001,2001,0,-0.17,0.05,0.22,7,19,12,7,5,-2,0.0,0.0,0.0,0.0,267500.0,267500.0
ryanr101,Rosy Ryan,New York Giants,GIANTS,1,1,1,2,1925,1925,0,-2.55,0.0,2.55,89,0,-89,45,0,-45,425.0,0.0,-425.0,0.0,3300.0,3300.0
rybam101,Mike Ryba,St. Louis Cardinals,CARDS,1,1,1,2,1940,1954,14,5.58,20.12,14.54,369,888,519,211,466,255,1746.0,4131.0,2385.0,0.0,0.0,0.0
ryerg101,Gary Ryerson,San Francisco Giants,GIANTS,1,2,1,3,1971,1975,4,-1.59,-0.22,1.37,49,62,13,28,2,-26,375.0,100.0,-275.0,0.0,0.0,0.0
ryerg101,Gary Ryerson,Milwaukee Brewers,BREWRS,3,7,7,14,1973,1978,5,7.23,1.8,-5.43,546,209,-337,1533,327,-1206,524.0,1634.0,1110.0,168301.0,15000.0,-153301.0
ryu-j001,Jae Kuk Ryu,Chicago Cubs,CUBS,1,1,2,3,2007,2007,0,-0.22,0.0,0.22,18,0,-18,0,0,0,74.0,0.0,-74.0,0.0,0.0,0.0
rzepm001,Marc Rzepczynski,Toronto Blue Jays,BJAYS,1,4,4,8,2011,2014,3,0.4,6.43,6.03,344,416,72,89,1599,1510,547.0,15.0,-532.0,4329600.0,3193000.0,-1136600.0
rzepm001,Marc Rzepczynski,St. Louis Cardinals,CARDS,1,1,1,2,2013,2013,0,1.15,0.0,-1.15,161,0,-161,0,0,0,268.0,0.0,-268.0,0.0,0.0,0.0
rzepm001,Marc Rzepczynski,Cleveland Indians,INDINS,1,1,1,2,2015,2018,3,-0.8,1.78,2.58,54,187,133,0,585,585,44.0,0.0,-44.0,2400000.0,0.0,-2400000.0
rzepm001,Marc Rzepczynski,San Diego Padres,PADRS,4,5,8,13,2015,2021,6,6.15,2.58,-3.57,395,351,-44,906,448,-458,1057.0,739.0,-318.0,1650000.0,15068125.0,13418125.0
rzepm001,Marc Rzepczynski,Oakland Athletics,ATLTCS,2,4,2,6,2016,2017,1,0.09,0.0,-0.09,236,0,-236,527,0,-527,38.0,0.0,-38.0,0.0,1333333.0,1333333.0
saark001,Kirk Saarloos,Houston Astros,ASTROS,1,1,1,2,2004,2005,1,3.13,-0.76,-3.89,80,181,101,1,2,1,995.0,274.0,-721.0,0.0,307000.0,307000.0
saark001,Kirk Saarloos,Oakland Athletics,ATLTCS,1,2,2,4,2007,2007,0,-0.82,0.0,0.82,68,0,-68,6,0,-6,128.0,0.0,-128.0,0.0,0.0,0.0
sabac001,CC Sabathia,Cleveland Indians,INDINS,1,1,4,5,2008,2018,10,5.2,22.37,17.17,34,1354,1320,50,5551,5501,392.0,190.0,-202.0,11000000.0,0.0,-11000000.0
sabeb001,Bret Saberhagen,Kansas City Royals,ROYALS,4,6,8,14,1991,1997,6,19.59,4.26,-15.33,606,997,391,1939,3941,2002,1576.0,52.0,-1524.0,3507500.0,3066667.0,-440833.0
sabeb001,Bret Saberhagen,New York Mets,METS,9,15,15,30,1995,2006,11,21.84,19.97,-1.87,1441,1812,371,2084,2876,792,2476.0,2029.0,-447.0,21862990.0,15877333.0,-5985657.0
sader101,Ray Sadecki,St. Louis Cardinals,CARDS,8,10,10,20,1966,1978,12,24.42,39.07,14.65,2169,1711,-458,3342,6557,3215,5037.0,616.0,-4421.0,202000.0,45000.0,-157000.0
sader101,Ray Sadecki,San Francisco Giants,GIANTS,2,3,3,6,1969,1971,2,8.87,-0.91,-9.78,806,89,-717,1416,200,-1216,1801.0,0.0,-1801.0,0.0,13000.0,13000.0
sader101,Ray Sadecki,New York Mets,METS,1,2,1,3,1974,1977,3,0.04,1.83,1.79,36,254,218,2,794,792,89.0,0.0,-89.0,0.0,150000.0,150000.0
sader101,Ray Sadecki,St. Louis Cardinals,CARDS,2,3,3,6,1975,1978,3,9.69,4.02,-5.67,1094,228,-866,136,461,325,2919.0,527.0,-2392.0,52000.0,0.0,-52000.0
sader101,Ray Sadecki,Atlanta Braves,BRAVES,1,2,3,5,1975,1977,2,0.35,1.15,0.8,8,136,128,0,30,30,23.0,421.0,398.0,0.0,0.0,0.0
sadlc002,Casey Sadler,Tampa Bay Devil Rays,RAYS,1,1,1,2,2019,2019,0,0.27,0.0,-0.27,47,0,-47,3,0,-3,81.0,0.0,-81.0,0.0,0.0,0.0
sadlc002,Casey Sadler,Los Angeles Dodgers,DOGRS,1,1,1,2,2020,2020,0,-0.14,0.0,0.14,10,0,-10,0,0,0,28.0,0.0,-28.0,0.0,0.0,0.0
sadld001,Donnie Sadler,Boston Red Sox,RSOX,1,2,1,3,2000,2001,1,-0.55,1.15,1.7,39,96,57,95,386,291,0.0,0.0,0.0,0.0,375000.0,375000.0
sadld001,Donnie Sadler,Cincinnati Reds,REDS,1,1,1,2,2001,2001,0,-0.37,0.0,0.37,89,0,-89,189,0,-189,0.0,0.0,0.0,225000.0,0.0,-225000.0
sadlr001,Ray Sadler,Chicago Cubs,CUBS,1,1,1,2,2003,2003,0,-0.06,0.44,0.5,3,33,30,8,110,102,0.0,0.0,0.0,0.0,1475000.0,1475000.0
sadob101,Bob Sadowski,Philadelphia Phillies,PHILS,1,2,2,4,1961,1962,1,-0.26,0.0,0.26,97,0,-97,147,0,-147,42.0,0.0,-42.0,0.0,0.0,0.0
sadob101,Bob Sadowski,St. Louis Cardinals,CARDS,2,7,3,10,1960,1963,3,1.56,-0.35,-1.91,364,164,-200,1157,310,-847,0.0,0.0,0.0,0.0,0.0,0.0
sadob102,Bob Sadowski,St. Louis Cardinals,CARDS,3,6,4,10,1963,1965,2,5.52,0.29,-5.23,682,84,-598,1519,49,-1470,1673.0,458.0,-1215.0,0.0,0.0,0.0
sadob102,Bob Sadowski,Atlanta Braves,BRAVES,5,10,8,18,1965,1968,3,-0.38,-0.18,0.2,622,407,-215,842,564,-278,716.0,549.0,-167.0,15000.0,12500.0,-2500.0
sadoj101,Jim Sadowski,Pittsburgh Pirates,PIRATS,1,1,1,2,1976,1976,0,0.0,0.0,0.0,0,0,0,0,0,0,0.0,0.0,0.0,0.0,0.0,0.0
sadzc001,Connor Sadzeck,Texas Rangers,RNGRS,1,1,1,2,2019,2019,0,0.43,0.0,-0.43,20,0,-20,0,0,0,71.0,0.0,-71.0,0.0,0.0,0.0
safft101,Tom Saffell,Kansas City Athletics,ATLTCS,32,65,62,127,1956,1976,20,95.85,56.13,-39.72,9593,6816,-2777,23097,19555,-3542,12004.0,6179.0,-5825.0,476100.0,606500.0,130400.0
sainj101,Johnny Sain,Boston Braves,BRAVES,8,13,13,26,1951,1968,17,6.08,31.32,25.24,1038,2055,1017,1363,3210,1847,2411.0,9683.0,7272.0,15000.0,12500.0,-2500.0
sainj101,Johnny Sain,New York Yankees,YANKS,1,2,2,4,1955,1955,0,3.23,0.0,-3.23,249,0,-249,578,0,-578,134.0,0.0,-134.0,20000.0,0.0,-20000.0
sakal001,Lenn Sakata,Milwaukee Brewers,BREWRS,1,1,1,2,1979,1982,3,4.14,-0.16,-4.3,441,20,-421,1068,0,-1068,0.0,111.0,111.0,0.0,0.0,0.0
salaa001,Angel Salazar,St. Louis Cardinals,CARDS,1,2,2,4,1985,1995,10,0.0,14.6,14.6,0,992,992,0,3173,3173,0.0,18.0,18.0,0.0,0.0,0.0
salaa001,Angel Salazar,New York Mets,METS,1,1,1,2,1986,1986,0,0.81,0.0,-0.81,233,0,-233,645,0,-645,0.0,0.0,0.0,0.0,0.0,0.0
salaa001,Angel Salazar,Kansas City Royals,ROYALS,2,3,4,7,1987,1991,4,5.13,5.94,0.81,160,651,491,182,2147,1965,1537.0,256.0,-1281.0,900000.0,580000.0,-320000.0
salaf001,Fernando Salas,St. Louis Cardinals,CARDS,2,3,4,7,2013,2019,6,9.31,6.71,-2.6,948,777,-171,2847,1905,-942,577.0,194.0,-383.0,3662000.0,0.0,-3662000.0
salaf001,Fernando Salas,Anaheim Angels,ANGELS,1,1,1,2,2016,2016,0,-0.39,0.0,0.39,128,0,-128,2,0,-2,187.0,0.0,-187.0,0.0,0.0,0.0
salaj001,Juan Salas,Tampa Bay Devil Rays,RAYS,1,1,1,2,2009,2009,0,0.0,0.0,0.0,0,0,0,0,0,0,0.0,0.0,0.0,0.0,0.0,0.0
salal001,Luis Salazar,Pittsburgh Pirates,PIRATS,1,2,2,4,1980,1982,2,6.29,0.5,-5.79,723,83,-640,2424,87,-2337,6.0,76.0,70.0,0.0,0.0,0.0
salal001,Luis Salazar,San Diego Padres,PADRS,2,6,4,10,1984,1989,5,23.33,0.76,-22.57,2084,146,-1938,6812,127,-6685,1933.0,1127.0,-806.0,0.0,0.0,0.0
salal001,Luis Salazar,Detroit Tigers,TIGRS,2,2,2,4,1989,1990,1,1.16,-2.52,-3.68,95,223,128,265,620,355,0.0,0.0,0.0,0.0,0.0,0.0
salal001,Luis Salazar,San Diego Padres,PADRS,8,18,21,39,1989,2006,17,11.32,49.82,38.5,3213,4280,1067,10642,14704,4062,712.0,1706.0,994.0,13757500.0,22894000.0,9136500.0
salam001,Mark Salas,Minnesota Twins,TWINS,1,1,1,2,1987,1988,1,-0.1,-1.37,-1.27,50,24,-26,130,0,-130,0.0,324.0,324.0,0.0,775000.0,775000.0
salam001,Mark Salas,New York Yankees,YANKS,2,4,3,7,1987,1989,2,7.16,-1.48,-8.64,782,63,-719,2351,14,-2337,594.0,729.0,135.0,247000.0,1140000.0,893000.0
salam002,Marino Salas,Milwaukee Brewers,BREWRS,1,2,1,3,2007,2007,0,-0.41,0.0,0.41,24,0,-24,0,0,0,51.0,0.0,-51.0,0.0,2733333.0,2733333.0
salao001,Oscar Salazar,Baltimore Orioles,ORLS,1,1,1,2,2009,2010,1,-0.35,0.5,0.85,140,52,-88,269,0,-269,0.0,131.0,131.0,0.0,430900.0,430900.0
salec001,Chris Sale,Chicago White Sox,WSOX,1,1,4,5,2016,2020,4,16.47,0.0,-16.47,96,0,-96,6,0,-6,1687.0,0.0,-1687.0,9150000.0,0.0,-9150000.0
salkb101,Bill Salkeld,Pittsburgh Pirates,PIRATS,2,5,3,8,1947,1949,2,5.52,3.82,-1.7,394,236,-158,1349,883,-466,38.0,0.0,-38.0,0.0,0.0,0.0
salkr001,Roger Salkeld,Seattle Mariners,MARNRS,1,1,1,2,1995,1995,0,0.08,2.23,2.15,58,28,-30,37,0,-37,348.0,538.0,190.0,0.0,0.0,0.0
salmb001,Brad Salmon,Cincinnati Reds,REDS,1,1,1,2,2008,2008,0,0.0,0.0,0.0,0,0,0,0,0,0,0.0,0.0,0.0,0.0,0.0,0.0
salmc101,Chico Salmon,Milwaukee Braves,BRAVES,2,2,2,4,1963,1969,6,1.17,0.66,-0.51,485,304,-181,1409,660,-749,0.0,0.0,0.0,0.0,0.0,0.0
salmc101,Chico Salmon,Seattle Pilots,BREWRS,4,5,6,11,1969,1972,3,-0.13,-1.34,-1.21,214,347,133,504,646,142,0.0,993.0,993.0,37000.0,42000.0,5000.0
saltj001,Jarrod Saltalamacchia,Atlanta Braves,BRAVES,3,7,5,12,2007,2009,2,51.72,9.48,-42.24,2314,404,-1910,8153,1445,-6708,2789.0,84.0,-2705.0,15385000.0,11700000.0,-3685000.0
saltj001,Jarrod Saltalamacchia,Texas Rangers,RNGRS,1,1,4,5,2010,2015,5,5.19,1.08,-4.11,355,45,-310,1329,0,-1329,0.0,134.0,134.0,418580.0,0.0,-418580.0
saltj101,Jack Saltzgaver,StPaul,StPaul,1,2,5,7,1931,1932,1,15.3,0.0,-15.3,992,0,-992,1098,0,-1098,2971.0,0.0,-2971.0,0.0,19500.0,19500.0
salvj101,Jack Salveson,New York Giants,GIANTS,1,1,1,2,1934,1934,0,-0.5,0.0,0.5,10,0,-10,2,0,-2,21.0,0.0,-21.0,0.0,0.0,0.0
salvj101,Jack Salveson,Pittsburgh Pirates,PIRATS,5,8,5,13,1935,1946,11,3.99,17.92,13.93,204,1148,944,662,4032,3370,200.0,666.0,466.0,3000.0,2400.0,-600.0
salvj101,Jack Salveson,Chicago White Sox,WSOX,1,1,1,2,1936,1947,11,0.0,30.28,30.28,0,523,523,0,732,732,0.0,5664.0,5664.0,0.0,0.0,0.0
salvm101,Manny Salvo,SanDiego,SanDiego,1,1,2,3,1938,1938,0,-0.67,0.0,0.67,64,0,-64,42,0,-42,409.0,0.0,-409.0,0.0,0.0,0.0
salvm101,Manny Salvo,New York Giants,GIANTS,1,2,1,3,1940,1945,5,4.14,-0.49,-4.63,264,88,-176,377,324,-53,1753.0,0.0,-1753.0,0.0,0.0,0.0
samaj001,Jeff Samardzija,Chicago Cubs,CUBS,3,8,6,14,2014,2019,5,16.29,18.03,1.74,803,963,160,2607,3455,848,941.0,121.0,-820.0,0.0,0.0,0.0
samaj001,Jeff Samardzija,Oakland Athletics,ATLTCS,1,2,4,6,2014,2020,6,0.52,22.61,22.09,80,1074,994,2,4228,4226,819.0,2.0,-817.0,5345000.0,500000.0,-4845000.0
samfr101,Ron Samford,Detroit Tigers,TIGRS,2,5,4,9,1958,1960,2,-1.58,7.47,9.05,379,604,225,1361,2163,802,0.0,0.0,0.0,7000.0,9500.0,2500.0
samfr101,Ron Samford,Washington Senators,TWINS,2,3,2,5,1960,1962,2,0.48,0.05,-0.43,150,222,72,361,823,462,0.0,80.0,80.0,0.0,0.0,0.0
sampa001,Adrian Sampson,Pittsburgh Pirates,PIRATS,1,1,1,2,2015,2015,0,-0.02,2.39,2.41,1,22,21,0,25,25,14.0,190.0,176.0,0.0,6700000.0,6700000.0
sampb001,Billy Sample,Texas Rangers,RNGRS,1,2,1,3,1985,1986,1,0.32,4.12,3.8,59,221,162,154,862,708,0.0,0.0,0.0,0.0,0.0,0.0
sampb001,Billy Sample,New York Yankees,YANKS,1,1,1,2,1985,1985,0,0.62,0.0,-0.62,92,0,-92,221,0,-221,0.0,0.0,0.0,435000.0,0.0,-435000.0
sampb002,Bill Sampen,Montreal Expos,NATEX,4,6,7,13,1992,1999,7,12.1,6.46,-5.64,755,737,-18,1155,1582,427,2451.0,419.0,-2032.0,1303000.0,340000.0,-963000.0
samuj001,Juan Samuel,Philadelphia Phillies,PHILS,3,3,6,9,1989,1996,7,4.02,4.94,0.92,508,827,319,380,597,217,949.0,1605.0,656.0,3675000.0,740000.0,-2935000.0
samuj001,Juan Samuel,New York Mets,METS,12,18,22,40,1989,1999,10,15.01,10.9,-4.11,1714,1663,-51,2841,1374,-1467,3557.0,4730.0,1173.0,13039666.0,11529167.0,-1510499.0
samuj001,Juan Samuel,Detroit Tigers,TIGRS,1,1,1,2,1995,1996,1,-0.11,0.02,0.13,15,7,-8,39,23,-16,0.0,0.0,0.0,375000.0,150000.0,-225000.0
samur001,Roger Samuels,San Francisco Giants,GIANTS,1,1,1,2,1989,1989,0,-0.32,0.91,1.23,10,83,73,0,129,129,11.0,0.0,-11.0,0.0,725000.0,725000.0
sanca001,Alejandro Sanchez,Philadelphia Phillies,PHILS,4,7,7,14,1984,1989,5,20.55,8.65,-11.9,1881,885,-996,3583,3171,-412,2761.0,15.0,-2746.0,1629900.0,750000.0,-879900.0
sanca001,Alejandro Sanchez,San Francisco Giants,GIANTS,1,1,1,2,1985,1988,3,-0.31,-0.49,-0.18,71,42,-29,133,43,-90,0.0,347.0,347.0,0.0,0.0,0.0
sanca001,Alejandro Sanchez,Detroit Tigers,TIGRS,1,2,1,3,1986,1986,0,-0.73,-0.07,0.66,33,35,2,51,93,42,0.0,0.0,0.0,0.0,0.0,0.0
sanca002,Alex Sanchez,Toronto Blue Jays,BJAYS,1,3,1,4,1990,1990,0,-0.34,0.18,0.52,4,3,-1,0,0,0,23.0,47.0,24.0,102500.0,775000.0,672500.0
sanca002,Alex Sanchez,Cleveland Indians,INDINS,16,22,26,48,1990,2020,30,33.95,111.05,77.1,3251,3351,100,9795,9199,-596,3983.0,9499.0,5516.0,44654400.0,15689000.0,-28965400.0
sanca003,Alex Sanchez,Milwaukee Brewers,BREWRS,7,13,15,28,2003,2012,9,37.6,23.81,-13.79,2643,1970,-673,10054,4716,-5338,883.0,6330.0,5447.0,9087000.0,19975667.0,10888667.0
sanca004,Anibal Sanchez,Boston Red Sox,RSOX,14,38,25,63,2005,2019,14,93.01,61.11,-31.9,5581,3052,-2529,12204,8864,-3340,8381.0,6378.0,-2003.0,13099733.0,30982000.0,17882267.0
sanca004,Anibal Sanchez,Miami Marlins,MARLNS,3,5,6,11,2012,2015,3,12.57,-1.22,-13.79,462,200,-262,752,437,-315,2987.0,792.0,-2195.0,8000000.0,2650000.0,-5350000.0
sanca005,Angel Sanchez,Boston Red Sox,RSOX,1,1,1,2,2010,2010,0,-1.16,-0.74,0.42,175,29,-146,597,68,-529,0.0,0.0,0.0,0.0,0.0,0.0
sanca006,Aaron Sanchez,Toronto Blue Jays,BJAYS,2,4,3,7,2019,2021,2,-0.75,-0.48,0.27,26,56,30,8,146,138,113.0,0.0,-113.0,4800000.0,0.0,-4800000.0
sanca008,Angel Sanchez,Los Angeles Dodgers,DOGRS,1,3,2,5,2013,2013,0,0.0,0.91,0.91,8,31,23,0,30,30,12.0,261.0,249.0,0.0,0.0,0.0
sancb001,Brian Sanches,Kansas City Royals,ROYALS,1,2,1,3,2003,2003,0,0.0,0.89,0.89,0,22,22,0,85,85,0.0,0.0,0.0,0.0,5500000.0,5500000.0
sancb001,Brian Sanches,San Diego Padres,PADRS,1,1,1,2,2004,2004,0,-0.58,0.0,0.58,71,0,-71,1,0,-1,127.0,0.0,-127.0,0.0,0.0,0.0
sancc002,Cristopher Sanchez,Tampa Bay Devil Rays,RAYS,1,1,1,2,2019,2019,0,-0.02,0.0,0.02,12,0,-12,0,0,0,38.0,0.0,-38.0,0.0,0.0,0.0
sancc101,Celerino Sanchez,MexicoCityTigers,MexicoCityTigers,1,1,1,2,1971,1971,0,-0.02,0.0,0.02,105,0,-105,336,0,-336,0.0,0.0,0.0,0.0,0.0,0.0
sancd001,Duaner Sanchez,Arizona Diamondbacks,DBACKS,1,1,1,2,2002,2002,0,-0.54,-0.43,0.11,18,66,48,0,0,0,25.0,74.0,49.0,0.0,2275000.0,2275000.0
sancd001,Duaner Sanchez,Los Angeles Dodgers,DOGRS,2,5,5,10,2006,2007,1,3.53,-1.15,-4.68,810,232,-578,1884,134,-1750,767.0,896.0,129.0,682000.0,4200000.0,3518000.0
sancf001,Freddy Sanchez,Boston Red Sox,RSOX,2,7,4,11,2003,2008,5,19.22,18.0,-1.22,1732,200,-1532,2840,14,-2826,1848.0,2423.0,575.0,634000.0,10500000.0,9866000.0
sancf001,Freddy Sanchez,Pittsburgh Pirates,PIRATS,2,2,2,4,2009,2013,4,2.86,0.0,-2.86,196,0,-196,847,0,-847,0.0,0.0,0.0,6250000.0,0.0,-6250000.0
sancf002,Felix Sanchez,Chicago Cubs,CUBS,1,1,2,3,2004,2005,1,0.0,0.0,0.0,0,0,0,0,0,0,0.0,0.0,0.0,0.0,0.0,0.0
sancg001,Gaby Sanchez,Miami Marlins,MARLNS,2,3,2,5,2012,2013,1,0.79,-0.75,-1.54,309,45,-264,740,147,-593,0.0,0.0,0.0,483000.0,0.0,-483000.0
sanch001,Humberto Sanchez,Detroit Tigers,TIGRS,1,3,1,4,2006,2009,3,-0.32,2.79,3.11,6,247,241,0,1075,1075,19.0,0.0,-19.0,0.0,10756171.0,10756171.0
sancj001,Jesus Sanchez,New York Mets,METS,4,8,6,14,1998,2004,6,16.46,25.48,9.02,820,471,-349,1355,484,-871,4079.0,4278.0,199.0,362500.0,1350000.0,987500.0
sancj001,Jesus Sanchez,Florida Marlins,MARLNS,1,1,1,2,2001,2003,2,-0.46,-0.36,0.1,16,4,-12,1,2,1,25.0,22.0,-3.0,0.0,0.0,0.0
sancj002,Jonathan Sanchez,San Francisco Giants,GIANTS,1,2,1,3,2011,2012,1,-1.57,4.82,6.39,14,113,99,2,501,499,165.0,0.0,-165.0,4800000.0,1250000.0,-3550000.0
sancj002,Jonathan Sanchez,Kansas City Royals,ROYALS,1,1,1,2,2012,2015,3,-0.39,3.59,3.98,6,116,110,3,17,14,34.0,1961.0,1927.0,5600000.0,8200000.0,2600000.0
sancj003,Jesus Sanchez,Tampa Bay Devil Rays,RAYS,2,4,4,8,2019,2021,2,4.08,3.02,-1.06,256,108,-148,694,3,-691,153.0,553.0,400.0,564200.0,1125000.0,560800.0
sancl001,Luis Sanchez,Houston Astros,ASTROS,2,3,2,5,1975,1984,9,11.67,4.55,-7.12,325,651,326,410,1211,801,3231.0,2344.0,-887.0,0.0,225000.0,225000.0
sancl001,Luis Sanchez,California Angels,ANGELS,1,2,1,3,1985,1987,2,0.0,0.47,0.47,0,75,75,0,0,0,0.0,360.0,360.0,340000.0,513500.0,173500.0
sancr001,Rey Sanchez,Texas Rangers,RNGRS,1,1,1,2,1990,1990,0,6.03,0.0,-6.03,594,0,-594,1995,0,-1995,0.0,0.0,0.0,0.0,0.0,0.0
sancr001,Rey Sanchez,Chicago Cubs,CUBS,1,1,1,2,1997,1997,0,0.3,0.0,-0.3,61,0,-61,198,0,-198,0.0,0.0,0.0,1287500.0,0.0,-1287500.0
sancr001,Rey Sanchez,Kansas City Royals,ROYALS,2,3,3,6,2001,2004,3,0.45,-0.12,-0.57,167,90,-77,246,1,-245,746.0,330.0,-416.0,2300000.0,3700000.0,1400000.0
sancr001,Rey Sanchez,New York Mets,METS,1,2,1,3,2003,2004,1,1.06,0.0,-1.06,46,0,-46,186,0,-186,0.0,0.0,0.0,1300000.0,0.0,-1300000.0
sancr002,Romulo Sanchez,Pittsburgh Pirates,PIRATS,1,1,1,2,2009,2009,0,0.17,-0.02,-0.19,2,6,4,0,0,0,13.0,9.0,-4.0,0.0,0.0,0.0
sancr003,Ricardo Sanchez,Anaheim Angels,ANGELS,1,2,1,3,2015,2016,1,0.0,-0.31,-0.31,0,19,19,0,39,39,0.0,0.0,0.0,0.0,0.0,0.0
sancs001,Sixto Sanchez,Philadelphia Phillies,PHILS,1,4,1,5,2019,2021,2,1.81,9.39,7.58,260,326,66,876,1325,449,117.0,0.0,-117.0,0.0,0.0,0.0
sanct001,Tony Sanchez,Anaheim Angels,ANGELS,1,1,1,2,2017,2017,0,0.0,-0.1,-0.1,1,24,23,1,105,104,0.0,0.0,0.0,0.0,0.0,0.0
sanct001,Tony Sanchez,Cincinnati Reds,REDS,1,1,1,2,2018,2018,0,0.0,0.0,0.0,0,0,0,0,0,0,0.0,0.0,0.0,0.0,0.0,0.0
sandc101,Charlie Sands,New York Yankees,YANKS,1,3,3,6,1970,1970,0,0.24,0.0,-0.24,29,0,-29,33,0,-33,0.0,0.0,0.0,0.0,0.0,0.0
sandc101,Charlie Sands,Pittsburgh Pirates,PIRATS,2,2,2,4,1973,1973,0,0.0,0.17,0.17,0,12,12,0,2,2,0.0,36.0,36.0,17500.0,0.0,-17500.0
sandc101,Charlie Sands,Detroit Tigers,TIGRS,2,2,2,4,1973,1973,0,0.22,0.46,0.24,60,22,-38,146,0,-146,0.0,241.0,241.0,0.0,0.0,0.0
sandd001,Deion Sanders,Atlanta Braves,BRAVES,4,7,6,13,1994,1999,5,12.41,12.45,0.04,1076,790,-286,4186,2175,-2011,105.0,396.0,291.0,4207513.0,3833333.0,-374180.0
sandd001,Deion Sanders,Cincinnati Reds,REDS,5,11,7,18,1995,2010,15,11.19,26.95,15.76,438,1436,998,728,5040,4312,2595.0,2089.0,-506.0,13266667.0,6562778.0,-6703889.0
sandh101,Heinie Sand,Philadelphia Phillies,PHILS,3,5,7,12,1928,1936,8,25.37,2.86,-22.51,1352,1204,-148,5364,5193,-171,77.0,0.0,-77.0,31000.0,12250.0,-18750.0
sandh101,Heinie Sand,SaltLakeCity,SaltLakeCity,1,1,4,5,1922,1922,0,0.41,0.0,-0.41,848,0,-848,3528,0,-3528,0.0,0.0,0.0,0.0,12100.0,12100.0
sandj002,Jerry Sands,Boston Red Sox,RSOX,1,4,2,6,2012,2019,7,7.63,8.07,0.44,566,624,58,6,2223,2217,907.0,22.0,-885.0,521000.0,4100000.0,3579000.0
sandj002,Jerry Sands,Los Angeles Dodgers,DOGRS,5,22,14,36,2012,2021,9,4.41,31.13,26.72,1016,1541,525,2843,5562,2719,1152.0,835.0,-317.0,78709000.0,90253480.0,11544480.0
sandk101,Ken Sanders,Boston Red Sox,RSOX,2,6,4,10,1966,1969,3,1.66,1.54,-0.12,432,533,101,910,683,-227,275.0,859.0,584.0,24500.0,15000.0,-9500.0
sandk101,Ken Sanders,Oakland Athletics,ATLTCS,9,20,12,32,1970,1976,6,26.16,16.01,-10.15,3775,1399,-2376,8326,3903,-4423,4415.0,1098.0,-3317.0,340600.0,421500.0,80900.0
sandk101,Ken Sanders,Milwaukee Brewers,BREWRS,3,6,5,11,1972,1984,12,7.41,27.71,20.3,475,1402,927,547,5127,4580,4062.0,1332.0,-2730.0,59800.0,15000.0,-44800.0
sandk101,Ken Sanders,Philadelphia Phillies,PHILS,1,3,1,4,1972,1973,1,-1.38,0.91,2.29,154,97,-57,334,364,30,133.0,0.0,-133.0,14500.0,55000.0,40500.0
sandk101,Ken Sanders,California Angels,ANGELS,1,1,1,2,1975,1980,5,1.5,0.39,-1.11,122,109,-13,4,147,143,270.0,0.0,-270.0,0.0,0.0,0.0
sandm101,Mike Sandlock,Boston Braves,BRAVES,1,2,1,3,1944,1944,0,0.92,0.2,-0.72,99,46,-53,257,168,-89,0.0,0.0,0.0,0.0,0.0,0.0
sandp001,Pablo Sandoval,Atlanta Braves,BRAVES,1,1,2,3,2021,2021,0,0.0,0.51,0.51,0,33,33,0,106,106,0.0,0.0,0.0,1000000.0,8000000.0,7000000.0
sandp002,Patrick Sandoval,Houston Astros,ASTROS,1,2,1,3,2018,2018,0,2.51,0.11,-2.4,39,41,2,6,114,108,489.0,0.0,-489.0,0.0,3900000.0,3900000.0
sandr001,Ryne Sandberg,Philadelphia Phillies,PHILS,2,4,2,6,1982,1986,4,69.17,2.77,-66.4,2804,581,-2223,11092,1670,-9422,193.0,313.0,120.0,0.0,0.0,0.0
sandr002,Reggie Sanders,Cincinnati Reds,REDS,4,7,7,14,1999,2004,5,10.74,9.45,-1.29,965,646,-319,3397,2378,-1019,0.0,0.0,0.0,3650000.0,1050000.0,-2600000.0
sandr002,Reggie Sanders,San Diego Padres,PADRS,1,3,3,6,1999,2006,7,3.54,15.79,12.25,377,961,584,1296,3858,2562,0.0,4.0,4.0,8651680.0,7650000.0,-1001680.0
sandr101,Roy Sanders,St.Louis Browns,ORLS,1,6,1,7,1921,1921,0,0.0,0.0,0.0,0,0,0,0,0,0,0.0,0.0,0.0,6600.0,0.0,-6600.0
sandr102,Ray Sanders,Boston Braves,BRAVES,4,15,8,23,1948,1960,12,49.35,41.77,-7.58,2025,1769,-256,7279,7265,-14,2138.0,0.0,-2138.0,0.0,42000.0,42000.0
sandr102,Ray Sanders,Brooklyn Dodgers,DOGRS,1,2,3,5,1948,1948,0,8.05,0.0,-8.05,219,0,-219,971,0,-971,0.0,0.0,0.0,0.0,0.0,0.0
sandr103,Reggie Sanders,Oakland Athletics,ATLTCS,2,4,2,6,1972,1972,0,0.23,-0.12,-0.35,110,22,-88,227,60,-167,13.0,3.0,-10.0,20500.0,36000.0,15500.0
sandr103,Reggie Sanders,Detroit Tigers,TIGRS,1,1,1,2,1975,1975,0,0.0,-0.17,-0.17,0,53,53,0,194,194,0.0,0.0,0.0,0.0,0.0,0.0
sandr104,Roy Sanders,KansasCity,KansasCity,1,2,3,5,1917,1918,1,0.77,0.0,-0.77,267,0,-267,890,0,-890,475.0,0.0,-475.0,0.0,2725.0,2725.0
sands001,Scott Sanderson,Montreal Expos,NATEX,2,3,3,6,1983,1986,3,11.29,0.58,-10.71,396,208,-188,249,9,-240,2573.0,362.0,-2211.0,513500.0,340000.0,-173500.0
sands002,Scott Sanders,San Diego Padres,PADRS,2,2,3,5,1996,2002,6,-1.22,5.66,6.88,96,246,150,0,223,223,617.0,1953.0,1336.0,6300000.0,235000.0,-6065000.0
sands002,Scott Sanders,Seattle Mariners,MARNRS,1,3,2,5,1997,1998,1,0.42,-0.64,-1.06,53,29,-24,0,2,2,389.0,290.0,-99.0,1300000.0,1410000.0,110000.0
sands002,Scott Sanders,Detroit Tigers,TIGRS,1,1,1,2,1998,1998,0,-0.22,0.0,0.22,46,0,-46,1,0,-1,92.0,0.0,-92.0,1700000.0,0.0,-1700000.0
sandt101,Tommy Sandt,St. Louis Cardinals,CARDS,3,4,5,9,1979,1984,5,-0.19,1.88,2.07,234,169,-65,556,151,-405,297.0,1188.0,891.0,0.0,200000.0,200000.0
sanff101,Fred Sanford,St.Louis Browns,ORLS,38,97,102,199,1948,1988,40,142.11,203.49,61.38,10392,17810,7418,23657,52919,29262,31054.0,19600.0,-11454.0,899583.0,209900.0,-689683.0
sanff101,Fred Sanford,New York Yankees,YANKS,1,3,1,4,1951,1954,3,18.48,1.84,-16.64,407,209,-198,444,108,-336,3513.0,1042.0,-2471.0,11500.0,0.0,-11500.0
sanff101,Fred Sanford,Washington Senators,TWINS,1,1,1,2,1951,1951,0,-1.17,-0.07,1.1,18,22,4,9,21,12,82.0,184.0,102.0,0.0,0.0,0.0
sanff101,Fred Sanford,St.Louis Browns,ORLS,2,5,3,8,1951,1952,1,0.64,0.33,-0.31,156,96,-60,332,319,-13,0.0,0.0,0.0,0.0,20000.0,20000.0
sanfj101,Jack Sanford,Philadelphia Phillies,PHILS,1,1,2,3,1958,1962,4,13.08,-2.23,-15.31,471,154,-317,541,186,-355,4217.0,374.0,-3843.0,0.0,0.0,0.0
sanfj101,Jack Sanford,California Angels,ANGELS,4,5,5,10,1967,1974,7,-0.7,4.94,5.64,265,604,339,780,1757,977,66.0,0.0,-66.0,57000.0,0.0,-57000.0
sangm101,Manny Sanguillen,Pittsburgh Pirates,PIRATS,1,2,1,3,1976,1976,0,0.65,0.0,-0.65,152,0,-152,601,0,-601,0.0,0.0,0.0,0.0,0.0,0.0
sangm101,Manny Sanguillen,Oakland Athletics,ATLTCS,1,1,3,4,1978,1980,2,-1.43,0.36,1.79,188,545,357,368,1322,954,0.0,327.0,327.0,0.0,0.0,0.0
sangm101,Manny Sanguillen,Pittsburgh Pirates,PIRATS,4,6,9,15,1980,1984,4,24.19,-0.04,-24.23,615,106,-509,1402,76,-1326,2781.0,299.0,-2482.0,300000.0,0.0,-300000.0
sanmr001,Reiver Sanmartin,Texas Rangers,RNGRS,1,1,1,2,2017,2019,2,0.0,0.0,0.0,0,0,0,0,0,0,0.0,0.0,0.0,0.0,0.0,0.0
sanmr001,Reiver Sanmartin,New York Yankees,YANKS,3,5,5,10,2019,2021,2,10.03,0.33,-9.7,238,102,-136,526,361,-165,1135.0,0.0,-1135.0,0.0,0.0,0.0
santa001,Andres Santana,San Francisco Giants,GIANTS,1,1,1,2,1993,1993,0,0.0,0.0,0.0,0,0,0,0,0,0,0.0,0.0,0.0,0.0,0.0,0.0
santa002,Angel Santos,Boston Red Sox,RSOX,1,1,1,2,2003,2005,2,0.2,-0.08,-0.28,32,4,-28,80,0,-80,0.0,23.0,23.0,0.0,0.0,0.0
santa101,Al Santorini,San Diego Padres,PADRS,3,3,6,9,1971,1977,6,12.6,11.49,-1.11,586,839,253,580,1845,1265,4520.0,1817.0,-2703.0,0.0,0.0,0.0
santa101,Al Santorini,St. Louis Cardinals,CARDS,4,4,4,8,1973,1976,3,2.97,0.71,-2.26,208,74,-134,184,108,-76,641.0,266.0,-375.0,34000.0,12500.0,-21500.0
santb001,Benito Santiago,Kansas City Royals,ROYALS,2,3,2,5,2004,2009,5,2.19,0.82,-1.37,418,240,-178,24,478,454,594.0,477.0,-117.0,2555000.0,395000.0,-2160000.0
santc002,Carlos Santana,Los Angeles Dodgers,DOGRS,1,2,2,4,2008,2011,3,29.84,9.15,-20.69,1336,406,-930,5723,1608,-4115,6.0,0.0,-6.0,0.0,6100000.0,6100000.0
santc002,Carlos Santana,Philadelphia Phillies,PHILS,2,3,4,7,2018,2019,1,7.13,-0.08,-7.21,336,92,-244,1315,2,-1313,47.0,142.0,95.0,18878833.0,17350000.0,-1528833.0
santc002,Carlos Santana,Seattle Mariners,MARNRS,2,4,3,7,2018,2019,1,6.24,2.05,-4.19,262,65,-197,1138,289,-849,0.0,0.0,0.0,0.0,18667000.0,18667000.0
santd001,Danny Santana,Minnesota Twins,TWINS,1,1,2,3,2017,2017,0,-0.09,0.0,0.09,84,0,-84,184,0,-184,0.0,0.0,0.0,0.0,0.0,0.0
santd002,Domingo Santana,Philadelphia Phillies,PHILS,2,5,5,10,2011,2018,7,10.84,2.57,-8.27,1005,441,-564,3635,1629,-2006,674.0,0.0,-674.0,10400000.0,8200000.0,-2200000.0
santd002,Domingo Santana,Houston Astros,ASTROS,1,4,3,7,2015,2017,2,18.89,0.28,-18.61,984,198,-786,1471,487,-984,1823.0,1153.0,-670.0,0.0,512500.0,512500.0
santd002,Domingo Santana,Milwaukee Brewers,BREWRS,1,1,2,3,2018,2020,2,0.49,0.26,-0.23,121,174,53,507,483,-24,0.0,0.0,0.0,572400.0,0.0,-572400.0
santd003,Dennis Santana,Los Angeles Dodgers,DOGRS,1,1,1,2,2021,2021,0,0.15,0.0,-0.15,40,0,-40,0,0,0,119.0,0.0,-119.0,0.0,0.0,0.0
sante001,Ervin Santana,Anaheim Angels,ANGELS,1,2,1,3,2012,2012,0,3.73,0.0,-3.73,74,0,-74,4,0,-4,829.0,0.0,-829.0,11200000.0,0.0,-11200000.0
santg001,Gregory Santos,Boston Red Sox,RSOX,1,2,1,3,2017,2019,2,-0.97,-1.55,-0.58,77,226,149,28,849,821,340.0,3.0,-337.0,0.0,4200000.0,4200000.0
santh001,Hector Santiago,Chicago White Sox,WSOX,3,5,5,10,2013,2020,7,6.93,16.12,9.19,431,440,9,1326,1933,607,1639.0,102.0,-1537.0,3255000.0,11333334.0,8078334.0
santh001,Hector Santiago,Anaheim Angels,ANGELS,1,2,3,5,2016,2018,2,-0.15,3.27,3.42,80,67,-13,0,11,11,566.0,1029.0,463.0,0.0,0.0,0.0
santj001,Julio Santana,Tampa Bay Devil Rays,RAYS,1,1,2,3,1999,1999,0,0.0,0.0,0.0,0,0,0,0,0,0,0.0,0.0,0.0,272500.0,0.0,-272500.0
santj002,Jose Santiago,Kansas City Royals,ROYALS,1,1,1,2,2001,2002,1,-0.82,7.23,8.05,183,52,-131,7,7,0,328.0,965.0,637.0,260000.0,0.0,-260000.0
santj003,Johan Santana,Florida Marlins,MARLNS,1,2,1,3,1999,1999,0,36.05,0.0,-36.05,267,0,-267,32,0,-32,3926.0,0.0,-3926.0,0.0,0.0,0.0
santj003,Johan Santana,Minnesota Twins,TWINS,4,5,8,13,2008,2014,6,49.88,4.96,-44.92,1812,511,-1301,6466,1339,-5127,2229.0,360.0,-1869.0,6987500.0,7175000.0,187500.0
santl001,Luis Santos,Pittsburgh Pirates,PIRATS,1,2,2,4,2012,2014,2,0.0,1.15,1.15,0,120,120,0,7,7,0.0,252.0,252.0,0.0,0.0,0.0
santp001,Pedro Santana,Houston Astros,ASTROS,1,2,1,3,1996,1996,0,0.0,-0.01,-0.01,1,18,17,0,0,0,0.0,28.0,28.0,0.0,400000.0,400000.0
santr001,Rafael Santana,New York Yankees,YANKS,4,6,6,12,1981,1985,4,4.34,5.22,0.88,642,287,-355,1507,453,-1054,133.0,764.0,631.0,435000.0,0.0,-435000.0
santr001,Rafael Santana,New York Mets,METS,3,5,7,12,1987,1991,4,-1.46,0.62,2.08,394,117,-277,613,186,-427,350.0,0.0,-350.0,250000.0,0.0,-250000.0
santr002,Ramon Santiago,Detroit Tigers,TIGRS,1,2,1,3,2004,2011,7,-0.28,18.63,18.91,27,817,790,58,3384,3326,0.0,0.0,0.0,0.0,0.0,0.0
santr102,Ron Santo,Chicago Cubs,CUBS,13,23,27,50,1973,1990,17,17.95,23.31,5.36,3143,2363,-780,8342,4769,-3573,1137.0,6181.0,5044.0,1130000.0,172700.0,-957300.0
sants001,Sergio Santos,Arizona Diamondbacks,DBACKS,1,2,2,4,2005,2008,3,6.92,12.54,5.62,335,469,134,1091,1778,687,155.0,619.0,464.0,9000000.0,5115000.0,-3885000.0
sants001,Sergio Santos,Chicago White Sox,WSOX,1,1,1,2,2011,2011,0,-0.71,0.0,0.71,67,0,-67,1,0,-1,155.0,0.0,-155.0,435000.0,0.0,-435000.0
santv001,Victor Santos,Detroit Tigers,TIGRS,1,2,1,3,2002,2002,0,-1.27,-0.52,0.75,48,45,-3,2,0,-2,78.0,125.0,47.0,0.0,0.0,0.0
sappd001,Dave Sappelt,Cincinnati Reds,REDS,1,3,1,4,2011,2015,4,7.63,1.09,-6.54,509,203,-306,388,0,-388,2074.0,256.0,-1818.0,422500.0,1600000.0,1177500.0
sardl001,Luis Sardinas,Texas Rangers,RNGRS,1,3,2,5,2015,2015,0,4.24,4.26,0.02,471,35,-436,105,4,-101,683.0,553.0,-130.0,0.0,0.0,0.0
sardl001,Luis Sardinas,Milwaukee Brewers,BREWRS,1,1,1,2,2015,2016,1,-0.48,-1.41,-0.93,33,104,71,77,289,212,3.0,0.0,-3.0,0.0,0.0,0.0
sardl001,Luis Sardinas,Seattle Mariners,MARNRS,1,1,1,2,2016,2016,0,-0.16,0.0,0.16,64,0,-64,173,0,-173,3.0,0.0,-3.0,512000.0,0.0,-512000.0
sarfd001,Dennis Sarfate,Houston Astros,ASTROS,1,5,1,6,2007,2009,2,11.62,3.81,-7.81,860,316,-544,1797,1340,-457,1330.0,0.0,-1330.0,382000.0,13811415.0,13429415.0
sargj101,Joe Sargent,Detroit Tigers,TIGRS,1,9,2,11,1921,1941,20,0.0,3.03,3.03,0,202,202,0,144,144,0.0,1168.0,1168.0,3000.0,0.0,-3000.0
sarmm101,Manny Sarmiento,Seattle Mariners,MARNRS,1,1,1,2,1981,1982,1,0.0,-0.69,-0.69,0,39,39,0,0,0,0.0,161.0,161.0,0.0,0.0,0.0
sarnb101,Bill Sarni,St. Louis Cardinals,CARDS,19,44,38,82,1956,1972,16,56.42,67.4,10.98,5645,3260,-2385,13530,9157,-4373,6309.0,6165.0,-144.0,120500.0,36000.0,-84500.0
sassm001,Mackey Sasser,San Francisco Giants,GIANTS,1,2,1,3,1987,1991,4,-0.47,5.23,5.7,26,353,327,49,256,207,0.0,2086.0,2086.0,0.0,795000.0,795000.0
sassm001,Mackey Sasser,Pittsburgh Pirates,PIRATS,2,3,3,6,1988,1988,0,13.41,0.21,-13.2,931,40,-891,3050,103,-2947,0.0,0.0,0.0,62500.0,0.0,-62500.0
sassr001,Rob Sasser,Anaheim Angels,ANGELS,1,2,1,3,1997,2000,3,0.66,4.28,3.62,38,78,40,115,11,-104,0.0,1167.0,1167.0,1916972.0,4850000.0,2933028.0
satrt101,Tom Satriano,California Angels,ANGELS,5,8,7,15,1969,1976,7,0.73,2.0,1.27,550,367,-183,1839,1229,-610,0.0,90.0,90.0,63500.0,80500.0,17000.0
sauck101,Kevin Saucier,Philadelphia Phillies,PHILS,1,1,1,2,1980,1982,2,0.0,-0.57,-0.57,0,184,184,0,10,10,0.0,377.0,377.0,0.0,0.0,0.0
sauck101,Kevin Saucier,Texas Rangers,RNGRS,1,1,1,2,1980,1983,3,2.21,1.16,-1.05,70,112,42,0,293,293,268.0,0.0,-268.0,0.0,0.0,0.0
sauee101,Ed Sauer,Pittsburgh Pirates,PIRATS,1,1,1,2,1949,1950,1,-0.18,0.76,0.94,79,48,-31,234,155,-79,0.0,0.0,0.0,0.0,0.0,0.0
sauee101,Ed Sauer,Boston Braves,BRAVES,1,3,1,4,1949,1949,0,0.73,0.0,-0.73,93,0,-93,264,0,-264,0.0,0.0,0.0,0.0,0.0,0.0
saueh101,Hank Sauer,Cincinnati Reds,REDS,3,4,5,9,1949,1951,2,25.39,2.56,-22.83,1630,361,-1269,6349,1295,-5054,0.0,0.0,0.0,10000.0,9000.0,-1000.0
saueh101,Hank Sauer,Chicago Cubs,CUBS,3,6,5,11,1956,1958,2,8.44,-0.08,-8.52,848,208,-640,2477,380,-2097,130.0,197.0,67.0,0.0,0.0,0.0
saues001,Scott Sauerbeck,Pittsburgh Pirates,PIRATS,7,13,14,27,2003,2013,10,4.43,39.52,35.09,675,2405,1730,958,7168,6210,1221.0,934.0,-287.0,15866667.0,309500.0,-15557167.0
saunj001,Joe Saunders,Anaheim Angels,ANGELS,1,4,1,5,2010,2012,2,13.1,6.5,-6.6,498,84,-414,497,11,-486,4323.0,1527.0,-2796.0,3700000.0,8250000.0,4550000.0
saunj001,Joe Saunders,Arizona Diamondbacks,DBACKS,1,2,2,4,2012,2012,0,0.57,0.25,-0.32,13,24,11,0,0,0,144.0,32.0,-112.0,6000000.0,3600000.0,-2400000.0
saunm001,Michael Saunders,Seattle Mariners,MARNRS,2,2,2,4,2014,2016,2,3.66,0.68,-2.98,183,23,-160,639,2,-637,190.0,340.0,150.0,9000000.0,5200000.0,-3800000.0
savaj001,Jack Savage,Los Angeles Dodgers,DOGRS,1,3,3,6,1987,1992,5,0.0,9.73,9.73,0,1063,1063,0,1797,1797,0.0,1084.0,1084.0,1187500.0,925000.0,-262500.0
savaj001,Jack Savage,New York Mets,METS,1,5,1,6,1989,1991,2,34.39,9.58,-24.81,807,164,-643,0,204,204,6852.0,1699.0,-5153.0,378000.0,2766666.0,2388666.0
savat101,Ted Savage,Philadelphia Phillies,PHILS,1,2,1,3,1962,1964,2,-0.67,1.44,2.11,85,121,36,167,417,250,0.0,0.0,0.0,0.0,0.0,0.0
savat101,Ted Savage,Pittsburgh Pirates,PIRATS,6,10,11,21,1964,1973,9,-1.2,0.41,1.61,81,41,-40,182,35,-147,16.0,36.0,20.0,17500.0,0.0,-17500.0
savat101,Ted Savage,Chicago Cubs,CUBS,2,3,3,6,1968,1974,6,-0.08,14.65,14.73,111,1174,1063,205,2396,2191,0.0,1177.0,1177.0,0.0,36500.0,36500.0
savat101,Ted Savage,Los Angeles Dodgers,DOGRS,1,1,1,2,1969,1970,1,0.61,0.0,-0.61,68,0,-68,132,0,-132,0.0,0.0,0.0,0.0,0.0,0.0
savat101,Ted Savage,Milwaukee Brewers,BREWRS,3,4,4,8,1971,1973,2,-0.51,-0.65,-0.14,22,168,146,41,528,487,0.0,22.0,22.0,40000.0,0.0,-40000.0
saveb101,Bob Saverine,Baltimore Orioles,ORLS,1,2,1,3,1965,1966,1,0.0,0.29,0.29,0,54,54,0,11,11,0.0,162.0,162.0,0.0,0.0,0.0
savrm101,Moe Savransky,Buffalo,Buffalo,1,2,1,3,1951,1952,1,4.75,0.0,-4.75,338,0,-338,99,0,-99,1213.0,0.0,-1213.0,0.0,6000.0,6000.0
sawac101,Carl Sawatski,Toronto,Toronto,1,1,2,3,1956,1956,0,0.68,0.0,-0.68,68,0,-68,131,0,-131,0.0,0.0,0.0,0.0,0.0,0.0
sawac101,Carl Sawatski,Milwaukee Braves,BRAVES,2,3,3,6,1958,1961,3,0.97,0.34,-0.63,134,49,-85,436,163,-273,0.0,0.0,0.0,0.0,0.0,0.0
sawac101,Carl Sawatski,Philadelphia Phillies,PHILS,1,1,2,3,1959,1961,2,3.25,1.12,-2.13,305,177,-128,785,422,-363,0.0,0.0,0.0,0.0,9000.0,9000.0
sawyr101,Rick Sawyer,Cleveland Indians,INDINS,4,7,5,12,1974,1976,2,-3.21,4.02,7.23,307,69,-238,459,0,-459,1098.0,1299.0,201.0,68000.0,35000.0,-33000.0
sawyr101,Rick Sawyer,New York Yankees,YANKS,1,1,1,2,1976,1976,0,0.41,-0.29,-0.7,138,13,-125,58,34,-24,578.0,0.0,-578.0,0.0,0.0,0.0
sax-d001,Dave Sax,Texas Rangers,RNGRS,1,1,1,2,1988,1988,0,0.0,0.0,0.0,0,0,0,0,0,0,0.0,0.0,0.0,0.0,0.0,0.0
sax-s001,Steve Sax,New York Yankees,YANKS,4,8,8,16,1992,2003,11,18.62,30.57,11.95,1366,580,-786,2830,16,-2814,2545.0,5552.0,3007.0,1188000.0,4740000.0,3552000.0
saylb101,Bill Sayles,New York Giants,GIANTS,2,4,3,7,1943,1945,2,-0.25,-0.04,0.21,36,72,36,28,39,11,123.0,375.0,252.0,0.0,0.0,0.0
sborj002,Josh Sborz,Los Angeles Dodgers,DOGRS,1,1,1,2,2021,2021,0,0.3,0.0,-0.3,68,0,-68,1,0,-1,177.0,0.0,-177.0,0.0,0.0,0.0
scahr001,Rob Scahill,Colorado Rockies,ROCKS,1,1,1,2,2014,2018,4,-0.09,-0.02,0.07,84,6,-78,2,0,-2,141.0,12.0,-129.0,0.0,0.0,0.0
scalj102,Jerry Scala,Sacramento,Sacramento,2,2,3,5,1951,1952,1,0.42,0.0,-0.42,302,0,-302,758,0,-758,0.0,0.0,0.0,0.0,0.0,0.0
scanb001,Bob Scanlan,Philadelphia Phillies,PHILS,3,5,4,9,1991,1996,5,0.9,5.94,5.04,864,567,-297,60,158,98,1703.0,1127.0,-576.0,3609000.0,2929000.0,-680000.0
scanb001,Bob Scanlan,Chicago Cubs,CUBS,1,1,2,3,1993,1993,0,0.89,0.0,-0.89,51,0,-51,0,0,0,564.0,0.0,-564.0,245000.0,0.0,-245000.0
scand101,Doc Scanlan,Brooklyn Dodgers,DOGRS,2,3,2,5,1911,1915,4,-0.82,7.63,8.45,36,220,184,23,209,186,201.0,1792.0,1591.0,2600.0,3500.0,900.0
scanp102,Pat Scanlon,Montreal Expos,NATEX,3,6,6,12,1976,1983,7,4.1,3.12,-0.98,573,1002,429,1861,2648,787,25.0,308.0,283.0,0.0,0.0,0.0
scanp102,Pat Scanlon,St. Louis Cardinals,CARDS,1,2,1,3,1977,1978,1,-0.62,0.98,1.6,351,116,-235,172,6,-166,1013.0,278.0,-735.0,0.0,0.0,0.0
scarl101,Les Scarsella,Cincinnati Reds,REDS,2,5,2,7,1939,1942,3,-0.55,3.89,4.44,194,139,-55,101,249,148,438.0,909.0,471.0,4500.0,12500.0,8000.0
scarm101,Mac Scarce,Philadelphia Phillies,PHILS,2,4,4,8,1974,1984,10,23.16,7.68,-15.48,1035,1011,-24,3964,168,-3796,0.0,2166.0,2166.0,0.0,90000.0,90000.0
scarm101,Mac Scarce,New York Mets,METS,2,2,3,5,1975,1976,1,-0.55,-0.88,-0.33,39,79,40,0,6,6,114.0,196.0,82.0,0.0,0.0,0.0
scarm101,Mac Scarce,Minnesota Twins,TWINS,2,2,2,4,1978,1981,3,0.0,0.0,0.0,0,41,41,0,0,0,0.0,266.0,266.0,0.0,0.0,0.0
scarr101,Randy Scarbery,Oakland Athletics,ATLTCS,1,1,1,2,1977,1977,0,0.0,0.18,0.18,0,6,6,0,0,0,0.0,55.0,55.0,0.0,0.0,0.0
scarr101,Randy Scarbery,Chicago White Sox,WSOX,7,12,10,22,1980,1994,14,14.41,9.12,-5.29,691,989,298,1049,2546,1497,4103.0,4503.0,400.0,1513333.0,147500.0,-1365833.0
scarr102,Ray Scarborough,Washington Senators,TWINS,12,23,24,47,1950,1963,13,21.31,19.51,-1.8,2117,2519,402,6320,5694,-626,2404.0,6282.0,3878.0,32000.0,59000.0,27000.0
scarr102,Ray Scarborough,Chicago White Sox,WSOX,5,11,10,21,1950,1963,13,1.07,31.48,30.41,1321,1905,584,3161,6140,2979,1824.0,1373.0,-451.0,20000.0,31000.0,11000.0
scarr103,Russ Scarritt,StPaul,StPaul,1,2,2,4,1928,1929,1,0.83,0.0,-0.83,329,0,-329,1236,0,-1236,0.0,0.0,0.0,0.0,3000.0,3000.0
scars001,Steve Scarsone,Philadelphia Phillies,PHILS,1,1,1,2,1992,1993,1,-0.11,0.28,0.39,11,70,59,19,241,222,0.0,0.0,0.0,0.0,0.0,0.0
scars001,Steve Scarsone,Baltimore Orioles,ORLS,1,1,1,2,1993,1993,0,1.3,-0.25,-1.55,281,10,-271,810,21,-789,0.0,0.0,0.0,0.0,0.0,0.0
schaa102,Art Schallock,Brooklyn Dodgers,DOGRS,1,1,3,4,1951,1951,0,0.28,0.0,-0.28,56,0,-56,29,0,-29,270.0,0.0,-270.0,0.0,0.0,0.0
schab102,Bill Schardt,Brooklyn Dodgers,DOGRS,1,2,2,4,1912,1916,4,0.0,-0.4,-0.4,0,214,214,0,788,788,0.0,0.0,0.0,4200.0,0.0,-4200.0
schab103,Biff Schaller,Chicago White Sox,WSOX,1,1,1,2,1913,1913,0,0.0,0.0,0.0,0,0,0,0,0,0,0.0,0.0,0.0,0.0,0.0,0.0
schac101,Charley Schanz,Seattle,Seattle,1,2,2,4,1949,1950,1,-0.68,0.0,0.68,28,0,-28,12,0,-12,68.0,0.0,-68.0,0.0,0.0,0.0
schad001,Dan Schatzeder,Montreal Expos,NATEX,1,1,1,2,1979,1980,1,1.95,2.49,0.54,49,139,90,0,587,587,792.0,0.0,-792.0,0.0,0.0,0.0
schad001,Dan Schatzeder,Detroit Tigers,TIGRS,1,2,1,3,1981,1986,5,-1.99,10.36,12.35,58,678,620,18,2558,2540,218.0,0.0,-218.0,0.0,0.0,0.0
schad001,Dan Schatzeder,Montreal Expos,NATEX,1,2,2,4,1986,1992,6,0.09,3.06,2.97,102,697,595,18,1867,1849,201.0,144.0,-57.0,415000.0,210000.0,-205000.0
schad001,Dan Schatzeder,Philadelphia Phillies,PHILS,1,2,2,4,1987,1987,0,-0.54,0.0,0.54,41,0,-41,0,0,0,162.0,0.0,-162.0,425000.0,0.0,-425000.0
schad001,Dan Schatzeder,Houston Astros,ASTROS,1,1,2,3,1990,1990,0,0.27,0.0,-0.27,12,0,-12,0,0,0,17.0,0.0,-17.0,450000.0,0.0,-450000.0
schag001,Gene Schall,Philadelphia Phillies,PHILS,1,1,1,2,1997,1997,0,0.0,-0.33,-0.33,0,22,22,0,41,41,0.0,0.0,0.0,0.0,0.0,0.0
schag101,Germany Schaefer,Detroit Tigers,TIGRS,1,2,1,3,1909,1909,0,6.2,1.23,-4.97,528,46,-482,1839,188,-1651,2.0,0.0,-2.0,0.0,0.0,0.0
schag102,George Scharein,New York Giants,GIANTS,1,2,1,3,1936,1936,0,-4.47,0.0,4.47,388,0,-388,1419,0,-1419,0.0,0.0,0.0,0.0,0.0,0.0
schag102,George Scharein,Philadelphia Phillies,PHILS,1,2,1,3,1940,1941,1,0.0,-0.18,-0.18,0,120,120,0,488,488,0.0,0.0,0.0,0.0,0.0,0.0
schaj002,Jordan Schafer,Atlanta Braves,BRAVES,1,4,2,6,2011,2012,1,1.07,6.78,5.71,249,208,-41,481,952,471,1075.0,0.0,-1075.0,0.0,4400000.0,4400000.0
schaj101,Jeff Schattinger,Kansas City Royals,ROYALS,1,1,1,2,1982,1987,5,0.0,-0.57,-0.57,0,390,390,0,821,821,0.0,0.0,0.0,0.0,0.0,0.0
schaj104,Jimmie Schaffer,St. Louis Cardinals,CARDS,15,32,26,58,1962,1972,10,54.99,16.45,-38.54,4551,1419,-3132,9818,4107,-5711,7592.0,1574.0,-6018.0,32500.0,24000.0,-8500.0
schaj104,Jimmie Schaffer,Chicago Cubs,CUBS,1,1,1,2,1964,1964,0,0.27,0.0,-0.27,17,0,-17,34,0,-34,0.0,0.0,0.0,0.0,17000.0,17000.0
schaj104,Jimmie Schaffer,Chicago White Sox,WSOX,1,1,1,2,1965,1965,0,-0.55,-0.06,0.49,24,28,4,38,3,-35,0.0,80.0,80.0,13500.0,0.0,-13500.0
schaj104,Jimmie Schaffer,New York Mets,METS,1,3,1,4,1966,1966,0,-0.11,-0.09,0.02,10,31,21,19,96,77,0.0,0.0,0.0,0.0,0.0,0.0
schaj104,Jimmie Schaffer,Cincinnati Reds,REDS,1,1,1,2,1969,1970,1,0.0,0.61,0.61,0,68,68,0,132,132,0.0,0.0,0.0,0.0,0.0,0.0
scham101,Mark Schaeffer,Boston Red Sox,RSOX,1,1,1,2,1969,1969,0,0.0,0.0,0.0,0,0,0,0,0,0,0.0,0.0,0.0,0.0,0.0,0.0
scham101,Mark Schaeffer,Houston Astros,ASTROS,7,14,10,24,1971,1989,18,9.86,19.8,9.94,2403,1970,-433,5583,4832,-751,5444.0,4390.0,-1054.0,22500.0,16500.0,-6000.0
schap101,Paul Schaal,Kansas City Royals,ROYALS,1,1,1,2,1974,1974,0,-0.63,-0.74,-0.11,53,36,-17,183,91,-92,0.0,0.0,0.0,0.0,0.0,0.0
schar103,Ray Schalk,Milwaukee,Milwaukee,1,1,5,6,1912,1919,7,33.22,0.0,-33.22,1757,0,-1757,6239,0,-6239,0.0,0.0,0.0,0.0,0.0,0.0
schaw101,Wally Schang,Philadelphia Athletics,ATLTCS,2,6,5,11,1917,1924,7,21.83,0.26,-21.57,730,281,-449,2197,867,-1330,2329.0,731.0,-1598.0,12000.0,0.0,-12000.0
schaw101,Wally Schang,Boston Red Sox,RSOX,11,21,24,45,1920,1937,17,85.68,51.32,-34.36,3377,2671,-706,8411,9094,683,11819.0,4939.0,-6880.0,73300.0,46200.0,-27100.0
schaw101,Wally Schang,New York Yankees,YANKS,1,1,2,3,1926,1926,0,11.12,0.0,-11.12,385,0,-385,1302,0,-1302,0.0,0.0,0.0,0.0,0.0,0.0
schaw101,Wally Schang,St.Louis Browns,ORLS,1,1,2,3,1929,1929,0,-0.56,0.0,0.56,45,0,-45,116,0,-116,0.0,0.0,0.0,10000.0,6000.0,-4000.0
scheb001,Bill Scherrer,Cincinnati Reds,REDS,1,1,2,3,1984,1985,1,-0.02,-0.88,-0.86,80,36,-44,0,3,3,318.0,70.0,-248.0,0.0,0.0,0.0
scheb101,Bob Scheffing,Chicago Cubs,CUBS,1,1,1,2,1950,1954,4,0.02,0.35,0.33,68,54,-14,190,126,-64,0.0,0.0,0.0,0.0,0.0,0.0
schef102,Fred Scherman,Detroit Tigers,TIGRS,2,3,3,6,1973,1976,3,-1.64,-0.8,0.84,197,425,228,134,1581,1447,233.0,157.0,-76.0,32000.0,66000.0,34000.0
scheh101,Heinie Scheer,Philadelphia Athletics,ATLTCS,1,4,1,5,1923,1932,9,0.0,51.22,51.22,0,1240,1240,0,5473,5473,0.0,0.0,0.0,9900.0,0.0,-9900.0
scheh103,Hank Schenz,Chicago Cubs,CUBS,1,1,1,2,1949,1949,0,0.0,-1.35,-1.35,0,65,65,0,201,201,0.0,0.0,0.0,0.0,0.0,0.0
schem001,Max Scherzer,Arizona Diamondbacks,DBACKS,5,9,10,19,2009,2019,10,25.87,12.08,-13.79,479,854,375,186,430,244,5327.0,4326.0,-1001.0,18334500.0,2200000.0,-16134500.0
schem001,Max Scherzer,Washington Nationals,NATEX,1,2,4,6,2021,2021,0,4.89,0.24,-4.65,74,47,-27,252,110,-142,205.0,188.0,-17.0,47503480.0,0.0,-47503480.0
scher001,Rich Scheid,New York Yankees,YANKS,4,8,6,14,1987,1994,7,-0.12,9.72,9.84,794,752,-42,1743,1510,-233,764.0,1690.0,926.0,2485000.0,3889167.0,1404167.0
scher001,Rich Scheid,Chicago Cubs,CUBS,1,1,1,2,1989,1989,0,0.0,0.0,0.0,0,0,0,0,0,0,0.0,0.0,0.0,0.0,0.0,0.0
scher001,Rich Scheid,Chicago White Sox,WSOX,1,1,1,2,1992,1992,0,-0.18,0.0,0.18,14,0,-14,1,0,-1,36.0,0.0,-36.0,0.0,0.0,0.0
scher101,Richie Scheinblum,Kansas City Royals,ROYALS,2,3,3,6,1972,1986,14,0.89,27.33,26.44,85,1835,1750,116,7325,7209,420.0,179.0,-241.0,31000.0,41000.0,10000.0
scher101,Richie Scheinblum,Cincinnati Reds,REDS,1,1,2,3,1973,1973,0,1.47,0.0,-1.47,87,0,-87,295,0,-295,0.0,0.0,0.0,27500.0,8550.0,-18950.0
scher101,Richie Scheinblum,California Angels,ANGELS,1,1,1,2,1974,1974,0,-0.74,-0.63,0.11,36,53,17,91,183,92,0.0,0.0,0.0,0.0,0.0,0.0
sches001,Scott Schebler,Los Angeles Dodgers,DOGRS,3,7,6,13,2015,2019,4,7.85,6.19,-1.66,1100,293,-807,3346,616,-2730,1782.0,1084.0,-698.0,0.0,0.0,0.0
schic001,Calvin Schiraldi,New York Mets,METS,6,12,11,23,1985,1994,9,8.23,9.35,1.12,636,686,50,644,1209,565,3320.0,3063.0,-257.0,4116666.0,2989167.0,-1127499.0
schic001,Calvin Schiraldi,Boston Red Sox,RSOX,2,3,2,5,1987,1992,5,5.91,6.0,0.09,700,548,-152,106,1578,1472,1775.0,506.0,-1269.0,1675000.0,2340000.0,665000.0
schic001,Calvin Schiraldi,Chicago Cubs,CUBS,1,3,2,5,1989,1992,3,9.01,-0.33,-9.34,632,454,-178,1598,1395,-203,382.0,0.0,-382.0,400000.0,750000.0,350000.0
schic002,Curt Schilling,Boston Red Sox,RSOX,1,2,1,3,1988,1990,2,35.17,11.38,-23.79,1803,83,-1720,7464,0,-7464,208.0,1586.0,1378.0,62500.0,850000.0,787500.0
schic002,Curt Schilling,Baltimore Orioles,ORLS,1,3,1,4,1991,1993,2,24.17,0.73,-23.44,904,185,-719,2612,764,-1848,2435.0,0.0,-2435.0,0.0,0.0,0.0
schic002,Curt Schilling,Houston Astros,ASTROS,1,1,1,2,1992,1993,1,36.28,0.0,-36.28,479,0,-479,594,0,-594,4978.0,0.0,-4978.0,0.0,0.0,0.0
schic002,Curt Schilling,Philadelphia Phillies,PHILS,3,3,7,10,2000,2006,6,30.94,10.08,-20.86,397,825,428,351,1810,1459,4627.0,3322.0,-1305.0,11600000.0,6125000.0,-5475000.0
schic002,Curt Schilling,Arizona Diamondbacks,DBACKS,4,10,11,21,2003,2008,5,32.54,-1.0,-33.54,2117,641,-1476,5077,396,-4681,5724.0,1159.0,-4565.0,17548667.0,6059000.0,-11489667.0
schic101,Chuck Schilling,Boston Red Sox,RSOX,2,5,3,8,1966,1966,0,-0.53,-0.7,-0.17,125,80,-45,299,29,-270,0.0,336.0,336.0,18500.0,0.0,-18500.0
schin001,Nate Schierholtz,San Francisco Giants,GIANTS,1,3,1,4,2012,2018,6,-0.86,10.45,11.31,288,772,484,953,3095,2142,6.0,0.0,-6.0,1300000.0,10400000.0,9100000.0
schir001,Ryan Schimpf,San Diego Padres,PADRS,1,1,1,2,2017,2017,0,0.0,0.0,0.0,0,0,0,0,0,0,0.0,0.0,0.0,546200.0,0.0,-546200.0
schir001,Ryan Schimpf,Tampa Bay Devil Rays,RAYS,1,1,1,2,2018,2018,0,0.0,0.0,0.0,0,0,0,0,0,0,0.0,0.0,0.0,0.0,0.0,0.0
schir001,Ryan Schimpf,Atlanta Braves,BRAVES,1,1,1,2,2018,2018,0,0.14,-0.36,-0.5,5,8,3,7,22,15,0.0,0.0,0.0,0.0,0.0,0.0
schla101,Admiral Schlei,Cincinnati Reds,REDS,3,3,9,12,1908,1925,17,7.71,59.0,51.29,556,2164,1608,1859,7745,5886,786.0,4428.0,3642.0,14391.0,23308.0,8917.0
schla101,Admiral Schlei,St. Louis Cardinals,CARDS,1,3,1,4,1908,1912,4,13.84,10.02,-3.82,1179,290,-889,3934,993,-2941,1350.0,10.0,-1340.0,0.0,0.0,0.0
schlb001,Brian Schlitter,Philadelphia Phillies,PHILS,1,1,1,2,2008,2009,1,-0.86,1.69,2.55,152,121,-31,1,0,-1,215.0,133.0,-82.0,0.0,3800000.0,3800000.0
schld001,Daniel Schlereth,Arizona Diamondbacks,DBACKS,5,9,10,19,2009,2019,10,25.87,12.08,-13.79,479,854,375,186,430,244,5327.0,4326.0,-1001.0,18334500.0,2200000.0,-16134500.0
schld101,Dutch Schliebner,Brooklyn Dodgers,DOGRS,1,1,2,3,1923,1933,10,0.14,0.11,-0.03,127,66,-61,503,57,-446,0.0,421.0,421.0,3000.0,0.0,-3000.0
schld101,Dutch Schliebner,St.Louis Browns,ORLS,29,55,62,117,1924,1952,28,152.63,143.12,-9.51,7484,11236,3752,22593,31279,8686,18747.0,30694.0,11947.0,281100.0,219150.0,-61950.0
schlg001,Gus Schlosser,Atlanta Braves,BRAVES,5,11,10,21,2015,2017,2,22.57,1.32,-21.25,930,130,-800,2591,403,-2188,1128.0,339.0,-789.0,16307500.0,20000000.0,3692500.0
schlj101,JayD Schlueter,Houston Astros,ASTROS,1,1,1,2,1973,1973,0,0.0,0.0,0.0,0,0,0,0,0,0,0.0,0.0,0.0,0.0,0.0,0.0
schlj101,JayD Schlueter,Houston Astros,ASTROS,6,9,10,19,1974,1989,15,0.9,31.67,30.77,1396,3000,1604,4891,8483,3592,0.0,5622.0,5622.0,705000.0,416000.0,-289000.0
schll101,Larry Schlafly,Boston Red Sox,RSOX,10,27,24,51,1907,1935,28,51.77,27.79,-23.98,3792,3187,-605,15081,11693,-3388,0.0,1203.0,1203.0,48850.0,29350.0,-19500.0
schlr101,Bill Schlesinger,Boston Red Sox,RSOX,1,1,1,2,1969,1969,0,0.0,-0.08,-0.08,0,53,53,0,70,70,0.0,0.0,0.0,0.0,0.0,0.0
schlr101,Bill Schlesinger,Boston Red Sox,RSOX,1,3,1,4,1967,1972,5,-0.13,11.23,11.36,5,302,297,13,404,391,0.0,3126.0,3126.0,0.0,17500.0,17500.0
schlt001,Travis Schlichting,Tampa Bay Devil Rays,RAYS,1,1,1,2,2005,2008,3,0.0,0.21,0.21,0,93,93,0,280,280,0.0,0.0,0.0,0.0,450000.0,450000.0
schmb001,Brian Schmack,Chicago White Sox,WSOX,1,2,1,3,2000,2002,2,-2.48,2.74,5.22,35,247,212,0,861,861,387.0,0.0,-387.0,200000.0,4500000.0,4300000.0
schmb101,Bob Schmidt,San Francisco Giants,GIANTS,9,17,13,30,1961,1972,11,22.69,19.49,-3.2,2066,1611,-455,6411,2790,-3621,1334.0,4789.0,3455.0,50000.0,89000.0,39000.0
schmb101,Bob Schmidt,Cincinnati Reds,REDS,1,2,2,4,1961,1966,5,3.64,1.4,-2.24,249,457,208,410,839,429,1116.0,326.0,-790.0,0.0,0.0,0.0
schmd001,Dave J. Schmidt,Texas Rangers,RNGRS,5,8,10,18,1985,1992,7,27.49,15.69,-11.8,1300,776,-524,3930,3021,-909,3469.0,327.0,-3142.0,2890539.0,357500.0,-2533039.0
schmf101,Freddy Schmidt,St. Louis Cardinals,CARDS,2,4,2,6,1947,1952,5,7.58,4.01,-3.57,327,364,37,1048,1141,93,230.0,0.0,-230.0,9000.0,0.0,-9000.0
schmj001,Jason Schmidt,Atlanta Braves,BRAVES,3,9,6,15,1996,2002,6,32.33,18.19,-14.14,1723,1238,-485,5218,2155,-3063,3645.0,2345.0,-1300.0,12631500.0,14051680.0,1420180.0
schmj001,Jason Schmidt,Pittsburgh Pirates,PIRATS,1,2,2,4,2001,2006,5,22.58,-2.33,-24.91,365,279,-86,551,301,-250,3209.0,841.0,-2368.0,5050000.0,310000.0,-4740000.0
schmj101,Johnny Schmitz,Chicago Cubs,CUBS,9,26,24,50,1951,1965,14,14.31,21.74,7.43,2452,2862,410,6527,5620,-907,3090.0,5461.0,2371.0,143500.0,125000.0,-18500.0
schmj101,Johnny Schmitz,Brooklyn Dodgers,DOGRS,1,1,1,2,1952,1952,0,0.21,0.0,-0.21,16,0,-16,6,0,-6,58.0,0.0,-58.0,0.0,0.0,0.0
schmj101,Johnny Schmitz,New York Yankees,YANKS,1,5,1,6,1952,1955,3,5.35,0.52,-4.83,390,26,-364,1419,10,-1409,46.0,107.0,61.0,0.0,13500.0,13500.0
schmj101,Johnny Schmitz,Washington Senators,TWINS,7,16,14,30,1955,1963,8,11.54,-1.9,-13.44,1150,1625,475,3478,3777,299,832.0,1792.0,960.0,17500.0,14000.0,-3500.0
schmr101,Ray Schmandt,Brooklyn Dodgers,DOGRS,1,2,1,3,1923,1926,3,0.02,18.82,18.8,141,519,378,488,2176,1688,0.0,0.0,0.0,0.0,0.0,0.0
schms001,Steve Schmoll,Los Angeles Dodgers,DOGRS,2,5,5,10,2006,2007,1,3.53,-1.15,-4.68,810,232,-578,1884,134,-1750,767.0,896.0,129.0,682000.0,4200000.0,3518000.0
schmw101,Willard Schmidt,St. Louis Cardinals,CARDS,27,56,48,104,1957,1994,37,117.05,198.75,81.7,11329,9665,-1664,30194,33834,3640,12663.0,4453.0,-8210.0,3323333.0,942667.0,-2380666.0
schnb001,Brian Schneider,Washington Nationals,NATEX,3,5,5,10,2007,2012,5,12.18,4.97,-7.21,1207,808,-399,2595,1406,-1189,688.0,605.0,-83.0,4767000.0,1203000.0,-3564000.0
schnd101,Dan Schneider,Atlanta Braves,BRAVES,1,3,3,6,1966,1970,4,-2.48,0.0,2.48,260,0,-260,50,0,-50,409.0,0.0,-409.0,0.0,0.0,0.0
schnd102,Dave Schneck,New York Mets,METS,6,9,10,19,1974,1984,10,10.05,22.43,12.38,1462,1185,-277,1334,4141,2807,2280.0,196.0,-2084.0,90000.0,0.0,-90000.0
schnd102,Dave Schneck,Philadelphia Phillies,PHILS,1,1,1,2,1975,1981,6,0.0,-0.47,-0.47,0,76,76,0,93,93,0.0,0.0,0.0,0.0,0.0,0.0
schnd102,Dave Schneck,Cincinnati Reds,REDS,2,2,2,4,1977,1979,2,4.41,-0.12,-4.53,274,99,-175,887,200,-687,0.0,0.0,0.0,0.0,0.0,0.0
schnf101,Frank Schneiberg,Brooklyn Dodgers,DOGRS,1,2,1,3,1910,1915,5,0.0,2.48,2.48,0,205,205,0,830,830,0.0,0.0,0.0,0.0,0.0,0.0
schnj101,Jeff Schneider,Baltimore Orioles,ORLS,1,2,1,3,1982,1983,1,18.92,1.8,-17.12,787,226,-561,3268,901,-2367,0.0,0.0,0.0,0.0,0.0,0.0
schod001,Dick Schofield,California Angels,ANGELS,1,2,1,3,1992,1996,4,2.15,2.22,0.07,142,49,-93,498,0,-498,0.0,723.0,723.0,1600000.0,0.0,-1600000.0
schod101,Dick Schofield,St. Louis Cardinals,CARDS,2,3,3,6,1958,1958,0,10.23,-0.59,-10.82,708,75,-633,2195,205,-1990,0.0,6.0,6.0,0.0,0.0,0.0
schod101,Dick Schofield,Pittsburgh Pirates,PIRATS,1,1,1,2,1965,1972,7,-0.4,3.44,3.84,112,625,513,439,1710,1271,0.0,0.0,0.0,0.0,0.0,0.0
schod101,Dick Schofield,New York Yankees,YANKS,1,1,2,3,1966,1966,0,1.03,0.0,-1.03,104,0,-104,351,0,-351,0.0,0.0,0.0,0.0,0.0,0.0
schod101,Dick Schofield,St. Louis Cardinals,CARDS,2,2,2,4,1968,1969,1,1.21,0.5,-0.71,242,85,-157,463,22,-441,402.0,252.0,-150.0,25000.0,53000.0,28000.0
schod101,Dick Schofield,Boston Red Sox,RSOX,1,1,1,2,1970,1970,0,0.63,0.0,-0.63,34,0,-34,72,0,-72,0.0,0.0,0.0,32000.0,0.0,-32000.0
schod101,Dick Schofield,St. Louis Cardinals,CARDS,2,4,3,7,1971,1971,0,0.65,0.42,-0.23,128,32,-96,382,84,-298,18.0,0.0,-18.0,27000.0,15000.0,-12000.0
schog102,Gerry Schoen,Seattle Pilots,BREWRS,3,5,5,10,1969,1971,2,-0.36,0.51,0.87,44,202,158,5,21,16,119.0,376.0,257.0,17500.0,26500.0,9000.0
schoj001,Jonathan Schoop,Baltimore Orioles,ORLS,2,2,4,6,2018,2020,2,-0.08,5.49,5.57,76,219,143,262,950,688,0.0,17.0,17.0,13325000.0,2550000.0,-10775000.0
schoo101,Otto Schomberg,Pittsburgh Pirates,PIRATS,1,2,1,3,1886,1886,0,0.0,0.0,0.0,0,0,0,0,0,0,0.0,0.0,0.0,0.0,0.0,0.0
schor101,Red Schoendienst,New York Giants,GIANTS,3,3,6,9,1957,1960,3,10.09,2.95,-7.14,546,495,-51,2172,1209,-963,0.0,503.0,503.0,42000.0,0.0,-42000.0
schor101,Red Schoendienst,St. Louis Cardinals,CARDS,19,44,38,82,1956,1972,16,56.42,67.4,10.98,5645,3260,-2385,13530,9157,-4373,6309.0,6165.0,-144.0,120500.0,36000.0,-84500.0
schos001,Scott Schoeneweis,Anaheim Angels,ANGELS,1,2,3,5,2003,2006,3,0.32,0.04,-0.28,41,21,-20,2,0,-2,416.0,90.0,-326.0,1425000.0,330000.0,-1095000.0
schos001,Scott Schoeneweis,Toronto Blue Jays,BJAYS,1,1,1,2,2006,2006,0,0.94,0.0,-0.94,32,0,-32,0,0,0,43.0,0.0,-43.0,2750000.0,0.0,-2750000.0
schos001,Scott Schoeneweis,New York Mets,METS,1,1,1,2,2008,2009,1,-0.7,0.0,0.7,87,0,-87,0,0,0,72.0,0.0,-72.0,3600000.0,0.0,-3600000.0
schra101,Al Schroll,Boston Red Sox,RSOX,1,1,1,2,1959,1960,1,-0.19,0.73,0.92,4,40,36,1,127,126,8.0,0.0,-8.0,0.0,0.0,0.0
schrb001,Bill Schroeder,Milwaukee Brewers,BREWRS,1,1,1,2,1988,1990,2,-0.07,-0.54,-0.47,59,97,38,203,201,-2,0.0,0.0,0.0,372500.0,97000.0,-275500.0
schrh101,Hank Schreiber,Indianapolis,Indianapolis,1,2,3,5,1926,1926,0,24.0,0.0,-24.0,988,0,-988,3984,0,-3984,0.0,0.0,0.0,0.0,9500.0,9500.0
schrh101,Hank Schreiber,Chicago Cubs,CUBS,1,1,1,2,1926,1926,0,0.0,0.0,0.0,0,0,0,0,0,0,0.0,0.0,0.0,3467.0,0.0,-3467.0
schrk001,Ken Schrom,California Angels,ANGELS,1,1,1,2,1980,1980,0,-0.15,0.01,0.16,26,21,-5,0,0,0,139.0,200.0,61.0,0.0,0.0,0.0
schrk001,Ken Schrom,Minnesota Twins,TWINS,1,2,2,4,1986,1986,0,-0.02,-0.18,-0.16,101,5,-96,0,0,0,1286.0,31.0,-1255.0,0.0,0.0,0.0
schrm001,Max Schrock,Washington Nationals,NATEX,1,1,2,3,2016,2016,0,0.0,0.35,0.35,0,28,28,0,0,0,0.0,35.0,35.0,0.0,0.0,0.0
schrm001,Max Schrock,Oakland Athletics,ATLTCS,1,2,1,3,2017,2017,0,-0.26,0.0,0.26,208,0,-208,527,0,-527,3.0,0.0,-3.0,0.0,1333333.0,1333333.0
schro101,Osee Schrecongost,Boston Red Sox,RSOX,1,1,1,2,1901,1905,4,0.11,0.74,0.63,18,448,430,74,1834,1760,0.0,0.0,0.0,0.0,0.0,0.0
schrp101,Pop Schriver,Philadelphia Phillies,PHILS,1,2,1,3,1891,1891,0,0.0,2.31,2.31,0,76,76,0,125,125,0.0,807.0,807.0,0.0,0.0,0.0
schrp101,Pop Schriver,Cincinnati Reds,REDS,1,5,3,8,1897,1900,3,8.1,12.35,4.25,718,395,-323,2747,1335,-1412,936.0,1747.0,811.0,0.0,0.0,0.0
schua001,A.J. Schugel,Anaheim Angels,ANGELS,2,4,5,9,2013,2018,5,-0.66,6.84,7.5,224,159,-65,546,24,-522,593.0,2315.0,1722.0,540000.0,0.0,-540000.0
schub101,Barney Schultz,St. Louis Cardinals,CARDS,2,2,2,4,1958,1962,4,-0.06,0.0,0.06,26,0,-26,2,0,-2,55.0,0.0,-55.0,0.0,0.0,0.0
schub101,Barney Schultz,Chicago Cubs,CUBS,1,1,1,2,1963,1963,0,2.11,-0.34,-2.45,176,27,-149,10,55,45,381.0,0.0,-381.0,0.0,0.0,0.0
schub102,Bill Schuster,Pittsburgh Pirates,PIRATS,2,3,2,5,1939,1954,15,-0.07,26.25,26.32,2,940,938,3,3857,3854,0.0,0.0,0.0,0.0,6000.0,6000.0
schub103,Bob Schultz,Chicago Cubs,CUBS,7,18,16,34,1953,1965,12,5.64,21.93,16.29,1405,1825,420,3839,2173,-1666,1451.0,4951.0,3500.0,82000.0,75000.0,-7000.0
schub104,Buddy Schultz,Chicago Cubs,CUBS,1,1,1,2,1977,1977,0,2.23,0.0,-2.23,267,0,-267,28,0,-28,632.0,0.0,-632.0,0.0,0.0,0.0
schud001,Don Schulze,Chicago Cubs,CUBS,4,14,9,23,1984,1991,7,18.76,21.66,2.9,1968,1112,-856,6227,902,-5325,1933.0,5322.0,3389.0,1746666.0,2928000.0,1181334.0
schud001,Don Schulze,Cleveland Indians,INDINS,1,1,1,2,1987,1987,0,-0.25,0.0,0.25,10,0,-10,5,0,-5,65.0,0.0,-65.0,0.0,0.0,0.0
schud001,Don Schulze,Minnesota Twins,TWINS,3,3,3,6,1988,1990,2,0.0,-0.18,-0.18,0,11,11,0,0,0,0.0,36.0,36.0,0.0,0.0,0.0
schud001,Don Schulze,New York Yankees,YANKS,1,2,2,4,1989,1990,1,-0.39,-0.36,0.03,192,13,-179,619,0,-619,73.0,249.0,176.0,575000.0,775000.0,200000.0
schud002,Dave Schuler,Cleveland Indians,INDINS,2,3,4,7,1977,1983,6,4.0,9.46,5.46,343,468,125,13,775,762,1466.0,1221.0,-245.0,85000.0,0.0,-85000.0
schue001,Erik Schullstrom,Baltimore Orioles,ORLS,1,2,1,3,1992,1992,0,-1.14,-0.08,1.06,223,5,-218,809,0,-809,0.0,99.0,99.0,0.0,2041667.0,2041667.0
schue001,Erik Schullstrom,Baltimore Orioles,ORLS,1,1,1,2,1993,1993,0,-0.25,1.35,1.6,46,33,-13,0,126,126,180.0,0.0,-180.0,0.0,450000.0,450000.0
schuf101,Fred Schulte,St.Louis Browns,ORLS,20,38,48,86,1932,1952,20,96.01,96.11,0.1,5218,8686,3468,17109,27646,10537,8613.0,15510.0,6897.0,185500.0,179450.0,-6050.0
schuf101,Fred Schulte,Milwaukee,Milwaukee,1,1,4,5,1926,1930,4,11.7,0.0,-11.7,720,0,-720,3061,0,-3061,0.0,0.0,0.0,0.0,14800.0,14800.0
schuf102,Ferdie Schupp,New York Giants,GIANTS,1,1,1,2,1919,1926,7,1.26,10.0,8.74,115,731,616,135,2428,2293,1076.0,0.0,-1076.0,4472.0,0.0,-4472.0
schuf102,Ferdie Schupp,St. Louis Cardinals,CARDS,1,2,1,3,1921,1924,3,-0.25,4.34,4.59,114,209,95,179,222,43,183.0,1768.0,1585.0,5000.0,7500.0,2500.0
schuf103,Frank Schulte,Chicago Cubs,CUBS,2,5,2,7,1916,1918,2,4.43,7.54,3.11,398,188,-210,1271,487,-784,0.0,807.0,807.0,4000.0,5500.0,1500.0
schuh101,Howie Schultz,StPaul,StPaul,1,1,2,3,1943,1943,0,0.43,0.0,-0.43,314,0,-314,1177,0,-1177,0.0,0.0,0.0,0.0,0.0,0.0
schuh104,Ham Schulte,New York Yankees,YANKS,1,1,2,3,1940,1940,0,-0.18,0.0,0.18,120,0,-120,488,0,-488,0.0,0.0,0.0,0.0,0.0,0.0
schuj002,Jaime Schultz,Tampa Bay Devil Rays,RAYS,1,1,1,2,2019,2019,0,-0.06,0.0,0.06,8,0,-8,0,0,0,15.0,0.0,-15.0,0.0,0.0,0.0
schuj101,Joe Schultz,Brooklyn Dodgers,DOGRS,1,2,1,3,1915,1919,4,-0.02,6.73,6.75,7,245,238,8,251,243,0.0,2183.0,2183.0,3500.0,7000.0,3500.0
schuj103,Joe Schultz,Pittsburgh Pirates,PIRATS,1,2,1,3,1941,1948,7,0.0,-0.37,-0.37,0,16,16,0,56,56,0.0,0.0,0.0,0.0,0.0,0.0
schuj106,Johnny Schulte,St. Louis Cardinals,CARDS,1,2,3,5,1927,1928,1,-1.19,0.0,1.19,135,0,-135,192,0,-192,529.0,0.0,-529.0,13300.0,8850.0,-4450.0
schum101,Mike Schultz,Cincinnati Reds,REDS,1,1,1,2,1949,1954,5,0.0,0.01,0.01,0,12,12,0,0,0,0.0,21.0,21.0,0.0,0.0,0.0
schup001,Patrick Schuster,Houston Astros,ASTROS,1,1,2,3,2013,2014,1,0.0,-0.87,-0.87,0,21,21,0,0,0,0.0,81.0,81.0,0.0,503600.0,503600.0
schur001,Rick Schu,Philadelphia Phillies,PHILS,2,4,3,7,1988,1988,0,-2.46,0.71,3.17,165,85,-80,504,178,-326,0.0,49.0,49.0,395000.0,0.0,-395000.0
schur101,Ron Schueler,Atlanta Braves,BRAVES,4,6,8,14,1973,1984,11,24.13,-0.92,-25.05,1923,1694,-229,5515,5664,149,1329.0,128.0,-1201.0,0.0,135000.0,135000.0
schus001,Skip Schumaker,St. Louis Cardinals,CARDS,1,1,1,2,2012,2012,0,-1.21,0.0,1.21,127,0,-127,356,0,-356,6.0,0.0,-6.0,1500000.0,0.0,-1500000.0
schuw101,Wes Schulmerich,Chicago Cubs,CUBS,3,9,5,14,1930,1941,11,5.24,32.0,26.76,900,1038,138,2126,2153,27,2562.0,5533.0,2971.0,3600.0,16000.0,12400.0
schuw101,Wes Schulmerich,Philadelphia Phillies,PHILS,1,3,2,5,1934,1941,7,-1.11,22.67,23.78,139,911,772,269,2270,2001,324.0,2379.0,2055.0,0.0,0.0,0.0
schuw101,Wes Schulmerich,Boston Braves,BRAVES,3,4,4,8,1933,1938,5,5.87,7.69,1.82,599,982,383,2168,3856,1688,0.0,0.0,0.0,0.0,0.0,0.0
schuw102,Wayne Schurr,Chicago Cubs,CUBS,1,2,2,4,1966,1966,0,0.0,0.0,0.0,0,0,0,0,0,0,0.0,0.0,0.0,0.0,0.0,0.0
schuw103,Walt Schulz,St. Louis Cardinals,CARDS,1,3,1,4,1921,1921,0,0.0,-0.04,-0.04,0,22,22,0,57,57,0.0,0.0,0.0,0.0,0.0,0.0
schwd101,Don Schwall,Boston Red Sox,RSOX,5,6,7,13,1962,1974,12,12.31,8.2,-4.11,890,1047,157,2393,1626,-767,1125.0,3389.0,2264.0,80500.0,77000.0,-3500.0
schwd101,Don Schwall,Pittsburgh Pirates,PIRATS,1,1,1,2,1966,1967,1,0.04,-0.39,-0.43,24,129,105,13,46,33,138.0,474.0,336.0,0.0,0.0,0.0
schwj001,Jeff Schwarz,Chicago White Sox,WSOX,1,1,1,2,1994,1994,0,0.1,-0.26,-0.36,4,11,7,0,21,21,20.0,0.0,-20.0,150000.0,0.0,-150000.0
schwk001,Kyle Schwarber,Washington Nationals,NATEX,1,1,1,2,2021,2021,0,1.33,0.0,-1.33,41,0,-41,168,0,-168,0.0,0.0,0.0,7000000.0,0.0,-7000000.0
schwm002,Michael Schwimer,Philadelphia Phillies,PHILS,1,1,1,2,2013,2013,0,0.0,0.0,0.0,0,0,0,0,0,0,0.0,0.0,0.0,0.0,0.0,0.0
scorh101,Herb Score,Cleveland Indians,INDINS,10,17,16,33,1960,1978,18,27.0,14.62,-12.38,2306,1988,-318,5446,5961,515,3368.0,3141.0,-227.0,115500.0,141500.0,26000.0
scotd001,Donnie Scott,Texas Rangers,RNGRS,2,2,2,4,1985,1987,2,-0.53,-0.41,0.12,90,46,-44,229,112,-117,0.0,0.0,0.0,0.0,0.0,0.0
scotd102,Dick Scott,Los Angeles Dodgers,DOGRS,2,2,3,5,1963,1975,12,1.11,15.76,14.65,40,959,919,0,118,118,177.0,2487.0,2310.0,0.0,0.0,0.0
scote101,Everett Scott,Boston Red Sox,RSOX,10,21,30,51,1921,1937,16,73.06,40.4,-32.66,4195,2010,-2185,13395,5364,-8031,9458.0,7949.0,-1509.0,78550.0,54250.0,-24300.0
scotg001,Gary Scott,Chicago Cubs,CUBS,1,2,1,3,1992,1993,1,1.43,0.32,-1.11,423,63,-360,1012,70,-942,0.0,573.0,573.0,116000.0,0.0,-116000.0
scotg001,Gary Scott,Florida Marlins,MARLNS,1,2,1,3,1993,1996,3,2.43,5.1,2.67,405,217,-188,18,182,164,808.0,1519.0,711.0,0.0,0.0,0.0
scotg001,Gary Scott,Cincinnati Reds,REDS,1,1,2,3,1993,1993,0,0.0,0.0,0.0,0,0,0,0,0,0,0.0,0.0,0.0,0.0,0.0,0.0
scotg102,George Scott,Boston Red Sox,RSOX,5,10,10,20,1971,1977,6,35.42,11.92,-23.5,1569,736,-833,4628,2092,-2536,3846.0,2344.0,-1502.0,155000.0,100500.0,-54500.0
scotg102,George Scott,Milwaukee Brewers,BREWRS,1,2,1,3,1976,1976,0,4.95,0.0,-4.95,442,0,-442,1687,0,-1687,0.0,0.0,0.0,150000.0,0.0,-150000.0
scotg102,George Scott,Boston Red Sox,RSOX,1,1,1,2,1979,1981,2,0.0,0.0,0.0,44,66,22,162,172,10,0.0,0.0,0.0,200000.0,0.0,-200000.0
scotj101,Jack Scott,Boston Braves,BRAVES,1,1,2,3,1922,1925,3,-0.04,0.46,0.5,2,344,342,1,722,721,3.0,1636.0,1633.0,0.0,0.0,0.0
scotj101,Jack Scott,New York Giants,GIANTS,6,15,10,25,1927,1949,22,30.29,66.01,35.72,2286,3209,923,6995,11614,4619,4737.0,1177.0,-3560.0,10500.0,25000.0,14500.0
scotj102,John Scott,Toronto Blue Jays,BJAYS,8,15,14,29,1977,1987,10,28.86,22.15,-6.71,2801,2757,-44,8515,8792,277,3123.0,3581.0,458.0,669000.0,240000.0,-429000.0
scotj102,John Scott,St. Louis Cardinals,CARDS,1,1,1,2,1978,1979,1,0.0,0.0,0.0,0,0,0,0,0,0,0.0,0.0,0.0,0.0,0.0,0.0
scotl001,Luke Scott,Cleveland Indians,INDINS,2,2,2,4,2004,2004,0,3.53,-1.31,-4.84,231,10,-221,763,0,-763,0.0,42.0,42.0,0.0,0.0,0.0
scotl001,Luke Scott,Houston Astros,ASTROS,1,5,1,6,2007,2009,2,11.62,3.81,-7.81,860,316,-544,1797,1340,-457,1330.0,0.0,-1330.0,382000.0,13811415.0,13429415.0
scotm001,Mike Scott,New York Mets,METS,1,1,1,2,1982,1986,4,23.81,0.98,-22.83,527,395,-132,622,1054,432,5112.0,0.0,-5112.0,0.0,0.0,0.0
scotm101,Mickey Scott,New York Yankees,YANKS,1,2,1,3,1969,1971,2,0.0,0.42,0.42,0,66,66,0,87,87,0.0,0.0,0.0,0.0,28500.0,28500.0
scotm101,Mickey Scott,Chicago White Sox,WSOX,1,1,1,2,1970,1970,0,0.33,0.0,-0.33,31,0,-31,3,0,-3,74.0,0.0,-74.0,0.0,0.0,0.0
scotm101,Mickey Scott,Montreal Expos,NATEX,1,1,1,2,1974,1975,1,0.0,0.5,0.5,0,117,117,0,13,13,0.0,301.0,301.0,0.0,0.0,0.0
scotm101,Mickey Scott,Baltimore Orioles,ORLS,1,2,1,3,1974,1974,0,-0.27,-0.11,0.16,98,9,-89,0,20,20,370.0,0.0,-370.0,0.0,55000.0,55000.0
scotm101,Mickey Scott,California Angels,ANGELS,1,1,1,2,1978,1978,0,0.0,0.0,0.0,0,0,0,0,0,0,0.0,0.0,0.0,0.0,0.0,0.0
scotp101,Pete Scott,KansasCity,KansasCity,1,1,3,4,1924,1931,7,0.0,0.0,0.0,0,0,0,0,0,0,0.0,0.0,0.0,0.0,2800.0,2800.0
scotp101,Pete Scott,Chicago Cubs,CUBS,1,2,1,3,1927,1935,8,1.8,26.3,24.5,269,949,680,1048,4196,3148,0.0,0.0,0.0,15500.0,11000.0,-4500.0
scotr101,Rodney Scott,Kansas City Royals,ROYALS,1,1,1,2,1975,1976,1,2.75,2.74,-0.01,421,142,-279,1741,417,-1324,0.0,0.0,0.0,0.0,0.0,0.0
scotr101,Rodney Scott,Montreal Expos,NATEX,1,1,1,2,1977,1977,0,0.0,-0.31,-0.31,0,26,26,0,1,1,0.0,62.0,62.0,0.0,0.0,0.0
scotr101,Rodney Scott,Texas Rangers,RNGRS,6,12,10,22,1977,1982,5,21.67,6.59,-15.08,1054,693,-361,2707,1819,-888,4329.0,810.0,-3519.0,313000.0,280000.0,-33000.0
scotr101,Rodney Scott,Oakland Athletics,ATLTCS,1,2,1,3,1978,1978,0,0.99,-0.55,-1.54,78,35,-43,280,0,-280,0.0,497.0,497.0,0.0,0.0,0.0
scotr101,Rodney Scott,Chicago Cubs,CUBS,1,2,1,3,1978,1979,1,3.97,-0.08,-4.05,798,31,-767,2458,14,-2444,0.0,0.0,0.0,0.0,0.0,0.0
scott001,Tony Scott,Montreal Expos,NATEX,3,6,6,12,1976,1983,7,4.1,3.12,-0.98,573,1002,429,1861,2648,787,25.0,308.0,283.0,0.0,0.0,0.0
scott001,Tony Scott,St. Louis Cardinals,CARDS,4,4,6,10,1981,1992,11,19.1,11.83,-7.27,956,729,-227,2639,1319,-1320,2317.0,4643.0,2326.0,1943333.0,497500.0,-1445833.0
scott002,Tim Scott,San Diego Padres,PADRS,1,1,1,2,1993,1994,1,3.1,-1.48,-4.58,358,143,-215,12,464,452,591.0,0.0,-591.0,125000.0,130000.0,5000.0
scott002,Tim Scott,Montreal Expos,NATEX,1,2,1,3,1996,1996,0,12.18,0.67,-11.51,598,24,-574,619,29,-590,4901.0,209.0,-4692.0,860000.0,1850000.0,990000.0
scott004,Tayler Scott,Milwaukee Brewers,BREWRS,1,1,1,2,2017,2019,2,0.0,3.37,3.37,0,276,276,0,3,3,0.0,460.0,460.0,0.0,2100000.0,2100000.0
scrie001,Evan Scribner,Arizona Diamondbacks,DBACKS,1,1,1,2,2008,2009,1,-0.23,-0.63,-0.4,19,74,55,0,155,155,42.0,0.0,-42.0,0.0,900000.0,900000.0
scrie001,Evan Scribner,Oakland Athletics,ATLTCS,1,1,1,2,2015,2015,0,0.4,0.0,-0.4,20,0,-20,0,0,0,64.0,0.0,-64.0,512500.0,0.0,-512500.0
scrua001,Andre Scrubb,Los Angeles Dodgers,DOGRS,1,1,1,2,2019,2020,1,0.89,-0.46,-1.35,38,12,-26,0,26,26,130.0,0.0,-130.0,0.0,582900.0,582900.0
scuds001,Scott Scudder,Cincinnati Reds,REDS,1,3,1,4,1991,1992,1,-2.2,4.96,7.16,60,62,2,0,87,87,839.0,641.0,-198.0,215000.0,2025000.0,1810000.0
scurr001,Rod Scurry,San Francisco Giants,GIANTS,1,1,1,2,1988,1990,2,0.23,1.05,0.82,39,154,115,0,266,266,94.0,0.0,-94.0,0.0,0.0,0.0
scutm001,Marco Scutaro,Cleveland Indians,INDINS,3,6,5,11,2000,2007,7,13.63,7.12,-6.51,820,378,-442,2478,197,-2281,718.0,1361.0,643.0,5247000.0,9550000.0,4303000.0
scutm001,Marco Scutaro,Oakland Athletics,ATLTCS,2,2,3,5,2007,2012,5,9.81,-0.44,-10.25,289,11,-278,1272,2,-1270,0.0,138.0,138.0,2030000.0,0.0,-2030000.0
scutm001,Marco Scutaro,Boston Red Sox,RSOX,2,2,2,4,2012,2013,1,0.05,0.75,0.7,95,66,-29,415,11,-404,0.0,217.0,217.0,504500.0,0.0,-504500.0
scutm001,Marco Scutaro,Colorado Rockies,ROCKS,1,2,1,3,2012,2015,3,4.02,-1.89,-5.91,193,142,-51,828,337,-491,0.0,0.0,0.0,6000000.0,0.0,-6000000.0
seabc001,Conner Seabold,Philadelphia Phillies,PHILS,1,2,2,4,2020,2020,0,3.19,-0.87,-4.06,36,25,-11,2,0,-2,504.0,67.0,-437.0,0.0,5113000.0,5113000.0
seamk101,Kim Seaman,New York Mets,METS,1,2,1,3,1978,1982,4,0.21,5.06,4.85,63,290,227,20,185,165,77.0,1823.0,1746.0,0.0,0.0,0.0
seamk101,Kim Seaman,St. Louis Cardinals,CARDS,9,26,18,44,1980,1992,12,83.63,101.91,18.28,6733,4351,-2382,20851,14642,-6209,6532.0,3025.0,-3507.0,1533333.0,576667.0,-956666.0
seamk101,Kim Seaman,San Diego Padres,PADRS,2,2,2,4,1982,1983,1,0.0,0.01,0.01,0,16,16,0,7,7,0.0,31.0,31.0,0.0,0.0,0.0
seanr001,Rudy Seanez,Cleveland Indians,INDINS,1,1,2,3,1991,1993,2,0.4,1.32,0.92,249,76,-173,3,0,-3,403.0,725.0,322.0,0.0,240000.0,240000.0
seanr001,Rudy Seanez,Los Angeles Dodgers,DOGRS,1,1,1,2,1992,1993,1,0.0,0.37,0.37,0,132,132,0,504,504,0.0,0.0,0.0,0.0,0.0,0.0
seanr001,Rudy Seanez,San Diego Padres,PADRS,2,2,2,4,2001,2002,1,0.2,0.0,-0.2,24,0,-24,0,0,0,36.0,0.0,-36.0,0.0,0.0,0.0
seanr001,Rudy Seanez,Kansas City Royals,ROYALS,1,1,1,2,2004,2005,1,0.52,-0.52,-1.04,46,59,13,0,247,247,69.0,0.0,-69.0,0.0,300000.0,300000.0
seark101,Ken Sears,New York Yankees,YANKS,2,3,4,7,1946,1948,2,0.12,0.0,-0.12,13,0,-13,18,0,-18,12.0,0.0,-12.0,0.0,0.0,0.0
searr001,Ray Searage,St. Louis Cardinals,CARDS,1,1,1,2,1979,1980,1,0.34,0.0,-0.34,52,0,-52,1,0,-1,110.0,0.0,-110.0,0.0,0.0,0.0
searr001,Ray Searage,New York Mets,METS,2,2,3,5,1982,1983,1,-1.38,-0.21,1.17,103,40,-63,175,58,-117,0.0,0.0,0.0,0.0,0.0,0.0
searr001,Ray Searage,Milwaukee Brewers,BREWRS,1,1,2,3,1986,1986,0,1.98,0.0,-1.98,87,0,-87,0,0,0,254.0,0.0,-254.0,121500.0,0.0,-121500.0
sears001,Steve Searcy,Philadelphia Phillies,PHILS,1,2,1,3,1992,1992,0,0.0,1.64,1.64,0,74,74,0,313,313,0.0,0.0,0.0,175000.0,715000.0,540000.0
seart001,Todd Sears,Colorado Rockies,ROCKS,3,7,6,13,2000,2002,2,3.49,2.57,-0.92,364,438,74,1382,1550,168,0.0,3.0,3.0,1050000.0,2422500.0,1372500.0
seart001,Todd Sears,Minnesota Twins,TWINS,1,1,1,2,2003,2003,0,0.04,0.0,-0.04,9,0,-9,8,0,-8,0.0,0.0,0.0,0.0,0.0,0.0
seavt001,Tom Seaver,New York Mets,METS,8,14,12,26,1977,1986,9,27.43,13.87,-13.56,2407,2813,406,3829,9573,5744,5804.0,2225.0,-3579.0,395000.0,413000.0,18000.0
seavt001,Tom Seaver,Cincinnati Reds,REDS,2,2,4,6,1982,1990,8,2.12,-0.96,-3.08,209,318,109,504,692,188,693.0,497.0,-196.0,450000.0,62500.0,-387500.0
seavt001,Tom Seaver,Chicago White Sox,WSOX,1,1,1,2,1986,1991,5,1.94,1.71,-0.23,16,498,482,0,1529,1529,313.0,6.0,-307.0,1132652.0,0.0,-1132652.0
seayb001,Bobby Seay,Tampa Bay Devil Rays,RAYS,1,1,1,2,2005,2005,0,-0.31,-0.04,0.27,31,11,-20,0,24,24,35.0,0.0,-35.0,0.0,0.0,0.0
sebrb001,Bob Sebra,Texas Rangers,RNGRS,1,2,1,3,1985,1991,6,2.79,7.32,4.53,107,694,587,87,2718,2631,806.0,0.0,-806.0,0.0,0.0,0.0
sebrb001,Bob Sebra,Montreal Expos,NATEX,1,1,1,2,1988,1988,0,-0.53,0.0,0.53,18,0,-18,18,0,-18,137.0,0.0,-137.0,0.0,0.0,0.0
sebrb001,Bob Sebra,Philadelphia Phillies,PHILS,1,1,1,2,1989,1990,1,-0.48,0.0,0.48,30,0,-30,1,0,-1,63.0,0.0,-63.0,0.0,0.0,0.0
sebrb001,Bob Sebra,Cincinnati Reds,REDS,1,2,2,4,1990,1992,2,2.39,3.07,0.68,42,257,215,0,822,822,597.0,0.0,-597.0,500000.0,675000.0,175000.0
sebrj101,Jimmy Sebring,Pittsburgh Pirates,PIRATS,3,7,4,11,1904,1910,6,14.19,23.57,9.38,1717,639,-1078,6091,1726,-4365,2702.0,3643.0,941.0,0.0,0.0,0.0
sebrj101,Jimmy Sebring,Cincinnati Reds,REDS,2,4,3,7,1905,1910,5,18.64,12.54,-6.1,746,275,-471,3017,389,-2628,9.0,2982.0,2973.0,0.0,0.0,0.0
secrd101,Don Secrist,Cincinnati Reds,REDS,2,3,3,6,1968,1970,2,-0.45,-1.78,-1.33,134,68,-66,227,36,-191,164.0,339.0,175.0,21500.0,31000.0,9500.0
sedls001,Shawn Sedlacek,Kansas City Royals,ROYALS,1,1,1,2,2004,2005,1,0.0,0.63,0.63,0,76,76,0,0,0,0.0,194.0,194.0,0.0,0.0,0.0
see-c101,Charlie See,Rochester,Rochester,1,1,1,2,1919,1919,0,-0.29,0.0,0.29,93,0,-93,221,0,-221,18.0,0.0,-18.0,0.0,0.0,0.0
see-l001,Larry See,Los Angeles Dodgers,DOGRS,1,1,1,2,1987,1988,1,-0.44,0.0,0.44,13,0,-13,25,0,-25,0.0,0.0,0.0,0.0,0.0,0.0
seedb101,Bob Seeds,Cleveland Indians,INDINS,2,3,3,6,1932,1938,6,-0.54,9.51,10.05,286,513,227,1117,1176,59,0.0,1369.0,1369.0,22500.0,11500.0,-11000.0
seedb101,Bob Seeds,Chicago White Sox,WSOX,2,7,3,10,1932,1936,4,0.81,-0.11,-0.92,234,49,-185,748,93,-655,0.0,39.0,39.0,8600.0,12500.0,3900.0
seedb101,Bob Seeds,Boston Red Sox,RSOX,4,10,7,17,1934,1940,6,25.17,35.69,10.52,1726,1087,-639,6233,3303,-2930,2563.0,4057.0,1494.0,43500.0,48000.0,4500.0
seedb101,Bob Seeds,Montreal,Montreal,1,1,2,3,1936,1936,0,0.31,0.0,-0.31,13,0,-13,47,0,-47,0.0,0.0,0.0,0.0,0.0,0.0
seelc001,Chris Seelbach,Atlanta Braves,BRAVES,1,1,1,2,1995,1995,0,0.0,0.1,0.1,0,28,28,0,0,0,0.0,39.0,39.0,0.0,0.0,0.0
seerp101,Pat Seerey,Cleveland Indians,INDINS,2,3,2,5,1948,1955,7,0.72,3.02,2.3,315,566,251,926,1749,823,633.0,0.0,-633.0,0.0,0.0,0.0
segeh101,Herman Segelke,Chicago Cubs,CUBS,2,2,3,5,1982,1985,3,-0.09,-0.14,-0.05,5,32,27,0,15,15,39.0,144.0,105.0,0.0,0.0,0.0
seger001,Rob Segedin,New York Yankees,YANKS,1,2,2,4,2016,2016,0,-0.23,0.27,0.5,53,73,20,103,169,66,0.0,8.0,8.0,0.0,0.0,0.0
segrk101,Kal Segrist,New York Yankees,YANKS,12,33,27,60,1954,1970,16,40.55,76.98,36.43,5201,4368,-833,16466,10777,-5689,3212.0,10751.0,7539.0,302500.0,109500.0,-193000.0
segud001,David Segui,Baltimore Orioles,ORLS,1,1,2,3,1994,1994,0,-0.63,0.0,0.63,125,0,-125,467,0,-467,0.0,0.0,0.0,0.0,0.0,0.0
segud001,David Segui,New York Mets,METS,9,18,15,33,1995,2005,10,9.72,6.12,-3.6,1692,2076,384,3051,3138,87,2422.0,2911.0,489.0,20343890.0,14951666.0,-5392224.0
segud001,David Segui,Seattle Mariners,MARNRS,2,3,3,6,1999,2001,2,0.61,1.56,0.95,215,177,-38,234,469,235,215.0,104.0,-111.0,4350000.0,1750000.0,-2600000.0
segud001,David Segui,Toronto Blue Jays,BJAYS,2,3,2,5,2000,2002,2,5.81,2.22,-3.59,286,281,-5,1103,1097,-6,0.0,25.0,25.0,0.0,0.0,0.0
segud001,David Segui,Texas Rangers,RNGRS,1,1,1,2,2000,2001,1,0.96,-1.73,-2.69,57,136,79,245,512,267,0.0,0.0,0.0,4325000.0,0.0,-4325000.0
segud101,Diego Segui,Washington Senators,RNGRS,1,1,1,2,1966,1966,0,5.15,-0.42,-5.57,336,10,-326,126,3,-123,1453.0,43.0,-1410.0,12000.0,0.0,-12000.0
segud101,Diego Segui,Milwaukee Brewers,BREWRS,16,29,31,60,1969,1986,17,56.11,55.7,-0.41,3782,3364,-418,9776,9018,-758,7371.0,9266.0,1895.0,829901.0,70000.0,-759901.0
segud101,Diego Segui,St. Louis Cardinals,CARDS,22,50,41,91,1973,1994,21,106.47,161.96,55.49,10190,8695,-1495,28502,26542,-1960,13842.0,9162.0,-4680.0,3130333.0,1562167.0,-1568166.0
seguf001,Fernando Seguignol,New York Yankees,YANKS,1,2,1,3,1995,1996,1,-0.58,4.06,4.64,173,123,-50,394,0,-394,0.0,375.0,375.0,0.0,0.0,0.0
seguj002,Jean Segura,Anaheim Angels,ANGELS,1,3,1,4,2012,2012,0,4.26,1.47,-2.79,508,13,-495,1945,0,-1945,179.0,268.0,89.0,0.0,13500000.0,13500000.0
seguj002,Jean Segura,Milwaukee Brewers,BREWRS,6,11,10,21,2016,2020,4,-0.37,15.97,16.34,772,552,-220,2514,1371,-1143,401.0,1885.0,1484.0,6500000.0,0.0,-6500000.0
seguj002,Jean Segura,Arizona Diamondbacks,DBACKS,1,3,2,5,2016,2019,3,21.55,3.22,-18.33,745,61,-684,3265,58,-3207,14.0,514.0,500.0,2600000.0,1044000.0,-1556000.0
seguj002,Jean Segura,Seattle Mariners,MARNRS,3,7,5,12,2018,2019,1,12.9,2.05,-10.85,683,65,-618,2542,289,-2253,142.0,0.0,-142.0,17350000.0,37545833.0,20195833.0
seibp001,Phil Seibel,Montreal Expos,NATEX,5,10,12,22,2002,2011,9,5.61,14.61,9.0,687,585,-102,161,612,451,1873.0,3946.0,2073.0,8655000.0,550000.0,-8105000.0
seibp001,Phil Seibel,Boston Red Sox,RSOX,1,1,1,2,2006,2007,1,0.0,0.55,0.55,0,29,29,0,0,0,0.0,62.0,62.0,0.0,950000.0,950000.0
seibs101,Socks Seibold,Chicago Cubs,CUBS,1,6,1,7,1928,1932,4,4.13,16.12,11.99,1036,317,-719,2232,1321,-911,4216.0,0.0,-4216.0,13000.0,30600.0,17600.0
seitk001,Kevin Seitzer,Milwaukee Brewers,BREWRS,3,8,7,15,1996,2004,8,1.87,17.53,15.66,400,1175,775,1247,3930,2683,437.0,1049.0,612.0,3900000.0,690000.0,-3210000.0
selbk101,Kip Selbach,Washington Senators,TWINS,1,1,1,2,1904,1904,0,4.98,-1.37,-6.35,279,95,-184,1192,397,-795,0.0,0.0,0.0,0.0,0.0,0.0
selea001,Aaron Sele,Boston Red Sox,RSOX,4,7,7,14,1997,2000,3,8.97,2.55,-6.42,585,374,-211,1634,946,-688,1253.0,139.0,-1114.0,5063500.0,700000.0,-4363500.0
selld101,Dave Sells,California Angels,ANGELS,1,1,1,2,1975,1975,0,0.0,1.05,1.05,10,21,11,1,0,-1,21.0,104.0,83.0,0.0,0.0,0.0
sellj001,Jeff Sellers,Boston Red Sox,RSOX,3,6,4,10,1988,1993,5,-2.7,4.47,7.17,436,419,-17,1235,872,-363,258.0,1268.0,1010.0,397000.0,3235000.0,2838000.0
sellj002,Justin Sellers,Oakland Athletics,ATLTCS,1,2,1,3,2009,2011,2,0.0,1.6,1.6,0,173,173,0,0,0,0.0,456.0,456.0,0.0,0.0,0.0
selmd101,Dick Selma,San Diego Padres,PADRS,9,11,16,27,1969,1978,9,13.9,9.38,-4.52,735,2260,1525,715,5015,4300,4453.0,3197.0,-1256.0,59500.0,168000.0,108500.0
selmd101,Dick Selma,Chicago Cubs,CUBS,2,3,3,6,1969,1974,5,1.23,0.0,-1.23,677,440,-237,1258,890,-368,797.0,392.0,-405.0,0.0,0.0,0.0
selms001,Sam Selman,San Francisco Giants,GIANTS,1,3,1,4,2021,2021,0,-0.36,0.65,1.01,27,52,25,0,0,0,63.0,73.0,10.0,0.0,1000000.0,1000000.0
selpc101,Carey Selph,Chicago White Sox,WSOX,1,2,1,3,1932,1932,0,1.87,0.41,-1.46,283,14,-269,1288,61,-1227,0.0,0.0,0.0,5000.0,0.0,-5000.0
sembc101,Carroll Sembera,Montreal Expos,NATEX,1,1,1,2,1970,1970,0,0.0,-0.22,-0.22,0,36,36,0,2,2,0.0,92.0,92.0,0.0,0.0,0.0
sembc101,Carroll Sembera,St. Louis Cardinals,CARDS,2,2,2,4,1971,1975,4,0.0,-0.44,-0.44,0,35,35,0,53,53,0.0,0.0,0.0,0.0,0.0,0.0
semia101,Andy Seminick,Philadelphia Phillies,PHILS,3,8,7,15,1951,1957,6,12.59,16.8,4.21,922,1010,88,2813,3409,596,109.0,186.0,77.0,63000.0,37500.0,-25500.0
semia101,Andy Seminick,Cincinnati Reds,REDS,5,10,14,24,1955,1965,10,64.57,18.03,-46.54,3586,1613,-1973,11340,3264,-8076,2563.0,1025.0,-1538.0,13500.0,15500.0,2000.0
semif001,Frank Seminara,San Diego Padres,PADRS,2,4,3,7,1993,2000,7,-0.42,-0.7,-0.28,28,54,26,3,11,8,67.0,168.0,101.0,326000.0,0.0,-326000.0
semim001,Marcus Semien,Chicago White Sox,WSOX,1,4,2,6,2014,2018,4,32.02,0.52,-31.5,1179,80,-1099,4237,2,-4235,1580.0,819.0,-761.0,500000.0,5345000.0,4845000.0
sempr101,Ray Semproch,Philadelphia Phillies,PHILS,1,2,3,5,1959,1962,3,0.43,-1.4,-1.83,456,279,-177,1595,804,-791,81.0,0.0,-81.0,9000.0,0.0,-9000.0
sempr101,Ray Semproch,Detroit Tigers,TIGRS,1,2,1,3,1960,1960,0,0.0,-0.36,-0.36,0,28,28,0,2,2,0.0,58.0,58.0,9000.0,28000.0,19000.0
senes101,Sonny Senerchia,St. Louis Cardinals,CARDS,16,37,31,68,1956,1972,16,46.04,61.47,15.43,4532,2723,-1809,10204,7606,-2598,7123.0,5609.0,-1514.0,32500.0,36000.0,3500.0
sents101,Steve Senteney,Toronto Blue Jays,BJAYS,2,2,2,4,1983,1985,2,1.28,-1.43,-2.71,359,208,-151,1182,557,-625,0.0,0.0,0.0,250000.0,0.0,-250000.0
sents101,Steve Senteney,New York Mets,METS,1,2,2,4,1983,1984,1,-1.75,-1.63,0.12,360,108,-252,1480,288,-1192,0.0,0.0,0.0,0.0,0.0,0.0
seo-j001,Jae Weong Seo,New York Mets,METS,1,2,2,4,2006,2009,3,-1.08,1.54,2.62,102,224,122,21,3,-18,303.0,341.0,38.0,0.0,0.0,0.0
seo-j001,Jae Weong Seo,Los Angeles Dodgers,DOGRS,1,3,3,6,2006,2007,1,1.99,-0.07,-2.06,586,130,-456,1881,113,-1768,426.0,593.0,167.0,682000.0,4200000.0,3518000.0
seoam101,Manny Seoane,Philadelphia Phillies,PHILS,1,1,1,2,1977,1979,2,-0.09,-0.61,-0.52,14,116,102,0,282,282,25.0,0.0,-25.0,0.0,150000.0,150000.0
serad001,Dan Serafini,Chicago Cubs,CUBS,1,1,1,2,1999,1999,0,-0.23,0.0,0.23,6,0,-6,0,0,0,9.0,0.0,-9.0,200000.0,0.0,-200000.0
serad001,Dan Serafini,San Diego Padres,PADRS,1,1,1,2,2000,2000,0,0.75,0.0,-0.75,22,0,-22,27,0,-27,187.0,0.0,-187.0,230000.0,0.0,-230000.0
serrj001,Jimmy Serrano,Montreal Expos,NATEX,1,2,1,3,2002,2002,0,1.77,-0.23,-2.0,288,13,-275,1125,14,-1111,0.0,0.0,0.0,0.0,0.0,0.0
serrw001,Wascar Serrano,San Diego Padres,PADRS,3,8,7,15,2001,2006,5,0.42,8.49,8.07,330,730,400,847,2213,1366,693.0,843.0,150.0,3727500.0,2445000.0,-1282500.0
servs001,Scott Service,Cincinnati Reds,REDS,5,11,7,18,1995,2010,15,11.19,26.95,15.76,438,1436,998,728,5040,4312,2595.0,2089.0,-506.0,13266667.0,6562778.0,-6703889.0
servs001,Scott Service,Cincinnati Reds,REDS,6,8,9,17,1997,2013,16,0.95,26.14,25.19,565,1375,810,1114,3203,2089,629.0,5071.0,4442.0,600000.0,0.0,-600000.0
servs002,Scott Servais,Houston Astros,ASTROS,2,4,2,6,1995,1996,1,9.88,0.54,-9.34,757,136,-621,2742,446,-2296,0.0,0.0,0.0,3390000.0,1875000.0,-1515000.0
sevea101,Al Severinsen,Baltimore Orioles,ORLS,10,29,24,53,1970,1988,18,23.09,129.53,106.44,2838,6114,3276,6187,12778,6591,10078.0,22814.0,12736.0,733833.0,72500.0,-661333.0
sevea101,Al Severinsen,San Diego Padres,PADRS,1,1,1,2,1972,1973,1,0.0,0.19,0.19,0,39,39,0,59,59,0.0,0.0,0.0,0.0,0.0,0.0
seveh101,Hank Severeid,St.Louis Browns,ORLS,28,56,65,121,1925,1952,27,169.27,185.55,16.28,8509,11840,3331,28645,39537,10892,13765.0,19385.0,5620.0,253500.0,236650.0,-16850.0
sewel101,Luke Sewell,Cleveland Indians,INDINS,1,1,1,2,1933,1934,1,1.78,-0.44,-2.22,213,80,-133,769,265,-504,0.0,0.0,0.0,0.0,0.0,0.0
sewel101,Luke Sewell,Washington Senators,TWINS,2,4,3,7,1935,1939,4,4.36,3.29,-1.07,361,407,46,554,735,181,2260.0,2671.0,411.0,0.0,0.0,0.0
sexsr001,Richie Sexson,Cleveland Indians,INDINS,3,6,5,11,2000,2007,7,13.63,7.12,-6.51,820,378,-442,2478,197,-2281,718.0,1361.0,643.0,5247000.0,9550000.0,4303000.0
sexsr001,Richie Sexson,Milwaukee Brewers,BREWRS,6,12,13,25,2003,2012,9,37.27,23.81,-13.46,2463,1970,-493,9279,4716,-4563,883.0,6330.0,5447.0,8747000.0,19975667.0,11228667.0
sextc001,Chris Sexton,Cincinnati Reds,REDS,1,1,1,2,1995,1995,0,-0.24,0.0,0.24,35,0,-35,70,0,-70,0.0,0.0,0.0,0.0,0.0,0.0
sextj101,Jimmy Sexton,Pittsburgh Pirates,PIRATS,1,2,1,3,1976,1981,5,3.27,4.64,1.37,297,554,257,1099,51,-1048,0.0,1061.0,1061.0,0.0,0.0,0.0
sextj101,Jimmy Sexton,Seattle Mariners,MARNRS,3,8,8,16,1977,1985,8,8.99,13.22,4.23,629,827,198,837,2831,1994,2623.0,1017.0,-1606.0,175000.0,512500.0,337500.0
sextj101,Jimmy Sexton,Houston Astros,ASTROS,2,2,2,4,1981,1983,2,0.56,0.0,-0.56,208,0,-208,157,0,-157,728.0,0.0,-728.0,0.0,0.0,0.0
seyfg101,Gordon Seyfried,Detroit Tigers,TIGRS,1,2,1,3,1962,1965,3,-0.2,-1.2,-1.0,38,174,136,3,601,598,79.0,0.0,-79.0,0.0,0.0,0.0
shacb001,Brian Shackelford,Kansas City Royals,ROYALS,1,2,2,4,2003,2003,0,-0.36,0.0,0.36,139,0,-139,11,0,-11,223.0,0.0,-223.0,0.0,0.0,0.0
shacb001,Brian Shackelford,Cincinnati Reds,REDS,1,2,3,5,2007,2007,0,0.0,0.07,0.07,0,27,27,0,68,68,0.0,0.0,0.0,0.0,0.0,0.0
shack001,Kevin Shackelford,Milwaukee Brewers,BREWRS,2,4,2,6,2014,2015,1,-0.1,-0.55,-0.45,292,98,-194,5,0,-5,440.0,141.0,-299.0,0.0,0.0,0.0
shafr001,Richie Shaffer,Tampa Bay Devil Rays,RAYS,1,2,3,5,2016,2021,5,-0.63,1.91,2.54,100,161,61,297,1,-296,3.0,549.0,546.0,0.0,0.0,0.0
shama101,Art Shamsky,Cincinnati Reds,REDS,4,6,7,13,1967,1977,10,10.39,11.79,1.4,662,1337,675,1652,602,-1050,1267.0,4200.0,2933.0,0.0,0.0,0.0
shama101,Art Shamsky,New York Mets,METS,1,4,4,8,1971,1975,4,1.94,1.36,-0.58,244,340,96,49,280,231,763.0,880.0,117.0,0.0,0.0,0.0
shanb102,Bobby Shantz,Kansas City Athletics,ATLTCS,38,80,81,161,1957,1976,19,137.3,59.64,-77.66,12943,8836,-4107,29783,24655,-5128,18720.0,9434.0,-9286.0,506100.0,626500.0,120400.0
shanb102,Bobby Shantz,Washington Senators,RNGRS,2,2,4,6,1960,1963,3,2.02,0.52,-1.5,88,185,97,21,629,608,268.0,0.0,-268.0,0.0,0.0,0.0
shanb102,Bobby Shantz,Houston Astros,ASTROS,10,15,16,31,1962,1978,16,37.76,14.84,-22.92,2088,2514,426,2358,8171,5813,10498.0,2643.0,-7855.0,0.0,90000.0,90000.0
shanb102,Bobby Shantz,St. Louis Cardinals,CARDS,1,3,3,6,1964,1965,1,-0.83,5.23,6.06,340,107,-233,612,464,-148,674.0,9.0,-665.0,0.0,12000.0,12000.0
shanh101,Howie Shanks,Washington Senators,TWINS,1,3,2,5,1923,1930,7,1.13,22.03,20.9,449,1009,560,1547,3473,1926,0.0,543.0,543.0,0.0,0.0,0.0
shanh101,Howie Shanks,Boston Red Sox,RSOX,3,4,3,7,1924,1925,1,-0.22,2.0,2.22,78,119,41,206,474,268,0.0,0.0,0.0,10750.0,8700.0,-2050.0
shanr101,Red Shannon,Philadelphia Athletics,ATLTCS,1,2,2,4,1919,1920,1,0.98,0.04,-0.94,143,118,-25,582,462,-120,0.0,0.0,0.0,2400.0,0.0,-2400.0
shanr101,Red Shannon,Boston Red Sox,RSOX,12,23,27,50,1919,1937,18,88.36,56.94,-31.42,3577,3010,-567,9223,10199,976,11819.0,5427.0,-6392.0,73300.0,54000.0,-19300.0
shanr101,Red Shannon,Louisville,Louisville,1,1,2,3,1925,1925,0,0.69,0.0,-0.69,19,0,-19,60,0,-60,0.0,0.0,0.0,0.0,3500.0,3500.0
shanr101,Red Shannon,Chicago Cubs,CUBS,2,4,3,7,1926,1934,8,0.0,24.0,24.0,0,988,988,0,3984,3984,0.0,0.0,0.0,12967.0,0.0,-12967.0
shanr101,Red Shannon,Baltimore,Baltimore,1,2,5,7,1917,1920,3,0.91,0.0,-0.91,304,0,-304,1098,0,-1098,1.0,0.0,-1.0,0.0,1800.0,1800.0
shans101,Spike Shannon,St. Louis Cardinals,CARDS,1,1,2,3,1906,1908,2,1.14,0.72,-0.42,308,182,-126,1333,648,-685,0.0,0.0,0.0,0.0,0.0,0.0
shanw101,Wally Shannon,St. Louis Cardinals,CARDS,2,7,3,10,1960,1963,3,1.56,-0.35,-1.91,364,164,-200,1157,310,-847,0.0,0.0,0.0,0.0,0.0,0.0
sharb101,Bud Sharpe,Pittsburgh Pirates,PIRATS,1,2,1,3,1910,1910,0,-1.88,1.0,2.88,213,60,-153,568,54,-514,814.0,458.0,-356.0,0.0,0.0,0.0
sharb102,Bill Sharp,Chicago White Sox,WSOX,1,1,1,2,1975,1978,3,0.72,-0.16,-0.88,203,81,-122,602,220,-382,0.0,0.0,0.0,0.0,0.0,0.0
shard101,Dick Sharon,Pittsburgh Pirates,PIRATS,5,5,6,11,1972,1983,11,-0.03,6.98,7.01,282,851,569,628,2739,2111,92.0,4.0,-88.0,0.0,9300.0,9300.0
shard101,Dick Sharon,Detroit Tigers,TIGRS,1,3,1,4,1974,1975,1,-0.19,-1.37,-1.18,91,45,-46,191,173,-18,0.0,0.0,0.0,79000.0,80000.0,1000.0
shard101,Dick Sharon,San Diego Padres,PADRS,1,1,1,2,1975,1977,2,0.0,1.7,1.7,0,141,141,0,522,522,0.0,0.0,0.0,0.0,0.0,0.0
shard101,Dick Sharon,St. Louis Cardinals,CARDS,1,1,1,2,1976,1976,0,0.0,0.0,0.0,0,0,0,0,0,0,0.0,0.0,0.0,0.0,0.0,0.0
shard101,Dick Sharon,California Angels,ANGELS,2,4,2,6,1976,1979,3,0.01,3.49,3.48,36,153,117,0,0,0,119.0,938.0,819.0,0.0,0.0,0.0
sharj101,Jack Sharrott,New York Giants,GIANTS,1,3,1,4,1893,1894,1,-1.18,4.81,5.99,549,157,-392,2414,700,-1714,168.0,0.0,-168.0,0.0,0.0,0.0
sharm001,Mike Sharperson,Toronto Blue Jays,BJAYS,2,2,3,5,1987,2000,13,8.72,20.44,11.72,552,205,-347,1277,2,-1275,566.0,3678.0,3112.0,5000000.0,0.0,-5000000.0
shaus101,Shag Shaughnessy,Philadelphia Athletics,ATLTCS,1,1,1,2,1908,1916,8,0.0,42.2,42.2,0,899,899,0,3853,3853,0.0,0.0,0.0,0.0,0.0,0.0
shawa101,Al Shaw,Boston Red Sox,RSOX,1,1,1,2,1908,1908,0,-0.98,0.34,1.32,32,19,-13,53,50,-3,0.0,0.0,0.0,0.0,0.0,0.0
shawb001,Bryan Shaw,Arizona Diamondbacks,DBACKS,3,6,6,12,2012,2021,9,44.83,10.87,-33.96,1441,607,-834,2691,1018,-1673,5272.0,2512.0,-2760.0,11602833.0,504900.0,-11097933.0
shawb103,Bob Shaw,Detroit Tigers,TIGRS,2,3,3,6,1958,1959,1,16.44,-3.06,-19.5,1173,107,-1066,3797,151,-3646,1676.0,92.0,-1584.0,32000.0,0.0,-32000.0
shawb103,Bob Shaw,Chicago White Sox,WSOX,11,17,21,38,1961,1969,8,15.81,27.33,11.52,1761,2250,489,3197,3489,292,3384.0,5251.0,1867.0,77750.0,58000.0,-19750.0
shawb103,Bob Shaw,Kansas City Athletics,ATLTCS,14,29,24,53,1961,1976,15,53.0,28.85,-24.15,5847,3256,-2591,13868,9788,-4080,6333.0,2140.0,-4193.0,393100.0,463000.0,69900.0
shawb103,Bob Shaw,Milwaukee Braves,BRAVES,10,14,18,32,1963,1973,10,11.77,26.43,14.66,1218,1711,493,2811,4870,2059,2257.0,2054.0,-203.0,95000.0,38000.0,-57000.0
shawd102,Don Shaw,St. Louis Cardinals,CARDS,4,5,4,9,1972,1974,2,-2.02,-0.41,1.61,103,140,37,163,256,93,16.0,34.0,18.0,22000.0,9600.0,-12400.0
shawd102,Don Shaw,Oakland Athletics,ATLTCS,1,1,1,2,1973,1974,1,0.0,0.11,0.11,0,24,24,0,26,26,0.0,0.0,0.0,0.0,0.0,0.0
shawj001,Jeff Shaw,Kansas City Royals,ROYALS,1,2,2,4,1992,1993,1,1.07,-0.36,-1.43,511,17,-494,265,0,-265,676.0,275.0,-401.0,0.0,300000.0,300000.0
shawj001,Jeff Shaw,Montreal Expos,NATEX,1,1,1,2,1995,1995,0,-0.11,-0.11,0.0,9,14,5,0,2,2,29.0,25.0,-4.0,325000.0,705000.0,380000.0
shawj001,Jeff Shaw,Cincinnati Reds,REDS,5,10,8,18,1998,2013,15,52.05,23.9,-28.15,3513,2196,-1317,11936,4753,-7183,1208.0,1995.0,787.0,12757695.0,1962667.0,-10795028.0
shawt001,Travis Shaw,Boston Red Sox,RSOX,1,4,1,5,2016,2019,3,5.97,-0.24,-6.21,440,43,-397,1667,0,-1667,0.0,128.0,128.0,515000.0,513900.0,-1100.0
shead101,Dave Shean,Philadelphia Phillies,PHILS,13,27,30,57,1909,1931,22,110.35,96.74,-13.61,5407,5417,10,17248,19665,2417,13600.0,6282.0,-7318.0,25000.0,31850.0,6850.0
shead101,Dave Shean,Boston Braves,BRAVES,1,1,2,3,1911,1912,1,-0.64,-1.23,-0.59,54,195,141,160,626,466,0.0,292.0,292.0,0.0,0.0,0.0
shead101,Dave Shean,Cincinnati Reds,REDS,1,1,1,2,1918,1918,0,1.46,0.0,-1.46,144,0,-144,614,0,-614,0.0,0.0,0.0,0.0,0.0,0.0
sheam102,Merv Shea,Louisville,Louisville,1,1,2,3,1933,1933,0,-0.26,0.0,0.26,16,0,-16,60,0,-60,0.0,0.0,0.0,0.0,0.0,0.0
sheam102,Merv Shea,Boston Red Sox,RSOX,8,14,12,26,1933,1943,10,54.55,37.24,-17.31,2815,1980,-835,9804,5762,-4042,4236.0,5439.0,1203.0,60350.0,84500.0,24150.0
sheam102,Merv Shea,St.Louis Browns,ORLS,1,1,1,2,1933,1935,2,-1.6,0.15,1.75,147,68,-79,473,201,-272,0.0,0.0,0.0,0.0,6500.0,6500.0
shear001,Ryan Shealy,Colorado Rockies,ROCKS,2,3,3,6,2006,2007,1,0.87,-0.8,-1.67,160,227,67,478,3,-475,128.0,305.0,177.0,662000.0,1335500.0,673500.0
shear101,Ray Shearer,Brooklyn Dodgers,DOGRS,1,1,1,2,1956,1956,0,0.03,0.0,-0.03,2,0,-2,3,0,-3,0.0,0.0,0.0,0.0,0.0,0.0
sheas101,Spec Shea,New York Yankees,YANKS,7,19,15,34,1952,1970,18,13.22,40.85,27.63,2406,2911,505,6464,7208,744,3937.0,4978.0,1041.0,115500.0,43000.0,-72500.0
shecj101,Jimmy Sheckard,Brooklyn Dodgers,DOGRS,1,1,5,6,1905,1907,2,19.07,1.04,-18.03,1001,116,-885,4393,448,-3945,0.0,0.0,0.0,0.0,0.0,0.0
sheea001,Andy Sheets,Tampa Bay Devil Rays,RAYS,1,2,1,3,1997,2002,5,1.57,0.35,-1.22,275,471,196,252,1802,1550,559.0,0.0,-559.0,0.0,900000.0,900000.0
sheea001,Andy Sheets,San Diego Padres,PADRS,2,3,4,7,1999,2006,7,-1.99,17.0,18.99,162,874,712,576,3363,2787,0.0,547.0,547.0,9625000.0,15000000.0,5375000.0
sheeb101,Bud Sheely,Seattle,Seattle,1,1,1,2,1951,1951,0,-1.14,0.0,1.14,101,0,-101,244,0,-244,0.0,0.0,0.0,0.0,0.0,0.0
sheel001,Larry Sheets,Baltimore Orioles,ORLS,1,1,1,2,1990,1990,0,-1.02,0.0,1.02,131,0,-131,390,0,-390,0.0,0.0,0.0,0.0,0.0,0.0
sheet102,Tom Sheehan,Cincinnati Reds,REDS,2,3,2,5,1925,1925,0,0.78,0.21,-0.57,65,51,-14,32,164,132,283.0,0.0,-283.0,0.0,3600.0,3600.0
shefg001,Gary Sheffield,Milwaukee Brewers,BREWRS,13,27,30,57,1992,2012,20,73.34,65.99,-7.35,4315,5311,996,13697,11972,-1725,3271.0,12033.0,8762.0,18537000.0,21422667.0,2885667.0
shefg001,Gary Sheffield,San Diego Padres,PADRS,2,3,4,7,1993,2008,15,13.46,26.09,12.63,630,1877,1247,2360,48,-2312,138.0,3132.0,2994.0,3375000.0,109000.0,-3266000.0
shefg001,Gary Sheffield,Florida Marlins,MARLNS,15,33,38,71,1998,2019,21,116.45,94.42,-22.03,4698,5470,772,15425,16217,792,10496.0,10160.0,-336.0,68580667.0,35694968.0,-32885699.0
shefg001,Gary Sheffield,Los Angeles Dodgers,DOGRS,5,10,8,18,2002,2017,15,17.25,38.29,21.04,819,2208,1389,2735,7440,4705,688.0,2385.0,1697.0,11580000.0,1700000.0,-9880000.0
shefg001,Gary Sheffield,New York Yankees,YANKS,1,1,3,4,2006,2012,6,2.79,-0.32,-3.11,247,6,-241,1075,0,-1075,0.0,19.0,19.0,10756171.0,0.0,-10756171.0
shefj001,Justus Sheffield,Cleveland Indians,INDINS,1,4,1,5,2016,2018,2,0.85,4.57,3.72,262,129,-133,807,2,-805,102.0,377.0,275.0,0.0,0.0,0.0
shefj001,Justus Sheffield,New York Yankees,YANKS,1,3,1,4,2018,2020,2,-1.57,1.84,3.41,118,37,-81,6,8,2,818.0,513.0,-305.0,0.0,4900000.0,4900000.0
shelc001,Chris Shelton,Detroit Tigers,TIGRS,1,1,1,2,2007,2008,1,0.38,0.0,-0.38,41,0,-41,117,0,-117,0.0,0.0,0.0,0.0,0.0,0.0
shelj001,John Shelby,Baltimore Orioles,ORLS,1,2,1,3,1987,1988,1,3.02,0.79,-2.23,473,97,-376,1461,0,-1461,135.0,334.0,199.0,300000.0,731250.0,431250.0
shelj101,Jim Shellenback,Pittsburgh Pirates,PIRATS,1,1,1,2,1969,1969,0,0.92,0.0,-0.92,276,0,-276,106,0,-106,1216.0,0.0,-1216.0,8500.0,10000.0,1500.0
shelr101,Rollie Sheldon,New York Yankees,YANKS,2,3,2,5,1965,1967,2,0.45,-0.46,-0.91,144,131,-13,217,298,81,767.0,0.0,-767.0,35500.0,12500.0,-23000.0
shelr101,Rollie Sheldon,Kansas City Athletics,ATLTCS,10,23,15,38,1966,1976,10,27.1,17.67,-9.43,4296,1831,-2465,8999,4813,-4186,5181.0,1373.0,-3808.0,355600.0,427500.0,71900.0
shelr101,Rollie Sheldon,Boston Red Sox,RSOX,1,3,1,4,1966,1966,0,0.0,0.6,0.6,0,12,12,0,10,10,0.0,93.0,93.0,18500.0,0.0,-18500.0
shems101,Steve Shemo,Boston Braves,BRAVES,1,2,1,3,1945,1949,4,0.0,3.35,3.35,0,154,154,0,133,133,0.0,1068.0,1068.0,0.0,0.0,0.0
shepk001,Keith Shepherd,Chicago White Sox,WSOX,1,1,1,2,1992,1992,0,0.02,0.16,0.14,24,40,16,0,131,131,66.0,0.0,-66.0,0.0,375000.0,375000.0
shepk001,Keith Shepherd,Colorado Rockies,ROCKS,1,1,1,2,1994,1994,0,-0.3,0.0,0.3,2,0,-2,0,0,0,3.0,0.0,-3.0,0.0,0.0,0.0
sherb101,Bill Sherdel,St. Louis Cardinals,CARDS,3,4,5,9,1930,1932,2,17.17,7.22,-9.95,980,103,-877,1735,151,-1584,4684.0,1094.0,-3590.0,38000.0,33000.0,-5000.0
shere101,Ed Sherling,Philadelphia Athletics,ATLTCS,3,9,5,14,1924,1935,11,15.67,38.22,22.55,391,1328,937,1453,5363,3910,735.0,0.0,-735.0,39667.0,10400.0,-29267.0
sherg001,George Sherrill,Seattle Mariners,MARNRS,4,9,5,14,2008,2013,5,43.53,3.71,-39.82,1975,169,-1806,6859,413,-6446,3908.0,766.0,-3142.0,1000000.0,1300000.0,300000.0
sherg001,George Sherrill,Baltimore Orioles,ORLS,2,2,3,5,2009,2014,5,0.22,-0.73,-0.95,208,80,-128,57,226,169,192.0,4.0,-188.0,2750000.0,0.0,-2750000.0
sherl101,Larry Sherry,Los Angeles Dodgers,DOGRS,3,4,6,10,1964,1979,15,17.69,25.85,8.16,1084,1813,729,2900,6019,3119,751.0,0.0,-751.0,0.0,0.0,0.0
sherl101,Larry Sherry,Detroit Tigers,TIGRS,1,1,1,2,1967,1967,0,-0.89,-0.12,0.77,58,25,-33,5,56,51,122.0,0.0,-122.0,29000.0,0.0,-29000.0
shern101,Neill Sheridan,SanFrancisco,SanFrancisco,1,1,3,4,1947,1949,2,0.0,0.0,0.0,2,0,-2,1,0,-1,0.0,0.0,0.0,0.0,6000.0,6000.0
sherp001,Pat Sheridan,Detroit Tigers,TIGRS,2,2,2,4,1989,1990,1,1.14,-1.31,-2.45,174,148,-26,464,429,-35,0.0,0.0,0.0,805000.0,990000.0,185000.0
sherr102,Roy Sherid,New York Yankees,YANKS,1,5,2,7,1931,1947,16,0.0,15.3,15.3,0,992,992,0,1098,1098,0.0,2971.0,2971.0,19500.0,0.0,-19500.0
sherv101,Vince Sherlock,Indianapolis,Indianapolis,1,2,3,5,1935,1936,1,2.11,0.0,-2.11,313,0,-313,1102,0,-1102,0.0,0.0,0.0,0.0,0.0,0.0
shetb101,Barry Shetrone,Baltimore Orioles,ORLS,1,3,2,5,1962,1967,5,0.29,3.01,2.72,74,349,275,211,975,764,63.0,22.0,-41.0,7000.0,0.0,-7000.0
shiec101,Charlie Shields,Altoona,Altoona,1,1,1,2,1907,1907,0,-0.73,0.0,0.73,6,0,-6,2,0,-2,20.0,0.0,-20.0,0.0,0.0,0.0
shiej001,Jason Shiell,Atlanta Braves,BRAVES,1,3,3,6,1999,2001,2,15.79,3.54,-12.25,961,377,-584,3858,1296,-2562,4.0,0.0,-4.0,7650000.0,8651680.0,1001680.0
shiej002,James Shields,Tampa Bay Devil Rays,RAYS,8,14,20,34,2012,2020,8,32.69,16.85,-15.84,1967,1086,-881,5025,2972,-2053,4433.0,3274.0,-1159.0,15365300.0,6506400.0,-8858900.0
shiej002,James Shields,San Diego Padres,PADRS,1,2,2,4,2016,2018,2,0.14,-0.69,-0.83,82,7,-75,11,5,-6,1308.0,59.0,-1249.0,0.0,0.0,0.0
shies001,Steve Shields,Atlanta Braves,BRAVES,1,1,1,2,1986,1987,1,0.23,-0.34,-0.57,3,11,8,0,19,19,26.0,0.0,-26.0,0.0,0.0,0.0
shies001,Steve Shields,Kansas City Royals,ROYALS,2,5,4,9,1986,1991,5,17.35,13.35,-4.0,586,809,223,839,3196,2357,3709.0,71.0,-3638.0,1438000.0,747500.0,-690500.0
shies001,Steve Shields,New York Yankees,YANKS,1,1,1,2,1989,1989,0,-0.69,0.0,0.69,11,0,-11,0,0,0,52.0,0.0,-52.0,0.0,0.0,0.0
shiet001,Tommy Shields,Pittsburgh Pirates,PIRATS,1,1,1,2,1991,1991,0,0.0,0.0,0.0,2,0,-2,0,0,0,0.0,0.0,0.0,0.0,0.0,0.0
shilj101,Jim Shilling,Philadelphia Phillies,PHILS,1,2,1,3,1940,1943,3,0.0,0.0,0.0,0,1,1,0,1,1,0.0,0.0,0.0,0.0,0.0,0.0
shinb101,Billy Shindle,Baltimore Orioles,BLN,1,2,2,4,1894,1899,5,9.18,29.72,20.54,830,772,-58,3686,3764,78,0.0,0.0,0.0,0.0,0.0,0.0
shing101,Ginger Shinault,Cleveland Indians,INDINS,1,5,1,6,1922,1935,13,0.0,5.93,5.93,0,850,850,0,2604,2604,0.0,0.0,0.0,0.0,0.0,0.0
shinr101,Ralph Shinners,Indianapolis,Indianapolis,2,2,7,9,1921,1924,3,2.5,0.0,-2.5,356,0,-356,1321,0,-1321,0.0,0.0,0.0,0.0,6500.0,6500.0
shint001,Tsuyoshi Shinjo,New York Mets,METS,2,4,5,9,2001,2003,2,1.23,0.97,-0.26,130,205,75,408,385,-23,84.0,416.0,332.0,7175000.0,4958000.0,-2217000.0
shinz001,Zak Shinall,Los Angeles Dodgers,DOGRS,1,1,1,2,1992,1992,0,0.0,0.0,0.0,0,0,0,0,0,0,0.0,0.0,0.0,0.0,0.0,0.0
shipc001,Craig Shipley,Los Angeles Dodgers,DOGRS,1,1,1,2,1988,1988,0,0.03,0.0,-0.03,4,0,-4,7,0,-7,0.0,0.0,0.0,0.0,0.0,0.0
shipc001,Craig Shipley,San Diego Padres,PADRS,6,15,16,31,1994,2006,12,12.56,40.19,27.63,2713,3390,677,9058,12055,2997,712.0,1324.0,612.0,13007500.0,22494000.0,9486500.0
shipc001,Craig Shipley,St. Louis Cardinals,CARDS,1,1,1,2,1998,1998,0,0.19,0.0,-0.19,77,0,-77,162,0,-162,0.0,0.0,0.0,0.0,0.0,0.0
shipd001,Dave Shipanoff,Toronto Blue Jays,BJAYS,2,4,2,6,1985,1985,0,1.41,-1.31,-2.72,202,123,-79,317,361,44,109.0,0.0,-109.0,185000.0,750000.0,565000.0
shipj101,Joe Shipley,St. Louis Cardinals,CARDS,1,1,1,2,1962,1962,0,-0.46,0.0,0.46,6,0,-6,2,0,-2,14.0,0.0,-14.0,0.0,0.0,0.0
shira101,Art Shires,Chicago White Sox,WSOX,4,9,7,16,1930,1935,5,3.83,5.44,1.61,940,520,-420,3521,1378,-2143,0.0,1149.0,1149.0,41500.0,34000.0,-7500.0
shira101,Art Shires,Milwaukee,Milwaukee,1,1,2,3,1931,1931,0,-0.39,0.0,0.39,82,0,-82,328,0,-328,0.0,0.0,0.0,0.0,0.0,0.0
shirb001,Bob Shirley,San Diego Padres,PADRS,11,20,24,44,1980,1993,13,78.65,50.21,-28.44,3246,4423,1177,10088,11380,1292,4862.0,3507.0,-1355.0,3006667.0,3395633.0,388966.0
shirb001,Bob Shirley,St. Louis Cardinals,CARDS,2,2,3,5,1982,1987,5,1.5,0.49,-1.01,82,382,300,48,668,620,458.0,170.0,-288.0,0.0,0.0,0.0
shirm101,Mule Shirley,Washington Senators,TWINS,1,1,1,2,1926,1926,0,0.0,0.0,0.0,0,0,0,0,0,0,0.0,0.0,0.0,0.0,0.0,0.0
shivi101,Ivey Shiver,Cincinnati Reds,REDS,1,3,1,4,1934,1936,2,0.0,1.84,1.84,0,131,131,0,110,110,0.0,910.0,910.0,3000.0,0.0,-3000.0
shocc101,Costen Shockley,Philadelphia Phillies,PHILS,1,2,1,3,1964,1966,2,4.55,-0.7,-5.25,450,79,-371,427,37,-390,3416.0,375.0,-3041.0,5400.0,15000.0,9600.0
shocg101,George Shoch,Brooklyn Dodgers,DOGRS,1,2,1,3,1897,1901,4,0.0,0.58,0.58,0,134,134,0,554,554,0.0,0.0,0.0,0.0,0.0,0.0
shocu101,Urban Shocker,New York Yankees,YANKS,5,14,12,26,1918,1931,13,64.97,61.9,-3.07,2396,2093,-303,7435,5797,-1638,6303.0,6917.0,614.0,44500.0,41500.0,-3000.0
shocu101,Urban Shocker,St.Louis Browns,ORLS,29,55,62,117,1924,1952,28,167.19,143.12,-24.07,7712,11236,3524,22879,31279,8400,20858.0,30694.0,9836.0,281100.0,235650.0,-45450.0
shofm101,Milt Shoffner,Cincinnati Reds,REDS,1,1,1,2,1940,1940,0,0.0,0.0,0.0,0,0,0,0,0,0,0.0,0.0,0.0,5000.0,0.0,-5000.0
shofs101,Strick Shofner,Boston Red Sox,RSOX,1,3,1,4,1947,1947,0,0.0,0.0,0.0,0,0,0,0,0,0,0.0,0.0,0.0,6000.0,0.0,-6000.0
shopk001,Kelly Shoppach,Boston Red Sox,RSOX,6,12,8,20,2006,2011,5,15.42,8.9,-6.52,1619,794,-825,3010,1778,-1232,1235.0,750.0,-485.0,8391733.0,1897000.0,-6494733.0
shopk001,Kelly Shoppach,Cleveland Indians,INDINS,1,1,1,2,2009,2011,2,0.87,-0.03,-0.9,150,44,-106,440,8,-432,0.0,669.0,669.0,1950000.0,0.0,-1950000.0
shopk001,Kelly Shoppach,Boston Red Sox,RSOX,1,1,1,2,2012,2013,1,0.1,0.03,-0.07,28,14,-14,87,0,-87,0.0,53.0,53.0,1135000.0,487500.0,-647500.0
shorb102,Bill Shores,Portland,Portland,1,1,2,3,1932,1933,1,-0.01,0.0,0.01,16,0,-16,12,0,-12,110.0,0.0,-110.0,0.0,0.0,0.0
shorb102,Bill Shores,Chicago White Sox,WSOX,4,9,4,13,1936,1950,14,-0.26,3.15,3.41,394,894,500,1460,3508,2048,0.0,0.0,0.0,20900.0,0.0,-20900.0
shorc101,Chick Shorten,Boston Red Sox,RSOX,1,3,1,4,1919,1919,0,4.45,1.63,-2.82,567,133,-434,1739,583,-1156,282.0,0.0,-282.0,0.0,0.0,0.0
shore101,Ernie Shore,New York Yankees,YANKS,1,2,1,3,1912,1912,0,0.0,0.0,0.0,0,0,0,0,0,0,0.0,0.0,0.0,0.0,0.0,0.0
shore101,Ernie Shore,Boston Red Sox,RSOX,4,11,11,22,1918,1925,7,12.28,-1.18,-13.46,1743,839,-904,6150,3067,-3083,700.0,265.0,-435.0,3300.0,12700.0,9400.0
shore101,Ernie Shore,New York Yankees,YANKS,3,12,4,16,1921,1928,7,-3.56,9.03,12.59,367,917,550,1242,3654,2412,159.0,0.0,-159.0,15750.0,13000.0,-2750.0
shorr001,Rick Short,Kansas City Royals,ROYALS,1,1,1,2,2004,2004,0,0.32,0.0,-0.32,11,0,-11,17,0,-17,0.0,0.0,0.0,0.0,0.0,0.0
shorz001,Zack Short,Chicago Cubs,CUBS,1,1,1,2,2020,2021,1,-0.48,-0.02,0.46,61,18,-43,184,56,-128,0.0,0.0,0.0,0.0,1500000.0,1500000.0
shotb101,Burt Shotton,St.Louis Browns,ORLS,1,2,2,4,1917,1920,3,3.97,0.15,-3.82,243,110,-133,1072,129,-943,0.0,1048.0,1048.0,9000.0,3200.0,-5800.0
shoub001,Brian Shouse,Texas Rangers,RNGRS,1,1,2,3,2006,2006,0,2.38,0.0,-2.38,391,0,-391,0,0,0,399.0,0.0,-399.0,725000.0,0.0,-725000.0
shouc101,Clyde Shoun,Chicago Cubs,CUBS,1,4,1,5,1938,1938,0,10.27,2.49,-7.78,576,26,-550,361,27,-334,2894.0,224.0,-2670.0,0.0,0.0,0.0
shouc101,Clyde Shoun,St. Louis Cardinals,CARDS,1,2,1,3,1942,1942,0,5.25,-0.02,-5.27,308,18,-290,155,2,-153,1547.0,37.0,-1510.0,0.0,0.0,0.0
shrec001,Chasen Shreve,Atlanta Braves,BRAVES,1,2,1,3,2015,2016,1,1.56,-0.24,-1.8,214,14,-200,2,7,5,580.0,79.0,-501.0,0.0,0.0,0.0
shrec001,Chasen Shreve,New York Yankees,YANKS,1,2,2,4,2018,2018,0,3.47,1.31,-2.16,336,39,-297,5,148,143,562.0,0.0,-562.0,825000.0,0.0,-825000.0
shuep001,Paul Shuey,Cleveland Indians,INDINS,2,3,4,7,2002,2005,3,1.47,0.77,-0.7,252,165,-87,226,251,25,550.0,830.0,280.0,4152400.0,3250000.0,-902400.0
shugf101,Frank Shugart,Pittsburgh Pirates,PIRATS,1,2,1,3,1893,1894,1,0.22,3.25,3.03,192,153,-39,860,698,-162,0.0,0.0,0.0,0.0,0.0,0.0
shugf101,Frank Shugart,St. Louis Cardinals,CARDS,1,1,1,2,1895,1895,0,-0.52,-0.94,-0.42,113,84,-29,511,407,-104,0.0,0.0,0.0,0.0,0.0,0.0
shuma001,Anthony Shumaker,New York Mets,METS,1,1,1,2,2000,2000,0,0.0,0.0,0.0,0,0,0,0,0,0,0.0,0.0,0.0,0.0,0.0,0.0
sicke101,Ed Sicking,New York Giants,GIANTS,2,7,2,9,1919,1926,7,9.28,14.26,4.98,1335,470,-865,2807,556,-2251,5840.0,4330.0,-1510.0,10442.0,9655.0,-787.0
siebd102,Dick Siebert,St. Louis Cardinals,CARDS,1,1,3,4,1938,1938,0,7.67,0.0,-7.67,1004,0,-1004,4195,0,-4195,0.0,0.0,0.0,3500.0,0.0,-3500.0
siebd102,Dick Siebert,Philadelphia Athletics,ATLTCS,1,1,1,2,1945,1947,2,0.0,-0.74,-0.74,0,136,136,0,556,556,0.0,0.0,0.0,12000.0,10000.0,-2000.0
siebd102,Dick Siebert,Brooklyn Dodgers,DOGRS,2,7,3,10,1936,1944,8,1.9,2.87,0.97,125,593,468,330,2189,1859,390.0,0.0,-390.0,10000.0,10000.0,0.0
siebn101,Norm Siebern,New York Yankees,YANKS,4,7,6,13,1959,1969,10,14.99,27.57,12.58,1233,1032,-201,4340,4017,-323,296.0,0.0,-296.0,175000.0,51000.0,-124000.0
siebn101,Norm Siebern,Kansas City Athletics,ATLTCS,2,2,4,6,1963,1965,2,5.51,1.89,-3.62,386,200,-186,1388,661,-727,0.0,46.0,46.0,32500.0,0.0,-32500.0
siebn101,Norm Siebern,Baltimore Orioles,ORLS,7,18,18,36,1965,1988,23,25.78,102.26,76.48,1705,4270,2565,1967,10311,8344,8511.0,12795.0,4284.0,787833.0,72400.0,-715433.0
siebn101,Norm Siebern,California Angels,ANGELS,2,2,2,4,1966,1967,1,2.08,-0.05,-2.13,370,60,-310,910,103,-807,0.0,0.0,0.0,46000.0,10000.0,-36000.0
siebp101,Paul Siebert,Houston Astros,ASTROS,1,1,1,2,1977,1977,0,-0.22,0.0,0.22,8,0,-8,0,0,0,11.0,0.0,-11.0,0.0,0.0,0.0
siebp101,Paul Siebert,San Diego Padres,PADRS,1,2,1,3,1977,1977,0,-0.17,0.36,0.53,215,56,-159,280,187,-93,168.0,0.0,-168.0,0.0,95000.0,95000.0
siebp101,Paul Siebert,New York Mets,METS,1,1,1,2,1978,1978,0,0.0,0.0,0.0,0,0,0,0,0,0,0.0,0.0,0.0,0.0,0.0,0.0
siebs101,Sonny Siebert,Cleveland Indians,INDINS,1,3,3,6,1969,1970,1,13.72,3.96,-9.76,502,371,-131,436,691,255,3166.0,784.0,-2382.0,34500.0,0.0,-34500.0
siebs101,Sonny Siebert,Texas Rangers,RNGRS,1,1,2,3,1973,1977,4,0.13,0.0,-0.13,56,0,-56,49,0,-49,401.0,0.0,-401.0,0.0,7800.0,7800.0
siebs101,Sonny Siebert,St. Louis Cardinals,CARDS,4,7,5,12,1974,1976,2,2.63,1.37,-1.26,416,126,-290,619,461,-158,1142.0,0.0,-1142.0,0.0,0.0,0.0
siebs101,Sonny Siebert,San Diego Padres,PADRS,1,1,1,2,1975,1975,0,0.46,-0.64,-1.1,18,87,69,1,223,222,183.0,0.0,-183.0,0.0,42500.0,42500.0
sierc001,Candy Sierra,San Diego Padres,PADRS,1,1,1,2,1988,1991,3,-0.02,4.68,4.7,2,220,218,1,252,251,12.0,1999.0,1987.0,62500.0,457500.0,395000.0
sierm002,Magneuris Sierra,St. Louis Cardinals,CARDS,1,4,1,5,2017,2019,2,8.96,4.59,-4.37,386,278,-108,632,1177,545,1696.0,0.0,-1696.0,0.0,3500000.0,3500000.0
sierr001,Ruben Sierra,Texas Rangers,RNGRS,2,5,3,8,1992,1996,4,8.49,4.09,-4.4,638,377,-261,2442,1627,-815,1191.0,3.0,-1188.0,15083333.0,7550000.0,-7533333.0
sierr001,Ruben Sierra,Oakland Athletics,ATLTCS,2,3,3,6,1995,1997,2,-0.97,-0.14,0.83,515,36,-479,1898,98,-1800,0.0,89.0,89.0,6200000.0,5300000.0,-900000.0
sierr001,Ruben Sierra,New York Yankees,YANKS,1,2,1,3,1996,1997,1,-0.38,0.96,1.34,46,151,105,180,653,473,0.0,0.0,0.0,6200000.0,9237500.0,3037500.0
sierr001,Ruben Sierra,Detroit Tigers,TIGRS,1,1,2,3,1996,1996,0,0.04,0.0,-0.04,25,0,-25,96,0,-96,0.0,0.0,0.0,0.0,0.0,0.0
sierr001,Ruben Sierra,Texas Rangers,RNGRS,1,1,1,2,2003,2003,0,-0.52,-0.44,0.08,231,30,-201,708,84,-624,0.0,0.0,0.0,600000.0,0.0,-600000.0
sievr101,Roy Sievers,Baltimore Orioles,ORLS,1,1,1,2,1954,1955,1,14.6,-0.96,-15.56,856,155,-701,3573,432,-3141,0.0,0.0,0.0,0.0,0.0,0.0
sievr101,Roy Sievers,Washington Senators,TWINS,4,9,9,18,1960,1971,11,32.57,40.51,7.94,1697,2191,494,5778,6105,327,873.0,2844.0,1971.0,153000.0,115000.0,-38000.0
sievr101,Roy Sievers,Chicago White Sox,WSOX,2,2,5,7,1961,1967,6,6.16,5.78,-0.38,593,417,-176,2190,480,-1710,0.0,2599.0,2599.0,44000.0,0.0,-44000.0
sigaf101,Frank Sigafoos,Chicago White Sox,WSOX,4,10,6,16,1929,1935,6,3.4,7.08,3.68,902,501,-401,3430,1582,-1848,0.0,735.0,735.0,34500.0,20500.0,-14000.0
sikob001,Brian Sikorski,San Diego Padres,PADRS,4,7,7,14,2006,2019,13,11.0,6.24,-4.76,793,884,91,2593,1173,-1420,319.0,1707.0,1388.0,3828600.0,21000000.0,17171400.0
silvc001,Carlos Silva,Philadelphia Phillies,PHILS,1,3,1,4,2003,2004,1,19.34,1.44,-17.9,901,67,-834,2722,75,-2647,2374.0,603.0,-1771.0,610000.0,6000000.0,5390000.0
silvc001,Carlos Silva,Seattle Mariners,MARNRS,1,2,1,3,2009,2011,2,1.59,0.02,-1.57,40,101,61,40,393,353,339.0,0.0,-339.0,12250000.0,7000000.0,-5250000.0
silvc101,Charlie Silvera,New York Yankees,YANKS,1,2,1,3,1956,1957,1,-0.26,0.0,0.26,26,0,-26,57,0,-57,0.0,0.0,0.0,16750.0,0.0,-16750.0
silvd001,Dave Silvestri,Houston Astros,ASTROS,7,14,19,33,1990,2004,14,26.09,8.2,-17.89,2264,1789,-475,4026,3854,-172,4263.0,3434.0,-829.0,7155000.0,5554000.0,-1601000.0
silvd001,Dave Silvestri,New York Yankees,YANKS,1,1,1,2,1995,1995,0,-0.71,0.0,0.71,125,0,-125,283,0,-283,0.0,0.0,0.0,116000.0,0.0,-116000.0
silvj001,Jose Silva,Toronto Blue Jays,BJAYS,2,7,5,12,1996,2001,5,5.42,8.51,3.09,1726,826,-900,3923,2165,-1758,1392.0,748.0,-644.0,1500000.0,5870000.0,4370000.0
silvj001,Jose Silva,Pittsburgh Pirates,PIRATS,1,1,1,2,2001,2001,0,0.22,0.0,-0.22,22,0,-22,1,0,-1,70.0,0.0,-70.0,795000.0,0.0,-795000.0
silvk101,Ken Silvestri,Chicago White Sox,WSOX,1,1,1,2,1940,1942,2,0.16,0.74,0.58,33,89,56,83,397,314,0.0,0.0,0.0,3000.0,9000.0,6000.0
simaa101,Al Sima,Chicago White Sox,WSOX,1,4,2,6,1954,1956,2,0.81,2.11,1.3,331,206,-125,724,121,-603,571.0,421.0,-150.0,8500.0,0.0,-8500.0
simaa101,Al Sima,Kansas City Athletics,ATLTCS,1,1,1,2,1955,1955,0,0.0,-0.73,-0.73,0,10,10,0,3,3,0.0,35.0,35.0,0.0,0.0,0.0
simab001,Bill Simas,California Angels,ANGELS,1,4,2,6,1995,1997,2,5.3,-0.85,-6.15,439,40,-399,87,0,-87,1686.0,680.0,-1006.0,0.0,2905000.0,2905000.0
simma001,Andrelton Simmons,Atlanta Braves,BRAVES,4,9,8,17,2015,2017,2,22.94,1.32,-21.62,894,130,-764,2564,403,-2161,887.0,339.0,-548.0,16307500.0,20000000.0,3692500.0
simma101,Al Simmons,Milwaukee,Milwaukee,5,5,13,18,1923,1937,14,58.42,0.0,-58.42,2136,0,-2136,8966,0,-8966,0.0,0.0,0.0,0.0,30900.0,30900.0
simmb001,Brian Simmons,Chicago White Sox,WSOX,2,5,3,8,2001,2001,0,-0.46,1.34,1.8,81,17,-64,117,2,-115,78.0,302.0,224.0,0.0,0.0,0.0
simmn001,Nelson Simmons,Baltimore Orioles,ORLS,1,1,1,2,1987,1987,0,0.0,0.0,0.0,0,0,0,0,0,0,0.0,0.0,0.0,0.0,0.0,0.0
simms001,Shae Simmons,Atlanta Braves,BRAVES,1,2,2,4,2017,2019,2,-0.62,-0.29,0.33,157,27,-130,613,12,-601,23.0,147.0,124.0,0.0,0.0,0.0
simmt001,Ted Simmons,St. Louis Cardinals,CARDS,6,17,11,28,1980,1992,12,64.49,98.46,33.97,5600,3789,-1811,17434,13612,-3822,5735.0,2617.0,-3118.0,1533333.0,0.0,-1533333.0
simmt001,Ted Simmons,Milwaukee Brewers,BREWRS,1,1,3,4,1986,1986,0,-0.7,1.33,2.03,227,68,-159,467,242,-225,0.0,0.0,0.0,0.0,0.0,0.0
simoa001,Alfredo Simon,Philadelphia Phillies,PHILS,2,3,2,5,2004,2005,1,-0.1,4.09,4.19,66,156,90,60,406,346,97.0,63.0,-34.0,1225000.0,6150000.0,4925000.0
simoa001,Alfredo Simon,Baltimore Orioles,ORLS,1,1,2,3,2006,2006,0,0.0,0.0,0.0,0,0,0,0,0,0,0.0,0.0,0.0,0.0,0.0,0.0
simoa001,Alfredo Simon,Cincinnati Reds,REDS,1,1,2,3,2014,2014,0,-0.51,0.0,0.51,33,0,-33,5,0,-5,561.0,0.0,-561.0,1500000.0,0.0,-1500000.0
simod001,Doug Simons,New York Mets,METS,2,2,2,4,1992,1992,0,-0.78,0.11,0.89,14,46,32,0,145,145,16.0,0.0,-16.0,0.0,2000000.0,2000000.0
simom101,Mel Simons,Louisville,Louisville,1,1,1,2,1931,1931,0,-0.56,0.0,0.56,75,0,-75,213,0,-213,0.0,0.0,0.0,0.0,0.0,0.0
simom101,Mel Simons,Chicago White Sox,WSOX,2,4,2,6,1932,1936,4,0.0,0.77,0.77,0,142,142,0,507,507,0.0,39.0,39.0,5500.0,0.0,-5500.0
simom102,Mike Simon,Boston Braves,BRAVES,6,8,9,17,1909,1927,18,12.78,37.81,25.03,886,1876,990,2292,5043,2751,2058.0,9235.0,7177.0,6000.0,0.0,-6000.0
simor001,Randall Simon,Detroit Tigers,TIGRS,4,6,6,12,2002,2010,8,-0.79,4.22,5.01,551,270,-281,568,7,-561,685.0,1453.0,768.0,2265000.0,318500.0,-1946500.0
simor001,Randall Simon,Pittsburgh Pirates,PIRATS,1,1,1,2,2003,2006,3,0.44,-0.06,-0.5,33,3,-30,110,8,-102,0.0,0.0,0.0,1475000.0,0.0,-1475000.0
simpa001,Allan Simpson,Seattle Mariners,MARNRS,1,1,1,2,2003,2003,0,-0.39,0.0,0.39,67,0,-67,1,0,-1,119.0,0.0,-119.0,0.0,0.0,0.0
simpa001,Allan Simpson,Colorado Rockies,ROCKS,1,1,1,2,2005,2006,1,-0.07,-0.77,-0.7,18,72,54,0,11,11,20.0,192.0,172.0,318000.0,0.0,-318000.0
simpd102,Dick Simpson,California Angels,ANGELS,3,3,3,6,1965,1967,2,2.08,0.48,-1.6,370,185,-185,910,507,-403,0.0,0.0,0.0,53000.0,40000.0,-13000.0
simpd102,Dick Simpson,Baltimore Orioles,ORLS,6,17,17,34,1965,1988,23,25.25,102.26,77.01,1580,4270,2690,1563,10311,8748,8511.0,12795.0,4284.0,757833.0,65400.0,-692433.0
simpd102,Dick Simpson,Cincinnati Reds,REDS,10,12,15,27,1968,1988,20,6.26,55.61,49.35,1200,3688,2488,3980,7973,3993,279.0,5781.0,5502.0,18500.0,0.0,-18500.0
simpd102,Dick Simpson,St. Louis Cardinals,CARDS,4,10,7,17,1968,1972,4,10.58,2.29,-8.29,1246,276,-970,1450,608,-842,1865.0,299.0,-1566.0,32500.0,24000.0,-8500.0
simpd102,Dick Simpson,Houston Astros,ASTROS,2,3,2,5,1968,1970,2,0.47,0.36,-0.11,24,150,126,15,31,16,43.0,466.0,423.0,23500.0,44500.0,21000.0
simpd102,Dick Simpson,New York Yankees,YANKS,1,1,1,2,1969,1969,0,-0.44,0.0,0.44,26,0,-26,56,0,-56,0.0,0.0,0.0,16000.0,12000.0,-4000.0
simpd102,Dick Simpson,Milwaukee Brewers,BREWRS,2,3,2,5,1969,1970,1,2.45,-0.08,-2.53,213,64,-149,45,45,0,485.0,396.0,-89.0,48000.0,33000.0,-15000.0
simph101,Harry Simpson,Kansas City Athletics,ATLTCS,50,107,110,217,1957,1976,19,243.41,144.18,-99.23,19841,14910,-4931,49436,46172,-3264,28049.0,12074.0,-15975.0,661100.0,839000.0,177900.0
simph101,Harry Simpson,New York Yankees,YANKS,1,2,2,4,1958,1960,2,2.31,-2.84,-5.15,242,240,-2,336,102,-234,756.0,1048.0,292.0,12500.0,0.0,-12500.0
simph101,Harry Simpson,Kansas City Athletics,ATLTCS,1,1,1,2,1959,1959,0,-0.11,0.7,0.81,38,61,23,79,161,82,0.0,0.0,0.0,12500.0,22000.0,9500.0
simph101,Harry Simpson,Chicago White Sox,WSOX,1,2,1,3,1959,1960,1,0.08,0.59,0.51,9,112,103,15,318,303,0.0,0.0,0.0,12500.0,0.0,-12500.0
simps101,Steve Simpson,San Diego Padres,PADRS,1,1,1,2,1973,1974,1,0.0,-0.44,-0.44,0,30,30,0,10,10,0.0,125.0,125.0,0.0,0.0,0.0
simpw101,Wayne Simpson,Cincinnati Reds,REDS,2,3,4,7,1972,1974,2,29.0,0.89,-28.11,1940,85,-1855,7657,116,-7541,179.0,420.0,241.0,68500.0,39550.0,-28950.0
simpw101,Wayne Simpson,Kansas City Royals,ROYALS,1,1,1,2,1974,1974,0,0.0,0.0,0.0,0,0,0,0,0,0,0.0,0.0,0.0,0.0,0.0,0.0
simpw101,Wayne Simpson,Pittsburgh Pirates,PIRATS,3,3,3,6,1975,1983,8,-0.85,6.88,7.73,131,845,714,293,2739,2446,92.0,0.0,-92.0,0.0,0.0,0.0
simsd101,Duke Sims,Cleveland Indians,INDINS,9,14,16,30,1970,1984,14,49.67,12.19,-37.48,2807,2706,-101,10352,8390,-1962,38.0,1919.0,1881.0,195250.0,296600.0,101350.0
simsd101,Duke Sims,New York Yankees,YANKS,2,2,3,5,1974,1978,4,18.37,3.77,-14.6,351,108,-243,118,205,87,5104.0,622.0,-4482.0,50000.0,0.0,-50000.0
simsl001,Lucas Sims,Atlanta Braves,BRAVES,1,3,1,4,2018,2020,2,1.47,1.06,-0.41,203,131,-72,53,396,343,403.0,0.0,-403.0,565000.0,645000.0,80000.0
sinam001,Matt Sinatro,Oakland Athletics,ATLTCS,1,1,1,2,1989,1991,2,0.0,-0.28,-0.28,0,19,19,0,26,26,0.0,0.0,0.0,0.0,0.0,0.0
sincs001,Steve Sinclair,Toronto Blue Jays,BJAYS,3,5,3,8,1999,2002,3,6.14,2.49,-3.65,321,312,-9,1103,1201,98,104.0,25.0,-79.0,0.0,2500000.0,2500000.0
singb101,Bill Singer,Los Angeles Dodgers,DOGRS,1,5,2,7,1972,1976,4,16.6,19.03,2.43,596,356,-240,1923,542,-1381,1810.0,2591.0,781.0,251500.0,115000.0,-136500.0
singb101,Bill Singer,California Angels,ANGELS,3,4,6,10,1975,1977,2,0.33,-0.47,-0.8,338,122,-216,1247,392,-855,194.0,18.0,-176.0,0.0,47000.0,47000.0
singb101,Bill Singer,Texas Rangers,RNGRS,5,14,9,23,1976,1988,12,43.04,39.52,-3.52,2266,2145,-121,8188,7408,-780,2609.0,4285.0,1676.0,330000.0,165000.0,-165000.0
singc001,Chris Singleton,San Francisco Giants,GIANTS,1,2,2,4,1997,1999,2,0.0,0.66,0.66,0,206,206,0,667,667,0.0,0.0,0.0,0.0,1700000.0,1700000.0
singc001,Chris Singleton,New York Yankees,YANKS,1,1,1,2,1998,1999,1,8.16,0.0,-8.16,420,0,-420,1528,0,-1528,0.0,0.0,0.0,0.0,0.0,0.0
singc001,Chris Singleton,Chicago White Sox,WSOX,1,1,1,2,2002,2005,3,1.84,1.61,-0.23,136,313,177,502,938,436,0.0,0.0,0.0,0.0,0.0,0.0
singd001,Duane Singleton,Milwaukee Brewers,BREWRS,1,1,1,2,1996,1996,0,-0.5,0.0,0.5,18,0,-18,61,0,-61,0.0,0.0,0.0,0.0,0.0,0.0
singe101,Elmer Singleton,New York Yankees,YANKS,1,1,2,3,1945,1945,0,-0.51,0.0,0.51,45,0,-45,16,0,-16,213.0,0.0,-213.0,0.0,0.0,0.0
singe101,Elmer Singleton,Boston Braves,BRAVES,4,7,6,13,1946,1952,6,-0.23,24.56,24.79,358,848,490,547,3228,2681,596.0,210.0,-386.0,0.0,0.0,0.0
singe101,Elmer Singleton,SanFrancisco,SanFrancisco,1,1,1,2,1950,1950,0,0.3,0.0,-0.3,42,0,-42,8,0,-8,109.0,0.0,-109.0,0.0,0.0,0.0
singe101,Elmer Singleton,Cincinnati Reds,REDS,5,9,14,23,1956,1965,9,64.39,16.2,-48.19,3193,1555,-1638,9922,3215,-6707,2746.0,1065.0,-1681.0,0.0,0.0,0.0
singf101,Fred Sington,Washington Senators,TWINS,1,1,2,3,1938,1939,1,1.0,0.0,-1.0,49,0,-49,167,0,-167,0.0,0.0,0.0,0.0,0.0,0.0
singf101,Fred Sington,Albany,Albany,1,1,3,4,1934,1934,0,0.43,0.0,-0.43,132,0,-132,445,0,-445,0.0,0.0,0.0,0.0,6000.0,6000.0
singj001,Jon Singleton,Philadelphia Phillies,PHILS,2,5,5,10,2011,2018,7,10.84,2.57,-8.27,1005,441,-564,3635,1629,-2006,674.0,0.0,-674.0,10400000.0,8200000.0,-2200000.0
singj101,John Singleton,Philadelphia Phillies,PHILS,4,9,8,17,1922,1936,14,25.37,3.27,-22.1,1352,2052,700,5364,8721,3357,77.0,0.0,-77.0,43100.0,12250.0,-30850.0
singk001,Ken Singleton,New York Mets,METS,2,5,3,8,1972,1979,7,27.3,7.07,-20.23,2407,595,-1812,9387,2358,-7029,284.0,578.0,294.0,110000.0,95000.0,-15000.0
singk001,Ken Singleton,Montreal Expos,NATEX,1,2,3,5,1974,1976,2,33.5,-0.16,-33.66,1482,37,-1445,6072,69,-6003,812.0,232.0,-580.0,98500.0,147000.0,48500.0
sipij101,John Sipin,St. Louis Cardinals,CARDS,3,5,4,9,1969,1972,3,0.79,1.88,1.09,125,189,64,357,73,-284,0.0,264.0,264.0,10000.0,7500.0,-2500.0
sippt001,Tony Sipp,Cleveland Indians,INDINS,4,8,11,19,2012,2019,7,4.46,23.51,19.05,328,937,609,554,910,356,512.0,4479.0,3967.0,22963900.0,12041333.0,-10922567.0
sirom001,Mike Sirotka,Chicago White Sox,WSOX,2,5,3,8,2001,2001,0,-0.46,1.34,1.8,81,17,-64,117,2,-115,78.0,302.0,224.0,0.0,0.0,0.0
sisca001,Andy Sisco,Kansas City Royals,ROYALS,2,3,2,5,2006,2009,3,0.12,0.28,0.16,146,224,78,259,764,505,45.0,0.0,-45.0,346500.0,350000.0,3500.0
siscs001,Steve Sisco,Atlanta Braves,BRAVES,1,1,1,2,2000,2004,4,0.0,-0.88,-0.88,0,124,124,0,195,195,0.0,0.0,0.0,0.0,201000.0,201000.0
siskd001,Doug Sisk,New York Mets,METS,3,3,4,7,1987,1996,9,1.0,0.17,-0.83,52,39,-13,0,18,18,283.0,68.0,-215.0,439000.0,0.0,-439000.0
siskd001,Doug Sisk,New York Mets,METS,1,1,1,2,1990,1990,0,-0.79,0.0,0.79,34,0,-34,0,0,0,50.0,0.0,-50.0,0.0,0.0,0.0
siskt101,Tommie Sisk,Pittsburgh Pirates,PIRATS,1,2,2,4,1969,1969,0,2.16,-0.66,-2.82,398,62,-336,1040,73,-967,429.0,0.0,-429.0,0.0,0.0,0.0
siskt101,Tommie Sisk,San Diego Padres,PADRS,1,1,1,2,1970,1970,0,-0.68,-0.37,0.31,34,5,-29,4,1,-3,100.0,16.0,-84.0,0.0,0.0,0.0
siskt101,Tommie Sisk,Chicago White Sox,WSOX,3,4,4,8,1970,1971,1,2.16,-0.62,-2.78,446,79,-367,1302,48,-1254,0.0,422.0,422.0,40000.0,53000.0,13000.0
sisld101,Dick Sisler,St. Louis Cardinals,CARDS,1,1,2,3,1948,1948,0,7.16,-0.77,-7.93,508,87,-421,2019,245,-1774,0.0,0.0,0.0,0.0,0.0,0.0
sisld101,Dick Sisler,Philadelphia Phillies,PHILS,3,8,7,15,1951,1957,6,12.59,16.8,4.21,922,1010,88,2813,3409,596,109.0,186.0,77.0,63000.0,37500.0,-25500.0
sisld101,Dick Sisler,Cincinnati Reds,REDS,2,3,4,7,1952,1953,1,3.75,-0.48,-4.23,393,72,-321,1163,232,-931,0.0,0.0,0.0,25500.0,0.0,-25500.0
sisld101,Dick Sisler,St. Louis Cardinals,CARDS,1,3,1,4,1954,1954,0,0.0,-0.06,-0.06,0,66,66,0,271,271,0.0,0.0,0.0,0.0,0.0,0.0
sisld102,Dave Sisler,Boston Red Sox,RSOX,2,3,2,5,1959,1959,0,7.37,-0.54,-7.91,476,29,-447,344,14,-330,1329.0,127.0,-1202.0,11000.0,0.0,-11000.0
sisld102,Dave Sisler,Washington Senators,RNGRS,26,46,51,97,1961,1986,25,143.34,114.36,-28.98,8501,6833,-1668,19421,19545,124,25708.0,12819.0,-12889.0,358650.0,824500.0,465850.0
sivep101,Pete Sivess,Philadelphia Phillies,PHILS,1,2,1,3,1939,1939,0,0.0,0.06,0.06,0,5,5,0,20,20,0.0,0.0,0.0,0.0,0.0,0.0
siwyj001,Jim Siwy,Chicago White Sox,WSOX,1,1,1,2,1984,1985,1,0.0,1.84,1.84,0,76,76,0,1,1,0.0,420.0,420.0,0.0,400000.0,400000.0
sizeg001,Grady Sizemore,Montreal Expos,NATEX,2,6,6,12,2002,2004,2,48.64,-2.57,-51.21,1323,330,-993,4723,156,-4567,4264.0,874.0,-3390.0,4000000.0,4925000.0,925000.0
sizes001,Scott Sizemore,Detroit Tigers,TIGRS,1,1,1,2,2011,2011,0,1.13,-0.41,-1.54,95,21,-74,361,0,-361,0.0,56.0,56.0,0.0,0.0,0.0
sizet101,Ted Sizemore,Los Angeles Dodgers,DOGRS,2,3,3,6,1970,1978,8,24.33,19.6,-4.73,1044,519,-525,4315,1112,-3203,0.0,3594.0,3594.0,125000.0,143750.0,18750.0
sizet101,Ted Sizemore,St. Louis Cardinals,CARDS,18,41,35,76,1976,1994,18,91.55,141.75,50.2,8569,6818,-1751,23900,23377,-523,10540.0,4019.0,-6521.0,3088333.0,809167.0,-2279166.0
sizet101,Ted Sizemore,Los Angeles Dodgers,DOGRS,1,1,2,3,1976,1980,4,0.97,0.11,-0.86,260,126,-134,967,302,-665,0.0,0.0,0.0,0.0,0.0,0.0
sizet101,Ted Sizemore,Philadelphia Phillies,PHILS,7,17,13,30,1979,1999,20,25.6,38.01,12.41,2807,3562,755,9986,9588,-398,522.0,1259.0,737.0,2950000.0,165000.0,-2785000.0
sizet101,Ted Sizemore,Chicago Cubs,CUBS,6,10,10,20,1979,1990,11,12.53,11.46,-1.07,946,694,-252,2591,463,-2128,1070.0,3095.0,2025.0,890000.0,85000.0,-805000.0
skaff101,Frank Skaff,Brooklyn Dodgers,DOGRS,1,2,1,3,1937,1937,0,0.0,-0.16,-0.16,0,12,12,0,30,30,0.0,0.0,0.0,0.0,0.0,0.0
skagt001,Tyler Skaggs,Anaheim Angels,ANGELS,1,4,1,5,2010,2012,2,13.1,6.5,-6.6,498,84,-414,497,11,-486,4323.0,1527.0,-2796.0,3700000.0,8250000.0,4550000.0
skagt001,Tyler Skaggs,Arizona Diamondbacks,DBACKS,2,4,7,11,2013,2018,5,5.96,2.34,-3.62,303,392,89,439,1311,872,1761.0,119.0,-1642.0,491000.0,2640000.0,2149000.0
skidr101,Roe Skidmore,Chicago Cubs,CUBS,1,3,2,5,1970,1973,3,1.15,0.0,-1.15,69,0,-69,29,0,-29,290.0,0.0,-290.0,0.0,0.0,0.0
skidr101,Roe Skidmore,Cincinnati Reds,REDS,1,2,2,4,1973,1973,0,0.24,0.19,-0.05,16,36,20,0,60,60,24.0,0.0,-24.0,16000.0,0.0,-16000.0
skidr101,Roe Skidmore,Houston Astros,ASTROS,1,1,1,2,1974,1974,0,0.0,0.0,0.0,0,0,0,0,0,0,0.0,0.0,0.0,0.0,19000.0,19000.0
skidr101,Roe Skidmore,Chicago White Sox,WSOX,2,2,3,5,1972,1975,3,0.3,1.16,0.86,50,152,102,93,427,334,0.0,0.0,0.0,0.0,0.0,0.0
skinb101,Bob Skinner,Pittsburgh Pirates,PIRATS,1,1,1,2,1963,1966,3,0.45,-0.21,-0.66,97,339,242,280,782,502,0.0,0.0,0.0,31000.0,0.0,-31000.0
skinb101,Bob Skinner,Cincinnati Reds,REDS,1,1,2,3,1964,1964,0,0.73,0.0,-0.73,184,0,-184,341,0,-341,0.0,0.0,0.0,26500.0,0.0,-26500.0
skinc102,Camp Skinner,New York Yankees,YANKS,1,4,1,5,1923,1934,11,-1.25,33.68,34.93,272,692,420,598,908,310,765.0,6610.0,5845.0,0.0,0.0,0.0
skinj001,Joel Skinner,Chicago White Sox,WSOX,1,3,3,6,1986,1991,5,0.75,-0.11,-0.86,650,316,-334,1809,1056,-753,0.0,0.0,0.0,475000.0,400873.0,-74127.0
skinj001,Joel Skinner,New York Yankees,YANKS,1,2,1,3,1989,1992,3,1.27,3.12,1.85,281,519,238,803,1911,1108,0.0,0.0,0.0,0.0,0.0,0.0
skizl101,Lou Skizas,New York Yankees,YANKS,3,5,6,11,1956,1960,4,1.84,-2.55,-4.39,364,104,-260,1055,53,-1002,0.0,406.0,406.0,4500.0,7000.0,2500.0
skizl101,Lou Skizas,Kansas City Athletics,ATLTCS,31,62,61,123,1957,1976,19,95.85,56.38,-39.47,9593,6643,-2950,23097,19018,-4079,12004.0,6179.0,-5825.0,476100.0,606500.0,130400.0
skizl101,Lou Skizas,Chicago White Sox,WSOX,1,2,1,3,1959,1959,0,0.02,-0.82,-0.84,10,26,16,1,100,99,22.0,0.0,-22.0,10500.0,0.0,-10500.0
skokc101,Craig Skok,Boston Red Sox,RSOX,2,4,3,7,1975,1977,2,14.8,6.95,-7.85,545,58,-487,1514,0,-1514,2654.0,1206.0,-1448.0,200000.0,190000.0,-10000.0
skowb101,Bill Skowron,New York Yankees,YANKS,1,1,1,2,1962,1965,3,-1.13,1.38,2.51,89,101,12,256,75,-181,0.0,685.0,685.0,37500.0,0.0,-37500.0
skowb101,Bill Skowron,Washington Senators,RNGRS,2,3,3,6,1964,1975,11,4.84,-0.04,-4.88,347,541,194,1279,559,-720,0.0,1708.0,1708.0,55000.0,42750.0,-12250.0
skowb101,Bill Skowron,Chicago White Sox,WSOX,2,2,3,5,1967,1969,2,-0.88,-0.11,0.77,62,3,-59,131,4,-127,0.0,0.0,0.0,36000.0,0.0,-36000.0
skrmm001,Matt Skrmetta,Detroit Tigers,TIGRS,1,2,1,3,1997,1997,0,2.51,-0.37,-2.88,188,52,-136,612,129,-483,0.0,0.0,0.0,0.0,0.0,0.0
skrmm001,Matt Skrmetta,Montreal Expos,NATEX,1,1,1,2,2000,2000,0,-0.6,0.0,0.6,16,0,-16,2,0,-2,28.0,0.0,-28.0,0.0,0.0,0.0
sladg101,Gordon Slade,Brooklyn Dodgers,DOGRS,1,2,2,4,1933,1934,1,1.18,1.07,-0.11,133,145,12,117,327,210,474.0,679.0,205.0,0.0,0.0,0.0
slagj102,Jimmy Slagle,Pittsburgh Pirates,PIRATS,2,4,2,6,1898,1901,3,1.28,0.36,-0.92,408,35,-373,1684,149,-1535,0.0,0.0,0.0,0.0,0.0,0.0
slatj001,Jim Slaton,Milwaukee Brewers,BREWRS,1,2,1,3,1977,1986,9,2.06,21.52,19.46,58,1149,1091,0,4658,4658,821.0,0.0,-821.0,45000.0,60000.0,15000.0
slatj001,Jim Slaton,Milwaukee Brewers,BREWRS,1,1,1,2,1983,1983,0,-0.09,0.0,0.09,75,0,-75,0,0,0,1154.0,0.0,-1154.0,247000.0,145000.0,-102000.0
slaud001,Don Slaught,Kansas City Royals,ROYALS,2,3,3,6,1985,1988,3,2.6,1.39,-1.21,377,358,-19,1204,1074,-130,0.0,58.0,58.0,0.0,0.0,0.0
slaud001,Don Slaught,Texas Rangers,RNGRS,1,1,1,2,1987,1991,4,3.59,1.41,-2.18,214,80,-134,750,0,-750,0.0,361.0,361.0,431500.0,68000.0,-363500.0
slaud001,Don Slaught,New York Yankees,YANKS,1,1,2,3,1989,1992,3,10.25,1.53,-8.72,475,54,-421,1624,0,-1624,0.0,266.0,266.0,650000.0,750000.0,100000.0
slaud001,Don Slaught,California Angels,ANGELS,1,1,1,2,1996,1996,0,-0.34,0.0,0.34,14,0,-14,39,0,-39,0.0,0.0,0.0,350000.0,0.0,-350000.0
slaue101,Enos Slaughter,St. Louis Cardinals,CARDS,23,49,45,94,1954,1972,18,76.87,67.34,-9.53,7508,3672,-3836,20292,10279,-10013,6403.0,6334.0,-69.0,130500.0,36000.0,-94500.0
slaue101,Enos Slaughter,New York Yankees,YANKS,1,2,2,4,1955,1955,0,3.23,0.0,-3.23,249,0,-249,578,0,-578,134.0,0.0,-134.0,20000.0,0.0,-20000.0
sleal101,Lou Sleater,St.Louis Browns,ORLS,1,2,1,3,1952,1952,0,-0.84,0.79,1.63,38,55,17,46,190,144,171.0,0.0,-171.0,6000.0,14500.0,8500.0
sleal101,Lou Sleater,Milwaukee Braves,BRAVES,1,1,1,2,1957,1957,0,0.98,0.0,-0.98,90,0,-90,24,0,-24,224.0,0.0,-224.0,0.0,0.0,0.0
sledt001,Terrmel Sledge,Seattle Mariners,MARNRS,1,2,1,3,2000,2001,1,1.04,-0.19,-1.23,169,10,-159,492,12,-480,20.0,0.0,-20.0,0.0,1350000.0,1350000.0
sledt001,Terrmel Sledge,Washington Nationals,NATEX,1,3,1,4,2005,2006,1,0.68,6.08,5.4,217,159,-58,754,728,-26,26.0,0.0,-26.0,3395000.0,7500000.0,4105000.0
sledt001,Terrmel Sledge,Texas Rangers,RNGRS,1,3,3,6,2006,2007,1,28.55,3.75,-24.8,1126,114,-1012,3924,0,-3924,1652.0,471.0,-1181.0,0.0,0.0,0.0
sloch001,Heathcliff Slocumb,Chicago Cubs,CUBS,3,5,6,11,1993,2001,8,0.23,2.96,2.73,314,769,455,362,1943,1581,1448.0,490.0,-958.0,5325000.0,1200000.0,-4125000.0
sloch001,Heathcliff Slocumb,Cleveland Indians,INDINS,1,1,1,2,1993,1995,2,2.12,-0.31,-2.43,226,54,-172,6,93,87,413.0,0.0,-413.0,165000.0,150000.0,-15000.0
sloch001,Heathcliff Slocumb,Philadelphia Phillies,PHILS,2,4,4,8,1996,1999,3,1.93,-0.39,-2.32,220,301,81,209,170,-39,390.0,444.0,54.0,225000.0,0.0,-225000.0
sloch001,Heathcliff Slocumb,Boston Red Sox,RSOX,1,1,2,3,1997,2011,14,0.43,43.6,43.17,90,1956,1866,0,5862,5862,288.0,3111.0,2823.0,2300000.0,0.0,-2300000.0
sloch001,Heathcliff Slocumb,St. Louis Cardinals,CARDS,1,2,2,4,2000,2000,0,0.41,0.16,-0.25,133,17,-116,223,58,-165,57.0,0.0,-57.0,1600000.0,1750000.0,150000.0
slowk001,Kevin Slowey,Colorado Rockies,ROCKS,1,2,1,3,2012,2012,0,0.0,0.09,0.09,0,4,4,0,0,0,0.0,6.0,6.0,0.0,0.0,0.0
slowk001,Kevin Slowey,Minnesota Twins,TWINS,1,1,1,2,2011,2011,0,0.0,0.0,0.0,0,0,0,0,0,0,0.0,0.0,0.0,2700000.0,0.0,-2700000.0
smajc001,Craig Smajstrla,Chicago White Sox,WSOX,1,1,1,2,1985,1985,0,0.0,0.0,0.0,0,0,0,0,0,0,0.0,0.0,0.0,0.0,0.0,0.0
smala001,Aaron Small,Toronto Blue Jays,BJAYS,1,1,1,2,1995,1995,0,-0.5,0.0,0.5,28,0,-28,2,0,-2,68.0,0.0,-68.0,0.0,0.0,0.0
smalj101,Jim Small,Detroit Tigers,TIGRS,4,12,12,24,1957,1964,7,6.47,14.38,7.91,1197,947,-250,3186,1303,-1883,1459.0,3692.0,2233.0,20000.0,9000.0,-11000.0
smalr001,Roy Smalley,Texas Rangers,RNGRS,5,14,9,23,1976,1988,12,43.04,39.52,-3.52,2266,2145,-121,8188,7408,-780,2609.0,4285.0,1676.0,330000.0,165000.0,-165000.0
smalr001,Roy Smalley,Minnesota Twins,TWINS,3,4,7,11,1982,1992,10,5.08,17.96,12.88,415,1594,1179,1314,3798,2484,157.0,1666.0,1509.0,1325000.0,873333.0,-451667.0
smalr001,Roy Smalley,New York Yankees,YANKS,9,13,16,29,1984,1997,13,30.87,14.75,-16.12,1297,1082,-215,2038,1524,-514,6414.0,4016.0,-2398.0,4250000.0,2212500.0,-2037500.0
smalr001,Roy Smalley,Chicago White Sox,WSOX,1,1,2,3,1985,1985,0,2.04,0.0,-2.04,382,0,-382,1330,0,-1330,0.0,0.0,0.0,0.0,0.0,0.0
smalr101,Roy Smalley,Chicago Cubs,CUBS,1,1,2,3,1954,1955,1,-0.06,-0.23,-0.17,25,37,12,42,31,-11,0.0,252.0,252.0,0.0,0.0,0.0
smeld001,Devin Smeltzer,Los Angeles Dodgers,DOGRS,1,3,1,4,2018,2018,0,0.86,0.11,-0.75,69,47,-22,205,170,-35,209.0,0.0,-209.0,9000000.0,9000000.0,0.0
smilj001,John Smiley,Pittsburgh Pirates,PIRATS,3,4,7,11,1992,2006,14,34.72,14.13,-20.59,539,1081,542,727,1318,591,5379.0,5331.0,-48.0,7350000.0,421500.0,-6928500.0
smilj001,John Smiley,Cincinnati Reds,REDS,5,9,11,20,1997,2005,8,10.23,15.87,5.64,1063,1597,534,3584,2539,-1045,112.0,2236.0,2124.0,7950000.0,1050000.0,-6900000.0
smita101,Art Smith,Toronto,Toronto,1,1,1,2,1932,1932,0,-0.57,0.0,0.57,6,0,-6,1,0,-1,21.0,0.0,-21.0,0.0,5000.0,5000.0
smita102,Al Smith,Cleveland Indians,INDINS,8,14,14,28,1957,1968,11,114.78,28.23,-86.55,4690,1762,-2928,15896,6646,-9250,7534.0,133.0,-7401.0,15000.0,32000.0,17000.0
smita102,Al Smith,Chicago White Sox,WSOX,8,13,17,30,1963,1971,8,31.42,56.47,25.05,2785,3257,472,9290,8734,-556,740.0,2775.0,2035.0,72500.0,33000.0,-39500.0
smita102,Al Smith,Baltimore Orioles,ORLS,1,2,1,3,1963,1964,1,-0.9,0.52,1.42,61,66,5,147,172,25,0.0,0.0,0.0,36500.0,0.0,-36500.0
smita105,Aleck Smith,Baltimore Orioles,BLN,3,4,4,8,1899,1906,7,-0.64,1.86,2.5,170,177,7,604,686,82,204.0,0.0,-204.0,0.0,0.0,0.0
smita105,Aleck Smith,Brooklyn Dodgers,DOGRS,1,2,1,3,1899,1902,3,2.44,3.21,0.77,77,202,125,321,766,445,0.0,0.0,0.0,0.0,0.0,0.0
smitb001,Bryn Smith,Baltimore Orioles,ORLS,3,7,7,14,1977,1987,10,17.37,17.58,0.21,774,1051,277,733,2635,1902,4935.0,985.0,-3950.0,558333.0,0.0,-558333.0
smitb004,Bud Smith,St. Louis Cardinals,CARDS,2,4,4,8,2002,2009,7,23.28,30.12,6.84,951,826,-125,3803,3406,-397,107.0,0.0,-107.0,7000000.0,8600000.0,1600000.0
smitb005,Burch Smith,San Diego Padres,PADRS,3,7,6,13,2014,2020,6,-1.53,-1.48,0.05,295,146,-149,1021,301,-720,0.0,78.0,78.0,506400.0,10644200.0,10137800.0
smitb005,Burch Smith,New York Mets,METS,1,1,1,2,2017,2017,0,-1.09,0.0,1.09,40,0,-40,0,0,0,234.0,0.0,-234.0,0.0,0.0,0.0
smitb006,Blake Smith,Los Angeles Dodgers,DOGRS,1,1,1,2,2015,2015,0,-0.04,-0.2,-0.16,6,2,-4,0,1,1,13.0,10.0,-3.0,0.0,0.0,0.0
smitb104,Bobby Smith,St. Louis Cardinals,CARDS,1,2,1,3,1959,1963,4,1.18,3.25,2.07,225,305,80,435,785,350,151.0,0.0,-151.0,9000.0,0.0,-9000.0
smitb104,Bobby Smith,New York Mets,METS,4,6,5,11,1962,1970,8,-0.09,3.45,3.54,269,654,385,400,1331,931,516.0,1427.0,911.0,10500.0,26000.0,15500.0
smitb104,Bobby Smith,Chicago Cubs,CUBS,5,10,7,17,1962,1977,15,11.99,38.79,26.8,728,2444,1716,383,6330,5947,3515.0,5246.0,1731.0,122500.0,47500.0,-75000.0
smitb105,Bernie Smith,New York Mets,METS,1,1,1,2,1969,1969,0,0.02,0.0,-0.02,59,0,-59,127,0,-127,0.0,0.0,0.0,0.0,0.0,0.0
smitb108,Bob Smith,Boston Red Sox,RSOX,1,1,1,2,1959,1959,0,-0.33,0.0,0.33,2,0,-2,0,0,0,2.0,0.0,-2.0,0.0,0.0,0.0
smitb108,Bob Smith,Chicago Cubs,CUBS,1,1,1,2,1959,1959,0,-0.45,0.16,0.61,24,41,17,6,91,85,88.0,0.0,-88.0,0.0,0.0,0.0
smitb110,Bob Smith,Boston Braves,BRAVES,5,9,7,16,1930,1938,8,10.35,19.77,9.42,741,1862,1121,2307,7255,4948,1075.0,89.0,-986.0,16000.0,3600.0,-12400.0
smitb110,Bob Smith,Chicago Cubs,CUBS,2,7,3,10,1932,1941,9,3.2,27.52,24.32,621,896,275,1233,2014,781,2473.0,4458.0,1985.0,0.0,0.0,0.0
smitb111,Bull Smith,Wheeling,Wheeling,1,1,2,3,1906,1906,0,0.0,0.0,0.0,1,0,-1,1,0,-1,0.0,0.0,0.0,0.0,0.0,0.0
smitb112,Bill Smith,St. Louis Cardinals,CARDS,1,2,1,3,1959,1963,4,1.18,3.25,2.07,225,305,80,435,785,350,151.0,0.0,-151.0,9000.0,0.0,-9000.0
smitc001,Chuck Smith,Texas Rangers,RNGRS,3,3,3,6,2000,2001,1,3.28,0.5,-2.78,168,38,-130,378,134,-244,632.0,0.0,-632.0,0.0,535000.0,535000.0
smitc004,Carson Smith,Seattle Mariners,MARNRS,2,3,3,6,2015,2018,3,-0.47,2.16,2.63,84,70,-14,9,13,4,729.0,1001.0,272.0,0.0,3666000.0,3666000.0
smitc006,Caleb Smith,New York Yankees,YANKS,1,2,2,4,2017,2017,0,5.67,0.0,-5.67,313,0,-313,917,0,-917,701.0,0.0,-701.0,0.0,0.0,0.0
smitc006,Caleb Smith,Miami Marlins,MARLNS,2,4,2,6,2020,2021,1,2.61,2.79,0.18,160,115,-45,284,406,122,441.0,172.0,-269.0,0.0,0.0,0.0
smitc101,Chris Smith,Texas Rangers,RNGRS,1,2,1,3,1980,1980,0,-0.15,1.32,1.47,9,109,100,9,388,379,0.0,0.0,0.0,0.0,0.0,0.0
smitc101,Chris Smith,Montreal Expos,NATEX,1,1,1,2,1983,1986,3,0.33,1.35,1.02,22,318,296,77,626,549,0.0,0.0,0.0,0.0,0.0,0.0
smitc103,Carr Smith,Washington Senators,TWINS,1,2,1,3,1924,1927,3,1.24,9.07,7.83,60,146,86,31,190,159,281.0,1502.0,1221.0,2100.0,7500.0,5400.0
smitc105,Charley Smith,Los Angeles Dodgers,DOGRS,2,3,3,6,1961,1962,1,7.87,-0.43,-8.3,525,100,-425,2040,21,-2019,0.0,267.0,267.0,6000.0,0.0,-6000.0
smitc105,Charley Smith,Philadelphia Phillies,PHILS,1,2,1,3,1961,1964,3,5.78,3.33,-2.45,417,331,-86,480,1188,708,2599.0,0.0,-2599.0,0.0,34000.0,34000.0
smitc105,Charley Smith,Chicago White Sox,WSOX,1,1,3,4,1964,1964,0,2.83,0.0,-2.83,262,0,-262,1002,0,-1002,0.0,0.0,0.0,10000.0,0.0,-10000.0
smitc105,Charley Smith,New York Mets,METS,3,5,4,9,1965,1970,5,3.02,4.23,1.21,629,336,-293,1532,1195,-337,1019.0,0.0,-1019.0,88000.0,85000.0,-3000.0
smitc105,Charley Smith,St. Louis Cardinals,CARDS,1,1,1,2,1966,1966,0,1.2,0.0,-1.2,181,0,-181,541,0,-541,0.0,0.0,0.0,20000.0,75000.0,55000.0
smitc105,Charley Smith,New York Yankees,YANKS,2,2,2,4,1968,1969,1,-0.33,0.0,0.33,44,1,-43,49,1,-48,0.0,0.0,0.0,41000.0,16000.0,-25000.0
smitc107,Charlie Smith,Washington Senators,TWINS,1,1,1,2,1909,1912,3,2.19,5.78,3.59,56,290,234,66,1206,1140,550.0,0.0,-550.0,0.0,0.0,0.0
smitd003,Dwight Smith,California Angels,ANGELS,1,1,1,2,1994,1994,0,0.18,0.0,-0.18,28,0,-28,80,0,-80,0.0,0.0,0.0,755718.0,0.0,-755718.0
smitd007,Dwight Smith,Toronto Blue Jays,BJAYS,1,1,1,2,2019,2019,0,-1.05,0.0,1.05,122,0,-122,464,0,-464,0.0,0.0,0.0,0.0,0.0,0.0
smitd009,Drew Smith,Detroit Tigers,TIGRS,1,1,1,2,2017,2019,2,0.0,0.11,0.11,0,185,185,0,654,654,0.0,0.0,0.0,0.0,0.0,0.0
smitd009,Drew Smith,Tampa Bay Devil Rays,RAYS,1,1,1,2,2017,2017,0,1.12,0.13,-0.99,119,52,-67,1,200,199,229.0,0.0,-229.0,0.0,7250000.0,7250000.0
smitd104,Dick Smith,New York Mets,METS,1,1,1,2,1964,1964,0,-0.22,0.0,0.22,10,0,-10,7,0,-7,0.0,0.0,0.0,0.0,0.0,0.0
smitd104,Dick Smith,Los Angeles Dodgers,DOGRS,1,1,1,2,1967,1967,0,0.0,0.0,0.0,0,0,0,0,0,0,0.0,0.0,0.0,0.0,0.0,0.0
smite104,Elmer Smith,Cleveland Indians,INDINS,1,2,2,4,1916,1916,0,1.57,0.61,-0.96,293,50,-243,1105,56,-1049,0.0,182.0,182.0,0.0,5000.0,5000.0
smite104,Elmer Smith,Cleveland Indians,INDINS,1,3,1,4,1921,1923,2,18.85,0.33,-18.52,768,142,-626,3109,582,-2527,0.0,0.0,0.0,10000.0,5000.0,-5000.0
smite104,Elmer Smith,Boston Red Sox,RSOX,3,7,10,17,1922,1935,13,18.05,-3.44,-21.49,1736,754,-982,6924,2797,-4127,0.0,159.0,159.0,16300.0,15750.0,-550.0
smite104,Elmer Smith,New York Yankees,YANKS,1,2,1,3,1924,1924,0,0.0,0.38,0.38,0,24,24,0,39,39,0.0,0.0,0.0,0.0,0.0,0.0
smite106,Earl Smith,Rochester,Rochester,1,1,6,7,1919,1938,19,4.82,0.0,-4.82,315,0,-315,900,0,-900,0.0,0.0,0.0,0.0,0.0,0.0
smite106,Earl Smith,New York Giants,GIANTS,1,2,2,4,1923,1923,0,10.49,3.07,-7.42,305,87,-218,539,194,-345,2035.0,323.0,-1712.0,12500.0,9600.0,-2900.0
smite107,Earl Smith,St.Louis Browns,ORLS,1,1,1,2,1921,1924,3,-1.27,-0.22,1.05,124,235,111,416,999,583,0.0,0.0,0.0,4200.0,4000.0,-200.0
smitf104,Frank Smith,Cincinnati Reds,REDS,6,10,16,26,1954,1965,11,65.0,15.82,-49.18,3249,1819,-1430,9927,3953,-5974,2863.0,1424.0,-1439.0,10000.0,0.0,-10000.0
smitf106,Frank Smith,Chicago White Sox,WSOX,1,2,2,4,1910,1915,5,0.0,10.22,10.22,86,540,454,299,2308,2009,88.0,0.0,-88.0,0.0,0.0,0.0
smitg001,Greg Smith,Chicago Cubs,CUBS,2,2,3,5,1990,1995,5,2.23,3.37,1.14,339,434,95,1423,1118,-305,0.0,468.0,468.0,0.0,0.0,0.0
smitg002,Greg Smith,Arizona Diamondbacks,DBACKS,6,14,16,30,2007,2018,11,24.99,30.17,5.18,855,1190,335,1319,2038,719,6760.0,6326.0,-434.0,14741000.0,15790000.0,1049000.0
smitg002,Greg Smith,Oakland Athletics,ATLTCS,6,8,8,16,2008,2014,6,50.06,1.09,-48.97,2622,167,-2455,9256,628,-8628,794.0,101.0,-693.0,16800000.0,9919000.0,-6881000.0
smitg101,George Smith,Detroit Tigers,TIGRS,1,3,1,4,1965,1967,2,0.26,-0.68,-0.94,350,64,-286,935,31,-904,0.0,314.0,314.0,32800.0,33000.0,200.0
smitg103,Germany Smith,Cincinnati Reds,REDS,1,3,1,4,1896,1906,10,0.1,7.82,7.72,152,1229,1077,519,5155,4636,447.0,0.0,-447.0,0.0,0.0,0.0
smitg104,George Smith,New York Giants,GIANTS,2,7,2,9,1919,1926,7,9.28,14.26,4.98,1335,470,-865,2807,556,-2251,5840.0,4330.0,-1510.0,10442.0,9655.0,-787.0
smitg104,George Smith,Philadelphia Phillies,PHILS,1,1,1,2,1923,1928,5,0.11,9.33,9.22,50,371,321,27,424,397,273.0,2366.0,2093.0,0.0,0.0,0.0
smith101,Happy Smith,Chicago Cubs,CUBS,1,3,1,4,1910,1912,2,-2.31,2.43,4.74,377,121,-256,1406,145,-1261,0.0,1039.0,1039.0,0.0,0.0,0.0
smith104,Harry Smith,Milwaukee,Milwaukee,1,1,1,2,1900,1900,0,-0.17,0.0,0.17,178,0,-178,644,0,-644,0.0,0.0,0.0,0.0,0.0,0.0
smith106,Hal Smith,New York Yankees,YANKS,12,33,27,60,1954,1970,16,40.55,76.98,36.43,5201,4368,-833,16466,10777,-5689,3212.0,10751.0,7539.0,302500.0,109500.0,-193000.0
smith106,Hal Smith,Baltimore Orioles,ORLS,1,1,1,2,1956,1960,4,2.11,-0.69,-2.8,351,240,-111,1215,585,-630,0.0,0.0,0.0,12500.0,11500.0,-1000.0
smith106,Hal Smith,Kansas City Athletics,ATLTCS,5,7,8,15,1959,1963,4,12.25,-4.01,-16.26,1107,620,-487,1242,1389,147,2603.0,1481.0,-1122.0,16500.0,0.0,-16500.0
smith110,Heinie Smith,New York Giants,GIANTS,1,1,1,2,1903,1903,0,-0.14,0.0,0.14,93,0,-93,376,0,-376,0.0,0.0,0.0,0.0,0.0,0.0
smitj001,Jason Smith,Chicago Cubs,CUBS,1,2,1,3,2001,2002,1,-0.39,3.26,3.65,27,195,168,73,796,723,0.0,0.0,0.0,665000.0,6500000.0,5835000.0
smitj002,Joe Smith,New York Mets,METS,1,7,3,10,2008,2010,2,7.03,-1.25,-8.28,462,358,-104,389,179,-210,868.0,325.0,-543.0,3398000.0,0.0,-3398000.0
smitj002,Joe Smith,Anaheim Angels,ANGELS,1,1,1,2,2016,2016,0,0.27,0.0,-0.27,31,0,-31,0,0,0,43.0,0.0,-43.0,0.0,0.0,0.0
smitj002,Joe Smith,Toronto Blue Jays,BJAYS,1,1,2,3,2017,2020,3,0.32,0.5,0.18,21,52,31,0,0,0,55.0,348.0,293.0,3000000.0,0.0,-3000000.0
smitj002,Joe Smith,Houston Astros,ASTROS,1,2,2,4,2021,2021,0,1.64,0.78,-0.86,83,33,-50,253,0,-253,54.0,87.0,33.0,4000000.0,3500000.0,-500000.0
smitj107,Jimmy Smith,Chicago Whales,CHF,1,2,1,3,1915,1916,1,0.0,0.08,0.08,0,24,24,0,92,92,0.0,0.0,0.0,0.0,0.0,0.0
smitj107,Jimmy Smith,Boston Braves,BRAVES,1,2,1,3,1919,1922,3,0.38,-0.18,-0.56,28,536,508,48,2218,2170,0.0,0.0,0.0,0.0,0.0,0.0
smitj107,Jimmy Smith,Philadelphia Phillies,PHILS,4,9,8,17,1922,1936,14,25.37,3.27,-22.1,1352,2052,700,5364,8721,3357,77.0,0.0,-77.0,43100.0,12250.0,-30850.0
smitj110,John Smith,Boston Red Sox,RSOX,1,2,1,3,1931,1931,0,0.0,0.0,0.0,0,0,0,0,0,0,0.0,0.0,0.0,2400.0,0.0,-2400.0
smitk101,Keith Smith,Texas Rangers,RNGRS,1,1,1,2,1979,1979,0,-0.27,0.0,0.27,30,0,-30,46,0,-46,0.0,0.0,0.0,0.0,0.0,0.0
smitl001,Lee Smith,Chicago Cubs,CUBS,2,4,4,8,1987,1992,5,11.91,1.25,-10.66,771,664,-107,1598,1497,-101,888.0,975.0,87.0,1240000.0,1225000.0,-15000.0
smitl001,Lee Smith,Boston Red Sox,RSOX,1,1,1,2,1990,1992,2,4.33,3.1,-1.23,490,409,-81,4,1578,1574,800.0,0.0,-800.0,1200000.0,1500000.0,300000.0
smitl001,Lee Smith,St. Louis Cardinals,CARDS,2,4,4,8,1993,1997,4,0.24,-1.47,-1.71,433,153,-280,688,182,-506,209.0,191.0,-18.0,7634167.0,2250000.0,-5384167.0
smitl001,Lee Smith,California Angels,ANGELS,2,3,3,6,1996,1998,2,1.77,2.75,0.98,237,228,-9,342,727,385,311.0,157.0,-154.0,3192000.0,3664500.0,472500.0
smitl002,Lonnie Smith,Philadelphia Phillies,PHILS,5,9,9,18,1981,1988,7,19.34,6.22,-13.12,1697,579,-1118,5512,1540,-3972,737.0,444.0,-293.0,1380000.0,532500.0,-847500.0
smitl002,Lonnie Smith,St. Louis Cardinals,CARDS,1,1,1,2,1985,1990,5,3.36,0.07,-3.29,302,274,-28,1263,462,-801,0.0,0.0,0.0,740000.0,0.0,-740000.0
smitl002,Lonnie Smith,Pittsburgh Pirates,PIRATS,1,1,2,3,1993,1993,0,-0.1,0.0,0.1,44,0,-44,104,0,-104,0.0,0.0,0.0,1000000.0,0.0,-1000000.0
smitm001,Mike Smith,Cincinnati Reds,REDS,1,1,1,2,1986,1986,0,0.06,0.0,-0.06,10,0,-10,2,0,-2,26.0,0.0,-26.0,0.0,0.0,0.0
smitm001,Mike Smith,Montreal Expos,NATEX,1,1,1,2,1988,1988,0,0.0,0.0,0.0,0,0,0,0,0,0,0.0,0.0,0.0,0.0,0.0,0.0
smitm001,Mike Smith,Baltimore Orioles,ORLS,1,1,1,2,1989,1989,0,-0.2,0.0,0.2,32,0,-32,3,0,-3,72.0,0.0,-72.0,0.0,0.0,0.0
smitm002,Mike Smithson,Boston Red Sox,RSOX,1,1,1,2,1982,1985,3,2.77,1.72,-1.05,41,64,23,0,0,0,810.0,351.0,-459.0,0.0,0.0,0.0
smitm002,Mike Smithson,Texas Rangers,RNGRS,1,3,1,4,1983,1986,3,7.12,8.55,1.43,212,414,202,0,1715,1715,3956.0,0.0,-3956.0,0.0,250000.0,250000.0
smitm004,Mark Smith,Baltimore Orioles,ORLS,1,1,1,2,1997,1997,0,0.0,0.0,0.0,0,0,0,0,0,0,0.0,0.0,0.0,0.0,0.0,0.0
smitm004,Mark Smith,San Diego Padres,PADRS,13,19,19,38,1997,2005,8,0.7,9.11,8.41,1015,1374,359,2046,2428,382,1171.0,1867.0,696.0,13510000.0,3990000.0,-9520000.0
smitm006,Matt Smith,New York Yankees,YANKS,1,4,2,6,2006,2008,2,0.06,7.5,7.44,46,382,336,0,1631,1631,38.0,136.0,98.0,0.0,16900000.0,16900000.0
smitm007,Mallex Smith,San Diego Padres,PADRS,1,4,2,6,2014,2016,2,14.14,4.21,-9.93,618,150,-468,1586,620,-966,1341.0,0.0,-1341.0,0.0,14250000.0,14250000.0
smitm007,Mallex Smith,Atlanta Braves,BRAVES,1,2,2,4,2017,2019,2,-0.62,-0.29,0.33,157,27,-130,613,12,-601,23.0,147.0,124.0,0.0,0.0,0.0
smitm007,Mallex Smith,Seattle Mariners,MARNRS,1,3,1,4,2017,2017,0,6.86,0.0,-6.86,335,0,-335,833,0,-833,1499.0,0.0,-1499.0,0.0,0.0,0.0
smitm007,Mallex Smith,Tampa Bay Devil Rays,RAYS,2,3,5,8,2018,2021,3,0.34,0.28,-0.06,245,235,-10,948,604,-344,0.0,88.0,88.0,0.0,4125000.0,4125000.0
smitm101,Mark Smith,Baltimore Orioles,ORLS,1,1,1,2,1983,1983,0,-0.27,0.0,0.27,8,0,-8,0,0,0,44.0,0.0,-44.0,0.0,0.0,0.0
smitm102,Milt Smith,Cincinnati Reds,REDS,1,1,1,2,1956,1956,0,0.0,0.39,0.39,0,22,22,0,6,6,0.0,81.0,81.0,0.0,0.0,0.0
smitm104,Mike Smith,Pittsburgh Pirates,PIRATS,3,8,7,15,1897,1910,13,26.73,36.51,9.78,1261,2039,778,4478,8482,4004,3164.0,936.0,-2228.0,0.0,0.0,0.0
smitm105,Mayo Smith,Philadelphia Athletics,ATLTCS,1,2,1,3,1945,1945,0,0.0,0.0,0.0,0,0,0,0,0,0,0.0,0.0,0.0,17200.0,0.0,-17200.0
smito001,Ozzie Smith,San Diego Padres,PADRS,6,11,12,23,1981,1993,12,64.79,33.72,-31.07,2384,3112,728,8892,7842,-1050,1163.0,2653.0,1490.0,905000.0,3605833.0,2700833.0
smitp001,Pete Smith,Philadelphia Phillies,PHILS,7,11,13,24,1985,2002,17,26.27,18.31,-7.96,2374,2693,319,6477,5504,-973,2850.0,5172.0,2322.0,2160000.0,1960000.0,-200000.0
smitp001,Pete Smith,Atlanta Braves,BRAVES,1,1,1,2,1993,1994,1,0.01,-0.1,-0.11,42,89,47,47,177,130,394.0,0.0,-394.0,1025000.0,500000.0,-525000.0
smitp001,Pete Smith,San Diego Padres,PADRS,1,1,1,2,1998,1998,0,-0.26,0.0,0.26,28,0,-28,2,0,-2,135.0,0.0,-135.0,975000.0,0.0,-975000.0
smitr001,Roy Smith,Philadelphia Phillies,PHILS,3,6,5,11,1982,1987,5,5.02,15.9,10.88,358,462,104,942,672,-270,1316.0,2480.0,1164.0,1109333.0,1060833.0,-48500.0
smitr001,Roy Smith,Cleveland Indians,INDINS,1,2,2,4,1986,1988,2,3.92,1.63,-2.29,86,69,-17,0,0,0,1168.0,825.0,-343.0,0.0,0.0,0.0
smitr101,Reggie Smith,Boston Red Sox,RSOX,5,10,8,18,1973,1987,14,23.48,30.66,7.18,1104,1173,69,2926,3213,287,3997.0,6340.0,2343.0,120000.0,96000.0,-24000.0
smitr101,Reggie Smith,St. Louis Cardinals,CARDS,3,5,7,12,1976,1978,2,31.74,-0.14,-31.88,908,133,-775,3459,264,-3195,0.0,236.0,236.0,0.0,0.0,0.0
smitr102,Ray Smith,Minnesota Twins,TWINS,1,1,1,2,1984,1984,0,0.0,0.0,0.0,0,0,0,0,0,0,0.0,0.0,0.0,0.0,0.0,0.0
smitr107,Red Smith,Philadelphia Athletics,ATLTCS,1,4,1,5,1925,1925,0,0.0,0.15,0.15,0,133,133,0,522,522,0.0,0.0,0.0,4850.0,0.0,-4850.0
smits002,Seth Smith,Colorado Rockies,ROCKS,2,2,3,5,2012,2015,3,2.63,2.18,-0.45,275,399,124,851,568,-283,74.0,434.0,360.0,675000.0,2825000.0,2150000.0
smits002,Seth Smith,Oakland Athletics,ATLTCS,1,1,1,2,2013,2014,1,3.42,1.75,-1.67,136,75,-61,521,0,-521,0.0,217.0,217.0,3675000.0,3200000.0,-475000.0
smits002,Seth Smith,San Diego Padres,PADRS,2,4,5,9,2014,2017,3,0.75,-0.96,-1.71,380,340,-40,891,17,-874,304.0,637.0,333.0,8694700.0,1043500.0,-7651200.0
smits002,Seth Smith,Seattle Mariners,MARNRS,1,1,2,3,2017,2017,0,0.55,-0.25,-0.8,111,29,-82,373,2,-371,0.0,392.0,392.0,0.0,0.0,0.0
smits101,Syd Smith,Philadelphia Athletics,ATLTCS,1,1,1,2,1908,1908,0,-0.11,-0.23,-0.12,27,6,-21,83,19,-64,0.0,0.0,0.0,0.0,0.0,0.0
smitt101,Tony Smith,Chicago Cubs,CUBS,1,3,1,4,1910,1912,2,-2.31,2.43,4.74,377,121,-256,1406,145,-1261,0.0,1039.0,1039.0,0.0,0.0,0.0
smitt104,Tom Smith,Philadelphia Phillies,PHILS,1,1,1,2,1896,1896,0,-0.71,-0.35,0.36,26,6,-20,43,5,-38,165.0,31.0,-134.0,0.0,0.0,0.0
smitv101,Vinnie Smith,Memphis,Memphis,1,1,2,3,1941,1942,1,-0.37,0.0,0.37,16,0,-16,56,0,-56,0.0,0.0,0.0,0.0,0.0,0.0
smitw001,Willie Smith,Pittsburgh Pirates,PIRATS,1,2,1,3,1989,1995,6,1.53,10.25,8.72,54,475,421,0,1624,1624,266.0,0.0,-266.0,750000.0,650000.0,-100000.0
smitw002,Will Smith,Anaheim Angels,ANGELS,2,3,2,5,2010,2015,5,-1.93,6.97,8.9,238,527,289,631,1904,1273,756.0,0.0,-756.0,0.0,460000.0,460000.0
smitw002,Will Smith,Kansas City Royals,ROYALS,1,1,1,2,2013,2014,1,0.94,1.13,0.19,350,132,-218,0,549,549,453.0,0.0,-453.0,0.0,2000000.0,2000000.0
smitw002,Will Smith,Milwaukee Brewers,BREWRS,2,2,3,5,2016,2021,5,3.2,-0.35,-3.55,287,20,-267,28,31,3,410.0,6.0,-404.0,0.0,0.0,0.0
smitw102,Willie Smith,Detroit Tigers,TIGRS,2,3,3,6,1964,1970,6,3.45,15.01,11.56,452,407,-45,1371,422,-949,95.0,3100.0,3005.0,0.0,12500.0,12500.0
smitw102,Willie Smith,Cleveland Indians,INDINS,2,2,2,4,1968,1972,4,-0.38,2.04,2.42,313,354,41,710,741,31,8.0,0.0,-8.0,0.0,26000.0,26000.0
smitw102,Willie Smith,Chicago Cubs,CUBS,1,1,1,2,1970,1973,3,-0.33,-0.52,-0.19,31,25,-6,58,79,21,0.0,0.0,0.0,11250.0,0.0,-11250.0
smitw102,Willie Smith,California Angels,ANGELS,1,1,1,2,1966,1966,0,-0.91,0.0,0.91,56,0,-56,80,0,-80,15.0,0.0,-15.0,16000.0,9500.0,-6500.0
smitz001,Zane Smith,Atlanta Braves,BRAVES,3,5,5,10,1989,1992,3,3.39,-0.63,-4.02,121,128,7,51,1,-50,748.0,253.0,-495.0,650000.0,2755334.0,2105334.0
smitz001,Zane Smith,Montreal Expos,NATEX,4,8,9,17,1990,2001,11,22.14,26.5,4.36,1780,1723,-57,4275,2818,-1457,3008.0,1716.0,-1292.0,1435000.0,200000.0,-1235000.0
smoaj001,Justin Smoak,Texas Rangers,RNGRS,1,4,2,6,2010,2012,2,2.66,1.99,-0.67,576,111,-465,1946,0,-1946,977.0,588.0,-389.0,0.0,10150000.0,10150000.0
smokj001,Josh Smoker,New York Mets,METS,1,1,2,3,2018,2021,3,-0.37,0.3,0.67,13,65,52,0,0,0,17.0,53.0,36.0,0.0,0.0,0.0
smolj001,John Smoltz,Detroit Tigers,TIGRS,1,1,1,2,1987,1989,2,69.53,6.3,-63.23,1409,78,-1331,1151,0,-1151,10185.0,1621.0,-8564.0,0.0,650000.0,650000.0
smolj002,Jake Smolinski,Washington Nationals,NATEX,3,5,5,10,2008,2013,5,5.63,4.16,-1.47,562,556,-6,2188,1050,-1138,12.0,770.0,758.0,5101000.0,810000.0,-4291000.0
smooh101,Homer Smoot,St. Louis Cardinals,CARDS,1,1,1,2,1906,1908,2,0.15,-0.34,-0.49,60,217,157,238,895,657,0.0,0.0,0.0,0.0,0.0,0.0
smyld001,Drew Smyly,Detroit Tigers,TIGRS,3,5,5,10,2014,2021,7,13.54,10.17,-3.37,428,201,-227,1262,19,-1243,1153.0,2223.0,1070.0,29745000.0,14508700.0,-15236300.0
smyld001,Drew Smyly,Tampa Bay Devil Rays,RAYS,3,4,8,12,2017,2021,4,0.34,5.04,4.7,245,457,212,948,1430,482,0.0,88.0,88.0,0.0,4125000.0,4125000.0
smyld001,Drew Smyly,Chicago Cubs,CUBS,1,2,1,3,2018,2018,0,-0.69,0.0,0.69,14,0,-14,1,0,-1,154.0,0.0,-154.0,0.0,0.0,0.0
smytr101,Red Smyth,St. Louis Cardinals,CARDS,1,2,2,4,1918,1918,0,0.0,-0.15,-0.15,0,31,31,0,60,60,0.0,69.0,69.0,0.0,0.0,0.0
smyts001,Steve Smyth,Chicago Cubs,CUBS,2,4,3,7,2004,2004,0,1.21,-0.22,-1.43,97,23,-74,6,19,13,216.0,5.0,-211.0,300000.0,700000.0,400000.0
snarr001,Ryan Snare,Cincinnati Reds,REDS,1,3,1,4,2002,2003,1,1.48,-2.8,-4.28,415,76,-339,1688,70,-1618,0.0,613.0,613.0,2400000.0,2475000.0,75000.0
snarr001,Ryan Snare,Florida Marlins,MARLNS,1,3,1,4,2003,2003,0,-0.88,2.14,3.02,60,66,6,206,2,-204,10.0,115.0,105.0,0.0,4500000.0,4500000.0
sneec001,Cy Sneed,Milwaukee Brewers,BREWRS,2,4,2,6,2015,2018,3,5.08,4.56,-0.52,245,411,166,950,1528,578,133.0,0.0,-133.0,2550000.0,8500000.0,5950000.0
snelb001,Blake Snell,Tampa Bay Devil Rays,RAYS,1,1,4,5,2020,2020,0,1.28,0.0,-1.28,52,0,-52,37,0,-37,386.0,0.0,-386.0,7600000.0,0.0,-7600000.0
snelc001,Chris Snelling,Seattle Mariners,MARNRS,1,2,2,4,2006,2008,2,-0.42,0.87,1.29,24,232,208,61,955,894,0.0,0.0,0.0,328500.0,7000000.0,6671500.0
snelc001,Chris Snelling,Washington Nationals,NATEX,6,10,9,19,2007,2020,13,4.33,17.52,13.19,559,1541,982,715,1832,1117,1207.0,2502.0,1295.0,9181616.0,4000000.0,-5181616.0
sneli001,Ian Snell,Pittsburgh Pirates,PIRATS,1,2,5,7,2009,2012,3,2.82,0.94,-1.88,179,390,211,514,1304,790,332.0,0.0,-332.0,10600000.0,822500.0,-9777500.0
snidt001,Travis Snider,Toronto Blue Jays,BJAYS,4,7,5,12,2012,2015,3,-0.1,0.42,0.52,371,228,-143,854,423,-431,111.0,275.0,164.0,510200.0,1561000.0,1050800.0
snidt001,Travis Snider,Pittsburgh Pirates,PIRATS,3,4,5,9,2015,2018,3,3.04,3.15,0.11,137,138,1,241,140,-101,662.0,1238.0,576.0,9167000.0,0.0,-9167000.0
snidv001,Van Snider,Kansas City Royals,ROYALS,1,1,1,2,1988,1999,11,-0.11,20.89,21.0,19,697,678,36,0,-36,0.0,2548.0,2548.0,0.0,0.0,0.0
snidv001,Van Snider,Cincinnati Reds,REDS,1,2,2,4,1989,1997,8,0.48,12.7,12.22,78,910,832,0,3572,3572,1277.0,0.0,-1277.0,0.0,0.0,0.0
snopc001,Chris Snopek,Chicago White Sox,WSOX,1,1,1,2,1998,1998,0,-0.08,0.0,0.08,8,0,-8,14,0,-14,0.0,0.0,0.0,190000.0,0.0,-190000.0
snowj001,J.T. Snow,New York Yankees,YANKS,1,3,1,4,1992,1994,2,-1.97,3.42,5.39,549,56,-493,1984,0,-1984,509.0,1123.0,614.0,0.0,1850000.0,1850000.0
snowj001,J.T. Snow,Anaheim Angels,ANGELS,1,1,2,3,1996,1998,2,12.44,0.96,-11.48,1183,63,-1120,4497,0,-4497,0.0,874.0,874.0,725000.0,240000.0,-485000.0
snydb101,Bernie Snyder,Philadelphia Athletics,ATLTCS,1,2,1,3,1935,1938,3,0.0,-0.88,-0.88,0,163,163,0,516,516,0.0,0.0,0.0,0.0,0.0,0.0
snydb102,Bill Snyder,Washington Senators,TWINS,3,6,4,10,1920,1933,13,2.2,13.36,11.16,219,847,628,852,3211,2359,0.0,616.0,616.0,2000.0,0.0,-2000.0
snydc001,Cory Snyder,Cleveland Indians,INDINS,1,2,2,4,1990,1992,2,-0.52,2.03,2.55,50,76,26,126,0,-126,0.0,701.0,701.0,700000.0,515000.0,-185000.0
snydc001,Cory Snyder,Chicago White Sox,WSOX,1,1,2,3,1991,1991,0,-0.65,0.12,0.77,21,6,-15,54,0,-54,0.0,15.0,15.0,800000.0,0.0,-800000.0
snydc002,Chris Snyder,Arizona Diamondbacks,DBACKS,1,3,3,6,2010,2010,0,0.71,-0.12,-0.83,105,82,-23,301,69,-232,0.0,68.0,68.0,5250000.0,3450000.0,-1800000.0
snydc002,Chris Snyder,Anaheim Angels,ANGELS,1,1,1,2,2013,2013,0,0.02,0.0,-0.02,9,0,-9,24,0,-24,0.0,0.0,0.0,0.0,0.0,0.0
snyde001,Earl Snyder,New York Mets,METS,3,9,8,17,2001,2008,7,12.43,-0.5,-12.93,1334,336,-998,2309,1012,-1297,1613.0,327.0,-1286.0,8000000.0,8077500.0,77500.0
snydf101,Frank Snyder,St. Louis Cardinals,CARDS,2,3,2,5,1919,1924,5,9.75,5.6,-4.15,845,324,-521,2607,357,-2250,183.0,2844.0,2661.0,5000.0,11972.0,6972.0
snydg102,Gene Snyder,Philadelphia Phillies,PHILS,1,3,1,4,1958,1958,0,-0.86,0.0,0.86,137,0,-137,129,0,-129,226.0,0.0,-226.0,0.0,0.0,0.0
snydj001,John Snyder,California Angels,ANGELS,1,4,2,6,1995,1997,2,5.3,-0.85,-6.15,439,40,-399,87,0,-87,1686.0,680.0,-1006.0,0.0,2905000.0,2905000.0
snydj001,John Snyder,Chicago White Sox,WSOX,1,2,2,4,2000,2004,4,-2.6,18.62,21.22,55,696,641,47,2756,2709,437.0,354.0,-83.0,0.0,0.0,0.0
snydj103,Jim Snyder,Philadelphia Phillies,PHILS,1,1,1,2,1958,1958,0,0.0,0.0,0.0,0,0,0,0,0,0,0.0,0.0,0.0,0.0,0.0,0.0
snydj105,Jerry Snyder,New York Yankees,YANKS,7,19,15,34,1952,1970,18,13.22,40.85,27.63,2406,2911,505,6464,7208,744,3937.0,4978.0,1041.0,115500.0,43000.0,-72500.0
snydr102,Russ Snyder,New York Yankees,YANKS,1,2,2,4,1959,1959,0,0.31,0.0,-0.31,212,0,-212,603,0,-603,0.0,0.0,0.0,0.0,0.0,0.0
snydr102,Russ Snyder,Kansas City Athletics,ATLTCS,24,51,45,96,1961,1976,15,93.37,59.87,-33.5,8944,6063,-2881,21756,17588,-4168,9976.0,4965.0,-5011.0,504100.0,545500.0,41400.0
snydr102,Russ Snyder,Baltimore Orioles,ORLS,2,4,4,8,1967,1973,6,9.46,19.82,10.36,579,770,191,2185,2951,766,146.0,306.0,160.0,72000.0,40300.0,-31700.0
snydr102,Russ Snyder,Chicago White Sox,WSOX,1,1,1,2,1968,1968,0,0.16,-0.34,-0.5,190,69,-121,539,183,-356,0.0,0.0,0.0,21500.0,32500.0,11000.0
snydr102,Russ Snyder,Cleveland Indians,INDINS,7,13,13,26,1970,1978,8,23.54,10.24,-13.3,1728,850,-878,4111,2770,-1341,2427.0,1183.0,-1244.0,83000.0,120000.0,37000.0
soboc001,Chad Sobotka,Atlanta Braves,BRAVES,1,2,1,3,2021,2021,0,0.01,-0.18,-0.19,6,32,26,0,78,78,12.0,0.0,-12.0,0.0,2000000.0,2000000.0
socom001,Miguel Socolovich,Boston Red Sox,RSOX,11,30,18,48,2008,2019,11,37.8,29.22,-8.58,3009,1818,-1191,5076,5902,826,5204.0,2054.0,-3150.0,4708000.0,21865000.0,17157000.0
sodee101,Eric Soderholm,Chicago White Sox,WSOX,2,3,3,6,1979,2007,28,0.48,2.65,2.17,63,150,87,166,0,-166,0.0,701.0,701.0,0.0,35000.0,35000.0
sodee101,Eric Soderholm,Texas Rangers,RNGRS,1,1,3,4,1979,1979,0,1.82,0.0,-1.82,95,0,-95,304,0,-304,0.0,0.0,0.0,0.0,0.0,0.0
sodoc001,Clint Sodowsky,Detroit Tigers,TIGRS,3,6,4,10,1996,1998,2,6.42,-0.59,-7.01,711,169,-542,196,193,-3,1179.0,433.0,-746.0,1584000.0,3255000.0,1671000.0
sodoc001,Clint Sodowsky,Arizona Diamondbacks,DBACKS,2,3,2,5,1999,2000,1,6.42,1.09,-5.33,440,238,-202,1365,1,-1364,398.0,284.0,-114.0,720000.0,1500000.0,780000.0
sogae001,Eric Sogard,San Diego Padres,PADRS,3,4,4,8,2010,2013,3,5.05,1.13,-3.92,706,243,-463,2175,585,-1590,34.0,54.0,20.0,0.0,0.0,0.0
sogae001,Eric Sogard,Toronto Blue Jays,BJAYS,1,1,2,3,2019,2019,0,0.71,0.0,-0.71,37,0,-37,119,0,-119,0.0,0.0,0.0,100000.0,0.0,-100000.0
sojol001,Luis Sojo,Toronto Blue Jays,BJAYS,1,3,3,6,1990,1995,5,3.61,21.84,18.23,424,669,245,1598,2979,1381,0.0,79.0,79.0,255000.0,990000.0,735000.0
sojol001,Luis Sojo,California Angels,ANGELS,1,1,2,3,1992,1993,1,-0.45,0.32,0.77,19,18,-1,54,70,16,0.0,0.0,0.0,190000.0,3633333.0,3443333.0
sojol001,Luis Sojo,Pittsburgh Pirates,PIRATS,1,1,1,2,2000,2002,2,-0.26,0.0,0.26,76,0,-76,222,0,-222,0.0,0.0,0.0,450000.0,0.0,-450000.0
solaj001,Julio Solano,Houston Astros,ASTROS,1,1,1,2,1987,1987,0,-0.22,0.0,0.22,24,0,-24,0,0,0,95.0,0.0,-95.0,0.0,0.0,0.0
solan001,Nick Solak,New York Yankees,YANKS,2,4,2,6,2018,2020,2,-1.13,4.02,5.15,271,71,-200,932,61,-871,0.0,823.0,823.0,621900.0,13000000.0,12378100.0
solan001,Nick Solak,Tampa Bay Devil Rays,RAYS,1,1,1,2,2019,2019,0,0.78,-0.41,-1.19,218,15,-203,879,0,-879,0.0,37.0,37.0,0.0,0.0,0.0
solat101,Tony Solaita,New York Yankees,YANKS,1,1,1,2,1973,1973,0,0.0,0.0,0.0,0,0,0,0,0,0,0.0,0.0,0.0,0.0,0.0,0.0
solat101,Tony Solaita,Montreal Expos,NATEX,1,1,1,2,1979,1980,1,0.55,0.0,-0.55,36,0,-36,121,0,-121,0.0,0.0,0.0,0.0,0.0,0.0
solay001,Yangervis Solarte,New York Yankees,YANKS,3,6,4,10,2014,2018,4,4.88,7.78,2.9,526,501,-25,1896,1981,85,219.0,0.0,-219.0,13550625.0,0.0,-13550625.0
solay001,Yangervis Solarte,San Diego Padres,PADRS,2,3,3,6,2018,2020,2,-0.24,0.14,0.38,184,23,-161,682,36,-646,19.0,30.0,11.0,0.0,100000.0,100000.0
solej001,Jorge Soler,Chicago Cubs,CUBS,1,1,1,2,2016,2017,1,1.39,1.83,0.44,395,115,-280,1580,0,-1580,0.0,176.0,176.0,3666667.0,8000000.0,4333333.0
solej001,Jorge Soler,Kansas City Royals,ROYALS,1,1,1,2,2021,2021,0,1.05,0.0,-1.05,55,0,-55,242,0,-242,0.0,0.0,0.0,8050000.0,0.0,-8050000.0
soloe101,Eddie Solomon,Los Angeles Dodgers,DOGRS,1,2,1,3,1975,1984,9,-0.7,25.95,26.65,50,645,595,25,676,651,233.0,5584.0,5351.0,0.0,0.0,0.0
soloe101,Eddie Solomon,Chicago Cubs,CUBS,1,1,1,2,1975,1975,0,-0.38,0.27,0.65,52,18,-34,5,1,-4,111.0,25.0,-86.0,0.0,0.0,0.0
soloe101,Eddie Solomon,St. Louis Cardinals,CARDS,1,1,1,2,1977,1977,0,4.13,0.0,-4.13,174,0,-174,133,0,-133,1142.0,0.0,-1142.0,0.0,0.0,0.0
soloe101,Eddie Solomon,Atlanta Braves,BRAVES,1,1,1,2,1980,1980,0,2.36,0.0,-2.36,123,0,-123,99,0,-99,822.0,0.0,-822.0,0.0,0.0,0.0
soloe101,Eddie Solomon,Pittsburgh Pirates,PIRATS,6,6,8,14,1982,1993,11,0.98,11.66,10.68,783,870,87,2768,2816,48,22.0,77.0,55.0,1442500.0,1020000.0,-422500.0
soltm101,Moose Solters,Boston Red Sox,RSOX,1,2,1,3,1935,1938,3,4.12,-2.77,-6.89,319,230,-89,1405,874,-531,0.0,0.0,0.0,0.0,7500.0,7500.0
soltm101,Moose Solters,St.Louis Browns,ORLS,12,23,32,55,1937,1952,15,55.87,54.37,-1.5,2736,6464,3728,7991,19515,11524,6789.0,12669.0,5880.0,129000.0,122100.0,-6900.0
soltm101,Moose Solters,St.Louis Browns,ORLS,1,1,1,2,1939,1941,2,0.5,3.93,3.43,234,169,-65,833,717,-116,0.0,0.0,0.0,0.0,10000.0,10000.0
sommb101,Bill Sommers,Boston Red Sox,RSOX,2,5,3,8,1947,1955,8,0.52,24.8,24.28,500,919,419,1627,990,-637,67.0,3427.0,3360.0,0.0,15500.0,15500.0
songd101,Don Songer,OklahomaCity,OklahomaCity,1,2,1,3,1924,1924,0,0.53,0.0,-0.53,98,0,-98,46,0,-46,457.0,0.0,-457.0,0.0,2400.0,2400.0
sorel001,Lary Sorensen,Milwaukee Brewers,BREWRS,2,5,6,11,1980,1986,6,6.59,20.26,13.67,970,997,27,2159,3010,851,2112.0,2376.0,264.0,0.0,0.0,0.0
sorel001,Lary Sorensen,St. Louis Cardinals,CARDS,2,3,2,5,1981,1990,9,6.11,11.74,5.63,370,733,363,1263,2386,1123,1236.0,0.0,-1236.0,740000.0,0.0,-740000.0
sorel001,Lary Sorensen,Philadelphia Phillies,PHILS,2,4,4,8,1986,1987,1,2.35,0.09,-2.26,749,102,-647,1893,18,-1875,306.0,201.0,-105.0,635000.0,415000.0,-220000.0
soria001,Alfonso Soriano,New York Yankees,YANKS,1,2,2,4,2004,2016,12,3.52,53.95,50.43,392,1509,1117,1582,6520,4938,0.0,0.0,0.0,0.0,0.0,0.0
soria001,Alfonso Soriano,Texas Rangers,RNGRS,3,5,7,12,2005,2008,3,39.21,4.43,-34.78,1374,331,-1043,4664,754,-3910,3052.0,497.0,-2555.0,7500000.0,3395000.0,-4105000.0
soria001,Alfonso Soriano,Chicago Cubs,CUBS,1,2,1,3,2013,2013,0,0.9,0.0,-0.9,125,0,-125,481,0,-481,0.0,0.0,0.0,0.0,0.0,0.0
sorij001,Joakim Soria,Texas Rangers,RNGRS,7,18,20,38,2014,2021,7,16.16,17.54,1.38,1321,328,-993,1769,20,-1749,3375.0,2717.0,-658.0,3762500.0,1106250.0,-2656250.0
sorij001,Joakim Soria,Detroit Tigers,TIGRS,1,1,1,2,2015,2021,6,0.73,1.1,0.37,58,352,294,0,1195,1195,80.0,0.0,-80.0,7000000.0,0.0,-7000000.0
sorij001,Joakim Soria,Kansas City Royals,ROYALS,1,3,2,5,2018,2021,3,1.11,-0.68,-1.79,43,21,-22,0,43,43,116.0,41.0,-75.0,0.0,0.0,0.0
sorij001,Joakim Soria,Chicago White Sox,WSOX,1,2,2,4,2018,2018,0,-0.17,0.0,0.17,52,0,-52,0,0,0,66.0,0.0,-66.0,0.0,0.0,0.0
sorij001,Joakim Soria,Arizona Diamondbacks,DBACKS,1,1,2,3,2021,2021,0,-0.26,0.0,0.26,10,0,-10,0,0,0,24.0,0.0,-24.0,3500000.0,0.0,-3500000.0
sorir001,Rafael Soriano,Seattle Mariners,MARNRS,1,1,1,2,2006,2008,2,3.51,-1.43,-4.94,318,20,-298,0,0,0,485.0,294.0,-191.0,450000.0,2200000.0,1750000.0
sorir001,Rafael Soriano,Atlanta Braves,BRAVES,2,4,3,7,2009,2010,1,4.12,-0.39,-4.51,390,148,-242,204,140,-64,921.0,170.0,-751.0,6765000.0,7250000.0,485000.0
sorrb101,Billy Sorrell,Philadelphia Phillies,PHILS,2,3,3,6,1968,1969,1,0.0,0.05,0.05,0,25,25,0,34,34,0.0,0.0,0.0,0.0,0.0,0.0
sorrp001,Paul Sorrento,California Angels,ANGELS,1,3,2,5,1988,1992,4,-0.32,6.07,6.39,96,81,-15,213,0,-213,64.0,1524.0,1460.0,0.0,1000000.0,1000000.0
sorrp001,Paul Sorrento,Minnesota Twins,TWINS,1,1,2,3,1992,1995,3,3.9,-0.31,-4.21,487,10,-477,1779,0,-1779,0.0,106.0,106.0,0.0,0.0,0.0
sorrv101,Vic Sorrell,Toronto,Toronto,1,1,1,2,1928,1928,0,17.07,0.0,-17.07,561,0,-561,624,0,-624,5010.0,0.0,-5010.0,0.0,0.0,0.0
sosae101,Elias Sosa,San Francisco Giants,GIANTS,1,2,1,3,1974,1980,6,-1.06,2.57,3.63,99,431,332,142,1370,1228,82.0,0.0,-82.0,0.0,0.0,0.0
sosae101,Elias Sosa,St. Louis Cardinals,CARDS,2,3,3,6,1975,1978,3,9.69,4.02,-5.67,1094,228,-866,136,461,325,2919.0,527.0,-2392.0,52000.0,0.0,-52000.0
sosae101,Elias Sosa,Atlanta Braves,BRAVES,1,2,1,3,1976,1977,1,4.08,0.61,-3.47,368,56,-312,639,9,-630,292.0,128.0,-164.0,0.0,135000.0,135000.0
sosae101,Elias Sosa,Pittsburgh Pirates,PIRATS,5,9,10,19,1978,1984,6,24.55,-1.47,-26.02,1160,294,-866,2724,444,-2280,3108.0,299.0,-2809.0,300000.0,0.0,-300000.0
sosah001,Henry Sosa,San Francisco Giants,GIANTS,1,2,1,3,2011,2011,0,-0.35,-0.74,-0.39,20,56,36,18,230,212,160.0,0.0,-160.0,0.0,2300000.0,2300000.0
sosaj001,Juan Sosa,Colorado Rockies,ROCKS,1,1,1,2,2001,2001,0,-0.01,0.0,0.01,2,0,-2,1,0,-1,0.0,0.0,0.0,0.0,0.0,0.0
sosaj002,Jorge Sosa,Tampa Bay Devil Rays,RAYS,1,1,1,2,2005,2006,1,3.13,0.19,-2.94,137,128,-9,63,420,357,664.0,0.0,-664.0,0.0,0.0,0.0
sosaj002,Jorge Sosa,Atlanta Braves,BRAVES,1,1,1,2,2006,2006,0,-0.17,0.0,0.17,38,0,-38,4,0,-4,92.0,0.0,-92.0,2200000.0,0.0,-2200000.0
sosas001,Sammy Sosa,Texas Rangers,RNGRS,3,5,6,11,1989,1992,3,24.82,3.73,-21.09,1170,237,-933,3620,767,-2853,3192.0,327.0,-2865.0,2411539.0,192500.0,-2219039.0
sosas001,Sammy Sosa,Chicago White Sox,WSOX,1,2,1,3,1992,1993,1,58.16,-2.67,-60.83,1875,257,-1618,7900,1106,-6794,125.0,0.0,-125.0,0.0,0.0,0.0
sosas001,Sammy Sosa,Chicago Cubs,CUBS,4,6,7,13,2005,2010,5,-0.96,4.29,5.25,367,641,274,1090,1872,782,0.0,0.0,0.0,3300000.0,10472409.0,7172409.0
sothd101,Denny Sothern,Philadelphia Phillies,PHILS,1,1,1,2,1930,1933,3,-0.43,-2.43,-2.0,17,236,219,54,905,851,0.0,0.0,0.0,5000.0,0.0,-5000.0
sothd101,Denny Sothern,Baltimore,Baltimore,1,1,1,2,1931,1931,0,-0.32,0.0,0.32,19,0,-19,37,0,-37,0.0,0.0,0.0,0.0,0.0,0.0
sotoe001,Elliot Soto,Chicago Cubs,CUBS,1,2,2,4,2015,2015,0,0.0,0.17,0.17,0,21,21,0,23,23,0.0,175.0,175.0,0.0,10000000.0,10000000.0
sotog001,Geovany Soto,Chicago Cubs,CUBS,2,2,3,5,2012,2012,0,0.74,0.0,-0.74,111,0,-111,386,0,-386,0.0,0.0,0.0,4300000.0,0.0,-4300000.0
sotog002,Giovanni Soto,Detroit Tigers,TIGRS,1,1,2,3,2010,2013,3,0.15,8.67,8.52,6,460,454,0,1851,1851,10.0,0.0,-10.0,0.0,4850000.0,4850000.0
soucb101,Bud Souchock,New York Yankees,YANKS,3,9,5,14,1948,1954,6,21.49,0.79,-20.7,1319,458,-861,2529,213,-2316,6559.0,1785.0,-4774.0,29000.0,8500.0,-20500.0
soutb101,Billy Southworth,Pittsburgh Pirates,PIRATS,5,10,8,18,1921,1932,11,20.59,54.57,33.98,2344,1948,-396,9152,7061,-2091,1307.0,3847.0,2540.0,22300.0,13500.0,-8800.0
soutb101,Billy Southworth,Boston Braves,BRAVES,1,2,3,5,1923,1927,4,1.22,11.01,9.79,273,702,429,996,2898,1902,87.0,0.0,-87.0,5000.0,17500.0,12500.0
soutb101,Billy Southworth,New York Giants,GIANTS,1,1,1,2,1926,1927,1,3.63,0.3,-3.33,210,169,-41,814,554,-260,0.0,0.0,0.0,8000.0,4875.0,-3125.0
soutb102,Bill Southworth,Chicago White Sox,WSOX,3,5,5,10,1967,1971,4,9.67,-0.45,-10.12,1085,468,-617,4072,1523,-2549,79.0,0.0,-79.0,35500.0,55000.0,19500.0
souzs001,Steven Souza,Washington Nationals,NATEX,2,4,6,10,2014,2021,7,10.96,22.51,11.55,452,684,232,1763,2913,1150,205.0,188.0,-17.0,47503480.0,0.0,-47503480.0
souzs001,Steven Souza,Tampa Bay Devil Rays,RAYS,2,2,5,7,2018,2020,2,0.38,-0.77,-1.15,290,25,-265,1151,0,-1151,0.0,114.0,114.0,0.0,0.0,0.0
spadb101,Bob Spade,New York Giants,GIANTS,1,2,2,4,1908,1908,0,0.79,-0.32,-1.11,104,11,-93,143,17,-126,1093.0,0.0,-1093.0,0.0,0.0,0.0
spana101,Al Spangler,Houston Astros,ASTROS,1,1,1,2,1965,1966,1,0.69,0.69,0.0,57,32,-25,115,2,-113,0.0,78.0,78.0,0.0,16500.0,16500.0
spand001,Denard Span,Minnesota Twins,TWINS,2,4,3,7,2012,2018,6,11.69,-0.56,-12.25,428,86,-342,1616,0,-1616,1029.0,585.0,-444.0,3000000.0,0.0,-3000000.0
spand001,Denard Span,San Francisco Giants,GIANTS,1,4,2,6,2017,2017,0,1.25,0.0,-1.25,79,0,-79,289,0,-289,0.0,0.0,0.0,11000000.0,13000000.0,2000000.0
spand001,Denard Span,Tampa Bay Devil Rays,RAYS,1,3,2,5,2018,2019,1,2.35,0.0,-2.35,144,0,-144,328,0,-328,139.0,0.0,-139.0,5300000.0,0.0,-5300000.0
sparj001,Jeff Sparks,Pittsburgh Pirates,PIRATS,1,2,2,4,1999,2007,8,1.13,-1.06,-2.19,216,241,25,680,708,28,91.0,0.0,-91.0,375000.0,0.0,-375000.0
sparj101,Joe Sparma,Detroit Tigers,TIGRS,6,6,7,13,1969,1973,4,-0.27,2.47,2.74,90,218,128,156,31,-125,124.0,816.0,692.0,23500.0,0.0,-23500.0
speab101,Bob Speake,Chicago Cubs,CUBS,2,3,2,5,1958,1961,3,0.92,4.24,3.32,121,278,157,224,1033,809,0.0,8.0,8.0,0.0,0.0,0.0
speat101,Tris Speaker,Boston Red Sox,RSOX,11,22,33,55,1916,1937,21,147.85,52.38,-95.47,5714,2379,-3335,20029,5927,-14102,9458.0,11085.0,1627.0,78550.0,54250.0,-24300.0
speeb101,By Speece,Omaha,Omaha,1,1,2,3,1924,1924,0,0.24,0.0,-0.24,42,0,-42,16,0,-16,169.0,0.0,-169.0,0.0,0.0,0.0
speeb101,By Speece,Washington Senators,TWINS,1,2,1,3,1924,1927,3,1.24,9.07,7.83,60,146,86,31,190,159,281.0,1502.0,1221.0,2100.0,7500.0,5400.0
speht001,Tim Spehr,Kansas City Royals,ROYALS,1,2,2,4,1992,1993,1,1.07,-0.36,-1.43,511,17,-494,265,0,-265,676.0,275.0,-401.0,0.0,300000.0,300000.0
speic001,Chris Speier,San Francisco Giants,GIANTS,1,1,1,2,1977,1977,0,9.43,-0.92,-10.35,895,104,-791,3289,387,-2902,0.0,0.0,0.0,90000.0,95000.0,5000.0
speic001,Chris Speier,Montreal Expos,NATEX,1,2,1,3,1984,1985,1,0.34,0.07,-0.27,38,37,-1,129,70,-59,0.0,0.0,0.0,0.0,0.0,0.0
speic001,Chris Speier,St. Louis Cardinals,CARDS,1,1,2,3,1984,1984,0,-0.19,0.0,0.19,12,0,-12,37,0,-37,0.0,0.0,0.0,0.0,0.0,0.0
speig001,Gabe Speier,Boston Red Sox,RSOX,1,3,1,4,2014,2019,5,9.45,9.39,-0.06,366,170,-196,427,24,-403,794.0,2892.0,2098.0,10500000.0,8500000.0,-2000000.0
speig001,Gabe Speier,Detroit Tigers,TIGRS,2,3,2,5,2015,2019,4,1.92,2.82,0.9,314,181,-133,389,391,2,300.0,240.0,-60.0,8515000.0,7000000.0,-1515000.0
speig001,Gabe Speier,Atlanta Braves,BRAVES,1,2,3,5,2015,2021,6,-1.25,7.57,8.82,58,639,581,48,2431,2383,417.0,219.0,-198.0,535000.0,513000.0,-22000.0
speig001,Gabe Speier,Arizona Diamondbacks,DBACKS,1,2,1,3,2018,2018,0,-0.12,-0.27,-0.15,25,84,59,0,320,320,62.0,0.0,-62.0,0.0,0.0,0.0
speij001,Justin Speier,Chicago Cubs,CUBS,4,13,7,20,1998,2009,11,13.03,10.6,-2.43,859,1301,442,2754,2788,34,471.0,1208.0,737.0,7140000.0,11000000.0,3860000.0
speij001,Justin Speier,Florida Marlins,MARLNS,1,1,1,2,1999,1999,0,-0.06,0.0,0.06,37,0,-37,3,0,-3,86.0,0.0,-86.0,0.0,0.0,0.0
speij001,Justin Speier,Cleveland Indians,INDINS,1,1,1,2,2001,2001,0,0.0,0.0,0.0,0,0,0,0,0,0,0.0,0.0,0.0,243000.0,0.0,-243000.0
speij001,Justin Speier,Colorado Rockies,ROCKS,4,6,6,12,2003,2010,7,7.79,3.67,-4.12,906,468,-438,1692,779,-913,1362.0,897.0,-465.0,3376000.0,4430000.0,1054000.0
speil001,Levale Speigner,Minnesota Twins,TWINS,1,1,1,2,2007,2008,1,-1.69,-0.22,1.47,50,4,-46,8,11,3,144.0,0.0,-144.0,0.0,0.0,0.0
spenb102,Bob Spence,Chicago White Sox,WSOX,2,3,2,5,1971,1972,1,0.08,0.0,-0.08,33,0,-33,5,0,-5,104.0,0.0,-104.0,0.0,0.0,0.0
spenc101,Chet Spencer,Rochester,Rochester,2,4,5,9,1911,1913,2,29.68,0.0,-29.68,1807,0,-1807,7810,0,-7810,0.0,0.0,0.0,0.0,0.0,0.0
spend101,Daryl Spencer,San Francisco Giants,GIANTS,10,19,14,33,1959,1972,13,26.08,20.98,-5.1,2290,1750,-540,7278,3376,-3902,1334.0,4789.0,3455.0,50000.0,89000.0,39000.0
spend101,Daryl Spencer,St. Louis Cardinals,CARDS,3,6,6,12,1961,1965,4,2.48,8.05,5.57,784,459,-325,2143,937,-1206,727.0,472.0,-255.0,0.0,12000.0,12000.0
speng101,Glenn Spencer,Pittsburgh Pirates,PIRATS,2,4,4,8,1932,1938,6,21.06,8.93,-12.13,668,581,-87,953,1370,417,4600.0,2252.0,-2348.0,0.0,0.0,0.0
speng101,Glenn Spencer,New York Giants,GIANTS,1,1,1,2,1933,1934,1,0.0,0.2,0.2,0,32,32,0,37,37,0.0,0.0,0.0,0.0,0.0,0.0
speng101,Glenn Spencer,Cincinnati Reds,REDS,3,5,6,11,1934,1937,3,22.67,0.4,-22.27,911,284,-627,2270,797,-1473,2379.0,341.0,-2038.0,0.0,0.0,0.0
spenj101,Jim Spencer,California Angels,ANGELS,3,4,5,9,1973,1975,2,-0.57,1.96,2.53,414,169,-245,1273,459,-814,189.0,261.0,72.0,0.0,130000.0,130000.0
spenj101,Jim Spencer,Texas Rangers,RNGRS,6,16,10,26,1975,1988,13,43.04,39.97,-3.07,2266,2155,-111,8188,7408,-780,2609.0,4479.0,1870.0,377000.0,165000.0,-212000.0
spenj101,Jim Spencer,California Angels,ANGELS,2,3,4,7,1975,1977,2,-0.12,-0.47,-0.35,328,122,-206,1247,392,-855,0.0,18.0,18.0,0.0,0.0,0.0
spenj101,Jim Spencer,Chicago White Sox,WSOX,1,3,3,6,1977,1978,1,1.55,0.0,-1.55,299,0,-299,869,0,-869,0.0,0.0,0.0,70000.0,0.0,-70000.0
spenj101,Jim Spencer,New York Yankees,YANKS,2,5,4,9,1981,1983,2,0.32,-0.84,-1.16,265,132,-133,447,432,-15,1046.0,0.0,-1046.0,250000.0,800000.0,550000.0
spenr101,Roy Spencer,Pittsburgh Pirates,PIRATS,1,2,1,3,1927,1927,0,0.0,0.0,0.0,0,0,0,0,0,0,0.0,0.0,0.0,11200.0,0.0,-11200.0
spenr101,Roy Spencer,Washington Senators,TWINS,3,5,4,9,1933,1939,6,3.92,5.07,1.15,441,620,179,819,1504,685,2260.0,2671.0,411.0,0.0,0.0,0.0
spens001,Shane Spencer,Cleveland Indians,INDINS,1,2,1,3,2003,2005,2,0.87,1.1,0.23,75,73,-2,221,247,26,251.0,0.0,-251.0,902400.0,0.0,-902400.0
spens003,Sean Spencer,Seattle Mariners,MARNRS,1,2,1,3,2000,2001,1,1.04,-0.19,-1.23,169,10,-159,492,12,-480,20.0,0.0,-20.0,0.0,1350000.0,1350000.0
spens101,Stan Spence,Boston Red Sox,RSOX,2,3,3,6,1941,1943,2,21.33,-1.33,-22.66,818,70,-748,3332,174,-3158,514.0,323.0,-191.0,22500.0,20000.0,-2500.0
spens101,Stan Spence,Washington Senators,TWINS,15,27,28,55,1947,1963,16,24.78,22.78,-2.0,2496,3241,745,7422,8427,1005,2404.0,6282.0,3878.0,43000.0,69000.0,26000.0
spens101,Stan Spence,Boston Red Sox,RSOX,4,11,9,20,1949,1956,7,14.35,13.52,-0.83,1766,1339,-427,5882,4275,-1607,1880.0,1611.0,-269.0,126000.0,54500.0,-71500.0
spent101,Tubby Spencer,St.Louis Browns,ORLS,2,3,3,6,1908,1914,6,-0.55,4.9,5.45,55,238,183,164,479,315,0.0,1597.0,1597.0,0.0,0.0,0.0
spent102,Tom Spencer,Cincinnati Reds,REDS,1,1,1,2,1976,1976,0,-0.61,0.0,0.61,29,0,-29,67,0,-67,0.0,0.0,0.0,0.0,0.0,0.0
spenv101,Vern Spencer,Toronto,Toronto,1,1,2,3,1920,1920,0,-0.55,0.0,0.55,45,0,-45,152,0,-152,0.0,0.0,0.0,0.0,0.0,0.0
spenv101,Vern Spencer,New York Giants,GIANTS,1,5,1,6,1921,1924,3,0.0,-0.65,-0.65,0,89,89,0,166,166,0.0,0.0,0.0,1500.0,0.0,-1500.0
sperr101,Rob Sperring,Chicago Cubs,CUBS,3,6,5,11,1977,1982,5,6.0,5.18,-0.82,669,907,238,2312,3575,1263,152.0,0.0,-152.0,320000.0,0.0,-320000.0
sperr101,Rob Sperring,San Francisco Giants,GIANTS,1,2,2,4,1977,1979,2,-0.16,-0.23,-0.07,100,281,181,275,873,598,0.0,0.0,0.0,0.0,0.0,0.0
spiee101,Ed Spiezio,St. Louis Cardinals,CARDS,3,8,6,14,1968,1972,4,11.85,2.24,-9.61,1182,243,-939,1248,521,-727,1854.0,299.0,-1555.0,17500.0,24000.0,6500.0
spiee101,Ed Spiezio,San Diego Padres,PADRS,1,1,2,3,1972,1972,0,-0.08,0.0,0.08,74,0,-74,295,0,-295,0.0,0.0,0.0,0.0,0.0,0.0
spikc101,Charlie Spikes,New York Yankees,YANKS,5,8,9,17,1972,1987,15,9.09,48.73,39.64,1757,1810,53,5603,6602,999,883.0,1959.0,1076.0,246600.0,963000.0,716400.0
spikc101,Charlie Spikes,Cleveland Indians,INDINS,2,2,2,4,1977,1982,5,-0.2,-0.46,-0.26,50,463,413,90,1581,1491,0.0,0.0,0.0,0.0,40000.0,40000.0
spild001,Dan Spillner,San Diego Padres,PADRS,3,3,3,6,1978,1981,3,8.67,-0.8,-9.47,302,140,-162,0,16,16,2359.0,323.0,-2036.0,0.0,0.0,0.0
spild001,Dan Spillner,Cleveland Indians,INDINS,1,1,1,2,1984,1984,0,1.84,0.0,-1.84,76,0,-76,1,0,-1,420.0,0.0,-420.0,400000.0,0.0,-400000.0
spilh001,Harry Spilman,Cincinnati Reds,REDS,11,15,21,36,1981,2006,25,17.83,35.54,17.71,3261,3027,-234,2392,4330,1938,4092.0,5583.0,1491.0,22668833.0,10745833.0,-11923000.0
spins101,Scipio Spinks,Houston Astros,ASTROS,8,14,11,25,1972,1989,17,22.94,18.16,-4.78,1829,2074,245,3832,5559,1727,6887.0,3273.0,-3614.0,22500.0,16500.0,-6000.0
spins101,Scipio Spinks,St. Louis Cardinals,CARDS,1,1,1,2,1974,1974,0,0.0,0.5,0.5,0,50,50,0,68,68,0.0,0.0,0.0,0.0,0.0,0.0
spivj001,Junior Spivey,Arizona Diamondbacks,DBACKS,1,6,3,9,2003,2005,2,15.82,-0.12,-15.94,1881,61,-1820,5048,104,-4944,2593.0,37.0,-2556.0,3548667.0,5425000.0,1876333.0
spivj001,Junior Spivey,Milwaukee Brewers,BREWRS,1,1,1,2,2005,2006,1,0.61,1.34,0.73,28,79,51,91,78,-13,0.0,670.0,670.0,2125000.0,2750000.0,625000.0
spoha101,Al Spohrer,New York Giants,GIANTS,1,4,1,5,1928,1928,0,11.88,2.32,-9.56,1432,52,-1380,2925,68,-2857,4700.0,475.0,-4225.0,21900.0,7000.0,-14900.0
spolp001,Paul Spoljaric,Toronto Blue Jays,BJAYS,1,2,1,3,1997,2002,5,1.41,11.51,10.1,180,698,518,0,2901,2901,633.0,0.0,-633.0,1485000.0,0.0,-1485000.0
spolp001,Paul Spoljaric,Seattle Mariners,MARNRS,1,1,1,2,1998,1999,1,-0.94,-0.01,0.93,10,2,-8,4,0,-4,34.0,4.0,-30.0,255000.0,2000000.0,1745000.0
spolp001,Paul Spoljaric,Philadelphia Phillies,PHILS,1,1,1,2,1999,2002,3,0.12,6.16,6.04,39,211,172,0,216,216,186.0,1819.0,1633.0,450000.0,379000.0,-71000.0
spolp001,Paul Spoljaric,Toronto Blue Jays,BJAYS,3,5,8,13,1999,2001,2,2.96,-0.34,-3.3,81,293,212,74,474,400,885.0,431.0,-454.0,8600000.0,1025000.0,-7575000.0
spoot001,Tim Spooneybarger,Atlanta Braves,BRAVES,1,2,2,4,2002,2008,6,0.15,5.9,5.75,66,176,110,3,203,200,126.0,1529.0,1403.0,200000.0,0.0,-200000.0
sprae001,Ed Sprague,Toronto Blue Jays,BJAYS,1,1,1,2,1998,1998,0,-0.8,0.0,0.8,27,0,-27,91,0,-91,0.0,0.0,0.0,2350000.0,0.0,-2350000.0
sprae001,Ed Sprague,San Diego Padres,PADRS,3,7,5,12,2000,2005,5,-0.83,-1.53,-0.7,173,136,-37,612,34,-578,24.0,532.0,508.0,8350000.0,4750000.0,-3600000.0
sprae101,Ed Sprague,Cincinnati Reds,REDS,1,2,2,4,1973,1973,0,0.24,0.19,-0.05,16,36,20,0,60,60,24.0,0.0,-24.0,16000.0,0.0,-16000.0
spraj001,Jerry Spradlin,Philadelphia Phillies,PHILS,1,1,1,2,1998,1999,1,-0.21,-0.39,-0.18,4,70,66,0,55,55,9.0,504.0,495.0,235000.0,1033333.0,798333.0
spraj001,Jerry Spradlin,Cleveland Indians,INDINS,1,1,2,3,1999,1999,0,0.45,0.0,-0.45,114,0,-114,1,0,-1,174.0,0.0,-174.0,687500.0,0.0,-687500.0
spraj001,Jerry Spradlin,San Francisco Giants,GIANTS,1,1,1,2,1999,2000,1,-0.22,0.0,0.22,53,0,-53,0,0,0,225.0,0.0,-225.0,0.0,0.0,0.0
sprij001,Jeffrey Springs,Texas Rangers,RNGRS,1,1,1,2,2020,2020,0,-0.27,0.0,0.27,16,0,-16,0,0,0,61.0,0.0,-61.0,0.0,0.0,0.0
sprij001,Jeffrey Springs,Boston Red Sox,RSOX,1,3,2,5,2021,2021,0,0.11,0.0,-0.11,61,0,-61,0,0,0,216.0,0.0,-216.0,0.0,0.0,0.0
sprij102,Jack Spring,Boston Red Sox,RSOX,2,2,3,5,1958,1959,1,-0.15,0.43,0.58,66,36,-30,4,4,0,126.0,91.0,-35.0,0.0,11000.0,11000.0
sprij102,Jack Spring,Boston Red Sox,RSOX,1,1,1,2,1958,1958,0,0.19,0.0,-0.19,28,0,-28,4,0,-4,65.0,0.0,-65.0,0.0,0.0,0.0
sprij102,Jack Spring,Chicago Cubs,CUBS,2,4,4,8,1964,1966,2,41.31,1.04,-40.27,2470,267,-2203,10220,596,-9624,9.0,335.0,326.0,12000.0,0.0,-12000.0
sprir001,Russ Springer,New York Yankees,YANKS,1,3,1,4,1992,1994,2,-1.97,3.42,5.39,549,56,-493,1984,0,-1984,509.0,1123.0,614.0,0.0,1850000.0,1850000.0
sprir001,Russ Springer,California Angels,ANGELS,1,2,1,3,1995,1995,0,-0.59,-0.19,0.4,154,11,-143,102,18,-84,370.0,0.0,-370.0,250000.0,250000.0,0.0
sprir001,Russ Springer,Arizona Diamondbacks,DBACKS,3,3,3,6,1998,2000,2,0.88,-0.27,-1.15,437,92,-345,1,29,28,618.0,105.0,-513.0,900000.0,785000.0,-115000.0
spris001,Steve Springer,New York Mets,METS,1,2,2,4,1988,1989,1,0.86,0.0,-0.86,37,0,-37,0,0,0,239.0,0.0,-239.0,0.0,0.0,0.0
sprob101,Bobby Sprowl,Boston Red Sox,RSOX,1,3,1,4,1979,1979,0,-0.68,2.56,3.24,58,84,26,7,347,340,138.0,0.0,-138.0,0.0,0.0,0.0
sprob101,Bobby Sprowl,Houston Astros,ASTROS,1,1,1,2,1983,1983,0,0.0,0.0,0.0,0,0,0,0,0,0,0.0,0.0,0.0,0.0,0.0,0.0
spruz001,Zeke Spruill,Atlanta Braves,BRAVES,4,10,11,21,2013,2019,6,22.68,8.16,-14.52,2194,1203,-991,6430,4358,-2072,1394.0,147.0,-1247.0,14250000.0,0.0,-14250000.0
spruz001,Zeke Spruill,Arizona Diamondbacks,DBACKS,1,1,1,2,2014,2014,0,0.0,0.0,0.0,0,0,0,0,0,0,0.0,0.0,0.0,0.0,0.0,0.0
spurc001,Chris Spurling,New York Yankees,YANKS,1,1,1,2,2000,2003,3,0.0,-0.26,-0.26,0,76,76,0,222,222,0.0,0.0,0.0,0.0,450000.0,450000.0
spurc001,Chris Spurling,Atlanta Braves,BRAVES,1,1,1,2,2003,2003,0,1.26,0.0,-1.26,141,0,-141,0,0,0,477.0,0.0,-477.0,0.0,0.0,0.0
stace101,Eddie Stack,Philadelphia Phillies,PHILS,1,1,1,2,1911,1911,0,1.82,0.0,-1.82,102,0,-102,81,0,-81,685.0,0.0,-685.0,0.0,0.0,0.0
stace101,Eddie Stack,Brooklyn Dodgers,DOGRS,1,2,1,3,1913,1915,2,-0.82,5.81,6.63,36,118,82,23,128,105,201.0,1107.0,906.0,2600.0,3500.0,900.0
staem101,Marv Staehle,Chicago White Sox,WSOX,1,2,1,3,1967,1968,1,-0.19,0.06,0.25,19,60,41,22,220,198,0.0,0.0,0.0,25000.0,0.0,-25000.0
staem101,Marv Staehle,Seattle Pilots,BREWRS,5,7,5,12,1969,1976,7,3.03,4.56,1.53,664,447,-217,2230,871,-1359,335.0,641.0,306.0,163000.0,34000.0,-129000.0
stafb101,Bill Stafford,New York Yankees,YANKS,3,5,4,9,1966,1973,7,1.66,4.77,3.11,451,607,156,554,678,124,1018.0,1714.0,696.0,17000.0,41500.0,24500.0
stafg101,General Stafford,New York Giants,GIANTS,2,4,3,7,1897,1903,6,1.21,7.1,5.89,186,517,331,798,2035,1237,0.0,0.0,0.0,0.0,0.0,0.0
stags101,Steve Staggs,Toronto Blue Jays,BJAYS,2,2,2,4,1978,1979,1,0.7,-0.32,-1.02,47,42,-5,97,0,-97,0.0,273.0,273.0,0.0,0.0,0.0
stahj101,Jake Stahl,Chicago White Sox,WSOX,1,1,1,2,1907,1907,0,1.29,0.0,-1.29,75,0,-75,301,0,-301,0.0,0.0,0.0,0.0,0.0,0.0
staim001,Matt Stairs,Oakland Athletics,ATLTCS,1,1,1,2,2000,2000,0,1.47,0.0,-1.47,128,0,-128,403,0,-403,0.0,0.0,0.0,3050000.0,0.0,-3050000.0
staim001,Matt Stairs,Kansas City Royals,ROYALS,1,1,1,2,2006,2006,0,-0.19,-0.17,0.02,26,4,-22,88,0,-88,0.0,20.0,20.0,1350000.0,0.0,-1350000.0
staim001,Matt Stairs,Toronto Blue Jays,BJAYS,1,1,1,2,2008,2009,1,0.6,0.0,-0.6,115,0,-115,148,0,-148,0.0,0.0,0.0,1625000.0,0.0,-1625000.0
stair101,Roy Staiger,New York Mets,METS,1,1,1,2,1977,1977,0,0.04,0.0,-0.04,4,0,-4,13,0,-13,0.0,0.0,0.0,40000.0,0.0,-40000.0
stait101,Tuck Stainback,Chicago Cubs,CUBS,1,4,1,5,1938,1938,0,10.27,2.49,-7.78,576,26,-550,361,27,-334,2894.0,224.0,-2670.0,0.0,0.0,0.0
stait101,Tuck Stainback,Philadelphia Phillies,PHILS,1,1,1,2,1938,1939,1,-0.5,1.49,1.99,103,163,60,318,603,285,0.0,0.0,0.0,0.0,0.0,0.0
stait101,Tuck Stainback,Detroit Tigers,TIGRS,1,2,1,3,1941,1946,5,-0.12,-1.38,-1.26,211,88,-123,687,313,-374,0.0,0.0,0.0,0.0,0.0,0.0
stait101,Tuck Stainback,LosAngeles,LosAngeles,1,1,3,4,1933,1937,4,-1.72,0.0,1.72,267,0,-267,727,0,-727,0.0,0.0,0.0,0.0,0.0,0.0
stalg102,George Staller,Brooklyn Dodgers,DOGRS,2,9,3,12,1941,1947,6,3.3,-0.19,-3.49,337,37,-300,419,81,-338,1285.0,0.0,-1285.0,17500.0,0.0,-17500.0
stalg103,Gerry Staley,St. Louis Cardinals,CARDS,1,2,1,3,1954,1956,2,-0.38,0.61,0.99,264,56,-208,738,5,-733,359.0,117.0,-242.0,0.0,10000.0,10000.0
stalg103,Gerry Staley,Chicago White Sox,WSOX,11,17,21,38,1961,1969,8,15.81,27.33,11.52,1761,2250,489,3197,3489,292,3384.0,5251.0,1867.0,77750.0,58000.0,-19750.0
stalg103,Gerry Staley,Kansas City Athletics,ATLTCS,1,2,2,4,1961,1963,2,0.04,2.6,2.56,55,199,144,51,85,34,40.0,733.0,693.0,0.0,0.0,0.0
stalt101,Tracy Stallard,Boston Red Sox,RSOX,2,4,2,6,1962,1966,4,1.63,7.14,5.51,379,407,28,759,1449,690,1141.0,0.0,-1141.0,0.0,0.0,0.0
stalt101,Tracy Stallard,New York Mets,METS,1,2,2,4,1964,1964,0,0.41,0.0,-0.41,120,0,-120,87,0,-87,740.0,0.0,-740.0,0.0,0.0,0.0
stalv101,Virgil Stallcup,Cincinnati Reds,REDS,2,3,4,7,1952,1953,1,3.75,-0.48,-4.23,393,72,-321,1163,232,-931,0.0,0.0,0.0,25500.0,0.0,-25500.0
stame001,Eric Stamets,Anaheim Angels,ANGELS,1,1,1,2,2015,2015,0,-0.71,-0.3,0.41,15,48,33,48,162,114,0.0,0.0,0.0,0.0,0.0,0.0
stana001,Andy Stankiewicz,New York Yankees,YANKS,1,2,1,3,1993,1994,1,0.14,-0.35,-0.49,80,32,-48,134,0,-134,0.0,120.0,120.0,138000.0,900000.0,762000.0
stand101,Don Stanhouse,Oakland Athletics,ATLTCS,2,3,2,5,1972,1972,0,-1.73,-0.85,0.88,237,13,-224,63,9,-54,1061.0,67.0,-994.0,75000.0,0.0,-75000.0
stand101,Don Stanhouse,Texas Rangers,RNGRS,2,3,3,6,1974,1976,2,4.6,-0.5,-5.1,567,57,-510,1479,176,-1303,1066.0,63.0,-1003.0,14000.0,110000.0,96000.0
stand101,Don Stanhouse,Montreal Expos,NATEX,1,3,3,6,1977,1986,9,17.04,9.91,-7.13,1002,506,-496,2634,346,-2288,744.0,3222.0,2478.0,0.0,0.0,0.0
stane101,Eddie Stanky,Chicago Cubs,CUBS,1,1,1,2,1944,1950,6,16.22,5.86,-10.36,532,379,-153,2362,203,-2159,0.0,1878.0,1878.0,0.0,0.0,0.0
stane101,Eddie Stanky,Brooklyn Dodgers,DOGRS,1,2,3,5,1948,1948,0,8.05,0.0,-8.05,219,0,-219,971,0,-971,0.0,0.0,0.0,0.0,0.0,0.0
stane101,Eddie Stanky,Boston Braves,BRAVES,3,12,6,18,1949,1960,11,49.35,33.68,-15.67,2025,1559,-466,7279,6319,-960,2138.0,0.0,-2138.0,0.0,42000.0,42000.0
stane101,Eddie Stanky,New York Giants,GIANTS,2,5,3,8,1951,1957,6,0.88,3.03,2.15,70,374,304,145,124,-21,0.0,1136.0,1136.0,32500.0,25000.0,-7500.0
stanf101,Fred Stanley,Cleveland Indians,INDINS,1,1,1,2,1972,1972,0,-0.3,0.29,0.59,39,44,5,99,16,-83,0.0,174.0,174.0,10500.0,0.0,-10500.0
stanf101,Fred Stanley,San Diego Padres,PADRS,1,1,1,2,1972,1972,0,2.85,0.0,-2.85,521,0,-521,1157,0,-1157,0.0,0.0,0.0,0.0,0.0,0.0
stanf101,Fred Stanley,New York Yankees,YANKS,2,5,3,8,1980,1985,5,23.27,1.25,-22.02,1007,92,-915,3692,0,-3692,136.0,811.0,675.0,650000.0,0.0,-650000.0
stanj105,Joe Stanka,Chicago Cubs,CUBS,3,7,5,12,1955,1961,6,-0.03,2.29,2.32,58,334,276,20,837,817,147.0,324.0,177.0,0.0,0.0,0.0
stanl101,Lee Stange,Minnesota Twins,TWINS,4,9,8,17,1964,1971,7,23.37,18.05,-5.32,1251,1468,217,3644,1313,-2331,1591.0,4850.0,3259.0,202500.0,192000.0,-10500.0
stanl101,Lee Stange,Cleveland Indians,INDINS,3,6,4,10,1966,1968,2,5.05,0.29,-4.76,824,214,-610,588,274,-314,3146.0,179.0,-2967.0,27000.0,25000.0,-2000.0
stanl102,Leroy Stanton,New York Mets,METS,1,4,1,5,1971,1973,2,45.16,0.14,-45.02,957,146,-811,2120,526,-1594,6672.0,0.0,-6672.0,45950.0,80000.0,34050.0
stanm002,Mike Stanley,Boston Red Sox,RSOX,2,4,3,7,1997,2004,7,10.08,53.51,43.43,478,211,-267,533,21,-512,3819.0,4151.0,332.0,2100000.0,3615000.0,1515000.0
stanm002,Mike Stanley,Toronto Blue Jays,BJAYS,2,2,3,5,1998,2000,2,2.97,0.45,-2.52,241,88,-153,918,207,-711,0.0,243.0,243.0,2020000.0,0.0,-2020000.0
stanm003,Mike Stanton,Atlanta Braves,BRAVES,2,3,3,6,1995,1997,2,1.44,0.0,-1.44,84,28,-56,0,58,58,245.0,0.0,-245.0,1500000.0,750000.0,-750000.0
stanm003,Mike Stanton,Boston Red Sox,RSOX,5,9,9,18,1996,2000,4,9.7,3.32,-6.38,608,447,-161,1634,946,-688,1320.0,379.0,-941.0,7038500.0,823500.0,-6215000.0
stanm003,Mike Stanton,New York Mets,METS,1,1,1,2,2004,2005,1,-0.09,0.11,0.2,33,6,-27,0,0,0,42.0,8.0,-34.0,3000000.0,1800000.0,-1200000.0
stanm003,Mike Stanton,Washington Nationals,NATEX,1,1,2,3,2005,2005,0,0.05,0.0,-0.05,1,0,-1,0,0,0,3.0,0.0,-3.0,0.0,0.0,0.0
stanm003,Mike Stanton,Washington Nationals,NATEX,1,1,1,2,2006,2011,5,0.66,0.59,-0.07,52,38,-14,1,35,34,70.0,319.0,249.0,1000000.0,0.0,-1000000.0
stanm004,Giancarlo Stanton,Miami Marlins,MARLNS,1,1,3,4,2017,2021,4,8.41,2.42,-5.99,338,321,-17,1450,1323,-127,0.0,8.0,8.0,14500000.0,9857143.0,-4642857.0
stano101,Oscar Stanage,St. Louis Cardinals,CARDS,2,2,2,4,1906,1907,1,-0.02,0.29,0.31,1,38,37,1,59,58,0.0,418.0,418.0,0.0,0.0,0.0
stanr001,Rob Stanifer,Florida Marlins,MARLNS,1,1,1,2,1999,1999,0,-0.55,0.0,0.55,11,0,-11,0,0,0,39.0,0.0,-39.0,0.0,0.0,0.0
stanr002,Ryne Stanek,Tampa Bay Devil Rays,RAYS,2,4,4,8,2019,2021,2,4.08,3.02,-1.06,256,108,-148,694,3,-691,153.0,553.0,400.0,564200.0,1125000.0,560800.0
stans001,Steve Stanicek,San Francisco Giants,GIANTS,1,1,1,2,1986,1986,0,0.06,0.0,-0.06,4,0,-4,7,0,-7,0.0,0.0,0.0,0.0,0.0,0.0
starc101,Charlie Starr,Pittsburgh Pirates,PIRATS,1,1,1,2,1909,1914,5,0.03,0.51,0.48,61,239,178,259,700,441,0.0,0.0,0.0,0.0,0.0,0.0
starc101,Charlie Starr,Boston Braves,BRAVES,5,7,8,15,1909,1927,18,12.27,37.78,25.51,647,1815,1168,1592,4784,3192,2058.0,9235.0,7177.0,6000.0,0.0,-6000.0
stard001,Denny Stark,Seattle Mariners,MARNRS,3,7,6,13,2001,2008,7,8.61,1.58,-7.03,1096,337,-759,200,984,784,2142.0,123.0,-2019.0,1587500.0,4850000.0,3262500.0
stard101,Dolly Stark,Brooklyn Dodgers,DOGRS,1,2,2,4,1912,1916,4,0.0,-0.4,-0.4,0,214,214,0,788,788,0.0,0.0,0.0,4200.0,0.0,-4200.0
stard102,Dick Starr,New York Yankees,YANKS,2,7,3,10,1948,1954,6,24.48,2.06,-22.42,970,341,-629,1730,188,-1542,4702.0,1746.0,-2956.0,11500.0,10000.0,-1500.0
stard102,Dick Starr,St.Louis Browns,ORLS,3,6,4,10,1951,1952,1,0.57,-0.84,-1.41,178,114,-64,353,328,-25,184.0,82.0,-102.0,0.0,20000.0,20000.0
starr101,Ray Starr,St. Louis Cardinals,CARDS,3,6,6,12,1932,1939,7,8.47,6.35,-2.12,942,482,-460,3293,766,-2527,60.0,2559.0,2499.0,0.0,0.0,0.0
stasm001,Max Stassi,Oakland Athletics,ATLTCS,1,3,2,5,2013,2016,3,8.06,4.16,-3.9,776,397,-379,2069,1228,-841,1629.0,325.0,-1304.0,0.0,0.0,0.0
stasm001,Max Stassi,Houston Astros,ASTROS,1,1,2,3,2019,2019,0,2.05,0.0,-2.05,138,0,-138,473,0,-473,0.0,0.0,0.0,590100.0,0.0,-590100.0
statj101,Jigger Statz,LosAngeles,LosAngeles,1,2,5,7,1921,1922,1,14.87,0.0,-14.87,633,0,-633,2280,0,-2280,2159.0,0.0,-2159.0,0.0,8074.0,8074.0
staur001,Rusty Staub,Houston Astros,ASTROS,1,1,2,3,1969,1973,4,18.54,0.22,-18.32,518,434,-84,2163,1578,-585,0.0,0.0,0.0,0.0,50000.0,50000.0
staur001,Rusty Staub,Montreal Expos,NATEX,5,7,9,16,1972,1985,13,40.49,30.74,-9.75,2632,3209,577,9789,10505,716,812.0,1543.0,731.0,193500.0,237000.0,43500.0
staur001,Rusty Staub,New York Mets,METS,1,2,2,4,1975,1979,4,6.09,1.21,-4.88,575,71,-504,2407,95,-2312,284.0,578.0,294.0,110000.0,95000.0,-15000.0
staur001,Rusty Staub,Detroit Tigers,TIGRS,1,1,2,3,1979,1979,0,0.03,0.0,-0.03,38,0,-38,101,0,-101,0.0,0.0,0.0,0.0,0.0,0.0
staur001,Rusty Staub,Montreal Expos,NATEX,2,2,3,5,1980,1986,6,1.65,1.2,-0.45,131,327,196,465,635,170,0.0,0.0,0.0,0.0,0.0,0.0
stcle101,Ebba St. Claire,Pittsburgh Pirates,PIRATS,1,1,1,2,1948,1948,0,0.0,0.0,0.0,0,0,0,0,0,0,0.0,0.0,0.0,0.0,0.0,0.0
stcle101,Ebba St. Claire,Milwaukee Braves,BRAVES,2,8,3,11,1954,1960,6,39.41,8.38,-31.03,1145,621,-524,1887,2335,448,6059.0,0.0,-6059.0,0.0,42000.0,42000.0
stclr001,Randy St. Claire,Montreal Expos,NATEX,3,5,4,9,1988,1992,4,1.15,0.52,-0.63,739,280,-459,1881,660,-1221,41.0,0.0,-41.0,330000.0,317500.0,-12500.0
steaj001,John Stearns,Philadelphia Phillies,PHILS,2,4,4,8,1974,1984,10,23.16,7.68,-15.48,1035,1011,-24,3964,168,-3796,0.0,2166.0,2166.0,0.0,90000.0,90000.0
steeb103,Bob Steele,St. Louis Cardinals,CARDS,5,8,7,15,1917,1928,11,8.64,27.59,18.95,1465,1547,82,4888,6229,1341,1090.0,0.0,-1090.0,36000.0,22800.0,-13200.0
steem101,Morrie Steevens,Chicago Cubs,CUBS,1,1,1,2,1964,1964,0,-0.56,0.0,0.56,20,0,-20,0,0,0,16.0,0.0,-16.0,0.0,0.0,0.0
stefj001,John Stefero,Baltimore Orioles,ORLS,2,3,2,5,1986,1991,5,29.01,1.13,-27.88,569,267,-302,791,631,-160,4827.0,0.0,-4827.0,630458.0,0.0,-630458.0
stegd001,Dave Stegman,Detroit Tigers,TIGRS,1,1,1,2,1980,1981,1,0.0,-0.19,-0.19,0,6,6,0,0,0,0.0,11.0,11.0,0.0,0.0,0.0
stegd001,Dave Stegman,San Diego Padres,PADRS,1,1,1,2,1981,1981,0,-0.03,0.0,0.03,2,0,-2,0,0,0,0.0,0.0,0.0,0.0,0.0,0.0
steib001,Bill Stein,St. Louis Cardinals,CARDS,1,1,1,2,1973,1975,2,0.0,-0.55,-0.55,0,30,30,0,47,47,0.0,0.0,0.0,0.0,0.0,0.0
steib001,Bill Stein,California Angels,ANGELS,1,1,2,3,1974,1974,0,0.75,0.0,-0.75,206,0,-206,720,0,-720,0.0,0.0,0.0,0.0,0.0,0.0
steib002,Blake Stein,St. Louis Cardinals,CARDS,1,3,1,4,1997,1997,0,-0.38,2.04,2.42,256,51,-205,9,224,215,1161.0,0.0,-1161.0,395000.0,7150000.0,6755000.0
steib002,Blake Stein,Oakland Athletics,ATLTCS,1,3,1,4,1999,2000,1,2.09,2.63,0.54,130,45,-85,4,6,2,1197.0,792.0,-405.0,201500.0,4800000.0,4598500.0
steih101,Harry Steinfeldt,Cincinnati Reds,REDS,2,4,3,7,1905,1910,5,18.64,12.54,-6.1,746,275,-471,3017,389,-2628,9.0,2982.0,2973.0,0.0,0.0,0.0
steih101,Harry Steinfeldt,StPaul,StPaul,2,3,3,6,1911,1912,1,1.07,0.0,-1.07,144,0,-144,499,0,-499,0.0,0.0,0.0,0.0,2100.0,2100.0
steij101,Justin Stein,Philadelphia Phillies,PHILS,1,1,1,2,1938,1939,1,0.04,0.84,0.8,11,87,76,19,330,311,0.0,0.0,0.0,0.0,0.0,0.0
steij101,Justin Stein,Cincinnati Reds,REDS,1,1,1,2,1938,1938,0,0.0,0.68,0.68,0,35,35,0,106,106,0.0,0.0,0.0,0.0,0.0,0.0
steir101,Randy Stein,New York Yankees,YANKS,1,2,1,3,1977,1977,0,0.0,0.37,0.37,0,8,8,0,27,27,0.0,0.0,0.0,0.0,0.0,0.0
steir101,Randy Stein,Milwaukee Brewers,BREWRS,1,1,1,2,1979,1981,2,-0.94,0.72,1.66,28,35,7,0,0,0,152.0,493.0,341.0,0.0,0.0,0.0
stelr101,Rick Stelmaszek,Texas Rangers,RNGRS,7,19,12,31,1973,1988,15,43.57,39.21,-4.36,2413,2544,131,8647,8625,-22,2773.0,4668.0,1895.0,457000.0,165000.0,-292000.0
stelr101,Rick Stelmaszek,California Angels,ANGELS,1,1,1,2,1974,1975,1,0.19,0.43,0.24,25,11,-14,56,0,-56,0.0,35.0,35.0,0.0,24000.0,24000.0
stelr101,Rick Stelmaszek,Chicago Cubs,CUBS,1,1,1,2,1976,1978,2,0.0,0.0,0.0,0,0,0,0,0,0,0.0,0.0,0.0,0.0,0.0,0.0
stemf101,Fred Stem,Boston Braves,BRAVES,1,1,1,2,1909,1910,1,0.0,-0.66,-0.66,0,65,65,0,234,234,0.0,0.0,0.0,0.0,0.0,0.0
stenc101,Casey Stengel,Brooklyn Dodgers,DOGRS,2,3,4,7,1918,1929,11,13.23,38.94,25.71,700,1051,351,2619,1612,-1007,779.0,8893.0,8114.0,0.0,0.0,0.0
stenc101,Casey Stengel,Pittsburgh Pirates,PIRATS,1,1,1,2,1919,1922,3,2.09,4.54,2.45,153,277,124,570,1156,586,0.0,0.0,0.0,4200.0,5000.0,800.0
stenc101,Casey Stengel,Philadelphia Phillies,PHILS,2,4,4,8,1921,1923,2,7.05,-3.87,-10.92,351,317,-34,1240,1284,44,0.0,0.0,0.0,5000.0,4000.0,-1000.0
stenc101,Casey Stengel,New York Giants,GIANTS,2,4,3,7,1923,1927,4,14.64,1.52,-13.12,912,442,-470,3712,1550,-2162,0.0,87.0,87.0,25500.0,9875.0,-15625.0
stend101,Dave Stenhouse,Cincinnati Reds,REDS,1,2,2,4,1961,1966,5,3.64,1.4,-2.24,249,457,208,410,839,429,1116.0,326.0,-790.0,0.0,0.0,0.0
stenj101,Jake Stenzel,Pittsburgh Pirates,PIRATS,1,4,2,6,1896,1898,2,3.6,0.48,-3.12,234,186,-48,984,763,-221,0.0,0.0,0.0,0.0,0.0,0.0
stenj101,Jake Stenzel,Baltimore Orioles,BLN,1,2,2,4,1898,1903,5,2.47,4.06,1.59,268,251,-17,1122,1106,-16,0.0,0.0,0.0,0.0,0.0,0.0
stenm001,Mike Stenhouse,Montreal Expos,NATEX,1,1,1,2,1985,1986,1,0.02,-0.32,-0.34,81,40,-41,209,0,-209,0.0,71.0,71.0,0.0,0.0,0.0
stenm001,Mike Stenhouse,Minnesota Twins,TWINS,1,1,1,2,1985,1985,0,-0.11,0.0,0.11,21,0,-21,34,0,-34,0.0,0.0,0.0,0.0,0.0,0.0
stepb102,Bob Stephenson,St. Louis Cardinals,CARDS,19,44,38,82,1956,1972,16,56.42,67.4,10.98,5645,3260,-2385,13530,9157,-4373,6309.0,6165.0,-144.0,120500.0,36000.0,-84500.0
stepb103,Bryan Stephens,Cleveland Indians,INDINS,1,4,2,6,1947,1949,2,3.17,0.88,-2.29,606,121,-485,1943,303,-1640,368.0,217.0,-151.0,0.0,20000.0,20000.0
stepb104,Buzz Stephen,Milwaukee Brewers,BREWRS,2,4,2,6,1970,1974,4,1.37,11.49,10.12,187,678,491,473,2707,2234,0.0,0.0,0.0,0.0,234000.0,234000.0
stepe101,Earl Stephenson,Chicago Cubs,CUBS,2,4,2,6,1971,1977,6,12.52,9.33,-3.19,493,821,328,508,3274,2766,3595.0,0.0,-3595.0,150000.0,45000.0,-105000.0
stepe101,Earl Stephenson,Milwaukee Brewers,BREWRS,3,6,5,11,1972,1984,12,7.41,27.71,20.3,475,1402,927,547,5127,4580,4062.0,1332.0,-2730.0,59800.0,15000.0,-44800.0
stepe101,Earl Stephenson,Montreal Expos,NATEX,1,1,1,2,1974,1974,0,0.0,0.0,0.0,0,0,0,0,0,0,0.0,0.0,0.0,0.0,0.0,0.0
stepg001,Garrett Stephenson,Baltimore Orioles,ORLS,1,2,2,4,1996,1997,1,0.34,0.44,0.1,89,89,0,71,320,249,679.0,0.0,-679.0,0.0,3250000.0,3250000.0
stepg001,Garrett Stephenson,Philadelphia Phillies,PHILS,3,4,5,9,1998,2002,4,4.86,4.39,-0.47,468,569,101,282,1029,747,2055.0,750.0,-1305.0,7696667.0,14670000.0,6973333.0
stepg101,Gene Stephens,Boston Red Sox,RSOX,1,1,1,2,1960,1960,0,1.46,0.31,-1.15,116,105,-11,292,448,156,0.0,0.0,0.0,0.0,0.0,0.0
stepg101,Gene Stephens,Baltimore Orioles,ORLS,2,2,3,5,1961,1963,2,-0.94,-0.08,0.86,197,127,-70,619,311,-308,0.0,0.0,0.0,0.0,0.0,0.0
stepj102,John Stephenson,New York Mets,METS,1,2,1,3,1967,1967,0,0.17,0.17,0.0,56,30,-26,61,24,-37,95.0,212.0,117.0,0.0,0.0,0.0
stepj103,Jerry Stephenson,Milwaukee Brewers,BREWRS,1,1,1,2,1970,1970,0,-0.2,-0.04,0.16,6,2,-4,1,0,-1,20.0,6.0,-14.0,0.0,0.0,0.0
stepp001,Phil Stephenson,Oakland Athletics,ATLTCS,1,2,2,4,1986,1986,0,-0.31,0.0,0.31,17,0,-17,23,0,-23,0.0,0.0,0.0,0.0,0.0,0.0
stepp001,Phil Stephenson,Chicago Cubs,CUBS,1,3,2,5,1989,1992,3,9.01,-0.33,-9.34,632,454,-178,1598,1395,-203,382.0,0.0,-382.0,400000.0,750000.0,350000.0
stepr002,Robert Stephenson,Cincinnati Reds,REDS,2,4,3,7,2020,2021,1,0.84,0.31,-0.53,95,46,-49,0,0,0,138.0,64.0,-74.0,0.0,4050000.0,4050000.0
stepr101,Riggs Stephenson,Indianapolis,Indianapolis,1,2,3,5,1926,1926,0,24.0,0.0,-24.0,988,0,-988,3984,0,-3984,0.0,0.0,0.0,0.0,9500.0,9500.0
stepv101,Vern Stephens,St.Louis Browns,ORLS,48,119,133,252,1947,1988,41,205.08,223.58,18.5,14314,21110,6796,35907,60131,24224,36284.0,27740.0,-8544.0,987083.0,277700.0,-709383.0
stepv101,Vern Stephens,Boston Red Sox,RSOX,1,1,3,4,1953,1955,2,0.29,1.18,0.89,66,202,136,207,118,-89,0.0,1116.0,1116.0,0.0,0.0,0.0
stera001,Adam Stern,Boston Red Sox,RSOX,1,2,1,3,2006,2007,1,0.0,-0.68,-0.68,2,18,16,0,65,65,0.0,0.0,0.0,335000.0,9000000.0,8665000.0
stevd001,Dave Stevens,Chicago Cubs,CUBS,2,3,2,5,1993,1995,2,-2.42,-1.8,0.62,423,66,-357,1019,51,-968,662.0,450.0,-212.0,349000.0,126000.0,-223000.0
stevj001,Jeff Stevens,Cincinnati Reds,REDS,2,3,3,6,2006,2017,11,1.0,28.05,27.05,120,1614,1494,499,6899,6400,0.0,0.0,0.0,0.0,0.0,0.0
stevj001,Jeff Stevens,Cleveland Indians,INDINS,2,4,3,7,2008,2013,5,-0.38,5.27,5.65,140,382,242,264,314,50,120.0,883.0,763.0,5500000.0,4750000.0,-750000.0
stevl001,Lee Stevens,California Angels,ANGELS,1,1,1,2,1993,1993,0,-0.62,0.0,0.62,338,0,-338,1374,0,-1374,0.0,0.0,0.0,0.0,0.0,0.0
stevl001,Lee Stevens,Texas Rangers,RNGRS,2,2,3,5,2000,2001,1,0.34,-0.15,-0.49,395,229,-166,1619,901,-718,0.0,0.0,0.0,4325000.0,0.0,-4325000.0
stevl001,Lee Stevens,Montreal Expos,NATEX,2,6,6,12,2002,2004,2,48.64,-2.57,-51.21,1323,330,-993,4723,156,-4567,4264.0,874.0,-3390.0,4000000.0,4925000.0,925000.0
stevr101,R C Stevens,Pittsburgh Pirates,PIRATS,1,3,1,4,1960,1961,1,4.94,2.05,-2.89,573,87,-486,984,20,-964,2463.0,268.0,-2195.0,0.0,0.0,0.0
stevt001,Todd Steverson,Detroit Tigers,TIGRS,7,19,14,33,1996,2002,6,8.66,7.11,-1.55,2368,1295,-1073,4185,3631,-554,2521.0,1620.0,-901.0,8560000.0,6675000.0,-1885000.0
stewa101,Ace Stewart,Cincinnati Reds,REDS,1,5,3,8,1897,1900,3,8.1,12.35,4.25,718,395,-323,2747,1335,-1412,936.0,1747.0,811.0,0.0,0.0,0.0
stewb101,Bud Stewart,New York Yankees,YANKS,1,1,2,3,1948,1948,0,3.69,0.0,-3.69,354,0,-354,1333,0,-1333,0.0,0.0,0.0,0.0,11000.0,11000.0
stewb101,Bud Stewart,Washington Senators,TWINS,1,1,1,2,1950,1952,2,2.29,0.53,-1.76,258,81,-177,600,272,-328,0.0,0.0,0.0,0.0,0.0,0.0
stewc001,Chris Stewart,Chicago White Sox,WSOX,1,1,1,2,2007,2007,0,-0.29,0.0,0.29,17,0,-17,43,0,-43,0.0,0.0,0.0,0.0,0.0,0.0
stewc001,Chris Stewart,San Francisco Giants,GIANTS,1,1,1,2,2012,2017,5,0.83,3.38,2.55,164,579,415,497,10,-487,0.0,929.0,929.0,0.0,0.0,0.0
stewc001,Chris Stewart,New York Yankees,YANKS,1,1,1,2,2013,2013,0,-0.19,0.0,0.19,192,0,-192,583,0,-583,0.0,0.0,0.0,515100.0,0.0,-515100.0
stewd001,Dave Stewart,Los Angeles Dodgers,DOGRS,5,8,6,14,1983,1994,11,11.39,19.01,7.62,690,775,85,366,1238,872,3528.0,4504.0,976.0,3861000.0,3708000.0,-153000.0
stewd001,Dave Stewart,Texas Rangers,RNGRS,2,3,2,5,1985,1987,2,-0.22,-0.57,-0.35,24,23,-1,0,0,0,50.0,96.0,46.0,505000.0,0.0,-505000.0
stewi001,Ian Stewart,Colorado Rockies,ROCKS,1,2,2,4,2011,2018,7,0.03,17.66,17.63,55,1081,1026,202,4267,4065,0.0,0.0,0.0,2287500.0,440000.0,-1847500.0
stewj102,Jimmy Stewart,Cincinnati Reds,REDS,6,8,13,21,1971,1982,11,32.36,75.99,43.63,1555,3237,1682,4173,10169,5996,5915.0,4444.0,-1471.0,0.0,0.0,0.0
stewl101,Lefty Stewart,Detroit Tigers,TIGRS,2,5,4,9,1927,1934,7,25.64,16.62,-9.02,1182,957,-225,3618,3579,-39,3712.0,0.0,-3712.0,12500.0,10000.0,-2500.0
stewl101,Lefty Stewart,St.Louis Browns,ORLS,20,38,48,86,1932,1952,20,96.01,96.11,0.1,5218,8686,3468,17109,27646,10537,8613.0,15510.0,6897.0,185500.0,179450.0,-6050.0
stewl101,Lefty Stewart,Washington Senators,TWINS,1,1,1,2,1935,1935,0,-0.66,-0.22,0.44,48,20,-28,33,9,-24,273.0,93.0,-180.0,7000.0,4200.0,-2800.0
stews001,Sammy Stewart,Baltimore Orioles,ORLS,1,1,1,2,1985,1988,3,0.3,-1.8,-2.1,27,64,37,0,153,153,191.0,0.0,-191.0,581250.0,130000.0,-451250.0
stews002,Shannon Stewart,Toronto Blue Jays,BJAYS,2,3,2,5,2003,2006,3,7.16,5.72,-1.44,628,158,-470,2571,235,-2336,23.0,1516.0,1493.0,6200000.0,660000.0,-5540000.0
stews003,Scott Stewart,Montreal Expos,NATEX,5,8,8,16,2004,2012,8,31.18,13.15,-18.03,2584,1404,-1180,7608,3538,-4070,729.0,605.0,-124.0,5079000.0,3403000.0,-1676000.0
stews101,Stuffy Stewart,St. Louis Cardinals,CARDS,4,7,6,13,1919,1928,9,6.49,22.08,15.59,1385,1345,-40,4793,5431,638,403.0,0.0,-403.0,33500.0,21000.0,-12500.0
stews101,Stuffy Stewart,Washington Senators,TWINS,1,3,1,4,1929,1929,0,0.0,0.0,0.0,0,0,0,0,0,0,0.0,0.0,0.0,0.0,0.0,0.0
stewz001,Zach Stewart,Cincinnati Reds,REDS,1,3,1,4,2009,2012,3,24.68,7.61,-17.07,1033,330,-703,4205,1298,-2907,160.0,0.0,-160.0,2425000.0,11625000.0,9200000.0
stewz001,Zach Stewart,Toronto Blue Jays,BJAYS,2,6,6,12,2011,2014,3,-0.73,6.64,7.37,396,443,47,89,1646,1557,842.0,15.0,-827.0,7829600.0,16693000.0,8863400.0
stewz001,Zach Stewart,Chicago White Sox,WSOX,1,2,2,4,2012,2012,0,-0.96,1.4,2.36,12,80,68,16,344,328,17.0,0.0,-17.0,0.0,0.0,0.0
stewz001,Zach Stewart,Boston Red Sox,RSOX,1,1,1,2,2012,2012,0,0.0,0.0,0.0,0,0,0,0,0,0,0.0,0.0,0.0,481500.0,0.0,-481500.0
stigd101,Dick Stigman,Cleveland Indians,INDINS,6,8,11,19,1962,1969,7,9.88,8.16,-1.72,1353,584,-769,1625,332,-1293,4119.0,3147.0,-972.0,97100.0,125000.0,27900.0
stigd101,Dick Stigman,Minnesota Twins,TWINS,1,2,2,4,1966,1968,2,-1.3,-0.53,0.77,68,125,57,19,299,280,243.0,0.0,-243.0,0.0,0.0,0.0
stigd101,Dick Stigman,Boston Red Sox,RSOX,1,3,1,4,1966,1966,0,0.0,0.6,0.6,0,12,12,0,10,10,0.0,93.0,93.0,18500.0,0.0,-18500.0
stilk001,Kurt Stillwell,Cincinnati Reds,REDS,1,2,2,4,1987,1990,3,6.27,5.43,-0.84,546,156,-390,2022,182,-1840,241.0,1481.0,1240.0,580000.0,325000.0,-255000.0
stilr102,Royle Stillman,Los Angeles Dodgers,DOGRS,3,10,5,15,1971,1976,5,18.58,22.72,4.14,838,611,-227,2013,960,-1053,3623.0,2900.0,-723.0,259900.0,282000.0,22100.0
stinb101,Bob Stinson,Los Angeles Dodgers,DOGRS,2,3,3,6,1970,1978,8,24.33,19.6,-4.73,1044,519,-525,4315,1112,-3203,0.0,3594.0,3594.0,125000.0,143750.0,18750.0
stinb101,Bob Stinson,St. Louis Cardinals,CARDS,2,2,2,4,1971,1972,1,-1.0,-0.24,0.76,49,22,-27,82,26,-56,0.0,0.0,0.0,0.0,23500.0,23500.0
stinb101,Bob Stinson,Montreal Expos,NATEX,2,2,2,4,1975,1977,2,2.74,-0.3,-3.04,142,33,-109,417,12,-405,0.0,62.0,62.0,0.0,0.0,0.0
stink001,Kelly Stinnett,New York Mets,METS,1,1,1,2,1996,1997,1,-0.45,0.35,0.8,44,105,61,68,6,-62,0.0,245.0,245.0,0.0,0.0,0.0
stink001,Kelly Stinnett,Cincinnati Reds,REDS,1,1,1,2,2003,2003,0,0.08,-0.3,-0.38,7,18,11,8,44,36,0.0,0.0,0.0,1300000.0,0.0,-1300000.0
stinl101,Lee Stine,SanFrancisco,SanFrancisco,1,1,3,4,1934,1934,0,-0.14,0.0,0.14,10,0,-10,2,0,-2,39.0,0.0,-39.0,0.0,0.0,0.0
stirs101,Snuffy Stirnweiss,New York Yankees,YANKS,2,8,4,12,1950,1954,4,21.38,0.72,-20.66,1235,437,-798,2252,180,-2072,6559.0,1785.0,-4774.0,29000.0,8500.0,-20500.0
stirs101,Snuffy Stirnweiss,St.Louis Browns,ORLS,2,4,3,7,1951,1952,1,-0.57,0.21,0.78,160,272,112,343,951,608,171.0,0.0,-171.0,6000.0,14500.0,8500.0
stitm001,Matt Stites,San Diego Padres,PADRS,1,2,1,3,2013,2015,2,-1.32,1.52,2.84,205,142,-63,0,131,131,225.0,1280.0,1055.0,0.0,0.0,0.0
stobc101,Chuck Stobbs,Boston Red Sox,RSOX,4,10,9,19,1951,1956,5,13.39,14.14,0.75,1557,1085,-472,4986,3287,-1699,2205.0,1545.0,-660.0,102000.0,52000.0,-50000.0
stobc101,Chuck Stobbs,Chicago White Sox,WSOX,3,6,4,10,1952,1961,9,29.42,7.92,-21.5,1605,736,-869,3412,1543,-1869,5853.0,1370.0,-4483.0,72000.0,42500.0,-29500.0
stock001,Kevin Stocker,Philadelphia Phillies,PHILS,2,3,5,8,1997,2009,12,10.22,47.24,37.02,613,1399,786,2435,5885,3450,136.0,38.0,-98.0,17790000.0,0.0,-17790000.0
stocm101,Milt Stock,Boston Braves,BRAVES,1,1,1,2,1913,1913,0,3.11,0.0,-3.11,122,0,-122,433,0,-433,0.0,0.0,0.0,0.0,0.0,0.0
stocm101,Milt Stock,New York Giants,GIANTS,1,3,1,4,1915,1915,0,8.83,1.16,-7.67,856,106,-750,2811,431,-2380,1477.0,0.0,-1477.0,0.0,0.0,0.0
stocm101,Milt Stock,Philadelphia Phillies,PHILS,4,9,10,19,1919,1929,10,27.15,17.61,-9.54,1789,754,-1035,5788,2055,-3733,4451.0,3446.0,-1005.0,8500.0,19850.0,11350.0
stocm101,Milt Stock,St. Louis Cardinals,CARDS,3,4,3,7,1924,1928,4,5.25,10.3,5.05,1271,559,-712,4468,2053,-2415,0.0,0.0,0.0,30500.0,21000.0,-9500.0
stocw101,Wes Stock,Baltimore Orioles,ORLS,1,1,1,2,1964,1967,3,3.8,1.47,-2.33,296,159,-137,29,359,330,713.0,0.0,-713.0,13500.0,0.0,-13500.0
stodb001,Bob Stoddard,Oakland Athletics,ATLTCS,1,2,1,3,1986,1987,1,0.5,0.04,-0.46,36,22,-14,1,42,41,70.0,0.0,-70.0,0.0,0.0,0.0
stodt001,Tim Stoddard,Baltimore Orioles,ORLS,1,1,1,2,1983,1986,3,0.0,4.34,4.34,0,230,230,0,678,678,0.0,0.0,0.0,0.0,0.0,0.0
stodt001,Tim Stoddard,Oakland Athletics,ATLTCS,1,1,2,3,1984,1984,0,0.61,0.0,-0.61,116,0,-116,12,0,-12,276.0,0.0,-276.0,0.0,0.0,0.0
stodt001,Tim Stoddard,San Diego Padres,PADRS,1,1,1,2,1986,1986,0,0.95,-0.49,-1.44,109,34,-75,0,20,20,591.0,227.0,-364.0,675000.0,800000.0,125000.0
stoka102,Al Stokes,Boston Red Sox,RSOX,1,4,2,6,1926,1926,0,0.0,0.0,0.0,0,0,0,0,0,0,0.0,0.0,0.0,15750.0,0.0,-15750.0
stokb001,Brian Stokes,New York Mets,METS,1,1,2,3,2010,2010,0,-0.59,-0.59,0.0,16,36,20,0,65,65,50.0,0.0,-50.0,0.0,0.0,0.0
stokt001,Troy Stokes,Pittsburgh Pirates,PIRATS,1,2,1,3,2021,2021,0,0.06,0.0,-0.06,26,0,-26,2,0,-2,55.0,0.0,-55.0,0.0,0.0,0.0
stona101,Arnie Stone,Pittsburgh Pirates,PIRATS,1,2,1,3,1924,1925,1,0.0,-0.02,-0.02,0,14,14,0,41,41,0.0,0.0,0.0,3600.0,0.0,-3600.0
stond102,Dean Stone,Washington Senators,TWINS,2,3,4,7,1957,1960,3,-2.93,-2.21,0.72,70,643,573,21,1367,1346,250.0,1860.0,1610.0,19500.0,0.0,-19500.0
stond102,Dean Stone,Boston Red Sox,RSOX,2,2,2,4,1959,1961,2,0.35,0.78,0.43,36,142,106,4,184,180,90.0,116.0,26.0,0.0,17000.0,17000.0
stond102,Dean Stone,Houston Astros,ASTROS,1,1,1,2,1962,1962,0,0.75,0.82,0.07,54,72,18,2,10,8,91.0,204.0,113.0,12500.0,0.0,-12500.0
stong101,George Stone,Boston Red Sox,RSOX,1,2,1,3,1904,1906,2,26.05,2.67,-23.38,846,148,-698,3645,654,-2991,0.0,0.0,0.0,0.0,4500.0,4500.0
stong102,George Stone,Atlanta Braves,BRAVES,2,3,3,6,1972,1978,6,10.9,-1.86,-12.76,922,458,-464,3059,568,-2491,1139.0,600.0,-539.0,0.0,42000.0,42000.0
stong102,George Stone,New York Mets,METS,1,1,1,2,1976,1976,0,0.0,0.0,0.0,0,0,0,0,0,0,0.0,0.0,0.0,0.0,0.0,0.0
stonj001,Jeff Stone,Philadelphia Phillies,PHILS,2,4,3,7,1988,1988,0,-2.46,0.71,3.17,165,85,-80,504,178,-326,0.0,49.0,49.0,395000.0,0.0,-395000.0
stonj102,John Stone,Detroit Tigers,TIGRS,1,1,1,2,1933,1937,4,15.44,9.25,-6.19,556,524,-32,2336,2216,-120,0.0,0.0,0.0,7000.0,11000.0,4000.0
stonr102,Ron Stone,Baltimore Orioles,ORLS,1,1,1,2,1969,1969,0,-3.37,0.83,4.2,362,37,-325,903,94,-809,0.0,0.0,0.0,0.0,0.0,0.0
stons101,Steve Stone,San Francisco Giants,GIANTS,1,2,1,3,1972,1976,4,13.25,-0.15,-13.4,475,156,-319,1568,147,-1421,1787.0,1201.0,-586.0,0.0,0.0,0.0
stons101,Steve Stone,Chicago White Sox,WSOX,1,4,1,5,1973,1973,0,6.5,0.0,-6.5,800,0,-800,1477,0,-1477,2061.0,0.0,-2061.0,32700.0,110000.0,77300.0
stooj001,Jim Stoops,San Francisco Giants,GIANTS,1,3,1,4,1998,2000,2,0.87,8.82,7.95,148,284,136,604,1104,500,12.0,0.0,-12.0,2750000.0,4900000.0,2150000.0
stora101,Alan Storke,Pittsburgh Pirates,PIRATS,3,9,6,15,1909,1915,6,20.39,14.17,-6.22,2165,858,-1307,7822,3752,-4070,942.0,0.0,-942.0,19200.0,16250.0,-2950.0
stora101,Alan Storke,St. Louis Cardinals,CARDS,1,2,3,5,1910,1914,4,0.92,4.47,3.55,70,779,709,75,3039,2964,641.0,470.0,-171.0,0.0,0.0,0.0
stord001,Drew Storen,Washington Nationals,NATEX,1,2,2,4,2016,2016,0,-0.54,-0.95,-0.41,42,103,61,0,375,375,100.0,0.0,-100.0,0.0,0.0,0.0
stord001,Drew Storen,Toronto Blue Jays,BJAYS,1,2,1,3,2016,2016,0,0.26,1.44,1.18,21,26,5,0,0,0,55.0,71.0,16.0,0.0,0.0,0.0
stotm001,Mel Stottlemyre,Houston Astros,ASTROS,1,1,1,2,1987,1987,0,0.04,-0.55,-0.59,13,18,5,0,25,25,94.0,0.0,-94.0,0.0,0.0,0.0
stott001,Todd Stottlemyre,Oakland Athletics,ATLTCS,3,3,7,10,1996,2000,4,8.36,-0.62,-8.98,237,137,-100,221,363,142,2452.0,153.0,-2299.0,0.0,475000.0,475000.0
stott001,Todd Stottlemyre,St. Louis Cardinals,CARDS,5,8,10,18,1998,2004,6,9.85,14.81,4.96,1166,1148,-18,3977,1495,-2482,740.0,2465.0,1725.0,14483333.0,16620281.0,2136948.0
stoua101,Allyn Stout,St. Louis Cardinals,CARDS,2,4,7,11,1933,1941,8,35.44,3.4,-32.04,1483,791,-692,3153,2855,-298,8479.0,390.0,-8089.0,10000.0,10000.0,0.0
stoua101,Allyn Stout,Cincinnati Reds,REDS,3,4,5,9,1934,1942,8,0.78,14.44,13.66,253,956,703,577,3608,3031,264.0,0.0,-264.0,23000.0,0.0,-23000.0
stovd001,DaRond Stovall,St. Louis Cardinals,CARDS,2,4,4,8,1995,1998,3,0.65,-1.89,-2.54,140,207,67,86,512,426,308.0,331.0,23.0,4525000.0,0.0,-4525000.0
stovg101,George Stovall,Cleveland Indians,INDINS,1,1,1,2,1912,1912,0,1.15,-0.67,-1.82,205,22,-183,743,14,-729,0.0,133.0,133.0,0.0,0.0,0.0
stovj101,Jesse Stovall,Cleveland Indians,INDINS,1,2,1,3,1904,1904,0,22.67,2.88,-19.79,462,138,-324,681,580,-101,5040.0,0.0,-5040.0,0.0,0.0,0.0
stpim001,Max St. Pierre,Kansas City Royals,ROYALS,1,1,1,2,2007,2008,1,0.0,0.0,0.0,0,0,0,0,0,0,0.0,0.0,0.0,0.0,0.0,0.0
straa102,Alan Strange,Hollywood,Hollywood,1,1,3,4,1933,1942,9,-1.79,0.0,1.79,294,0,-294,1022,0,-1022,0.0,0.0,0.0,0.0,5500.0,5500.0
straa102,Alan Strange,St.Louis Browns,ORLS,13,24,33,57,1935,1952,17,55.71,59.14,3.43,2756,6712,3956,8050,20700,12650,6789.0,12669.0,5880.0,132500.0,130100.0,-2400.0
strab101,Bob Strampe,Detroit Tigers,TIGRS,1,3,1,4,1974,1975,1,-0.19,-1.37,-1.18,91,45,-46,191,173,-18,0.0,0.0,0.0,79000.0,80000.0,1000.0
strac001,Chris Stratton,San Francisco Giants,GIANTS,1,1,1,2,2019,2019,0,-0.68,0.17,0.85,8,12,4,2,0,-2,88.0,20.0,-68.0,0.0,0.0,0.0
strad002,Doug Strange,Detroit Tigers,TIGRS,1,1,1,2,1990,1992,2,0.0,0.0,0.0,0,0,0,0,0,0,0.0,0.0,0.0,0.0,0.0,0.0
strad003,Dan Straily,Oakland Athletics,ATLTCS,2,6,6,12,2014,2020,6,10.93,24.37,13.44,708,1106,398,2216,4232,2016,860.0,540.0,-320.0,5345000.0,500000.0,-4845000.0
strad003,Dan Straily,Chicago Cubs,CUBS,1,2,1,3,2015,2016,1,4.82,6.42,1.6,226,281,55,835,1241,406,50.0,0.0,-50.0,0.0,0.0,0.0
strad003,Dan Straily,Houston Astros,ASTROS,1,1,1,2,2016,2016,0,0.0,-0.55,-0.55,0,15,15,0,30,30,0.0,3.0,3.0,0.0,0.0,0.0
strad003,Dan Straily,Cincinnati Reds,REDS,1,1,3,4,2017,2018,1,1.87,1.79,-0.08,112,137,25,107,38,-69,912.0,478.0,-434.0,0.0,0.0,0.0
straj101,Joe Strain,San Francisco Giants,GIANTS,5,7,8,15,1980,1986,6,-0.94,5.74,6.68,341,455,114,825,812,-13,372.0,2489.0,2117.0,552000.0,0.0,-552000.0
stram001,Matt Strahm,Kansas City Royals,ROYALS,2,7,5,12,2017,2021,4,3.49,-0.89,-4.38,348,169,-179,52,6,-46,1021.0,694.0,-327.0,538900.0,4194700.0,3655800.0
stram002,Myles Straw,Houston Astros,ASTROS,1,1,2,3,2021,2021,0,1.78,-0.24,-2.02,60,31,-29,268,0,-268,0.0,76.0,76.0,0.0,975000.0,975000.0
stram101,Mike Strahler,Los Angeles Dodgers,DOGRS,1,5,2,7,1972,1976,4,16.6,19.03,2.43,596,356,-240,1923,542,-1381,1810.0,2591.0,781.0,251500.0,115000.0,-136500.0
stram101,Mike Strahler,California Angels,ANGELS,1,1,1,2,1973,1975,2,0.46,0.22,-0.24,22,60,38,0,146,146,241.0,0.0,-241.0,0.0,0.0,0.0
stram101,Mike Strahler,Detroit Tigers,TIGRS,1,1,1,2,1973,1973,0,0.0,0.0,0.0,0,0,0,0,0,0,0.0,0.0,0.0,0.0,0.0,0.0
strap101,Paul Strand,SaltLakeCity,SaltLakeCity,2,2,5,7,1923,1924,1,-0.64,0.0,0.64,106,0,-106,374,0,-374,0.0,0.0,0.0,0.0,0.0,0.0
strap101,Paul Strand,Philadelphia Athletics,ATLTCS,1,3,1,4,1924,1927,3,0.0,4.07,4.07,0,425,425,0,1818,1818,0.0,0.0,0.0,12000.0,0.0,-12000.0
stras101,Scott Stratton,Louisville Colonels,LS3,1,1,1,2,1894,1900,6,0.41,0.13,-0.28,55,8,-47,136,37,-99,475.0,0.0,-475.0,0.0,0.0,0.0
stras102,Sammy Strang,Chicago Cubs,CUBS,1,3,1,4,1901,1902,1,10.49,-0.18,-10.67,648,75,-573,2353,299,-2054,0.0,0.0,0.0,0.0,0.0,0.0
streg101,Gabby Street,Washington Senators,TWINS,3,6,4,10,1912,1922,10,-0.55,4.17,4.72,29,440,411,95,1167,1072,0.0,0.0,0.0,4000.0,0.0,-4000.0
streh001,Huston Street,Oakland Athletics,ATLTCS,6,8,8,16,2008,2014,6,50.06,1.09,-48.97,2622,167,-2455,9256,628,-8628,794.0,101.0,-693.0,16800000.0,9919000.0,-6881000.0
streh001,Huston Street,Colorado Rockies,ROCKS,1,2,1,3,2011,2011,0,3.82,0.0,-3.82,253,0,-253,0,0,0,386.0,0.0,-386.0,7300000.0,0.0,-7300000.0
streh001,Huston Street,San Diego Padres,PADRS,3,5,8,13,2014,2019,5,2.1,2.53,0.43,243,302,59,4,1043,1039,1186.0,40.0,-1146.0,9925000.0,505000.0,-9420000.0
stric101,Cub Stricker,Cleveland Spiders,CL4,1,2,1,3,1891,1899,8,0.0,34.84,34.84,0,1004,1004,0,4749,4749,0.0,0.0,0.0,0.0,0.0,0.0
stric101,Cub Stricker,St. Louis Cardinals,CARDS,1,1,1,2,1892,1892,0,0.0,1.68,1.68,0,24,24,0,40,40,0.0,276.0,276.0,0.0,0.0,0.0
stric101,Cub Stricker,Pittsburgh Pirates,PIRATS,1,1,1,2,1892,1897,5,0.38,5.48,5.1,75,115,40,302,185,-117,0.0,1232.0,1232.0,0.0,0.0,0.0
strig102,George Strickland,Pittsburgh Pirates,PIRATS,1,2,3,5,1952,1952,0,6.5,-0.35,-6.85,756,19,-737,2451,60,-2391,46.0,0.0,-46.0,0.0,10000.0,10000.0
strih001,Hunter Strickland,Boston Red Sox,RSOX,3,4,4,8,2009,2010,1,0.8,1.92,1.12,204,165,-39,735,496,-239,0.0,3.0,3.0,0.0,9935000.0,9935000.0
strih001,Hunter Strickland,Seattle Mariners,MARNRS,1,2,3,5,2019,2020,1,-0.26,0.45,0.71,55,27,-28,1,0,-1,72.0,60.0,-12.0,2210000.0,0.0,-2210000.0
strij101,Joe Stripp,Cincinnati Reds,REDS,5,9,12,21,1932,1942,10,46.0,30.81,-15.19,3034,1950,-1084,10521,6810,-3711,2379.0,542.0,-1837.0,5500.0,0.0,-5500.0
strij101,Joe Stripp,Brooklyn Dodgers,DOGRS,1,4,1,5,1937,1944,7,1.9,1.11,-0.79,125,343,218,330,1190,860,390.0,0.0,-390.0,10000.0,10000.0,0.0
strij101,Joe Stripp,Boston Braves,BRAVES,1,1,1,2,1938,1940,2,0.0,0.42,0.42,0,46,46,0,8,8,0.0,114.0,114.0,0.0,0.0,0.0
strij102,Jake Striker,Cleveland Indians,INDINS,6,11,11,22,1959,1968,9,95.02,18.27,-76.75,3674,1436,-2238,12659,5344,-7315,4502.0,50.0,-4452.0,0.0,32000.0,32000.0
strij104,Jim Strickland,Minnesota Twins,TWINS,2,3,3,6,1973,1977,4,0.26,-0.78,-1.04,4,55,51,0,0,0,14.0,604.0,590.0,11000.0,0.0,-11000.0
strin101,Nick Strincevich,Boston Braves,BRAVES,2,2,2,4,1941,1946,5,8.45,1.67,-6.78,379,275,-104,431,177,-254,2222.0,1218.0,-1004.0,0.0,0.0,0.0
strir001,Ross Stripling,Los Angeles Dodgers,DOGRS,1,1,2,3,2020,2021,1,0.83,0.0,-0.83,32,0,-32,6,0,-6,351.0,0.0,-351.0,2100000.0,0.0,-2100000.0
stris001,Scott Strickland,Montreal Expos,NATEX,5,10,12,22,2002,2011,9,5.61,14.61,9.0,687,585,-102,161,612,451,1873.0,3946.0,2073.0,8655000.0,550000.0,-8105000.0
strob101,Brent Strom,New York Mets,METS,1,2,1,3,1972,1972,0,0.32,0.0,-0.32,27,0,-27,0,0,0,369.0,0.0,-369.0,6000.0,19000.0,13000.0
strob101,Brent Strom,Cleveland Indians,INDINS,1,2,1,3,1974,1974,0,1.74,-1.01,-2.75,126,11,-115,121,0,-121,1043.0,131.0,-912.0,0.0,0.0,0.0
stroe101,Ed Stroud,Chicago White Sox,WSOX,2,3,2,5,1967,1968,1,4.19,-0.43,-4.62,463,83,-380,1301,274,-1027,0.0,0.0,0.0,32500.0,0.0,-32500.0
stroe101,Ed Stroud,Washington Senators,RNGRS,5,8,5,13,1971,1977,6,-0.82,1.98,2.8,387,300,-87,987,715,-272,759.0,568.0,-191.0,0.0,21000.0,21000.0
stroj101,Jim Stroner,Wichita,Wichita,1,2,2,4,1928,1928,0,-0.01,0.0,0.01,6,0,-6,9,0,-9,0.0,0.0,0.0,0.0,0.0,0.0
strom001,Marcus Stroman,Toronto Blue Jays,BJAYS,2,4,3,7,2019,2021,2,4.89,1.43,-3.46,85,16,-69,81,2,-79,716.0,253.0,-463.0,7400000.0,6100000.0,-1300000.0
strop001,Pedro Strop,Texas Rangers,RNGRS,1,1,1,2,2011,2011,0,2.38,0.01,-2.37,116,7,-109,0,0,0,303.0,21.0,-282.0,416000.0,6000000.0,5584000.0
strop001,Pedro Strop,Baltimore Orioles,ORLS,2,4,4,8,2013,2019,6,26.47,2.52,-23.95,1116,493,-623,389,1879,1490,3793.0,272.0,-3521.0,514000.0,6900000.0,6386000.0
stros101,Steve Stroughter,Seattle Mariners,MARNRS,1,1,1,2,1980,1981,1,0.0,0.0,0.0,0,0,0,0,0,0,0.0,0.0,0.0,0.0,0.0,0.0
strua102,Amos Strunk,Philadelphia Athletics,ATLTCS,2,6,5,11,1917,1924,7,21.83,0.26,-21.57,730,281,-449,2197,867,-1330,2329.0,731.0,-1598.0,12000.0,0.0,-12000.0
strua102,Amos Strunk,Boston Red Sox,RSOX,14,27,32,59,1919,1937,18,90.7,63.54,-27.16,3925,3492,-433,10546,11886,1340,11819.0,5915.0,-5904.0,73300.0,64200.0,-9100.0
stryd101,Dutch Stryker,Boston Braves,BRAVES,15,35,27,62,1924,1952,28,61.82,121.75,59.93,3287,6434,3147,11058,21686,10628,3053.0,10767.0,7714.0,56700.0,31000.0,-25700.0
stuad101,Dick Stuart,Pittsburgh Pirates,PIRATS,2,3,3,6,1962,1967,5,1.35,11.96,10.61,573,824,251,1418,1789,371,1199.0,1482.0,283.0,30000.0,0.0,-30000.0
stuad101,Dick Stuart,Boston Red Sox,RSOX,3,3,4,7,1964,1974,10,0.01,5.43,5.42,189,323,134,646,116,-530,79.0,1344.0,1265.0,61000.0,47000.0,-14000.0
stuad101,Dick Stuart,Philadelphia Phillies,PHILS,1,1,3,4,1966,1968,2,-0.09,-0.11,-0.02,31,10,-21,96,19,-77,0.0,0.0,0.0,0.0,0.0,0.0
stual101,Luke Stuart,Richmond,Richmond,1,1,2,3,1921,1921,0,0.08,0.0,-0.08,3,0,-3,3,0,-3,0.0,0.0,0.0,0.0,0.0,0.0
stuam101,Marlin Stuart,Detroit Tigers,TIGRS,6,16,16,32,1952,1961,9,19.6,10.08,-9.52,1436,1371,-65,2274,3811,1537,4378.0,2214.0,-2164.0,23200.0,36000.0,12800.0
stubd001,Drew Stubbs,Cincinnati Reds,REDS,1,2,3,5,2012,2013,1,0.85,4.63,3.78,146,154,8,481,712,231,0.0,0.0,0.0,527500.0,5384000.0,4856500.0
stubd001,Drew Stubbs,Cleveland Indians,INDINS,2,2,2,4,2013,2014,1,2.39,0.36,-2.03,192,33,-159,538,0,-538,11.0,74.0,63.0,4075000.0,675000.0,-3400000.0
stubf001,Franklin Stubbs,Los Angeles Dodgers,DOGRS,1,1,1,2,1990,1990,0,2.79,-1.08,-3.87,146,10,-136,501,7,-494,0.0,62.0,62.0,0.0,0.0,0.0
stubg001,Garrett Stubbs,Houston Astros,ASTROS,1,1,1,2,2021,2021,0,0.0,0.0,0.0,0,0,0,0,0,0,0.0,0.0,0.0,0.0,0.0,0.0
stubm101,Moose Stubing,San Francisco Giants,GIANTS,1,1,1,2,1965,1965,0,0.0,0.0,0.0,0,0,0,0,0,0,0.0,0.0,0.0,0.0,0.0,0.0
stueg101,George Stueland,Chicago Cubs,CUBS,1,2,2,4,1923,1931,8,0.0,12.05,12.05,0,628,628,0,625,625,0.0,5104.0,5104.0,3400.0,0.0,-3400.0
stueg101,George Stueland,Chicago Cubs,CUBS,2,4,2,6,1925,1929,4,0.0,4.41,4.41,0,280,280,0,989,989,0.0,0.0,0.0,4000.0,0.0,-4000.0
stule001,Everett Stull,Montreal Expos,NATEX,2,2,2,4,1997,2002,5,0.0,-1.17,-1.17,0,186,186,0,49,49,0.0,614.0,614.0,220000.0,150000.0,-70000.0
stule002,Eric Stults,Atlanta Braves,BRAVES,6,15,9,24,2015,2021,6,3.56,2.51,-1.05,557,291,-266,805,489,-316,986.0,676.0,-310.0,21307500.0,11500000.0,-9807500.0
stumb101,Bill Stumpf,New York Yankees,YANKS,5,13,8,21,1913,1946,33,28.8,113.37,84.57,1052,3692,2640,1402,9991,8589,7730.0,15194.0,7464.0,42500.0,38450.0,-4050.0
stupj001,John Stuper,Pittsburgh Pirates,PIRATS,1,1,1,2,1979,1979,0,2.1,0.0,-2.1,156,0,-156,137,0,-137,1188.0,0.0,-1188.0,0.0,0.0,0.0
stupj001,John Stuper,St. Louis Cardinals,CARDS,2,3,4,7,1984,1984,0,-0.19,-0.22,-0.03,234,13,-221,556,14,-542,297.0,0.0,-297.0,0.0,200000.0,200000.0
stupj001,John Stuper,Cincinnati Reds,REDS,3,6,4,10,1985,1988,3,12.45,4.93,-7.52,892,228,-664,620,336,-284,4251.0,1549.0,-2702.0,1777500.0,937500.0,-840000.0
sturb101,Bobby Sturgeon,Chicago Cubs,CUBS,1,1,2,3,1948,1948,0,-0.28,-0.05,0.23,34,48,14,82,105,23,0.0,0.0,0.0,0.0,0.0,0.0
sturt001,Tanyon Sturtze,Chicago White Sox,WSOX,1,1,1,2,2000,2003,3,5.72,5.66,-0.06,98,291,193,13,881,868,1416.0,0.0,-1416.0,206000.0,270000.0,64000.0
sturt001,Tanyon Sturtze,Los Angeles Dodgers,DOGRS,1,1,1,2,2004,2005,1,0.61,0.01,-0.6,117,19,-98,3,25,22,498.0,0.0,-498.0,0.0,0.0,0.0
sturt101,Tom Sturdivant,New York Yankees,YANKS,3,7,5,12,1959,1966,7,10.26,14.71,4.45,1028,1524,496,3254,3264,10,1701.0,4103.0,2402.0,84000.0,27500.0,-56500.0
sturt101,Tom Sturdivant,Kansas City Athletics,ATLTCS,1,1,1,2,1959,1960,1,0.22,0.26,0.04,80,73,-7,24,243,219,304.0,0.0,-304.0,0.0,0.0,0.0
sturt101,Tom Sturdivant,Washington Senators,RNGRS,1,1,1,2,1961,1961,0,3.47,-0.88,-4.35,130,23,-107,73,9,-64,658.0,89.0,-569.0,0.0,0.0,0.0
styll101,Lena Styles,Philadelphia Athletics,ATLTCS,1,1,1,2,1921,1922,1,0.0,-1.06,-1.06,0,44,44,0,20,20,0.0,205.0,205.0,0.0,0.0,0.0
stync001,Chris Stynes,Toronto Blue Jays,BJAYS,2,4,4,8,1995,1997,2,19.63,3.81,-15.82,207,44,-163,147,0,-147,2766.0,687.0,-2079.0,8000000.0,0.0,-8000000.0
stync001,Chris Stynes,Kansas City Royals,ROYALS,1,2,2,4,1997,1999,2,7.45,1.22,-6.23,503,193,-310,1598,1,-1597,0.0,629.0,629.0,0.0,0.0,0.0
stync001,Chris Stynes,Cincinnati Reds,REDS,4,5,6,11,2000,2013,13,-0.14,18.69,18.83,362,872,510,1099,1605,506,0.0,5071.0,5071.0,600000.0,0.0,-600000.0
suare001,Eugenio Suarez,Detroit Tigers,TIGRS,1,2,1,3,2014,2015,1,13.23,-0.51,-13.74,916,33,-883,3730,5,-3725,0.0,561.0,561.0,0.0,1500000.0,1500000.0
suark101,Ken Suarez,Cleveland Indians,INDINS,6,11,10,21,1971,1978,7,26.06,8.28,-17.78,1542,586,-956,3690,1786,-1904,2427.0,1183.0,-1244.0,83000.0,120000.0,37000.0
suark101,Ken Suarez,Texas Rangers,RNGRS,1,1,1,2,1974,1976,2,0.0,1.26,1.26,0,89,89,0,214,214,0.0,0.0,0.0,0.0,0.0,0.0
suark101,Ken Suarez,Cleveland Indians,INDINS,1,3,1,4,1974,1974,0,0.32,-0.11,-0.43,178,15,-163,399,61,-338,0.0,0.0,0.0,19750.0,160000.0,140250.0
suchj101,Jim Suchecki,Boston Red Sox,RSOX,3,7,4,11,1951,1954,3,1.03,-2.94,-3.97,539,149,-390,1347,410,-937,675.0,0.0,-675.0,8500.0,0.0,-8500.0
sucrj001,Jesus Sucre,Seattle Mariners,MARNRS,1,1,1,2,2017,2017,0,-0.19,0.0,0.19,138,0,-138,390,0,-390,6.0,0.0,-6.0,0.0,0.0,0.0
sudab101,Bill Sudakis,New York Mets,METS,1,1,1,2,1973,1973,0,1.38,0.0,-1.38,82,0,-82,263,0,-263,0.0,0.0,0.0,0.0,0.0,0.0
sudab101,Bill Sudakis,New York Yankees,YANKS,1,1,1,2,1974,1975,1,-0.55,0.0,0.55,30,0,-30,73,0,-73,0.0,0.0,0.0,30000.0,20000.0,-10000.0
sudhw101,Willie Sudhoff,St.Louis Browns,ORLS,2,3,2,5,1905,1907,2,-1.49,0.53,2.02,22,110,88,7,131,124,66.0,1108.0,1042.0,0.0,0.0,0.0
suerw001,William Suero,Toronto Blue Jays,BJAYS,1,2,1,3,1991,1992,1,-0.04,3.8,3.84,33,189,156,34,768,734,0.0,0.0,0.0,0.0,875000.0,875000.0
sugdj101,Joe Sugden,Pittsburgh Pirates,PIRATS,1,1,1,2,1897,1898,1,0.64,-0.06,-0.7,89,5,-84,320,18,-302,0.0,0.0,0.0,0.0,0.0,0.0
sugdj101,Joe Sugden,Chicago White Sox,WSOX,1,1,1,2,1902,1902,0,4.95,3.2,-1.75,343,46,-297,1204,62,-1142,3.0,526.0,523.0,0.0,0.0,0.0
suggg101,George Suggs,Detroit Tigers,TIGRS,1,3,1,4,1909,1909,0,0.0,-0.16,-0.16,0,8,8,0,8,8,0.0,60.0,60.0,0.0,0.0,0.0
suhrg101,Gus Suhr,Pittsburgh Pirates,PIRATS,1,1,1,2,1939,1946,7,1.65,14.95,13.3,70,406,336,265,430,165,0.0,3506.0,3506.0,8000.0,0.0,-8000.0
suhrg101,Gus Suhr,Brooklyn Dodgers,DOGRS,1,3,1,4,1941,1946,5,0.0,0.04,0.04,0,2,2,0,5,5,0.0,0.0,0.0,0.0,0.0,0.0
sukec101,Clyde Sukeforth,Cincinnati Reds,REDS,5,9,12,21,1932,1942,10,46.0,30.81,-15.19,3034,1950,-1084,10521,6810,-3711,2379.0,542.0,-1837.0,5500.0,0.0,-5500.0
sullb102,Billy Sullivan,GrandRapids,GrandRapids,1,1,1,2,1899,1899,0,0.37,0.0,-0.37,94,0,-94,329,0,-329,0.0,0.0,0.0,0.0,0.0,0.0
sullb103,Billy Sullivan,Chicago White Sox,WSOX,1,3,1,4,1934,1934,0,0.0,0.0,0.0,0,0,0,0,0,0,0.0,0.0,0.0,2700.0,0.0,-2700.0
sullb103,Billy Sullivan,Cleveland Indians,INDINS,1,3,1,4,1938,1941,3,1.14,1.94,0.8,388,390,2,935,1415,480,285.0,0.0,-285.0,0.0,0.0,0.0
sullb103,Billy Sullivan,St.Louis Browns,ORLS,1,1,1,2,1940,1940,0,2.31,-0.71,-3.02,163,63,-100,525,18,-507,0.0,224.0,224.0,0.0,0.0,0.0
sullf101,Frank Sullivan,Boston Red Sox,RSOX,1,1,1,2,1960,1964,4,-0.05,3.74,3.79,136,152,16,41,188,147,547.0,1447.0,900.0,0.0,0.0,0.0
sullh101,Haywood Sullivan,Washington Senators,RNGRS,1,1,2,3,1960,1960,0,-0.08,0.0,0.08,252,0,-252,823,0,-823,0.0,0.0,0.0,0.0,0.0,0.0
sullj101,Joe Sullivan,Philadelphia Phillies,PHILS,1,3,1,4,1896,1900,4,-0.5,6.22,6.72,240,440,200,1079,2080,1001,0.0,0.0,0.0,0.0,0.0,0.0
sullj103,John Sullivan,Philadelphia Phillies,PHILS,1,2,1,3,1969,1969,0,0.0,-0.07,-0.07,0,13,13,0,14,14,0.0,0.0,0.0,0.0,0.0,0.0
sullj103,John Sullivan,New York Mets,METS,1,2,1,3,1968,1969,1,0.12,0.0,-0.12,12,0,-12,20,0,-20,0.0,0.0,0.0,0.0,0.0,0.0
sullj104,John Sullivan,Washington Senators,TWINS,19,34,35,69,1948,1963,15,46.33,1.08,-45.25,3341,4737,1396,11069,13056,1987,1598.0,4683.0,3085.0,53500.0,14000.0,-39500.0
sullj105,John Sullivan,Chicago Cubs,CUBS,2,8,5,13,1921,1926,5,29.39,11.6,-17.79,1120,351,-769,4097,694,-3403,1929.0,2961.0,1032.0,13500.0,18700.0,5200.0
sullj108,Jim Sullivan,Baltimore,Baltimore,1,1,1,2,1921,1931,10,-1.06,0.0,1.06,44,0,-44,20,0,-20,205.0,0.0,-205.0,0.0,0.0,0.0
sullm001,Marc Sullivan,Boston Red Sox,RSOX,1,1,1,2,1987,1987,0,0.0,0.0,0.0,0,0,0,0,0,0,0.0,0.0,0.0,150000.0,0.0,-150000.0
sullm101,Mike Sullivan,Cincinnati Reds,REDS,3,6,3,9,1893,1898,5,6.54,9.57,3.03,667,550,-117,2741,2351,-390,620.0,786.0,166.0,0.0,0.0,0.0
sulls001,Scott Sullivan,Cincinnati Reds,REDS,1,1,2,3,2003,2004,1,0.3,-1.28,-1.58,15,82,67,0,219,219,43.0,0.0,-43.0,2800000.0,0.0,-2800000.0
sulsc001,Cole Sulser,Cleveland Indians,INDINS,2,5,4,9,2018,2021,3,4.35,4.54,0.19,327,378,51,1228,1477,249,22.0,0.0,-22.0,18667000.0,0.0,-18667000.0
summc001,Champ Summers,Oakland Athletics,ATLTCS,2,3,2,5,1975,1978,3,-2.31,4.93,7.24,199,165,-34,247,0,-247,92.0,1056.0,964.0,0.0,0.0,0.0
summc001,Champ Summers,Chicago Cubs,CUBS,1,1,1,2,1977,1977,0,-0.12,0.0,0.12,99,0,-99,200,0,-200,0.0,0.0,0.0,0.0,0.0,0.0
summc001,Champ Summers,Cincinnati Reds,REDS,1,1,1,2,1979,1979,0,4.41,0.0,-4.41,274,0,-274,887,0,-887,0.0,0.0,0.0,0.0,0.0,0.0
summc001,Champ Summers,Detroit Tigers,TIGRS,1,1,2,3,1982,1983,1,-0.11,3.01,3.12,99,246,147,177,904,727,0.0,0.0,0.0,0.0,0.0,0.0
summc001,Champ Summers,San Francisco Giants,GIANTS,1,1,2,3,1983,1984,1,-0.1,-0.3,-0.2,47,17,-30,59,23,-36,0.0,0.0,0.0,0.0,0.0,0.0
summh101,Homer Summa,Philadelphia Athletics,ATLTCS,1,2,1,3,1930,1930,0,0.0,0.0,0.0,0,0,0,0,0,0,0.0,0.0,0.0,0.0,0.0,0.0
sundb101,Billy Sunday,Pittsburgh Pirates,PIRATS,1,1,3,4,1890,1892,2,0.47,-0.87,-1.34,31,43,12,139,162,23,0.0,150.0,150.0,0.0,0.0,0.0
sundj001,Jim Sundberg,Texas Rangers,RNGRS,1,1,2,3,1983,1985,2,3.15,-2.36,-5.51,110,80,-30,395,251,-144,0.0,0.0,0.0,0.0,0.0,0.0
sundj001,Jim Sundberg,Milwaukee Brewers,BREWRS,3,4,6,10,1985,1991,6,23.75,18.35,-5.4,1450,817,-633,1291,1958,667,4939.0,4297.0,-642.0,700000.0,325000.0,-375000.0
sundj001,Jim Sundberg,Kansas City Royals,ROYALS,1,1,2,3,1987,1988,1,0.52,-0.74,-1.26,85,103,18,227,176,-51,0.0,58.0,58.0,0.0,0.0,0.0
sunds101,Steve Sundra,Cleveland Indians,INDINS,1,2,1,3,1935,1940,5,14.33,18.91,4.58,396,307,-89,481,384,-97,3424.0,2789.0,-635.0,0.0,0.0,0.0
sunds101,Steve Sundra,Washington Senators,TWINS,1,2,2,4,1942,1942,0,6.64,0.79,-5.85,330,98,-232,878,296,-582,1025.0,122.0,-903.0,7250.0,7500.0,250.0
sunkt101,Tom Sunkel,St. Louis Cardinals,CARDS,1,1,2,3,1941,1943,2,-0.27,0.0,0.27,44,0,-44,25,0,-25,245.0,0.0,-245.0,0.0,0.0,0.0
suppj001,Jeff Suppan,Pittsburgh Pirates,PIRATS,5,8,9,17,2003,2013,10,4.43,21.03,16.6,571,1401,830,955,4379,3424,773.0,467.0,-306.0,13800000.0,0.0,-13800000.0
surhb001,B.J. Surhoff,Baltimore Orioles,ORLS,1,2,3,5,2000,2002,2,1.16,-0.42,-1.58,214,107,-107,759,224,-535,6.0,2.0,-4.0,4146789.0,800000.0,-3346789.0
surhr001,Rich Surhoff,Philadelphia Phillies,PHILS,1,1,1,2,1985,1986,1,-0.28,-0.22,0.06,7,24,17,0,0,0,25.0,50.0,25.0,0.0,505000.0,505000.0
surhr001,Rich Surhoff,Texas Rangers,RNGRS,1,2,1,3,1986,1987,1,0.0,-0.29,-0.29,0,16,16,0,0,0,0.0,71.0,71.0,0.0,0.0,0.0
surke001,Eric Surkamp,Chicago White Sox,WSOX,1,1,1,2,2015,2015,0,-0.2,0.0,0.2,2,0,-2,1,0,-1,10.0,0.0,-10.0,0.0,0.0,0.0
surkm101,Max Surkont,Chicago White Sox,WSOX,1,1,1,2,1950,1951,1,8.31,0.0,-8.31,210,0,-210,251,0,-251,2034.0,0.0,-2034.0,0.0,0.0,0.0
surkm101,Max Surkont,Milwaukee Braves,BRAVES,2,10,2,12,1953,1960,7,8.19,12.74,4.55,794,729,-65,1824,3040,1216,2135.0,0.0,-2135.0,0.0,42000.0,42000.0
surkm101,Max Surkont,Pittsburgh Pirates,PIRATS,2,2,2,4,1956,1958,2,-0.44,-0.66,-0.22,30,146,116,3,40,37,58.0,478.0,420.0,0.0,0.0,0.0
susaa001,Andrew Susac,San Francisco Giants,GIANTS,1,2,1,3,2016,2019,3,-0.35,3.53,3.88,20,278,258,31,2,-29,6.0,410.0,404.0,0.0,0.0,0.0
susaa001,Andrew Susac,Milwaukee Brewers,BREWRS,1,1,1,2,2018,2018,0,-0.33,0.0,0.33,9,0,-9,26,0,-26,0.0,0.0,0.0,0.0,0.0,0.0
sutcr001,Rick Sutcliffe,Los Angeles Dodgers,DOGRS,4,5,6,11,1981,1986,5,8.2,1.95,-6.25,273,439,166,478,515,37,1699.0,432.0,-1267.0,1085000.0,435000.0,-650000.0
sutcr001,Rick Sutcliffe,Cleveland Indians,INDINS,13,23,29,52,1984,2001,17,109.74,66.95,-42.79,6226,4765,-1461,18678,17797,-881,7708.0,2241.0,-5467.0,19613332.0,19125000.0,-488332.0
suthg101,Gary Sutherland,Montreal Expos,NATEX,1,1,2,3,1972,1972,0,-0.3,0.0,0.3,21,0,-21,66,0,-66,0.0,0.0,0.0,0.0,0.0,0.0
suthg101,Gary Sutherland,Houston Astros,ASTROS,1,2,2,4,1973,1975,2,0.24,-0.75,-0.99,348,138,-210,1336,4,-1332,157.0,233.0,76.0,66000.0,32000.0,-34000.0
suthg101,Gary Sutherland,Detroit Tigers,TIGRS,1,1,1,2,1976,1976,0,-0.89,-1.04,-0.15,59,77,18,130,245,115,0.0,0.0,0.0,0.0,0.0,0.0
suths101,Suds Sutherland,Detroit Tigers,TIGRS,1,9,2,11,1921,1941,20,0.0,3.03,3.03,0,202,202,0,144,144,0.0,1168.0,1168.0,3000.0,0.0,-3000.0
suttb001,Bruce Sutter,Chicago Cubs,CUBS,3,3,6,9,1980,1989,9,5.77,17.19,11.42,519,1190,671,95,4076,3981,1190.0,412.0,-778.0,2083333.0,132500.0,-1950833.0
suttd001,Don Sutton,Houston Astros,ASTROS,2,2,5,7,1982,1989,7,6.15,15.11,8.96,395,1557,1162,15,3653,3638,2094.0,1456.0,-638.0,1105000.0,490000.0,-615000.0
suttd001,Don Sutton,Milwaukee Brewers,BREWRS,1,1,3,4,1984,1986,2,2.63,1.47,-1.16,29,29,0,0,0,0,583.0,511.0,-72.0,625000.0,600000.0,-25000.0
suttd001,Don Sutton,Oakland Athletics,ATLTCS,1,1,2,3,1985,1985,0,4.61,0.0,-4.61,74,0,-74,0,0,0,1291.0,0.0,-1291.0,0.0,0.0,0.0
suttd002,Drew Sutton,Houston Astros,ASTROS,2,2,3,5,2009,2012,3,-0.72,0.76,1.48,100,307,207,309,1107,798,0.0,160.0,160.0,2300000.0,0.0,-2300000.0
suttj101,John Sutton,Texas Rangers,RNGRS,1,1,1,2,1976,1976,0,0.2,0.0,-0.2,28,0,-28,1,0,-1,73.0,0.0,-73.0,0.0,0.0,0.0
suttl001,Larry Sutton,St. Louis Cardinals,CARDS,1,1,1,2,2001,2001,0,0.0,0.0,0.0,0,0,0,0,0,0,0.0,0.0,0.0,305000.0,0.0,-305000.0
suzui001,Ichiro Suzuki,Seattle Mariners,MARNRS,5,8,8,16,2012,2017,5,12.61,3.47,-9.14,1452,363,-1089,5137,584,-4553,347.0,816.0,469.0,27679600.0,5022800.0,-22656800.0
suzuk001,Kurt Suzuki,Oakland Athletics,ATLTCS,2,4,2,6,2012,2014,2,0.75,-1.33,-2.08,243,41,-202,896,1,-895,0.0,121.0,121.0,0.0,6500000.0,6500000.0
suzuk001,Kurt Suzuki,Washington Nationals,NATEX,1,1,1,2,2013,2021,8,0.33,-0.13,-0.46,15,11,-4,35,0,-35,0.0,34.0,34.0,0.0,0.0,0.0
suzum001,Mac Suzuki,Seattle Mariners,MARNRS,1,2,2,4,1999,1999,0,0.0,-0.48,-0.48,0,3,3,0,0,0,0.0,9.0,9.0,212000.0,750000.0,538000.0
suzum001,Mac Suzuki,Kansas City Royals,ROYALS,1,2,1,3,2001,2003,2,-0.28,-0.5,-0.22,31,265,234,74,964,890,19.0,0.0,-19.0,320000.0,2150000.0,1830000.0
sveud001,Dale Sveum,Milwaukee Brewers,BREWRS,1,1,1,2,1991,1992,1,-1.04,-1.17,-0.13,54,25,-29,153,0,-153,0.0,174.0,174.0,0.0,0.0,0.0
sveud001,Dale Sveum,Philadelphia Phillies,PHILS,1,1,1,2,1992,1992,0,0.16,0.02,-0.14,40,24,-16,131,0,-131,0.0,66.0,66.0,375000.0,0.0,-375000.0
swand001,Dansby Swanson,Arizona Diamondbacks,DBACKS,2,5,3,8,2015,2018,3,16.27,-1.52,-17.79,1329,142,-1187,5122,368,-4754,281.0,417.0,136.0,513000.0,535000.0,22000.0
swane001,Erik Swanson,Texas Rangers,RNGRS,1,3,1,4,2016,2016,0,0.0,0.27,0.27,0,52,52,0,206,206,0.0,0.0,0.0,0.0,0.0,0.0
swane001,Erik Swanson,New York Yankees,YANKS,1,3,1,4,2018,2020,2,-1.57,1.84,3.41,118,37,-81,6,8,2,818.0,513.0,-305.0,0.0,4900000.0,4900000.0
swane101,Evar Swanson,St. Louis Cardinals,CARDS,1,1,2,3,1932,1936,4,5.38,1.87,-3.51,275,283,8,1205,1288,83,0.0,0.0,0.0,0.0,5000.0,5000.0
swanr001,Russ Swan,San Francisco Giants,GIANTS,1,1,1,2,1990,1990,0,0.74,0.0,-0.74,152,0,-152,0,0,0,749.0,0.0,-749.0,100000.0,0.0,-100000.0
swans101,Stan Swanson,Cincinnati Reds,REDS,3,3,3,6,1971,1972,1,0.08,0.0,-0.08,60,0,-60,129,0,-129,0.0,0.0,0.0,0.0,9500.0,9500.0
swara001,Anthony Swarzak,Chicago White Sox,WSOX,1,1,1,2,2017,2019,2,0.9,-1.3,-2.2,56,116,60,0,287,287,87.0,0.0,-87.0,900000.0,0.0,-900000.0
swara001,Anthony Swarzak,New York Mets,METS,1,5,3,8,2018,2018,0,-0.49,0.0,0.49,191,0,-191,565,0,-565,376.0,0.0,-376.0,16500000.0,12258065.0,-4241935.0
swara001,Anthony Swarzak,Seattle Mariners,MARNRS,1,2,2,4,2019,2019,0,0.41,-0.53,-0.94,85,11,-74,0,0,0,119.0,33.0,-86.0,8500000.0,5375000.0,-3125000.0
swarm101,Monty Swartz,Cincinnati Reds,REDS,1,3,1,4,1921,1926,5,0.0,8.24,8.24,0,602,602,0,2409,2409,0.0,0.0,0.0,0.0,0.0,0.0
sweeb001,Brian Sweeney,Seattle Mariners,MARNRS,2,4,5,9,2004,2008,4,-0.53,1.64,2.17,147,104,-43,117,144,27,212.0,123.0,-89.0,750000.0,0.0,-750000.0
sweeb101,Bill Sweeney,Detroit Tigers,TIGRS,2,5,3,8,1928,1933,5,12.96,10.92,-2.04,710,561,-149,2975,2358,-617,0.0,0.0,0.0,21000.0,7000.0,-14000.0
sweeb102,Bill Sweeney,Chicago Cubs,CUBS,1,2,1,3,1907,1907,0,11.38,-0.4,-11.78,977,51,-926,4014,159,-3855,0.0,0.0,0.0,0.0,0.0,0.0
sweeb102,Bill Sweeney,Boston Braves,BRAVES,1,2,1,3,1914,1917,3,1.39,7.06,5.67,134,317,183,540,1353,813,0.0,0.0,0.0,0.0,0.0,0.0
sweed001,Darnell Sweeney,Los Angeles Dodgers,DOGRS,1,2,2,4,2015,2018,3,-0.34,2.52,2.86,37,386,349,98,1246,1148,0.0,0.0,0.0,0.0,0.0,0.0
sweed001,Darnell Sweeney,Philadelphia Phillies,PHILS,3,5,5,10,2016,2018,2,3.05,1.06,-1.99,238,68,-170,808,210,-598,0.0,0.0,0.0,10527000.0,13400000.0,2873000.0
sweem001,Mark Sweeney,California Angels,ANGELS,1,1,1,2,1995,1995,0,-0.25,0.36,0.61,179,28,-151,372,0,-372,0.0,98.0,98.0,0.0,600000.0,600000.0
sweem001,Mark Sweeney,St. Louis Cardinals,CARDS,1,3,3,6,1997,1997,0,-0.21,-1.09,-0.88,425,93,-332,688,180,-508,185.0,68.0,-117.0,4942500.0,2250000.0,-2692500.0
sweem001,Mark Sweeney,San Diego Padres,PADRS,3,7,8,15,1999,2006,7,6.95,24.07,17.12,734,1502,768,2481,5933,3452,0.0,4.0,4.0,8651680.0,7650000.0,-1001680.0
sweem001,Mark Sweeney,Cincinnati Reds,REDS,3,4,5,9,2000,2004,4,0.58,5.78,5.2,321,456,135,1051,1700,649,0.0,0.0,0.0,3650000.0,1050000.0,-2600000.0
sweem001,Mark Sweeney,Milwaukee Brewers,BREWRS,2,7,6,13,2002,2004,2,1.18,1.8,0.62,314,393,79,929,661,-268,437.0,1049.0,612.0,2750000.0,500000.0,-2250000.0
sweem001,Mark Sweeney,San Francisco Giants,GIANTS,1,1,1,2,2007,2008,1,-1.0,0.11,1.11,128,24,-104,142,42,-100,0.0,0.0,0.0,900000.0,0.0,-900000.0
sweer001,Ryan Sweeney,Chicago White Sox,WSOX,2,5,4,9,2008,2011,3,24.92,-0.88,-25.8,1177,181,-996,4107,638,-3469,1718.0,20.0,-1698.0,3600000.0,1165000.0,-2435000.0
sweer001,Ryan Sweeney,Oakland Athletics,ATLTCS,2,4,6,10,2011,2019,8,6.28,16.11,9.83,292,639,347,512,2366,1854,1216.0,614.0,-602.0,1865000.0,0.0,-1865000.0
swifb001,Bill Swift,Seattle Mariners,MARNRS,2,4,3,7,1991,1993,2,19.75,1.34,-18.41,1114,134,-980,1118,402,-716,2994.0,104.0,-2890.0,5400000.0,4950000.0,-450000.0
swifb101,Bill Swift,KansasCity,KansasCity,1,1,2,3,1932,1935,3,21.31,0.0,-21.31,610,0,-610,603,0,-603,4663.0,0.0,-4663.0,0.0,0.0,0.0
swifb101,Bill Swift,Pittsburgh Pirates,PIRATS,1,2,1,3,1939,1940,1,-0.39,0.77,1.16,8,70,62,3,29,26,28.0,274.0,246.0,7000.0,10000.0,3000.0
swifb101,Bill Swift,Chicago White Sox,WSOX,1,3,1,4,1943,1943,0,0.0,0.0,0.0,0,0,0,0,0,0,0.0,0.0,0.0,8600.0,0.0,-8600.0
swifb102,Bob Swift,New York Yankees,YANKS,1,2,1,3,1937,1937,0,-1.38,0.0,1.38,222,0,-222,709,0,-709,0.0,0.0,0.0,0.0,0.0,0.0
swifb102,Bob Swift,St.Louis Browns,ORLS,3,4,5,9,1942,1952,10,5.24,7.57,2.33,522,583,61,1337,761,-576,901.0,2542.0,1641.0,21000.0,7000.0,-14000.0
swifb102,Bob Swift,Philadelphia Athletics,ATLTCS,1,2,1,3,1943,1946,3,0.19,0.0,-0.19,648,0,-648,1982,0,-1982,0.0,0.0,0.0,6000.0,7000.0,1000.0
swihb001,Blake Swihart,Boston Red Sox,RSOX,1,2,1,3,2019,2019,0,-0.94,0.0,0.94,31,0,-31,70,0,-70,0.0,0.0,0.0,910000.0,0.0,-910000.0
swing001,Greg Swindell,Cleveland Indians,INDINS,1,1,3,4,1991,1993,2,4.96,-2.2,-7.16,62,60,-2,87,0,-87,641.0,839.0,198.0,2025000.0,215000.0,-1810000.0
swing001,Greg Swindell,Minnesota Twins,TWINS,2,4,5,9,1998,2002,4,-0.39,0.81,1.2,167,43,-124,84,66,-18,831.0,325.0,-506.0,2100000.0,0.0,-2100000.0
swisn001,Nick Swisher,Oakland Athletics,ATLTCS,17,32,32,64,2008,2019,11,47.93,48.81,0.88,3102,2736,-366,6703,7885,1182,8838.0,5246.0,-3592.0,12082501.0,5500000.0,-6582501.0
swisn001,Nick Swisher,Chicago White Sox,WSOX,1,2,3,5,2008,2011,3,11.97,-0.72,-12.69,599,28,-571,2501,50,-2451,3.0,20.0,17.0,3600000.0,1165000.0,-2435000.0
swisn001,Nick Swisher,Cleveland Indians,INDINS,1,3,1,4,2015,2015,0,-0.91,-0.23,0.68,92,27,-65,305,93,-212,0.0,0.0,0.0,0.0,0.0,0.0
swiss101,Steve Swisher,Chicago White Sox,WSOX,1,4,1,5,1973,1973,0,6.5,0.0,-6.5,800,0,-800,1477,0,-1477,2061.0,0.0,-2061.0,32700.0,110000.0,77300.0
swiss101,Steve Swisher,Chicago Cubs,CUBS,12,22,23,45,1977,1990,13,19.55,19.15,-0.4,3026,1816,-1210,7924,3345,-4579,1137.0,4804.0,3667.0,1020000.0,140000.0,-880000.0
swiss101,Steve Swisher,St. Louis Cardinals,CARDS,9,26,18,44,1980,1992,12,83.63,101.91,18.28,6733,4351,-2382,20851,14642,-6209,6532.0,3025.0,-3507.0,1533333.0,576667.0,-956666.0
swobr101,Ron Swoboda,New York Mets,METS,7,11,11,22,1971,1984,13,10.8,20.91,10.11,1517,1503,-14,1460,5043,3583,2280.0,196.0,-2084.0,90000.0,0.0,-90000.0
swobr101,Ron Swoboda,Montreal Expos,NATEX,1,1,1,2,1971,1971,0,0.28,1.09,0.81,152,51,-101,350,159,-191,0.0,0.0,0.0,0.0,16000.0,16000.0
sykeb101,Bob Sykes,Detroit Tigers,TIGRS,2,4,3,7,1978,1985,7,-2.68,10.4,13.08,239,743,504,342,1333,991,691.0,2139.0,1448.0,0.0,200000.0,200000.0
sykeb101,Bob Sykes,St. Louis Cardinals,CARDS,3,4,6,10,1981,1994,13,1.02,39.1,38.08,307,1804,1497,1154,7358,6204,0.0,0.0,0.0,1500000.0,102500.0,-1397500.0
syndn001,Noah Syndergaard,Toronto Blue Jays,BJAYS,1,4,3,7,2012,2016,4,18.37,4.87,-13.5,742,311,-431,2152,493,-1659,2154.0,2473.0,319.0,0.0,5229800.0,5229800.0
szczm001,Matt Szczur,Chicago Cubs,CUBS,1,1,1,2,2017,2018,1,0.03,0.32,0.29,161,20,-141,298,2,-296,0.0,37.0,37.0,0.0,0.0,0.0
szumj001,Jason Szuminski,Kansas City Royals,ROYALS,1,2,1,3,2003,2004,1,-0.25,0.05,0.3,14,6,-8,1,1,0,30.0,0.0,-30.0,0.0,0.0,0.0
tabaj001,Jeff Tabaka,San Diego Padres,PADRS,1,2,1,3,1995,1995,0,-0.01,0.15,0.16,84,54,-30,3,165,162,134.0,0.0,-134.0,140000.0,2000000.0,1860000.0
tabaj002,Jose Tabata,New York Yankees,YANKS,1,4,2,6,2008,2011,3,7.23,0.52,-6.71,1088,146,-942,2084,276,-1808,3210.0,148.0,-3062.0,391425.0,5500000.0,5108575.0
tabaj002,Jose Tabata,Pittsburgh Pirates,PIRATS,1,1,2,3,2015,2016,1,0.0,-0.21,-0.21,0,51,51,0,90,90,0.0,0.0,0.0,4000000.0,0.0,-4000000.0
tabel101,Lefty Taber,Philadelphia Phillies,PHILS,1,3,1,4,1928,1928,0,0.0,1.31,1.31,0,96,96,0,292,292,0.0,0.0,0.0,0.0,0.0,0.0
tablp001,Pat Tabler,New York Yankees,YANKS,7,14,14,28,1981,1993,12,67.75,44.14,-23.61,3137,1398,-1739,9400,3277,-6123,6684.0,5010.0,-1674.0,2477500.0,2887766.0,410266.0
tablp001,Pat Tabler,Chicago Cubs,CUBS,3,6,6,12,1983,1990,7,9.95,11.91,1.96,748,630,-118,2292,307,-1985,429.0,3028.0,2599.0,890000.0,85000.0,-805000.0
tablp001,Pat Tabler,Chicago White Sox,WSOX,1,1,1,2,1983,1985,2,7.4,0.49,-6.91,707,221,-486,2753,442,-2311,0.0,0.0,0.0,0.0,0.0,0.0
tablp001,Pat Tabler,Cleveland Indians,INDINS,19,25,31,56,1988,2020,32,31.66,118.21,86.55,3541,3433,-108,10779,9199,-1580,4030.0,10939.0,6909.0,46229400.0,16426500.0,-29802900.0
tablp001,Pat Tabler,Kansas City Royals,ROYALS,2,3,3,6,1990,1998,8,4.8,3.63,-1.17,369,159,-210,1163,0,-1163,0.0,1998.0,1998.0,725000.0,293000.0,-432000.0
tabog001,Greg Tabor,Texas Rangers,RNGRS,1,2,1,3,1988,1988,0,-0.02,-0.74,-0.72,2,12,10,5,0,-5,0.0,188.0,188.0,0.0,0.0,0.0
tadak001,Kazuhito Tadano,Cleveland Indians,INDINS,1,1,1,2,2006,2006,0,0.0,0.0,0.0,0,0,0,0,0,0,0.0,0.0,0.0,0.0,0.0,0.0
tailj001,Jameson Taillon,Pittsburgh Pirates,PIRATS,1,1,4,5,2021,2021,0,2.23,-0.2,-2.43,31,9,-22,2,3,1,433.0,54.0,-379.0,0.0,0.0,0.0
taitd101,Doug Taitt,Boston Red Sox,RSOX,4,5,5,10,1929,1936,7,-0.03,21.89,21.92,236,1145,909,851,4811,3960,0.0,0.0,0.0,35000.0,32000.0,-3000.0
talbf101,Fred Talbot,Chicago White Sox,WSOX,16,33,31,64,1965,1979,14,66.9,101.26,34.36,5527,5050,-477,14821,15211,390,11511.0,9679.0,-1832.0,609700.0,568700.0,-41000.0
talbf101,Fred Talbot,Kansas City Athletics,ATLTCS,2,3,5,8,1966,1967,1,5.45,-1.25,-6.7,785,201,-584,1910,500,-1410,1121.0,300.0,-821.0,25000.0,30000.0,5000.0
talbf101,Fred Talbot,New York Yankees,YANKS,2,2,2,4,1969,1973,4,1.79,4.54,2.75,242,385,143,56,473,417,736.0,593.0,-143.0,17000.0,16500.0,-500.0
talbf101,Fred Talbot,Seattle Pilots,BREWRS,5,8,6,14,1969,1976,7,4.01,14.86,10.85,708,774,66,2221,2768,547,397.0,153.0,-244.0,159600.0,25000.0,-134600.0
talbm001,Mitch Talbot,Houston Astros,ASTROS,1,2,2,4,2006,2006,0,34.91,0.23,-34.68,1067,68,-999,4478,261,-4217,29.0,0.0,-29.0,0.0,6916667.0,6916667.0
talbm001,Mitch Talbot,Tampa Bay Devil Rays,RAYS,1,1,1,2,2009,2011,2,-0.03,0.87,0.9,44,150,106,8,440,432,669.0,0.0,-669.0,0.0,1950000.0,1950000.0
tallb001,Brian Tallet,Cleveland Indians,INDINS,1,1,1,2,2006,2006,0,0.61,0.0,-0.61,228,0,-228,3,0,-3,1234.0,0.0,-1234.0,0.0,0.0,0.0
tallb001,Brian Tallet,St. Louis Cardinals,CARDS,2,5,5,10,2011,2013,2,7.58,0.4,-7.18,577,344,-233,1599,89,-1510,283.0,547.0,264.0,3193000.0,4329600.0,1136600.0
taltt101,Tim Talton,San Francisco Giants,GIANTS,1,1,1,2,1965,1965,0,0.69,0.0,-0.69,83,0,-83,123,0,-123,0.0,0.0,0.0,0.0,0.0,0.0
tamaj101,John Tamargo,St. Louis Cardinals,CARDS,1,1,1,2,1978,1979,1,-0.11,0.42,0.53,66,6,-60,180,4,-176,0.0,39.0,39.0,0.0,0.0,0.0
tamaj101,John Tamargo,San Francisco Giants,GIANTS,1,1,2,3,1979,1980,1,0.06,-0.31,-0.37,49,63,14,83,218,135,0.0,0.0,0.0,0.0,0.0,0.0
tamuv101,Vito Tamulis,New York Yankees,YANKS,1,1,1,2,1937,1937,0,-0.24,0.0,0.24,6,0,-6,6,0,-6,46.0,0.0,-46.0,0.0,4500.0,4500.0
tamuv101,Vito Tamulis,Brooklyn Dodgers,DOGRS,2,9,3,12,1940,1947,7,2.8,7.69,4.89,657,371,-286,1221,447,-774,1499.0,2793.0,1294.0,17500.0,0.0,-17500.0
tamuv101,Vito Tamulis,Philadelphia Phillies,PHILS,1,1,1,2,1941,1941,0,0.13,1.33,1.2,24,58,34,5,40,35,66.0,394.0,328.0,0.0,0.0,0.0
tamuv101,Vito Tamulis,Brooklyn Dodgers,DOGRS,1,1,2,3,1941,1947,6,0.0,-0.18,-0.18,0,33,33,0,24,24,0.0,74.0,74.0,0.0,0.0,0.0
tanaf001,Frank Tanana,California Angels,ANGELS,1,3,2,5,1981,1984,3,0.12,12.81,12.69,77,526,449,135,1947,1812,448.0,774.0,326.0,0.0,0.0,0.0
tanaf001,Frank Tanana,Texas Rangers,RNGRS,1,1,1,2,1985,1985,0,13.09,0.0,-13.09,252,0,-252,1,0,-1,4654.0,0.0,-4654.0,590000.0,0.0,-590000.0
tanaf001,Frank Tanana,New York Mets,METS,1,1,1,2,1993,1994,1,0.21,0.09,-0.12,3,2,-1,0,0,0,59.0,3.0,-56.0,1500000.0,0.0,-1500000.0
tankd001,Dennis Tankersley,Boston Red Sox,RSOX,1,2,1,3,2000,2000,0,-1.48,-0.14,1.34,52,33,-19,23,123,100,259.0,0.0,-259.0,0.0,800000.0,800000.0
tankd001,Dennis Tankersley,San Diego Padres,PADRS,2,6,3,9,2004,2005,1,-0.69,-0.05,0.64,140,84,-56,489,11,-478,24.0,273.0,249.0,7550000.0,4750000.0,-2800000.0
tannb001,Bruce Tanner,Chicago White Sox,WSOX,1,2,1,3,1986,1989,3,3.34,0.37,-2.97,291,194,-97,0,702,702,1471.0,0.0,-1471.0,240000.0,218200.0,-21800.0
tannc101,Chuck Tanner,Chicago Cubs,CUBS,2,2,2,4,1959,1959,0,-0.45,-0.17,0.28,24,43,19,6,91,85,88.0,2.0,-86.0,0.0,0.0,0.0
tannc101,Chuck Tanner,Oakland Athletics,ATLTCS,2,2,5,7,1976,1980,4,-1.43,1.01,2.44,188,697,509,368,1923,1555,0.0,327.0,327.0,0.0,0.0,0.0
tannj101,Jesse Tannehill,New York Yankees,YANKS,2,3,2,5,1903,1904,1,24.87,1.41,-23.46,923,85,-838,1185,123,-1062,8913.0,822.0,-8091.0,0.0,0.0,0.0
tannj101,Jesse Tannehill,Boston Red Sox,RSOX,1,1,1,2,1908,1908,0,0.2,-0.31,-0.51,55,2,-53,87,1,-86,278.0,9.0,-269.0,0.0,0.0,0.0
tapak001,Kevin Tapani,Oakland Athletics,ATLTCS,1,4,2,6,1987,1994,7,2.78,10.76,7.98,260,216,-44,78,1,-77,952.0,3814.0,2862.0,1137653.0,0.0,-1137653.0
tapak001,Kevin Tapani,New York Mets,METS,1,5,1,6,1989,1991,2,34.39,9.58,-24.81,807,164,-643,0,204,204,6852.0,1699.0,-5153.0,378000.0,2766666.0,2388666.0
tapak001,Kevin Tapani,Minnesota Twins,TWINS,2,3,5,8,1995,2000,5,1.39,-0.49,-1.88,429,829,400,30,2713,2683,819.0,618.0,-201.0,4612500.0,218000.0,-4394500.0
tappt101,Ted Tappe,Cincinnati Reds,REDS,2,7,3,10,1954,1960,6,0.48,13.19,12.71,599,458,-141,824,407,-417,733.0,2898.0,2165.0,18000.0,30000.0,12000.0
tarat001,Tony Tarasco,Atlanta Braves,BRAVES,3,6,4,10,1995,1999,4,13.08,11.82,-1.26,850,727,-123,3247,1894,-1353,105.0,396.0,291.0,575000.0,700000.0,125000.0
tarat001,Tony Tarasco,Montreal Expos,NATEX,1,1,1,2,1996,1997,1,-0.19,-0.47,-0.28,131,130,-1,285,256,-29,0.0,0.0,0.0,0.0,0.0,0.0
tarps001,Stephen Tarpley,Baltimore Orioles,ORLS,1,2,1,3,2015,2015,0,1.85,1.0,-0.85,210,69,-141,101,236,135,1030.0,0.0,-1030.0,0.0,0.0,0.0
tarps001,Stephen Tarpley,Pittsburgh Pirates,PIRATS,2,3,3,6,2016,2018,2,2.04,3.15,1.11,68,138,70,5,140,135,662.0,1238.0,576.0,9167000.0,0.0,-9167000.0
tarps001,Stephen Tarpley,New York Yankees,YANKS,1,1,2,3,2020,2020,0,-0.48,0.0,0.48,12,0,-12,0,0,0,33.0,0.0,-33.0,0.0,0.0,0.0
tartd001,Danny Tartabull,Seattle Mariners,MARNRS,1,2,3,5,1986,1991,5,13.13,9.05,-4.08,676,330,-346,2684,625,-2059,71.0,1795.0,1724.0,85000.0,120000.0,35000.0
tartd001,Danny Tartabull,New York Yankees,YANKS,2,3,3,6,1995,2000,5,-0.47,-0.06,0.41,70,303,233,278,1302,1024,0.0,0.0,0.0,11500000.0,15437500.0,3937500.0
tartd001,Danny Tartabull,Oakland Athletics,ATLTCS,1,1,2,3,1996,1997,1,0.57,-0.05,-0.62,132,12,-120,541,0,-541,0.0,89.0,89.0,0.0,0.0,0.0
tartj101,Jose Tartabull,San Francisco Giants,GIANTS,1,1,1,2,1961,1962,1,1.56,0.11,-1.45,494,7,-487,1390,9,-1381,0.0,0.0,0.0,0.0,0.0,0.0
tartj101,Jose Tartabull,Kansas City Athletics,ATLTCS,10,23,15,38,1966,1976,10,27.1,17.67,-9.43,4296,1831,-2465,8999,4813,-4186,5181.0,1373.0,-3808.0,355600.0,427500.0,71900.0
tarvl001,La Schelle Tarver,New York Mets,METS,6,12,11,23,1985,1994,9,8.23,9.35,1.12,636,686,50,644,1209,565,3320.0,3063.0,-257.0,4116666.0,2989167.0,-1127499.0
tasbw101,Willie Tasby,Baltimore Orioles,ORLS,3,3,4,7,1960,1963,3,-0.63,1.38,2.01,302,243,-59,1067,603,-464,0.0,0.0,0.0,0.0,0.0,0.0
tasbw101,Willie Tasby,Washington Senators,RNGRS,3,3,4,7,1962,1966,4,8.16,4.13,-4.03,769,613,-156,457,1604,1147,1507.0,990.0,-517.0,0.0,0.0,0.0
tascj001,Jack Taschner,San Francisco Giants,GIANTS,2,2,2,4,2009,2009,0,1.91,0.0,-1.91,218,0,-218,612,0,-612,88.0,0.0,-88.0,0.0,0.0,0.0
tateb101,Bennie Tate,Washington Senators,TWINS,1,2,1,3,1930,1930,0,0.86,0.43,-0.43,237,38,-199,612,91,-521,414.0,0.0,-414.0,13500.0,7000.0,-6500.0
tateb101,Bennie Tate,Chicago White Sox,WSOX,3,8,5,13,1932,1935,3,3.4,4.58,1.18,902,283,-619,3430,766,-2664,0.0,735.0,735.0,34500.0,20500.0,-14000.0
tated001,Dillon Tate,Texas Rangers,RNGRS,1,3,1,4,2016,2016,0,0.0,0.27,0.27,0,52,52,0,206,206,0.0,0.0,0.0,0.0,0.0,0.0
tated001,Dillon Tate,New York Yankees,YANKS,1,3,1,4,2018,2019,1,-0.19,2.71,2.9,121,97,-24,0,0,0,451.0,259.0,-192.0,0.0,12000000.0,12000000.0
tatif001,Fernando Tatis,Texas Rangers,RNGRS,5,11,11,22,1998,2007,9,64.71,14.02,-50.69,2900,693,-2207,10742,1670,-9072,2420.0,2612.0,192.0,7720000.0,9894000.0,2174000.0
tatif001,Fernando Tatis,St. Louis Cardinals,CARDS,4,6,7,13,2000,2004,4,4.8,5.31,0.51,823,756,-67,2678,110,-2568,559.0,1705.0,1146.0,6083333.0,13400281.0,7316948.0
tatif002,Fernando Tatis,Chicago White Sox,WSOX,1,2,2,4,2016,2018,2,12.87,0.14,-12.73,280,82,-198,1180,11,-1169,59.0,1308.0,1249.0,0.0,0.0,0.0
tatuj101,Jarvis Tatum,California Angels,ANGELS,3,6,8,14,1970,1974,4,2.03,2.21,0.18,1109,432,-677,3640,1513,-2127,261.0,88.0,-173.0,44000.0,159000.0,115000.0
tatuk101,Ken Tatum,California Angels,ANGELS,3,6,8,14,1970,1974,4,2.03,2.21,0.18,1109,432,-677,3640,1513,-2127,261.0,88.0,-173.0,44000.0,159000.0,115000.0
tatuk101,Ken Tatum,Boston Red Sox,RSOX,5,10,8,18,1973,1987,14,23.48,30.66,7.18,1104,1173,69,2926,3213,287,3997.0,6340.0,2343.0,120000.0,96000.0,-24000.0
tatuk101,Ken Tatum,St. Louis Cardinals,CARDS,6,8,7,15,1974,1977,3,-1.89,-0.71,1.18,576,98,-478,1332,140,-1192,128.0,23.0,-105.0,0.0,20000.0,20000.0
tatut101,Tommy Tatum,Nashville,Nashville,1,2,1,3,1941,1941,0,-0.18,0.0,0.18,33,0,-33,24,0,-24,74.0,0.0,-74.0,0.0,0.0,0.0
taube001,Ed Taubensee,Cleveland Indians,INDINS,15,21,25,46,1991,2020,29,33.95,111.42,77.47,3251,3340,89,9795,9199,-596,3983.0,9391.0,5408.0,44654400.0,15589000.0,-29065400.0
taube001,Ed Taubensee,Houston Astros,ASTROS,1,1,2,3,1994,1995,1,5.01,-0.51,-5.52,694,54,-640,2324,0,-2324,0.0,49.0,49.0,275000.0,0.0,-275000.0
taube001,Ed Taubensee,Cincinnati Reds,REDS,2,2,3,5,2000,2003,3,-0.31,2.29,2.6,112,212,100,133,37,-96,123.0,625.0,502.0,1650000.0,0.0,-1650000.0
taubt001,Ty Taubenheim,Milwaukee Brewers,BREWRS,3,7,5,12,2005,2012,7,36.63,9.25,-27.38,2335,589,-1746,9079,878,-8201,310.0,3140.0,2830.0,860000.0,11627000.0,10767000.0
taucm001,Mike Tauchman,Colorado Rockies,ROCKS,1,1,1,2,2019,2021,2,3.86,-0.25,-4.11,141,26,-115,423,0,-423,0.0,40.0,40.0,0.0,0.0,0.0
taucm001,Mike Tauchman,New York Yankees,YANKS,1,1,2,3,2021,2021,0,0.0,0.95,0.95,65,52,-13,175,0,-175,3.0,128.0,125.0,0.0,925000.0,925000.0
tausw101,Walt Tauscher,Washington Senators,TWINS,1,5,1,6,1931,1939,8,0.0,8.51,8.51,0,385,385,0,407,407,0.0,3095.0,3095.0,6500.0,0.0,-6500.0
tavaj001,Julian Tavarez,Cleveland Indians,INDINS,3,6,6,12,1996,2001,5,40.02,3.44,-36.58,2173,212,-1961,7166,649,-6517,933.0,172.0,-761.0,7541666.0,6600000.0,-941666.0
tavaj001,Julian Tavarez,Chicago Cubs,CUBS,1,4,2,6,2002,2004,2,19.76,10.92,-8.84,396,427,31,455,211,-244,3529.0,2185.0,-1344.0,0.0,0.0,0.0
tavaj002,Jesus Tavarez,Florida Marlins,MARLNS,1,1,1,2,1996,1996,0,-0.28,0.0,0.28,42,0,-42,74,0,-74,0.0,0.0,0.0,134000.0,0.0,-134000.0
tavea101,Alex Taveras,Houston Astros,ASTROS,1,2,1,3,1977,1978,1,0.09,-0.34,-0.43,21,13,-8,7,21,14,0.0,0.0,0.0,0.0,0.0,0.0
tavef101,Frank Taveras,Pittsburgh Pirates,PIRATS,12,17,20,37,1979,1993,14,29.24,38.19,8.95,2220,2952,732,6305,6236,-69,5336.0,7958.0,2622.0,2472500.0,1200000.0,-1272500.0
tavef101,Frank Taveras,New York Mets,METS,1,1,2,3,1981,1981,0,-0.53,0.0,0.53,48,0,-48,98,0,-98,0.0,0.0,0.0,195000.0,0.0,-195000.0
tavej101,Jackie Tavener,Detroit Tigers,TIGRS,1,2,1,3,1928,1933,5,1.66,19.39,17.73,166,319,153,343,408,65,447.0,2479.0,2032.0,0.0,0.0,0.0
tavew001,Willy Taveras,Houston Astros,ASTROS,1,3,2,5,2006,2007,1,4.59,-0.73,-5.32,489,38,-451,1012,30,-982,873.0,297.0,-576.0,727000.0,4500000.0,3773000.0
tavew001,Willy Taveras,Cincinnati Reds,REDS,1,2,2,4,2010,2010,0,1.98,0.0,-1.98,268,0,-268,835,0,-835,0.0,0.0,0.0,0.0,0.0,0.0
tayla001,Aaron Taylor,Seattle Mariners,MARNRS,9,17,17,34,2004,2015,11,0.83,33.05,32.22,1230,1934,704,2304,5785,3481,1045.0,3331.0,2286.0,19030000.0,18500000.0,-530000.0
taylb001,Billy Taylor,Oakland Athletics,ATLTCS,1,1,2,3,1999,2001,2,-0.38,4.14,4.52,36,174,138,0,0,0,40.0,542.0,502.0,2500000.0,1950000.0,-550000.0
taylb004,Blake Taylor,Pittsburgh Pirates,PIRATS,1,2,1,3,2014,2014,0,0.0,-0.07,-0.07,0,131,131,0,397,397,0.0,0.0,0.0,0.0,0.0,0.0
taylb004,Blake Taylor,New York Mets,METS,1,2,1,3,2019,2020,1,1.02,0.19,-0.83,78,16,-62,0,34,34,190.0,0.0,-190.0,0.0,2212000.0,2212000.0
taylb102,Bill Taylor,Oakland,Oakland,1,2,2,4,1950,1950,0,-0.62,0.0,0.62,132,0,-132,152,0,-152,0.0,0.0,0.0,0.0,0.0,0.0
taylb106,Ben Taylor,Brooklyn Dodgers,DOGRS,1,1,3,4,1951,1951,0,-0.18,0.0,0.18,33,0,-33,104,0,-104,0.0,0.0,0.0,0.0,5100.0,5100.0
taylb106,Ben Taylor,St.Louis Browns,ORLS,17,42,41,83,1952,1988,36,52.55,138.07,85.52,3971,7990,4019,7618,22164,14546,14427.0,15253.0,826.0,829333.0,135900.0,-693433.0
taylb106,Ben Taylor,Detroit Tigers,TIGRS,1,1,1,2,1952,1952,0,0.0,0.0,0.0,0,0,0,0,0,0,0.0,0.0,0.0,0.0,0.0,0.0
taylb106,Ben Taylor,Dallas,Dallas,1,4,2,6,1954,1954,0,0.0,0.0,0.0,0,0,0,0,0,0,0.0,0.0,0.0,0.0,0.0,0.0
taylc001,Chris Taylor,Seattle Mariners,MARNRS,1,1,1,2,2016,2016,0,14.83,0.0,-14.83,657,0,-657,2444,0,-2444,0.0,0.0,0.0,0.0,0.0,0.0
taylc101,Chuck Taylor,St. Louis Cardinals,CARDS,1,2,1,3,1964,1965,1,-0.99,-0.76,0.23,78,138,60,148,253,105,0.0,0.0,0.0,0.0,0.0,0.0
taylc101,Chuck Taylor,Houston Astros,ASTROS,3,6,5,11,1965,1970,5,24.19,12.71,-11.48,1107,622,-485,906,1206,300,7567.0,2468.0,-5099.0,0.0,61000.0,61000.0
taylc101,Chuck Taylor,St. Louis Cardinals,CARDS,9,16,14,30,1971,1976,5,14.55,3.01,-11.54,1564,430,-1134,3017,530,-2487,3834.0,1012.0,-2822.0,0.0,0.0,0.0
taylc102,Carl Taylor,Pittsburgh Pirates,PIRATS,6,12,13,25,1969,1988,19,54.34,40.3,-14.04,3033,2509,-524,9949,6676,-3273,5429.0,2003.0,-3426.0,819000.0,0.0,-819000.0
taylc102,Carl Taylor,St. Louis Cardinals,CARDS,1,2,3,5,1970,1972,2,0.0,0.71,0.71,0,95,95,0,203,203,0.0,0.0,0.0,17500.0,12000.0,-5500.0
taylc102,Carl Taylor,Milwaukee Brewers,BREWRS,4,8,8,16,1971,1978,7,7.91,9.79,1.88,698,534,-164,1896,1479,-417,524.0,1634.0,1110.0,168301.0,15000.0,-153301.0
tayld001,Dwight Taylor,Cleveland Indians,INDINS,1,1,1,2,1985,1986,1,-0.07,0.31,0.38,4,15,11,2,0,-2,0.0,186.0,186.0,0.0,0.0,0.0
tayld001,Dwight Taylor,Cleveland Indians,INDINS,1,2,2,4,1990,1990,0,0.0,0.0,0.0,0,0,0,0,0,0,0.0,0.0,0.0,0.0,0.0,0.0
tayld002,Dorn Taylor,Pittsburgh Pirates,PIRATS,1,1,1,2,1990,1990,0,-0.07,0.11,0.18,4,10,6,0,0,0,11.0,21.0,10.0,0.0,335000.0,335000.0
tayld101,Danny Taylor,Washington Senators,TWINS,2,8,2,10,1926,1941,15,14.54,44.02,29.48,801,1602,801,1696,6582,4886,3390.0,957.0,-2433.0,24000.0,6000.0,-18000.0
tayld101,Danny Taylor,Memphis,Memphis,1,1,2,3,1928,1931,3,1.97,0.0,-1.97,170,0,-170,586,0,-586,0.0,0.0,0.0,0.0,4000.0,4000.0
tayle101,Ed Taylor,Boston Braves,BRAVES,1,1,2,3,1928,1929,1,0.0,-1.24,-1.24,0,94,94,0,291,291,0.0,20.0,20.0,0.0,0.0,0.0
taylh102,Hawk Taylor,New York Mets,METS,1,1,2,3,1967,1967,0,0.59,0.0,-0.59,23,0,-23,56,0,-56,0.0,0.0,0.0,13000.0,8000.0,-5000.0
taylh102,Hawk Taylor,Kansas City Royals,ROYALS,1,1,1,2,1971,1971,0,0.0,0.0,0.0,0,0,0,0,0,0,0.0,0.0,0.0,0.0,0.0,0.0
taylh104,Harry Taylor,Louisville Colonels,LS3,1,2,1,3,1893,1894,1,35.58,1.66,-33.92,755,147,-608,3472,687,-2785,0.0,0.0,0.0,0.0,0.0,0.0
taylj001,Josh Taylor,Arizona Diamondbacks,DBACKS,1,1,1,2,2018,2018,0,2.44,-0.36,-2.8,129,49,-80,0,85,85,307.0,0.0,-307.0,0.0,0.0,0.0
taylj001,Josh Taylor,Philadelphia Phillies,PHILS,1,3,1,4,2015,2015,0,0.0,0.0,0.0,0,0,0,0,0,0,0.0,0.0,0.0,0.0,0.0,0.0
taylj101,Jack Taylor,Chicago Cubs,CUBS,2,4,3,7,1903,1912,9,14.83,52.1,37.27,532,1045,513,1056,2195,1139,4091.0,6835.0,2744.0,0.0,2400.0,2400.0
taylj101,Jack Taylor,St. Louis Cardinals,CARDS,2,3,6,9,1906,1914,8,1.56,6.72,5.16,140,1071,931,180,3501,3321,1449.0,3031.0,1582.0,0.0,0.0,0.0
taylj102,Jack Taylor,Philadelphia Phillies,PHILS,1,5,3,8,1897,1902,5,9.88,14.87,4.99,647,845,198,2475,2785,310,1192.0,3296.0,2104.0,0.0,0.0,0.0
taylj102,Jack Taylor,St. Louis Cardinals,CARDS,1,1,2,3,1898,1899,1,1.29,0.0,-1.29,50,0,-50,74,0,-74,541.0,0.0,-541.0,0.0,0.0,0.0
taylj103,Joe Taylor,Cincinnati Reds,REDS,3,6,6,12,1957,1960,3,46.58,-0.35,-46.93,2142,12,-2130,7009,0,-7009,805.0,19.0,-786.0,0.0,0.0,0.0
taylm001,Michael Taylor,Philadelphia Phillies,PHILS,1,3,2,5,2009,2013,4,-0.14,16.2,16.34,41,202,161,2,264,262,517.0,2108.0,1591.0,0.0,14250000.0,14250000.0
taylm001,Michael Taylor,Toronto Blue Jays,BJAYS,3,3,3,6,2009,2019,10,-0.55,7.38,7.93,507,518,11,1794,1862,68,0.0,0.0,0.0,0.0,0.0,0.0
taylm001,Michael Taylor,Oakland Athletics,ATLTCS,1,1,1,2,2014,2014,0,0.15,0.0,-0.15,11,0,-11,33,0,-33,0.0,0.0,0.0,0.0,0.0,0.0
taylr001,Reggie Taylor,Philadelphia Phillies,PHILS,1,1,1,2,2002,2003,1,-0.16,-0.39,-0.23,235,87,-148,505,6,-499,0.0,173.0,173.0,0.0,0.0,0.0
taylr001,Reggie Taylor,Colorado Rockies,ROCKS,1,1,1,2,2005,2005,0,-0.04,-0.31,-0.27,11,31,20,24,0,-24,0.0,35.0,35.0,0.0,0.0,0.0
taylr101,Ron Taylor,Cleveland Indians,INDINS,2,5,2,7,1962,1968,6,3.21,3.85,0.64,600,709,109,441,2271,1830,1817.0,0.0,-1817.0,27000.0,25000.0,-2000.0
taylr101,Ron Taylor,St. Louis Cardinals,CARDS,10,18,16,34,1965,1976,11,25.61,13.65,-11.96,1956,974,-982,3292,632,-2660,6302.0,2494.0,-3808.0,0.0,0.0,0.0
tayls002,Scott Taylor,Seattle Mariners,MARNRS,1,1,1,2,1990,1990,0,0.0,0.0,0.0,0,0,0,0,0,0,0.0,0.0,0.0,0.0,0.0,0.0
tayls002,Scott Taylor,Milwaukee Brewers,BREWRS,1,1,1,2,1995,1996,1,-0.4,-1.45,-1.05,3,200,197,0,491,491,46.0,0.0,-46.0,0.0,0.0,0.0
tayls102,Sammy Taylor,Milwaukee Braves,BRAVES,2,5,5,10,1957,1961,4,-0.24,3.65,3.89,692,187,-505,1842,252,-1590,561.0,791.0,230.0,0.0,0.0,0.0
tayls102,Sammy Taylor,Chicago Cubs,CUBS,6,11,8,19,1962,1977,15,12.5,38.57,26.07,818,2457,1639,610,6362,5752,3515.0,5246.0,1731.0,122500.0,58000.0,-64500.0
tayls102,Sammy Taylor,New York Mets,METS,3,5,4,9,1963,1970,7,0.13,2.94,2.81,256,564,308,368,1104,736,516.0,1427.0,911.0,0.0,26000.0,26000.0
tayls102,Sammy Taylor,Cincinnati Reds,REDS,1,1,1,2,1963,1963,0,0.12,-0.27,-0.39,4,15,11,10,32,22,0.0,0.0,0.0,0.0,0.0,0.0
taylt101,Tony Taylor,Chicago Cubs,CUBS,17,29,28,57,1960,1982,22,71.82,137.22,65.4,4054,6789,2735,10993,16906,5913,10563.0,17980.0,7417.0,552500.0,88500.0,-464000.0
taylt101,Tony Taylor,Philadelphia Phillies,PHILS,1,1,2,3,1971,1971,0,3.07,0.0,-3.07,217,0,-217,745,0,-745,0.0,0.0,0.0,60000.0,0.0,-60000.0
taylt102,Tommy Taylor,Memphis,Memphis,2,3,3,6,1924,1924,0,0.84,0.0,-0.84,204,0,-204,334,0,-334,684.0,0.0,-684.0,0.0,3200.0,3200.0
taylt102,Tommy Taylor,Washington Senators,TWINS,4,11,5,16,1924,1941,17,16.54,44.06,27.52,920,1674,754,2170,6771,4601,3390.0,1035.0,-2355.0,27200.0,6000.0,-21200.0
taylw001,Wade Taylor,Seattle Mariners,MARNRS,4,7,6,13,1987,1995,8,7.57,0.25,-7.32,518,728,210,671,2089,1418,1950.0,271.0,-1679.0,982500.0,1100000.0,117500.0
taylz101,Zack Taylor,Brooklyn Dodgers,DOGRS,2,5,4,9,1925,1927,2,6.65,0.24,-6.41,787,339,-448,3022,1227,-1795,0.0,0.0,0.0,27500.0,4800.0,-22700.0
taylz101,Zack Taylor,Boston Braves,BRAVES,7,13,11,24,1927,1938,11,17.24,17.06,-0.18,1140,2433,1293,3084,9081,5997,3328.0,1364.0,-1964.0,42000.0,12100.0,-29900.0
teacb101,Bud Teachout,Chicago Cubs,CUBS,1,2,1,3,1931,1933,2,-0.02,-0.44,-0.42,2,94,92,0,73,73,3.0,633.0,630.0,33000.0,20000.0,-13000.0
teagt001,Taylor Teagarden,Texas Rangers,RNGRS,1,1,2,3,2011,2011,0,-0.52,0.0,0.52,45,0,-45,126,0,-126,0.0,0.0,0.0,0.0,0.0,0.0
teahm001,Mark Teahen,Oakland Athletics,ATLTCS,1,2,1,3,2004,2005,1,4.64,1.22,-3.42,770,62,-708,2737,0,-2737,839.0,198.0,-641.0,0.0,0.0,0.0
teahm001,Mark Teahen,Kansas City Royals,ROYALS,1,1,2,3,2009,2013,4,-1.63,1.37,3.0,128,345,217,392,1174,782,0.0,0.0,0.0,3575000.0,811000.0,-2764000.0
teahm001,Mark Teahen,Chicago White Sox,WSOX,4,6,7,13,2011,2016,5,-1.99,0.09,2.08,103,232,129,66,344,278,233.0,625.0,392.0,13500000.0,3500000.0,-10000000.0
tebbb101,Birdie Tebbetts,Detroit Tigers,TIGRS,1,1,1,2,1947,1948,1,3.02,0.99,-2.03,419,125,-294,1601,355,-1246,0.0,0.0,0.0,0.0,0.0,0.0
teixm001,Mark Teixeira,Texas Rangers,RNGRS,8,20,28,48,2007,2021,14,23.19,61.95,38.76,1540,2663,1123,4320,8186,3866,2620.0,5087.0,2467.0,14431080.0,1106250.0,-13324830.0
teixm001,Mark Teixeira,Atlanta Braves,BRAVES,2,2,3,5,2008,2009,1,3.87,2.69,-1.18,93,187,94,329,753,424,0.0,0.0,0.0,15385000.0,1450000.0,-13935000.0
tejam001,Miguel Tejada,Baltimore Orioles,ORLS,2,2,7,9,2007,2014,7,3.91,11.78,7.87,332,910,578,1340,1971,631,22.0,1330.0,1308.0,13811415.0,382000.0,-13429415.0
tejam001,Miguel Tejada,Baltimore Orioles,ORLS,1,2,1,3,2010,2010,0,1.18,0.0,-1.18,59,0,-59,253,0,-253,0.0,0.0,0.0,6000000.0,0.0,-6000000.0
tejaw001,Wilfredo Tejada,Montreal Expos,NATEX,1,1,1,2,1988,1988,0,0.0,0.0,0.0,0,0,0,0,0,0,0.0,0.0,0.0,0.0,0.0,0.0
tejer001,Rob Tejeda,Philadelphia Phillies,PHILS,1,2,1,3,2006,2006,0,-0.83,0.74,1.57,42,132,90,7,301,294,525.0,0.0,-525.0,0.0,0.0,0.0
tekob001,Blake Tekotte,San Diego Padres,PADRS,1,1,1,2,2012,2012,0,-0.19,0.0,0.19,20,0,-20,36,0,-36,0.0,0.0,0.0,0.0,0.0,0.0
tekuk001,Kent Tekulve,Pittsburgh Pirates,PIRATS,3,7,8,15,1985,1992,7,16.38,23.12,6.74,1100,1493,393,694,1281,587,3771.0,7235.0,3464.0,1860000.0,180000.0,-1680000.0
telit001,Tomas Telis,Texas Rangers,RNGRS,2,4,2,6,2015,2017,2,2.24,2.95,0.71,421,128,-293,185,0,-185,487.0,355.0,-132.0,0.0,507500.0,507500.0
tellr001,Rowdy Tellez,Toronto Blue Jays,BJAYS,1,1,2,3,2021,2021,0,0.23,0.58,0.35,56,34,-22,174,0,-174,0.0,98.0,98.0,0.0,0.0,0.0
tellt001,Tom Tellmann,San Diego Padres,PADRS,1,1,2,3,1982,1982,0,4.1,0.0,-4.1,94,0,-94,0,0,0,542.0,0.0,-542.0,0.0,0.0,0.0
tempg001,Garry Templeton,St. Louis Cardinals,CARDS,1,3,3,6,1981,1992,11,19.37,59.81,40.44,1893,1695,-198,5833,6828,995,883.0,553.0,-330.0,793333.0,0.0,-793333.0
tempg001,Garry Templeton,San Diego Padres,PADRS,1,1,1,2,1991,1993,2,-1.06,2.4,3.46,80,294,214,234,873,639,0.0,0.0,0.0,530000.0,637500.0,107500.0
tempj101,Johnny Temple,Cincinnati Reds,REDS,2,3,4,7,1959,1963,4,15.51,0.98,-14.53,676,413,-263,1467,1285,-182,3599.0,454.0,-3145.0,0.0,0.0,0.0
tempj101,Johnny Temple,Cleveland Indians,INDINS,2,2,4,6,1961,1965,4,0.95,1.11,0.16,254,127,-127,658,440,-218,0.0,0.0,0.0,7500.0,10500.0,3000.0
tenag101,Gene Tenace,San Diego Padres,PADRS,11,20,24,44,1980,1993,13,78.65,50.21,-28.44,3246,4423,1177,10088,11380,1292,4862.0,3507.0,-1355.0,3006667.0,3395633.0,388966.0
tennf102,Fred Tenney,Boston Braves,BRAVES,2,4,6,10,1907,1911,4,19.52,11.83,-7.69,821,855,34,3252,2714,-538,0.0,1733.0,1733.0,0.0,0.0,0.0
tepef101,Frank Tepedino,New York Yankees,YANKS,14,25,25,50,1971,1997,26,98.22,28.51,-69.71,5419,1835,-3584,10839,3270,-7569,18250.0,6192.0,-12058.0,4415000.0,2839500.0,-1575500.0
tepef101,Frank Tepedino,New York Yankees,YANKS,6,12,9,21,1973,1983,10,29.7,21.37,-8.33,2028,936,-1092,2549,2957,408,5698.0,1893.0,-3805.0,79000.0,458000.0,379000.0
teper001,Ryan Tepera,Chicago Cubs,CUBS,1,1,1,2,2021,2021,0,0.63,0.0,-0.63,25,0,-25,0,0,0,54.0,0.0,-54.0,800000.0,0.0,-800000.0
terlg101,Greg Terlecky,St. Louis Cardinals,CARDS,1,2,1,3,1975,1976,1,0.63,-0.55,-1.18,80,66,-14,258,97,-161,0.0,0.0,0.0,0.0,0.0,0.0
terpj101,Jeff Terpko,Washington Senators,RNGRS,8,16,13,29,1970,1982,12,21.36,8.18,-13.18,1080,728,-352,2708,1819,-889,4391.0,989.0,-3402.0,326500.0,280000.0,-46500.0
terpj101,Jeff Terpko,Philadelphia Phillies,PHILS,1,2,3,5,1970,1977,7,1.17,0.0,-1.17,48,0,-48,40,0,-40,179.0,0.0,-179.0,0.0,0.0,0.0
terpj101,Jeff Terpko,Texas Rangers,RNGRS,7,13,11,24,1977,1982,5,21.36,6.59,-14.77,1080,693,-387,2708,1819,-889,4391.0,810.0,-3581.0,313000.0,280000.0,-33000.0
terra101,Adonis Terry,Baltimore Orioles,BLN,1,1,1,2,1892,1892,0,5.48,0.38,-5.1,115,75,-40,185,302,117,1232.0,0.0,-1232.0,0.0,0.0,0.0
terrr101,Ralph Terry,New York Yankees,YANKS,3,9,7,16,1957,1962,5,10.27,3.25,-7.02,1508,714,-794,3698,610,-3088,2854.0,1762.0,-1092.0,12500.0,12500.0,0.0
terrr101,Ralph Terry,Kansas City Athletics,ATLTCS,17,36,31,67,1959,1976,17,68.33,55.7,-12.63,8021,5164,-2857,18125,17078,-1047,14086.0,3207.0,-10879.0,387100.0,512500.0,125400.0
terrr101,Ralph Terry,New York Yankees,YANKS,2,4,3,7,1964,1966,2,1.12,2.59,1.47,72,260,188,65,33,-32,521.0,611.0,90.0,84000.0,27500.0,-56500.0
terrr101,Ralph Terry,Cleveland Indians,INDINS,4,5,7,12,1966,1969,3,-0.01,3.11,3.12,516,278,-238,84,92,8,1577.0,1093.0,-484.0,75600.0,66000.0,-9600.0
terrs001,Scott Terry,Cincinnati Reds,REDS,2,3,2,5,1987,1988,1,5.7,-0.03,-5.73,528,69,-459,113,58,-55,1552.0,108.0,-1444.0,132500.0,1463333.0,1330833.0
terrw001,Walt Terrell,Texas Rangers,RNGRS,2,3,2,5,1982,1984,2,21.02,0.29,-20.73,680,235,-445,875,838,-37,5969.0,0.0,-5969.0,400000.0,0.0,-400000.0
terrw001,Walt Terrell,New York Mets,METS,1,1,1,2,1984,1993,9,7.72,22.03,14.31,218,1154,936,0,4591,4591,3984.0,0.0,-3984.0,111000.0,0.0,-111000.0
terrw001,Walt Terrell,Detroit Tigers,TIGRS,2,2,3,5,1988,1990,2,0.12,1.07,0.95,71,125,54,155,406,251,370.0,283.0,-87.0,2148333.0,1508333.0,-640000.0
terrw001,Walt Terrell,San Diego Padres,PADRS,1,2,2,4,1989,1990,1,-0.36,-0.39,-0.03,13,192,179,0,619,619,249.0,73.0,-176.0,775000.0,575000.0,-200000.0
terww101,Wayne Terwilliger,Chicago Cubs,CUBS,9,26,24,50,1951,1965,14,14.31,21.74,7.43,2452,2862,410,6527,5620,-907,3090.0,5461.0,2371.0,143500.0,125000.0,-18500.0
terww101,Wayne Terwilliger,San Francisco Giants,GIANTS,1,1,1,2,1957,1957,0,0.0,0.0,0.0,0,0,0,0,0,0,0.0,0.0,0.0,0.0,0.0,0.0
tessj001,Jay Tessmer,New York Yankees,YANKS,2,3,2,5,2001,2001,0,0.68,0.25,-0.43,79,11,-68,1,0,-1,146.0,32.0,-114.0,0.0,0.0,0.0
tettd101,Dick Tettelbach,New York Yankees,YANKS,7,20,15,35,1956,1970,14,3.04,33.17,30.13,2442,2492,50,6615,5619,-996,2999.0,5239.0,2240.0,115500.0,43000.0,-72500.0
tettd101,Dick Tettelbach,Washington Senators,TWINS,1,2,1,3,1957,1957,0,0.92,-0.4,-1.32,46,96,50,9,331,322,120.0,0.0,-120.0,8000.0,0.0,-8000.0
tettm001,Mickey Tettleton,Baltimore Orioles,ORLS,1,1,1,2,1991,1991,0,14.83,-0.4,-15.23,570,21,-549,2343,0,-2343,0.0,313.0,313.0,0.0,0.0,0.0
teuft001,Tim Teufel,Minnesota Twins,TWINS,5,6,7,13,1986,1989,3,8.22,-2.13,-10.35,574,122,-452,1466,209,-1257,305.0,169.0,-136.0,0.0,0.0,0.0
teuft001,Tim Teufel,New York Mets,METS,1,1,1,2,1991,1991,0,2.4,-1.06,-3.46,294,80,-214,873,234,-639,0.0,0.0,0.0,637500.0,530000.0,-107500.0
teutn001,Nate Teut,Chicago Cubs,CUBS,1,1,1,2,2001,2002,1,-0.36,-0.46,-0.1,4,16,12,2,1,-1,22.0,25.0,3.0,0.0,0.0,0.0
tewkb001,Bob Tewksbury,New York Yankees,YANKS,4,8,6,14,1987,1994,7,-0.12,9.72,9.84,794,752,-42,1743,1510,-233,764.0,1690.0,926.0,2485000.0,3889167.0,1404167.0
texek001,Kanekoa Texeira,Chicago White Sox,WSOX,1,2,3,5,2008,2011,3,11.97,-0.72,-12.69,599,28,-571,2501,50,-2451,3.0,20.0,17.0,3600000.0,1165000.0,-2435000.0
thacm101,Moe Thacker,Chicago Cubs,CUBS,16,27,26,53,1962,1982,20,54.43,129.03,74.6,2307,6354,4047,4353,15923,11570,10563.0,16087.0,5524.0,552500.0,88500.0,-464000.0
thame001,Eric Thames,Toronto Blue Jays,BJAYS,1,1,1,2,2012,2016,4,0.0,0.53,0.53,40,150,110,130,0,-130,0.0,429.0,429.0,485900.0,480700.0,-5200.0
thame001,Eric Thames,Seattle Mariners,MARNRS,2,2,2,4,2013,2017,4,0.0,0.24,0.24,0,14,14,0,5,5,0.0,187.0,187.0,0.0,0.0,0.0
thamm001,Marcus Thames,New York Yankees,YANKS,1,1,1,2,2003,2005,2,-0.44,-0.52,-0.08,30,231,201,84,708,624,0.0,0.0,0.0,0.0,600000.0,600000.0
thatj001,Joe Thatcher,Milwaukee Brewers,BREWRS,1,3,1,4,2007,2007,0,2.56,0.04,-2.52,559,54,-505,1,1,0,595.0,76.0,-519.0,0.0,2150000.0,2150000.0
thatj001,Joe Thatcher,San Diego Padres,PADRS,1,2,1,3,2013,2015,2,-1.32,1.52,2.84,205,142,-63,0,131,131,225.0,1280.0,1055.0,0.0,0.0,0.0
thatj001,Joe Thatcher,Arizona Diamondbacks,DBACKS,1,2,2,4,2014,2019,5,-0.49,0.11,0.6,34,4,-30,15,0,-15,19.0,9.0,-10.0,2884500.0,0.0,-2884500.0
thayd001,Dale Thayer,San Diego Padres,PADRS,1,2,1,3,2006,2007,1,-0.26,0.94,1.2,13,88,75,1,235,234,47.0,0.0,-47.0,0.0,0.0,0.0
theor101,Ron Theobald,Washington Senators,RNGRS,1,2,1,3,1970,1970,0,4.46,0.11,-4.35,279,77,-202,994,154,-840,0.0,0.0,0.0,19000.0,0.0,-19000.0
therr001,Ryan Theriot,Chicago Cubs,CUBS,1,3,3,6,2010,2012,2,3.28,-0.26,-3.54,168,192,24,342,477,135,1023.0,0.0,-1023.0,15600000.0,410000.0,-15190000.0
therr001,Ryan Theriot,Los Angeles Dodgers,DOGRS,1,1,1,2,2010,2012,2,0.34,-0.37,-0.71,132,96,-36,483,1,-482,0.0,159.0,159.0,0.0,402000.0,402000.0
thevt101,Tommy Thevenow,St. Louis Cardinals,CARDS,1,1,2,3,1928,1928,0,-5.14,0.0,5.14,246,0,-246,978,0,-978,0.0,0.0,0.0,6000.0,7000.0,1000.0
thevt101,Tommy Thevenow,Philadelphia Phillies,PHILS,2,3,6,9,1930,1936,6,25.37,8.0,-17.37,1352,958,-394,5364,4215,-1149,77.0,0.0,-77.0,24000.0,6250.0,-17750.0
thevt101,Tommy Thevenow,New York Giants,GIANTS,1,1,1,2,1937,1937,0,-0.06,0.0,0.06,21,0,-21,39,0,-39,0.0,0.0,0.0,0.0,0.0,0.0
thiej102,Jake Thielman,Cleveland Indians,INDINS,2,3,2,5,1908,1914,6,-0.3,-1.58,-1.28,2,95,93,0,309,309,2.0,0.0,-2.0,0.0,0.0,0.0
thigb001,Bobby Thigpen,Chicago White Sox,WSOX,2,2,2,4,1993,1995,2,-0.39,1.47,1.86,48,101,53,3,0,-3,83.0,464.0,381.0,4121667.0,600000.0,-3521667.0
thobj001,J.J. Thobe,Cleveland Indians,INDINS,2,4,2,6,1994,1994,0,-0.31,-0.66,-0.35,27,19,-8,0,0,0,177.0,71.0,-106.0,1850000.0,2975000.0,1125000.0
tholj001,Josh Thole,New York Mets,METS,5,10,9,19,2012,2021,9,5.89,21.61,15.72,446,1069,623,898,3007,2109,2473.0,2300.0,-173.0,18229800.0,3500000.0,-14729800.0
thoma003,Aaron Thompson,Florida Marlins,MARLNS,1,1,1,2,2009,2009,0,0.0,0.35,0.35,0,35,35,0,150,150,0.0,0.0,0.0,0.0,5500000.0,5500000.0
thomb105,Bobby Thomson,New York Giants,GIANTS,15,30,31,61,1954,1968,14,48.23,65.72,17.49,4661,4032,-629,15306,7933,-7373,2020.0,13164.0,11144.0,128000.0,149500.0,21500.0
thomb105,Bobby Thomson,Milwaukee Braves,BRAVES,1,3,1,4,1957,1960,3,3.25,5.66,2.41,395,272,-123,1122,1140,18,434.0,0.0,-434.0,0.0,42000.0,42000.0
thomb105,Bobby Thomson,San Francisco Giants,GIANTS,1,1,2,3,1958,1958,0,4.43,0.19,-4.24,274,66,-208,1032,84,-948,0.0,0.0,0.0,0.0,0.0,0.0
thomb105,Bobby Thomson,Chicago Cubs,CUBS,1,1,1,2,1959,1961,2,0.73,-0.19,-0.92,40,4,-36,127,1,-126,0.0,8.0,8.0,0.0,0.0,0.0
thomc001,Charles Thomas,Atlanta Braves,BRAVES,1,3,1,4,2004,2013,9,-3.0,25.61,28.61,78,476,398,55,578,523,230.0,4719.0,4489.0,370000.0,5000000.0,4630000.0
thomc001,Charles Thomas,Oakland Athletics,ATLTCS,1,1,1,2,2007,2007,0,0.0,0.0,0.0,0,0,0,0,0,0,0.0,0.0,0.0,0.0,0.0,0.0
thomd001,Derrel Thomas,Houston Astros,ASTROS,7,14,10,24,1971,1989,18,9.86,19.8,9.94,2403,1970,-433,5583,4832,-751,5444.0,4390.0,-1054.0,22500.0,16500.0,-6000.0
thomd001,Derrel Thomas,San Diego Padres,PADRS,3,4,5,9,1974,1982,8,3.97,1.27,-2.7,511,929,418,1498,1651,153,340.0,1465.0,1125.0,0.0,0.0,0.0
thomd001,Derrel Thomas,San Francisco Giants,GIANTS,9,11,16,27,1978,1998,20,9.76,25.98,16.22,738,2478,1740,1752,8190,6438,1958.0,443.0,-1515.0,7402778.0,4466667.0,-2936111.0
thomd003,Daryl Thompson,Washington Nationals,NATEX,1,5,3,8,2006,2009,3,-0.61,0.43,1.04,705,795,90,181,2860,2679,809.0,139.0,-670.0,1352000.0,4550000.0,3198000.0
thomd102,Don Thompson,Boston Braves,BRAVES,4,14,5,19,1949,1960,11,7.36,21.56,14.2,1117,1270,153,2487,5255,2768,2162.0,0.0,-2162.0,6600.0,46800.0,40200.0
thomd103,Danny Thompson,Minnesota Twins,TWINS,4,6,12,18,1976,1992,16,15.53,44.0,28.47,533,2941,2408,1530,9053,7523,1468.0,2182.0,714.0,1325000.0,873333.0,-451667.0
thomf102,Fred Thomas,Cleveland Indians,INDINS,1,3,1,4,1916,1927,11,11.98,74.79,62.81,369,1519,1150,563,6634,6071,3136.0,0.0,-3136.0,0.0,0.0,0.0
thomf102,Fred Thomas,Washington Senators,TWINS,2,3,2,5,1920,1924,4,4.25,3.02,-1.23,196,364,168,615,1337,722,26.0,0.0,-26.0,0.0,0.0,0.0
thomf103,Frank Thomas,Pittsburgh Pirates,PIRATS,9,16,18,34,1959,1973,14,-0.94,37.67,38.61,564,1623,1059,1204,4862,3658,386.0,2327.0,1941.0,17500.0,0.0,-17500.0
thomf103,Frank Thomas,Cincinnati Reds,REDS,3,4,7,11,1959,1965,6,25.72,11.28,-14.44,1639,857,-782,5251,1135,-4116,272.0,935.0,663.0,0.0,0.0,0.0
thomf103,Frank Thomas,Chicago Cubs,CUBS,2,2,3,5,1961,1961,0,2.63,-0.43,-3.06,139,23,-116,500,42,-458,0.0,0.0,0.0,0.0,0.0,0.0
thomf103,Frank Thomas,Milwaukee Braves,BRAVES,1,2,2,4,1961,1964,3,3.7,0.59,-3.11,377,85,-292,1356,234,-1122,0.0,0.0,0.0,0.0,0.0,0.0
thomf103,Frank Thomas,New York Mets,METS,3,5,6,11,1964,1966,2,1.26,-0.39,-1.65,104,131,27,259,161,-98,71.0,326.0,255.0,0.0,0.0,0.0
thomf103,Frank Thomas,Houston Astros,ASTROS,2,4,2,6,1965,1968,3,0.18,0.0,-0.18,376,0,-376,1109,0,-1109,0.0,0.0,0.0,0.0,0.0,0.0
thomf105,Fay Thomas,St.Louis Browns,ORLS,1,1,1,2,1935,1936,1,0.0,-0.2,-0.2,0,18,18,0,2,2,0.0,58.0,58.0,4000.0,0.0,-4000.0
thomf106,Fresco Thompson,New York Giants,GIANTS,6,15,10,25,1927,1949,22,30.29,66.01,35.72,2286,3209,923,6995,11614,4619,4737.0,1177.0,-3560.0,10500.0,25000.0,14500.0
thomf106,Fresco Thompson,Philadelphia Phillies,PHILS,5,12,10,22,1930,1941,11,17.23,29.97,12.74,1414,1700,286,5405,4168,-1237,324.0,4825.0,4501.0,17000.0,18200.0,1200.0
thomf106,Fresco Thompson,Omaha,Omaha,1,1,2,3,1924,1924,0,-0.02,0.0,0.02,14,0,-14,41,0,-41,0.0,0.0,0.0,0.0,3600.0,3600.0
thomg001,Gorman Thomas,Milwaukee Brewers,BREWRS,1,1,1,2,1977,1978,1,0.0,0.16,0.16,0,29,29,0,88,88,0.0,0.0,0.0,0.0,0.0,0.0
thomg001,Gorman Thomas,Milwaukee Brewers,BREWRS,1,3,2,5,1983,1987,4,7.32,0.25,-7.07,394,574,180,437,1374,937,1362.0,450.0,-912.0,600000.0,885000.0,285000.0
thomg001,Gorman Thomas,Cleveland Indians,INDINS,3,4,4,8,1983,1989,6,6.14,3.15,-2.99,575,539,-36,2408,2048,-360,0.0,224.0,224.0,630000.0,0.0,-630000.0
thomg101,Gary Thomasson,San Francisco Giants,GIANTS,4,14,8,22,1978,1992,14,8.18,23.62,15.44,767,1277,510,1656,1600,-56,2714.0,7759.0,5045.0,0.0,0.0,0.0
thomg101,Gary Thomasson,Oakland Athletics,ATLTCS,1,1,3,4,1978,1982,4,0.98,-2.09,-3.07,54,227,173,130,698,568,0.0,0.0,0.0,0.0,0.0,0.0
thomg101,Gary Thomasson,New York Yankees,YANKS,7,12,12,24,1979,1992,13,8.38,13.81,5.43,1369,688,-681,2988,2039,-949,2564.0,669.0,-1895.0,913333.0,1045000.0,131667.0
thomg102,George Thomas,Los Angeles Angels,ANGELS,5,8,8,16,1963,1968,5,-0.19,2.29,2.48,637,490,-147,1176,840,-336,443.0,1488.0,1045.0,44000.0,15000.0,-29000.0
thomg102,George Thomas,Detroit Tigers,TIGRS,1,3,1,4,1965,1967,2,0.26,-0.68,-0.94,350,64,-286,935,31,-904,0.0,314.0,314.0,32800.0,33000.0,200.0
thomh102,Herb Thomas,Boston Braves,BRAVES,7,13,11,24,1927,1938,11,17.24,17.06,-0.18,1140,2433,1293,3084,9081,5997,3328.0,1364.0,-1964.0,42000.0,12100.0,-29900.0
thomh104,Harry Thompson,Washington Senators,TWINS,1,1,1,2,1919,1919,0,-0.24,-0.87,-0.63,8,24,16,6,84,78,36.0,0.0,-36.0,0.0,2400.0,2400.0
thomi001,Ian Thomas,Atlanta Braves,BRAVES,6,15,9,24,2015,2021,6,3.56,2.51,-1.05,557,291,-266,805,489,-316,986.0,676.0,-310.0,21307500.0,11500000.0,-9807500.0
thomj001,Jason Thompson,Detroit Tigers,TIGRS,1,1,1,2,1980,1982,2,3.58,1.49,-2.09,102,193,91,387,736,349,0.0,0.0,0.0,0.0,0.0,0.0
thomj001,Jason Thompson,California Angels,ANGELS,1,1,2,3,1981,1983,2,9.75,0.89,-8.86,671,87,-584,2696,282,-2414,0.0,43.0,43.0,0.0,0.0,0.0
thomj001,Jason Thompson,Pittsburgh Pirates,PIRATS,1,1,2,3,1986,1986,0,-0.23,0.0,0.23,30,0,-30,69,0,-69,0.0,0.0,0.0,0.0,0.0,0.0
thomj002,Jim Thome,Philadelphia Phillies,PHILS,4,7,6,13,2005,2009,4,28.26,6.87,-21.39,725,457,-268,2185,1302,-883,3223.0,280.0,-2943.0,13496667.0,12952000.0,-544667.0
thomj002,Jim Thome,Chicago White Sox,WSOX,1,2,1,3,2009,2009,0,0.0,0.0,0.0,17,0,-17,17,0,-17,0.0,0.0,0.0,13000000.0,0.0,-13000000.0
thomj002,Jim Thome,Philadelphia Phillies,PHILS,1,1,2,3,2012,2012,0,0.0,0.0,0.0,28,0,-28,115,0,-115,0.0,0.0,0.0,1250000.0,0.0,-1250000.0
thomj003,Justin Thompson,Detroit Tigers,TIGRS,1,6,3,9,1999,2004,5,20.76,4.31,-16.45,1380,309,-1071,3548,496,-3052,1196.0,551.0,-645.0,1937500.0,9240000.0,7302500.0
thomj005,John Thomson,Colorado Rockies,ROCKS,1,2,3,5,2002,2003,1,-0.58,3.78,4.36,21,232,211,25,840,815,163.0,36.0,-127.0,1350000.0,362500.0,-987500.0
thomj007,Jake Thompson,Detroit Tigers,TIGRS,2,3,2,5,2014,2021,7,0.73,1.99,1.26,58,412,354,0,1195,1195,80.0,156.0,76.0,7000000.0,0.0,-7000000.0
thomj007,Jake Thompson,Texas Rangers,RNGRS,5,14,16,30,2015,2021,6,11.03,13.28,2.25,790,293,-497,1664,16,-1648,2536.0,2164.0,-372.0,3762500.0,1106250.0,-2656250.0
thomk101,Kite Thomas,Washington Senators,TWINS,1,1,1,2,1954,1954,0,0.0,0.35,0.35,0,76,76,0,192,192,0.0,0.0,0.0,0.0,0.0,0.0
thoml001,Larry Thomas,Chicago White Sox,WSOX,1,2,1,3,1997,1998,1,0.48,0.0,-0.48,32,0,-32,0,0,0,174.0,0.0,-174.0,157500.0,200000.0,42500.0
thoml002,Lane Thomas,Toronto Blue Jays,BJAYS,1,1,1,2,2017,2017,0,-0.02,0.0,0.02,84,0,-84,142,0,-142,0.0,0.0,0.0,0.0,0.0,0.0
thoml002,Lane Thomas,St. Louis Cardinals,CARDS,1,1,1,2,2021,2021,0,1.31,0.07,-1.24,45,23,-22,206,22,-184,0.0,198.0,198.0,0.0,0.0,0.0
thoml102,Leo Thomas,St.Louis Browns,ORLS,11,21,24,45,1950,1960,10,30.8,26.53,-4.27,2470,2935,465,5868,7663,1795,6528.0,5672.0,-856.0,55500.0,57800.0,2300.0
thoml102,Leo Thomas,Portland,Portland,1,1,3,4,1951,1951,0,-0.01,0.0,0.01,41,0,-41,146,0,-146,0.0,0.0,0.0,0.0,0.0,0.0
thoml102,Leo Thomas,St.Louis Browns,ORLS,1,2,2,4,1952,1952,0,0.64,0.34,-0.3,156,55,-101,332,173,-159,0.0,0.0,0.0,0.0,20000.0,20000.0
thoml103,Lee Thomas,New York Yankees,YANKS,1,3,2,5,1961,1962,1,3.35,0.73,-2.62,729,113,-616,2005,155,-1850,725.0,95.0,-630.0,0.0,0.0,0.0
thoml103,Lee Thomas,Los Angeles Angels,ANGELS,1,1,1,2,1964,1965,1,2.14,-0.36,-2.5,258,180,-78,1045,593,-452,0.0,0.0,0.0,0.0,0.0,0.0
thoml103,Lee Thomas,Boston Red Sox,RSOX,1,3,2,5,1965,1968,3,0.78,1.64,0.86,187,156,-31,154,15,-139,353.0,393.0,40.0,12500.0,15000.0,2500.0
thoml103,Lee Thomas,Atlanta Braves,BRAVES,1,1,1,2,1966,1966,0,-1.51,-0.11,1.4,152,76,-76,379,9,-370,0.0,196.0,196.0,0.0,0.0,0.0
thoml103,Lee Thomas,Chicago Cubs,CUBS,1,1,2,3,1968,1968,0,-1.85,0.0,1.85,90,0,-90,221,0,-221,0.0,0.0,0.0,0.0,0.0,0.0
thomm001,Milt Thompson,Atlanta Braves,BRAVES,2,3,3,6,1985,1994,9,11.78,9.36,-2.42,1062,684,-378,2024,1673,-351,1256.0,1991.0,735.0,1575000.0,850000.0,-725000.0
thomm001,Milt Thompson,Philadelphia Phillies,PHILS,1,1,2,3,1988,1991,3,10.67,-1.11,-11.78,514,275,-239,1641,597,-1044,0.0,0.0,0.0,240000.0,340000.0,100000.0
thomm001,Milt Thompson,Philadelphia Phillies,PHILS,1,1,1,2,1994,1994,0,0.12,0.14,0.02,101,6,-95,172,0,-172,0.0,12.0,12.0,1375000.0,475000.0,-900000.0
thomm003,Mike Thomas,New York Mets,METS,2,3,2,5,1991,1992,1,-0.46,-0.67,-0.21,29,186,157,7,7,0,134.0,344.0,210.0,4233334.0,1600000.0,-2633334.0
thomm005,Mason Thompson,San Diego Padres,PADRS,1,2,1,3,2021,2021,0,-0.22,-0.24,-0.02,54,45,-9,0,0,0,65.0,57.0,-8.0,0.0,6000000.0,6000000.0
thomm101,Myles Thomas,Toronto,Toronto,1,1,1,2,1925,1925,0,-1.0,0.0,1.0,143,0,-143,97,0,-97,827.0,0.0,-827.0,0.0,0.0,0.0
thomm101,Myles Thomas,New York Yankees,YANKS,2,5,3,8,1932,1940,8,1.79,6.34,4.55,337,462,125,641,986,345,1980.0,2260.0,280.0,0.0,0.0,0.0
thomm102,Mike Thompson,Texas Rangers,RNGRS,5,9,7,16,1973,1978,5,27.38,17.18,-10.2,597,193,-404,206,0,-206,7753.0,3742.0,-4011.0,60000.0,160000.0,100000.0
thomm102,Mike Thompson,Atlanta Braves,BRAVES,1,1,1,2,1976,1976,0,0.0,0.0,0.0,0,7,7,0,7,7,0.0,0.0,0.0,0.0,0.0,0.0
thomm102,Mike Thompson,Cincinnati Reds,REDS,1,1,1,2,1976,1976,0,0.0,0.0,0.0,0,0,0,0,0,0,0.0,0.0,0.0,0.0,0.0,0.0
thomp101,Pinch Thomas,Boston Red Sox,RSOX,22,48,61,109,1917,1937,20,205.66,131.1,-74.56,9653,6423,-3230,27902,20755,-7147,27230.0,14799.0,-12431.0,136800.0,133950.0,-2850.0
thomr001,Roy Thomas,Philadelphia Phillies,PHILS,1,3,2,5,1975,1979,4,0.71,0.93,0.22,442,215,-227,1620,199,-1421,0.0,1610.0,1610.0,0.0,0.0,0.0
thomr001,Roy Thomas,Seattle Mariners,MARNRS,2,3,3,6,1977,1986,9,0.93,-0.1,-1.03,116,416,300,284,1201,917,19.0,0.0,-19.0,0.0,0.0,0.0
thomr001,Roy Thomas,Oakland Athletics,ATLTCS,4,7,6,13,1981,1985,4,8.77,6.3,-2.47,225,81,-144,0,4,4,2629.0,1218.0,-1411.0,600000.0,1225000.0,625000.0
thomr002,Rich Thompson,Cleveland Indians,INDINS,1,1,1,2,1985,1985,0,0.0,0.0,0.0,0,0,0,0,0,0,0.0,0.0,0.0,0.0,0.0,0.0
thomr004,Ryan Thompson,Toronto Blue Jays,BJAYS,1,2,1,3,1992,1992,0,11.81,1.64,-10.17,781,8,-773,3098,0,-3098,0.0,159.0,159.0,109000.0,4250000.0,4141000.0
thomr004,Ryan Thompson,New York Mets,METS,8,17,14,31,1996,2005,9,5.29,6.22,0.93,1355,2056,701,1632,3118,1486,2422.0,2738.0,316.0,19588333.0,14951666.0,-4636667.0
thomr004,Ryan Thompson,Cleveland Indians,INDINS,1,1,1,2,1997,1998,1,0.0,-0.29,-0.29,0,31,31,0,70,70,0.0,0.0,0.0,0.0,0.0,0.0
thomr005,Rich Thompson,Toronto Blue Jays,BJAYS,1,1,1,2,2003,2003,0,0.0,-0.6,-0.6,0,3,3,0,0,0,0.0,15.0,15.0,0.0,0.0,0.0
thomr005,Rich Thompson,San Diego Padres,PADRS,1,1,2,3,2003,2004,1,0.05,-0.25,-0.3,6,14,8,1,1,0,0.0,30.0,30.0,0.0,0.0,0.0
thomr005,Rich Thompson,Philadelphia Phillies,PHILS,1,1,1,2,2012,2012,0,-0.52,0.0,0.52,23,0,-23,24,0,-24,0.0,0.0,0.0,0.0,0.0,0.0
thoms001,Scot Thompson,San Francisco Giants,GIANTS,1,2,1,3,1985,1986,1,-1.74,-0.39,1.35,56,69,13,46,222,176,103.0,0.0,-103.0,552000.0,0.0,-552000.0
thoms102,Stan Thomas,Texas Rangers,RNGRS,1,2,1,3,1975,1982,7,2.82,-1.21,-4.03,325,301,-24,802,863,61,317.0,0.0,-317.0,0.0,0.0,0.0
thoms102,Stan Thomas,New York Yankees,YANKS,19,44,41,85,1977,1995,18,29.75,51.78,22.03,3287,4268,981,7585,11807,4222,7486.0,4403.0,-3083.0,3944706.0,6805000.0,2860294.0
thomt002,Trayce Thompson,Chicago White Sox,WSOX,3,7,6,13,2015,2017,2,4.46,5.75,1.29,441,251,-190,564,1001,437,693.0,30.0,-663.0,12535000.0,6150000.0,-6385000.0
thomt002,Trayce Thompson,Oakland Athletics,ATLTCS,1,1,1,2,2018,2018,0,-1.05,0.0,1.05,48,0,-48,130,0,-130,0.0,0.0,0.0,0.0,0.0,0.0
thomt103,Tommy Thomas,Washington Senators,TWINS,1,3,1,4,1935,1935,0,-0.51,0.0,0.51,66,0,-66,27,0,-27,256.0,0.0,-256.0,0.0,0.0,0.0
thomt103,Tommy Thomas,Baltimore,Baltimore,1,2,1,3,1925,1925,0,22.29,0.0,-22.29,491,0,-491,595,0,-595,4665.0,0.0,-4665.0,0.0,4800.0,4800.0
thomt105,Tommy Thompson,Boston Braves,BRAVES,7,21,11,32,1936,1952,16,22.0,38.45,16.45,1506,1907,401,5516,6570,1054,0.0,2449.0,2449.0,12500.0,0.0,-12500.0
thomt106,Tim Thompson,Brooklyn Dodgers,DOGRS,1,1,3,4,1956,1956,0,-0.25,0.0,0.25,173,0,-173,537,0,-537,0.0,0.0,0.0,0.0,0.0,0.0
thomt106,Tim Thompson,Kansas City Athletics,ATLTCS,31,62,61,123,1957,1976,19,95.85,56.38,-39.47,9593,6643,-2950,23097,19018,-4079,12004.0,6179.0,-5825.0,476100.0,606500.0,130400.0
thomv101,Valmy Thomas,San Francisco Giants,GIANTS,1,2,1,3,1958,1965,7,-2.23,13.08,15.31,168,471,303,186,541,355,408.0,4217.0,3809.0,0.0,0.0,0.0
thond001,Dickie Thon,California Angels,ANGELS,1,1,1,2,1981,1985,4,16.04,9.21,-6.83,566,90,-476,2013,0,-2013,0.0,1850.0,1850.0,0.0,0.0,0.0
thonj101,Jack Thoney,Toronto,Toronto,1,1,2,3,1907,1907,0,0.74,0.0,-0.74,148,0,-148,508,0,-508,0.0,0.0,0.0,0.0,3800.0,3800.0
thonj101,Jack Thoney,Boston Red Sox,RSOX,9,25,23,48,1912,1935,23,51.77,27.05,-24.72,3792,3039,-753,15081,11185,-3896,0.0,1203.0,1203.0,45050.0,29350.0,-15700.0
thora001,Andre Thornton,Philadelphia Phillies,PHILS,1,2,2,4,1972,1973,1,-1.32,-1.5,-0.18,90,36,-54,4,15,11,108.0,168.0,60.0,0.0,0.0,0.0
thora001,Andre Thornton,Atlanta Braves,BRAVES,1,1,1,2,1973,1973,0,5.17,-0.15,-5.32,271,3,-268,980,12,-968,0.0,0.0,0.0,0.0,0.0,0.0
thora001,Andre Thornton,Chicago Cubs,CUBS,3,3,5,8,1976,1980,4,1.24,1.37,0.13,77,682,605,219,1832,1613,160.0,648.0,488.0,0.0,0.0,0.0
thora001,Andre Thornton,Montreal Expos,NATEX,1,1,1,2,1976,1978,2,19.05,-0.41,-19.46,1225,84,-1141,5096,61,-5035,0.0,557.0,557.0,0.0,0.0,0.0
thorb102,Bob Thorpe,Detroit Tigers,TIGRS,2,2,2,4,1957,1958,1,-0.68,1.06,1.74,8,50,42,1,41,40,26.0,328.0,302.0,0.0,0.0,0.0
thorh101,Hank Thormahlen,New York Yankees,YANKS,4,8,10,18,1920,1931,11,18.87,48.71,29.84,1297,1673,376,4337,4022,-315,1020.0,6917.0,5897.0,44500.0,41500.0,-3000.0
thorj101,Jim Thorpe,New York Giants,GIANTS,1,1,1,2,1919,1919,0,0.58,0.42,-0.16,60,14,-46,168,8,-160,0.0,68.0,68.0,3913.0,3000.0,-913.0
thorj102,John Thornton,Milwaukee,Milwaukee,1,1,2,3,1891,1901,10,1.61,0.0,-1.61,84,0,-84,138,0,-138,843.0,0.0,-843.0,0.0,0.0,0.0
thorl001,Lou Thornton,Milwaukee Brewers,BREWRS,1,1,1,2,1989,1989,0,0.0,0.0,0.0,0,0,0,0,0,0,0.0,0.0,0.0,0.0,0.0,0.0
thorm001,Matt Thornton,Seattle Mariners,MARNRS,1,1,1,2,2006,2006,0,10.77,-0.06,-10.83,545,6,-539,1,9,8,1390.0,0.0,-1390.0,0.0,0.0,0.0
thorm001,Matt Thornton,Chicago White Sox,WSOX,4,7,6,13,2013,2020,7,3.55,16.12,12.57,359,440,81,1313,1933,620,399.0,102.0,-297.0,3255000.0,11824334.0,8569334.0
thorp101,Paul Thormodsgard,Minnesota Twins,TWINS,1,1,1,2,1979,1981,2,0.0,-0.3,-0.3,0,185,185,0,579,579,0.0,0.0,0.0,0.0,0.0,0.0
thort001,Tyler Thornburg,Milwaukee Brewers,BREWRS,2,2,6,8,2016,2019,3,1.72,7.43,5.71,199,464,265,473,1467,994,128.0,121.0,-7.0,513900.0,2015000.0,1501100.0
thort002,Trent Thornton,Houston Astros,ASTROS,1,1,1,2,2018,2018,0,1.08,0.0,-1.08,77,0,-77,3,0,-3,627.0,0.0,-627.0,0.0,2000000.0,2000000.0
throf101,Faye Throneberry,Boston Red Sox,RSOX,3,5,4,9,1957,1961,4,-1.86,-2.15,-0.29,679,212,-467,1371,205,-1166,1950.0,366.0,-1584.0,0.0,36500.0,36500.0
throg101,George Throop,Kansas City Royals,ROYALS,1,1,1,2,1979,1980,1,-0.01,0.0,0.01,28,0,-28,3,0,-3,67.0,0.0,-67.0,0.0,0.0,0.0
throm101,Marv Throneberry,New York Yankees,YANKS,4,7,6,13,1959,1969,10,14.99,27.57,12.58,1233,1032,-201,4340,4017,-323,296.0,0.0,-296.0,175000.0,51000.0,-124000.0
throm101,Marv Throneberry,Kansas City Athletics,ATLTCS,1,1,1,2,1961,1963,2,-0.46,-1.04,-0.58,65,67,2,121,208,87,0.0,0.0,0.0,0.0,0.0,0.0
throm101,Marv Throneberry,Baltimore Orioles,ORLS,1,1,2,3,1962,1963,1,0.1,0.38,0.28,130,62,-68,411,190,-221,0.0,0.0,0.0,0.0,0.0,0.0
thurm001,Mark Thurmond,San Diego Padres,PADRS,1,1,1,2,1986,1986,0,1.85,-0.32,-2.17,75,48,-27,0,12,12,340.0,184.0,-156.0,270000.0,550000.0,280000.0
thurm001,Mark Thurmond,Detroit Tigers,TIGRS,1,1,1,2,1988,1988,0,-0.03,-1.01,-0.98,92,105,13,0,327,327,494.0,0.0,-494.0,0.0,0.0,0.0
thurs101,Sloppy Thurston,Chicago White Sox,WSOX,1,2,1,3,1927,1927,0,2.1,1.22,-0.88,71,68,-3,101,246,145,616.0,0.0,-616.0,0.0,0.0,0.0
thurs101,Sloppy Thurston,Brooklyn Dodgers,DOGRS,1,4,1,5,1933,1933,0,0.0,0.0,0.0,0,0,0,0,0,0,0.0,0.0,0.0,0.0,0.0,0.0
tianl101,Luis Tiant,Cleveland Indians,INDINS,15,21,26,47,1969,1984,15,48.37,39.17,-9.2,3144,4059,915,8529,12020,3491,2855.0,3764.0,909.0,351750.0,418600.0,66850.0
tibbj001,Jay Tibbs,New York Mets,METS,1,3,1,4,1984,1987,3,3.5,-0.12,-3.62,99,72,-27,111,61,-50,956.0,505.0,-451.0,0.0,0.0,0.0
tibbj001,Jay Tibbs,Cincinnati Reds,REDS,3,6,4,10,1985,1988,3,12.45,4.93,-7.52,892,228,-664,620,336,-284,4251.0,1549.0,-2702.0,1777500.0,937500.0,-840000.0
tibbj001,Jay Tibbs,Montreal Expos,NATEX,4,6,7,13,1988,1996,8,-0.35,1.55,1.9,76,567,491,0,268,268,1095.0,805.0,-290.0,625000.0,705000.0,80000.0
tibbj001,Jay Tibbs,Baltimore Orioles,ORLS,1,1,1,2,1990,1990,0,0.11,-0.07,-0.18,10,4,-6,0,0,0,21.0,11.0,-10.0,335000.0,0.0,-335000.0
tidrd001,Dick Tidrow,Cleveland Indians,INDINS,5,10,12,22,1974,1980,6,19.8,1.33,-18.47,1334,439,-895,4058,397,-3661,2358.0,2962.0,604.0,38000.0,65000.0,27000.0
tidrd001,Dick Tidrow,New York Yankees,YANKS,1,1,1,2,1979,1979,0,5.44,-0.93,-6.37,526,15,-511,29,0,-29,1191.0,83.0,-1108.0,0.0,0.0,0.0
tidrd001,Dick Tidrow,Chicago Cubs,CUBS,3,6,6,12,1983,1990,7,9.95,11.91,1.96,748,630,-118,2292,307,-1985,429.0,3028.0,2599.0,890000.0,85000.0,-805000.0
tiefb101,Bobby Tiefenauer,St. Louis Cardinals,CARDS,2,4,3,7,1955,1958,3,5.63,6.35,0.72,262,260,-2,209,244,35,1575.0,1954.0,379.0,0.0,0.0,0.0
tiefb101,Bobby Tiefenauer,Detroit Tigers,TIGRS,1,2,2,4,1956,1956,0,0.0,0.0,0.0,0,0,0,0,0,0,0.0,0.0,0.0,0.0,0.0,0.0
tiefb101,Bobby Tiefenauer,Toronto,Toronto,1,1,2,3,1958,1958,0,-0.02,0.0,0.02,52,0,-52,3,0,-3,128.0,0.0,-128.0,0.0,0.0,0.0
tiefb101,Bobby Tiefenauer,Houston Astros,ASTROS,1,1,1,2,1963,1963,0,0.0,0.0,0.0,0,0,0,0,0,0,0.0,0.0,0.0,0.0,0.0,0.0
tiefb101,Bobby Tiefenauer,St. Louis Cardinals,CARDS,1,1,1,2,1963,1964,1,1.09,0.0,-1.09,128,0,-128,23,0,-23,329.0,0.0,-329.0,0.0,0.0,0.0
tiefb101,Bobby Tiefenauer,Milwaukee Braves,BRAVES,2,4,4,8,1965,1970,5,-2.43,0.0,2.43,280,0,-280,53,0,-53,470.0,0.0,-470.0,12000.0,0.0,-12000.0
tiefb101,Bobby Tiefenauer,Cleveland Indians,INDINS,2,2,2,4,1968,1969,1,-0.71,-0.19,0.52,64,10,-54,37,0,-37,362.0,8.0,-354.0,0.0,0.0,0.0
tiefv101,Verle Tiefenthaler,San Francisco Giants,GIANTS,1,4,2,6,1962,1964,2,7.93,4.13,-3.8,685,341,-344,242,140,-102,2569.0,1260.0,-1309.0,0.0,0.0,0.0
tierc101,Cotton Tierney,Pittsburgh Pirates,PIRATS,1,3,2,5,1923,1926,3,3.4,4.98,1.58,247,281,34,625,924,299,954.0,681.0,-273.0,4200.0,5500.0,1300.0
tierc101,Cotton Tierney,Philadelphia Phillies,PHILS,1,1,2,3,1923,1925,2,-0.32,-0.04,0.28,136,145,9,539,576,37,0.0,0.0,0.0,0.0,6000.0,6000.0
tierc101,Cotton Tierney,Boston Braves,BRAVES,1,1,1,2,1925,1926,1,-0.53,1.22,1.75,93,136,43,284,503,219,0.0,0.0,0.0,0.0,0.0,0.0
tierc101,Cotton Tierney,Brooklyn Dodgers,DOGRS,3,9,3,12,1926,1934,8,0.53,8.67,8.14,100,822,722,99,3036,2937,677.0,0.0,-677.0,30000.0,12000.0,-18000.0
tietl101,Les Tietje,Chicago White Sox,WSOX,1,1,1,2,1936,1936,0,-0.39,1.9,2.29,75,61,-14,50,79,29,427.0,586.0,159.0,0.0,5500.0,5500.0
tillb101,Bob Tillman,New York Yankees,YANKS,1,2,1,3,1967,1970,3,0.07,0.93,0.86,226,220,-6,711,719,8,0.0,0.0,0.0,6000.0,0.0,-6000.0
tillb101,Bob Tillman,Atlanta Braves,BRAVES,1,1,3,4,1970,1971,1,0.0,0.0,0.0,0,0,0,0,0,0,0.0,0.0,0.0,0.0,0.0,0.0
tillc001,Chris Tillman,Seattle Mariners,MARNRS,4,9,5,14,2008,2013,5,43.53,3.71,-39.82,1975,169,-1806,6859,413,-6446,3908.0,766.0,-3142.0,1000000.0,1300000.0,300000.0
tillr001,Rusty Tillman,New York Mets,METS,1,1,1,2,1985,1985,0,0.0,0.0,0.0,0,0,0,0,0,0,0.0,0.0,0.0,0.0,0.0,0.0
tillr001,Rusty Tillman,San Diego Padres,PADRS,1,1,2,3,1986,1986,0,0.04,0.5,0.46,22,36,14,42,1,-41,0.0,70.0,70.0,0.0,0.0,0.0
tillt101,Thad Tillotson,Los Angeles Dodgers,DOGRS,1,2,1,3,1966,1967,1,-0.61,1.03,1.64,100,104,4,20,351,331,326.0,0.0,-326.0,0.0,0.0,0.0
tilsc001,Charlie Tilson,St. Louis Cardinals,CARDS,1,1,1,2,2016,2017,1,-1.57,1.15,2.72,96,107,11,280,0,-280,0.0,125.0,125.0,0.0,0.0,0.0
timlm001,Mike Timlin,Toronto Blue Jays,BJAYS,1,2,1,3,1997,2002,5,1.41,11.51,10.1,180,698,518,0,2901,2901,633.0,0.0,-633.0,1485000.0,0.0,-1485000.0
timlm001,Mike Timlin,Baltimore Orioles,ORLS,2,3,3,6,2000,2004,4,1.52,3.04,1.52,282,270,-12,37,1020,983,490.0,0.0,-490.0,4250000.0,200000.0,-4050000.0
timlm001,Mike Timlin,St. Louis Cardinals,CARDS,2,4,4,8,2002,2009,7,23.28,30.12,6.84,951,826,-125,3803,3406,-397,107.0,0.0,-107.0,7000000.0,8600000.0,1600000.0
timmo001,Ozzie Timmons,Chicago Cubs,CUBS,1,2,1,3,1997,1997,0,0.02,0.0,-0.02,6,0,-6,9,0,-9,0.0,0.0,0.0,0.0,0.0,0.0
timmt101,Tom Timmermann,Detroit Tigers,TIGRS,2,4,2,6,1973,1975,2,0.22,-0.05,-0.27,33,98,65,0,215,215,403.0,135.0,-268.0,27500.0,0.0,-27500.0
tingr001,Ron Tingley,San Diego Padres,PADRS,1,1,1,2,1984,1984,0,0.0,0.0,0.0,0,0,0,0,0,0,0.0,0.0,0.0,0.0,0.0,0.0
tingr001,Ron Tingley,Cleveland Indians,INDINS,1,1,1,2,1989,1990,1,0.65,-0.22,-0.87,183,8,-175,387,12,-375,0.0,0.0,0.0,0.0,0.0,0.0
tinkj101,Joe Tinker,Chicago Cubs,CUBS,1,3,5,8,1912,1913,1,3.8,1.08,-2.72,112,82,-30,420,326,-94,0.0,0.0,0.0,7925.0,9780.0,1855.0
tinnb101,Bud Tinning,Chicago Cubs,CUBS,1,3,1,4,1934,1940,6,-0.12,5.38,5.5,10,264,254,1,289,288,23.0,2233.0,2210.0,0.0,0.0,0.0
tinoj001,Jesus Tinoco,Toronto Blue Jays,BJAYS,1,4,2,6,2015,2018,3,-2.36,5.17,7.53,267,257,-10,284,987,703,875.0,49.0,-826.0,0.0,0.0,0.0
tinoj001,Jesus Tinoco,Colorado Rockies,ROCKS,1,1,1,2,2020,2020,0,0.2,0.0,-0.2,3,0,-3,0,0,0,15.0,0.0,-15.0,0.0,0.0,0.0
tinsl001,Lee Tinsley,Oakland Athletics,ATLTCS,1,2,1,3,1991,1991,0,0.0,-0.69,-0.69,0,56,56,0,204,204,0.0,0.0,0.0,0.0,0.0,0.0
tinsl001,Lee Tinsley,Seattle Mariners,MARNRS,1,1,1,2,1994,2009,15,2.69,0.0,-2.69,270,0,-270,768,0,-768,0.0,0.0,0.0,0.0,0.0,0.0
tinsl001,Lee Tinsley,Boston Red Sox,RSOX,2,4,5,9,1996,2011,15,0.04,46.15,46.11,391,2084,1693,170,5862,5692,732.0,3501.0,2769.0,2300000.0,0.0,-2300000.0
tinsl001,Lee Tinsley,Philadelphia Phillies,PHILS,1,1,1,2,1996,1996,0,-0.62,0.0,0.62,92,0,-92,209,0,-209,0.0,0.0,0.0,225000.0,0.0,-225000.0
tipte101,Eric Tipton,Philadelphia Athletics,ATLTCS,1,2,1,3,1941,1941,0,0.0,0.0,0.0,0,0,0,0,0,0,0.0,0.0,0.0,7500.0,0.0,-7500.0
tipte101,Eric Tipton,New York Yankees,YANKS,1,1,2,3,1942,1942,0,8.15,0.0,-8.15,451,0,-451,1756,0,-1756,0.0,0.0,0.0,0.0,0.0,0.0
tiptj101,Joe Tipton,Cleveland Indians,INDINS,15,27,25,52,1948,1968,20,162.56,72.5,-90.06,7529,3103,-4426,24130,8852,-15278,13186.0,8500.0,-4686.0,30900.0,42000.0,11100.0
tiptj101,Joe Tipton,Chicago White Sox,WSOX,7,9,10,19,1949,1976,27,1.76,48.29,46.53,980,3043,2063,2144,11322,9178,489.0,1217.0,728.0,27000.0,17000.0,-10000.0
tiptj101,Joe Tipton,Cleveland Indians,INDINS,1,1,1,2,1954,1954,0,0.59,0.08,-0.51,54,4,-50,193,8,-185,0.0,0.0,0.0,0.0,0.0,0.0
tituj101,John Titus,Philadelphia Phillies,PHILS,1,1,1,2,1912,1913,1,3.7,0.46,-3.24,183,136,-47,734,285,-449,0.0,0.0,0.0,0.0,3600.0,3600.0
tobid001,Dave Tobik,Detroit Tigers,TIGRS,1,1,1,2,1983,1987,4,1.06,4.64,3.58,51,361,310,0,939,939,259.0,0.0,-259.0,0.0,0.0,0.0
tobij101,Jack Tobin,St.Louis Browns,ORLS,23,43,52,95,1926,1952,26,132.07,125.15,-6.92,6541,9540,2999,21287,29892,8605,12928.0,19199.0,6271.0,217500.0,195450.0,-22050.0
tobij103,Jim Tobin,Pittsburgh Pirates,PIRATS,1,2,1,3,1939,1947,8,20.23,6.51,-13.72,447,292,-155,628,168,-460,4101.0,1592.0,-2509.0,10000.0,4500.0,-5500.0
todda101,Al Todd,Philadelphia Phillies,PHILS,6,6,12,18,1935,1946,11,47.95,20.5,-27.45,1477,1508,31,3069,3345,276,8600.0,5759.0,-2841.0,8000.0,9500.0,1500.0
todda101,Al Todd,Pittsburgh Pirates,PIRATS,1,3,1,4,1938,1941,3,0.0,-0.2,-0.2,0,90,90,0,209,209,0.0,0.0,0.0,0.0,0.0,0.0
todda101,Al Todd,Boston Braves,BRAVES,1,1,1,2,1939,1946,7,0.42,0.29,-0.13,86,210,124,266,200,-66,0.0,1618.0,1618.0,0.0,0.0,0.0
todda101,Al Todd,Brooklyn Dodgers,DOGRS,2,4,3,7,1939,1949,10,-0.11,3.64,3.75,242,623,381,841,2080,1239,0.0,101.0,101.0,10000.0,12500.0,2500.0
toddj001,Jess Todd,St. Louis Cardinals,CARDS,1,2,1,3,2009,2009,0,4.0,0.42,-3.58,311,68,-243,0,262,262,883.0,0.0,-883.0,0.0,5500000.0,5500000.0
toddj101,Jackson Todd,New York Mets,METS,1,1,1,2,1978,1978,0,0.0,0.0,0.0,0,0,0,0,0,0,0.0,0.0,0.0,0.0,0.0,0.0
toddj102,Jim Todd,Chicago Cubs,CUBS,2,2,3,5,1975,1977,2,-0.16,-0.83,-0.67,260,159,-101,200,245,45,857.0,0.0,-857.0,0.0,0.0,0.0
toddj102,Jim Todd,Oakland Athletics,ATLTCS,1,1,1,2,1977,1978,1,-1.48,3.4,4.88,40,55,15,2,0,-2,92.0,442.0,350.0,0.0,0.0,0.0
toddj102,Jim Todd,Chicago Cubs,CUBS,3,4,4,8,1977,1979,2,4.22,1.01,-3.21,882,153,-729,2458,300,-2158,817.0,108.0,-709.0,0.0,0.0,0.0
todtp101,Phil Todt,Philadelphia Athletics,ATLTCS,4,8,4,12,1931,1934,3,0.0,-0.85,-0.85,0,42,42,0,71,71,0.0,34.0,34.0,7600.0,0.0,-7600.0
todtp101,Phil Todt,SanAntonio,SanAntonio,1,5,1,6,1923,1923,0,9.54,0.0,-9.54,1176,0,-1176,4721,0,-4721,0.0,0.0,0.0,0.0,0.0,0.0
tolab101,Bobby Tolan,St. Louis Cardinals,CARDS,4,7,5,12,1968,1971,3,20.24,2.27,-17.97,1458,401,-1057,4171,1565,-2606,1006.0,0.0,-1006.0,87500.0,15000.0,-72500.0
tolab101,Bobby Tolan,Cincinnati Reds,REDS,3,4,4,8,1973,1977,4,0.21,0.35,0.14,831,242,-589,1153,359,-794,1183.0,1024.0,-159.0,0.0,0.0,0.0
tolej001,Jose Tolentino,Oakland Athletics,ATLTCS,1,1,2,3,1987,1987,0,0.0,0.0,0.0,0,0,0,0,0,0,0.0,0.0,0.0,0.0,0.0,0.0
tolif001,Freddie Toliver,New York Yankees,YANKS,2,4,3,7,1981,1988,7,1.81,9.6,7.79,277,868,591,978,3230,2252,30.0,0.0,-30.0,1050000.0,1450000.0,400000.0
tolif001,Freddie Toliver,Cincinnati Reds,REDS,1,3,2,5,1985,1989,4,0.22,4.93,4.71,144,460,316,269,1695,1426,243.0,0.0,-243.0,117500.0,620000.0,502500.0
tolif001,Freddie Toliver,Philadelphia Phillies,PHILS,1,1,1,2,1988,1988,0,0.39,0.0,-0.39,29,0,-29,0,0,0,431.0,0.0,-431.0,0.0,0.0,0.0
tolif001,Freddie Toliver,Minnesota Twins,TWINS,1,1,1,2,1989,1989,0,-0.42,0.08,0.5,18,7,-11,0,0,0,42.0,26.0,-16.0,0.0,0.0,0.0
tolif001,Freddie Toliver,San Diego Padres,PADRS,1,2,2,4,1989,1990,1,-0.36,-0.39,-0.03,13,192,179,0,619,619,249.0,73.0,-176.0,775000.0,575000.0,-200000.0
tollb001,Brian Tollberg,Milwaukee Brewers,BREWRS,1,1,1,2,1997,1997,0,2.13,0.0,-2.13,104,0,-104,110,0,-110,922.0,0.0,-922.0,0.0,0.0,0.0
tollw001,Wayne Tolleson,Texas Rangers,RNGRS,5,8,10,18,1985,1992,7,27.49,15.69,-11.8,1300,776,-524,3930,3021,-909,3469.0,327.0,-3142.0,2890539.0,357500.0,-2533039.0
tollw001,Wayne Tolleson,Chicago White Sox,WSOX,1,3,3,6,1986,1991,5,0.75,-0.11,-0.86,650,316,-334,1809,1056,-753,0.0,0.0,0.0,475000.0,400873.0,-74127.0
tolsc101,Chick Tolson,Chicago Cubs,CUBS,1,2,1,3,1930,1931,1,0.0,0.38,0.38,0,39,39,0,178,178,0.0,0.0,0.0,10500.0,0.0,-10500.0
tomad101,Dick Tomanek,Cleveland Indians,INDINS,18,28,30,58,1958,1984,26,63.62,52.24,-11.38,5094,5420,326,14869,17997,3128,4436.0,3464.0,-972.0,307350.0,510600.0,203250.0
tomkb001,Brett Tomko,Cincinnati Reds,REDS,2,6,3,9,2000,2013,13,18.66,15.9,-2.76,696,1440,744,2678,3953,1275,381.0,721.0,340.0,8282695.0,396000.0,-7886695.0
tomkb001,Brett Tomko,Seattle Mariners,MARNRS,12,24,25,49,2001,2015,14,25.13,36.61,11.48,2313,2617,304,5473,8533,3060,4049.0,2794.0,-1255.0,29602500.0,19930000.0,-9672500.0
tomkb001,Brett Tomko,San Diego Padres,PADRS,1,1,2,3,2002,2003,1,0.08,-1.26,-1.34,65,128,63,78,2,-76,608.0,230.0,-378.0,1100000.0,245000.0,-855000.0
tomld001,Dave Tomlin,Cincinnati Reds,REDS,3,4,4,8,1973,1977,4,0.21,0.35,0.14,831,242,-589,1153,359,-794,1183.0,1024.0,-159.0,0.0,0.0,0.0
tomld001,Dave Tomlin,San Diego Padres,PADRS,5,10,7,17,1978,1984,6,16.75,8.81,-7.94,1038,562,-476,3623,1933,-1690,529.0,1480.0,951.0,0.0,0.0,0.0
tompr101,Ron Tompkins,Oakland Athletics,ATLTCS,3,6,4,10,1967,1972,5,-0.2,0.87,1.07,128,137,9,155,280,125,313.0,17.0,-296.0,33250.0,36000.0,2750.0
tompr101,Ron Tompkins,Atlanta Braves,BRAVES,1,1,1,2,1969,1969,0,0.0,0.0,0.0,0,0,0,0,0,0,0.0,0.0,0.0,0.0,25000.0,25000.0
tomst101,Tommy Toms,St. Louis Cardinals,CARDS,1,1,1,2,1979,1979,0,0.0,0.14,0.14,0,6,6,0,13,13,0.0,0.0,0.0,0.0,0.0,0.0
tonef101,Fred Toney,New York Giants,GIANTS,3,8,5,13,1922,1930,8,4.92,14.44,9.52,1096,750,-346,1706,1477,-229,6029.0,4662.0,-1367.0,17500.0,39500.0,22000.0
toolb101,Bert Tooley,Brooklyn Dodgers,DOGRS,1,1,1,2,1912,1914,2,0.0,0.1,0.1,0,80,80,0,200,200,0.0,0.0,0.0,2100.0,0.0,-2100.0
topos101,Specs Toporcer,Syracuse,Syracuse,1,1,3,4,1921,1933,12,6.03,0.0,-6.03,546,0,-546,1779,0,-1779,0.0,0.0,0.0,0.0,0.0,0.0
torbj101,Jeff Torborg,California Angels,ANGELS,1,1,1,2,1973,1973,0,0.0,0.0,0.0,0,0,0,0,0,0,0.0,0.0,0.0,30000.0,10000.0,-20000.0
torge101,Earl Torgeson,Seattle,Seattle,1,1,2,3,1946,1946,0,19.04,0.0,-19.04,720,0,-720,3001,0,-3001,0.0,0.0,0.0,0.0,0.0,0.0
torge101,Earl Torgeson,Milwaukee Braves,BRAVES,5,8,10,18,1953,1966,13,4.65,28.76,24.11,447,1818,1371,1596,5886,4290,15.0,0.0,-15.0,0.0,0.0,0.0
torge101,Earl Torgeson,Detroit Tigers,TIGRS,1,1,1,2,1957,1957,0,4.81,0.01,-4.8,397,65,-332,984,181,-803,0.0,0.0,0.0,0.0,22000.0,22000.0
toroa001,Abraham Toro,Houston Astros,ASTROS,1,2,2,4,2021,2021,0,1.64,0.78,-0.86,83,33,-50,253,0,-253,54.0,87.0,33.0,4000000.0,3500000.0,-500000.0
torra001,Andres Torres,San Francisco Giants,GIANTS,1,2,1,3,2011,2016,5,1.51,6.46,4.95,247,583,336,434,2471,2037,191.0,0.0,-191.0,3850000.0,3500000.0,-350000.0
torra002,Alex Torres,Anaheim Angels,ANGELS,1,3,1,4,2009,2011,2,9.82,-0.01,-9.83,598,38,-560,1637,7,-1630,198.0,564.0,366.0,405000.0,6000000.0,5595000.0
torra002,Alex Torres,Tampa Bay Devil Rays,RAYS,6,8,11,19,2014,2020,6,-0.42,14.29,14.71,628,826,198,687,1868,1181,884.0,1581.0,697.0,2158000.0,100000.0,-2058000.0
torra002,Alex Torres,San Diego Padres,PADRS,2,2,3,5,2015,2019,4,0.89,-1.48,-2.37,134,87,-47,1,2,1,187.0,126.0,-61.0,0.0,1500000.0,1500000.0
torra101,Angel Torres,St. Louis Cardinals,CARDS,7,10,11,21,1976,1992,16,18.25,16.78,-1.47,1455,1377,-78,2974,3172,198,3388.0,4921.0,1533.0,1943333.0,497500.0,-1445833.0
torra101,Angel Torres,Montreal Expos,NATEX,1,2,1,3,1977,1978,1,0.21,-0.44,-0.65,10,62,52,0,27,27,25.0,305.0,280.0,0.0,0.0,0.0
torrg001,Gleyber Torres,Chicago Cubs,CUBS,1,4,1,5,2016,2016,0,9.71,1.2,-8.51,545,54,-491,1768,0,-1768,353.0,80.0,-273.0,0.0,0.0,0.0
torrh101,Hector Torres,San Francisco Giants,GIANTS,3,4,4,8,1966,1971,5,8.87,-1.67,-10.54,806,276,-530,1416,715,-701,1801.0,0.0,-1801.0,0.0,13000.0,13000.0
torrh101,Hector Torres,California Angels,ANGELS,1,1,1,2,1967,1967,0,-2.95,0.23,3.18,231,26,-205,719,7,-712,0.0,91.0,91.0,0.0,0.0,0.0
torrh101,Hector Torres,Houston Astros,ASTROS,1,1,1,2,1970,1978,8,-0.04,4.23,4.27,31,1021,990,63,4100,4037,0.0,0.0,0.0,0.0,0.0,0.0
torrh101,Hector Torres,Chicago Cubs,CUBS,1,2,2,4,1972,1972,0,0.36,-1.6,-1.96,335,85,-250,844,8,-836,2.0,188.0,186.0,0.0,0.0,0.0
torrh101,Hector Torres,Houston Astros,ASTROS,1,1,1,2,1973,1973,0,0.0,0.0,0.0,0,0,0,0,0,0,0.0,0.0,0.0,16000.0,0.0,-16000.0
torrh101,Hector Torres,San Diego Padres,PADRS,2,4,2,6,1976,1981,5,20.22,7.28,-12.94,1143,413,-730,4572,857,-3715,0.0,1243.0,1243.0,0.0,0.0,0.0
torrh101,Hector Torres,Cleveland Indians,INDINS,3,5,6,11,1977,1980,3,-0.98,0.01,0.99,287,197,-90,716,415,-301,0.0,597.0,597.0,0.0,0.0,0.0
torrj001,Jose Torres,Oakland Athletics,ATLTCS,4,8,5,13,2015,2018,3,5.93,2.94,-2.99,610,354,-256,992,1020,28,691.0,108.0,-583.0,4517500.0,2983333.0,-1534167.0
torrj101,Joe Torre,Atlanta Braves,BRAVES,2,2,2,4,1969,1973,4,22.48,7.01,-15.47,921,431,-490,3912,1646,-2266,0.0,162.0,162.0,0.0,75000.0,75000.0
torrj101,Joe Torre,St. Louis Cardinals,CARDS,6,8,8,16,1974,1978,4,12.43,5.6,-6.83,1504,362,-1142,1454,839,-615,2982.0,616.0,-2366.0,202000.0,0.0,-202000.0
torrl001,Luis Torrens,Cincinnati Reds,REDS,2,3,3,6,2016,2020,4,-1.12,0.1,1.22,206,115,-91,536,298,-238,0.0,23.0,23.0,0.0,4100000.0,4100000.0
torrl001,Luis Torrens,San Diego Padres,PADRS,1,4,3,7,2020,2021,1,5.43,0.42,-5.01,353,36,-317,1365,75,-1290,2.0,42.0,40.0,0.0,0.0,0.0
torrm001,Mike Torrez,St. Louis Cardinals,CARDS,3,5,4,9,1971,1971,0,3.53,0.17,-3.36,337,40,-297,618,85,-533,1940.0,21.0,-1919.0,27000.0,15000.0,-12000.0
torrm001,Mike Torrez,Montreal Expos,NATEX,1,2,3,5,1974,1976,2,33.5,-0.16,-33.66,1482,37,-1445,6072,69,-6003,812.0,232.0,-580.0,98500.0,147000.0,48500.0
torrm001,Mike Torrez,Baltimore Orioles,ORLS,5,15,15,30,1976,1988,12,24.68,74.72,50.04,1245,3374,2129,1799,7287,5488,7873.0,11309.0,3436.0,558333.0,0.0,-558333.0
torrm001,Mike Torrez,Oakland Athletics,ATLTCS,1,1,3,4,1977,1978,1,2.42,-2.3,-4.72,31,228,197,0,609,609,651.0,78.0,-573.0,100000.0,0.0,-100000.0
torrm001,Mike Torrez,Boston Red Sox,RSOX,1,1,1,2,1983,1983,0,-0.77,0.0,0.77,96,0,-96,85,0,-85,780.0,0.0,-780.0,0.0,0.0,0.0
torrp101,Pablo Torrealba,Oakland Athletics,ATLTCS,1,1,2,3,1978,1980,2,-0.37,5.31,5.68,28,338,310,0,1013,1013,189.0,453.0,264.0,0.0,0.0,0.0
torrr001,Ronald Torreyes,Cincinnati Reds,REDS,1,3,1,4,2011,2015,4,7.63,1.09,-6.54,509,203,-306,388,0,-388,2074.0,256.0,-1818.0,422500.0,1600000.0,1177500.0
torrr001,Ronald Torreyes,Los Angeles Dodgers,DOGRS,1,2,2,4,2016,2016,0,1.39,0.0,-1.39,222,40,-182,607,83,-524,8.0,0.0,-8.0,0.0,0.0,0.0
torrr001,Ronald Torreyes,New York Yankees,YANKS,1,1,1,2,2018,2018,0,0.0,0.0,0.0,0,0,0,0,0,0,0.0,0.0,0.0,615500.0,0.0,-615500.0
torrr101,Rusty Torres,New York Yankees,YANKS,5,8,9,17,1972,1987,15,9.09,48.73,39.64,1757,1810,53,5603,6602,999,883.0,1959.0,1076.0,246600.0,963000.0,716400.0
torrr101,Rusty Torres,Cleveland Indians,INDINS,1,3,1,4,1974,1974,0,0.32,-0.11,-0.43,178,15,-163,399,61,-338,0.0,0.0,0.0,19750.0,160000.0,140250.0
torrr101,Rusty Torres,Texas Rangers,RNGRS,5,9,9,18,1978,1982,4,22.0,5.65,-16.35,909,552,-357,2290,1222,-1068,4197.0,810.0,-3387.0,313000.0,280000.0,-33000.0
torrs001,Salomon Torres,San Francisco Giants,GIANTS,4,5,6,11,1995,2002,7,1.56,13.92,12.36,217,677,460,467,1531,1064,771.0,2970.0,2199.0,4725000.0,975000.0,-3750000.0
torrs001,Salomon Torres,Pittsburgh Pirates,PIRATS,1,1,2,3,2007,2008,1,0.79,-0.41,-1.2,140,24,-116,1,0,-1,240.0,51.0,-189.0,2733333.0,0.0,-2733333.0
torry001,Yorvit Torrealba,San Francisco Giants,GIANTS,1,2,1,3,2005,2009,4,0.09,12.27,12.18,42,666,624,119,2799,2680,0.0,0.0,0.0,715000.0,3750000.0,3035000.0
torry001,Yorvit Torrealba,Seattle Mariners,MARNRS,2,2,2,4,2005,2006,1,0.94,0.0,-0.94,373,0,-373,1383,0,-1383,0.0,0.0,0.0,0.0,316000.0,316000.0
torvk001,Kelvin Torve,San Francisco Giants,GIANTS,1,1,1,2,1985,1985,0,0.0,0.0,0.0,0,0,0,0,0,0,0.0,0.0,0.0,0.0,0.0,0.0
tostl101,Lou Tost,Hollywood,Hollywood,1,1,1,2,1941,1941,0,1.35,0.0,-1.35,76,0,-76,56,0,-56,460.0,0.0,-460.0,0.0,0.0,0.0
tothp101,Paul Toth,St. Louis Cardinals,CARDS,1,1,1,2,1962,1962,0,1.69,-0.06,-1.75,74,2,-72,59,1,-58,526.0,15.0,-511.0,0.0,0.0,0.0
tothp101,Paul Toth,Chicago Cubs,CUBS,2,4,4,8,1964,1966,2,41.31,1.04,-40.27,2470,267,-2203,10220,596,-9624,9.0,335.0,326.0,12000.0,0.0,-12000.0
tothp101,Paul Toth,New York Yankees,YANKS,1,2,1,3,1967,1968,1,0.0,0.0,0.0,0,0,0,0,0,0,0.0,0.0,0.0,0.0,0.0,0.0
toust001,Touki Toussaint,Arizona Diamondbacks,DBACKS,2,3,2,5,2015,2017,2,-1.46,1.06,2.52,118,146,28,80,316,236,435.0,0.0,-435.0,0.0,507500.0,507500.0
tovac101,Cesar Tovar,Cincinnati Reds,REDS,2,2,3,5,1964,1966,2,26.68,-0.65,-27.33,1125,61,-1064,4607,13,-4594,133.0,184.0,51.0,0.0,8500.0,8500.0
tovac101,Cesar Tovar,Minnesota Twins,TWINS,2,2,4,6,1972,1974,2,0.75,-1.38,-2.13,99,154,55,364,334,-30,22.0,133.0,111.0,55000.0,14500.0,-40500.0
townh101,Happy Townsend,Washington Senators,TWINS,1,1,1,2,1905,1907,2,0.0,1.73,1.73,0,73,73,0,101,101,0.0,688.0,688.0,0.0,0.0,0.0
townh101,Happy Townsend,Detroit Tigers,TIGRS,1,1,1,2,1905,1905,0,-0.74,0.0,0.74,34,0,-34,33,0,-33,278.0,0.0,-278.0,0.0,0.0,0.0
trabb001,Billy Traber,New York Mets,METS,3,9,8,17,2001,2008,7,12.43,-0.5,-12.93,1334,336,-998,2309,1012,-1297,1613.0,327.0,-1286.0,8000000.0,8077500.0,77500.0
tracd101,Dick Tracewski,Los Angeles Dodgers,DOGRS,4,5,5,10,1965,1970,5,16.33,5.42,-10.91,1557,311,-1246,3120,174,-2946,1193.0,662.0,-531.0,36500.0,17500.0,-19000.0
tracj101,Jim Tracy,Chicago Cubs,CUBS,1,1,1,2,1981,1986,5,0.0,0.76,0.76,0,378,378,0,690,690,0.0,0.0,0.0,0.0,0.0,0.0
tracs001,Steve Trachsel,Tampa Bay Devil Rays,RAYS,1,2,1,3,2000,2003,3,1.0,0.98,-0.02,34,198,164,0,846,846,251.0,0.0,-251.0,1000000.0,0.0,-1000000.0
tracs001,Steve Trachsel,Baltimore Orioles,ORLS,1,1,2,3,2007,2010,3,-0.48,-1.45,-0.97,8,90,82,7,155,148,52.0,100.0,48.0,3000000.0,0.0,-3000000.0
tragw101,Walt Tragesser,Philadelphia Phillies,PHILS,1,1,1,2,1921,1922,1,0.0,0.6,0.6,0,96,96,0,306,306,0.0,0.0,0.0,0.0,0.0,0.0
tramb001,Bubba Trammell,Tampa Bay Devil Rays,RAYS,1,2,2,4,2000,2003,3,0.01,4.03,4.02,189,316,127,73,802,729,294.0,1188.0,894.0,863000.0,0.0,-863000.0
tramb001,Bubba Trammell,New York Mets,METS,1,1,1,2,2000,2001,1,2.0,0.0,-2.0,275,64,-211,1011,0,-1011,0.0,128.0,128.0,0.0,700000.0,700000.0
tramb001,Bubba Trammell,San Diego Padres,PADRS,3,5,4,9,2003,2004,1,0.21,1.96,1.75,115,115,0,147,449,302,127.0,0.0,-127.0,5500000.0,0.0,-5500000.0
tramt001,Taylor Trammell,Cincinnati Reds,REDS,1,3,1,4,2019,2020,1,0.0,2.49,2.49,0,30,30,0,16,16,0.0,388.0,388.0,9700000.0,0.0,-9700000.0
tramt001,Taylor Trammell,San Diego Padres,PADRS,1,4,3,7,2020,2021,1,5.43,0.42,-5.01,353,36,-317,1365,75,-1290,2.0,42.0,40.0,0.0,0.0,0.0
trauj001,John Trautwein,Montreal Expos,NATEX,2,2,2,4,1988,1989,1,-0.61,0.0,0.61,9,0,-9,0,0,0,48.0,0.0,-48.0,0.0,0.0,0.0
travd001,Devon Travis,Detroit Tigers,TIGRS,1,1,1,2,2014,2017,3,5.83,0.44,-5.39,316,170,-146,1246,636,-610,0.0,0.0,0.0,0.0,0.0,0.0
travs001,Sam Travis,Boston Red Sox,RSOX,2,4,3,7,2020,2021,1,0.11,-0.27,-0.38,61,16,-45,0,0,0,216.0,61.0,-155.0,0.0,0.0,0.0
treag101,George Treadway,Baltimore Orioles,BLN,1,2,2,4,1894,1899,5,9.18,29.72,20.54,830,772,-58,3686,3764,78,0.0,0.0,0.0,0.0,0.0,0.0
treaj001,Jeff Treadway,Los Angeles Dodgers,DOGRS,2,4,3,7,1995,1996,1,1.62,-0.16,-1.78,426,245,-181,1244,564,-680,244.0,191.0,-53.0,305000.0,2000000.0,1695000.0
tream001,Matt Treanor,Kansas City Royals,ROYALS,1,1,1,2,1997,1999,2,2.01,0.2,-1.81,274,152,-122,832,0,-832,0.0,358.0,358.0,0.0,150000.0,150000.0
tream001,Matt Treanor,Milwaukee Brewers,BREWRS,1,1,1,2,2010,2010,0,-0.58,0.0,0.58,89,0,-89,284,0,-284,0.0,0.0,0.0,0.0,0.0,0.0
trecf101,Frank Trechock,Washington Senators,TWINS,2,7,2,9,1940,1943,3,7.97,0.58,-7.39,391,342,-49,1546,1354,-192,0.0,0.0,0.0,0.0,0.0,0.0
trecf101,Frank Trechock,New York Giants,GIANTS,2,7,5,12,1948,1954,6,0.0,-0.44,-0.44,0,186,186,0,308,308,0.0,172.0,172.0,0.0,0.0,0.0
treib001,Blake Treinen,Oakland Athletics,ATLTCS,8,15,10,25,2013,2018,5,10.44,2.58,-7.86,1089,362,-727,2080,1057,-1023,1184.0,312.0,-872.0,8300001.0,4800000.0,-3500001.0
treib001,Blake Treinen,Washington Nationals,NATEX,2,4,3,7,2017,2020,3,5.92,4.82,-1.1,246,410,164,62,3,-59,883.0,620.0,-263.0,8230366.0,0.0,-8230366.0
tresm101,Mike Tresh,Detroit Tigers,TIGRS,5,17,11,28,1937,1952,15,24.1,51.38,27.28,3640,2564,-1076,12152,7653,-4499,3951.0,7313.0,3362.0,74300.0,79500.0,5200.0
trest101,Tom Tresh,New York Yankees,YANKS,2,2,2,4,1969,1973,4,3.28,1.33,-1.95,467,344,-123,1321,850,-471,0.0,0.0,0.0,16000.0,7500.0,-8500.0
treva001,Alex Trevino,New York Mets,METS,1,3,1,4,1982,1986,4,1.8,4.68,2.88,378,655,277,630,2610,1980,505.0,0.0,-505.0,0.0,0.0,0.0
treva001,Alex Trevino,Atlanta Braves,BRAVES,1,1,1,2,1985,1987,2,0.49,-0.06,-0.55,57,3,-54,179,2,-177,0.0,0.0,0.0,0.0,0.0,0.0
treva001,Alex Trevino,San Francisco Giants,GIANTS,1,1,1,2,1985,1989,4,1.71,4.89,3.18,161,522,361,389,1862,1473,0.0,0.0,0.0,462500.0,140000.0,-322500.0
triag101,Gus Triandos,New York Yankees,YANKS,12,33,27,60,1954,1970,16,40.55,76.98,36.43,5201,4368,-833,16466,10777,-5689,3212.0,10751.0,7539.0,302500.0,109500.0,-193000.0
triag101,Gus Triandos,Baltimore Orioles,ORLS,1,2,1,3,1962,1962,0,0.46,0.0,-0.46,158,0,-158,435,0,-435,0.0,0.0,0.0,0.0,0.0,0.0
triag101,Gus Triandos,Detroit Tigers,TIGRS,2,4,4,8,1963,1970,7,32.41,16.87,-15.54,651,629,-22,1145,1412,267,4562.0,2945.0,-1617.0,39000.0,0.0,-39000.0
trilm001,Manny Trillo,Oakland Athletics,ATLTCS,1,3,1,4,1974,1976,2,1.24,1.92,0.68,1157,275,-882,3065,1015,-2050,578.0,0.0,-578.0,69800.0,150000.0,80200.0
trilm001,Manny Trillo,Chicago Cubs,CUBS,9,17,19,36,1979,1990,11,20.77,12.9,-7.87,2689,1303,-1386,6948,2680,-4268,1072.0,3217.0,2145.0,890000.0,85000.0,-805000.0
trilm001,Manny Trillo,Philadelphia Phillies,PHILS,5,11,8,19,1982,1999,17,22.81,28.42,5.61,2142,1948,-194,7615,5685,-1930,390.0,1257.0,867.0,2950000.0,165000.0,-2785000.0
trilm001,Manny Trillo,Cleveland Indians,INDINS,1,1,2,3,1983,1983,0,0.28,0.0,-0.28,31,0,-31,136,0,-136,0.0,0.0,0.0,375000.0,0.0,-375000.0
trilm001,Manny Trillo,San Francisco Giants,GIANTS,1,1,1,2,1985,1986,1,0.74,0.0,-0.74,265,0,-265,593,0,-593,0.0,0.0,0.0,709714.0,0.0,-709714.0
tripc101,Coaker Triplett,St. Louis Cardinals,CARDS,1,3,2,5,1943,1946,3,7.07,3.43,-3.64,654,226,-428,2414,842,-1572,0.0,0.0,0.0,0.0,0.0,0.0
trlir001,Ricky Trlicek,Atlanta Braves,BRAVES,1,1,2,3,1989,1990,1,-0.11,-1.22,-1.11,2,67,65,0,204,204,5.0,0.0,-5.0,0.0,800000.0,800000.0
trlir001,Ricky Trlicek,Boston Red Sox,RSOX,1,1,1,2,1997,1997,0,-0.32,-0.16,0.16,18,3,-15,0,0,0,27.0,10.0,-17.0,184250.0,262500.0,78250.0
tromm001,Mike Trombley,Baltimore Orioles,ORLS,1,1,2,3,2001,2006,5,-0.47,1.42,1.89,38,279,241,0,871,871,70.0,30.0,-40.0,2333333.0,0.0,-2333333.0
tropn001,Nick Tropeano,Houston Astros,ASTROS,1,2,1,3,2014,2015,1,3.0,0.42,-2.58,223,73,-150,597,229,-368,587.0,0.0,-587.0,0.0,517500.0,517500.0
trotb101,Bill Trotter,St.Louis Browns,ORLS,1,2,2,4,1942,1947,5,0.79,6.64,5.85,98,330,232,296,878,582,122.0,1025.0,903.0,7500.0,7250.0,-250.0
troud101,Dizzy Trout,Indianapolis,Indianapolis,1,2,3,5,1936,1936,0,49.01,0.0,-49.01,1002,0,-1002,1002,0,-1002,7777.0,0.0,-7777.0,0.0,0.0,0.0
troud101,Dizzy Trout,Detroit Tigers,TIGRS,18,41,43,84,1952,1964,12,49.33,53.4,4.07,4601,4657,56,11266,12496,1230,8483.0,9258.0,775.0,157700.0,102900.0,-54800.0
trous001,Steve Trout,Chicago White Sox,WSOX,4,9,10,19,1983,1991,8,34.9,10.9,-24.0,2508,1101,-1407,7089,2979,-4110,3712.0,567.0,-3145.0,640000.0,879873.0,239873.0
trous001,Steve Trout,Chicago Cubs,CUBS,2,2,4,6,1987,1990,3,-0.54,-0.95,-0.41,14,52,38,0,9,9,139.0,133.0,-6.0,890000.0,85000.0,-805000.0
trous001,Steve Trout,New York Yankees,YANKS,3,5,5,10,1987,1994,7,0.83,10.26,9.43,742,738,-4,1734,1510,-224,631.0,1551.0,920.0,2400000.0,2999167.0,599167.0
trubc001,Chris Truby,Houston Astros,ASTROS,2,2,2,4,2002,2009,7,-0.8,5.27,6.07,147,469,322,481,1028,547,0.0,1403.0,1403.0,1500000.0,0.0,-1500000.0
trubc001,Chris Truby,Montreal Expos,NATEX,2,2,2,4,2002,2003,1,-2.04,-0.82,1.22,299,201,-98,686,540,-146,0.0,0.0,0.0,1095000.0,375000.0,-720000.0
trubh101,Harry Truby,Pittsburgh Pirates,PIRATS,1,4,2,6,1896,1898,2,3.6,0.48,-3.12,234,186,-48,984,763,-221,0.0,0.0,0.0,0.0,0.0,0.0
trucv101,Virgil Trucks,Detroit Tigers,TIGRS,13,25,26,51,1952,1968,16,25.92,52.07,26.15,2610,3104,494,6934,6097,-837,4331.0,10073.0,5742.0,79500.0,15900.0,-63600.0
trucv101,Virgil Trucks,St.Louis Browns,ORLS,16,39,39,78,1953,1988,35,62.78,132.67,69.89,3897,7526,3629,7249,20942,13693,16132.0,14151.0,-1981.0,815833.0,138400.0,-677433.0
trucv101,Virgil Trucks,Chicago White Sox,WSOX,6,9,11,20,1955,1969,14,12.94,20.18,7.24,1394,1327,-67,4462,4906,444,852.0,12.0,-840.0,77250.0,45000.0,-32250.0
trucv101,Virgil Trucks,Detroit Tigers,TIGRS,4,10,9,19,1956,1961,5,13.15,0.77,-12.38,602,579,-23,394,1616,1222,3228.0,40.0,-3188.0,13200.0,0.0,-13200.0
trucv101,Virgil Trucks,Kansas City Athletics,ATLTCS,3,4,4,8,1958,1960,2,-3.45,4.79,8.24,286,319,33,181,498,317,1056.0,779.0,-277.0,12500.0,34500.0,22000.0
trujm001,Mike Trujillo,Chicago White Sox,WSOX,1,2,1,3,1984,1985,1,0.0,-0.28,-0.28,0,12,12,0,16,16,0.0,0.0,0.0,0.0,0.0,0.0
trujm001,Mike Trujillo,Boston Red Sox,RSOX,3,7,5,12,1986,1993,7,7.37,8.49,1.12,984,1130,146,3351,3154,-197,369.0,1455.0,1086.0,1275000.0,132500.0,-1142500.0
trumm001,Mark Trumbo,Anaheim Angels,ANGELS,2,4,5,9,2013,2018,5,-0.66,6.84,7.5,224,159,-65,546,24,-522,593.0,2315.0,1722.0,540000.0,0.0,-540000.0
trumm001,Mark Trumbo,Arizona Diamondbacks,DBACKS,1,2,4,6,2015,2018,3,2.85,2.85,0.0,190,248,58,363,765,402,400.0,92.0,-308.0,0.0,2100000.0,2100000.0
trumm001,Mark Trumbo,Seattle Mariners,MARNRS,1,2,1,3,2015,2015,0,1.72,0.0,-1.72,407,0,-407,1659,0,-1659,0.0,0.0,0.0,6900000.0,514000.0,-6386000.0
tsitj101,John Tsitouris,Detroit Tigers,TIGRS,4,12,12,24,1957,1964,7,6.47,14.38,7.91,1197,947,-250,3186,1303,-1883,1459.0,3692.0,2233.0,20000.0,9000.0,-11000.0
tsitj101,John Tsitouris,Kansas City Athletics,ATLTCS,1,2,1,3,1961,1961,0,1.89,1.04,-0.85,216,93,-123,188,76,-112,1621.0,384.0,-1237.0,0.0,0.0,0.0
tsuty001,Yoshi Tsutsugo,Tampa Bay Devil Rays,RAYS,1,1,1,2,2021,2021,0,-0.08,0.0,0.08,12,0,-12,31,0,-31,0.0,0.0,0.0,7000000.0,0.0,-7000000.0
tubbg001,Greg Tubbs,Atlanta Braves,BRAVES,2,2,2,4,1990,1991,1,1.07,-0.04,-1.11,105,5,-100,275,1,-274,0.0,0.0,0.0,0.0,0.0,0.0
tucke001,Eddie Tucker,Houston Astros,ASTROS,1,1,1,2,1995,1996,1,-0.14,0.0,0.14,17,0,-17,27,0,-27,0.0,0.0,0.0,0.0,0.0,0.0
tuckm001,Michael Tucker,Kansas City Royals,ROYALS,2,3,3,6,1997,2002,5,6.48,5.78,-0.7,926,799,-127,2620,3080,460,0.0,181.0,181.0,3800000.0,3550000.0,-250000.0
tuckm001,Michael Tucker,Atlanta Braves,BRAVES,2,6,5,11,1998,2002,4,23.0,11.12,-11.88,1472,1098,-374,4934,1979,-2955,1246.0,898.0,-348.0,12520000.0,11751680.0,-768320.0
tuckm001,Michael Tucker,Cincinnati Reds,REDS,2,2,3,5,2001,2005,4,1.18,-0.11,-1.29,63,28,-35,235,1,-234,0.0,76.0,76.0,1800000.0,795000.0,-1005000.0
tuckm001,Michael Tucker,Chicago Cubs,CUBS,1,1,1,2,2001,2002,1,0.26,0.0,-0.26,248,0,-248,981,0,-981,0.0,0.0,0.0,0.0,0.0,0.0
tuckm001,Michael Tucker,San Francisco Giants,GIANTS,1,1,1,2,2005,2005,0,-0.05,0.0,0.05,22,0,-22,21,0,-21,0.0,0.0,0.0,2000000.0,0.0,-2000000.0
tuckp001,Preston Tucker,Houston Astros,ASTROS,1,1,1,2,2017,2017,0,-0.01,0.0,0.01,80,0,-80,142,0,-142,0.0,0.0,0.0,0.0,0.0,0.0
tuckp001,Preston Tucker,Atlanta Braves,BRAVES,1,3,1,4,2018,2020,2,1.47,1.06,-0.41,203,131,-72,53,396,343,403.0,0.0,-403.0,565000.0,645000.0,80000.0
tuckt102,Thurman Tucker,Chicago White Sox,WSOX,1,1,1,2,1948,1949,1,0.34,-0.44,-0.78,221,66,-155,608,179,-429,0.0,0.0,0.0,0.0,0.0,0.0
tudoj001,John Tudor,Boston Red Sox,RSOX,3,3,3,6,1983,1987,4,5.36,6.23,0.87,299,579,280,871,2393,1522,636.0,0.0,-636.0,225000.0,0.0,-225000.0
tudoj001,John Tudor,Pittsburgh Pirates,PIRATS,3,8,8,16,1984,1992,8,29.05,20.57,-8.48,821,1486,665,1077,1551,474,5314.0,7059.0,1745.0,1030000.0,180000.0,-850000.0
tudoj001,John Tudor,St. Louis Cardinals,CARDS,1,1,1,2,1988,1992,4,1.28,1.7,0.42,30,500,470,18,2026,2008,200.0,0.0,-200.0,1100000.0,1720000.0,620000.0
tuftb101,Bob Tufts,San Francisco Giants,GIANTS,3,6,7,13,1982,1992,10,0.93,10.52,9.59,146,1038,892,148,1280,1132,952.0,5228.0,4276.0,0.0,0.0,0.0
tuftb101,Bob Tufts,Kansas City Royals,ROYALS,2,3,3,6,1983,1990,7,8.3,23.07,14.77,256,327,71,214,512,298,1914.0,3771.0,1857.0,1318000.0,662500.0,-655500.0
tuivs001,Sam Tuivailala,St. Louis Cardinals,CARDS,1,1,1,2,2018,2018,0,1.02,0.0,-1.02,29,0,-29,0,0,0,85.0,0.0,-85.0,554600.0,0.0,-554600.0
tulot001,Troy Tulowitzki,Colorado Rockies,ROCKS,4,6,8,14,2015,2020,5,9.83,-2.06,-11.89,514,266,-248,1003,284,-719,1008.0,871.0,-137.0,0.0,0.0,0.0
turbg101,George Turbeville,Philadelphia Athletics,ATLTCS,2,4,2,6,1938,1947,9,0.0,6.93,6.93,0,1140,1140,0,4751,4751,0.0,0.0,0.0,12000.0,13500.0,1500.0
turlb101,Bob Turley,Baltimore Orioles,ORLS,15,37,36,73,1954,1988,34,52.13,133.41,81.28,3638,7388,3750,6759,20843,14084,14284.0,13293.0,-991.0,815833.0,128400.0,-687433.0
turnj001,Justin Turner,Cincinnati Reds,REDS,1,3,2,5,2008,2011,3,-0.23,1.51,1.74,26,269,243,51,1011,960,0.0,0.0,0.0,3000000.0,7500000.0,4500000.0
turnj002,Jacob Turner,Detroit Tigers,TIGRS,1,3,2,5,2012,2017,5,-1.8,11.54,13.34,208,344,136,437,741,304,809.0,2395.0,1586.0,1175000.0,8000000.0,6825000.0
turnj002,Jacob Turner,Miami Marlins,MARLNS,1,1,2,3,2014,2014,0,-0.66,0.0,0.66,15,0,-15,10,0,-10,104.0,0.0,-104.0,0.0,0.0,0.0
turnj102,Jim Turner,Indianapolis,Indianapolis,1,1,1,2,1936,1936,0,9.04,0.0,-9.04,192,0,-192,270,0,-270,2042.0,0.0,-2042.0,0.0,0.0,0.0
turnj102,Jim Turner,Boston Braves,BRAVES,1,1,2,3,1939,1940,1,3.89,0.15,-3.74,101,18,-83,121,64,-57,909.0,0.0,-909.0,12500.0,4500.0,-8000.0
turnj102,Jim Turner,Cincinnati Reds,REDS,1,3,1,4,1942,1942,0,-0.7,0.0,0.7,176,38,-138,37,128,91,438.0,0.0,-438.0,0.0,0.0,0.0
turnm001,Matt Turner,Atlanta Braves,BRAVES,1,2,1,3,1991,1991,0,0.0,-0.43,-0.43,0,48,48,0,3,3,0.0,104.0,104.0,0.0,0.0,0.0
turnm001,Matt Turner,Florida Marlins,MARLNS,1,1,1,2,1994,1994,0,0.21,0.39,0.18,9,42,33,0,1,1,38.0,70.0,32.0,0.0,0.0,0.0
turns001,Shane Turner,New York Yankees,YANKS,1,2,1,3,1987,1987,0,-0.56,-0.16,0.4,55,65,10,124,184,60,0.0,0.0,0.0,62500.0,700000.0,637500.0
turns001,Shane Turner,Philadelphia Phillies,PHILS,1,1,1,2,1989,1989,0,-0.02,0.0,0.02,4,0,-4,1,0,-1,0.0,0.0,0.0,0.0,0.0,0.0
turnt001,Trea Turner,San Diego Padres,PADRS,2,6,5,11,2014,2020,6,27.48,-0.67,-28.15,849,63,-786,2993,31,-2962,1330.0,78.0,-1252.0,0.0,6850000.0,6850000.0
turnt001,Trea Turner,Washington Nationals,NATEX,1,2,4,6,2021,2021,0,4.89,0.24,-4.65,74,47,-27,252,110,-142,205.0,188.0,-17.0,47503480.0,0.0,-47503480.0
turnt101,Tuck Turner,Philadelphia Phillies,PHILS,1,3,1,4,1896,1900,4,-0.5,6.22,6.72,240,440,200,1079,2080,1001,0.0,0.0,0.0,0.0,0.0,0.0
turnt105,Terry Turner,Columbus,Columbus,1,1,2,3,1903,1905,2,38.48,0.0,-38.48,1619,0,-1619,6493,0,-6493,0.0,0.0,0.0,0.0,0.0,0.0
tuttb101,Bill Tuttle,Detroit Tigers,TIGRS,4,12,12,24,1957,1964,7,6.47,14.38,7.91,1197,947,-250,3186,1303,-1883,1459.0,3692.0,2233.0,20000.0,9000.0,-11000.0
tuttb101,Bill Tuttle,Kansas City Athletics,ATLTCS,2,3,5,8,1961,1963,2,-0.83,2.26,3.09,294,240,-54,628,222,-406,40.0,738.0,698.0,0.0,0.0,0.0
twitw101,Wayne Twitchell,Milwaukee Brewers,BREWRS,10,24,23,47,1971,1984,13,40.35,84.88,44.53,2851,4171,1320,6365,14852,8487,12446.0,5331.0,-7115.0,466901.0,45000.0,-421901.0
twitw101,Wayne Twitchell,Philadelphia Phillies,PHILS,12,28,21,49,1977,1999,22,39.49,55.77,16.28,5043,4716,-327,14497,10321,-4176,7936.0,3859.0,-4077.0,2950000.0,1495000.0,-1455000.0
twomb101,Babe Twombly,Chicago Cubs,CUBS,2,8,5,13,1921,1926,5,29.39,11.6,-17.79,1120,351,-769,4097,694,-3403,1929.0,2961.0,1032.0,13500.0,18700.0,5200.0
tyacj101,Jim Tyack,Philadelphia Athletics,ATLTCS,1,1,1,2,1943,1944,1,0.0,-0.63,-0.63,0,32,32,0,138,138,0.0,0.0,0.0,3500.0,0.0,-3500.0
tyacj101,Jim Tyack,Philadelphia Athletics,ATLTCS,1,1,1,2,1943,1944,1,0.0,-0.63,-0.63,0,32,32,0,138,138,0.0,0.0,0.0,3500.0,0.0,-3500.0
tylel101,Lefty Tyler,Boston Braves,BRAVES,3,4,6,10,1918,1921,3,32.45,6.15,-26.3,1008,651,-357,2505,2581,76,5076.0,0.0,-5076.0,0.0,4800.0,4800.0
tynej001,Jason Tyner,New York Mets,METS,2,3,3,6,2000,2001,1,6.03,0.01,-6.02,591,253,-338,1813,73,-1740,1188.0,422.0,-766.0,0.0,1563000.0,1563000.0
tyroj101,Jim Tyrone,Chicago Cubs,CUBS,1,1,1,2,1977,1977,0,0.27,0.0,-0.27,96,0,-96,328,0,-328,0.0,0.0,0.0,0.0,0.0,0.0
tysom101,Mike Tyson,St. Louis Cardinals,CARDS,1,1,1,2,1979,1981,2,-1.51,-0.16,1.35,173,22,-151,466,6,-460,0.0,65.0,65.0,0.0,0.0,0.0
tysot102,Ty Tyson,Louisville,Louisville,2,2,3,5,1925,1926,1,3.49,0.0,-3.49,304,0,-304,1085,0,-1085,0.0,0.0,0.0,0.0,3600.0,3600.0
tysot102,Ty Tyson,Buffalo,Buffalo,1,1,2,3,1927,1928,1,-0.16,0.0,0.16,59,0,-59,229,0,-229,0.0,0.0,0.0,0.0,12000.0,12000.0
ueckb101,Bob Uecker,Milwaukee Braves,BRAVES,2,2,3,5,1964,1965,1,-0.33,-0.91,-0.58,133,91,-42,390,156,-234,0.0,0.0,0.0,0.0,0.0,0.0
ueckb101,Bob Uecker,St. Louis Cardinals,CARDS,11,23,19,42,1965,1972,7,31.6,1.61,-29.99,3237,670,-2567,8420,1434,-6986,1865.0,703.0,-1162.0,32500.0,24000.0,-8500.0
ueckb101,Bob Uecker,Philadelphia Phillies,PHILS,3,4,4,8,1967,1974,7,-1.15,1.59,2.74,159,477,318,337,1585,1248,624.0,0.0,-624.0,32000.0,15000.0,-17000.0
uehak001,Koji Uehara,Baltimore Orioles,ORLS,2,2,3,5,2011,2016,5,1.34,20.41,19.07,98,1005,907,0,3248,3248,209.0,1190.0,981.0,7650000.0,442160.0,-7207840.0
uggld001,Dan Uggla,Florida Marlins,MARLNS,4,6,8,14,2010,2016,6,15.72,5.36,-10.36,961,1222,261,2736,1427,-1309,2987.0,1776.0,-1211.0,15800000.0,4875000.0,-10925000.0
uhalf101,Frenchy Uhalt,Oakland,Oakland,1,1,2,3,1933,1933,0,-0.04,0.0,0.04,57,0,-57,199,0,-199,0.0,0.0,0.0,0.0,4500.0,4500.0
uhlat101,Ted Uhlaender,Minnesota Twins,TWINS,2,5,4,9,1969,1971,2,19.42,3.86,-15.56,887,264,-623,3069,67,-3002,587.0,852.0,265.0,120000.0,70000.0,-50000.0
uhlat101,Ted Uhlaender,Cleveland Indians,INDINS,4,5,7,12,1971,1983,12,3.02,13.82,10.8,466,736,270,144,826,682,1581.0,2898.0,1317.0,116000.0,0.0,-116000.0
uhleg101,George Uhle,Cleveland Indians,INDINS,1,1,2,3,1928,1930,2,19.39,1.63,-17.76,319,74,-245,408,56,-352,2479.0,447.0,-2032.0,0.0,0.0,0.0
uhlem101,Maury Uhler,Cincinnati Reds,REDS,3,6,6,12,1914,1930,16,6.12,48.22,42.1,494,2027,1533,2101,8451,6350,0.0,27.0,27.0,0.0,3300.0,3300.0
umbaa101,Arnold Umbach,Atlanta Braves,BRAVES,1,3,2,5,1966,1968,2,0.94,-0.28,-1.22,101,10,-91,383,29,-354,0.0,0.0,0.0,57500.0,0.0,-57500.0
umbaj101,Jim Umbarger,Texas Rangers,RNGRS,6,12,10,22,1977,1982,5,21.67,6.59,-15.08,1054,693,-361,2707,1819,-888,4329.0,810.0,-3519.0,313000.0,280000.0,-33000.0
umbrj101,Jim Umbricht,Milwaukee Braves,BRAVES,1,1,1,2,1959,1959,0,-0.2,0.0,0.2,38,0,-38,10,0,-10,153.0,0.0,-153.0,0.0,0.0,0.0
umpht101,Tom Umphlett,Boston Red Sox,RSOX,1,2,1,3,1953,1953,0,2.57,0.0,-2.57,409,0,-409,921,0,-921,1057.0,0.0,-1057.0,0.0,0.0,0.0
umpht101,Tom Umphlett,Washington Senators,TWINS,7,16,14,30,1955,1963,8,11.54,-1.9,-13.44,1150,1625,475,3478,3777,299,832.0,1792.0,960.0,17500.0,14000.0,-3500.0
umpht101,Tom Umphlett,Boston Red Sox,RSOX,1,2,1,3,1962,1963,1,0.0,-0.22,-0.22,0,89,89,0,301,301,0.0,0.0,0.0,0.0,0.0,0.0
unded001,Duane Underwood,Chicago Cubs,CUBS,1,1,1,2,2021,2021,0,0.17,0.0,-0.17,82,0,-82,4,0,-4,218.0,0.0,-218.0,0.0,0.0,0.0
undep101,Pat Underwood,Detroit Tigers,TIGRS,1,1,1,2,1983,1983,0,0.0,0.75,0.75,0,59,59,0,149,149,0.0,0.0,0.0,0.0,0.0,0.0
undet001,Tom Underwood,Philadelphia Phillies,PHILS,3,5,4,9,1977,1983,6,1.29,13.57,12.28,795,776,-19,1705,2597,892,551.0,251.0,-300.0,300000.0,80000.0,-220000.0
undet001,Tom Underwood,St. Louis Cardinals,CARDS,8,20,14,34,1977,1992,15,72.28,107.29,35.01,5696,4011,-1685,17434,13849,-3585,7151.0,4578.0,-2573.0,1533333.0,19000.0,-1514333.0
undet001,Tom Underwood,Toronto Blue Jays,BJAYS,5,9,9,18,1979,1987,8,10.29,14.89,4.6,1883,1679,-204,6026,5403,-623,668.0,1848.0,1180.0,0.0,240000.0,240000.0
undet001,Tom Underwood,New York Yankees,YANKS,2,5,4,9,1981,1983,2,0.32,-0.84,-1.16,265,132,-133,447,432,-15,1046.0,0.0,-1046.0,250000.0,800000.0,550000.0
unglb101,Bob Unglaub,New York Yankees,YANKS,1,1,1,2,1904,1906,2,2.47,1.13,-1.34,263,234,-29,1019,989,-30,0.0,0.0,0.0,0.0,0.0,0.0
unsed101,Del Unser,Texas Rangers,RNGRS,15,34,23,57,1971,1988,17,48.57,49.18,0.61,3015,3170,155,9911,9907,-4,4375.0,6620.0,2245.0,528000.0,301000.0,-227000.0
unsed101,Del Unser,Cleveland Indians,INDINS,4,5,5,10,1972,1978,6,17.47,7.73,-9.74,1096,443,-653,3100,1364,-1736,0.0,1052.0,1052.0,33000.0,79000.0,46000.0
unsed101,Del Unser,Philadelphia Phillies,PHILS,2,4,4,8,1974,1984,10,23.16,7.68,-15.48,1035,1011,-24,3964,168,-3796,0.0,2166.0,2166.0,0.0,90000.0,90000.0
unsed101,Del Unser,New York Mets,METS,3,4,4,8,1976,1978,2,2.45,0.15,-2.3,488,71,-417,1259,171,-1088,0.0,0.0,0.0,0.0,0.0,0.0
uprid101,Dixie Upright,Chicago White Sox,WSOX,30,58,56,114,1953,1971,18,64.71,123.68,58.97,7642,8383,741,20635,20225,-410,7158.0,13512.0,6354.0,248750.0,225500.0,-23250.0
upshc101,Cecil Upshaw,Atlanta Braves,BRAVES,1,1,1,2,1973,1974,1,-0.14,0.12,0.26,70,51,-19,2,60,58,115.0,0.0,-115.0,37000.0,0.0,-37000.0
upshc101,Cecil Upshaw,Houston Astros,ASTROS,1,1,1,2,1973,1974,1,-0.05,-0.48,-0.43,7,68,61,0,1,1,24.0,135.0,111.0,0.0,31000.0,31000.0
upshc101,Cecil Upshaw,Cleveland Indians,INDINS,5,10,12,22,1974,1980,6,19.8,1.33,-18.47,1334,439,-895,4058,397,-3661,2358.0,2962.0,604.0,38000.0,65000.0,27000.0
upshc101,Cecil Upshaw,New York Yankees,YANKS,1,1,1,2,1974,1975,1,0.79,0.0,-0.79,29,1,-28,0,0,0,142.0,0.0,-142.0,0.0,29000.0,29000.0
uptob001,Melvin Upton,Atlanta Braves,BRAVES,4,8,11,19,2015,2021,6,6.43,9.54,3.11,663,1279,616,1140,3485,2345,998.0,1493.0,495.0,8100000.0,1673000.0,-6427000.0
uptob001,Melvin Upton,San Diego Padres,PADRS,1,2,1,3,2016,2016,0,-0.4,0.0,0.4,57,0,-57,165,0,-165,0.0,0.0,0.0,0.0,0.0,0.0
uptob101,Bill Upton,Cleveland Indians,INDINS,1,3,1,4,1954,1955,1,-0.18,-0.05,0.13,26,176,150,8,639,631,106.0,0.0,-106.0,0.0,0.0,0.0
uptoj001,Justin Upton,Arizona Diamondbacks,DBACKS,5,9,11,20,2013,2019,6,9.33,5.76,-3.57,709,1160,451,2798,2556,-242,0.0,1347.0,1347.0,0.0,0.0,0.0
uptoj001,Justin Upton,Atlanta Braves,BRAVES,2,4,6,10,2014,2019,5,3.78,1.55,-2.23,316,457,141,1233,1449,216,47.0,147.0,100.0,14250000.0,0.0,-14250000.0
uptoj001,Justin Upton,Detroit Tigers,TIGRS,1,1,2,3,2017,2017,0,2.06,0.0,-2.06,366,0,-366,1512,0,-1512,0.0,0.0,0.0,0.0,0.0,0.0
uptot101,Tom Upton,St.Louis Browns,ORLS,34,89,94,183,1951,1988,37,141.32,199.23,57.91,10082,16608,6526,23224,49618,26394,30166.0,18711.0,-11455.0,889583.0,189900.0,-699683.0
uptot101,Tom Upton,Chicago White Sox,WSOX,1,1,1,2,1951,1953,2,-0.1,-0.6,-0.5,5,64,59,7,155,148,0.0,0.0,0.0,0.0,0.0,0.0
uptot101,Tom Upton,Washington Senators,TWINS,17,30,33,63,1952,1963,11,45.18,4.68,-40.5,3039,4336,1297,10601,11469,868,1213.0,4683.0,3470.0,38500.0,14000.0,-24500.0
urbab101,Billy Urbanski,Boston Braves,BRAVES,1,1,1,2,1937,1938,1,0.0,-0.06,-0.06,0,21,21,0,39,39,0.0,0.0,0.0,0.0,0.0,0.0
urbaj101,Jack Urban,New York Yankees,YANKS,6,15,13,28,1957,1970,13,5.72,32.98,27.26,1633,2423,790,4235,5558,1323,2553.0,4978.0,2425.0,115500.0,43000.0,-72500.0
urbaj101,Jack Urban,Kansas City Athletics,ATLTCS,1,1,1,2,1959,1960,1,0.0,-0.22,-0.22,0,6,6,0,0,0,0.0,11.0,11.0,0.0,0.0,0.0
urbal101,Luke Urban,Boston Braves,BRAVES,1,3,1,4,1928,1928,0,0.0,-0.51,-0.51,0,14,14,0,6,6,0.0,65.0,65.0,10080.0,0.0,-10080.0
urbat001,Tom Urbani,St. Louis Cardinals,CARDS,1,2,2,4,1996,1997,1,-0.3,0.33,0.63,16,17,1,0,37,37,71.0,0.0,-71.0,180000.0,0.0,-180000.0
urbiu001,Ugueth Urbina,Montreal Expos,NATEX,2,2,3,5,2001,2005,4,3.55,9.62,6.07,161,226,65,78,284,206,910.0,1755.0,845.0,6950000.0,2350000.0,-4600000.0
urbiu001,Ugueth Urbina,Texas Rangers,RNGRS,2,4,6,10,2003,2007,4,30.69,2.87,-27.82,1192,174,-1018,3926,206,-3720,1767.0,481.0,-1286.0,4500000.0,0.0,-4500000.0
urbiu001,Ugueth Urbina,Detroit Tigers,TIGRS,1,2,1,3,2005,2009,4,-0.18,19.15,19.33,143,632,489,65,2819,2754,157.0,0.0,-157.0,5025000.0,4600000.0,-425000.0
urial001,Luis Urias,San Diego Padres,PADRS,2,8,4,12,2019,2020,1,4.06,1.62,-2.44,306,12,-294,771,0,-771,833.0,208.0,-625.0,6368900.0,24600000.0,18231100.0
uribj001,Jose Uribe,St. Louis Cardinals,CARDS,1,4,1,5,1985,1987,2,10.04,9.7,-0.34,1204,322,-882,3785,1371,-2414,620.0,0.0,-620.0,0.0,0.0,0.0
uribj002,Juan Uribe,Colorado Rockies,ROCKS,2,3,2,5,2003,2006,3,9.11,0.43,-8.68,1175,364,-811,4011,914,-3097,15.0,134.0,119.0,626000.0,1850000.0,1224000.0
uribj002,Juan Uribe,Los Angeles Dodgers,DOGRS,1,2,4,6,2015,2016,1,1.24,-0.01,-1.25,134,78,-56,167,142,-25,113.0,54.0,-59.0,0.0,0.0,0.0
uribj002,Juan Uribe,Atlanta Braves,BRAVES,5,11,7,18,2015,2021,6,3.57,1.27,-2.3,479,157,-322,663,322,-341,932.0,563.0,-369.0,21307500.0,11500000.0,-9807500.0
urrej101,John Urrea,St. Louis Cardinals,CARDS,9,26,18,44,1980,1992,12,83.63,101.91,18.28,6733,4351,-2382,20851,14642,-6209,6532.0,3025.0,-3507.0,1533333.0,576667.0,-956666.0
urshg001,Giovanny Urshela,Cleveland Indians,INDINS,1,1,1,2,2018,2018,0,-0.4,0.0,0.4,19,0,-19,46,0,-46,0.0,0.0,0.0,0.0,0.0,0.0
usheb101,Bob Usher,Cincinnati Reds,REDS,10,20,25,45,1951,1965,14,82.49,29.43,-53.06,4608,2904,-1704,14725,6918,-7807,2749.0,1517.0,-1232.0,76250.0,75500.0,-750.0
usheb101,Bob Usher,Cleveland Indians,INDINS,1,1,2,3,1957,1957,0,-0.4,0.0,0.4,96,0,-96,331,0,-331,0.0,0.0,0.0,0.0,8000.0,8000.0
utlec001,Chase Utley,Philadelphia Phillies,PHILS,4,7,7,14,2015,2018,3,5.57,0.72,-4.85,624,105,-519,2054,308,-1746,0.0,0.0,0.0,10527000.0,13400000.0,2873000.0
vacht101,Tex Vache,Boston Red Sox,RSOX,1,2,1,3,1925,1927,2,0.0,1.87,1.87,0,185,185,0,714,714,0.0,0.0,0.0,7200.0,7000.0,-200.0
vacht101,Tex Vache,Detroit Tigers,TIGRS,3,7,6,13,1925,1934,9,25.64,16.48,-9.16,1182,968,-214,3618,3598,-20,3712.0,0.0,-3712.0,12500.0,10000.0,-2500.0
vailm001,Mike Vail,St. Louis Cardinals,CARDS,4,5,5,10,1974,1977,3,-1.77,-0.4,1.37,404,34,-370,964,23,-941,66.0,23.0,-43.0,0.0,0.0,0.0
vailm001,Mike Vail,Cleveland Indians,INDINS,7,12,12,24,1978,2004,26,35.46,53.62,18.16,1913,2796,883,6764,10176,3412,2682.0,3776.0,1094.0,1767500.0,1412500.0,-355000.0
vailm001,Mike Vail,Chicago Cubs,CUBS,1,1,1,2,1980,1982,2,-0.4,-0.02,0.38,109,70,-39,228,148,-80,0.0,0.0,0.0,0.0,0.0,0.0
vailm001,Mike Vail,Cincinnati Reds,REDS,1,1,1,2,1983,1983,0,-0.2,-1.57,-1.37,18,66,48,27,24,-3,0.0,269.0,269.0,0.0,0.0,0.0
vailm001,Mike Vail,San Francisco Giants,GIANTS,1,1,1,2,1983,1984,1,0.56,-0.17,-0.73,34,7,-27,62,8,-54,0.0,0.0,0.0,0.0,0.0,0.0
valbl001,Luis Valbuena,Seattle Mariners,MARNRS,8,16,16,32,2008,2015,7,2.79,32.43,29.64,1083,1763,680,2877,5784,2907,720.0,2794.0,2074.0,18727500.0,15904400.0,-2823100.0
valbl001,Luis Valbuena,Chicago Cubs,CUBS,1,2,1,3,2015,2016,1,4.82,6.42,1.6,226,281,55,835,1241,406,50.0,0.0,-50.0,0.0,0.0,0.0
valdc003,Cesar Valdez,Arizona Diamondbacks,DBACKS,1,1,1,2,2010,2011,1,0.0,0.13,0.13,0,41,41,0,23,23,0.0,230.0,230.0,0.0,4300000.0,4300000.0
valdi001,Ismael Valdez,Los Angeles Dodgers,DOGRS,3,5,6,11,1999,2006,7,3.68,11.28,7.6,433,1170,737,1668,2480,812,416.0,1435.0,1019.0,12175000.0,11536000.0,-639000.0
valdi001,Ismael Valdez,Chicago Cubs,CUBS,1,1,3,4,2000,2002,2,-0.49,-0.56,-0.07,18,24,6,13,10,-3,120.0,98.0,-22.0,5737500.0,0.0,-5737500.0
valdi001,Ismael Valdez,Texas Rangers,RNGRS,1,1,2,3,2002,2003,1,0.16,-0.48,-0.64,8,24,16,0,54,54,148.0,0.0,-148.0,2500000.0,0.0,-2500000.0
valdi001,Ismael Valdez,San Diego Padres,PADRS,2,3,2,5,2004,2005,1,0.37,0.54,0.17,54,58,4,37,241,204,340.0,0.0,-340.0,800000.0,2150000.0,1350000.0
valdm001,Marc Valdes,Tampa Bay Devil Rays,RAYS,2,3,2,5,2000,2003,3,-0.29,3.35,3.64,103,238,135,3,757,754,170.0,0.0,-170.0,575000.0,6510000.0,5935000.0
valdm002,Mario Valdez,Minnesota Twins,TWINS,1,1,1,2,2000,2001,1,-0.21,-0.17,0.04,37,15,-22,79,40,-39,0.0,0.0,0.0,0.0,0.0,0.0
valdm003,Merkin Valdez,Atlanta Braves,BRAVES,1,2,1,3,2002,2004,2,0.14,4.84,4.7,172,133,-39,38,153,115,546.0,1251.0,705.0,215000.0,2862500.0,2647500.0
valdr002,Raul Valdes,Houston Astros,ASTROS,1,1,1,2,2014,2014,0,0.0,0.0,0.0,0,0,0,0,0,0,0.0,0.0,0.0,0.0,0.0,0.0
valds001,Sergio Valdez,Montreal Expos,NATEX,5,11,10,21,1989,2001,12,21.4,30.38,8.98,1830,1831,1,4276,2869,-1407,3122.0,2278.0,-844.0,1435000.0,850000.0,-585000.0
valds101,Sandy Valdespino,Atlanta Braves,BRAVES,1,1,1,2,1968,1969,1,-0.29,1.16,1.45,41,72,31,137,3,-134,0.0,117.0,117.0,0.0,0.0,0.0
valds101,Sandy Valdespino,Houston Astros,ASTROS,1,2,1,3,1969,1970,1,-0.73,-0.15,0.58,198,81,-117,682,308,-374,0.0,0.0,0.0,12000.0,69000.0,57000.0
valdw001,Wilson Valdez,Florida Marlins,MARLNS,1,2,1,3,2004,2004,0,0.33,0.26,-0.07,19,45,26,46,0,-46,0.0,77.0,77.0,0.0,6375000.0,6375000.0
valdw001,Wilson Valdez,Seattle Mariners,MARNRS,1,1,2,3,2005,2005,0,0.14,0.0,-0.14,9,0,-9,15,0,-15,0.0,0.0,0.0,316000.0,0.0,-316000.0
valdw001,Wilson Valdez,Kansas City Royals,ROYALS,1,1,1,2,2006,2006,0,0.41,0.0,-0.41,41,0,-41,80,0,-80,0.0,0.0,0.0,0.0,0.0,0.0
valdw001,Wilson Valdez,Philadelphia Phillies,PHILS,1,1,1,2,2012,2014,2,-1.68,0.43,2.11,77,118,41,208,0,-208,0.0,172.0,172.0,0.0,0.0,0.0
valeb001,Breyvic Valera,St. Louis Cardinals,CARDS,1,1,1,2,2018,2018,0,-0.2,0.0,0.2,20,0,-20,34,0,-34,0.0,0.0,0.0,0.0,0.0,0.0
valeb001,Breyvic Valera,Los Angeles Dodgers,DOGRS,1,5,1,6,2018,2018,0,-0.21,2.49,2.7,29,66,37,41,296,255,217.0,0.0,-217.0,0.0,16000000.0,16000000.0
valeb101,Benny Valenzuela,St. Louis Cardinals,CARDS,2,6,5,11,1958,1965,7,0.78,23.86,23.08,573,513,-60,1253,888,-365,694.0,3387.0,2693.0,0.0,12000.0,12000.0
valeb102,Bobby Valentine,Los Angeles Dodgers,DOGRS,1,5,2,7,1972,1976,4,16.6,19.03,2.43,596,356,-240,1923,542,-1381,1810.0,2591.0,781.0,251500.0,115000.0,-136500.0
valeb102,Bobby Valentine,California Angels,ANGELS,1,2,1,3,1975,1975,0,0.37,0.02,-0.35,66,1,-65,152,0,-152,0.0,15.0,15.0,0.0,0.0,0.0
valeb102,Bobby Valentine,San Diego Padres,PADRS,1,2,1,3,1977,1977,0,-0.17,0.36,0.53,215,56,-159,280,187,-93,168.0,0.0,-168.0,0.0,95000.0,95000.0
valec101,Corky Valentine,Cincinnati Reds,REDS,4,7,9,16,1956,1966,10,6.9,8.42,1.52,812,960,148,2097,3305,1208,111.0,126.0,15.0,0.0,10500.0,10500.0
valed001,Danny Valencia,Minnesota Twins,TWINS,1,1,1,2,2012,2012,0,-0.13,0.0,0.13,10,0,-10,29,0,-29,0.0,0.0,0.0,515000.0,0.0,-515000.0
valed001,Danny Valencia,Baltimore Orioles,ORLS,1,1,1,2,2013,2015,2,0.33,1.32,0.99,36,196,160,119,341,222,0.0,0.0,0.0,0.0,0.0,0.0
valed001,Danny Valencia,Kansas City Royals,ROYALS,2,2,3,5,2014,2015,1,1.34,-0.13,-1.47,175,23,-152,339,36,-303,234.0,58.0,-176.0,1065000.0,510200.0,-554800.0
valed001,Danny Valencia,Oakland Athletics,ATLTCS,1,1,1,2,2016,2016,0,1.0,0.0,-1.0,130,0,-130,500,0,-500,0.0,0.0,0.0,3150000.0,0.0,-3150000.0
valee001,Ellis Valentine,Montreal Expos,NATEX,10,15,18,33,1981,1996,15,5.79,9.59,3.8,1470,1819,349,2699,1445,-1254,2901.0,3210.0,309.0,955000.0,1022500.0,67500.0
valee002,Eric Valent,Philadelphia Phillies,PHILS,1,1,1,2,2003,2003,0,-0.3,0.08,0.38,18,7,-11,44,8,-36,0.0,0.0,0.0,0.0,1300000.0,1300000.0
valef001,Fernando Valenzuela,San Diego Padres,PADRS,4,10,11,21,1997,2006,9,5.86,22.51,16.65,827,1744,917,2661,6285,3624,68.0,189.0,121.0,10901680.0,12592500.0,1690820.0
valef101,Fred Valentine,Washington Senators,RNGRS,1,1,1,2,1968,1968,0,-0.23,-0.83,-0.6,47,26,-21,99,16,-83,0.0,146.0,146.0,0.0,17500.0,17500.0
valej001,Julio Valera,New York Mets,METS,1,1,2,3,1992,1992,0,2.22,2.15,-0.07,49,142,93,0,498,498,723.0,0.0,-723.0,0.0,1600000.0,1600000.0
valej003,Jose Valentin,San Diego Padres,PADRS,3,6,6,12,1992,2008,16,33.52,31.92,-1.6,1981,2091,110,6462,948,-5514,2787.0,3132.0,345.0,3375000.0,109000.0,-3266000.0
valej003,Jose Valentin,Milwaukee Brewers,BREWRS,1,2,2,4,2000,2000,0,18.62,-2.6,-21.22,696,55,-641,2756,47,-2709,354.0,437.0,83.0,0.0,0.0,0.0
valej004,Javier Valentin,Minnesota Twins,TWINS,1,2,2,4,2002,2002,0,-0.32,0.0,0.32,128,0,-128,72,0,-72,759.0,0.0,-759.0,0.0,0.0,0.0
valej004,Javier Valentin,Milwaukee Brewers,BREWRS,1,1,1,2,2003,2003,0,-0.18,-0.18,0.0,49,30,-19,142,52,-90,0.0,0.0,0.0,0.0,0.0,0.0
valej005,Joe Valentine,Chicago White Sox,WSOX,4,7,9,16,2002,2011,9,3.51,0.6,-2.91,386,338,-48,35,47,12,766.0,905.0,139.0,11095000.0,2433333.0,-8661667.0
valej005,Joe Valentine,Oakland Athletics,ATLTCS,1,3,1,4,2003,2003,0,14.51,0.2,-14.31,509,45,-464,479,186,-293,4166.0,0.0,-4166.0,0.0,0.0,0.0
valej006,Jesmuel Valentin,Los Angeles Dodgers,DOGRS,1,2,1,3,2014,2014,0,1.78,-0.44,-2.22,191,18,-173,89,15,-74,227.0,131.0,-96.0,0.0,0.0,0.0
valev101,Vito Valentinetti,Chicago Cubs,CUBS,1,2,1,3,1957,1965,8,-0.13,9.65,9.78,10,894,884,1,138,137,23.0,2255.0,2232.0,0.0,0.0,0.0
valev101,Vito Valentinetti,Cleveland Indians,INDINS,1,2,2,4,1958,1958,0,0.0,0.0,0.0,54,0,-54,37,0,-37,56.0,0.0,-56.0,0.0,0.0,0.0
valev101,Vito Valentinetti,Detroit Tigers,TIGRS,2,3,4,7,1958,1964,6,0.54,14.8,14.26,185,334,149,295,362,67,451.0,2919.0,2468.0,0.0,0.0,0.0
valev101,Vito Valentinetti,Washington Senators,TWINS,1,1,1,2,1959,1962,3,0.0,0.0,0.0,0,0,0,0,0,0,0.0,0.0,0.0,0.0,0.0,0.0
valld001,Dave Valle,Boston Red Sox,RSOX,1,1,1,2,1994,1994,0,0.5,0.23,-0.27,16,48,32,46,204,158,0.0,0.0,0.0,1200000.0,1100000.0,-100000.0
vallh101,Hector Valle,New York Mets,METS,1,1,1,2,1968,1969,1,0.0,1.13,1.13,0,46,46,0,12,12,0.0,191.0,191.0,0.0,0.0,0.0
valoe101,Elmer Valo,Philadelphia Phillies,PHILS,2,8,4,12,1957,1962,5,1.07,-3.22,-4.29,707,621,-86,1985,2063,78,115.0,0.0,-115.0,9000.0,0.0,-9000.0
valvj001,Jose Valverde,Arizona Diamondbacks,DBACKS,2,2,4,6,2007,2011,4,2.28,-1.01,-3.29,270,701,431,1,203,202,441.0,929.0,488.0,6185000.0,856000.0,-5329000.0
vanca101,Al Van Camp,Boston Red Sox,RSOX,9,16,13,29,1933,1943,10,54.55,36.98,-17.57,2815,1996,-819,9804,5822,-3982,4236.0,5439.0,1203.0,60350.0,84500.0,24150.0
vancd101,Dazzy Vance,Brooklyn Dodgers,DOGRS,1,2,2,4,1933,1934,1,1.18,1.07,-0.11,133,145,12,117,327,210,474.0,679.0,205.0,0.0,0.0,0.0
vande001,Ed Vande Berg,Seattle Mariners,MARNRS,1,1,1,2,1985,1986,1,0.6,-0.02,-0.62,120,50,-70,1,146,145,214.0,0.0,-214.0,315000.0,500000.0,185000.0
vandj001,John Vander Wal,Colorado Rockies,ROCKS,1,1,1,2,1998,1998,0,0.94,0.0,-0.94,152,0,-152,319,0,-319,0.0,0.0,0.0,560000.0,0.0,-560000.0
vandj001,John Vander Wal,San Diego Padres,PADRS,2,4,4,8,2000,2002,2,4.18,0.64,-3.54,373,277,-96,1290,508,-782,0.0,215.0,215.0,1750000.0,1850000.0,100000.0
vandj001,John Vander Wal,Pittsburgh Pirates,PIRATS,1,2,2,4,2001,2006,5,22.58,-2.33,-24.91,365,279,-86,551,301,-250,3209.0,841.0,-2368.0,5050000.0,310000.0,-4740000.0
vandj001,John Vander Wal,San Francisco Giants,GIANTS,1,1,1,2,2001,2002,1,0.36,1.38,1.02,84,86,2,245,5,-240,0.0,205.0,205.0,0.0,0.0,0.0
vandr001,Rick van den Hurk,Florida Marlins,MARLNS,1,1,1,2,2010,2010,0,-0.24,0.05,0.29,11,34,23,0,0,0,76.0,36.0,-40.0,0.0,1350000.0,1350000.0
vanej001,Jonathan Van Every,Boston Red Sox,RSOX,1,1,1,2,2010,2010,0,0.0,0.0,0.0,0,0,0,0,0,0,0.0,0.0,0.0,0.0,0.0,0.0
vanej001,Jonathan Van Every,Pittsburgh Pirates,PIRATS,1,1,1,2,2010,2010,0,-0.08,0.0,0.08,22,0,-22,21,0,-21,3.0,0.0,-3.0,0.0,0.0,0.0
vange101,Elam Vangilder,St.Louis Browns,ORLS,22,44,51,95,1927,1952,25,139.77,131.99,-7.78,6854,9855,3001,22708,32907,10199,12609.0,15510.0,2901.0,213500.0,207450.0,-6050.0
vanha001,Andy Van Hekken,Seattle Mariners,MARNRS,1,2,1,3,1999,2000,1,0.81,-1.0,-1.81,5,121,116,0,527,527,90.0,0.0,-90.0,0.0,1750000.0,1750000.0
vanhg101,George Van Haltren,Pittsburgh Pirates,PIRATS,1,2,1,3,1887,1887,0,5.98,2.8,-3.18,310,72,-238,1158,138,-1020,1220.0,967.0,-253.0,0.0,0.0,0.0
vanhg101,George Van Haltren,Baltimore Orioles,BLN,1,1,2,3,1892,1899,7,3.2,31.31,28.11,137,781,644,667,3624,2957,0.0,0.0,0.0,3500.0,0.0,-3500.0
vanmj001,Josh VanMeter,San Diego Padres,PADRS,2,5,4,9,2016,2021,5,5.2,-0.79,-5.99,462,106,-356,1663,243,-1420,2.0,42.0,40.0,0.0,0.0,0.0
vanmj001,Josh VanMeter,Cincinnati Reds,REDS,1,2,2,4,2020,2020,0,0.09,0.33,0.24,136,6,-130,368,0,-368,0.0,23.0,23.0,0.0,4100000.0,4100000.0
vanpt001,Todd Van Poppel,Texas Rangers,RNGRS,6,10,9,19,1998,2015,17,5.51,25.74,20.23,761,2021,1260,2144,8331,6187,1539.0,1259.0,-280.0,19651100.0,3670000.0,-15981100.0
vanrb001,Ben VanRyn,Montreal Expos,NATEX,1,1,1,2,1991,1991,0,0.0,0.0,0.0,0,0,0,0,0,0,0.0,0.0,0.0,0.0,0.0,0.0
vanrb001,Ben VanRyn,Los Angeles Dodgers,DOGRS,1,1,1,2,1994,1998,4,0.0,-0.13,-0.13,0,3,3,0,0,0,0.0,7.0,7.0,0.0,0.0,0.0
vanrb001,Ben VanRyn,California Angels,ANGELS,2,2,2,4,1996,1997,1,-0.03,0.05,0.08,31,22,-9,102,61,-41,0.0,15.0,15.0,0.0,375000.0,375000.0
vanrb001,Ben VanRyn,Chicago Cubs,CUBS,1,1,1,2,1998,1998,0,-0.14,0.13,0.27,12,44,32,0,15,15,8.0,149.0,141.0,170000.0,240000.0,70000.0
vansa001,Andy Van Slyke,St. Louis Cardinals,CARDS,1,3,1,4,1987,1989,2,43.01,2.18,-40.83,1782,406,-1376,6646,1435,-5211,1043.0,0.0,-1043.0,0.0,0.0,0.0
vansa001,Andy Van Slyke,Baltimore Orioles,ORLS,1,1,1,2,1995,1995,0,0.25,0.05,-0.2,63,3,-60,247,0,-247,0.0,12.0,12.0,600000.0,0.0,-600000.0
vanss001,Scott Van Slyke,Los Angeles Dodgers,DOGRS,2,4,3,7,2017,2019,2,0.0,-0.41,-0.41,0,127,127,0,39,39,0.0,126.0,126.0,1325000.0,14825000.0,13500000.0
vargc001,Claudio Vargas,Florida Marlins,MARLNS,2,6,6,12,2002,2005,3,-0.85,8.29,9.14,199,741,542,190,1520,1330,741.0,1719.0,978.0,6500000.0,9062500.0,2562500.0
vargc001,Claudio Vargas,Arizona Diamondbacks,DBACKS,7,17,19,36,2006,2018,12,24.81,35.93,11.12,1150,1382,232,1829,2226,397,7355.0,7967.0,612.0,18358000.0,18990000.0,632000.0
vargc001,Claudio Vargas,Los Angeles Dodgers,DOGRS,1,1,1,2,2009,2009,0,0.64,0.0,-0.64,89,0,-89,3,0,-3,150.0,0.0,-150.0,400000.0,0.0,-400000.0
vargj001,Jason Vargas,Florida Marlins,MARLNS,2,3,5,8,2006,2009,3,0.88,2.31,1.43,194,420,226,65,1,-64,750.0,584.0,-166.0,737000.0,0.0,-737000.0
vargj001,Jason Vargas,New York Mets,METS,1,7,3,10,2008,2010,2,8.89,-1.25,-10.14,554,358,-196,1346,179,-1167,2162.0,325.0,-1837.0,3398000.0,4805000.0,1407000.0
vargj001,Jason Vargas,Seattle Mariners,MARNRS,1,1,1,2,2012,2013,1,1.95,2.86,0.91,24,156,132,0,657,657,450.0,0.0,-450.0,4850000.0,2975000.0,-1875000.0
vargj001,Jason Vargas,New York Mets,METS,1,1,1,2,2019,2019,0,-0.5,0.0,0.5,21,0,-21,14,0,-14,166.0,0.0,-166.0,8000000.0,0.0,-8000000.0
varij001,Jason Varitek,Seattle Mariners,MARNRS,1,2,1,3,1997,1998,1,43.6,0.43,-43.17,1956,90,-1866,5862,0,-5862,3111.0,288.0,-2823.0,0.0,2300000.0,2300000.0
varnp101,Pete Varney,Chicago White Sox,WSOX,1,1,1,2,1976,1977,1,-0.29,-0.38,-0.09,5,8,3,10,0,-10,0.0,84.0,84.0,0.0,0.0,0.0
varsg001,Gary Varsho,Chicago Cubs,CUBS,1,1,1,2,1991,1991,0,0.39,0.0,-0.39,269,0,-269,473,0,-473,0.0,0.0,0.0,0.0,0.0,0.0
varva001,Anthony Varvaro,Atlanta Braves,BRAVES,1,1,2,3,2014,2014,0,0.13,0.0,-0.13,9,0,-9,0,0,0,33.0,0.0,-33.0,515000.0,0.0,-515000.0
vasqa002,Andrew Vasquez,Minnesota Twins,TWINS,1,1,1,2,2021,2021,0,0.08,0.0,-0.08,4,0,-4,0,0,0,5.0,0.0,-5.0,0.0,0.0,0.0
vasqj001,Jorge Vasquez,Kansas City Royals,ROYALS,2,3,3,6,2004,2005,1,0.31,-1.05,-1.36,34,32,-2,57,100,43,27.0,0.0,-27.0,3200000.0,3000000.0,-200000.0
vasqr101,Rafael Vasquez,Pittsburgh Pirates,PIRATS,1,3,3,6,1978,1978,0,-3.43,0.0,3.43,296,0,-296,706,0,-706,404.0,0.0,-404.0,0.0,0.0,0.0
vasqr101,Rafael Vasquez,Seattle Mariners,MARNRS,1,3,1,4,1979,1981,2,2.1,-0.37,-2.47,64,83,19,0,269,269,447.0,0.0,-447.0,0.0,0.0,0.0
vasqr101,Rafael Vasquez,Cleveland Indians,INDINS,5,10,10,20,1980,2004,24,35.2,53.01,17.81,1530,2520,990,5654,9198,3544,2682.0,3776.0,1094.0,1767500.0,1412500.0,-355000.0
vasqv001,Virgil Vasquez,Pittsburgh Pirates,PIRATS,1,1,1,2,2010,2010,0,0.0,0.0,0.0,0,0,0,0,0,0,0.0,0.0,0.0,0.0,0.0,0.0
vastj001,Jerry Vasto,Colorado Rockies,ROCKS,1,1,2,3,2018,2018,0,0.0,0.02,0.02,5,10,5,0,16,16,11.0,0.0,-11.0,0.0,2300000.0,2300000.0
vatcj001,Jim Vatcher,Philadelphia Phillies,PHILS,1,3,2,5,1990,1996,6,0.28,7.71,7.43,106,447,341,38,1122,1084,145.0,1741.0,1596.0,750000.0,2100000.0,1350000.0
vauga101,Arky Vaughan,Pittsburgh Pirates,PIRATS,3,4,6,10,1941,1946,5,11.58,5.96,-5.62,464,1100,636,1609,4195,2586,570.0,336.0,-234.0,0.0,3000.0,3000.0
vaugg001,Greg Vaughn,Milwaukee Brewers,BREWRS,8,13,15,28,1996,2006,10,13.14,4.75,-8.39,1056,1863,807,2193,3091,898,1015.0,2798.0,1783.0,17862000.0,10210000.0,-7652000.0
vaugg001,Greg Vaughn,San Diego Padres,PADRS,3,7,8,15,1999,2006,7,6.95,24.07,17.12,734,1502,768,2481,5933,3452,0.0,4.0,4.0,8651680.0,7650000.0,-1001680.0
vaugh101,Hippo Vaughn,Washington Senators,TWINS,2,4,4,8,1912,1919,7,0.15,11.96,11.81,110,595,485,129,1405,1276,1048.0,2565.0,1517.0,3200.0,9000.0,5800.0
vaugh101,Hippo Vaughn,KansasCity,KansasCity,1,1,1,2,1913,1913,0,40.38,0.0,-40.38,612,0,-612,821,0,-821,6642.0,0.0,-6642.0,0.0,2500.0,2500.0
vaugm001,Mo Vaughn,Anaheim Angels,ANGELS,1,1,1,2,2001,2003,2,-1.24,1.49,2.73,166,55,-111,654,9,-645,0.0,843.0,843.0,0.0,8500000.0,8500000.0
vazqj001,Javier Vazquez,Montreal Expos,NATEX,4,5,6,11,2003,2010,7,22.54,15.72,-6.82,1678,876,-802,5174,3385,-1789,1287.0,295.0,-992.0,11812000.0,2564100.0,-9247900.0
vazqj001,Javier Vazquez,New York Yankees,YANKS,5,14,10,24,2005,2012,7,13.28,19.25,5.97,1549,974,-575,2912,2867,-45,5079.0,1808.0,-3271.0,1556425.0,9100000.0,7543575.0
vazqj001,Javier Vazquez,Arizona Diamondbacks,DBACKS,8,18,14,32,2005,2017,12,11.66,26.28,14.62,663,1746,1083,1106,4655,3549,3122.0,1995.0,-1127.0,34900000.0,7815000.0,-27085000.0
vazqj001,Javier Vazquez,Chicago White Sox,WSOX,2,4,6,10,2008,2015,7,5.25,6.88,1.63,121,767,646,107,2238,2131,727.0,0.0,-727.0,11905000.0,0.0,-11905000.0
vazqj001,Javier Vazquez,Atlanta Braves,BRAVES,3,6,8,14,2009,2014,5,9.14,2.66,-6.48,1368,918,-450,996,2818,1822,2035.0,774.0,-1261.0,14152500.0,10750000.0,-3402500.0
vazqr001,Ramon Vazquez,Seattle Mariners,MARNRS,12,24,25,49,2001,2015,14,25.13,36.61,11.48,2313,2617,304,5473,8533,3060,4049.0,2794.0,-1255.0,29602500.0,19930000.0,-9672500.0
vazqr001,Ramon Vazquez,San Diego Padres,PADRS,1,4,1,5,2004,2006,2,-1.11,5.11,6.22,91,244,153,210,1047,837,85.0,0.0,-85.0,1842500.0,0.0,-1842500.0
vazqr001,Ramon Vazquez,Boston Red Sox,RSOX,1,1,1,2,2005,2008,3,-1.15,2.32,3.47,46,301,255,103,791,688,0.0,0.0,0.0,700000.0,1300000.0,600000.0
veacb101,Bobby Veach,Boston Red Sox,RSOX,1,2,2,4,1925,1925,0,-1.49,-0.59,0.9,98,12,-86,146,10,-136,166.0,84.0,-82.0,14000.0,4000.0,-10000.0
vealc101,Coot Veal,Los Angeles Angels,ANGELS,1,1,1,2,1960,1961,1,-0.75,0.58,1.33,69,66,-3,252,276,24,0.0,0.0,0.0,0.0,0.0,0.0
vealc101,Coot Veal,Pittsburgh Pirates,PIRATS,1,1,1,2,1962,1962,0,-0.19,0.0,0.19,15,0,-15,37,0,-37,0.0,0.0,0.0,0.0,0.0,0.0
velaa001,Andrew Velazquez,Arizona Diamondbacks,DBACKS,3,7,4,11,2014,2019,5,3.79,-0.16,-3.95,192,125,-67,130,321,191,1136.0,438.0,-698.0,4275000.0,3625000.0,-650000.0
velaa001,Andrew Velazquez,Tampa Bay Devil Rays,RAYS,1,1,1,2,2019,2019,0,0.01,0.0,-0.01,5,0,-5,12,0,-12,0.0,0.0,0.0,0.0,0.0,0.0
velah001,Hector Velazquez,Baltimore Orioles,ORLS,1,1,1,2,2020,2020,0,0.0,0.0,0.0,0,0,0,0,0,0,0.0,0.0,0.0,0.0,0.0,0.0
velaj001,Jorge Velandia,Detroit Tigers,TIGRS,1,2,1,3,1994,1994,0,0.37,-0.32,-0.69,295,11,-284,639,0,-639,0.0,34.0,34.0,365000.0,750000.0,385000.0
velaj001,Jorge Velandia,San Diego Padres,PADRS,3,4,4,8,1997,2000,3,-0.13,-0.75,-0.62,150,123,-27,122,262,140,149.0,49.0,-100.0,693000.0,687500.0,-5500.0
velaj001,Jorge Velandia,Oakland Athletics,ATLTCS,2,3,2,5,2000,2006,6,-0.54,-0.87,-0.33,133,51,-82,102,156,54,151.0,0.0,-151.0,219500.0,383333.0,163833.0
velar001,Randy Velarde,Chicago White Sox,WSOX,6,11,12,23,1987,1997,10,68.61,10.72,-57.89,2705,1926,-779,10284,5529,-4755,1119.0,1575.0,456.0,1600000.0,247000.0,-1353000.0
velar001,Randy Velarde,Anaheim Angels,ANGELS,1,2,3,5,1999,2005,6,5.25,4.59,-0.66,273,402,129,988,1145,157,548.0,0.0,-548.0,3425000.0,0.0,-3425000.0
velar001,Randy Velarde,Oakland Athletics,ATLTCS,2,4,3,7,2000,2003,3,16.02,0.77,-15.25,587,71,-516,813,190,-623,4166.0,326.0,-3840.0,3050000.0,0.0,-3050000.0
velar001,Randy Velarde,Texas Rangers,RNGRS,1,1,2,3,2001,2005,4,0.36,-0.24,-0.6,15,75,60,55,0,-55,0.0,195.0,195.0,3150000.0,0.0,-3150000.0
velav001,Vincent Velasquez,Houston Astros,ASTROS,2,8,3,11,2015,2020,5,7.89,4.62,-3.27,397,276,-121,183,0,-183,2153.0,753.0,-1400.0,5115800.0,5819000.0,703200.0
venam001,Max Venable,San Francisco Giants,GIANTS,3,6,4,10,1984,1992,8,-0.38,4.13,4.51,126,534,408,225,652,427,93.0,2798.0,2705.0,0.0,0.0,0.0
venam001,Max Venable,Montreal Expos,NATEX,2,3,3,6,1985,1992,7,0.8,2.75,1.95,294,716,422,339,1893,1554,201.0,144.0,-57.0,415000.0,210000.0,-205000.0
venam002,Mike Venafro,Texas Rangers,RNGRS,6,7,11,18,2002,2013,11,4.52,9.79,5.27,476,622,146,1358,1735,377,495.0,2132.0,1637.0,1600000.0,4102400.0,2502400.0
venam002,Mike Venafro,Kansas City Royals,ROYALS,1,1,1,2,2004,2004,0,0.03,0.0,-0.03,34,0,-34,0,0,0,27.0,0.0,-27.0,0.0,0.0,0.0
venaw001,Will Venable,San Diego Padres,PADRS,1,1,2,3,2015,2017,2,-0.05,0.11,0.16,37,22,-15,82,0,-82,0.0,32.0,32.0,4250000.0,508500.0,-3741500.0
vendp001,Pat Venditte,Toronto Blue Jays,BJAYS,1,1,1,2,2016,2018,2,-0.15,0.0,0.15,7,0,-7,0,0,0,40.0,0.0,-40.0,0.0,0.0,0.0
vendp001,Pat Venditte,Seattle Mariners,MARNRS,1,1,1,2,2017,2017,0,0.0,0.0,0.0,0,0,0,0,0,0,0.0,0.0,0.0,0.0,0.0,0.0
ventj001,Jonny Venters,Tampa Bay Devil Rays,RAYS,1,1,1,2,2018,2018,0,-0.78,0.0,0.78,74,0,-74,0,0,0,75.0,0.0,-75.0,0.0,0.0,0.0
ventr001,Robin Ventura,New York Mets,METS,2,2,3,5,2001,2005,4,7.09,0.66,-6.43,348,175,-173,1359,14,-1345,0.0,284.0,284.0,8000000.0,9600000.0,1600000.0
ventr001,Robin Ventura,New York Yankees,YANKS,3,5,5,10,2003,2012,9,-0.94,12.92,13.86,321,1121,800,352,3051,2699,235.0,682.0,447.0,6620923.0,4005000.0,-2615923.0
verad001,Dario Veras,San Diego Padres,PADRS,4,8,7,15,1998,2002,4,4.23,0.82,-3.41,472,389,-83,1448,834,-614,139.0,215.0,76.0,3650000.0,3850000.0,200000.0
veraj001,Jose Veras,Pittsburgh Pirates,PIRATS,2,2,2,4,2011,2012,1,-0.13,0.08,0.21,161,126,-35,59,293,234,201.0,41.0,-160.0,2537500.0,478000.0,-2059500.0
veraj001,Jose Veras,Houston Astros,ASTROS,2,4,3,7,2013,2020,7,2.74,2.61,-0.13,120,107,-13,0,0,0,313.0,384.0,71.0,4600000.0,5300000.0,700000.0
veraq001,Quilvio Veras,New York Mets,METS,3,3,3,6,1994,1998,4,13.47,2.48,-10.99,517,448,-69,1904,1221,-683,114.0,81.0,-33.0,704000.0,1305500.0,601500.0
veraq001,Quilvio Veras,Florida Marlins,MARLNS,4,9,8,17,1996,2005,9,13.89,25.16,11.27,984,1378,394,2411,4089,1678,3020.0,1719.0,-1301.0,6730000.0,9062500.0,2332500.0
veraq001,Quilvio Veras,San Diego Padres,PADRS,1,3,3,6,1999,2006,7,3.54,15.79,12.25,377,961,584,1296,3858,2562,0.0,4.0,4.0,8651680.0,7650000.0,-1001680.0
verbe101,Emil Verban,St. Louis Cardinals,CARDS,1,1,1,2,1946,1946,0,1.87,0.31,-1.56,348,52,-296,1271,151,-1120,0.0,0.0,0.0,0.0,0.0,0.0
verbe101,Emil Verban,Boston Braves,BRAVES,1,3,1,4,1950,1955,5,0.0,4.71,4.71,0,200,200,0,221,221,0.0,1757.0,1757.0,0.0,0.0,0.0
verbj101,Joe Verbanic,Philadelphia Phillies,PHILS,1,2,1,3,1966,1967,1,2.28,-0.25,-2.53,150,12,-138,53,1,-52,579.0,24.0,-555.0,6000.0,25000.0,19000.0
verda001,Alex Verdugo,Los Angeles Dodgers,DOGRS,1,3,3,6,2020,2020,0,4.62,3.6,-1.02,205,55,-150,839,246,-593,0.0,0.0,0.0,0.0,0.0,0.0
verdr001,Ryan Verdugo,San Francisco Giants,GIANTS,1,2,1,3,2011,2012,1,-1.57,4.82,6.39,14,113,99,2,501,499,165.0,0.0,-165.0,4800000.0,1250000.0,-3550000.0
vered001,Dave Veres,Oakland Athletics,ATLTCS,1,1,1,2,1991,1993,2,0.0,-0.19,-0.19,0,57,57,0,0,0,0.0,312.0,312.0,0.0,0.0,0.0
vered001,Dave Veres,Houston Astros,ASTROS,1,2,1,3,1995,1998,3,1.28,3.85,2.57,256,330,74,42,1150,1108,419.0,0.0,-419.0,125000.0,285000.0,160000.0
vered001,Dave Veres,Montreal Expos,NATEX,1,2,2,4,1997,1999,2,4.68,1.62,-3.06,267,77,-190,4,314,310,460.0,0.0,-460.0,725000.0,0.0,-725000.0
vered001,Dave Veres,Colorado Rockies,ROCKS,13,23,24,47,1999,2003,4,20.8,11.07,-9.73,2188,1626,-562,1402,1034,-368,5980.0,2442.0,-3538.0,24071314.0,14545000.0,-9526314.0
verer001,Randy Veres,Florida Marlins,MARLNS,1,1,1,2,1996,1996,0,-0.7,0.0,0.7,25,0,-25,0,0,0,91.0,0.0,-91.0,0.0,0.0,0.0
vergj101,Johnny Vergez,New York Giants,GIANTS,3,12,5,17,1934,1949,15,8.76,66.74,57.98,1268,2382,1114,4502,9585,5083,296.0,0.0,-296.0,0.0,10500.0,10500.0
verhj101,John Verhoeven,California Angels,ANGELS,1,3,1,4,1977,1979,2,0.12,1.23,1.11,29,53,24,3,0,-3,151.0,726.0,575.0,0.0,70000.0,70000.0
verlj001,Justin Verlander,Detroit Tigers,TIGRS,1,3,3,6,2017,2017,0,16.16,0.0,-16.16,77,0,-77,7,0,-7,1431.0,0.0,-1431.0,0.0,0.0,0.0
vernm101,Mickey Vernon,Washington Senators,TWINS,13,25,27,52,1948,1963,15,65.65,20.21,-45.44,3128,2926,-202,8413,6562,-1851,9264.0,7302.0,-1962.0,32000.0,59000.0,27000.0
vernm101,Mickey Vernon,Cleveland Indians,INDINS,5,9,8,17,1950,1960,10,47.08,3.02,-44.06,2365,489,-1876,7147,530,-6617,4632.0,1673.0,-2959.0,15900.0,10000.0,-5900.0
vernm101,Mickey Vernon,Washington Senators,TWINS,7,16,14,30,1955,1963,8,11.54,-1.9,-13.44,1150,1625,475,3478,3777,299,832.0,1792.0,960.0,17500.0,14000.0,-3500.0
vernm101,Mickey Vernon,Cleveland Indians,INDINS,2,2,2,4,1959,1959,0,1.75,-0.34,-2.09,202,37,-165,122,69,-53,368.0,26.0,-342.0,0.0,0.0,0.0
versz101,Zoilo Versalles,Minnesota Twins,TWINS,3,7,7,14,1967,1971,4,19.69,11.71,-7.98,1089,1188,99,3536,1015,-2521,872.0,2508.0,1636.0,193000.0,192000.0,-1000.0
versz101,Zoilo Versalles,San Diego Padres,PADRS,2,3,3,6,1968,1970,2,0.13,-0.12,-0.25,138,118,-20,364,329,-35,0.0,0.0,0.0,7500.0,0.0,-7500.0
veryt001,Tom Veryzer,Detroit Tigers,TIGRS,1,1,1,2,1977,1978,1,-0.46,0.01,0.47,463,10,-453,1581,32,-1549,0.0,0.0,0.0,40000.0,0.0,-40000.0
veryt001,Tom Veryzer,Cleveland Indians,INDINS,1,1,1,2,1982,1982,0,-0.21,0.0,0.21,40,0,-40,58,0,-58,0.0,0.0,0.0,0.0,0.0,0.0
veryt001,Tom Veryzer,New York Mets,METS,1,1,2,3,1983,1983,0,-1.38,0.0,1.38,103,0,-103,175,0,-175,0.0,0.0,0.0,0.0,0.0,0.0
veseb101,Bob Veselic,Minnesota Twins,TWINS,1,1,1,2,1983,1985,2,0.0,0.29,0.29,0,132,132,0,0,0,0.0,728.0,728.0,0.0,0.0,0.0
vesia001,Alex Vesia,Miami Marlins,MARLNS,1,2,1,3,2021,2021,0,0.61,1.46,0.85,82,133,51,4,0,-4,120.0,192.0,72.0,0.0,0.0,0.0
vicks101,Sammy Vick,New York Yankees,YANKS,4,8,10,18,1920,1931,11,18.87,48.71,29.84,1297,1673,376,4337,4022,-315,1020.0,6917.0,5897.0,44500.0,41500.0,-3000.0
vickt101,Tom Vickery,Philadelphia Phillies,PHILS,1,2,1,3,1891,1891,0,0.0,2.31,2.31,0,76,76,0,125,125,0.0,807.0,807.0,0.0,0.0,0.0
vicos101,Sam Vico,Detroit Tigers,TIGRS,1,2,1,3,1951,1951,0,0.0,-0.4,-0.4,0,12,12,0,2,2,0.0,32.0,32.0,0.0,0.0,0.0
victs001,Shane Victorino,Philadelphia Phillies,PHILS,4,7,7,14,2012,2015,3,1.82,-2.18,-4.0,133,216,83,372,522,150,193.0,209.0,16.0,9996000.0,16483000.0,6487000.0
victs001,Shane Victorino,Boston Red Sox,RSOX,1,2,1,3,2015,2016,1,-0.33,0.17,0.5,38,67,29,98,141,43,0.0,0.0,0.0,13000000.0,0.0,-13000000.0
vidaj101,Jose Vidal,Seattle Pilots,BREWRS,3,4,3,7,1969,1970,1,2.45,-0.52,-2.97,213,90,-123,45,101,56,485.0,396.0,-89.0,60000.0,49000.0,-11000.0
vidrj001,Jose Vidro,Washington Nationals,NATEX,9,14,14,28,2006,2020,14,5.07,16.75,11.68,804,1666,862,1696,2244,548,1207.0,2502.0,1295.0,16181616.0,6203500.0,-9978116.0
vieit001,Thyago Vieira,Seattle Mariners,MARNRS,1,1,1,2,2017,2017,0,-0.43,0.0,0.43,23,0,-23,0,0,0,74.0,0.0,-74.0,0.0,0.0,0.0
viele001,Engelb Vielma,San Francisco Giants,GIANTS,1,1,1,2,2018,2018,0,-0.02,0.0,0.02,6,0,-6,8,0,-8,0.0,0.0,0.0,0.0,0.0,0.0
villb001,Brandon Villafuerte,New York Mets,METS,3,6,4,10,1998,2002,4,4.04,-0.58,-4.62,267,21,-246,904,25,-879,36.0,163.0,127.0,362500.0,1350000.0,987500.0
villb001,Brandon Villafuerte,Florida Marlins,MARLNS,1,1,1,2,1999,1999,0,-0.11,0.0,0.11,3,0,-3,0,0,0,13.0,0.0,-13.0,0.0,0.0,0.0
villb001,Brandon Villafuerte,Detroit Tigers,TIGRS,1,2,1,3,2000,2002,2,-0.26,-0.7,-0.44,6,35,29,0,0,0,17.0,149.0,132.0,0.0,220000.0,220000.0
villb002,Brayan Villarreal,Detroit Tigers,TIGRS,1,2,1,3,2013,2018,5,0.0,7.04,7.04,2,558,556,0,2068,2068,0.0,0.0,0.0,0.0,0.0,0.0
villc001,Carlos Villanueva,San Francisco Giants,GIANTS,1,2,2,4,2004,2005,1,2.11,-0.79,-2.9,447,88,-359,72,5,-67,1275.0,156.0,-1119.0,0.0,0.0,0.0
villc002,Christian Villanueva,Texas Rangers,RNGRS,1,2,1,3,2012,2012,0,22.27,0.17,-22.1,395,12,-383,404,0,-404,3685.0,207.0,-3478.0,0.0,14000000.0,14000000.0
ville001,Eduardo Villacis,Colorado Rockies,ROCKS,1,1,1,2,2002,2002,0,-0.19,0.0,0.19,1,0,-1,0,0,0,10.0,0.0,-10.0,0.0,0.0,0.0
villi001,Ismael Villegas,Chicago Cubs,CUBS,3,3,3,6,1996,2003,7,-0.22,-0.8,-0.58,15,461,446,31,1239,1208,8.0,0.0,-8.0,715000.0,109000.0,-606000.0
villj001,Jonathan Villar,Philadelphia Phillies,PHILS,1,3,1,4,2010,2011,1,1.12,5.11,3.99,320,74,-246,775,83,-692,998.0,665.0,-333.0,470000.0,15000000.0,14530000.0
villj001,Jonathan Villar,Houston Astros,ASTROS,1,1,1,2,2015,2020,5,4.6,-0.41,-5.01,365,26,-339,1394,0,-1394,0.0,116.0,116.0,0.0,0.0,0.0
villj001,Jonathan Villar,Milwaukee Brewers,BREWRS,1,3,1,4,2018,2018,0,5.49,-0.04,-5.53,219,46,-173,950,134,-816,17.0,0.0,-17.0,2550000.0,8500000.0,5950000.0
villj001,Jonathan Villar,Baltimore Orioles,ORLS,1,1,1,2,2019,2019,0,-0.04,0.0,0.04,30,0,-30,128,0,-128,0.0,0.0,0.0,4825000.0,0.0,-4825000.0
villj001,Jonathan Villar,Miami Marlins,MARLNS,1,1,1,2,2020,2020,0,-0.1,0.0,0.1,22,0,-22,79,0,-79,0.0,0.0,0.0,8200000.0,0.0,-8200000.0
villo001,Oscar Villarreal,Arizona Diamondbacks,DBACKS,8,19,20,39,2005,2018,13,24.88,36.62,11.74,1440,1497,57,1874,2669,795,8219.0,7967.0,-252.0,18358000.0,19450000.0,1092000.0
villo001,Oscar Villarreal,Atlanta Braves,BRAVES,2,2,2,4,2007,2009,2,-0.62,1.24,1.86,142,40,-102,176,146,-30,113.0,0.0,-113.0,925000.0,0.0,-925000.0
villr001,Ron Villone,Seattle Mariners,MARNRS,1,2,2,4,1995,1995,0,0.73,0.19,-0.54,185,12,-173,270,0,-270,132.0,189.0,57.0,224000.0,3400000.0,3176000.0
villr001,Ron Villone,San Diego Padres,PADRS,4,10,10,20,1996,2006,10,7.75,31.03,23.28,1053,1823,770,3065,7183,4118,514.0,4.0,-510.0,9096680.0,13525000.0,4428320.0
villr001,Ron Villone,Milwaukee Brewers,BREWRS,2,5,3,8,1997,2001,4,0.99,0.01,-0.98,271,614,343,839,2349,1510,81.0,415.0,334.0,6930000.0,4850000.0,-2080000.0
villr001,Ron Villone,Cincinnati Reds,REDS,1,1,2,3,2000,2000,0,-0.48,0.0,0.48,44,0,-44,11,0,-11,140.0,0.0,-140.0,1600000.0,0.0,-1600000.0
villr001,Ron Villone,Colorado Rockies,ROCKS,1,1,1,2,2001,2001,0,0.55,0.67,0.12,98,75,-23,59,0,-59,524.0,116.0,-408.0,2800000.0,1600000.0,-1200000.0
villr001,Ron Villone,Seattle Mariners,MARNRS,2,2,3,5,2005,2008,3,-0.3,0.0,0.3,69,0,-69,1,0,-1,151.0,0.0,-151.0,1950000.0,0.0,-1950000.0
villr001,Ron Villone,Florida Marlins,MARLNS,1,1,1,2,2005,2005,0,0.68,0.0,-0.68,117,0,-117,0,0,0,368.0,0.0,-368.0,0.0,0.0,0.0
vinaf001,Fernando Vina,New York Mets,METS,1,2,1,3,1994,1996,2,5.97,0.34,-5.63,528,218,-310,2187,7,-2180,0.0,427.0,427.0,120000.0,180000.0,60000.0
vinaf001,Fernando Vina,Milwaukee Brewers,BREWRS,3,5,8,13,1999,2004,5,6.18,4.51,-1.67,713,592,-121,2226,61,-2165,355.0,1056.0,701.0,3700000.0,475000.0,-3225000.0
vincn001,Nick Vincent,San Diego Padres,PADRS,1,1,1,2,2016,2016,0,2.34,0.0,-2.34,205,0,-205,0,0,0,544.0,0.0,-544.0,0.0,0.0,0.0
vinik001,Ken Vining,San Francisco Giants,GIANTS,1,6,3,9,1997,1999,2,21.4,-0.07,-21.47,1008,161,-847,1122,94,-1028,2523.0,875.0,-1648.0,0.0,9757500.0,9757500.0
violf001,Frank Viola,Minnesota Twins,TWINS,5,6,13,19,1989,2000,11,15.8,32.13,16.33,867,1585,718,294,2714,2420,3364.0,8064.0,4700.0,11729166.0,930000.0,-10799166.0
virdb101,Bill Virdon,New York Yankees,YANKS,2,5,3,8,1954,1955,1,3.52,0.32,-3.2,493,79,-414,1250,164,-1086,274.0,0.0,-274.0,20000.0,0.0,-20000.0
virdb101,Bill Virdon,St. Louis Cardinals,CARDS,22,48,42,90,1956,1972,16,75.15,67.05,-8.1,7158,3428,-3730,19510,9607,-9903,6403.0,6194.0,-209.0,130500.0,36000.0,-94500.0
virgo001,Ozzie Virgil,Philadelphia Phillies,PHILS,7,11,13,24,1985,2002,17,26.27,18.31,-7.96,2374,2693,319,6477,5504,-973,2850.0,5172.0,2322.0,2160000.0,1960000.0,-200000.0
virgo101,Ozzie Virgil,San Francisco Giants,GIANTS,2,3,4,7,1958,1958,0,0.51,0.0,-0.51,435,23,-412,1397,29,-1368,0.0,0.0,0.0,0.0,0.0,0.0
virgo101,Ozzie Virgil,Detroit Tigers,TIGRS,1,2,2,4,1961,1961,0,2.6,-0.03,-2.63,199,50,-149,85,51,-34,733.0,40.0,-693.0,0.0,0.0,0.0
virgo101,Ozzie Virgil,Baltimore Orioles,ORLS,1,1,1,2,1963,1963,0,0.0,0.0,0.0,0,0,0,0,0,0,0.0,0.0,0.0,0.0,0.0,0.0
virgo101,Ozzie Virgil,Pittsburgh Pirates,PIRATS,5,8,9,17,1965,1978,13,5.88,26.82,20.94,656,1597,941,1421,5058,3637,1342.0,1651.0,309.0,94500.0,49000.0,-45500.0
vitij001,Joe Vitiello,San Francisco Giants,GIANTS,1,1,1,2,2003,2003,0,0.84,0.0,-0.84,38,0,-38,86,0,-86,0.0,0.0,0.0,0.0,0.0,0.0
vitto101,Ossie Vitt,Detroit Tigers,TIGRS,1,1,3,4,1919,1921,2,2.61,4.52,1.91,298,565,267,1243,1738,495,0.0,269.0,269.0,0.0,0.0,0.0
vizca001,Arodys Vizcaino,New York Yankees,YANKS,1,4,2,6,2009,2013,4,3.9,2.44,-1.46,585,309,-276,511,6,-505,625.0,1000.0,375.0,1800000.0,11927500.0,10127500.0
vizca001,Arodys Vizcaino,Atlanta Braves,BRAVES,1,2,3,5,2012,2013,1,0.12,-0.62,-0.74,37,188,151,0,323,323,51.0,665.0,614.0,0.0,1150000.0,1150000.0
vizca001,Arodys Vizcaino,Chicago Cubs,CUBS,2,2,2,4,2014,2018,4,5.93,1.45,-4.48,462,304,-158,438,587,149,516.0,4.0,-512.0,950000.0,0.0,-950000.0
vizca001,Arodys Vizcaino,Atlanta Braves,BRAVES,1,2,2,4,2019,2019,0,-0.53,0.41,0.94,11,85,74,0,0,0,33.0,119.0,86.0,5375000.0,8500000.0,3125000.0
vizcj001,Jose Vizcaino,Los Angeles Dodgers,DOGRS,1,1,1,2,1990,1990,0,2.05,0.0,-2.05,330,0,-330,1076,0,-1076,0.0,0.0,0.0,0.0,0.0,0.0
vizcj001,Jose Vizcaino,Chicago Cubs,CUBS,1,1,2,3,1994,1995,1,2.33,1.32,-1.01,334,104,-230,1419,42,-1377,0.0,468.0,468.0,0.0,0.0,0.0
vizcj001,Jose Vizcaino,New York Mets,METS,1,2,2,4,1996,1998,2,0.91,1.15,0.24,87,354,267,307,1284,977,0.0,0.0,0.0,4160000.0,5150000.0,990000.0
vizcj001,Jose Vizcaino,Cleveland Indians,INDINS,3,6,6,12,1996,2001,5,40.02,3.44,-36.58,2173,212,-1961,7166,649,-6517,933.0,172.0,-761.0,7541666.0,6600000.0,-941666.0
vizcj001,Jose Vizcaino,Los Angeles Dodgers,DOGRS,1,2,1,3,2000,2000,0,0.24,-0.61,-0.85,73,41,-32,191,68,-123,0.0,0.0,0.0,3500000.0,1000000.0,-2500000.0
vizcl001,Luis Vizcaino,Oakland Athletics,ATLTCS,1,1,1,2,2002,2010,8,0.0,10.58,10.58,0,229,229,0,6,6,0.0,1320.0,1320.0,0.0,0.0,0.0
vizcl001,Luis Vizcaino,Texas Rangers,RNGRS,1,1,1,2,2002,2002,0,1.66,0.0,-1.66,440,0,-440,2,0,-2,646.0,0.0,-646.0,0.0,0.0,0.0
vizcl001,Luis Vizcaino,Milwaukee Brewers,BREWRS,2,5,5,10,2004,2008,4,16.9,5.78,-11.12,1386,618,-768,5417,1625,-3792,210.0,270.0,60.0,9450000.0,13770260.0,4320260.0
vizcl001,Luis Vizcaino,Chicago White Sox,WSOX,3,7,7,14,2005,2015,10,21.04,18.91,-2.13,1161,870,-291,3709,2249,-1460,1060.0,1883.0,823.0,16705000.0,11000000.0,-5705000.0
vizcl001,Luis Vizcaino,Arizona Diamondbacks,DBACKS,1,4,2,6,2007,2008,1,-0.71,4.28,4.99,171,78,-93,110,78,-32,366.0,722.0,356.0,0.0,0.0,0.0
vizcl001,Luis Vizcaino,Colorado Rockies,ROCKS,1,1,1,2,2009,2009,0,0.25,3.48,3.23,8,69,61,0,75,75,11.0,648.0,637.0,0.0,0.0,0.0
vizqo001,Omar Vizquel,Seattle Mariners,MARNRS,1,1,3,4,1993,1996,3,30.23,-0.2,-30.43,1478,237,-1241,6542,811,-5731,0.0,0.0,0.0,1112500.0,1117500.0,5000.0
voged001,Daniel Vogelbach,Chicago Cubs,CUBS,4,5,5,10,2016,2020,4,4.67,3.17,-1.5,619,278,-341,1969,187,-1782,208.0,960.0,752.0,2440000.0,3083600.0,643600.0
voger001,Ryan Vogelsong,San Francisco Giants,GIANTS,2,3,3,6,2001,2006,5,-2.21,23.96,26.17,411,451,40,569,556,-13,1088.0,3414.0,2326.0,310000.0,5050000.0,4740000.0
vogts001,Stephen Vogt,Arizona Diamondbacks,DBACKS,1,1,1,2,2021,2021,0,-0.32,0.0,0.32,26,0,-26,87,0,-87,0.0,0.0,0.0,3500000.0,0.0,-3500000.0
voigj001,Jack Voigt,Baltimore Orioles,ORLS,1,1,1,2,1995,1995,0,-0.37,0.0,0.37,38,0,-38,82,0,-82,0.0,0.0,0.0,0.0,0.0,0.0
voigj001,Jack Voigt,Texas Rangers,RNGRS,1,1,1,2,1995,1995,0,0.0,0.15,0.15,0,4,4,0,0,0,0.0,12.0,12.0,155000.0,0.0,-155000.0
voisb101,Bill Voiselle,New York Giants,GIANTS,1,2,1,3,1947,1948,1,4.92,-0.4,-5.32,178,16,-162,203,17,-186,1549.0,110.0,-1439.0,0.0,0.0,0.0
voisb101,Bill Voiselle,Boston Braves,BRAVES,1,1,2,3,1949,1951,2,-0.51,-0.08,0.43,38,67,29,13,165,152,154.0,0.0,-154.0,0.0,0.0,0.0
voitl001,Luke Voit,St. Louis Cardinals,CARDS,1,2,2,4,2018,2019,1,4.54,0.23,-4.31,281,49,-232,1133,2,-1131,0.0,54.0,54.0,0.0,825000.0,825000.0
vollc101,Clyde Vollmer,Cincinnati Reds,REDS,1,1,1,2,1948,1948,0,0.48,0.0,-0.48,316,0,-316,1112,0,-1112,0.0,0.0,0.0,0.0,0.0,0.0
vollc101,Clyde Vollmer,Washington Senators,TWINS,1,1,2,3,1950,1950,0,2.98,0.17,-2.81,263,40,-223,929,137,-792,0.0,0.0,0.0,0.0,0.0,0.0
volqe001,Edinson Volquez,Texas Rangers,RNGRS,1,2,1,3,2007,2012,5,4.01,22.54,18.53,363,647,284,148,2814,2666,1527.0,0.0,-1527.0,0.0,380000.0,380000.0
volqe001,Edinson Volquez,Cincinnati Reds,REDS,2,5,3,8,2011,2020,9,8.75,14.41,5.66,882,376,-506,2596,411,-2185,1389.0,3437.0,2048.0,9475000.0,460700.0,-9014300.0
volsc001,Chris Volstad,Miami Marlins,MARLNS,1,1,2,3,2012,2012,0,-1.46,0.72,2.18,42,67,25,34,36,2,334.0,397.0,63.0,0.0,0.0,0.0
vosbe001,Ed Vosberg,San Diego Padres,PADRS,1,1,1,2,1988,1993,5,0.0,0.08,0.08,0,84,84,0,296,296,0.0,0.0,0.0,0.0,0.0,0.0
vosbe001,Ed Vosberg,Houston Astros,ASTROS,1,1,1,2,1989,1991,2,0.0,0.57,0.57,0,77,77,0,187,187,0.0,0.0,0.0,0.0,0.0,0.0
vosbe001,Ed Vosberg,Texas Rangers,RNGRS,1,1,1,2,1997,2001,4,-0.08,13.58,13.66,33,155,122,0,20,20,36.0,2770.0,2734.0,450000.0,0.0,-450000.0
vosbe001,Ed Vosberg,Florida Marlins,MARLNS,1,1,1,2,1997,1997,0,-0.72,0.0,0.72,30,0,-30,0,0,0,25.0,0.0,-25.0,0.0,0.0,0.0
voslj001,Jason Vosler,Chicago Cubs,CUBS,1,1,1,2,2018,2018,0,0.0,0.0,0.0,0,0,0,0,0,0,0.0,0.0,0.0,0.0,0.0,0.0
vosmj101,Joe Vosmik,Cleveland Indians,INDINS,1,3,3,6,1937,1939,2,6.18,8.46,2.28,372,600,228,1331,2387,1056,1093.0,179.0,-914.0,0.0,0.0,0.0
vosmj101,Joe Vosmik,St.Louis Browns,ORLS,9,17,25,42,1937,1952,15,43.78,53.09,9.31,1937,5273,3336,5181,15101,9920,6172.0,11573.0,5401.0,123000.0,105100.0,-17900.0
vossb101,Bill Voss,Chicago White Sox,WSOX,2,3,2,5,1969,1969,0,1.28,-1.35,-2.63,213,36,-177,599,8,-591,0.0,125.0,125.0,27500.0,19000.0,-8500.0
vossb101,Bill Voss,California Angels,ANGELS,1,1,1,2,1971,1971,0,0.01,0.0,-0.01,124,0,-124,345,0,-345,0.0,0.0,0.0,0.0,0.0,0.0
vossb101,Bill Voss,Milwaukee Brewers,BREWRS,2,3,3,6,1972,1972,0,0.08,-0.41,-0.49,40,64,24,109,140,31,0.0,0.0,0.0,37000.0,42000.0,5000.0
vossb101,Bill Voss,Oakland Athletics,ATLTCS,2,3,3,6,1972,1973,1,1.29,0.41,-0.88,134,35,-99,556,136,-420,0.0,22.0,22.0,100000.0,35500.0,-64500.0
vossb101,Bill Voss,St. Louis Cardinals,CARDS,1,1,1,2,1972,1972,0,0.0,0.0,0.0,0,0,0,0,0,0,0.0,0.0,0.0,0.0,0.0,0.0
voylb001,Brad Voyles,Atlanta Braves,BRAVES,1,2,1,3,2001,2001,0,-0.65,0.03,0.68,44,49,5,1,163,162,205.0,0.0,-205.0,0.0,2300000.0,2300000.0
vuckp001,Pete Vuckovich,Toronto Blue Jays,BJAYS,8,15,14,29,1977,1987,10,28.86,22.15,-6.71,2801,2757,-44,8515,8792,277,3123.0,3581.0,458.0,669000.0,240000.0,-429000.0
vuckp001,Pete Vuckovich,St. Louis Cardinals,CARDS,6,17,11,28,1980,1992,12,64.49,98.46,33.97,5600,3789,-1811,17434,13612,-3822,5735.0,2617.0,-3118.0,1533333.0,0.0,-1533333.0
vukog001,George Vukovich,Philadelphia Phillies,PHILS,5,11,8,19,1982,1999,17,22.81,28.42,5.61,2142,1948,-194,7615,5685,-1930,390.0,1257.0,867.0,2950000.0,165000.0,-2785000.0
vukoj101,John Vukovich,Philadelphia Phillies,PHILS,3,7,6,13,1972,1979,7,31.4,20.05,-11.35,1669,1025,-644,5610,3103,-2507,2357.0,4062.0,1705.0,29500.0,80800.0,51300.0
vukoj101,John Vukovich,Milwaukee Brewers,BREWRS,2,2,2,4,1974,1975,1,-0.05,-0.17,-0.12,31,6,-25,46,0,-46,0.0,35.0,35.0,34000.0,0.0,-34000.0
vukoj101,John Vukovich,Cincinnati Reds,REDS,3,3,3,6,1975,1979,4,3.94,-0.12,-4.06,350,99,-251,980,200,-780,0.0,0.0,0.0,0.0,0.0,0.0
waddr101,Rube Waddell,Louisville Colonels,LS3,1,12,5,17,1899,1900,1,267.1,0.0,-267.1,7388,0,-7388,29004,0,-29004,7568.0,0.0,-7568.0,4350.0,0.0,-4350.0
waddr101,Rube Waddell,Pittsburgh Pirates,PIRATS,1,1,1,2,1900,1901,1,0.0,-0.04,-0.04,0,4,4,0,3,3,0.0,24.0,24.0,0.0,0.0,0.0
wadeb101,Ben Wade,St. Louis Cardinals,CARDS,2,3,2,5,1955,1956,1,1.12,2.31,1.19,44,114,70,11,20,9,165.0,277.0,112.0,0.0,0.0,0.0
wadeg101,Gale Wade,Cleveland Indians,INDINS,1,3,1,4,1954,1955,1,4.04,0.12,-3.92,157,113,-44,207,390,183,1291.0,0.0,-1291.0,0.0,65000.0,65000.0
wadej101,Jake Wade,Detroit Tigers,TIGRS,1,3,2,5,1938,1946,8,-0.33,15.76,16.09,102,1005,903,69,3681,3612,596.0,671.0,75.0,19500.0,16000.0,-3500.0
wadej101,Jake Wade,Chicago White Sox,WSOX,1,1,1,2,1944,1947,3,0.97,-0.17,-1.14,26,58,32,10,18,8,106.0,209.0,103.0,5600.0,4000.0,-1600.0
wadej101,Jake Wade,New York Giants,GIANTS,1,4,1,5,1947,1953,6,0.0,-0.83,-0.83,0,19,19,0,46,46,0.0,19.0,19.0,0.0,0.0,0.0
wadek001,Konner Wade,Colorado Rockies,ROCKS,1,1,1,2,2017,2017,0,-0.4,0.0,0.4,7,0,-7,0,0,0,37.0,0.0,-37.0,0.0,0.0,0.0
wadel001,LaMonte Wade,Minnesota Twins,TWINS,1,1,1,2,2021,2021,0,1.22,-0.46,-1.68,109,4,-105,381,0,-381,0.0,26.0,26.0,0.0,0.0,0.0
wadet002,Tyler Wade,New York Yankees,YANKS,1,1,1,2,2021,2021,0,0.0,0.0,0.0,0,0,0,0,0,0,0.0,0.0,0.0,0.0,0.0,0.0
wadsj101,Jack Wadsworth,Louisville Colonels,LS3,1,12,5,17,1899,1900,1,267.1,0.0,-267.1,7388,0,-7388,29004,0,-29004,7568.0,0.0,-7568.0,4350.0,0.0,-4350.0
wagnb001,Billy Wagner,Houston Astros,ASTROS,2,4,5,9,2003,2007,4,8.53,-4.45,-12.98,725,187,-538,1017,101,-916,1251.0,1063.0,-188.0,8727000.0,4825000.0,-3902000.0
wagnb001,Billy Wagner,New York Mets,METS,1,1,2,3,2009,2010,1,0.34,-0.21,-0.55,15,100,85,0,180,180,41.0,0.0,-41.0,10500000.0,400000.0,-10100000.0
wagng101,Gary Wagner,Philadelphia Phillies,PHILS,1,1,1,2,1969,1971,2,-0.15,0.3,0.45,88,10,-78,10,1,-9,170.0,19.0,-151.0,15000.0,0.0,-15000.0
wagnh101,Honus Wagner,Louisville Colonels,LS3,1,12,5,17,1899,1900,1,267.1,0.0,-267.1,7388,0,-7388,29004,0,-29004,7568.0,0.0,-7568.0,4350.0,0.0,-4350.0
wagnh102,Hal Wagner,Philadelphia Athletics,ATLTCS,1,1,1,2,1944,1946,2,2.46,0.58,-1.88,204,136,-68,778,556,-222,0.0,0.0,0.0,6000.0,5000.0,-1000.0
wagnh102,Hal Wagner,Boston Red Sox,RSOX,1,1,1,2,1947,1950,3,0.99,3.02,2.03,125,419,294,355,1601,1246,0.0,0.0,0.0,0.0,0.0,0.0
wagnl101,Leon Wagner,San Francisco Giants,GIANTS,10,19,14,33,1959,1972,13,26.08,20.98,-5.1,2290,1750,-540,7278,3376,-3902,1334.0,4789.0,3455.0,50000.0,89000.0,39000.0
wagnl101,Leon Wagner,St. Louis Cardinals,CARDS,1,4,1,5,1960,1961,1,0.0,0.08,0.08,0,58,58,0,21,21,0.0,225.0,225.0,0.0,0.0,0.0
wagnl101,Leon Wagner,Toronto,Toronto,1,1,1,2,1961,1961,0,6.42,0.0,-6.42,442,0,-442,1801,0,-1801,0.0,0.0,0.0,0.0,0.0,0.0
wagnl101,Leon Wagner,Los Angeles Angels,ANGELS,2,2,4,6,1963,1970,7,4.21,3.61,-0.6,770,439,-331,2474,1110,-1364,542.0,509.0,-33.0,20000.0,0.0,-20000.0
wagnl101,Leon Wagner,Cleveland Indians,INDINS,8,14,14,28,1968,1978,10,23.2,10.4,-12.8,1797,1040,-757,4294,3309,-985,2427.0,1183.0,-1244.0,115500.0,141500.0,26000.0
wagnm001,Mark Wagner,Detroit Tigers,TIGRS,1,1,1,2,1980,1983,3,1.16,2.21,1.05,112,70,-42,293,0,-293,0.0,268.0,268.0,0.0,0.0,0.0
wagnm002,Matt Wagner,Seattle Mariners,MARNRS,2,4,3,7,1996,1999,3,0.25,7.02,6.77,475,103,-372,1514,15,-1499,341.0,1794.0,1453.0,5016667.0,2800000.0,-2216667.0
wagnr001,Ryan Wagner,Cincinnati Reds,REDS,1,3,5,8,2006,2012,6,0.43,-0.61,-1.04,795,705,-90,2860,181,-2679,139.0,809.0,670.0,4550000.0,1352000.0,-3198000.0
wagnt001,Tyler Wagner,Milwaukee Brewers,BREWRS,6,11,10,21,2016,2020,4,-0.37,15.97,16.34,772,552,-220,2514,1371,-1143,401.0,1885.0,1484.0,6500000.0,0.0,-6500000.0
waguj001,Jacob Waguespack,Philadelphia Phillies,PHILS,1,1,1,2,2018,2018,0,0.26,0.09,-0.17,29,18,-11,3,0,-3,287.0,12.0,-275.0,0.0,1812500.0,1812500.0
wahlb001,Bobby Wahl,Oakland Athletics,ATLTCS,1,3,1,4,2018,2018,0,-0.32,0.3,0.62,13,30,17,0,0,0,16.0,94.0,78.0,0.0,7925000.0,7925000.0
wahlb001,Bobby Wahl,New York Mets,METS,2,4,2,6,2019,2019,0,-0.03,-0.49,-0.46,40,34,-6,112,53,-59,7.0,0.0,-7.0,571765.0,0.0,-571765.0
wahlk101,Kermit Wahl,Cincinnati Reds,REDS,1,2,1,3,1949,1950,1,0.0,0.76,0.76,0,138,138,0,500,500,0.0,0.0,0.0,0.0,0.0,0.0
wahlk101,Kermit Wahl,Brooklyn Dodgers,DOGRS,1,1,2,3,1949,1949,0,-0.74,0.0,0.74,109,0,-109,389,0,-389,0.0,0.0,0.0,0.0,0.0,0.0
wahlk101,Kermit Wahl,Philadelphia Athletics,ATLTCS,1,1,1,2,1951,1952,1,0.0,2.8,2.8,0,123,123,0,503,503,0.0,0.0,0.0,0.0,0.0,0.0
wahlk101,Kermit Wahl,Chicago White Sox,WSOX,27,53,44,97,1951,1969,18,83.35,62.63,-20.72,6936,5271,-1665,17430,11733,-5697,13187.0,9922.0,-3265.0,288750.0,292500.0,3750.0
wahlk101,Kermit Wahl,St.Louis Browns,ORLS,18,45,42,87,1951,1988,37,51.78,138.85,87.07,4039,8046,4007,7629,22393,14764,14591.0,15253.0,662.0,829333.0,135900.0,-693433.0
waina001,Adam Wainwright,Atlanta Braves,BRAVES,2,5,3,8,2003,2005,2,48.74,10.63,-38.11,1422,247,-1175,1200,926,-274,9241.0,27.0,-9214.0,3968000.0,5200000.0,1232000.0
waind001,Dave Wainhouse,Montreal Expos,NATEX,1,2,2,4,1992,1993,1,-0.6,-0.77,-0.17,3,95,92,0,242,242,7.0,0.0,-7.0,0.0,0.0,0.0
waite101,Eddie Waitkus,Chicago Cubs,CUBS,2,3,3,6,1948,1953,5,8.13,13.76,5.63,675,587,-88,2640,227,-2413,597.0,2431.0,1834.0,16000.0,0.0,-16000.0
waitr001,Rick Waits,Texas Rangers,RNGRS,2,5,3,8,1975,1978,3,27.68,13.0,-14.68,537,88,-449,186,0,-186,7504.0,2017.0,-5487.0,60000.0,160000.0,100000.0
waitr001,Rick Waits,Cleveland Indians,INDINS,4,6,7,13,1983,1989,6,6.39,10.47,4.08,1149,933,-216,3782,2485,-1297,450.0,1586.0,1136.0,1515000.0,600000.0,-915000.0
wakeb101,Bill Wakefield,St. Louis Cardinals,CARDS,2,4,2,6,1963,1966,3,0.61,-0.46,-1.07,354,142,-212,526,97,-429,552.0,871.0,319.0,0.0,0.0,0.0
waked101,Dick Wakefield,Detroit Tigers,TIGRS,12,27,25,52,1949,1961,12,21.38,16.07,-5.31,2122,2387,265,3941,7076,3135,5639.0,2357.0,-3282.0,45200.0,36000.0,-9200.0
wakeh101,Howard Wakefield,Cleveland Indians,INDINS,1,2,1,3,1907,1907,0,-0.05,-0.01,0.04,39,12,-27,151,47,-104,0.0,0.0,0.0,0.0,0.0,0.0
walbm001,Matt Walbeck,Chicago Cubs,CUBS,2,3,2,5,1993,1995,2,-2.42,-1.8,0.62,423,66,-357,1019,51,-968,662.0,450.0,-212.0,349000.0,126000.0,-223000.0
walbm001,Matt Walbeck,Minnesota Twins,TWINS,1,1,1,2,1996,1996,0,-1.37,0.0,1.37,133,0,-133,384,0,-384,0.0,0.0,0.0,225000.0,0.0,-225000.0
walbm001,Matt Walbeck,Detroit Tigers,TIGRS,1,2,1,3,1997,1997,0,-0.94,0.0,0.94,337,0,-337,1117,0,-1117,0.0,0.0,0.0,728000.0,0.0,-728000.0
walbm001,Matt Walbeck,San Diego Padres,PADRS,1,2,2,4,2002,2002,0,-0.26,-0.46,-0.2,167,15,-152,507,42,-465,0.0,0.0,0.0,0.0,0.0,0.0
walbr101,Rube Walberg,Philadelphia Athletics,ATLTCS,1,3,3,6,1933,1936,3,51.32,1.87,-49.45,848,361,-487,1283,1356,73,5977.0,119.0,-5858.0,31000.0,8500.0,-22500.0
walbr101,Rube Walberg,Portland,Portland,1,1,2,3,1922,1922,0,0.03,0.0,-0.03,4,0,-4,1,0,-1,15.0,0.0,-15.0,0.0,0.0,0.0
waldj001,Jordan Walden,Anaheim Angels,ANGELS,1,1,1,2,2012,2013,1,1.18,-0.38,-1.56,211,15,-196,0,0,0,291.0,219.0,-72.0,495000.0,535000.0,40000.0
waldj001,Jordan Walden,Atlanta Braves,BRAVES,3,6,6,12,2014,2021,7,6.17,11.17,5.0,236,884,648,658,2525,1867,448.0,1265.0,817.0,6525000.0,1034000.0,-5491000.0
walkb001,Bob Walk,Philadelphia Phillies,PHILS,4,7,5,12,1981,1986,5,7.41,4.36,-3.05,1382,627,-755,3921,1660,-2261,861.0,557.0,-304.0,0.0,0.0,0.0
walkb101,Bill Walker,New York Giants,GIANTS,3,11,6,17,1932,1949,17,15.21,55.77,40.56,1303,2528,1225,3690,9780,6090,2269.0,40.0,-2229.0,0.0,0.0,0.0
walkb101,Bill Walker,St. Louis Cardinals,CARDS,1,2,1,3,1936,1939,3,0.0,2.32,2.32,0,112,112,0,94,94,0.0,807.0,807.0,0.0,0.0,0.0
walkc001,Chico Walker,Chicago Cubs,CUBS,1,1,1,2,1987,1987,0,-0.63,0.0,0.63,33,0,-33,86,0,-86,0.0,0.0,0.0,0.0,0.0,0.0
walkc101,Curt Walker,New York Giants,GIANTS,1,3,1,4,1921,1926,5,11.79,12.89,1.1,909,765,-144,3326,3232,-94,0.0,0.0,0.0,5400.0,5000.0,-400.0
walkc101,Curt Walker,Philadelphia Phillies,PHILS,7,15,13,28,1924,1941,17,41.73,36.54,-5.19,2531,2703,172,10014,8113,-1901,324.0,5521.0,5197.0,21500.0,23200.0,1700.0
walkd001,Duane Walker,Cincinnati Reds,REDS,2,3,2,5,1985,1988,3,10.64,5.16,-5.48,575,386,-189,438,1599,1161,2258.0,0.0,-2258.0,790909.0,0.0,-790909.0
walkd101,Dixie Walker,Chicago White Sox,WSOX,2,4,5,9,1937,1950,13,5.83,16.69,10.86,429,2282,1853,1515,8577,7062,633.0,270.0,-363.0,37500.0,31250.0,-6250.0
walkd101,Dixie Walker,Brooklyn Dodgers,DOGRS,3,7,9,16,1947,1954,7,6.69,26.56,19.87,628,1156,528,1259,3340,2081,1417.0,3832.0,2415.0,38000.0,0.0,-38000.0
walke101,Ernie Walker,St.Louis Browns,ORLS,1,4,2,6,1915,1924,9,0.0,-0.32,-0.32,0,2,2,0,1,1,0.0,10.0,10.0,0.0,0.0,0.0
walkg101,Gee Walker,Detroit Tigers,TIGRS,5,17,11,28,1937,1952,15,24.1,51.38,27.28,3640,2564,-1076,12152,7653,-4499,3951.0,7313.0,3362.0,74300.0,79500.0,5200.0
walkg101,Gee Walker,Chicago White Sox,WSOX,1,1,2,3,1939,1948,9,1.25,11.88,10.63,140,825,685,620,3004,2384,0.0,270.0,270.0,12500.0,12250.0,-250.0
walkg101,Gee Walker,Washington Senators,TWINS,4,6,5,11,1940,1946,6,3.39,-0.87,-4.26,1062,351,-711,4332,1228,-3104,0.0,315.0,315.0,30000.0,22500.0,-7500.0
walkg101,Gee Walker,Boston Red Sox,RSOX,4,12,11,23,1940,1956,16,20.74,30.94,10.2,2288,1730,-558,6966,4243,-2723,4828.0,6235.0,1407.0,124000.0,52122.0,-71878.0
walkh102,Harry Walker,St. Louis Cardinals,CARDS,2,4,2,6,1947,1952,5,7.58,4.01,-3.57,327,364,37,1048,1141,93,230.0,0.0,-230.0,9000.0,0.0,-9000.0
walkh102,Harry Walker,Philadelphia Phillies,PHILS,1,1,1,2,1948,1953,5,0.07,3.84,3.77,42,317,275,172,792,620,0.0,0.0,0.0,0.0,0.0,0.0
walkh102,Harry Walker,Chicago Cubs,CUBS,4,8,7,15,1949,1958,9,10.8,25.37,14.57,1114,1705,591,3490,6393,2903,130.0,197.0,67.0,0.0,10000.0,10000.0
walkh102,Harry Walker,Cincinnati Reds,REDS,2,2,3,5,1949,1951,2,-0.06,0.2,0.26,133,95,-38,336,282,-54,0.0,0.0,0.0,0.0,9000.0,9000.0
walkj001,Jamie Walker,Atlanta Braves,BRAVES,3,8,7,15,1997,2002,5,31.06,17.6,-13.46,2077,2024,-53,7209,4599,-2610,1427.0,898.0,-529.0,12520000.0,11751680.0,-768320.0
walkj102,Jim Walkup,St.Louis Browns,ORLS,6,10,14,24,1939,1952,13,23.39,27.61,4.22,1164,2723,1559,2963,7190,4227,3417.0,6493.0,3076.0,67500.0,49800.0,-17700.0
walkj103,Johnny Walker,Philadelphia Athletics,ATLTCS,2,5,2,7,1922,1932,10,0.0,50.75,50.75,0,1434,1434,0,6162,6162,0.0,0.0,0.0,9900.0,0.0,-9900.0
walkj104,Jerry Walker,Baltimore Orioles,ORLS,2,3,3,6,1961,1968,7,0.91,10.3,9.39,413,715,302,408,702,294,1330.0,1894.0,564.0,21750.0,0.0,-21750.0
walkj104,Jerry Walker,Kansas City Athletics,ATLTCS,1,1,1,2,1963,1963,0,-0.74,-1.47,-0.73,90,101,11,23,254,231,293.0,0.0,-293.0,0.0,0.0,0.0
walkl001,Larry Walker,Colorado Rockies,ROCKS,4,6,7,13,2004,2007,3,3.29,2.51,-0.78,196,277,81,584,129,-455,352.0,1323.0,971.0,15166667.0,3600000.0,-11566667.0
walkm002,Mike Walker,Pittsburgh Pirates,PIRATS,1,3,2,5,1989,1989,0,-1.22,-1.21,0.01,20,71,51,0,253,253,300.0,0.0,-300.0,222500.0,215000.0,-7500.0
walkn001,Neil Walker,Pittsburgh Pirates,PIRATS,2,2,3,5,2015,2017,2,2.96,-0.18,-3.14,197,117,-80,758,34,-724,33.0,429.0,396.0,8000000.0,7000000.0,-1000000.0
walkn001,Neil Walker,New York Mets,METS,1,2,1,3,2017,2019,2,0.43,-0.06,-0.49,38,6,-32,149,0,-149,0.0,7.0,7.0,17200000.0,0.0,-17200000.0
walkp001,Pete Walker,New York Mets,METS,2,3,3,6,1996,1998,2,0.54,-0.29,-0.83,36,62,26,79,131,52,2.0,0.0,-2.0,0.0,0.0,0.0
walkr101,Rube Walker,Chicago Cubs,CUBS,9,26,24,50,1951,1965,14,14.31,21.74,7.43,2452,2862,410,6527,5620,-907,3090.0,5461.0,2371.0,143500.0,125000.0,-18500.0
walkt001,Tony Walker,Cincinnati Reds,REDS,2,5,3,8,1983,1989,6,5.92,4.25,-1.67,542,577,35,401,2023,1622,1019.0,0.0,-1019.0,117500.0,620000.0,502500.0
walkt002,Todd Walker,Minnesota Twins,TWINS,2,3,3,6,2000,2003,3,3.0,-0.02,-3.02,196,31,-165,636,86,-550,0.0,0.0,0.0,822500.0,0.0,-822500.0
walkt002,Todd Walker,Colorado Rockies,ROCKS,2,5,4,9,2001,2002,1,3.51,-0.39,-3.9,333,251,-82,1296,922,-374,0.0,3.0,3.0,1050000.0,1600000.0,550000.0
walkt002,Todd Walker,Cincinnati Reds,REDS,1,1,2,3,2002,2004,2,1.1,0.0,-1.1,144,0,-144,647,0,-647,0.0,0.0,0.0,2050000.0,0.0,-2050000.0
walkt002,Todd Walker,Chicago Cubs,CUBS,2,2,2,4,2006,2009,3,0.86,0.05,-0.81,93,142,49,144,0,-144,87.0,206.0,119.0,2500000.0,2500000.0,0.0
walkt003,Tyler Walker,San Francisco Giants,GIANTS,1,1,1,2,2006,2006,0,0.12,0.0,-0.12,20,0,-20,0,0,0,60.0,0.0,-60.0,387000.0,0.0,-387000.0
walkt004,Taijuan Walker,Seattle Mariners,MARNRS,4,9,8,17,2016,2019,3,31.56,9.44,-22.12,1249,337,-912,4632,1487,-3145,656.0,14.0,-642.0,18394000.0,40145833.0,21751833.0
walkt004,Taijuan Walker,Seattle Mariners,MARNRS,1,1,1,2,2020,2020,0,0.95,0.0,-0.95,6,0,-6,0,0,0,79.0,0.0,-79.0,2000000.0,0.0,-2000000.0
walkt101,Tillie Walker,Washington Senators,TWINS,2,4,4,8,1912,1919,7,0.15,11.96,11.81,110,595,485,129,1405,1276,1048.0,2565.0,1517.0,3200.0,9000.0,5800.0
walkt101,Tillie Walker,Boston Red Sox,RSOX,8,19,22,41,1918,1935,17,51.77,23.6,-28.17,3792,2718,-1074,15081,10291,-4790,0.0,1203.0,1203.0,45050.0,29350.0,-15700.0
walkt101,Tillie Walker,KansasCity,KansasCity,1,1,4,5,1913,1915,2,8.53,0.0,-8.53,318,0,-318,1249,0,-1249,0.0,0.0,0.0,0.0,3200.0,3200.0
walkt103,Tom Walker,Montreal Expos,NATEX,3,5,4,9,1974,1979,5,-1.98,12.65,14.63,252,716,464,89,1902,1813,1002.0,1380.0,378.0,39500.0,53000.0,13500.0
wallb001,Brett Wallace,St. Louis Cardinals,CARDS,1,3,1,4,2009,2016,7,-0.87,23.07,23.94,9,982,973,8,4121,4113,101.0,0.0,-101.0,0.0,13500000.0,13500000.0
wallb001,Brett Wallace,Oakland Athletics,ATLTCS,2,2,2,4,2009,2014,5,0.15,-0.84,-0.99,11,26,15,33,81,48,0.0,0.0,0.0,0.0,0.0,0.0
wallb001,Brett Wallace,Toronto Blue Jays,BJAYS,2,2,2,4,2010,2019,9,0.29,7.38,7.09,481,518,37,1713,1862,149,0.0,0.0,0.0,0.0,0.0,0.0
wallc001,Chad Wallach,Miami Marlins,MARLNS,2,5,4,9,2014,2015,1,5.93,0.44,-5.49,229,31,-198,228,27,-201,1943.0,265.0,-1678.0,9400000.0,7250000.0,-2150000.0
walld001,Denny Walling,Oakland Athletics,ATLTCS,1,2,1,3,1977,1977,0,13.96,-0.94,-14.9,1072,59,-1013,2929,157,-2772,0.0,0.0,0.0,0.0,130000.0,130000.0
walld001,Denny Walling,Houston Astros,ASTROS,1,1,1,2,1988,1989,1,-1.07,-2.33,-1.26,166,86,-80,290,38,-252,0.0,408.0,408.0,575000.0,400000.0,-175000.0
walld002,Donne Wall,Cincinnati Reds,REDS,1,2,1,3,1997,1998,1,0.65,-0.13,-0.78,96,83,-13,333,147,-186,0.0,0.0,0.0,0.0,335000.0,335000.0
walld002,Donne Wall,Detroit Tigers,TIGRS,2,5,3,8,1997,1998,1,5.42,-0.93,-6.35,622,96,-526,194,193,-1,1023.0,185.0,-838.0,1475000.0,3035000.0,1560000.0
walld002,Donne Wall,San Diego Padres,PADRS,4,6,5,11,2000,2004,4,0.21,3.96,3.75,179,390,211,147,1460,1313,255.0,0.0,-255.0,6200000.0,0.0,-6200000.0
walld003,Derek Wallace,Chicago Cubs,CUBS,3,6,5,11,1995,2001,6,3.42,12.38,8.96,1105,1119,14,1379,4029,2650,1216.0,830.0,-386.0,9308333.0,6555000.0,-2753333.0
walld003,Derek Wallace,Kansas City Royals,ROYALS,1,3,2,5,1995,1999,4,-0.09,-0.06,0.03,38,81,43,0,0,0,74.0,445.0,371.0,0.0,125000.0,125000.0
walld003,Derek Wallace,New York Mets,METS,1,1,1,2,1999,1999,0,0.15,0.0,-0.15,8,0,-8,0,0,0,25.0,0.0,-25.0,0.0,0.0,0.0
walld102,Don Wallace,California Angels,ANGELS,1,2,1,3,1967,1968,1,0.0,0.59,0.59,0,23,23,0,56,56,0.0,0.0,0.0,8000.0,13000.0,5000.0
wallj001,Jeff Wallace,Kansas City Royals,ROYALS,1,4,2,6,1996,1997,1,2.49,5.44,2.95,410,153,-257,728,660,-68,275.0,0.0,-275.0,120000.0,7200000.0,7080000.0
wallj002,Josh Wall,Los Angeles Dodgers,DOGRS,1,3,2,5,2013,2013,0,0.0,0.91,0.91,8,31,23,0,30,30,12.0,261.0,249.0,0.0,0.0,0.0
wallj101,Joe Wallis,Chicago Cubs,CUBS,2,2,2,4,1978,1982,4,-0.4,1.94,2.34,109,345,236,228,856,628,0.0,0.0,0.0,0.0,0.0,0.0
wallj101,Joe Wallis,Cleveland Indians,INDINS,6,11,11,22,1978,2004,26,33.5,53.62,20.12,1638,2796,1158,6056,10176,4120,2682.0,3776.0,1094.0,1767500.0,1412500.0,-355000.0
walll101,Lee Walls,Pittsburgh Pirates,PIRATS,3,4,5,9,1957,1959,2,9.68,2.34,-7.34,949,404,-545,3178,1303,-1875,0.0,0.0,0.0,0.0,70000.0,70000.0
walll101,Lee Walls,Chicago Cubs,CUBS,3,5,4,9,1959,1961,2,8.16,-0.89,-9.05,620,173,-447,633,602,-31,802.0,0.0,-802.0,0.0,0.0,0.0
walll101,Lee Walls,Cincinnati Reds,REDS,1,2,3,5,1960,1963,3,24.2,5.52,-18.68,1274,332,-942,4678,994,-3684,0.0,0.0,0.0,0.0,0.0,0.0
walll101,Lee Walls,New York Mets,METS,4,7,6,13,1961,1970,9,0.46,4.8,4.34,417,826,409,613,1978,1365,516.0,1616.0,1100.0,0.0,52000.0,52000.0
wallm101,Murray Wall,Milwaukee Braves,BRAVES,1,1,1,2,1955,1955,0,0.0,0.0,0.0,0,0,0,0,0,0,0.0,0.0,0.0,0.0,0.0,0.0
wallm101,Murray Wall,Boston Red Sox,RSOX,1,2,2,4,1959,1960,1,0.88,-0.17,-1.05,192,13,-179,454,12,-442,4.0,0.0,-4.0,0.0,13000.0,13000.0
wallm102,Mike Wallace,Philadelphia Phillies,PHILS,1,1,1,2,1974,1974,0,0.48,0.0,-0.48,26,0,-26,0,0,0,170.0,0.0,-170.0,0.0,20000.0,20000.0
wallm102,Mike Wallace,St. Louis Cardinals,CARDS,1,1,1,2,1976,1977,1,-0.15,0.2,0.35,5,28,23,0,1,1,25.0,73.0,48.0,0.0,0.0,0.0
wallt001,Tim Wallach,Montreal Expos,NATEX,1,1,1,2,1992,1992,0,1.46,0.0,-1.46,388,0,-388,1525,0,-1525,0.0,0.0,0.0,1906500.0,0.0,-1906500.0
wallt002,Ty Waller,St. Louis Cardinals,CARDS,1,3,1,4,1980,1984,4,14.5,6.0,-8.5,1050,498,-552,4046,39,-4007,0.0,1190.0,1190.0,0.0,700000.0,700000.0
wallt002,Ty Waller,Chicago Cubs,CUBS,1,1,1,2,1982,1986,4,0.0,0.79,0.79,0,32,32,0,23,23,0.0,191.0,191.0,0.0,0.0,0.0
walsj108,Jimmy Walsh,Baltimore,Baltimore,2,3,5,8,1912,1914,2,9.51,0.0,-9.51,886,0,-886,3679,0,-3679,0.0,0.0,0.0,0.0,0.0,0.0
walsj108,Jimmy Walsh,New York Yankees,YANKS,1,1,1,2,1914,1914,0,2.93,1.39,-1.54,299,69,-230,1224,238,-986,0.0,0.0,0.0,0.0,0.0,0.0
walsj108,Jimmy Walsh,Philadelphia Athletics,ATLTCS,1,1,1,2,1916,1916,0,0.94,1.24,0.3,71,34,-37,237,115,-122,0.0,0.0,0.0,0.0,0.0,0.0
waltb102,Bucky Walters,Boston Braves,BRAVES,3,7,4,11,1932,1940,8,0.0,6.35,6.35,0,477,477,0,1162,1162,0.0,2031.0,2031.0,0.0,0.0,0.0
waltb102,Bucky Walters,Philadelphia Phillies,PHILS,2,2,4,6,1938,1940,2,43.86,2.13,-41.73,653,301,-352,968,820,-148,7065.0,703.0,-6362.0,5500.0,0.0,-5500.0
waltc101,Charlie Walters,Minnesota Twins,TWINS,1,2,1,3,1970,1971,1,0.8,0.53,-0.27,190,173,-17,21,478,457,465.0,0.0,-465.0,0.0,0.0,0.0
waltd001,Dan Walters,Houston Astros,ASTROS,2,2,2,4,1988,1991,3,0.08,0.57,0.49,84,77,-7,296,187,-109,0.0,0.0,0.0,0.0,0.0,0.0
waltd101,Danny Walton,Houston Astros,ASTROS,1,2,1,3,1969,1970,1,-0.73,-0.15,0.58,198,81,-117,682,308,-374,0.0,0.0,0.0,12000.0,69000.0,57000.0
waltd101,Danny Walton,Milwaukee Brewers,BREWRS,1,1,2,3,1971,1972,1,-0.35,-0.35,0.0,5,88,83,14,173,159,0.0,0.0,0.0,18000.0,0.0,-18000.0
waltd101,Danny Walton,New York Yankees,YANKS,13,23,24,47,1972,1997,25,98.02,28.86,-69.16,5103,1830,-3273,10077,3256,-6821,18250.0,6192.0,-12058.0,4415000.0,2821500.0,-1593500.0
waltd101,Danny Walton,Minnesota Twins,TWINS,1,1,1,2,1975,1980,5,0.0,3.77,3.77,18,460,442,17,1491,1474,0.0,0.0,0.0,0.0,0.0,0.0
waltd101,Danny Walton,Los Angeles Dodgers,DOGRS,1,1,2,3,1977,1978,1,-0.34,0.0,0.34,13,0,-13,21,0,-21,0.0,0.0,0.0,0.0,0.0,0.0
waltd101,Danny Walton,Texas Rangers,RNGRS,1,2,2,4,1980,1983,3,0.0,-0.43,-0.43,0,24,24,0,73,73,0.0,0.0,0.0,0.0,0.0,0.0
waltg001,Gene Walter,San Diego Padres,PADRS,7,15,16,31,1986,1992,6,36.08,17.42,-18.66,2233,2005,-228,6347,3857,-2490,2335.0,2895.0,560.0,4783333.0,3737500.0,-1045833.0
waltg001,Gene Walter,New York Mets,METS,1,1,1,2,1988,1989,1,-0.1,0.04,0.14,16,20,4,0,0,0,79.0,42.0,-37.0,111600.0,320000.0,208400.0
waltk101,Ken Walters,Detroit Tigers,TIGRS,5,9,7,16,1959,1967,8,4.29,0.05,-4.24,724,813,89,2270,1691,-579,122.0,890.0,768.0,38000.0,37000.0,-1000.0
waltm001,Mike Walters,California Angels,ANGELS,1,3,2,5,1982,1987,5,16.27,3.87,-12.4,962,569,-393,3760,1197,-2563,264.0,852.0,588.0,0.0,0.0,0.0
waltp001,P.J. Walters,St. Louis Cardinals,CARDS,2,5,5,10,2011,2013,2,7.58,0.4,-7.18,577,344,-233,1599,89,-1510,283.0,547.0,264.0,3193000.0,4329600.0,1136600.0
waltr102,Roxy Walters,New York Yankees,YANKS,5,19,8,27,1918,1928,10,9.22,7.55,-1.67,1051,1233,182,2808,4705,1897,3476.0,418.0,-3058.0,39950.0,18400.0,-21550.0
waltr102,Roxy Walters,Boston Red Sox,RSOX,2,5,5,10,1924,1925,1,9.31,0.12,-9.19,860,387,-473,3360,1555,-1805,0.0,0.0,0.0,3300.0,0.0,-3300.0
waltz001,Zach Walters,Arizona Diamondbacks,DBACKS,1,1,1,2,2011,2011,0,0.48,-0.85,-1.33,40,6,-34,52,4,-48,0.0,34.0,34.0,0.0,7500000.0,7500000.0
waltz001,Zach Walters,Washington Nationals,NATEX,1,1,2,3,2014,2014,0,-0.51,0.42,0.93,42,49,7,124,200,76,0.0,0.0,0.0,0.0,10000000.0,10000000.0
wambb101,Bill Wambsganss,Cleveland Indians,INDINS,1,4,3,7,1924,1928,4,0.12,9.37,9.25,387,855,468,1555,3344,1789,0.0,0.0,0.0,0.0,0.0,0.0
wambb101,Bill Wambsganss,Philadelphia Athletics,ATLTCS,1,2,1,3,1926,1927,1,0.0,-0.86,-0.86,0,30,30,0,102,102,0.0,0.0,0.0,7500.0,0.0,-7500.0
wanel101,Lloyd Waner,Pittsburgh Pirates,PIRATS,1,1,1,2,1941,1948,7,0.56,9.1,8.54,19,324,305,53,256,203,0.0,2222.0,2222.0,0.0,0.0,0.0
wanel101,Lloyd Waner,Boston Braves,BRAVES,1,1,1,2,1941,1946,5,-0.65,1.11,1.76,55,256,201,175,124,-51,0.0,1218.0,1218.0,0.0,0.0,0.0
wanel101,Lloyd Waner,Philadelphia Phillies,PHILS,2,3,3,6,1943,1943,0,0.73,1.46,0.73,404,136,-268,1520,565,-955,0.0,0.0,0.0,0.0,0.0,0.0
wannp101,Pee-Wee Wanninger,New York Yankees,YANKS,1,2,1,3,1925,1928,3,0.0,5.57,5.57,0,264,264,0,860,860,0.0,0.0,0.0,1800.0,0.0,-1800.0
wannp101,Pee-Wee Wanninger,StPaul,StPaul,5,7,11,18,1926,1930,4,0.96,0.0,-0.96,661,0,-661,1974,0,-1974,611.0,0.0,-611.0,0.0,43750.0,43750.0
wapns001,Steve Wapnick,Toronto Blue Jays,BJAYS,1,2,1,3,1991,1991,0,-0.18,-0.65,-0.47,19,21,2,18,54,36,15.0,0.0,-15.0,0.0,800000.0,800000.0
warda101,Aaron Ward,New York Yankees,YANKS,2,4,3,7,1927,1930,3,2.12,-0.44,-2.56,145,285,140,550,851,301,0.0,0.0,0.0,15000.0,0.0,-15000.0
wardc001,Curt Wardle,Minnesota Twins,TWINS,4,9,7,16,1985,1995,10,10.17,8.8,-1.37,960,260,-700,2169,213,-1956,3138.0,2882.0,-256.0,1000000.0,650000.0,-350000.0
wardc001,Curt Wardle,Cleveland Indians,INDINS,1,1,1,2,1987,1990,3,0.0,-0.28,-0.28,0,16,16,0,0,0,0.0,67.0,67.0,0.0,0.0,0.0
wardc002,Colin Ward,Detroit Tigers,TIGRS,1,1,1,2,1984,1984,0,0.02,0.0,-0.02,12,0,-12,2,0,-2,37.0,0.0,-37.0,0.0,0.0,0.0
wardc002,Colin Ward,San Francisco Giants,GIANTS,1,2,2,4,1987,1988,1,0.0,0.35,0.35,0,47,47,0,92,92,0.0,0.0,0.0,0.0,0.0,0.0
wardc002,Colin Ward,San Francisco Giants,GIANTS,1,1,1,2,1985,1989,4,0.0,0.0,0.0,0,0,0,0,0,0,0.0,0.0,0.0,0.0,0.0,0.0
wardc003,Colby Ward,California Angels,ANGELS,1,1,1,2,1989,1996,7,0.15,0.0,-0.15,22,0,-22,0,0,0,108.0,0.0,-108.0,0.0,0.0,0.0
wardc102,Chuck Ward,Pittsburgh Pirates,PIRATS,2,4,3,7,1918,1922,4,39.97,14.96,-25.01,1164,899,-265,2135,3669,1534,8893.0,0.0,-8893.0,4200.0,5000.0,800.0
wardd001,Duane Ward,Atlanta Braves,BRAVES,2,2,2,4,1986,2008,22,16.77,73.29,56.52,531,1476,945,0,1238,1238,3573.0,10890.0,7317.0,650000.0,700000.0,50000.0
wardd002,Daryle Ward,Detroit Tigers,TIGRS,5,12,14,26,1996,2010,14,13.89,24.32,10.43,4127,1434,-2693,10052,2196,-7856,4562.0,6757.0,2195.0,11529000.0,4780000.0,-6749000.0
wardd002,Daryle Ward,Houston Astros,ASTROS,1,1,1,2,2003,2004,1,-1.07,0.0,1.07,52,0,-52,114,0,-114,0.0,0.0,0.0,0.0,0.0,0.0
wardd002,Daryle Ward,Washington Nationals,NATEX,1,1,1,2,2006,2011,5,0.15,-0.89,-1.04,20,29,9,27,27,0,0.0,257.0,257.0,700000.0,0.0,-700000.0
wardd101,Dick Ward,Chicago Cubs,CUBS,1,3,1,4,1934,1940,6,-0.12,5.38,5.5,10,264,254,1,289,288,23.0,2233.0,2210.0,0.0,0.0,0.0
wardg001,Gary Ward,Minnesota Twins,TWINS,4,9,8,17,1983,1989,6,9.78,12.43,2.65,977,522,-455,3365,183,-3182,1024.0,5443.0,4419.0,738500.0,1210000.0,471500.0
wardj103,Jay Ward,Kansas City Athletics,ATLTCS,2,4,3,7,1961,1962,1,-0.07,-0.09,-0.02,40,20,-20,51,37,-14,0.0,0.0,0.0,0.0,0.0,0.0
wardj103,Jay Ward,Los Angeles Dodgers,DOGRS,1,1,1,2,1962,1962,0,-0.14,0.0,0.14,21,0,-21,53,0,-53,0.0,0.0,0.0,0.0,0.0,0.0
wardj103,Jay Ward,Cleveland Indians,INDINS,2,2,2,4,1970,1973,3,5.62,2.87,-2.75,277,239,-38,6,11,5,1317.0,439.0,-878.0,0.0,12600.0,12600.0
wardp101,Preston Ward,Chicago Cubs,CUBS,7,18,16,34,1953,1965,12,5.64,21.93,16.29,1405,1825,420,3839,2173,-1666,1451.0,4951.0,3500.0,82000.0,75000.0,-7000.0
wardp101,Preston Ward,Pittsburgh Pirates,PIRATS,2,4,2,6,1956,1961,5,0.64,4.92,4.28,352,489,137,904,1463,559,547.0,0.0,-547.0,0.0,16500.0,16500.0
wardp101,Preston Ward,Cleveland Indians,INDINS,18,28,30,58,1958,1984,26,63.62,52.24,-11.38,5094,5420,326,14869,17997,3128,4436.0,3464.0,-972.0,307350.0,510600.0,203250.0
wardp102,Pete Ward,Baltimore Orioles,ORLS,4,10,7,17,1963,1973,10,64.06,37.52,-26.54,3307,1677,-1630,9685,6745,-2940,2176.0,306.0,-1870.0,108500.0,40300.0,-68200.0
wardp102,Pete Ward,Chicago White Sox,WSOX,2,2,3,5,1969,1970,1,0.75,0.0,-0.75,97,0,-97,90,0,-90,74.0,0.0,-74.0,28500.0,0.0,-28500.0
wardp103,Piggy Ward,Baltimore Orioles,BLN,2,3,2,5,1893,1894,1,0.56,3.4,2.84,50,114,64,211,180,-31,99.0,1102.0,1003.0,0.0,2100.0,2100.0
wardt001,Turner Ward,New York Yankees,YANKS,1,2,1,3,1989,1992,3,1.27,3.12,1.85,281,519,238,803,1911,1108,0.0,0.0,0.0,0.0,0.0,0.0
wardt001,Turner Ward,Cleveland Indians,INDINS,4,5,9,14,1991,1996,5,12.63,7.08,-5.55,801,582,-219,2368,1823,-545,1452.0,1275.0,-177.0,3575000.0,1765000.0,-1810000.0
wareb101,Buzzy Wares,St.Louis Browns,ORLS,1,4,2,6,1915,1924,9,0.0,-0.32,-0.32,0,2,2,0,1,1,0.0,10.0,10.0,0.0,0.0,0.0
wareb101,Buzzy Wares,Montgomery,Montgomery,1,3,2,5,1912,1913,1,-0.14,0.0,0.14,252,0,-252,843,0,-843,0.0,0.0,0.0,0.0,0.0,0.0
warnj101,Jack Warner,Vernon,Vernon,1,1,5,6,1925,1927,2,1.07,0.0,-1.07,324,0,-324,1271,0,-1271,0.0,0.0,0.0,0.0,0.0,0.0
warnj101,Jack Warner,Detroit Tigers,TIGRS,1,1,1,2,1928,1928,0,0.0,0.0,0.0,0,0,0,0,0,0,0.0,0.0,0.0,0.0,30000.0,30000.0
warnj101,Jack Warner,Brooklyn Dodgers,DOGRS,6,13,10,23,1932,1948,16,22.8,18.44,-4.36,1723,1313,-410,5249,4047,-1202,2633.0,2535.0,-98.0,0.0,0.0,0.0
warnj101,Jack Warner,Philadelphia Phillies,PHILS,1,3,1,4,1933,1934,1,0.0,-0.13,-0.13,0,10,10,0,32,32,0.0,0.0,0.0,0.0,0.0,0.0
warnj102,Jackie Warner,California Angels,ANGELS,4,5,5,10,1967,1974,7,-0.7,4.94,5.64,265,604,339,780,1757,977,66.0,0.0,-66.0,57000.0,0.0,-57000.0
warnl101,Lon Warneke,Chicago Cubs,CUBS,1,1,2,3,1936,1941,5,15.14,2.86,-12.28,366,328,-38,461,1111,650,3473.0,437.0,-3036.0,15500.0,0.0,-15500.0
warra001,Adam Warren,New York Yankees,YANKS,2,5,2,7,2015,2017,2,1.29,3.2,1.91,400,263,-137,1373,1083,-290,113.0,0.0,-113.0,12429743.0,21357143.0,8927400.0
warra001,Adam Warren,Chicago Cubs,CUBS,1,4,1,5,2016,2016,0,9.71,1.2,-8.51,545,54,-491,1768,0,-1768,353.0,80.0,-273.0,0.0,0.0,0.0
warra001,Adam Warren,New York Yankees,YANKS,1,1,1,2,2018,2018,0,0.39,0.0,-0.39,24,0,-24,0,0,0,65.0,0.0,-65.0,3315000.0,0.0,-3315000.0
warrm001,Mike Warren,Milwaukee Brewers,BREWRS,1,2,1,3,1982,1983,1,-0.85,-0.28,0.57,52,36,-16,0,52,52,614.0,0.0,-614.0,0.0,0.0,0.0
warsr101,Rabbit Warstler,Boston Red Sox,RSOX,1,3,3,6,1933,1937,4,1.87,9.37,7.5,361,417,56,1356,657,-699,119.0,1357.0,1238.0,8500.0,31000.0,22500.0
warsr101,Rabbit Warstler,Indianapolis,Indianapolis,1,1,3,4,1930,1945,15,-1.81,0.0,1.81,327,0,-327,1185,0,-1185,0.0,0.0,0.0,0.0,6600.0,6600.0
wartd101,Dan Warthen,Montreal Expos,NATEX,1,2,2,4,1977,1979,2,-0.51,-1.74,-1.23,63,126,63,93,101,8,11.0,753.0,742.0,0.0,0.0,0.0
wartd101,Dan Warthen,Philadelphia Phillies,PHILS,4,9,6,15,1978,1988,10,16.49,18.27,1.78,2081,1091,-990,4349,640,-3709,6661.0,2589.0,-4072.0,0.0,1330000.0,1330000.0
warwc101,Carl Warwick,Los Angeles Dodgers,DOGRS,1,2,1,3,1961,1963,2,-1.3,1.55,2.85,292,144,-148,701,421,-280,0.0,0.0,0.0,0.0,0.0,0.0
warwc101,Carl Warwick,St. Louis Cardinals,CARDS,2,5,4,9,1962,1965,3,0.93,8.59,7.66,640,305,-335,1722,489,-1233,727.0,472.0,-255.0,0.0,12000.0,12000.0
warwc101,Carl Warwick,Houston Astros,ASTROS,9,14,14,28,1964,1978,14,34.4,13.08,-21.32,1890,2214,324,2333,7061,4728,10035.0,2590.0,-7445.0,0.0,90000.0,90000.0
warwc101,Carl Warwick,Baltimore Orioles,ORLS,2,2,3,5,1966,1970,4,-0.16,-0.4,-0.24,29,86,57,36,210,174,0.0,0.0,0.0,0.0,0.0,0.0
wasdj001,John Wasdin,Oakland Athletics,ATLTCS,1,2,1,3,1997,1997,0,2.36,0.22,-2.14,184,108,-76,1,446,445,1019.0,0.0,-1019.0,0.0,0.0,0.0
wasdj001,John Wasdin,Boston Red Sox,RSOX,2,5,5,10,2000,2002,2,0.87,1.83,0.96,125,248,123,134,537,403,371.0,782.0,411.0,3375000.0,6575000.0,3200000.0
wasdj001,John Wasdin,Baltimore Orioles,ORLS,1,1,1,2,2001,2002,1,0.0,0.12,0.12,0,24,24,0,2,2,0.0,132.0,132.0,0.0,700000.0,700000.0
wasdj001,John Wasdin,Pittsburgh Pirates,PIRATS,1,1,1,2,2003,2003,0,-0.6,0.0,0.6,3,0,-3,0,0,0,15.0,0.0,-15.0,0.0,0.0,0.0
wasdj101,Jimmy Wasdell,Minneapolis,Minneapolis,1,1,3,4,1937,1946,9,-1.14,0.0,1.14,124,0,-124,429,0,-429,0.0,0.0,0.0,0.0,0.0,0.0
wasdj101,Jimmy Wasdell,Brooklyn Dodgers,DOGRS,1,4,1,5,1941,1948,7,4.25,10.42,6.17,798,406,-392,2943,1540,-1403,336.0,0.0,-336.0,0.0,0.0,0.0
washc001,Claudell Washington,Oakland Athletics,ATLTCS,2,3,4,7,1977,1978,1,1.93,-0.88,-2.81,219,180,-39,877,417,-460,0.0,629.0,629.0,0.0,0.0,0.0
washc001,Claudell Washington,Texas Rangers,RNGRS,5,9,9,18,1978,1982,4,22.0,5.65,-16.35,909,552,-357,2290,1222,-1068,4197.0,810.0,-3387.0,313000.0,280000.0,-33000.0
washc001,Claudell Washington,Chicago White Sox,WSOX,2,2,2,4,1980,1983,3,0.13,0.0,-0.13,79,0,-79,306,0,-306,0.0,0.0,0.0,0.0,0.0,0.0
washc001,Claudell Washington,Atlanta Braves,BRAVES,1,2,2,4,1986,1988,2,2.5,1.46,-1.04,350,271,-79,1144,976,-168,0.0,0.0,0.0,750000.0,1050000.0,300000.0
washc001,Claudell Washington,California Angels,ANGELS,1,2,1,3,1990,1993,3,0.54,2.38,1.84,153,560,407,83,2347,2264,698.0,0.0,-698.0,675000.0,200000.0,-475000.0
washg102,George Washington,Indianapolis,Indianapolis,1,1,3,4,1934,1947,13,-0.31,0.0,0.31,128,0,-128,405,0,-405,0.0,0.0,0.0,0.0,2700.0,2700.0
washj001,Jarrod Washburn,Seattle Mariners,MARNRS,1,1,2,3,2009,2012,3,-0.68,-0.44,0.24,8,25,17,0,1,1,129.0,377.0,248.0,9850000.0,0.0,-9850000.0
washl101,LaRue Washington,Texas Rangers,RNGRS,1,2,1,3,1980,1980,0,-0.15,1.32,1.47,9,109,100,9,388,379,0.0,0.0,0.0,0.0,0.0,0.0
washr001,Ron Washington,Kansas City Royals,ROYALS,1,1,1,2,1976,1976,0,-0.03,0.0,0.03,10,0,-10,20,0,-20,0.0,0.0,0.0,0.0,0.0,0.0
washr001,Ron Washington,Los Angeles Dodgers,DOGRS,1,1,1,2,1980,1980,0,1.54,0.0,-1.54,452,0,-452,1340,0,-1340,0.0,0.0,0.0,0.0,0.0,0.0
washr101,Ray Washburn,St. Louis Cardinals,CARDS,11,18,17,35,1969,1976,7,16.37,3.31,-13.06,1906,573,-1333,3074,793,-2281,4746.0,1182.0,-3564.0,35000.0,0.0,-35000.0
washu001,U L Washington,Kansas City Royals,ROYALS,1,1,2,3,1985,1985,0,0.55,0.0,-0.55,68,0,-68,209,0,-209,0.0,0.0,0.0,0.0,0.0,0.0
wasim001,Mark Wasinger,San Diego Padres,PADRS,1,2,2,4,1987,1987,0,0.35,0.0,-0.35,47,0,-47,92,0,-92,0.0,0.0,0.0,0.0,0.0,0.0
waslg101,Gary Waslewski,Boston Red Sox,RSOX,2,2,2,4,1968,1970,2,0.74,0.23,-0.51,58,170,112,73,424,351,62.0,0.0,-62.0,48000.0,25000.0,-23000.0
waslg101,Gary Waslewski,St. Louis Cardinals,CARDS,1,1,1,2,1969,1969,0,0.98,0.39,-0.59,72,61,-11,39,21,-18,402.0,190.0,-212.0,0.0,37000.0,37000.0
waslg101,Gary Waslewski,Montreal Expos,NATEX,2,2,2,4,1970,1974,4,1.23,12.72,11.49,100,509,409,12,2140,2128,272.0,0.0,-272.0,0.0,0.0,0.0
watef101,Fred Waters,Milwaukee Braves,BRAVES,2,10,2,12,1953,1960,7,8.19,12.74,4.55,794,729,-65,1824,3040,1216,2135.0,0.0,-2135.0,0.0,42000.0,42000.0
wates101,Steve Waterbury,St. Louis Cardinals,CARDS,10,23,19,42,1977,1992,15,86.36,109.79,23.43,6625,4679,-1946,21245,15231,-6014,7151.0,5142.0,-2009.0,1613333.0,19000.0,-1594333.0
wathd001,Dusty Wathan,San Diego Padres,PADRS,1,1,1,2,2002,2002,0,0.0,-0.11,-0.11,0,7,7,0,20,20,0.0,0.0,0.0,0.0,0.0,0.0
watkg101,George Watkins,St. Louis Cardinals,CARDS,2,2,2,4,1934,1934,0,1.77,-0.52,-2.29,205,85,-120,753,252,-501,0.0,0.0,0.0,0.0,0.0,0.0
watkg101,George Watkins,New York Giants,GIANTS,3,12,5,17,1934,1949,15,8.76,66.74,57.98,1268,2382,1114,4502,9585,5083,296.0,0.0,-296.0,0.0,10500.0,10500.0
watkp001,Pat Watkins,Cincinnati Reds,REDS,1,1,1,2,1999,1999,0,0.0,0.0,0.0,0,0,0,0,0,0,0.0,0.0,0.0,0.0,0.0,0.0
watkp001,Pat Watkins,Florida Marlins,MARLNS,1,1,1,2,1999,1999,0,-0.5,0.0,0.5,16,0,-16,22,0,-22,0.0,0.0,0.0,0.0,0.0,0.0
watsa001,Allen Watson,St. Louis Cardinals,CARDS,6,11,12,23,1995,2004,9,7.92,19.88,11.96,1477,1521,44,4061,3047,-1014,1672.0,2465.0,793.0,14938333.0,17095281.0,2156948.0
watsa001,Allen Watson,San Francisco Giants,GIANTS,1,2,1,3,1996,2005,9,0.96,12.44,11.48,63,1182,1119,0,4497,4497,874.0,0.0,-874.0,240000.0,725000.0,485000.0
watsa001,Allen Watson,New York Mets,METS,1,2,2,4,1999,1999,0,-0.48,0.0,0.48,3,0,-3,0,0,0,9.0,0.0,-9.0,750000.0,212000.0,-538000.0
watsb001,Bob Watson,Houston Astros,ASTROS,3,3,5,8,1979,1983,4,2.74,-0.68,-3.42,228,58,-170,347,7,-340,612.0,138.0,-474.0,0.0,0.0,0.0
watsb001,Bob Watson,New York Yankees,YANKS,1,1,1,2,1982,1982,0,0.01,0.0,-0.01,171,0,-171,394,0,-394,0.0,0.0,0.0,570000.0,0.0,-570000.0
watsm001,Mark Watson,Milwaukee Brewers,BREWRS,1,1,1,2,1998,1998,0,-0.18,0.0,0.18,8,0,-8,0,0,0,19.0,0.0,-19.0,0.0,0.0,0.0
watsm002,Matt Watson,Montreal Expos,NATEX,5,10,12,22,2002,2011,9,5.61,14.61,9.0,687,585,-102,161,612,451,1873.0,3946.0,2073.0,8655000.0,550000.0,-8105000.0
watsm102,Milt Watson,St. Louis Cardinals,CARDS,1,1,2,3,1918,1918,0,-0.22,-0.43,-0.21,62,22,-40,57,90,33,479.0,0.0,-479.0,0.0,0.0,0.0
watsm103,Mule Watson,Boston Braves,BRAVES,9,18,16,34,1923,1938,15,22.25,29.52,7.27,1842,2916,1074,4975,10263,5288,4661.0,3399.0,-1262.0,56400.0,40100.0,-16300.0
watst001,Tony Watson,Pittsburgh Pirates,PIRATS,1,1,2,3,2017,2017,0,0.39,0.0,-0.39,48,0,-48,0,0,0,60.0,0.0,-60.0,5600000.0,0.0,-5600000.0
watst001,Tony Watson,Anaheim Angels,ANGELS,1,1,3,4,2021,2021,0,0.65,-0.36,-1.01,52,27,-25,0,0,0,73.0,63.0,-10.0,1000000.0,0.0,-1000000.0
watwj101,Johnny Watwood,Chicago White Sox,WSOX,3,8,5,13,1932,1935,3,3.4,4.58,1.18,902,283,-619,3430,766,-2664,0.0,735.0,735.0,34500.0,20500.0,-14000.0
watwj101,Johnny Watwood,Boston Red Sox,RSOX,1,3,1,4,1933,1937,4,0.0,5.56,5.56,0,404,404,0,1495,1495,0.0,0.0,0.0,8250.0,0.0,-8250.0
wayng001,Gary Wayne,Minnesota Twins,TWINS,1,2,1,3,1993,1994,1,0.21,-1.18,-1.39,130,34,-96,1,0,-1,187.0,132.0,-55.0,0.0,0.0,0.0
waynj001,Justin Wayne,Montreal Expos,NATEX,2,6,6,12,2002,2005,3,7.25,0.27,-6.98,492,319,-173,648,239,-409,1719.0,1333.0,-386.0,4812500.0,6500000.0,1687500.0
weatd001,David Weathers,Florida Marlins,MARLNS,3,3,3,6,1996,1999,3,-0.83,3.9,4.73,87,283,196,125,682,557,117.0,312.0,195.0,675000.0,119000.0,-556000.0
weatd001,David Weathers,New York Yankees,YANKS,2,2,3,5,1997,2005,8,0.34,4.28,3.94,155,341,186,511,1162,651,50.0,4.0,-46.0,2435000.0,900000.0,-1535000.0
weatd001,David Weathers,Milwaukee Brewers,BREWRS,1,2,2,4,2001,2003,2,0.61,-1.88,-2.49,56,108,52,0,117,117,85.0,715.0,630.0,1200000.0,0.0,-1200000.0
weatd001,David Weathers,New York Mets,METS,1,2,1,3,2004,2004,0,-0.5,0.91,1.41,53,86,33,2,359,357,109.0,0.0,-109.0,3933333.0,12500000.0,8566667.0
weatr101,Roy Weatherly,Cleveland Indians,INDINS,5,7,7,14,1942,1948,6,26.71,21.32,-5.39,1251,1052,-199,4956,4042,-914,0.0,0.0,0.0,29000.0,37900.0,8900.0
weava101,Art Weaver,St.Louis Browns,ORLS,3,4,4,8,1905,1907,2,-1.04,4.18,5.22,52,223,171,153,810,657,0.0,0.0,0.0,0.0,0.0,0.0
weave001,Eric Weaver,Los Angeles Dodgers,DOGRS,1,1,1,2,1998,1998,0,-0.33,0.0,0.33,8,0,-8,0,0,0,28.0,0.0,-28.0,0.0,0.0,0.0
weavf101,Floyd Weaver,Cleveland Indians,INDINS,1,1,2,3,1966,1970,4,0.0,-0.53,-0.53,0,142,142,0,357,357,0.0,0.0,0.0,0.0,0.0,0.0
weavf101,Floyd Weaver,Milwaukee Brewers,BREWRS,2,3,2,5,1972,1974,2,0.0,0.87,0.87,0,19,19,0,1,1,0.0,76.0,76.0,0.0,0.0,0.0
weavj001,Jim Weaver,Minnesota Twins,TWINS,4,9,7,16,1985,1995,10,10.17,8.8,-1.37,960,260,-700,2169,213,-1956,3138.0,2882.0,-256.0,1000000.0,650000.0,-350000.0
weavj001,Jim Weaver,Chicago White Sox,WSOX,1,1,1,2,1989,1989,0,-0.19,0.0,0.19,12,0,-12,20,0,-20,0.0,0.0,0.0,0.0,0.0,0.0
weavj002,Jeff Weaver,Detroit Tigers,TIGRS,1,2,3,5,2002,2010,8,1.2,9.65,8.45,49,784,735,0,1705,1705,712.0,3903.0,3191.0,2350000.0,0.0,-2350000.0
weavj002,Jeff Weaver,New York Yankees,YANKS,1,4,1,5,2003,2005,2,4.25,2.4,-1.85,506,36,-470,179,2,-177,2047.0,616.0,-1431.0,4150000.0,15714286.0,11564286.0
weavj002,Jeff Weaver,Anaheim Angels,ANGELS,1,2,1,3,2006,2010,4,-0.08,0.02,0.1,32,20,-12,35,21,-14,250.0,0.0,-250.0,8325000.0,0.0,-8325000.0
weavj101,Jim Weaver,Washington Senators,TWINS,1,3,1,4,1929,1929,0,0.0,0.0,0.0,0,0,0,0,0,0,0.0,0.0,0.0,0.0,0.0,0.0
weavj101,Jim Weaver,Baltimore,Baltimore,1,2,3,5,1930,1930,0,-0.48,0.0,0.48,34,0,-34,24,0,-24,173.0,0.0,-173.0,0.0,6500.0,6500.0
weavj101,Jim Weaver,Chicago Cubs,CUBS,1,3,2,5,1934,1941,7,3.72,22.26,18.54,346,634,288,358,941,583,2252.0,4458.0,2206.0,0.0,0.0,0.0
weavj102,Jim Weaver,Cleveland Indians,INDINS,2,4,4,8,1967,1969,2,1.58,2.6,1.02,217,267,50,702,761,59,0.0,0.0,0.0,0.0,0.0,0.0
weavj102,Jim Weaver,Houston Astros,ASTROS,2,2,2,4,1967,1978,11,0.44,2.08,1.64,85,1214,1129,71,4740,4669,159.0,0.0,-159.0,0.0,0.0,0.0
weavl001,Luke Weaver,St. Louis Cardinals,CARDS,1,4,1,5,2018,2018,0,4.82,0.0,-4.82,382,0,-382,1034,0,-1034,549.0,0.0,-549.0,550800.0,11100000.0,10549200.0
weavm101,Monte Weaver,Baltimore,Baltimore,2,2,8,10,1931,1934,3,18.55,0.0,-18.55,986,0,-986,2913,0,-2913,3095.0,0.0,-3095.0,0.0,6500.0,6500.0
weavo101,Orlie Weaver,Chicago Cubs,CUBS,3,6,7,13,1911,1916,5,-3.91,1.45,5.36,376,507,131,960,1665,705,899.0,27.0,-872.0,4500.0,0.0,-4500.0
weavr101,Roger Weaver,Detroit Tigers,TIGRS,2,2,2,4,1982,1983,1,0.0,-0.76,-0.76,0,14,14,0,33,33,0.0,0.0,0.0,0.0,0.0,0.0
webbd001,Daniel Webb,Toronto Blue Jays,BJAYS,1,2,1,3,2012,2012,0,-0.18,0.35,0.53,100,54,-46,0,0,0,330.0,131.0,-199.0,0.0,0.0,0.0
webbe101,Earl Webb,Toledo,Toledo,1,1,2,3,1925,1926,1,0.0,0.0,0.0,4,0,-4,4,0,-4,0.0,0.0,0.0,0.0,8500.0,8500.0
webbe101,Earl Webb,New York Giants,GIANTS,1,1,1,2,1925,1927,2,0.0,0.26,0.26,0,140,140,0,531,531,0.0,0.0,0.0,3600.0,0.0,-3600.0
webbe101,Earl Webb,Washington Senators,TWINS,1,1,1,2,1930,1930,0,8.5,-0.07,-8.57,330,6,-324,1383,5,-1378,0.0,0.0,0.0,0.0,7000.0,7000.0
webbe101,Earl Webb,Boston Red Sox,RSOX,2,3,3,6,1932,1936,4,1.18,12.1,10.92,183,698,515,710,2971,2261,0.0,0.0,0.0,23500.0,25000.0,1500.0
webbe101,Earl Webb,Louisville,Louisville,1,1,2,3,1926,1926,0,3.23,0.0,-3.23,164,0,-164,554,0,-554,0.0,0.0,0.0,0.0,0.0,0.0
webbh101,Hank Webb,New York Mets,METS,2,4,2,6,1977,1979,2,0.2,5.03,4.83,10,268,258,0,1093,1093,24.0,0.0,-24.0,0.0,0.0,0.0
webbl102,Les Webber,Cleveland Indians,INDINS,1,3,1,4,1948,1948,0,0.0,0.0,0.0,0,0,0,0,0,0,0.0,0.0,0.0,0.0,0.0,0.0
webbr001,Ryan Webb,Oakland Athletics,ATLTCS,2,5,3,8,2009,2016,7,1.67,5.28,3.61,416,684,268,588,2314,1726,340.0,0.0,-340.0,410000.0,1250000.0,840000.0
webbr001,Ryan Webb,San Diego Padres,PADRS,7,19,13,32,2010,2021,11,21.8,17.69,-4.11,1883,1364,-519,3716,4253,537,2638.0,362.0,-2276.0,9990300.0,405000.0,-9585300.0
webbr001,Ryan Webb,Baltimore Orioles,ORLS,1,3,2,5,2015,2015,0,0.0,0.0,0.0,0,0,0,0,0,0,0.0,0.0,0.0,0.0,0.0,0.0
webbr101,Red Webb,New York Giants,GIANTS,14,31,27,58,1949,1968,19,59.86,70.44,10.58,4286,4168,-118,14522,10114,-4408,1384.0,8678.0,7294.0,127500.0,134500.0,7000.0
webbs101,Skeeter Webb,Cleveland Indians,INDINS,1,1,2,3,1940,1940,0,-2.42,0.0,2.42,342,0,-342,1323,0,-1323,0.0,0.0,0.0,0.0,0.0,0.0
webbs101,Skeeter Webb,Chicago White Sox,WSOX,1,1,1,2,1944,1946,2,-0.96,-0.17,0.79,232,17,-215,719,19,-700,0.0,0.0,0.0,6000.0,3600.0,-2400.0
webbt001,Tyler Webb,New York Yankees,YANKS,2,3,3,6,2017,2017,0,5.53,0.11,-5.42,317,13,-304,917,45,-872,707.0,0.0,-707.0,0.0,0.0,0.0
weben001,Neil Weber,Arizona Diamondbacks,DBACKS,1,1,1,2,1999,1999,0,0.0,0.0,0.0,0,0,0,0,0,0,0.0,0.0,0.0,0.0,0.0,0.0
websa001,Allen Webster,Los Angeles Dodgers,DOGRS,5,22,14,36,2012,2021,9,4.41,31.13,26.72,1016,1541,525,2843,5562,2719,1152.0,835.0,-317.0,78709000.0,90253480.0,11544480.0
websa001,Allen Webster,Boston Red Sox,RSOX,3,6,4,10,2014,2019,5,1.08,2.41,1.33,219,69,-150,105,2,-103,1466.0,676.0,-790.0,3666000.0,523500.0,-3142500.0
websm001,Mitch Webster,Toronto Blue Jays,BJAYS,1,1,1,2,1985,1986,1,9.96,0.0,-9.96,462,0,-462,1862,0,-1862,0.0,0.0,0.0,0.0,0.0,0.0
websm001,Mitch Webster,Montreal Expos,NATEX,3,5,5,10,1988,2001,13,10.34,12.73,2.39,993,989,-4,2591,1867,-724,539.0,722.0,183.0,837500.0,135000.0,-702500.0
websm001,Mitch Webster,Chicago Cubs,CUBS,1,1,1,2,1989,1991,2,3.14,-0.41,-3.55,141,84,-57,513,181,-332,0.0,0.0,0.0,550000.0,97500.0,-452500.0
websm001,Mitch Webster,Cleveland Indians,INDINS,1,1,1,2,1991,1991,0,-0.92,-0.88,0.04,36,14,-22,106,0,-106,0.0,104.0,104.0,750000.0,0.0,-750000.0
websm001,Mitch Webster,Pittsburgh Pirates,PIRATS,1,1,1,2,1991,1991,0,0.19,-0.17,-0.36,417,16,-401,736,23,-713,0.0,0.0,0.0,0.0,0.0,0.0
websr101,Ray Webster,Cleveland Indians,INDINS,2,2,2,4,1960,1960,0,1.58,-0.36,-1.94,47,6,-41,8,0,-8,62.0,7.0,-55.0,0.0,0.0,0.0
websr102,Ramon Webster,Oakland Athletics,ATLTCS,3,3,3,6,1970,1971,1,-0.66,0.1,0.76,339,68,-271,884,161,-723,0.0,17.0,17.0,17000.0,18200.0,1200.0
weekj001,Jemile Weeks,Oakland Athletics,ATLTCS,1,2,1,3,2013,2014,1,-0.03,-1.33,-1.3,3,41,38,13,1,-12,0.0,121.0,121.0,0.0,6500000.0,6500000.0
weekj001,Jemile Weeks,Baltimore Orioles,ORLS,1,2,2,4,2014,2014,0,0.24,-0.08,-0.32,17,19,2,41,45,4,0.0,0.0,0.0,515000.0,0.0,-515000.0
weekj101,John Weekly,Houston Astros,ASTROS,1,2,1,3,1964,1964,0,0.0,0.62,0.62,0,89,89,0,342,342,0.0,0.0,0.0,0.0,8500.0,8500.0
weekj101,John Weekly,Houston Astros,ASTROS,1,2,1,3,1966,1967,1,0.0,0.2,0.2,0,20,20,0,3,3,0.0,71.0,71.0,0.0,0.0,0.0
wehmh101,Herm Wehmeier,Philadelphia Phillies,PHILS,4,7,7,14,1956,1968,12,28.54,33.07,4.53,1270,1974,704,1527,5948,4421,4802.0,2050.0,-2752.0,0.0,0.0,0.0
wehrd001,Dave Wehrmeister,San Diego Padres,PADRS,1,1,1,2,1979,1979,0,-0.06,-0.02,0.04,5,75,70,0,225,225,21.0,0.0,-21.0,0.0,0.0,0.0
wehrd001,Dave Wehrmeister,New York Yankees,YANKS,1,1,2,3,1983,1983,0,-0.39,0.0,0.39,14,0,-14,2,0,-2,45.0,0.0,-45.0,0.0,0.0,0.0
weigp001,Patrick Weigel,Atlanta Braves,BRAVES,1,2,1,3,2021,2021,0,0.01,-0.18,-0.19,6,32,26,0,78,78,12.0,0.0,-12.0,0.0,2000000.0,2000000.0
weigr101,Ralph Weigel,Cleveland Indians,INDINS,1,1,1,2,1948,1948,0,-0.44,1.16,1.6,66,83,17,179,274,95,0.0,0.0,0.0,0.0,0.0,0.0
weikd101,Dick Weik,Washington Senators,TWINS,8,17,15,32,1950,1963,13,11.48,15.58,4.1,1173,2463,1290,3483,7409,3926,910.0,1792.0,882.0,17500.0,14000.0,-3500.0
weikd101,Dick Weik,Cleveland Indians,INDINS,4,8,7,15,1953,1960,7,29.6,3.08,-26.52,1527,466,-1061,3515,525,-2990,4632.0,1595.0,-3037.0,15900.0,10000.0,-5900.0
weilb101,Bob Weiland,Chicago White Sox,WSOX,3,9,4,13,1930,1936,6,0.81,-0.65,-1.46,234,127,-107,748,417,-331,0.0,39.0,39.0,19600.0,12500.0,-7100.0
weilb101,Bob Weiland,Chicago White Sox,WSOX,1,1,1,2,1931,1934,3,4.66,1.38,-3.28,186,174,-12,160,194,34,1403.0,1583.0,180.0,3000.0,8500.0,5500.0
weilb101,Bob Weiland,Boston Red Sox,RSOX,4,10,7,17,1934,1940,6,25.17,35.69,10.52,1726,1087,-639,6233,3303,-2930,2563.0,4057.0,1494.0,43500.0,48000.0,4500.0
weilb101,Bob Weiland,Cleveland Indians,INDINS,2,4,2,6,1934,1940,6,1.33,10.59,9.26,342,673,331,1172,2639,1467,96.0,0.0,-96.0,5000.0,4250.0,-750.0
weilk001,Kyle Weiland,Boston Red Sox,RSOX,2,6,3,9,2011,2019,8,10.72,7.46,-3.26,739,668,-71,662,2223,1561,960.0,157.0,-803.0,971000.0,4521000.0,3550000.0
weimj101,Jake Weimer,Chicago Cubs,CUBS,1,1,2,3,1905,1911,6,11.75,19.21,7.46,171,733,562,246,2999,2753,1889.0,0.0,-1889.0,0.0,0.0,0.0
weimj101,Jake Weimer,Cincinnati Reds,REDS,1,2,2,4,1908,1910,2,-0.57,0.79,1.36,13,104,91,18,143,125,9.0,1093.0,1084.0,0.0,0.0,0.0
weinl101,Lefty Weinert,Philadelphia Phillies,PHILS,1,1,1,2,1924,1924,0,0.0,0.0,0.0,0,0,0,0,0,0,0.0,0.0,0.0,3600.0,0.0,-3600.0
weinl101,Lefty Weinert,Chicago Cubs,CUBS,1,2,1,3,1928,1932,4,0.0,1.97,1.97,0,170,170,0,586,586,0.0,0.0,0.0,4000.0,0.0,-4000.0
weinp101,Phil Weintraub,New York Giants,GIANTS,1,3,1,4,1935,1947,12,0.93,6.58,5.65,74,650,576,80,2704,2624,660.0,0.0,-660.0,0.0,0.0,0.0
weinp101,Phil Weintraub,Baltimore,Baltimore,1,1,1,2,1938,1938,0,2.49,0.0,-2.49,100,0,-100,421,0,-421,0.0,0.0,0.0,0.0,0.0,0.0
weisa101,Al Weis,Chicago White Sox,WSOX,9,20,20,40,1967,1979,12,42.61,39.14,-3.47,3793,2645,-1148,10113,8109,-2004,6603.0,4869.0,-1734.0,267950.0,412200.0,144250.0
weisw001,Walt Weiss,Oakland Athletics,ATLTCS,1,1,2,3,1992,1992,0,1.48,0.0,-1.48,158,0,-158,591,0,-591,0.0,0.0,0.0,760000.0,0.0,-760000.0
welaj101,Johnny Welaj,Washington Senators,TWINS,16,29,30,59,1941,1963,22,24.05,43.96,19.91,2536,4015,1479,7469,11713,4244,2727.0,6408.0,3681.0,56000.0,82500.0,26500.0
welaj101,Johnny Welaj,Philadelphia Athletics,ATLTCS,1,2,2,4,1943,1943,0,0.0,-0.05,-0.05,0,2,2,0,3,3,0.0,21.0,21.0,9500.0,0.0,-9500.0
welcb001,Bob Welch,Los Angeles Dodgers,DOGRS,1,3,3,6,1987,1992,5,9.39,9.73,0.34,242,1063,821,1,1797,1796,3926.0,1084.0,-2842.0,1187500.0,1137653.0,-49847.0
welcc101,Curt Welch,St.Louis Cardinals,CARDS,1,2,4,6,1887,1897,10,9.58,4.43,-5.15,488,169,-319,2210,668,-1542,3.0,0.0,-3.0,0.0,0.0,0.0
welcm001,Mike Welch,New York Mets,METS,1,1,1,2,1997,1999,2,-0.68,0.0,0.68,20,0,-20,3,0,-3,62.0,0.0,-62.0,0.0,0.0,0.0
weldm101,Mike Welday,Chicago White Sox,WSOX,2,8,2,10,1909,1928,19,0.0,33.7,33.7,0,1837,1837,0,6519,6519,0.0,0.0,0.0,2400.0,0.0,-2400.0
welkd001,Duke Welker,Pittsburgh Pirates,PIRATS,1,2,1,3,2013,2013,0,-0.24,-0.03,0.21,28,25,-3,122,92,-30,0.0,0.0,0.0,0.0,0.0,0.0
welkd001,Duke Welker,Minnesota Twins,TWINS,1,1,1,2,2013,2014,1,0.04,0.24,0.2,2,4,2,0,1,1,4.0,40.0,36.0,0.0,0.0,0.0
wellb001,Brad Wellman,Kansas City Royals,ROYALS,3,7,5,12,1982,1990,8,15.6,24.69,9.09,1105,393,-712,1343,512,-831,5715.0,4650.0,-1065.0,1318000.0,662500.0,-655500.0
wellc001,Casper Wells,Detroit Tigers,TIGRS,7,12,11,23,2011,2021,10,17.56,10.21,-7.35,1262,701,-561,1311,661,-650,4444.0,2831.0,-1613.0,16933000.0,8359750.0,-8573250.0
welld001,David Wells,Detroit Tigers,TIGRS,7,14,18,32,1995,2010,15,14.27,22.97,8.7,4267,1601,-2666,10453,2795,-7658,4780.0,7012.0,2232.0,14390667.0,5079000.0,-9311667.0
welld001,David Wells,Cincinnati Reds,REDS,2,2,3,5,1995,1998,3,2.51,-0.84,-3.35,153,154,1,186,454,268,673.0,51.0,-622.0,0.0,109000.0,109000.0
welld001,David Wells,New York Yankees,YANKS,1,3,1,4,1999,2003,4,11.64,19.58,7.94,456,165,-291,1235,16,-1219,1600.0,3012.0,1412.0,0.0,0.0,0.0
welld001,David Wells,Toronto Blue Jays,BJAYS,2,3,5,8,2001,2001,0,1.34,-0.46,-1.8,17,81,64,2,117,115,302.0,78.0,-224.0,0.0,0.0,0.0
welld001,David Wells,Boston Red Sox,RSOX,1,1,1,2,2006,2009,3,-0.26,-0.21,0.05,54,48,-6,50,112,62,441.0,0.0,-441.0,4075000.0,0.0,-4075000.0
wellg101,Greg Wells,Toronto Blue Jays,BJAYS,1,1,1,2,1982,1983,1,-0.5,-0.81,-0.31,15,152,137,57,369,312,0.0,0.0,0.0,0.0,0.0,0.0
wellj001,Jared Wells,San Diego Padres,PADRS,1,1,1,2,2008,2009,1,-0.17,0.31,0.48,6,45,39,0,38,38,16.0,333.0,317.0,0.0,392500.0,392500.0
wellk001,Kip Wells,Chicago White Sox,WSOX,1,3,2,5,2001,2002,1,9.76,-1.6,-11.36,587,29,-558,520,5,-515,4516.0,401.0,-4115.0,300000.0,1933333.0,1633333.0
wellk001,Kip Wells,Pittsburgh Pirates,PIRATS,2,2,2,4,2006,2010,4,-0.07,-1.84,-1.77,2,228,226,0,194,194,24.0,247.0,223.0,4552000.0,3250000.0,-1302000.0
wellt001,Terry Wells,Houston Astros,ASTROS,1,1,1,2,1990,1990,0,-1.08,2.79,3.87,10,146,136,7,501,494,62.0,0.0,-62.0,0.0,0.0,0.0
wellt002,Todd Wellemeyer,Chicago Cubs,CUBS,1,1,2,3,2006,2006,0,-0.02,0.0,0.02,36,0,-36,0,0,0,64.0,0.0,-64.0,0.0,0.0,0.0
wellv001,Vernon Wells,Toronto Blue Jays,BJAYS,2,2,3,5,2011,2011,0,7.36,0.87,-6.49,588,128,-460,2216,275,-1941,0.0,152.0,152.0,0.0,0.0,0.0
wellv001,Vernon Wells,Anaheim Angels,ANGELS,1,1,2,3,2013,2013,0,-0.08,0.0,0.08,130,0,-130,458,0,-458,0.0,0.0,0.0,0.0,0.0,0.0
welsc001,Chris Welsh,New York Yankees,YANKS,6,13,11,24,1981,1992,11,27.03,19.65,-7.38,2401,1053,-1348,5956,3510,-2446,5438.0,699.0,-4739.0,913333.0,1745000.0,831667.0
welsc001,Chris Welsh,Montreal Expos,NATEX,1,1,1,2,1984,1985,1,0.73,0.0,-0.73,25,0,-25,0,0,0,229.0,0.0,-229.0,0.0,0.0,0.0
welsj101,Jimmy Welsh,Seattle,Seattle,1,1,3,4,1924,1939,15,6.53,0.0,-6.53,553,0,-553,2315,0,-2315,0.0,0.0,0.0,0.0,6100.0,6100.0
welsj101,Jimmy Welsh,Boston Braves,BRAVES,14,32,26,58,1928,1952,24,61.82,116.64,54.82,3287,6047,2760,11058,20048,8990,3053.0,10767.0,7714.0,50600.0,31000.0,-19600.0
welsj101,Jimmy Welsh,New York Giants,GIANTS,2,3,2,5,1929,1930,1,2.77,-1.87,-4.64,281,184,-97,1029,649,-380,0.0,0.0,0.0,0.0,7000.0,7000.0
welsj101,Jimmy Welsh,Boston Braves,BRAVES,5,9,7,16,1930,1938,8,10.35,19.77,9.42,741,1862,1121,2307,7255,4948,1075.0,89.0,-986.0,16000.0,3600.0,-12400.0
wendj001,J.B. Wendelken,Boston Red Sox,RSOX,3,8,6,14,2013,2020,7,1.74,3.1,1.36,152,304,152,96,10,-86,1036.0,1375.0,339.0,5113000.0,0.0,-5113000.0
wendj001,J.B. Wendelken,Chicago White Sox,WSOX,1,2,1,3,2015,2017,2,1.38,1.19,-0.19,101,94,-7,0,384,384,336.0,0.0,-336.0,0.0,1925000.0,1925000.0
wendj002,Joey Wendle,Cleveland Indians,INDINS,2,2,2,4,2014,2019,5,1.27,-0.45,-1.72,215,94,-121,733,375,-358,0.0,0.0,0.0,6500000.0,4100000.0,-2400000.0
wendj002,Joey Wendle,Oakland Athletics,ATLTCS,2,4,4,8,2017,2021,4,10.42,0.25,-10.17,504,191,-313,1839,676,-1163,0.0,0.0,0.0,535000.0,0.0,-535000.0
wendt001,Turk Wendell,Atlanta Braves,BRAVES,1,2,2,4,1991,1993,2,0.81,1.0,0.19,361,259,-102,26,720,694,723.0,247.0,-476.0,0.0,1040000.0,1040000.0
wendt001,Turk Wendell,Chicago Cubs,CUBS,2,4,4,8,1997,2001,4,3.27,3.1,-0.17,1097,717,-380,1379,2198,819,1191.0,830.0,-361.0,9308333.0,6555000.0,-2753333.0
wendt001,Turk Wendell,New York Mets,METS,2,6,5,11,2001,2005,4,2.32,0.95,-1.37,695,209,-486,27,48,21,1207.0,444.0,-763.0,5800000.0,655000.0,-5145000.0
wengd001,Don Wengert,Oakland Athletics,ATLTCS,3,5,4,9,1997,2006,9,-1.08,-1.24,-0.16,199,140,-59,175,236,61,192.0,0.0,-192.0,392000.0,633333.0,241333.0
wengd001,Don Wengert,San Diego Padres,PADRS,1,1,1,2,1998,1998,0,0.13,-0.14,-0.27,44,12,-32,15,0,-15,149.0,8.0,-141.0,240000.0,170000.0,-70000.0
wents101,Stan Wentzel,Boston Braves,BRAVES,4,7,6,13,1946,1952,6,-0.23,24.56,24.79,358,848,490,547,3228,2681,596.0,210.0,-386.0,0.0,0.0,0.0
weraj101,Julie Wera,StPaul,StPaul,1,1,1,2,1926,1926,0,0.01,0.0,-0.01,43,0,-43,58,0,-58,0.0,0.0,0.0,0.0,0.0,0.0
weraj101,Julie Wera,New York Yankees,YANKS,1,2,1,3,1931,1947,16,0.0,24.32,24.32,0,1666,1666,0,7252,7252,0.0,0.0,0.0,0.0,0.0,0.0
werbb101,Billy Werber,Boston Red Sox,RSOX,2,3,4,7,1936,1940,4,20.71,2.22,-18.49,1267,394,-873,4856,1328,-3528,671.0,596.0,-75.0,16000.0,29500.0,13500.0
werhj101,Johnny Werhas,Los Angeles Dodgers,DOGRS,1,1,1,2,1967,1967,0,0.13,0.87,0.74,49,90,41,89,257,168,0.0,0.0,0.0,10000.0,16000.0,6000.0
werlb101,Bill Werle,Pittsburgh Pirates,PIRATS,1,1,1,2,1952,1956,4,-0.28,0.21,0.49,38,80,42,9,41,32,117.0,400.0,283.0,0.0,0.0,0.0
werlb101,Bill Werle,SanFrancisco,SanFrancisco,1,1,3,4,1948,1949,1,3.61,0.0,-3.61,294,0,-294,201,0,-201,1770.0,0.0,-1770.0,0.0,0.0,0.0
werna001,Andrew Werner,San Diego Padres,PADRS,1,2,2,4,2012,2016,4,-0.78,7.91,8.69,52,195,143,95,168,73,0.0,1566.0,1566.0,481000.0,0.0,-481000.0
wernd101,Don Werner,Cincinnati Reds,REDS,1,2,2,4,1980,1980,0,-0.43,0.0,0.43,24,0,-24,73,0,-73,0.0,0.0,0.0,0.0,0.0,0.0
wernd101,Don Werner,Kansas City Royals,ROYALS,1,2,1,3,1984,1986,2,-0.02,-0.09,-0.07,22,5,-17,15,0,-15,132.0,39.0,-93.0,0.0,0.0,0.0
wertb001,Bill Wertz,Cleveland Indians,INDINS,1,1,1,2,1996,1996,0,0.0,0.0,0.0,0,0,0,0,0,0,0.0,0.0,0.0,0.0,0.0,0.0
wertd101,Dennis Werth,New York Yankees,YANKS,1,1,1,2,1982,1982,0,-0.12,0.0,0.12,41,0,-41,19,0,-19,0.0,0.0,0.0,0.0,0.0,0.0
wertd103,Don Wert,Detroit Tigers,TIGRS,3,8,7,15,1970,1979,9,1.68,25.88,24.2,545,2212,1667,1182,7310,6128,747.0,4256.0,3509.0,232600.0,149500.0,-83100.0
wertj001,Jayson Werth,Baltimore Orioles,ORLS,2,2,2,4,2000,2003,3,0.17,1.98,1.81,41,164,123,104,569,465,0.0,80.0,80.0,0.0,237500.0,237500.0
wertj001,Jayson Werth,Toronto Blue Jays,BJAYS,3,7,7,14,2004,2014,10,3.57,12.83,9.26,587,928,341,810,1646,836,842.0,1398.0,556.0,7829600.0,16693000.0,8863400.0
wertj101,Johnny Werts,Boston Braves,BRAVES,1,3,1,4,1928,1928,0,0.0,-0.51,-0.51,0,14,14,0,6,6,0.0,65.0,65.0,10080.0,0.0,-10080.0
wertv101,Vic Wertz,Detroit Tigers,TIGRS,6,16,16,32,1952,1961,9,19.6,10.08,-9.52,1436,1371,-65,2274,3811,1537,4378.0,2214.0,-2164.0,23200.0,36000.0,12800.0
wertv101,Vic Wertz,Baltimore Orioles,ORLS,5,8,10,18,1954,1960,6,21.82,11.95,-9.87,1218,957,-261,3526,2530,-996,2291.0,1476.0,-815.0,0.0,4800.0,4800.0
wertv101,Vic Wertz,Cleveland Indians,INDINS,3,4,5,9,1958,1965,7,9.07,15.07,6.0,1121,727,-394,4065,1984,-2081,0.0,1913.0,1913.0,0.0,0.0,0.0
westd001,David West,New York Mets,METS,1,5,1,6,1989,1991,2,34.39,9.58,-24.81,807,164,-643,0,204,204,6852.0,1699.0,-5153.0,378000.0,2766666.0,2388666.0
westd001,David West,Minnesota Twins,TWINS,1,1,1,2,1992,1993,1,3.78,1.22,-2.56,244,53,-191,60,0,-60,755.0,243.0,-512.0,0.0,225000.0,225000.0
westd001,David West,Houston Astros,ASTROS,1,1,1,2,1998,1998,0,-0.31,0.0,0.31,6,0,-6,0,0,0,6.0,0.0,-6.0,0.0,0.0,0.0
westj001,Jake Westbrook,Colorado Rockies,ROCKS,8,16,13,29,1997,2002,5,6.04,1.53,-4.51,876,711,-165,660,1343,683,2239.0,928.0,-1311.0,9375000.0,9275000.0,-100000.0
westj001,Jake Westbrook,Montreal Expos,NATEX,1,3,1,4,1999,2001,2,1.49,-0.32,-1.81,57,27,-30,6,21,15,645.0,214.0,-431.0,0.0,3125000.0,3125000.0
westj001,Jake Westbrook,New York Yankees,YANKS,5,9,7,16,2000,2012,12,11.39,22.07,10.68,570,1540,970,441,4696,4255,3809.0,682.0,-3127.0,14660923.0,19005000.0,4344077.0
westj001,Jake Westbrook,Cleveland Indians,INDINS,2,3,3,6,2010,2020,10,1.34,32.12,30.78,188,260,72,187,150,-37,1652.0,4025.0,2373.0,28000000.0,1400000.0,-26600000.0
westm001,Mickey Weston,Baltimore Orioles,ORLS,1,1,1,2,1990,1991,1,0.08,-0.6,-0.68,2,38,36,0,0,0,6.0,186.0,180.0,104500.0,242500.0,138000.0
westm102,Max West,Boston Braves,BRAVES,1,1,2,3,1946,1946,0,0.38,-0.01,-0.39,72,20,-52,235,3,-232,0.0,46.0,46.0,0.0,0.0,0.0
westm102,Max West,Cleveland Indians,INDINS,2,2,2,4,1951,1951,0,0.0,-0.14,-0.14,0,11,11,0,12,12,0.0,0.0,0.0,0.0,0.0,0.0
wests101,Sam West,Washington Senators,TWINS,3,6,5,11,1932,1936,4,25.58,12.35,-13.23,1434,628,-806,5873,2235,-3638,390.0,1249.0,859.0,38000.0,36200.0,-1800.0
wests101,Sam West,St.Louis Browns,ORLS,1,1,1,2,1938,1939,1,4.51,0.82,-3.69,290,144,-146,1024,624,-400,0.0,0.0,0.0,0.0,7000.0,7000.0
westw102,Wally Westlake,Oakland,Oakland,1,1,2,3,1946,1946,0,11.3,0.0,-11.3,580,0,-580,2223,0,-2223,0.0,0.0,0.0,0.0,0.0,0.0
westw102,Wally Westlake,Pittsburgh Pirates,PIRATS,20,37,49,86,1951,1973,22,26.24,49.68,23.44,3262,4651,1389,9080,13358,4278,3705.0,3970.0,265.0,216500.0,102000.0,-114500.0
westw102,Wally Westlake,St. Louis Cardinals,CARDS,2,5,3,8,1952,1954,2,-0.48,0.45,0.93,72,246,174,232,797,565,0.0,0.0,0.0,0.0,25500.0,25500.0
westw102,Wally Westlake,Cincinnati Reds,REDS,1,1,2,3,1952,1952,0,3.24,0.0,-3.24,212,0,-212,636,0,-636,0.0,0.0,0.0,0.0,0.0,0.0
westw102,Wally Westlake,Cleveland Indians,INDINS,9,17,16,33,1955,1968,13,100.62,38.17,-62.45,4524,2758,-1766,15556,10180,-5376,4502.0,562.0,-3940.0,0.0,32000.0,32000.0
wethj001,Jeff Wetherby,Atlanta Braves,BRAVES,1,2,2,4,1990,1990,0,0.0,0.0,0.0,0,0,0,0,0,0,0.0,0.0,0.0,0.0,0.0,0.0
wettj001,John Wetteland,Los Angeles Dodgers,DOGRS,3,4,4,8,1991,1994,3,3.76,0.59,-3.17,176,242,66,364,733,369,1120.0,132.0,-988.0,2900000.0,3708000.0,808000.0
wettj001,John Wetteland,Cincinnati Reds,REDS,5,7,10,17,1991,2006,15,8.76,8.38,-0.38,1127,1227,100,1121,3011,1890,1371.0,1423.0,52.0,12068333.0,8870833.0,-3197500.0
wettj001,John Wetteland,Montreal Expos,NATEX,1,1,2,3,1995,2001,6,4.06,-0.58,-4.64,123,173,50,0,394,394,375.0,0.0,-375.0,0.0,0.0,0.0
whalb101,Bert Whaling,Boston Braves,BRAVES,1,2,1,3,1915,1917,2,0.0,0.67,0.67,0,170,170,0,638,638,0.0,0.0,0.0,6800.0,0.0,-6800.0
whalr001,Rob Whalen,New York Mets,METS,1,2,2,4,2015,2015,0,-0.77,0.79,1.56,50,93,43,21,281,260,224.0,0.0,-224.0,0.0,8000000.0,8000000.0
whalr001,Rob Whalen,Atlanta Braves,BRAVES,2,3,3,6,2016,2021,5,-0.2,0.58,0.78,48,74,26,123,266,143,45.0,0.0,-45.0,0.0,0.0,0.0
wheal101,Lee Wheat,Cleveland Indians,INDINS,1,3,1,4,1954,1955,1,-0.18,-0.05,0.13,26,176,150,8,639,631,106.0,0.0,-106.0,0.0,0.0,0.0
wheal101,Lee Wheat,Kansas City Athletics,ATLTCS,32,65,62,127,1956,1976,20,95.85,56.13,-39.72,9593,6816,-2777,23097,19555,-3542,12004.0,6179.0,-5825.0,476100.0,606500.0,130400.0
wheam101,Mack Wheat,Newark,Newark,1,1,1,2,1915,1915,0,-1.75,0.0,1.75,137,0,-137,369,0,-369,0.0,0.0,0.0,0.0,0.0,0.0
wheaw101,Woody Wheaton,Philadelphia Athletics,ATLTCS,1,5,1,6,1944,1946,2,0.0,1.19,1.19,0,162,162,0,669,669,0.0,0.0,0.0,3000.0,0.0,-3000.0
wheed001,Dan Wheeler,New York Mets,METS,1,1,1,2,2004,2004,0,4.64,0.0,-4.64,400,0,-400,0,0,0,626.0,0.0,-626.0,311500.0,0.0,-311500.0
wheed001,Dan Wheeler,Houston Astros,ASTROS,1,1,2,3,2007,2008,1,2.19,2.71,0.52,246,161,-85,0,616,616,592.0,0.0,-592.0,2100000.0,2700000.0,600000.0
wheej001,Jason Wheeler,Los Angeles Dodgers,DOGRS,1,1,1,2,2017,2017,0,0.0,0.0,0.0,0,0,0,0,0,0,0.0,0.0,0.0,0.0,0.0,0.0
wheer001,Ryan Wheeler,Arizona Diamondbacks,DBACKS,1,1,1,2,2012,2016,4,-1.06,0.75,1.81,59,93,34,106,0,-106,0.0,123.0,123.0,0.0,481000.0,481000.0
wheez001,Zack Wheeler,San Francisco Giants,GIANTS,1,1,2,3,2011,2011,0,10.76,1.17,-9.59,246,44,-202,250,179,-71,2248.0,0.0,-2248.0,0.0,19325436.0,19325436.0
whelk001,Kevin Whelan,Detroit Tigers,TIGRS,1,3,1,4,2006,2009,3,-0.32,2.79,3.11,6,247,241,0,1075,1075,19.0,0.0,-19.0,0.0,10756171.0,10756171.0
whilj101,Jack Whillock,Detroit Tigers,TIGRS,1,1,1,2,1973,1973,0,0.0,0.0,0.0,0,0,0,0,0,0,0.0,0.0,0.0,0.0,0.0,0.0
whism001,Matt Whisenant,Philadelphia Phillies,PHILS,1,2,1,3,1992,1994,2,-0.36,6.59,6.95,27,115,88,0,149,149,41.0,1169.0,1128.0,0.0,0.0,0.0
whism001,Matt Whisenant,Florida Marlins,MARLNS,1,1,1,2,1997,2008,11,0.2,2.01,1.81,152,274,122,0,832,832,358.0,0.0,-358.0,150000.0,0.0,-150000.0
whisp101,Pete Whisenant,Milwaukee Braves,BRAVES,1,1,1,2,1955,1959,4,-0.74,-0.76,-0.02,58,208,150,122,613,491,0.0,0.0,0.0,0.0,0.0,0.0
whisp101,Pete Whisenant,St. Louis Cardinals,CARDS,1,1,1,2,1956,1956,0,1.02,0.9,-0.12,103,75,-28,346,181,-165,0.0,0.0,0.0,0.0,0.0,0.0
whisp101,Pete Whisenant,Chicago Cubs,CUBS,2,5,4,9,1956,1958,2,7.54,-1.1,-8.64,773,105,-668,2296,34,-2262,130.0,197.0,67.0,0.0,0.0,0.0
whisp101,Pete Whisenant,Cleveland Indians,INDINS,1,1,1,2,1960,1960,0,-0.14,2.56,2.7,68,117,49,140,520,380,0.0,0.0,0.0,0.0,0.0,0.0
whita001,Alex White,Cleveland Indians,INDINS,1,4,1,5,2011,2013,2,-0.32,1.97,2.29,204,79,-125,247,10,-237,813.0,1274.0,461.0,0.0,2800000.0,2800000.0
whita001,Alex White,Colorado Rockies,ROCKS,1,2,2,4,2012,2014,2,0.0,0.63,0.63,0,153,153,0,1,1,0.0,245.0,245.0,0.0,515500.0,515500.0
whita102,Art Whitney,Pittsburgh Pirates,PIRATS,1,1,1,2,1888,1888,0,0.62,0.2,-0.42,220,30,-190,868,115,-753,13.0,0.0,-13.0,0.0,0.0,0.0
whitb101,Burgess Whitehead,St. Louis Cardinals,CARDS,2,3,4,7,1935,1942,7,9.44,16.07,6.63,978,440,-538,3815,541,-3274,437.0,4133.0,3696.0,0.0,15500.0,15500.0
whitb105,Bill White,San Francisco Giants,GIANTS,1,2,2,4,1959,1961,2,28.04,6.49,-21.55,1173,252,-921,4711,231,-4480,0.0,1899.0,1899.0,0.0,0.0,0.0
whitb105,Bill White,St. Louis Cardinals,CARDS,11,23,19,42,1965,1972,7,31.6,1.61,-29.99,3237,670,-2567,8420,1434,-6986,1865.0,703.0,-1162.0,32500.0,24000.0,-8500.0
whitb105,Bill White,Philadelphia Phillies,PHILS,5,10,9,19,1969,1984,15,35.13,12.22,-22.91,1727,1537,-190,5411,1840,-3571,1000.0,2166.0,1166.0,0.0,123000.0,123000.0
whitb108,Bill Whitby,Minnesota Twins,TWINS,1,1,2,3,1969,1969,0,0.0,0.0,0.0,0,0,0,0,0,0,0.0,0.0,0.0,0.0,0.0,0.0
whitc101,Charlie White,Baltimore Orioles,ORLS,1,2,1,3,1954,1954,0,0.12,-0.22,-0.34,62,2,-60,138,1,-137,0.0,12.0,12.0,0.0,0.0,0.0
whitc102,Charlie Whitehouse,Indianapolis,Indianapolis,1,1,3,4,1920,1928,8,0.0,0.0,0.0,0,0,0,0,0,0,0.0,0.0,0.0,0.0,1800.0,1800.0
whitd001,Devon White,California Angels,ANGELS,2,4,5,9,1990,1993,3,21.39,3.93,-17.46,688,442,-246,3033,1668,-1365,79.0,0.0,-79.0,1180000.0,3888333.0,2708333.0
whitd001,Devon White,Florida Marlins,MARLNS,2,2,2,4,1997,2002,5,3.75,0.6,-3.15,146,250,104,627,860,233,0.0,0.0,0.0,3400000.0,0.0,-3400000.0
whitd001,Devon White,Los Angeles Dodgers,DOGRS,2,2,3,5,2001,2003,2,0.82,0.03,-0.79,126,298,172,432,953,521,0.0,0.0,0.0,0.0,0.0,0.0
whitd103,Dick Whitman,Philadelphia Phillies,PHILS,1,2,1,3,1951,1952,1,0.0,-0.41,-0.41,0,96,96,0,243,243,0.0,0.0,0.0,10000.0,9000.0,-1000.0
white001,Ed Whitson,Pittsburgh Pirates,PIRATS,2,4,6,10,1979,1990,11,17.64,30.66,13.02,910,2106,1196,973,7523,6550,3555.0,123.0,-3432.0,975500.0,260000.0,-715500.0
white001,Ed Whitson,San Francisco Giants,GIANTS,1,1,1,2,1981,1985,4,2.62,-1.37,-3.99,40,271,231,0,606,606,323.0,0.0,-323.0,0.0,0.0,0.0
white001,Ed Whitson,Cleveland Indians,INDINS,1,1,2,3,1982,1984,2,15.84,-0.69,-16.53,463,165,-298,481,273,-208,4063.0,402.0,-3661.0,0.0,0.0,0.0
white001,Ed Whitson,New York Yankees,YANKS,1,1,1,2,1986,1988,2,13.61,0.95,-12.66,334,109,-225,365,0,-365,3063.0,591.0,-2472.0,800000.0,675000.0,-125000.0
white002,Ernie Whitt,Toronto Blue Jays,BJAYS,1,2,1,3,1989,1993,4,-1.22,-0.11,1.11,67,2,-65,204,0,-204,0.0,5.0,5.0,800000.0,0.0,-800000.0
white003,Ed Whited,Houston Astros,ASTROS,1,2,2,4,1987,1992,5,-0.79,-1.14,-0.35,36,612,576,82,2086,2004,0.0,0.0,0.0,0.0,875000.0,875000.0
white006,Eli White,Oakland Athletics,ATLTCS,2,4,3,7,2018,2019,1,0.76,-0.15,-0.91,276,139,-137,886,518,-368,0.0,0.0,0.0,4147500.0,1050000.0,-3097500.0
white102,Earl Whitehill,Detroit Tigers,TIGRS,1,1,2,3,1932,1935,3,12.58,7.81,-4.77,270,276,6,428,268,-160,2990.0,2107.0,-883.0,0.0,6500.0,6500.0
white102,Earl Whitehill,Washington Senators,TWINS,1,1,1,2,1936,1937,1,-1.03,0.0,1.03,118,0,-118,125,0,-125,922.0,0.0,-922.0,0.0,0.0,0.0
whitf103,Fred Whitfield,St. Louis Cardinals,CARDS,11,19,18,37,1962,1976,14,28.47,15.48,-12.99,2535,1258,-1277,5298,686,-4612,6302.0,3329.0,-2973.0,0.0,0.0,0.0
whitf103,Fred Whitfield,Cleveland Indians,INDINS,1,3,1,4,1967,1968,1,1.38,0.99,-0.39,316,130,-186,387,265,-122,982.0,0.0,-982.0,27000.0,25000.0,-2000.0
whitg001,Gabe White,Montreal Expos,NATEX,1,1,1,2,1995,1995,0,2.89,0.0,-2.89,525,0,-525,26,0,-26,988.0,0.0,-988.0,109000.0,0.0,-109000.0
whitg001,Gabe White,Cincinnati Reds,REDS,3,5,5,10,2000,2002,2,4.91,-0.68,-5.59,311,84,-227,13,25,12,534.0,281.0,-253.0,630000.0,2670000.0,2040000.0
whitg001,Gabe White,Colorado Rockies,ROCKS,4,6,7,13,2001,2003,2,2.38,1.01,-1.37,515,182,-333,507,247,-260,927.0,121.0,-806.0,4816667.0,6725000.0,1908333.0
whitg001,Gabe White,New York Yankees,YANKS,1,1,2,3,2004,2007,3,-0.62,0.0,0.62,80,0,-80,0,0,0,117.0,0.0,-117.0,1925000.0,0.0,-1925000.0
whith101,Hal White,Detroit Tigers,TIGRS,13,25,26,51,1952,1968,16,25.92,52.07,26.15,2610,3104,494,6934,6097,-837,4331.0,10073.0,5742.0,79500.0,15900.0,-63600.0
whitj001,Jerry White,Montreal Expos,NATEX,1,1,1,2,1978,1983,5,0.22,1.87,1.65,59,450,391,162,72,-90,0.0,1045.0,1045.0,0.0,0.0,0.0
whitj001,Jerry White,Chicago Cubs,CUBS,1,2,1,3,1978,1979,1,3.97,-0.08,-4.05,798,31,-767,2458,14,-2444,0.0,0.0,0.0,0.0,0.0,0.0
whitj101,John Whitehead,Chicago White Sox,WSOX,1,1,1,2,1939,1939,0,0.32,0.06,-0.26,90,57,-33,31,62,31,330.0,270.0,-60.0,0.0,6000.0,6000.0
whitj102,Jim Whitney,Washington Senators,WS8,1,1,1,2,1889,1889,0,0.0,0.0,0.0,0,0,0,0,0,0,0.0,0.0,0.0,0.0,0.0,0.0
whitj104,Jo-Jo White,Seattle,Seattle,1,1,1,2,1942,1943,1,1.01,0.0,-1.01,224,0,-224,889,0,-889,0.0,0.0,0.0,0.0,6000.0,6000.0
whitj104,Jo-Jo White,Detroit Tigers,TIGRS,1,5,1,6,1938,1952,14,0.0,25.69,25.69,0,589,589,0,728,728,0.0,4363.0,4363.0,11000.0,0.0,-11000.0
whitk101,Kirby White,Boston Braves,BRAVES,1,1,2,3,1910,1911,1,0.74,-1.88,-2.62,64,213,149,55,568,513,467.0,814.0,347.0,0.0,0.0,0.0
whitl002,Larry White,Cleveland Indians,INDINS,17,30,35,65,1981,2001,20,116.55,78.96,-37.59,6988,5496,-1492,21431,20127,-1304,7765.0,4126.0,-3639.0,20493332.0,19210000.0,-1283332.0
whitl003,Len Whitehouse,Texas Rangers,RNGRS,1,1,1,2,1982,1983,1,0.93,0.0,-0.93,95,0,-95,0,0,0,337.0,0.0,-337.0,0.0,0.0,0.0
whitm001,Mark Whiten,Toronto Blue Jays,BJAYS,1,4,2,6,1991,1993,2,4.36,3.25,-1.11,538,117,-421,1892,245,-1647,194.0,389.0,195.0,115000.0,2600000.0,2485000.0
whitm001,Mark Whiten,Cleveland Indians,INDINS,2,2,4,6,1993,1996,3,4.72,4.68,-0.04,353,76,-277,1130,23,-1107,1063.0,1084.0,21.0,0.0,0.0,0.0
whitm001,Mark Whiten,St. Louis Cardinals,CARDS,2,3,3,6,1995,1996,1,1.59,0.67,-0.92,214,226,12,117,434,317,740.0,182.0,-558.0,125000.0,0.0,-125000.0
whitm001,Mark Whiten,Boston Red Sox,RSOX,1,1,1,2,1995,1995,0,3.11,0.03,-3.08,120,5,-115,461,17,-444,0.0,0.0,0.0,1638268.0,2000000.0,361732.0
whitm001,Mark Whiten,Atlanta Braves,BRAVES,1,1,1,2,1996,1996,0,1.68,0.0,-1.68,40,0,-40,163,0,-163,0.0,0.0,0.0,0.0,0.0,0.0
whitm003,Matt White,Boston Red Sox,RSOX,1,1,1,2,2003,2003,0,-0.12,0.0,0.12,4,0,-4,0,0,0,6.0,0.0,-6.0,300000.0,0.0,-300000.0
whitm103,Mike White,California Angels,ANGELS,1,2,2,4,1966,1967,1,0.0,0.0,0.0,0,0,0,0,0,0,0.0,0.0,0.0,0.0,0.0,0.0
whitp102,Possum Whitted,St. Louis Cardinals,CARDS,1,2,1,3,1914,1914,0,0.65,1.83,1.18,156,44,-112,545,55,-490,0.0,460.0,460.0,2300.0,0.0,-2300.0
whitp102,Possum Whitted,Boston Braves,BRAVES,1,3,1,4,1915,1917,2,5.22,6.66,1.44,653,350,-303,2277,1416,-861,0.0,0.0,0.0,0.0,0.0,0.0
whitp102,Possum Whitted,Philadelphia Phillies,PHILS,3,5,5,10,1919,1923,4,11.59,-1.78,-13.37,628,470,-158,2396,1854,-542,0.0,0.0,0.0,10000.0,8200.0,-1800.0
whitp103,Pinky Whitney,Boston Braves,BRAVES,2,2,2,4,1936,1938,2,5.14,0.0,-5.14,446,109,-337,1587,323,-1264,0.0,0.0,0.0,0.0,0.0,0.0
whitp103,Pinky Whitney,Philadelphia Phillies,PHILS,4,10,6,16,1933,1941,8,6.58,22.7,16.12,1012,1092,80,3802,2883,-919,324.0,2494.0,2170.0,0.0,0.0,0.0
whitr001,Rondell White,Montreal Expos,NATEX,1,1,1,2,2000,2004,4,2.57,-1.2,-3.77,114,27,-87,431,25,-406,0.0,207.0,207.0,4000000.0,0.0,-4000000.0
whitr001,Rondell White,New York Yankees,YANKS,1,1,3,4,2003,2003,0,1.96,-0.1,-2.06,115,22,-93,449,61,-388,0.0,0.0,0.0,0.0,0.0,0.0
whitr001,Rondell White,San Diego Padres,PADRS,2,2,3,5,2003,2004,1,0.31,0.0,-0.31,93,0,-93,86,0,-86,127.0,0.0,-127.0,5500000.0,0.0,-5500000.0
whitr002,Rick White,Tampa Bay Devil Rays,RAYS,1,2,2,4,2000,2003,3,0.01,4.03,4.02,189,316,127,73,802,729,294.0,1188.0,894.0,863000.0,0.0,-863000.0
whitr002,Rick White,Los Angeles Dodgers,DOGRS,1,1,1,2,2004,2004,0,-0.61,0.0,0.61,65,0,-65,0,0,0,235.0,0.0,-235.0,0.0,0.0,0.0
whits101,Steve Whitaker,Kansas City Royals,ROYALS,2,4,2,6,1969,1977,8,11.49,4.04,-7.45,1298,779,-519,3743,2778,-965,624.0,554.0,-70.0,65000.0,48000.0,-17000.0
whits101,Steve Whitaker,Milwaukee Brewers,BREWRS,2,3,2,5,1969,1970,1,2.45,-0.08,-2.53,213,64,-149,45,45,0,485.0,396.0,-89.0,48000.0,33000.0,-15000.0
whits102,Steve White,Boston Red Sox,RSOX,10,29,25,54,1911,1935,24,51.77,27.79,-23.98,3792,3076,-716,15081,11324,-3757,0.0,1203.0,1203.0,45050.0,29350.0,-15700.0
whits103,Sammy White,Boston Red Sox,RSOX,3,7,4,11,1960,1966,6,-0.53,-1.25,-0.72,125,550,425,299,1387,1088,0.0,336.0,336.0,18500.0,0.0,-18500.0
whits103,Sammy White,Seattle,Seattle,1,1,1,2,1949,1949,0,1.9,0.0,-1.9,981,0,-981,3621,0,-3621,0.0,0.0,0.0,0.0,0.0,0.0
whitt001,Terry Whitfield,New York Yankees,YANKS,2,4,2,6,1977,1977,0,1.79,2.44,0.65,858,32,-826,2573,4,-2569,78.0,651.0,573.0,0.0,100000.0,100000.0
whitt002,Tyler White,Houston Astros,ASTROS,1,1,1,2,2019,2019,0,-0.46,0.0,0.46,12,0,-12,26,0,-26,0.0,0.0,0.0,582900.0,0.0,-582900.0
whitw001,Wally Whitehurst,Oakland Athletics,ATLTCS,1,4,2,6,1987,1994,7,2.78,10.76,7.98,260,216,-44,78,1,-77,952.0,3814.0,2862.0,1137653.0,0.0,-1137653.0
whitw001,Wally Whitehurst,New York Mets,METS,2,4,2,6,1992,1993,1,12.22,-0.41,-12.63,490,79,-411,1635,295,-1340,509.0,0.0,-509.0,2535000.0,4200000.0,1665000.0
wicka101,Al Wickland,StPaul,StPaul,1,1,1,2,1919,1919,0,-0.75,0.0,0.75,26,0,-26,49,0,-49,0.0,0.0,0.0,0.0,0.0,0.0
wickb001,Bob Wickman,Chicago White Sox,WSOX,1,3,1,4,1992,1994,2,12.77,-0.22,-12.99,326,200,-126,0,759,759,3273.0,0.0,-3273.0,0.0,0.0,0.0
wickb001,Bob Wickman,New York Yankees,YANKS,2,5,4,9,1996,2003,7,18.7,20.21,1.51,1086,282,-804,1937,16,-1921,2545.0,3310.0,765.0,1050000.0,3840000.0,2790000.0
wickb001,Bob Wickman,Milwaukee Brewers,BREWRS,9,19,22,41,2000,2012,12,44.17,39.37,-4.8,3016,3033,17,9285,7113,-2172,2619.0,7597.0,4978.0,13997000.0,20222667.0,6225667.0
wickb001,Bob Wickman,Cleveland Indians,INDINS,2,2,2,4,2006,2007,1,1.23,0.74,-0.49,197,52,-145,140,196,56,209.0,0.0,-209.0,5000000.0,6000000.0,1000000.0
wickb101,Bob Wicker,St. Louis Cardinals,CARDS,1,1,1,2,1903,1910,7,8.69,-0.8,-9.49,211,35,-176,381,52,-329,2177.0,383.0,-1794.0,0.0,0.0,0.0
wickb101,Bob Wicker,Chicago Cubs,CUBS,1,1,2,3,1906,1913,7,0.58,19.28,18.7,40,329,289,54,440,386,448.0,3405.0,2957.0,0.0,0.0,0.0
wickd101,Dave Wickersham,Kansas City Athletics,ATLTCS,15,33,27,60,1963,1976,13,55.99,46.74,-9.25,6677,4175,-2502,14870,13661,-1209,10290.0,2197.0,-8093.0,387100.0,512500.0,125400.0
wickd101,Dave Wickersham,Detroit Tigers,TIGRS,3,3,3,6,1967,1972,5,3.73,-0.74,-4.47,476,328,-148,46,564,518,1071.0,291.0,-780.0,49000.0,29000.0,-20000.0
wickd101,Dave Wickersham,Kansas City Royals,ROYALS,1,1,1,2,1969,1970,1,0.0,0.0,0.0,0,0,0,0,0,0,0.0,0.0,0.0,25000.0,0.0,-25000.0
wickf101,Floyd Wicker,Montreal Expos,NATEX,1,1,1,2,1969,1971,2,-0.3,-0.32,-0.02,26,110,84,52,391,339,0.0,0.0,0.0,0.0,0.0,0.0
wickf101,Floyd Wicker,Milwaukee Brewers,BREWRS,4,6,4,10,1971,1976,5,3.35,4.86,1.51,554,421,-133,1839,819,-1020,335.0,641.0,306.0,163000.0,34000.0,-129000.0
wickk001,Kevin Wickander,Cleveland Indians,INDINS,1,1,1,2,1993,1993,0,-0.56,0.0,0.56,66,0,-66,2,0,-2,76.0,0.0,-76.0,145000.0,0.0,-145000.0
wickk001,Kevin Wickander,Detroit Tigers,TIGRS,1,1,1,2,1995,1995,0,0.45,0.0,-0.45,29,0,-29,0,0,0,94.0,0.0,-94.0,160000.0,0.0,-160000.0
wickk101,Kemp Wicker,Brooklyn Dodgers,DOGRS,1,3,1,4,1941,1946,5,0.0,-0.17,-0.17,0,19,19,0,34,34,0.0,0.0,0.0,0.0,8000.0,8000.0
wickr001,Rowan Wick,San Diego Padres,PADRS,1,1,1,2,2018,2020,2,0.91,0.0,-0.91,124,0,-124,0,0,0,221.0,0.0,-221.0,0.0,0.0,0.0
widet001,Taylor Widener,New York Yankees,YANKS,2,4,2,6,2018,2020,2,-0.27,4.02,4.29,326,71,-255,950,61,-889,271.0,823.0,552.0,621900.0,13000000.0,12378100.0
widgc001,Chris Widger,Seattle Mariners,MARNRS,2,4,3,7,1996,1999,3,0.25,7.02,6.77,475,103,-372,1514,15,-1499,341.0,1794.0,1453.0,5016667.0,2800000.0,-2216667.0
widgc001,Chris Widger,Montreal Expos,NATEX,2,4,3,7,2000,2006,6,0.49,7.12,6.63,227,328,101,766,1220,454,26.0,20.0,-6.0,4745000.0,7500000.0,2755000.0
widma101,Al Widmar,Boston Red Sox,RSOX,2,8,5,13,1947,1955,8,6.5,21.93,15.43,835,962,127,1487,3127,1640,2844.0,2066.0,-778.0,10000.0,32000.0,22000.0
widma101,Al Widmar,St.Louis Browns,ORLS,34,89,94,183,1951,1988,37,141.32,199.23,57.91,10082,16608,6526,23224,49618,26394,30166.0,18711.0,-11455.0,889583.0,189900.0,-699683.0
wieat101,Ted Wieand,St. Louis Cardinals,CARDS,27,56,48,104,1957,1994,37,117.05,198.75,81.7,11329,9665,-1664,30194,33834,3640,12663.0,4453.0,-8210.0,3323333.0,942667.0,-2380666.0
wieat101,Ted Wieand,Cincinnati Reds,REDS,1,3,2,5,1960,1960,0,3.11,0.0,-3.11,276,0,-276,63,0,-63,598.0,0.0,-598.0,0.0,0.0,0.0
wiecb001,Brad Wieck,New York Mets,METS,1,2,1,3,2015,2015,0,-1.89,0.09,1.98,94,76,-18,2,1,-1,145.0,103.0,-42.0,0.0,0.0,0.0
wiecb001,Brad Wieck,San Diego Padres,PADRS,1,1,1,2,2019,2019,0,0.8,-0.23,-1.03,58,4,-54,0,0,0,84.0,5.0,-79.0,0.0,1500000.0,1500000.0
wiegt001,Tom Wieghaus,Montreal Expos,NATEX,1,1,1,2,1984,1984,0,-0.34,0.0,0.34,6,0,-6,12,0,-12,0.0,0.0,0.0,0.0,0.0,0.0
wielj001,Joe Wieland,Texas Rangers,RNGRS,1,2,1,3,2011,2012,1,-0.83,1.99,2.82,224,92,-132,92,0,-92,1056.0,234.0,-822.0,0.0,2535000.0,2535000.0
wielj001,Joe Wieland,San Diego Padres,PADRS,2,5,4,9,2014,2016,2,8.85,0.65,-8.2,684,254,-430,2593,1079,-1514,26.0,0.0,-26.0,1293600.0,21000000.0,19706400.0
wielj001,Joe Wieland,Los Angeles Dodgers,DOGRS,2,5,3,8,2016,2021,5,-0.91,0.86,1.77,22,242,220,43,6,-37,56.0,333.0,277.0,0.0,0.0,0.0
wielj001,Joe Wieland,Seattle Mariners,MARNRS,1,1,1,2,2016,2016,0,0.0,0.0,0.0,0,0,0,0,0,0,0.0,0.0,0.0,590000.0,0.0,-590000.0
wiesb101,Bob Wiesler,New York Yankees,YANKS,7,20,15,35,1956,1970,14,3.04,33.17,30.13,2442,2492,50,6615,5619,-996,2999.0,5239.0,2240.0,115500.0,43000.0,-72500.0
wietw101,Whitey Wietelmann,Boston Braves,BRAVES,4,7,6,13,1946,1952,6,-0.23,24.56,24.79,358,848,490,547,3228,2681,596.0,210.0,-386.0,0.0,0.0,0.0
wigga001,Alan Wiggins,San Diego Padres,PADRS,1,1,2,3,1985,1986,1,-0.72,0.74,1.46,232,44,-188,947,6,-941,0.0,120.0,120.0,512500.0,0.0,-512500.0
wiggs001,Scott Wiggins,New York Yankees,YANKS,3,4,5,9,2002,2007,5,0.56,1.31,0.75,51,257,206,183,839,656,17.0,91.0,74.0,13000000.0,12200000.0,-800000.0
wiggt001,Ty Wigginton,New York Mets,METS,4,6,6,12,2004,2010,6,-0.86,11.14,12.0,655,533,-122,1973,723,-1250,683.0,3210.0,2527.0,2841000.0,10775000.0,7934000.0
wiggt001,Ty Wigginton,Tampa Bay Devil Rays,RAYS,1,2,1,3,2007,2010,3,2.71,2.19,-0.52,161,246,85,616,0,-616,0.0,592.0,592.0,2700000.0,2100000.0,-600000.0
wighb101,Bill Wight,New York Yankees,YANKS,2,4,2,6,1948,1956,8,8.14,18.41,10.27,334,437,103,647,602,-45,2224.0,4492.0,2268.0,0.0,0.0,0.0
wighb101,Bill Wight,Chicago White Sox,WSOX,5,11,10,21,1950,1963,13,1.07,31.48,30.41,1321,1905,584,3161,6140,2979,1824.0,1373.0,-451.0,20000.0,31000.0,11000.0
wighb101,Bill Wight,Boston Red Sox,RSOX,2,6,6,12,1952,1956,4,8.2,10.1,1.9,1335,867,-468,4777,3045,-1732,507.0,401.0,-106.0,80000.0,40000.0,-40000.0
wighb101,Bill Wight,Detroit Tigers,TIGRS,3,7,7,14,1953,1959,6,19.59,21.85,2.26,1560,1406,-154,4177,3381,-796,3244.0,3436.0,192.0,42000.0,15900.0,-26100.0
wighb101,Bill Wight,Cleveland Indians,INDINS,3,4,3,7,1955,1960,5,5.1,-0.07,-5.17,210,79,-131,284,145,-139,1239.0,27.0,-1212.0,0.0,0.0,0.0
wilbd101,Del Wilber,Boston Red Sox,RSOX,2,2,2,4,1954,1960,6,1.54,5.91,4.37,150,520,370,430,1970,1540,0.0,0.0,0.0,0.0,18000.0,18000.0
wilbt101,Ted Wilborn,Toronto Blue Jays,BJAYS,5,9,9,18,1979,1987,8,10.29,14.89,4.6,1883,1679,-204,6026,5403,-623,668.0,1848.0,1180.0,0.0,240000.0,240000.0
wilbt101,Ted Wilborn,New York Yankees,YANKS,1,2,1,3,1982,1983,1,0.43,-1.33,-1.76,102,24,-78,34,0,-34,441.0,285.0,-156.0,0.0,0.0,0.0
wilcm001,Milt Wilcox,Cincinnati Reds,REDS,1,1,1,2,1971,1971,0,-0.84,0.0,0.84,132,0,-132,51,0,-51,1085.0,0.0,-1085.0,0.0,31000.0,31000.0
wilcm001,Milt Wilcox,Cleveland Indians,INDINS,3,4,6,10,1975,1983,8,3.79,14.66,10.87,393,604,211,16,775,759,1581.0,1813.0,232.0,85000.0,0.0,-85000.0
wilem101,Mark Wiley,San Diego Padres,PADRS,1,1,1,2,1978,1978,0,-0.02,0.0,0.02,2,0,-2,0,0,0,8.0,0.0,-8.0,0.0,0.0,0.0
wilem101,Mark Wiley,Toronto Blue Jays,BJAYS,1,1,1,2,1980,1980,0,0.0,0.23,0.23,0,41,41,0,0,0,0.0,165.0,165.0,0.0,0.0,0.0
wiler101,Randy Wiles,St. Louis Cardinals,CARDS,1,1,1,2,1976,1977,1,-0.22,0.0,0.22,5,0,-5,0,0,0,8.0,0.0,-8.0,0.0,0.0,0.0
wiler101,Randy Wiles,St. Louis Cardinals,CARDS,1,1,1,2,1977,1977,0,0.0,0.0,0.0,0,0,0,0,0,0,0.0,0.0,0.0,0.0,0.0,0.0
wilfr001,Rob Wilfong,Minnesota Twins,TWINS,3,6,6,12,1982,1989,7,9.33,17.94,8.61,1193,1029,-164,3688,4105,417,852.0,435.0,-417.0,1243500.0,1775000.0,531500.0
wilhh101,Hoyt Wilhelm,New York Giants,GIANTS,1,1,1,2,1957,1959,2,0.28,-1.14,-1.42,80,225,145,6,643,637,165.0,0.0,-165.0,0.0,0.0,0.0
wilhh101,Hoyt Wilhelm,Baltimore Orioles,ORLS,4,10,7,17,1963,1973,10,64.06,37.52,-26.54,3307,1677,-1630,9685,6745,-2940,2176.0,306.0,-1870.0,108500.0,40300.0,-68200.0
wilhh101,Hoyt Wilhelm,Kansas City Royals,ROYALS,3,5,5,10,1968,1978,10,3.8,11.09,7.29,526,770,244,825,2425,1600,1152.0,645.0,-507.0,49000.0,86500.0,37500.0
wilhh101,Hoyt Wilhelm,California Angels,ANGELS,3,7,6,13,1969,1990,21,44.93,60.7,15.77,1370,2449,1079,2746,9851,7105,8249.0,1336.0,-6913.0,212000.0,50000.0,-162000.0
wilhh101,Hoyt Wilhelm,Chicago Cubs,CUBS,2,3,3,6,1970,1972,2,2.13,-1.94,-4.07,441,108,-333,857,47,-810,244.0,188.0,-56.0,0.0,0.0,0.0
wilhj101,Joe Wilhoit,Venice,Venice,1,1,2,3,1915,1915,0,0.67,0.0,-0.67,170,0,-170,638,0,-638,0.0,0.0,0.0,0.0,6800.0,6800.0
wilhj101,Joe Wilhoit,New York Giants,GIANTS,2,8,3,11,1919,1923,4,10.49,7.89,-2.6,305,402,97,539,1094,555,2035.0,323.0,-1712.0,12500.0,9600.0,-2900.0
wilhj102,Jim Wilhelm,San Diego Padres,PADRS,5,11,10,21,1980,1989,9,32.03,18.53,-13.5,2570,1341,-1229,8500,3002,-5498,2306.0,4252.0,1946.0,0.0,300000.0,300000.0
wilht001,Tom Wilhelmsen,Seattle Mariners,MARNRS,2,5,3,8,2015,2017,2,-1.06,0.95,2.01,37,177,140,16,698,682,66.0,0.0,-66.0,6250000.0,5475000.0,-775000.0
wilka003,Aaron Wilkerson,Boston Red Sox,RSOX,1,2,2,4,2016,2016,0,-0.35,-0.44,-0.09,28,47,19,9,137,128,106.0,0.0,-106.0,0.0,0.0,0.0
wilkb001,Bill Wilkinson,Seattle Mariners,MARNRS,1,2,3,5,1989,1989,0,-1.21,-0.79,0.42,71,15,-56,253,0,-253,0.0,256.0,256.0,215000.0,222500.0,7500.0
wilkb002,Brad Wilkerson,Washington Nationals,NATEX,1,3,1,4,2005,2006,1,0.68,6.08,5.4,217,159,-58,754,728,-26,26.0,0.0,-26.0,3395000.0,7500000.0,4105000.0
wilkc001,Curt Wilkerson,Texas Rangers,RNGRS,2,7,4,11,1988,1994,6,0.27,27.89,27.62,791,1284,493,491,4575,4084,1767.0,710.0,-1057.0,532500.0,300500.0,-232000.0
wilkd001,Dean Wilkins,New York Yankees,YANKS,4,8,6,14,1987,1994,7,-0.12,9.72,9.84,794,752,-42,1743,1510,-233,764.0,1690.0,926.0,2485000.0,3889167.0,1404167.0
wilkd001,Dean Wilkins,Chicago Cubs,CUBS,1,1,1,2,1991,1991,0,-1.78,0.0,1.78,14,0,-14,1,0,-1,24.0,0.0,-24.0,0.0,0.0,0.0
wilkh101,Harry Wilke,Mobile,Mobile,1,1,1,2,1926,1926,0,-0.23,0.0,0.23,3,0,-3,9,0,-9,0.0,0.0,0.0,0.0,3467.0,3467.0
wilkr001,Rick Wilkins,Chicago Cubs,CUBS,1,1,2,3,1995,1998,3,0.14,8.11,7.97,99,639,540,357,2349,1992,0.0,0.0,0.0,0.0,1840000.0,1840000.0
wilkr001,Rick Wilkins,Houston Astros,ASTROS,1,2,1,3,1996,1996,0,1.77,0.4,-1.37,118,37,-81,393,89,-304,0.0,0.0,0.0,1550000.0,1875000.0,325000.0
wilkr001,Rick Wilkins,Seattle Mariners,MARNRS,1,1,1,2,1998,1998,0,-0.17,0.0,0.17,5,0,-5,17,0,-17,0.0,0.0,0.0,425000.0,0.0,-425000.0
wilkt101,Ted Wilks,St. Louis Cardinals,CARDS,3,10,5,15,1951,1954,3,10.75,2.71,-8.04,1144,382,-762,2713,1234,-1479,1601.0,388.0,-1213.0,41500.0,63500.0,22000.0
wilkt101,Ted Wilks,Pittsburgh Pirates,PIRATS,1,2,3,5,1952,1952,0,6.5,-0.35,-6.85,756,19,-737,2451,60,-2391,46.0,0.0,-46.0,0.0,10000.0,10000.0
willa101,Al Williams,Atlanta,Atlanta,1,1,2,3,1935,1946,11,-2.17,0.0,2.17,92,0,-92,56,0,-56,506.0,0.0,-506.0,0.0,0.0,0.0
willb001,Brian Williams,Houston Astros,ASTROS,14,30,36,66,1994,2008,14,59.26,31.82,-27.44,4671,6059,1388,11202,15757,4555,6620.0,5977.0,-643.0,31714000.0,14229000.0,-17485000.0
willb101,Bump Wills,Texas Rangers,RNGRS,1,1,3,4,1982,1983,1,0.93,-0.09,-1.02,128,40,-88,477,0,-477,0.0,152.0,152.0,0.0,0.0,0.0
willb104,Billy Williams,Chicago Cubs,CUBS,11,19,24,43,1974,1990,16,23.18,13.21,-9.97,3006,2415,-591,7963,5685,-2278,1223.0,3795.0,2572.0,1040000.0,154800.0,-885200.0
willb105,Bernie Williams,San Francisco Giants,GIANTS,3,7,6,13,1973,1979,6,5.12,0.53,-4.59,507,876,369,1563,1384,-179,25.0,2162.0,2137.0,125000.0,0.0,-125000.0
willb106,Bob Will,Chicago Cubs,CUBS,1,2,2,4,1964,1965,1,0.14,0.31,0.17,26,71,45,14,56,42,133.0,454.0,321.0,0.0,0.0,0.0
willc001,Carl Willis,Detroit Tigers,TIGRS,1,2,1,3,1984,1986,2,-0.97,-0.02,0.95,94,80,-14,7,0,-7,227.0,318.0,91.0,0.0,0.0,0.0
willc001,Carl Willis,Cincinnati Reds,REDS,1,1,1,2,1988,1988,0,-0.64,0.0,0.64,6,0,-6,0,0,0,36.0,0.0,-36.0,0.0,0.0,0.0
willc101,Charlie Williams,New York Mets,METS,1,2,1,3,1972,1972,0,3.76,1.62,-2.14,474,69,-405,81,242,161,1449.0,0.0,-1449.0,0.0,165000.0,165000.0
willc102,Claude Willoughby,Philadelphia Phillies,PHILS,2,3,6,9,1930,1936,6,25.37,8.0,-17.37,1352,958,-394,5364,4215,-1149,77.0,0.0,-77.0,24000.0,6250.0,-17750.0
willc103,Cy Williams,Chicago Cubs,CUBS,1,1,1,2,1917,1920,3,30.63,4.03,-26.6,1463,354,-1109,5786,1419,-4367,0.0,0.0,0.0,4000.0,4000.0,0.0
willd001,Dana Williams,Boston Red Sox,RSOX,1,1,1,2,1989,1989,0,0.0,0.0,0.0,0,0,0,0,0,0,0.0,0.0,0.0,0.0,0.0,0.0
willd002,David Williams,Pittsburgh Pirates,PIRATS,2,2,3,5,2005,2008,3,-0.67,-0.41,0.26,212,85,-127,705,244,-461,120.0,32.0,-88.0,8830000.0,7800000.0,-1030000.0
willd002,David Williams,Cincinnati Reds,REDS,2,3,2,5,2006,2010,4,-0.46,0.93,1.39,16,46,30,12,125,113,100.0,13.0,-87.0,1800000.0,405000.0,-1395000.0
willd003,Dontrelle Willis,Chicago Cubs,CUBS,1,4,2,6,2002,2004,2,19.76,10.92,-8.84,396,427,31,455,211,-244,3529.0,2185.0,-1344.0,0.0,0.0,0.0
willd003,Dontrelle Willis,Florida Marlins,MARLNS,5,6,11,17,2007,2013,6,60.75,3.64,-57.11,2705,1161,-1544,9389,789,-8600,1298.0,2358.0,1060.0,18420219.0,799800.0,-17620419.0
willd003,Dontrelle Willis,Detroit Tigers,TIGRS,1,2,1,3,2010,2010,0,-0.24,0.0,0.24,11,0,-11,6,0,-6,67.0,0.0,-67.0,12000000.0,0.0,-12000000.0
willd101,Dallas Williams,Baltimore Orioles,ORLS,1,2,1,3,1982,1985,3,-0.67,0.87,1.54,18,216,198,41,563,522,0.0,0.0,0.0,0.0,0.0,0.0
willd101,Dallas Williams,Cincinnati Reds,REDS,1,1,1,2,1984,1984,0,0.0,0.0,0.0,0,0,0,0,0,0,0.0,0.0,0.0,0.0,0.0,0.0
willd102,Davey Williams,Atlanta,Atlanta,1,1,3,4,1948,1950,2,5.49,0.0,-5.49,517,0,-517,1993,0,-1993,0.0,0.0,0.0,0.0,0.0,0.0
willd104,Dick Williams,Baltimore Orioles,ORLS,2,2,2,4,1957,1960,3,-0.29,4.68,4.97,129,349,220,330,994,664,0.0,0.0,0.0,18000.0,17000.0,-1000.0
willd104,Dick Williams,Cleveland Indians,INDINS,8,15,14,29,1958,1968,10,101.35,32.49,-68.86,4418,2446,-1972,15260,8973,-6287,4502.0,562.0,-3940.0,0.0,32000.0,32000.0
willd104,Dick Williams,Baltimore Orioles,ORLS,1,1,1,2,1958,1959,1,4.3,-0.22,-4.52,257,114,-143,1004,390,-614,0.0,0.0,0.0,0.0,0.0,0.0
willd104,Dick Williams,Kansas City Athletics,ATLTCS,2,3,3,6,1961,1963,2,10.64,-2.14,-12.78,963,354,-609,748,642,-106,2603.0,934.0,-1669.0,0.0,0.0,0.0
willd104,Dick Williams,Houston Astros,ASTROS,2,2,2,4,1962,1965,3,0.55,-0.97,-1.52,151,61,-90,238,215,-23,0.0,0.0,0.0,0.0,0.0,0.0
willd109,Dewey Williams,Atlanta,Atlanta,1,1,1,2,1940,1940,0,0.0,0.0,0.0,0,0,0,0,0,0,0.0,0.0,0.0,0.0,0.0,0.0
wille001,Eddie Williams,New York Mets,METS,1,3,1,4,1984,1987,3,3.5,-0.12,-3.62,99,72,-27,111,61,-50,956.0,505.0,-451.0,0.0,0.0,0.0
wille001,Eddie Williams,Cleveland Indians,INDINS,1,1,2,3,1989,1989,0,0.81,0.24,-0.57,66,9,-57,229,0,-229,0.0,99.0,99.0,0.0,0.0,0.0
wille001,Eddie Williams,Los Angeles Dodgers,DOGRS,1,1,1,2,1997,1997,0,-0.32,0.0,0.32,30,0,-30,103,0,-103,0.0,0.0,0.0,0.0,0.0,0.0
wille101,Earl Williams,Atlanta Braves,BRAVES,11,19,24,43,1972,1986,14,30.99,9.46,-21.53,1998,2587,589,5259,6910,1651,4220.0,2478.0,-1742.0,95000.0,320500.0,225500.0
wille101,Earl Williams,Baltimore Orioles,ORLS,5,14,13,27,1975,1988,13,15.26,67.8,52.54,1091,3227,2136,1433,6729,5296,6521.0,11016.0,4495.0,558333.0,0.0,-558333.0
willf001,Frank Williams,San Francisco Giants,GIANTS,1,3,1,4,1987,1987,0,2.82,0.95,-1.87,290,101,-189,7,239,232,505.0,0.0,-505.0,0.0,0.0,0.0
willf002,Frank Wills,Kansas City Royals,ROYALS,2,3,3,6,1985,1988,3,0.52,1.39,0.87,85,358,273,227,1074,847,0.0,58.0,58.0,0.0,0.0,0.0
willf002,Frank Wills,New York Mets,METS,1,1,1,2,1985,1985,0,-0.89,0.0,0.89,24,0,-24,0,0,0,369.0,0.0,-369.0,0.0,0.0,0.0
willg001,Gerald Williams,New York Yankees,YANKS,2,5,4,9,1996,2003,7,18.7,20.21,1.51,1086,282,-804,1937,16,-1921,2545.0,3310.0,765.0,1050000.0,3840000.0,2790000.0
willg001,Gerald Williams,Milwaukee Brewers,BREWRS,1,1,1,2,1997,2002,5,4.09,2.1,-1.99,272,242,-30,756,8,-748,0.0,405.0,405.0,700000.0,150000.0,-550000.0
willg002,George Williams,Minnesota Twins,TWINS,1,1,1,2,1999,1999,0,0.0,0.0,0.0,0,0,0,0,0,0,0.0,0.0,0.0,0.0,0.0,0.0
willg101,George Williams,St. Louis Cardinals,CARDS,1,1,1,2,1965,1967,2,0.0,0.0,0.0,0,0,0,0,0,0,0.0,0.0,0.0,0.0,0.0,0.0
willg103,Gus Williams,St.Louis Browns,ORLS,1,3,1,4,1915,1917,2,0.0,-0.08,-0.08,0,17,17,0,34,34,0.0,0.0,0.0,1800.0,0.0,-1800.0
willh103,Harry Williams,New York Yankees,YANKS,1,2,1,3,1914,1914,0,0.0,0.51,0.51,0,93,93,0,380,380,0.0,0.0,0.0,0.0,0.0,0.0
willj001,Jerry Willard,Philadelphia Phillies,PHILS,5,11,8,19,1982,1999,17,22.81,28.42,5.61,2142,1948,-194,7615,5685,-1930,390.0,1257.0,867.0,2950000.0,165000.0,-2785000.0
willj003,Jerome Williams,San Francisco Giants,GIANTS,2,3,3,6,2005,2008,3,2.36,1.11,-1.25,196,369,173,41,1,-40,695.0,405.0,-290.0,336000.0,7000000.0,6664000.0
willj004,Josh Willingham,Florida Marlins,MARLNS,13,35,35,70,2008,2020,12,62.26,28.41,-33.85,4300,3021,-1279,10993,9069,-1924,7970.0,4278.0,-3692.0,67010000.0,34658100.0,-32351900.0
willj004,Josh Willingham,Washington Nationals,NATEX,2,2,3,5,2010,2013,3,2.17,-0.11,-2.28,146,253,107,563,47,-516,12.0,339.0,327.0,5101000.0,0.0,-5101000.0
willj004,Josh Willingham,Minnesota Twins,TWINS,1,1,1,2,2014,2016,2,0.18,0.0,-0.18,24,0,-24,86,0,-86,0.0,0.0,0.0,7000000.0,0.0,-7000000.0
willj006,Justin Williams,Arizona Diamondbacks,DBACKS,3,7,4,11,2014,2019,5,3.79,-0.16,-3.95,192,125,-67,130,321,191,1136.0,438.0,-698.0,4275000.0,3625000.0,-650000.0
willj006,Justin Williams,Tampa Bay Devil Rays,RAYS,2,5,5,10,2018,2020,2,6.49,6.47,-0.02,634,226,-408,1668,967,-701,343.0,0.0,-343.0,4100000.0,1152200.0,-2947800.0
willj102,Jim Willoughby,San Francisco Giants,GIANTS,1,1,1,2,1974,1974,0,0.0,0.0,0.0,0,0,0,0,0,0,0.0,0.0,0.0,0.0,0.0,0.0
willj102,Jim Willoughby,St. Louis Cardinals,CARDS,3,3,5,8,1975,1976,1,1.63,0.21,-1.42,279,64,-215,541,200,-341,606.0,0.0,-606.0,0.0,0.0,0.0
willj102,Jim Willoughby,Chicago White Sox,WSOX,1,1,1,2,1978,1978,0,0.0,0.0,0.0,0,0,0,0,0,0,0.0,0.0,0.0,0.0,0.0,0.0
willj104,Jim Willis,Chicago Cubs,CUBS,3,6,6,12,1954,1961,7,3.29,2.06,-1.23,406,565,159,221,1460,1239,2057.0,7.0,-2050.0,0.0,4000.0,4000.0
willj106,Jimmy Williams,New York Yankees,YANKS,3,6,6,12,1907,1911,4,37.76,7.87,-29.89,2601,491,-2110,10473,2011,-8462,0.0,0.0,0.0,0.0,0.0,0.0
willj107,Jimy Williams,St. Louis Cardinals,CARDS,4,6,5,11,1968,1971,3,5.07,0.97,-4.1,849,114,-735,2705,290,-2415,0.0,0.0,0.0,0.0,0.0,0.0
willj107,Jimy Williams,Montreal Expos,NATEX,1,1,1,2,1971,1971,0,0.0,0.0,0.0,0,0,0,0,0,0,0.0,0.0,0.0,0.0,0.0,0.0
willj108,Jim Williams,Chicago Cubs,CUBS,3,4,3,7,1967,1973,6,1.48,-0.34,-1.82,258,333,75,792,861,69,0.0,8.0,8.0,37250.0,0.0,-37250.0
willk001,Ken Williams,Chicago White Sox,WSOX,3,4,5,9,1989,1991,2,-0.18,4.71,4.89,248,106,-142,427,126,-301,701.0,946.0,245.0,1315000.0,700000.0,-615000.0
willm001,Matt Williams,Toronto Blue Jays,BJAYS,1,3,1,4,1985,1986,1,0.93,0.73,-0.2,6,131,125,0,477,477,78.0,0.0,-78.0,0.0,683333.0,683333.0
willm002,Mitch Williams,San Diego Padres,PADRS,1,1,1,2,1985,1985,0,3.58,0.0,-3.58,232,0,-232,0,0,0,824.0,0.0,-824.0,0.0,0.0,0.0
willm002,Mitch Williams,Texas Rangers,RNGRS,2,7,4,11,1988,1994,6,0.27,27.89,27.62,791,1284,493,491,4575,4084,1767.0,710.0,-1057.0,532500.0,300500.0,-232000.0
willm002,Mitch Williams,Chicago Cubs,CUBS,3,3,7,10,1991,1995,4,4.89,1.97,-2.92,667,742,75,18,57,39,1589.0,1518.0,-71.0,557500.0,0.0,-557500.0
willm002,Mitch Williams,Philadelphia Phillies,PHILS,2,3,3,6,1993,1996,3,-1.07,3.02,4.09,122,167,45,3,151,148,185.0,433.0,248.0,3609000.0,2929000.0,-680000.0
willm003,Matt Williams,San Francisco Giants,GIANTS,1,2,4,6,1996,2002,6,4.28,33.7,29.42,158,1486,1328,649,4565,3916,0.0,882.0,882.0,6600000.0,391666.0,-6208334.0
willm003,Matt Williams,Cleveland Indians,INDINS,2,2,4,6,1997,2001,4,7.37,-0.84,-8.21,623,54,-569,2465,0,-2465,51.0,172.0,121.0,7150000.0,0.0,-7150000.0
willm004,Mark Williamson,San Diego Padres,PADRS,2,3,3,6,1986,1990,4,10.9,-1.16,-12.06,682,244,-438,834,162,-672,3461.0,484.0,-2977.0,1525000.0,583133.0,-941867.0
willm005,Mike Williams,Pittsburgh Pirates,PIRATS,1,1,1,2,2001,2002,1,0.27,0.08,-0.19,50,24,-26,0,23,23,67.0,208.0,141.0,1200000.0,0.0,-1200000.0
willm005,Mike Williams,Pittsburgh Pirates,PIRATS,1,2,1,3,2003,2003,0,-0.52,0.0,0.52,56,0,-56,0,0,0,77.0,0.0,-77.0,3500000.0,0.0,-3500000.0
willm006,Matt Williams,Cleveland Indians,INDINS,1,1,1,2,1995,1995,0,0.0,-0.14,-0.14,0,17,17,0,27,27,0.0,0.0,0.0,0.0,0.0,0.0
willm102,Maury Wills,Los Angeles Dodgers,DOGRS,1,1,2,3,1966,1968,2,7.77,-0.49,-8.26,302,319,17,1350,982,-368,0.0,0.0,0.0,85000.0,0.0,-85000.0
willm102,Maury Wills,Montreal Expos,NATEX,4,5,7,12,1969,1978,9,18.8,19.12,0.32,1836,868,-968,5544,3116,-2428,0.0,0.0,0.0,0.0,0.0,0.0
willm105,Mark Williams,Kansas City Royals,ROYALS,1,1,1,2,1975,1975,0,0.02,0.0,-0.02,3,0,-3,3,0,-3,0.0,0.0,0.0,0.0,0.0,0.0
willn001,Nick Williams,Texas Rangers,RNGRS,5,14,16,30,2015,2021,6,11.03,13.28,2.25,790,293,-497,1664,16,-1648,2536.0,2164.0,-372.0,3762500.0,1106250.0,-2656250.0
willn101,Nick Willhite,Los Angeles Dodgers,DOGRS,1,1,1,2,1966,1967,1,-0.48,-0.23,0.25,20,8,-12,10,0,-10,118.0,20.0,-98.0,9000.0,27500.0,18500.0
willn101,Nick Willhite,California Angels,ANGELS,5,5,6,11,1967,1973,6,0.62,4.1,3.48,359,646,287,804,471,-333,516.0,1754.0,1238.0,10000.0,52000.0,42000.0
willr001,Reggie Williams,Los Angeles Dodgers,DOGRS,1,1,1,2,1988,1988,0,-0.06,0.0,0.06,11,0,-11,31,0,-31,0.0,0.0,0.0,0.0,0.0,0.0
willr002,Reggie Williams,California Angels,ANGELS,1,1,1,2,1993,1999,6,-0.14,4.43,4.57,15,188,173,13,0,-13,0.0,640.0,640.0,0.0,0.0,0.0
willr003,Randy Williams,Seattle Mariners,MARNRS,1,1,1,2,2004,2004,0,-0.27,0.0,0.27,4,0,-4,1,0,-1,13.0,0.0,-13.0,0.0,0.0,0.0
willr104,Rip Williams,New York Yankees,YANKS,1,2,1,3,1912,1912,0,4.64,-0.55,-5.19,406,29,-377,1061,95,-966,0.0,0.0,0.0,0.0,0.0,0.0
willr104,Rip Williams,Buffalo,Buffalo,1,1,2,3,1910,1910,0,-0.3,0.0,0.3,95,0,-95,329,0,-329,0.0,0.0,0.0,0.0,0.0,0.0
willr104,Rip Williams,Washington Senators,TWINS,1,4,1,5,1917,1922,5,0.0,-0.6,-0.6,0,32,32,0,104,104,0.0,0.0,0.0,0.0,0.0,0.0
wills002,Scott Williamson,Cincinnati Reds,REDS,1,1,2,3,2003,2007,4,0.92,-1.4,-2.32,55,12,-43,0,6,6,147.0,54.0,-93.0,1600000.0,0.0,-1600000.0
wills002,Scott Williamson,Chicago Cubs,CUBS,1,1,2,3,2006,2006,0,-0.26,0.0,0.26,22,0,-22,0,0,0,33.0,0.0,-33.0,2000000.0,0.0,-2000000.0
wills102,Stan Williams,Los Angeles Dodgers,DOGRS,1,1,1,2,1962,1963,1,1.38,-1.13,-2.51,101,89,-12,75,256,181,685.0,0.0,-685.0,0.0,37500.0,37500.0
wills102,Stan Williams,Cleveland Indians,INDINS,15,21,26,47,1969,1984,15,48.37,39.17,-9.2,3144,4059,915,8529,12020,3491,2855.0,3764.0,909.0,351750.0,418600.0,66850.0
wills102,Stan Williams,Minnesota Twins,TWINS,1,1,2,3,1971,1971,0,0.65,0.0,-0.65,20,0,-20,1,0,-1,38.0,0.0,-38.0,40000.0,0.0,-40000.0
willt001,Todd Williams,Los Angeles Dodgers,DOGRS,1,1,1,2,1995,1995,0,0.0,0.0,0.0,0,0,0,0,0,0,0.0,0.0,0.0,0.0,0.0,0.0
willt001,Todd Williams,Cincinnati Reds,REDS,1,1,1,2,1999,2000,1,0.16,-0.06,-0.22,13,9,-4,0,1,1,29.0,0.0,-29.0,0.0,0.0,0.0
willt002,Trevor Williams,Miami Marlins,MARLNS,1,1,1,2,2015,2015,0,4.86,0.0,-4.86,194,0,-194,145,0,-145,1604.0,0.0,-1604.0,0.0,0.0,0.0
willt002,Trevor Williams,Chicago Cubs,CUBS,1,3,1,4,2021,2021,0,2.33,0.0,-2.33,66,0,-66,194,0,-194,97.0,0.0,-97.0,14100000.0,0.0,-14100000.0
willt003,Taylor Williams,Seattle Mariners,MARNRS,1,1,1,2,2020,2020,0,0.12,0.0,-0.12,10,0,-10,0,0,0,19.0,0.0,-19.0,0.0,0.0,0.0
willt103,Ted Williams,SanDiego,SanDiego,2,2,5,7,1937,1939,2,130.77,0.0,-130.77,2971,0,-2971,11881,0,-11881,6.0,0.0,-6.0,0.0,3000.0,3000.0
willv101,Vic Willis,Syracuse,Syracuse,1,1,2,3,1897,1897,0,42.08,0.0,-42.08,658,0,-658,1092,0,-1092,7720.0,0.0,-7720.0,0.0,0.0,0.0
willv101,Vic Willis,Boston Braves,BRAVES,3,4,6,10,1905,1917,12,22.76,27.79,5.03,670,2025,1355,1752,7631,5879,3628.0,2702.0,-926.0,0.0,0.0,0.0
willw001,Woody Williams,Toronto Blue Jays,BJAYS,1,3,1,4,1998,2001,3,7.56,0.33,-7.23,451,52,-399,328,5,-323,2800.0,760.0,-2040.0,1787500.0,3250000.0,1462500.0
willw001,Woody Williams,San Diego Padres,PADRS,1,1,2,3,2001,2002,1,11.71,0.53,-11.18,185,121,-64,221,385,164,1766.0,0.0,-1766.0,5083333.0,8100000.0,3016667.0
willw103,Walt Williams,St. Louis Cardinals,CARDS,1,2,2,4,1966,1967,1,2.36,-0.3,-2.66,603,24,-579,1918,71,-1847,0.0,0.0,0.0,9000.0,30000.0,21000.0
willw103,Walt Williams,Chicago White Sox,WSOX,2,2,2,4,1972,1976,4,1.09,-0.65,-1.74,105,187,82,371,504,133,0.0,142.0,142.0,53000.0,22500.0,-30500.0
willw103,Walt Williams,Cleveland Indians,INDINS,4,7,5,12,1974,1976,2,-3.21,4.02,7.23,307,69,-238,459,0,-459,1098.0,1299.0,201.0,68000.0,35000.0,-33000.0
wilsa001,Alex Wilson,Boston Red Sox,RSOX,1,3,1,4,2014,2019,5,9.45,9.39,-0.06,366,170,-196,427,24,-403,794.0,2892.0,2098.0,10500000.0,8500000.0,-2000000.0
wilsa101,Artie Wilson,Oakland,Oakland,1,3,5,8,1950,1951,1,-0.44,0.0,0.44,186,0,-186,308,0,-308,172.0,0.0,-172.0,0.0,0.0,0.0
wilsa102,Art Wilson,Pittsburgh Pirates,PIRATS,1,1,2,3,1916,1917,1,0.51,0.75,0.24,117,127,10,375,438,63,0.0,0.0,0.0,5500.0,4000.0,-1500.0
wilsa102,Art Wilson,Chicago Cubs,CUBS,1,3,1,4,1918,1918,0,1.89,7.03,5.14,176,71,-105,557,112,-445,0.0,807.0,807.0,0.0,0.0,0.0
wilsa103,Archie Wilson,New York Yankees,YANKS,7,19,15,34,1952,1970,18,13.22,40.85,27.63,2406,2911,505,6464,7208,744,3937.0,4978.0,1041.0,115500.0,43000.0,-72500.0
wilsa103,Archie Wilson,Washington Senators,TWINS,2,2,2,4,1952,1953,1,-0.15,0.45,0.6,18,90,72,41,299,258,0.0,0.0,0.0,0.0,0.0,0.0
wilsa103,Archie Wilson,Toronto,Toronto,2,3,4,7,1956,1958,2,-0.02,0.0,0.02,52,0,-52,3,0,-3,128.0,0.0,-128.0,0.0,0.0,0.0
wilsb002,Bobby Wilson,Texas Rangers,RNGRS,1,2,1,3,2016,2016,0,-1.41,0.37,1.78,25,30,5,62,94,32,38.0,4.0,-34.0,0.0,0.0,0.0
wilsb002,Bobby Wilson,Detroit Tigers,TIGRS,1,1,1,2,2016,2018,2,-0.37,-0.76,-0.39,42,32,-10,141,0,-141,0.0,209.0,209.0,0.0,0.0,0.0
wilsb002,Bobby Wilson,Minnesota Twins,TWINS,1,1,2,3,2018,2018,0,0.0,-0.01,-0.01,0,14,14,0,34,34,0.0,3.0,3.0,0.0,0.0,0.0
wilsb003,Bryse Wilson,Atlanta Braves,BRAVES,1,2,1,3,2021,2021,0,0.25,0.61,0.36,15,53,38,12,0,-12,121.0,78.0,-43.0,0.0,1700000.0,1700000.0
wilsb101,Bill Wilson,Philadelphia Phillies,PHILS,1,1,1,2,1973,1974,1,0.0,0.14,0.14,0,44,44,0,0,0,0.0,74.0,74.0,0.0,0.0,0.0
wilsb103,Bill Wilson,Chicago White Sox,WSOX,1,4,2,6,1954,1956,2,0.81,2.11,1.3,331,206,-125,724,121,-603,571.0,421.0,-150.0,8500.0,0.0,-8500.0
wilsc001,Craig Wilson,St. Louis Cardinals,CARDS,1,2,2,4,1993,1994,1,0.21,6.98,6.77,278,245,-33,1031,1059,28,0.0,0.0,0.0,0.0,0.0,0.0
wilsc003,Craig Wilson,Toronto Blue Jays,BJAYS,2,7,5,12,1996,2001,5,5.42,8.51,3.09,1726,826,-900,3923,2165,-1758,1392.0,748.0,-644.0,1500000.0,5870000.0,4370000.0
wilsc003,Craig Wilson,Pittsburgh Pirates,PIRATS,1,1,1,2,2006,2007,1,-0.91,1.4,2.31,40,143,103,109,28,-81,0.0,426.0,426.0,3300000.0,3600000.0,300000.0
wilsc102,Chief Wilson,Pittsburgh Pirates,PIRATS,1,5,3,8,1913,1915,2,18.03,3.31,-14.72,1733,233,-1500,6155,938,-5217,795.0,0.0,-795.0,11400.0,13500.0,2100.0
wilsd001,Dan Wilson,Cincinnati Reds,REDS,9,15,18,33,1993,2013,20,45.48,40.95,-4.53,3672,3082,-590,10149,8976,-1173,3098.0,6878.0,3780.0,12546000.0,18840000.0,6294000.0
wilsd002,Desi Wilson,Texas Rangers,RNGRS,1,2,1,3,1994,1995,1,14.18,0.0,-14.18,1333,0,-1333,5009,0,-5009,0.0,0.0,0.0,0.0,3550000.0,3550000.0
wilse001,Enrique Wilson,Minnesota Twins,TWINS,1,1,1,2,1994,1994,0,-0.01,0.0,0.01,190,0,-190,607,0,-607,0.0,0.0,0.0,0.0,0.0,0.0
wilse001,Enrique Wilson,Cleveland Indians,INDINS,1,2,1,3,2000,2002,2,-2.57,-1.33,1.24,129,133,4,392,475,83,0.0,0.0,0.0,450000.0,2166667.0,1716667.0
wilse001,Enrique Wilson,Pittsburgh Pirates,PIRATS,2,3,2,5,2001,2003,2,4.87,0.09,-4.78,558,46,-512,637,4,-633,777.0,109.0,-668.0,635000.0,0.0,-635000.0
wilse102,Earl Wilson,Boston Red Sox,RSOX,3,6,5,11,1966,1968,2,22.76,3.78,-18.98,955,221,-734,2583,411,-2172,3084.0,1094.0,-1990.0,17000.0,24000.0,7000.0
wilsf101,Frank Wilson,St.Louis Browns,ORLS,3,6,3,9,1928,1932,4,0.0,1.32,1.32,0,238,238,0,781,781,0.0,187.0,187.0,15500.0,0.0,-15500.0
wilsf101,Frank Wilson,Boston Braves,BRAVES,1,3,1,4,1926,1931,5,0.0,6.6,6.6,0,629,629,0,2661,2661,0.0,0.0,0.0,8700.0,0.0,-8700.0
wilsg001,Glenn Wilson,Detroit Tigers,TIGRS,1,2,2,4,1984,1992,8,6.42,12.78,6.36,721,1236,515,2522,2277,-245,3.0,1451.0,1448.0,0.0,0.0,0.0
wilsg001,Glenn Wilson,Philadelphia Phillies,PHILS,2,4,4,8,1987,1989,2,8.23,2.23,-6.0,632,164,-468,1265,649,-616,1310.0,12.0,-1298.0,1629900.0,750000.0,-879900.0
wilsg001,Glenn Wilson,Seattle Mariners,MARNRS,2,2,2,4,1988,1991,3,2.35,0.72,-1.63,199,342,143,639,1197,558,0.0,0.0,0.0,1540000.0,750000.0,-790000.0
wilsg001,Glenn Wilson,Pittsburgh Pirates,PIRATS,3,3,4,7,1989,1993,4,1.22,0.03,-1.19,481,43,-438,1664,92,-1572,0.0,18.0,18.0,750000.0,0.0,-750000.0
wilsg103,Grady Wilson,Pittsburgh Pirates,PIRATS,1,2,1,3,1949,1949,0,0.0,0.0,0.0,0,0,0,0,0,0,0.0,0.0,0.0,0.0,0.0,0.0
wilsh102,Hack Wilson,New York Giants,GIANTS,2,3,2,5,1925,1927,2,0.0,0.26,0.26,0,144,144,0,535,535,0.0,0.0,0.0,12100.0,0.0,-12100.0
wilsh102,Hack Wilson,Chicago Cubs,CUBS,1,2,1,3,1931,1933,2,-0.02,-0.44,-0.42,2,94,92,0,73,73,3.0,633.0,630.0,33000.0,20000.0,-13000.0
wilsh102,Hack Wilson,St. Louis Cardinals,CARDS,1,1,2,3,1932,1932,0,5.81,0.0,-5.81,319,0,-319,1163,0,-1163,0.0,0.0,0.0,0.0,0.0,0.0
wilsh102,Hack Wilson,Portsmouth,Portsmouth,1,2,1,3,1923,1923,0,2.21,0.0,-2.21,334,0,-334,792,0,-792,1269.0,0.0,-1269.0,0.0,0.0,0.0
wilsj002,Jack Wilson,St. Louis Cardinals,CARDS,3,3,4,7,2000,2003,3,21.81,-0.28,-22.09,1522,122,-1400,4703,0,-4703,378.0,121.0,-257.0,1600000.0,1000000.0,-600000.0
wilsj002,Jack Wilson,Pittsburgh Pirates,PIRATS,1,2,5,7,2009,2012,3,2.82,0.94,-1.88,179,390,211,514,1304,790,332.0,0.0,-332.0,10600000.0,822500.0,-9777500.0
wilsj002,Jack Wilson,Seattle Mariners,MARNRS,1,1,1,2,2011,2011,0,-0.98,0.0,0.98,57,0,-57,122,0,-122,0.0,0.0,0.0,5000000.0,0.0,-5000000.0
wilsj004,Justin Wilson,Pittsburgh Pirates,PIRATS,1,1,1,2,2014,2019,5,0.99,8.49,7.5,101,450,349,0,1734,1734,237.0,0.0,-237.0,515000.0,700000.0,185000.0
wilsj004,Justin Wilson,New York Yankees,YANKS,2,3,3,6,2015,2021,6,4.01,1.99,-2.02,203,135,-68,0,2,2,424.0,876.0,452.0,4456000.0,0.0,-4456000.0
wilsj004,Justin Wilson,Detroit Tigers,TIGRS,1,2,3,5,2017,2017,0,1.19,0.18,-1.01,218,27,-191,113,106,-7,217.0,0.0,-217.0,4700000.0,0.0,-4700000.0
wilsj004,Justin Wilson,New York Yankees,YANKS,1,2,1,3,2021,2021,0,1.83,0.0,-1.83,88,0,-88,0,0,0,127.0,0.0,-127.0,3900000.0,0.0,-3900000.0
wilsj103,Jack Wilson,Portland,Portland,1,1,1,2,1935,1938,3,12.22,0.0,-12.22,518,0,-518,417,0,-417,3203.0,0.0,-3203.0,0.0,0.0,0.0
wilsj103,Jack Wilson,Boston Red Sox,RSOX,2,3,3,6,1941,1943,2,21.33,-1.33,-22.66,818,70,-748,3332,174,-3158,514.0,323.0,-191.0,22500.0,20000.0,-2500.0
wilsj104,Jim Wilson,Boston Red Sox,RSOX,2,8,5,13,1947,1955,8,6.5,21.93,15.43,835,962,127,1487,3127,1640,2844.0,2066.0,-778.0,10000.0,32000.0,22000.0
wilsj104,Jim Wilson,Cleveland Indians,INDINS,1,1,3,4,1949,1949,0,0.0,0.0,0.0,0,0,0,0,0,0,0.0,0.0,0.0,0.0,0.0,0.0
wilsj104,Jim Wilson,Seattle,Seattle,1,1,3,4,1950,1950,0,4.71,0.0,-4.71,200,0,-200,221,0,-221,1757.0,0.0,-1757.0,0.0,0.0,0.0
wilsj104,Jim Wilson,Baltimore Orioles,ORLS,20,39,43,82,1956,1988,32,49.21,127.79,78.58,4349,6653,2304,7582,14604,7022,16102.0,17161.0,1059.0,768333.0,153000.0,-615333.0
wilsj105,Jimmie Wilson,Philadelphia Phillies,PHILS,5,9,9,18,1928,1940,12,39.18,41.3,2.12,1904,2696,792,7415,9869,2454,0.0,0.0,0.0,21000.0,7500.0,-13500.0
wilsj105,Jimmie Wilson,St. Louis Cardinals,CARDS,1,1,2,3,1933,1936,3,0.74,4.53,3.79,311,321,10,949,1140,191,0.0,0.0,0.0,0.0,0.0,0.0
wilsj105,Jimmie Wilson,NewHaven,NewHaven,1,1,2,3,1923,1923,0,4.33,0.0,-4.33,838,0,-838,2778,0,-2778,0.0,0.0,0.0,0.0,0.0,0.0
wilsm001,Mookie Wilson,New York Mets,METS,1,1,2,3,1989,1990,1,1.54,-0.46,-2.0,287,96,-191,1134,2,-1132,0.0,175.0,175.0,1000000.0,200000.0,-800000.0
wilsp001,Paul Wilson,New York Mets,METS,2,3,3,6,2000,2001,1,6.03,0.01,-6.02,591,253,-338,1813,73,-1740,1188.0,422.0,-766.0,0.0,1563000.0,1563000.0
wilsp002,Preston Wilson,New York Mets,METS,1,3,1,4,1998,2005,7,6.18,24.6,18.42,588,972,384,2350,3941,1591,0.0,0.0,0.0,0.0,0.0,0.0
wilsp002,Preston Wilson,Florida Marlins,MARLNS,4,9,11,20,2002,2015,13,11.51,22.72,11.21,893,1533,640,2983,2710,-273,1797.0,5078.0,3281.0,13177000.0,10303543.0,-2873457.0
wilsp002,Preston Wilson,Colorado Rockies,ROCKS,1,1,3,4,2005,2006,1,0.4,-0.93,-1.33,68,16,-52,280,9,-271,0.0,74.0,74.0,12500000.0,674000.0,-11826000.0
wilsr102,Red Wilson,Chicago White Sox,WSOX,30,57,56,113,1954,1971,17,69.82,122.29,52.47,8118,8309,191,22337,20184,-2153,7158.0,13512.0,6354.0,248750.0,237500.0,-11250.0
wilsr102,Red Wilson,Detroit Tigers,TIGRS,1,2,1,3,1960,1960,0,-0.21,0.09,0.3,42,26,-16,127,61,-66,0.0,0.0,0.0,0.0,0.0,0.0
wilss001,Steve Wilson,Texas Rangers,RNGRS,2,7,4,11,1988,1994,6,0.27,27.89,27.62,791,1284,493,491,4575,4084,1767.0,710.0,-1057.0,532500.0,300500.0,-232000.0
wilss001,Steve Wilson,Chicago Cubs,CUBS,1,1,1,2,1991,1991,0,0.95,0.0,-0.95,192,0,-192,6,0,-6,302.0,0.0,-302.0,205000.0,0.0,-205000.0
wilst001,Tack Wilson,Los Angeles Dodgers,DOGRS,1,1,1,2,1983,1983,0,-0.05,0.0,0.05,5,0,-5,4,0,-4,0.0,0.0,0.0,0.0,0.0,0.0
wilst001,Tack Wilson,Texas Rangers,RNGRS,1,2,2,4,1989,1989,0,0.0,0.0,0.0,0,0,0,0,0,0,0.0,0.0,0.0,0.0,0.0,0.0
wilst003,Tom Wilson,New York Yankees,YANKS,1,1,2,3,1996,1996,0,0.0,0.0,0.0,0,0,0,0,0,0,0.0,0.0,0.0,0.0,0.0,0.0
wilst003,Tom Wilson,Oakland Athletics,ATLTCS,1,1,1,2,2002,2002,0,0.2,0.0,-0.2,192,0,-192,589,0,-589,0.0,0.0,0.0,0.0,0.0,0.0
wilst003,Tom Wilson,New York Mets,METS,1,1,1,2,2004,2004,0,-0.14,0.0,0.14,9,0,-9,8,0,-8,0.0,0.0,0.0,0.0,0.0,0.0
wilst102,Tex Wilson,Brooklyn Dodgers,DOGRS,2,4,2,6,1925,1931,6,-1.16,1.81,2.97,36,399,363,37,1222,1185,282.0,591.0,309.0,7500.0,0.0,-7500.0
wilst104,Terry Wilshusen,California Angels,ANGELS,2,3,2,5,1973,1974,1,-0.74,0.84,1.58,36,140,104,91,478,387,0.0,0.0,0.0,8550.0,27500.0,18950.0
wilsv001,Vance Wilson,New York Mets,METS,2,2,2,4,2005,2008,3,2.0,-1.09,-3.09,222,73,-149,687,89,-598,0.0,54.0,54.0,0.0,1700000.0,1700000.0
wilth101,Hal Wiltse,Boston Red Sox,RSOX,1,1,1,2,1928,1928,0,0.17,-0.02,-0.19,52,104,52,23,343,320,216.0,0.0,-216.0,3600.0,8000.0,4400.0
wilts101,Snake Wiltse,Syracuse,Syracuse,1,1,3,4,1901,1911,10,-0.42,0.0,0.42,14,0,-14,21,0,-21,133.0,0.0,-133.0,0.0,0.0,0.0
wincs001,Scott Winchester,Cleveland Indians,INDINS,1,4,2,6,1997,1998,1,5.24,-0.51,-5.75,1014,98,-916,190,187,-3,2567.0,112.0,-2455.0,0.0,4300000.0,4300000.0
wincs001,Scott Winchester,Arizona Diamondbacks,DBACKS,2,2,3,5,1997,2002,5,7.08,-0.46,-7.54,838,201,-637,44,1,-43,1558.0,280.0,-1278.0,210000.0,175000.0,-35000.0
windg101,Gordie Windhorn,Boston Red Sox,RSOX,1,2,1,3,1957,1957,0,-2.46,0.0,2.46,96,0,-96,53,0,-53,393.0,0.0,-393.0,0.0,0.0,0.0
windg101,Gordie Windhorn,New York Yankees,YANKS,1,2,1,3,1960,1960,0,0.05,-0.09,-0.14,34,8,-26,37,0,-37,0.0,13.0,13.0,0.0,0.0,0.0
windg101,Gordie Windhorn,Los Angeles Dodgers,DOGRS,2,3,4,7,1961,1962,1,-0.42,0.0,0.42,35,0,-35,74,0,-74,0.0,0.0,0.0,0.0,0.0,0.0
windg101,Gordie Windhorn,Kansas City Athletics,ATLTCS,1,1,1,2,1962,1962,0,-0.07,0.19,0.26,40,6,-34,51,16,-35,0.0,0.0,0.0,0.0,0.0,0.0
winer001,Robbie Wine,Houston Astros,ASTROS,1,1,1,2,1988,1988,0,0.0,0.0,0.0,0,0,0,0,0,0,0.0,0.0,0.0,0.0,0.0,0.0
winfd001,Dave Winfield,New York Yankees,YANKS,1,1,1,2,1990,1993,3,1.69,-0.2,-1.89,262,27,-235,1103,0,-1103,0.0,429.0,429.0,1958652.0,1300000.0,-658652.0
winga101,Al Wingo,Detroit Tigers,TIGRS,2,4,2,6,1928,1933,5,12.96,7.86,-5.1,710,567,-143,2975,2526,-449,0.0,0.0,0.0,13000.0,7000.0,-6000.0
wingi101,Ivey Wingo,St. Louis Cardinals,CARDS,1,1,1,2,1915,1919,4,13.97,6.56,-7.41,1010,392,-618,3390,1201,-2189,0.0,0.0,0.0,0.0,0.0,0.0
winkb801,Bobby Winkles,Chicago White Sox,WSOX,1,1,1,2,1958,1960,2,0.0,0.0,0.0,0,0,0,0,0,0,0.0,0.0,0.0,0.0,0.0,0.0
winkd001,Daniel Winkler,Atlanta Braves,BRAVES,1,2,1,3,2019,2020,1,0.0,1.32,1.32,0,68,68,0,0,0,0.0,131.0,131.0,1610000.0,14000000.0,12390000.0
winnh001,Herm Winningham,New York Mets,METS,1,4,1,5,1984,1989,5,17.64,11.38,-6.26,1847,600,-1247,5919,2448,-3471,1489.0,0.0,-1489.0,356000.0,0.0,-356000.0
winnh001,Herm Winningham,Montreal Expos,NATEX,3,5,4,9,1988,1992,4,1.15,0.52,-0.63,739,280,-459,1881,660,-1221,41.0,0.0,-41.0,330000.0,317500.0,-12500.0
winnj001,Jim Winn,Pittsburgh Pirates,PIRATS,1,1,1,2,1987,1990,3,-0.64,3.32,3.96,57,350,293,0,663,663,282.0,6.0,-276.0,0.0,0.0,0.0
winnr001,Randy Winn,Tampa Bay Devil Rays,RAYS,2,2,3,5,2002,2004,2,10.07,0.43,-9.64,527,52,-475,2100,155,-1945,0.0,0.0,0.0,960000.0,0.0,-960000.0
winnr001,Randy Winn,Seattle Mariners,MARNRS,3,3,4,7,2005,2007,2,13.21,0.09,-13.12,1039,42,-997,4182,119,-4063,0.0,0.0,0.0,3750000.0,1031000.0,-2719000.0
winst101,Tom Winsett,St. Louis Cardinals,CARDS,2,2,4,6,1936,1938,2,-1.6,0.05,1.65,216,177,-39,671,491,-180,3.0,0.0,-3.0,0.0,0.0,0.0
winst101,Tom Winsett,Boston Red Sox,RSOX,1,2,1,3,1931,1931,0,0.0,0.0,0.0,0,0,0,0,0,0,0.0,0.0,0.0,2400.0,0.0,-2400.0
wintc101,Clarence Winters,SanAntonio,SanAntonio,1,1,1,2,1924,1924,0,-0.83,0.0,0.83,8,0,-8,3,0,-3,21.0,0.0,-21.0,0.0,3600.0,3600.0
wintj101,Jesse Winters,New York Giants,GIANTS,2,7,2,9,1921,1924,3,-1.56,-0.07,1.49,187,154,-33,261,191,-70,992.0,253.0,-739.0,6000.0,0.0,-6000.0
wintm001,Matt Winters,Chicago White Sox,WSOX,4,8,9,17,1986,1996,10,8.12,26.46,18.34,1204,1239,35,3582,5184,1602,266.0,488.0,222.0,4896500.0,2055555.0,-2840945.0
wirta101,Alan Wirth,San Francisco Giants,GIANTS,4,14,8,22,1978,1992,14,8.18,23.62,15.44,767,1277,510,1656,1600,-56,2714.0,7759.0,5045.0,0.0,0.0,0.0
wirtk101,Kettle Wirts,Chicago White Sox,WSOX,6,16,8,24,1924,1936,12,0.32,2.24,1.92,474,816,342,1478,2777,1299,0.0,222.0,222.0,28700.0,12500.0,-16200.0
wisdp001,Patrick Wisdom,St. Louis Cardinals,CARDS,1,1,1,2,2018,2019,1,-0.25,-0.09,0.16,9,5,-4,28,7,-21,0.0,0.0,0.0,0.0,0.0,0.0
wisec101,Casey Wise,Chicago Cubs,CUBS,2,2,5,7,1957,1962,5,-1.01,1.27,2.28,58,134,76,170,208,38,0.0,138.0,138.0,0.0,0.0,0.0
wisec101,Casey Wise,Milwaukee Braves,BRAVES,1,3,2,5,1959,1961,2,-0.44,0.34,0.78,224,49,-175,615,163,-452,0.0,0.0,0.0,0.0,0.0,0.0
wiser101,Rick Wise,Philadelphia Phillies,PHILS,1,1,1,2,1972,1986,14,8.78,69.39,60.61,140,1000,860,202,1413,1211,1584.0,11092.0,9508.0,0.0,0.0,0.0
wiser101,Rick Wise,St. Louis Cardinals,CARDS,10,15,16,31,1973,1978,5,43.88,7.39,-36.49,1933,556,-1377,5993,1737,-4256,2099.0,259.0,-1840.0,96000.0,140000.0,44000.0
wiser101,Rick Wise,Boston Red Sox,RSOX,2,6,3,9,1978,1987,9,14.86,20.93,6.07,699,715,16,1362,2220,858,3997.0,3996.0,-1.0,0.0,0.0,0.0
wislm001,Matt Wisler,San Diego Padres,PADRS,6,17,12,29,2015,2021,6,17.57,11.2,-6.37,1317,971,-346,3711,2795,-916,1719.0,362.0,-1357.0,9570500.0,0.0,-9570500.0
wislm001,Matt Wisler,Atlanta Braves,BRAVES,1,3,1,4,2018,2020,2,1.47,1.06,-0.41,203,131,-72,53,396,343,403.0,0.0,-403.0,565000.0,645000.0,80000.0
wislm001,Matt Wisler,Cincinnati Reds,REDS,1,1,1,2,2019,2019,0,-0.09,0.0,0.09,39,0,-39,1,0,-1,87.0,0.0,-87.0,0.0,0.0,0.0
wislm001,Matt Wisler,San Francisco Giants,GIANTS,1,2,1,3,2021,2021,0,0.28,0.0,-0.28,28,0,-28,0,0,0,88.0,0.0,-88.0,1150000.0,0.0,-1150000.0
wisnj101,Jack Wisner,New York Giants,GIANTS,3,6,3,9,1926,1940,14,11.39,25.05,13.66,220,939,719,272,1487,1215,2128.0,7418.0,5290.0,4500.0,0.0,-4500.0
witaj001,Jay Witasick,St. Louis Cardinals,CARDS,6,12,11,23,1996,2004,8,8.44,23.16,14.72,1305,1318,13,4128,1707,-2421,1089.0,4162.0,3073.0,14483333.0,16620281.0,2136948.0
witaj001,Jay Witasick,Oakland Athletics,ATLTCS,1,1,2,3,1999,2000,1,0.38,0.0,-0.38,59,0,-59,9,0,-9,743.0,0.0,-743.0,0.0,0.0,0.0
witaj001,Jay Witasick,Kansas City Royals,ROYALS,1,1,1,2,2000,2001,1,0.25,0.3,0.05,256,21,-235,31,0,-31,620.0,366.0,-254.0,250000.0,360000.0,110000.0
witaj001,Jay Witasick,San Diego Padres,PADRS,4,6,6,12,2001,2005,4,0.88,0.22,-0.66,482,271,-211,1468,818,-650,145.0,188.0,43.0,5015000.0,3000000.0,-2015000.0
witaj001,Jay Witasick,New York Yankees,YANKS,1,1,1,2,2001,2002,1,1.38,0.36,-1.02,86,84,-2,5,245,240,205.0,0.0,-205.0,0.0,0.0,0.0
witaj001,Jay Witasick,Colorado Rockies,ROCKS,3,5,4,9,2005,2010,5,4.0,-0.14,-4.14,707,385,-322,1691,690,-1001,801.0,134.0,-667.0,2526000.0,4430000.0,1904000.0
witem101,Mickey Witek,New York Yankees,YANKS,1,1,3,4,1939,1943,4,7.53,0.0,-7.53,579,0,-579,2323,0,-2323,0.0,0.0,0.0,0.0,6000.0,6000.0
witem101,Mickey Witek,Boston Red Sox,RSOX,1,2,2,4,1948,1948,0,0.0,0.0,0.0,2,0,-2,1,0,-1,0.0,0.0,0.0,0.0,0.0,0.0
witem101,Mickey Witek,New York Giants,GIANTS,2,7,5,12,1948,1954,6,0.0,-0.44,-0.44,0,186,186,0,308,308,0.0,172.0,172.0,0.0,0.0,0.0
withc001,Chris Withrow,Los Angeles Dodgers,DOGRS,1,2,4,6,2015,2016,1,1.24,-0.01,-1.25,134,78,-56,167,142,-25,113.0,54.0,-59.0,0.0,0.0,0.0
withc101,Corky Withrow,St. Louis Cardinals,CARDS,2,4,3,7,1964,1965,1,0.31,0.14,-0.17,71,26,-45,56,14,-42,454.0,133.0,-321.0,0.0,0.0,0.0
withf101,Frank Withrow,Philadelphia Phillies,PHILS,6,11,10,21,1923,1940,17,39.18,45.63,6.45,1904,3534,1630,7415,12647,5232,0.0,0.0,0.0,21000.0,7500.0,-13500.0
wittb001,Bobby Witt,Texas Rangers,RNGRS,2,5,3,8,1992,1996,4,8.49,4.09,-4.4,638,377,-261,2442,1627,-815,1191.0,3.0,-1188.0,15083333.0,7550000.0,-7533333.0
wittb001,Bobby Witt,Florida Marlins,MARLNS,1,1,2,3,1995,1997,2,3.86,0.0,-3.86,95,0,-95,7,0,-7,1618.0,0.0,-1618.0,1800000.0,109000.0,-1691000.0
wittm001,Mike Witt,California Angels,ANGELS,1,1,1,2,1990,1991,1,-0.2,1.69,1.89,27,262,235,0,1103,1103,429.0,0.0,-429.0,1300000.0,1958652.0,658652.0
wittn001,Nick Wittgren,Miami Marlins,MARLNS,1,1,1,2,2019,2019,0,1.31,0.0,-1.31,147,0,-147,0,0,0,431.0,0.0,-431.0,0.0,0.0,0.0
wockj001,John Wockenfuss,Texas Rangers,RNGRS,3,7,4,11,1973,1978,5,27.61,17.12,-10.49,555,168,-387,197,0,-197,7626.0,3555.0,-4071.0,60000.0,160000.0,100000.0
wockj001,John Wockenfuss,St. Louis Cardinals,CARDS,1,1,1,2,1973,1973,0,6.8,0.0,-6.8,677,0,-677,2117,0,-2117,0.0,0.0,0.0,0.0,0.0,0.0
wockj001,John Wockenfuss,Detroit Tigers,TIGRS,1,2,2,4,1984,1992,8,6.42,12.78,6.36,721,1236,515,2522,2277,-245,3.0,1451.0,1448.0,0.0,0.0,0.0
woeha101,Andy Woehr,Philadelphia Phillies,PHILS,1,2,1,3,1924,1924,0,0.0,0.0,0.0,0,0,0,0,0,0,0.0,0.0,0.0,4800.0,0.0,-4800.0
wohlj001,Jim Wohlford,Kansas City Royals,ROYALS,2,4,3,7,1976,1980,4,4.07,20.62,16.55,704,736,32,973,2593,1620,2869.0,802.0,-2067.0,0.0,0.0,0.0
wohlj001,Jim Wohlford,San Francisco Giants,GIANTS,1,1,1,2,1983,1983,0,1.35,0.33,-1.02,318,22,-296,626,77,-549,0.0,0.0,0.0,0.0,0.0,0.0
wohlm001,Mark Wohlers,Atlanta Braves,BRAVES,1,2,1,3,1999,1999,0,0.18,-0.27,-0.45,99,27,-72,0,1,1,180.0,50.0,-130.0,5200000.0,800000.0,-4400000.0
wohlm001,Mark Wohlers,Cincinnati Reds,REDS,1,1,1,2,2001,2001,0,0.22,0.0,-0.22,36,0,-36,0,0,0,107.0,0.0,-107.0,500000.0,0.0,-500000.0
wojca001,Asher Wojciechowski,Toronto Blue Jays,BJAYS,4,12,6,18,2012,2016,4,10.83,2.99,-7.84,1068,309,-759,3494,605,-2889,904.0,1431.0,527.0,11237500.0,12316000.0,1078500.0
wojep101,Pete Wojey,Brooklyn Dodgers,DOGRS,1,1,2,3,1955,1955,0,0.17,0.0,-0.17,8,0,-8,0,0,0,16.0,0.0,-16.0,0.0,0.0,0.0
wojep101,Pete Wojey,Detroit Tigers,TIGRS,3,5,6,11,1958,1964,6,0.54,14.8,14.26,185,388,203,295,399,104,451.0,2975.0,2524.0,0.0,0.0,0.0
wojne001,Ed Wojna,Philadelphia Phillies,PHILS,1,4,2,6,1983,1984,1,4.33,2.1,-2.23,526,139,-387,92,339,247,1500.0,17.0,-1483.0,0.0,0.0,0.0
wojne001,Ed Wojna,San Diego Padres,PADRS,1,1,1,2,1987,1988,1,0.0,0.0,0.0,0,0,0,0,0,0,0.0,0.0,0.0,0.0,675000.0,675000.0
wojne001,Ed Wojna,Chicago White Sox,WSOX,1,2,1,3,1989,1989,0,0.24,0.81,0.57,9,66,57,0,229,229,99.0,0.0,-99.0,0.0,0.0,0.0
wolcb001,Bob Wolcott,Arizona Diamondbacks,DBACKS,1,1,1,2,1998,2000,2,-0.14,0.0,0.14,4,0,-4,0,0,0,20.0,0.0,-20.0,0.0,0.0,0.0
wolfb001,Brian Wolfe,Milwaukee Brewers,BREWRS,1,1,1,2,2006,2007,1,0.72,1.11,0.39,75,76,1,0,289,289,248.0,0.0,-248.0,0.0,0.0,0.0
wolfb102,Barney Wolfe,New York Yankees,YANKS,1,2,1,3,1904,1904,0,10.23,2.28,-7.95,672,44,-628,792,66,-726,6259.0,413.0,-5846.0,0.0,0.0,0.0
wolfl101,Larry Wolfe,Minnesota Twins,TWINS,1,1,1,2,1979,1979,0,0.18,0.0,-0.18,65,0,-65,124,0,-124,0.0,0.0,0.0,0.0,0.0,0.0
wolfr001,Randy Wolf,San Diego Padres,PADRS,2,2,2,4,2008,2009,1,1.12,-0.01,-1.13,25,8,-17,26,6,-20,227.0,54.0,-173.0,4750000.0,0.0,-4750000.0
wolfr002,Ross Wolf,Baltimore Orioles,ORLS,1,1,1,2,2010,2011,1,0.02,-0.09,-0.11,11,65,54,0,172,172,38.0,0.0,-38.0,0.0,405000.0,405000.0
wolfr102,Roger Wolff,Philadelphia Athletics,ATLTCS,1,1,1,2,1943,1946,3,5.14,6.62,1.48,174,166,-8,200,214,14,1581.0,1742.0,161.0,5000.0,15000.0,10000.0
wolfr102,Roger Wolff,Washington Senators,TWINS,1,1,1,2,1947,1947,0,0.01,-0.8,-0.81,14,36,22,5,89,84,48.0,0.0,-48.0,0.0,0.0,0.0
wolfr102,Roger Wolff,Pittsburgh Pirates,PIRATS,1,2,1,3,1947,1953,6,0.0,-0.99,-0.99,0,295,295,0,686,686,0.0,0.0,0.0,0.0,0.0,0.0
wolfw101,Wally Wolf,Houston Astros,ASTROS,2,4,2,6,1964,1966,2,0.87,1.76,0.89,66,278,212,152,894,742,15.0,0.0,-15.0,0.0,0.0,0.0
wolvh101,Harry Wolverton,Philadelphia Phillies,PHILS,1,2,1,3,1904,1904,0,3.87,0.0,-3.87,209,0,-209,665,0,-665,1001.0,0.0,-1001.0,0.0,0.0,0.0
womad101,Dooley Womack,New York Yankees,YANKS,2,2,2,4,1968,1969,1,0.39,0.08,-0.31,86,6,-80,63,14,-49,154.0,0.0,-154.0,38500.0,12000.0,-26500.0
womad101,Dooley Womack,Houston Astros,ASTROS,1,2,1,3,1969,1970,1,0.39,-0.47,-0.86,18,90,72,1,24,23,43.0,312.0,269.0,23500.0,22000.0,-1500.0
womad101,Dooley Womack,Houston Astros,ASTROS,2,4,2,6,1969,1973,4,-0.36,3.98,4.34,121,303,182,243,70,-173,0.0,713.0,713.0,23500.0,0.0,-23500.0
womat001,Tony Womack,Pittsburgh Pirates,PIRATS,1,1,2,3,1999,2000,1,1.43,0.08,-1.35,629,8,-621,2744,1,-2743,0.0,16.0,16.0,0.0,0.0,0.0
womat001,Tony Womack,Arizona Diamondbacks,DBACKS,1,1,1,2,2003,2003,0,-0.63,0.0,0.63,21,0,-21,81,0,-81,0.0,0.0,0.0,6000000.0,0.0,-6000000.0
womat001,Tony Womack,Colorado Rockies,ROCKS,1,1,1,2,2003,2003,0,0.24,0.0,-0.24,40,0,-40,109,0,-109,0.0,0.0,0.0,0.0,0.0,0.0
womat001,Tony Womack,Boston Red Sox,RSOX,1,1,1,2,2004,2004,0,3.28,0.0,-3.28,145,0,-145,606,0,-606,0.0,0.0,0.0,0.0,0.0,0.0
womat001,Tony Womack,New York Yankees,YANKS,1,2,2,4,2005,2005,0,0.1,0.0,-0.1,9,0,-9,23,0,-23,0.0,0.0,0.0,2000000.0,0.0,-2000000.0
wongc001,Connor Wong,Los Angeles Dodgers,DOGRS,1,3,3,6,2020,2020,0,4.62,3.6,-1.02,205,55,-150,839,246,-593,0.0,0.0,0.0,0.0,0.0,0.0
wooda001,Al Woods,Toronto Blue Jays,BJAYS,1,1,1,2,1982,1984,2,0.0,4.73,4.73,0,269,269,0,899,899,0.0,0.0,0.0,0.0,0.0,0.0
wooda002,Alex Wood,Atlanta Braves,BRAVES,3,7,11,18,2015,2020,5,4.88,-1.29,-6.17,588,465,-123,687,1320,633,1642.0,246.0,-1396.0,24400000.0,34929500.0,10529500.0
wooda002,Alex Wood,Los Angeles Dodgers,DOGRS,3,12,8,20,2018,2021,3,5.8,8.33,2.53,663,133,-530,2223,501,-1722,299.0,229.0,-70.0,36964000.0,68503480.0,31539480.0
woodd102,Dick Woodson,Minnesota Twins,TWINS,1,1,2,3,1974,1977,3,-0.46,-0.48,-0.02,8,13,5,0,0,0,84.0,140.0,56.0,29000.0,0.0,-29000.0
woodd102,Dick Woodson,New York Yankees,YANKS,1,1,1,2,1975,1975,0,0.0,0.0,0.0,0,0,0,0,0,0,0.0,0.0,0.0,0.0,0.0,0.0
woodf102,Frank Woodward,Philadelphia Phillies,PHILS,3,6,7,13,1919,1925,6,15.32,16.37,1.05,851,640,-211,1993,1730,-263,4451.0,3043.0,-1408.0,8500.0,16850.0,8350.0
woodg001,Gary Woods,Toronto Blue Jays,BJAYS,3,3,3,6,1978,1986,8,0.25,3.51,3.26,73,454,381,181,1261,1080,0.0,0.0,0.0,0.0,0.0,0.0
woodg001,Gary Woods,Houston Astros,ASTROS,1,1,1,2,1981,1981,0,0.76,0.0,-0.76,378,0,-378,690,0,-690,0.0,0.0,0.0,0.0,0.0,0.0
woodg101,Gene Woodling,Cleveland Indians,INDINS,1,1,1,2,1946,1947,1,0.08,0.35,0.27,22,61,39,87,135,48,0.0,0.0,0.0,0.0,0.0,0.0
woodg101,Gene Woodling,Pittsburgh Pirates,PIRATS,1,5,1,6,1947,1947,0,0.0,0.0,0.0,0,0,0,0,0,0,0.0,0.0,0.0,5000.0,0.0,-5000.0
woodg101,Gene Woodling,New York Yankees,YANKS,12,33,27,60,1954,1970,16,40.55,76.98,36.43,5201,4368,-833,16466,10777,-5689,3212.0,10751.0,7539.0,302500.0,109500.0,-193000.0
woodg101,Gene Woodling,Baltimore Orioles,ORLS,2,3,3,6,1955,1956,1,5.21,-0.32,-5.53,337,154,-183,1279,434,-845,0.0,0.0,0.0,0.0,0.0,0.0
woodg101,Gene Woodling,Cleveland Indians,INDINS,8,15,14,29,1958,1968,10,101.35,32.49,-68.86,4418,2446,-1972,15260,8973,-6287,4502.0,562.0,-3940.0,0.0,32000.0,32000.0
woodh001,Hunter Wood,Tampa Bay Devil Rays,RAYS,1,2,2,4,2019,2019,0,0.02,0.0,-0.02,21,0,-21,0,0,0,49.0,0.0,-49.0,0.0,0.0,0.0
woodh101,Hal Woodeshick,Detroit Tigers,TIGRS,3,4,5,9,1958,1968,10,1.32,14.68,13.36,168,713,545,243,528,285,332.0,3536.0,3204.0,0.0,0.0,0.0
woodh101,Hal Woodeshick,Cleveland Indians,INDINS,1,2,1,3,1959,1960,1,-2.61,0.95,3.56,330,49,-281,541,143,-398,528.0,0.0,-528.0,0.0,0.0,0.0
woodh101,Hal Woodeshick,Washington Senators,RNGRS,1,1,1,2,1961,1967,6,-0.79,0.48,1.27,24,430,406,5,1410,1405,55.0,0.0,-55.0,0.0,0.0,0.0
woodh101,Hal Woodeshick,Houston Astros,ASTROS,3,6,5,11,1965,1970,5,24.19,12.71,-11.48,1107,622,-485,906,1206,300,7567.0,2468.0,-5099.0,0.0,61000.0,61000.0
woodj001,Jason Wood,Oakland Athletics,ATLTCS,1,1,1,2,1998,1998,0,-0.21,1.23,1.44,37,61,24,73,201,128,0.0,0.0,0.0,170000.0,2300000.0,2130000.0
woodj103,Jim Woods,Chicago Cubs,CUBS,1,3,1,4,1960,1961,1,4.05,4.05,0.0,233,260,27,447,1040,593,1208.0,0.0,-1208.0,0.0,0.0,0.0
woodk002,Kerry Wood,Cleveland Indians,INDINS,1,2,2,4,2010,2010,0,1.48,0.0,-1.48,24,0,-24,0,0,0,78.0,0.0,-78.0,10500000.0,0.0,-10500000.0
woodk101,Ken Wood,St.Louis Browns,ORLS,3,5,5,10,1951,1956,5,0.5,2.1,1.6,348,405,57,823,914,91,0.0,256.0,256.0,0.0,20000.0,20000.0
woodk101,Ken Wood,Boston Red Sox,RSOX,1,1,1,2,1952,1953,1,0.53,-0.15,-0.68,73,18,-55,275,41,-234,0.0,0.0,0.0,0.0,0.0,0.0
woodk101,Ken Wood,Washington Senators,TWINS,1,1,1,2,1953,1953,0,0.0,-0.08,-0.08,0,17,17,0,24,24,0.0,0.0,0.0,0.0,0.0,0.0
woodl101,Larry Woodall,Chicago Cubs,CUBS,2,8,3,11,1933,1946,13,22.35,18.34,-4.01,627,903,276,2568,3781,1213,0.0,0.0,0.0,0.0,0.0,0.0
woodm002,Mike Wood,Oakland Athletics,ATLTCS,1,2,1,3,2004,2005,1,4.64,1.22,-3.42,770,62,-708,2737,0,-2737,839.0,198.0,-641.0,0.0,0.0,0.0
woodr102,Ron Woods,Detroit Tigers,TIGRS,1,1,1,2,1969,1970,1,1.05,0.61,-0.44,192,94,-98,500,377,-123,0.0,0.0,0.0,7500.0,0.0,-7500.0
woodr102,Ron Woods,New York Yankees,YANKS,1,1,1,2,1971,1973,2,2.67,0.28,-2.39,373,152,-221,944,350,-594,0.0,0.0,0.0,16000.0,0.0,-16000.0
woods001,Steve Woodard,Milwaukee Brewers,BREWRS,9,19,22,41,2000,2012,12,44.17,39.37,-4.8,3016,3033,17,9285,7113,-2172,2619.0,7597.0,4978.0,13997000.0,20222667.0,6225667.0
woods102,Sam Woodruff,Cincinnati Reds,REDS,1,2,1,3,1905,1905,0,0.0,0.0,0.0,0,0,0,0,0,0,0.0,0.0,0.0,0.0,0.0,0.0
woods102,Sam Woodruff,Louisville,Louisville,1,1,2,3,1910,1910,0,-0.59,0.0,0.59,21,0,-21,69,0,-69,0.0,0.0,0.0,0.0,0.0,0.0
woodt001,Tracy Woodson,Los Angeles Dodgers,DOGRS,1,1,1,2,1989,1989,0,0.0,0.0,0.0,0,0,0,0,0,0,0.0,0.0,0.0,0.0,0.0,0.0
woodt004,Travis Wood,Cincinnati Reds,REDS,1,3,1,4,2011,2015,4,7.63,1.09,-6.54,509,203,-306,388,0,-388,2074.0,256.0,-1818.0,422500.0,1600000.0,1177500.0
woodt004,Travis Wood,Kansas City Royals,ROYALS,2,7,5,12,2017,2021,4,3.49,-0.89,-4.38,348,169,-179,52,6,-46,1021.0,694.0,-327.0,538900.0,4194700.0,3655800.0
woodw101,Woody Woodward,Atlanta Braves,BRAVES,3,5,5,10,1968,1970,2,13.88,3.02,-10.86,1605,185,-1420,1388,304,-1084,4147.0,923.0,-3224.0,0.0,12000.0,12000.0
woodw102,Walt Woods,Pittsburgh Pirates,PIRATS,1,3,1,4,1901,1901,0,0.0,-0.42,-0.42,0,14,14,0,21,21,0.0,133.0,133.0,0.0,0.0,0.0
woodw103,Wilbur Wood,Pittsburgh Pirates,PIRATS,1,1,1,2,1966,1968,2,50.06,-1.24,-51.3,965,125,-840,349,30,-319,7574.0,354.0,-7220.0,0.0,26000.0,26000.0
workb001,Brandon Workman,Boston Red Sox,RSOX,1,2,2,4,2020,2020,0,-0.87,0.58,1.45,25,2,-23,0,0,0,67.0,30.0,-37.0,5113000.0,0.0,-5113000.0
workc101,Chuck Workman,Boston Braves,BRAVES,1,1,1,2,1946,1946,0,0.37,-0.14,-0.51,58,24,-34,162,55,-107,0.0,0.0,0.0,0.0,0.0,0.0
worlv001,Vance Worley,Philadelphia Phillies,PHILS,3,4,4,8,2012,2016,4,1.59,4.92,3.33,336,335,-1,250,1350,1100,1151.0,0.0,-1151.0,4595000.0,492500.0,-4102500.0
worrm001,Mark Worrell,St. Louis Cardinals,CARDS,1,2,1,3,2008,2009,1,4.04,-0.85,-4.89,717,77,-640,3,193,190,1041.0,0.0,-1041.0,0.0,4500000.0,4500000.0
worrt002,Tim Worrell,San Diego Padres,PADRS,11,16,16,32,1997,2005,8,0.63,9.5,8.87,874,1331,457,1663,2360,697,1171.0,1867.0,696.0,13510000.0,3990000.0,-9520000.0
worrt002,Tim Worrell,Detroit Tigers,TIGRS,1,2,1,3,1998,1998,0,0.14,-0.51,-0.65,78,52,-26,182,145,-37,16.0,0.0,-16.0,1000000.0,2200000.0,1200000.0
worrt002,Tim Worrell,Cleveland Indians,INDINS,1,1,1,2,1998,1998,0,1.32,0.0,-1.32,82,0,-82,0,0,0,316.0,0.0,-316.0,0.0,0.0,0.0
worrt002,Tim Worrell,Chicago Cubs,CUBS,2,3,2,5,2000,2002,2,1.7,3.59,1.89,504,173,-331,24,670,646,747.0,0.0,-747.0,3450000.0,1325000.0,-2125000.0
worrt002,Tim Worrell,Philadelphia Phillies,PHILS,1,2,1,3,2005,2006,1,0.45,-0.09,-0.54,64,10,-54,1,6,5,95.0,0.0,-95.0,3050000.0,330000.0,-2720000.0
worta101,Al Worthington,San Francisco Giants,GIANTS,1,1,1,2,1960,1961,1,-0.51,0.2,0.71,12,119,107,1,176,175,35.0,0.0,-35.0,0.0,0.0,0.0
wortc001,Craig Worthington,Baltimore Orioles,ORLS,1,2,2,4,1992,1992,0,0.0,0.0,0.0,0,0,0,0,0,0,0.0,0.0,0.0,0.0,0.0,0.0
wortc001,Craig Worthington,Cincinnati Reds,REDS,1,1,2,3,1995,1995,0,0.43,0.0,-0.43,39,0,-39,104,0,-104,0.0,0.0,0.0,0.0,0.0,0.0
wortc101,Chuck Wortman,KansasCity,KansasCity,1,2,1,3,1916,1916,0,-2.05,0.0,2.05,161,0,-161,494,0,-494,0.0,0.0,0.0,0.0,1350.0,1350.0
wortr101,Rich Wortham,Chicago White Sox,WSOX,2,2,2,4,1980,1987,7,0.85,11.85,11.0,80,716,636,347,2709,2362,0.0,0.0,0.0,252000.0,425000.0,173000.0
wothm001,Matt Wotherspoon,New York Yankees,YANKS,1,1,1,2,2017,2017,0,-0.4,0.0,0.4,2,0,-2,0,0,0,14.0,0.0,-14.0,0.0,0.0,0.0
wriga102,Al Wright,Mission,Mission,1,2,2,4,1932,1933,1,-0.29,0.0,0.29,86,0,-86,205,0,-205,0.0,0.0,0.0,0.0,0.0,0.0
wrigc001,Chase Wright,New York Yankees,YANKS,2,3,3,6,2009,2009,0,-0.08,0.01,0.09,52,39,-13,126,98,-28,0.0,0.0,0.0,0.0,1500000.0,1500000.0
wrigc102,Clyde Wright,California Angels,ANGELS,3,7,8,15,1973,1976,3,0.2,6.55,6.35,187,557,370,417,1633,1216,696.0,244.0,-452.0,35000.0,131300.0,96300.0
wrigc102,Clyde Wright,Milwaukee Brewers,BREWRS,1,1,1,2,1974,1976,2,-0.25,1.7,1.95,25,58,33,0,0,0,280.0,938.0,658.0,67001.0,0.0,-67001.0
wrige101,Ed Wright,Indianapolis,Indianapolis,1,1,2,3,1945,1945,0,3.35,0.0,-3.35,154,0,-154,133,0,-133,1068.0,0.0,-1068.0,0.0,0.0,0.0
wrige101,Ed Wright,Philadelphia Phillies,PHILS,1,1,1,2,1950,1950,0,0.0,0.0,0.0,0,0,0,0,0,0,0.0,0.0,0.0,0.0,0.0,0.0
wrigg001,George Wright,San Francisco Giants,GIANTS,1,1,1,2,1989,1989,0,0.0,-0.19,-0.19,0,12,12,0,20,20,0.0,0.0,0.0,0.0,0.0,0.0
wrigg102,Glenn Wright,Pittsburgh Pirates,PIRATS,1,1,2,3,1928,1930,2,8.54,0.53,-8.01,434,100,-334,1570,99,-1471,0.0,677.0,677.0,12000.0,21000.0,9000.0
wrigg103,Gene Wright,Cleveland Indians,INDINS,2,2,2,4,1903,1905,2,3.81,4.62,0.81,75,142,67,117,222,105,918.0,1669.0,751.0,0.0,0.0,0.0
wrigj001,Jamey Wright,Colorado Rockies,ROCKS,3,5,7,12,1999,2008,9,2.61,15.28,12.67,628,1324,696,1684,1373,-311,1546.0,2205.0,659.0,5440000.0,6737500.0,1297500.0
wrigj001,Jamey Wright,Milwaukee Brewers,BREWRS,1,2,2,4,2002,2003,1,0.01,0.04,0.03,8,8,0,6,1,-5,45.0,12.0,-33.0,4250000.0,300000.0,-3950000.0
wrigj002,Jaret Wright,New York Yankees,YANKS,1,2,1,3,2006,2008,2,-0.34,0.34,0.68,3,28,25,0,0,0,31.0,107.0,76.0,7666667.0,0.0,-7666667.0
wrigj101,Jim Wright,Kansas City Royals,ROYALS,1,1,1,2,1982,1982,0,0.0,0.0,0.0,0,0,0,0,0,0,0.0,0.0,0.0,0.0,0.0,0.0
wrigj102,Joe Wright,Louisville Colonels,LS3,1,2,1,3,1896,1899,3,-0.17,5.69,5.86,17,500,483,58,1976,1918,0.0,0.0,0.0,0.0,0.0,0.0
wrigk101,Ken Wright,Kansas City Royals,ROYALS,1,2,1,3,1973,1977,4,9.36,0.87,-8.49,1040,79,-961,3577,0,-3577,17.0,554.0,537.0,65000.0,48000.0,-17000.0
wrigk101,Ken Wright,New York Yankees,YANKS,1,1,1,2,1974,1975,1,0.0,0.48,0.48,0,26,26,0,0,0,0.0,170.0,170.0,20000.0,0.0,-20000.0
wrigm001,Mike Wright,Baltimore Orioles,ORLS,1,1,1,2,2019,2019,0,-0.21,0.0,0.21,9,0,-9,0,0,0,48.0,0.0,-48.0,567500.0,0.0,-567500.0
wrigm101,Mel Wright,New York Yankees,YANKS,2,5,3,8,1954,1955,1,3.52,0.32,-3.2,493,79,-414,1250,164,-1086,274.0,0.0,-274.0,20000.0,0.0,-20000.0
wrigr001,Ricky Wright,Los Angeles Dodgers,DOGRS,5,8,6,14,1983,1994,11,11.39,19.01,7.62,690,775,85,366,1238,872,3528.0,4504.0,976.0,3861000.0,3708000.0,-153000.0
wrigr002,Ron Wright,Atlanta Braves,BRAVES,3,9,6,15,1996,2002,6,32.33,18.19,-14.14,1723,1238,-485,5218,2155,-3063,3645.0,2345.0,-1300.0,12631500.0,14051680.0,1420180.0
wrigr104,Rasty Wright,St.Louis Browns,ORLS,1,2,1,3,1920,1920,0,0.0,5.97,5.97,0,76,76,0,110,110,0.0,806.0,806.0,0.0,0.0,0.0
wrigs001,Steven Wright,Cleveland Indians,INDINS,5,9,12,21,2012,2019,7,7.61,23.51,15.9,415,937,522,560,910,350,1555.0,4479.0,2924.0,22963900.0,12523333.0,-10440567.0
wrigt101,Tom Wright,Boston Red Sox,RSOX,2,3,3,6,1951,1954,3,0.76,-1.3,-2.06,327,78,-249,1005,178,-827,0.0,0.0,0.0,0.0,0.0,0.0
wrigt101,Tom Wright,St.Louis Browns,ORLS,1,2,2,4,1952,1952,0,0.64,0.34,-0.3,156,55,-101,332,173,-159,0.0,0.0,0.0,0.0,20000.0,20000.0
wrigt101,Tom Wright,Chicago White Sox,WSOX,1,1,1,2,1954,1954,0,0.35,0.0,-0.35,85,0,-85,200,0,-200,0.0,0.0,0.0,0.0,0.0,0.0
wrigt102,Taffy Wright,Washington Senators,TWINS,5,8,6,14,1939,1946,7,15.27,0.38,-14.89,1887,491,-1396,7336,1848,-5488,270.0,315.0,45.0,42250.0,35000.0,-7250.0
wuerm001,Michael Wuertz,Chicago Cubs,CUBS,1,1,2,3,2009,2009,0,1.6,0.0,-1.6,173,0,-173,0,0,0,456.0,0.0,-456.0,0.0,0.0,0.0
wuesy101,Yats Wuestling,Detroit Tigers,TIGRS,1,3,2,5,1930,1932,2,0.55,-1.14,-1.69,146,271,125,467,761,294,97.0,731.0,634.0,18000.0,25000.0,7000.0
wyatj102,John Wyatt,New York Yankees,YANKS,1,1,1,2,1968,1968,0,0.35,0.0,-0.35,44,0,-44,2,0,-2,91.0,0.0,-91.0,0.0,8000.0,8000.0
wyatj102,John Wyatt,Kansas City Athletics,ATLTCS,10,23,15,38,1966,1976,10,27.1,17.67,-9.43,4296,1831,-2465,8999,4813,-4186,5181.0,1373.0,-3808.0,355600.0,427500.0,71900.0
wyatw101,Whit Wyatt,Detroit Tigers,TIGRS,1,1,1,2,1933,1934,1,-0.72,-1.98,-1.26,164,56,-108,74,52,-22,631.0,381.0,-250.0,3900.0,0.0,-3900.0
wyneb001,Butch Wynegar,Minnesota Twins,TWINS,4,5,7,12,1982,1986,4,11.35,2.12,-9.23,555,275,-280,2031,106,-1925,297.0,1461.0,1164.0,620000.0,0.0,-620000.0
wyneb001,Butch Wynegar,New York Yankees,YANKS,2,2,4,6,1986,1992,6,6.03,0.09,-5.94,415,42,-373,167,0,-167,1440.0,174.0,-1266.0,733333.0,425000.0,-308333.0
wynnb102,Billy Wynne,New York Mets,METS,2,5,4,9,1967,1974,7,2.47,11.88,9.41,357,948,591,832,3426,2594,1066.0,0.0,-1066.0,89000.0,31000.0,-58000.0
wynnb102,Billy Wynne,Chicago White Sox,WSOX,5,12,9,21,1970,1979,9,24.46,26.69,2.23,2016,1630,-386,4784,5459,675,4690.0,2166.0,-2524.0,87700.0,263100.0,175400.0
wynne101,Early Wynn,Washington Senators,TWINS,13,25,27,52,1948,1963,15,65.65,20.21,-45.44,3128,2926,-202,8413,6562,-1851,9264.0,7302.0,-1962.0,32000.0,59000.0,27000.0
wynne101,Early Wynn,Cleveland Indians,INDINS,8,14,14,28,1957,1968,11,114.78,28.23,-86.55,4690,1762,-2928,15896,6646,-9250,7534.0,133.0,-7401.0,15000.0,32000.0,17000.0
wynnj101,Jim Wynn,Houston Astros,ASTROS,4,4,6,10,1973,1979,6,12.44,0.12,-12.32,338,148,-190,1224,113,-1111,349.0,1017.0,668.0,100000.0,100000.0,0.0
wynnj101,Jim Wynn,Los Angeles Dodgers,DOGRS,1,4,2,6,1975,1984,9,-0.88,19.14,20.02,1504,1261,-243,5163,4749,-414,0.0,0.0,0.0,0.0,0.0,0.0
wynnm001,Marvell Wynne,Kansas City Royals,ROYALS,1,2,1,3,1981,1981,0,0.0,-1.23,-1.23,0,8,8,0,0,0,0.0,59.0,59.0,0.0,0.0,0.0
wynnm001,Marvell Wynne,New York Mets,METS,1,2,2,4,1983,1984,1,-1.75,-1.63,0.12,360,108,-252,1480,288,-1192,0.0,0.0,0.0,0.0,0.0,0.0
wynnm001,Marvell Wynne,Pittsburgh Pirates,PIRATS,1,1,1,2,1986,1992,6,0.09,1.19,1.1,468,414,-54,1204,60,-1144,0.0,993.0,993.0,0.0,0.0,0.0
wynnm001,Marvell Wynne,San Diego Padres,PADRS,8,18,21,39,1989,2006,17,11.32,49.82,38.5,3213,4280,1067,10642,14704,4062,712.0,1706.0,994.0,13757500.0,22894000.0,9136500.0
wyroj101,Johnny Wyrostek,Pittsburgh Pirates,PIRATS,2,6,4,10,1943,1950,7,26.56,10.14,-16.42,1156,549,-607,3340,925,-2415,3832.0,2198.0,-1634.0,0.0,0.0,0.0
wyroj101,Johnny Wyrostek,Philadelphia Phillies,PHILS,1,2,1,3,1948,1950,2,7.24,0.5,-6.74,573,215,-358,2394,797,-1597,0.0,0.0,0.0,0.0,0.0,0.0
wyroj101,Johnny Wyrostek,Cincinnati Reds,REDS,3,4,4,8,1952,1958,6,0.93,3.9,2.97,451,195,-256,1172,136,-1036,552.0,1210.0,658.0,0.0,0.0,0.0
yajum001,Miguel Yajure,New York Yankees,YANKS,1,4,1,5,2021,2021,0,-0.2,2.23,2.43,9,31,22,3,2,-1,54.0,433.0,379.0,0.0,0.0,0.0
yamaj001,Jordan Yamamoto,Milwaukee Brewers,BREWRS,1,4,1,5,2018,2018,0,-6.06,7.26,13.32,541,147,-394,1645,651,-994,270.0,0.0,-270.0,0.0,0.0,0.0
yamaj001,Jordan Yamamoto,Miami Marlins,MARLNS,1,1,1,2,2021,2021,0,-0.17,0.0,0.17,4,0,-4,2,0,-2,20.0,0.0,-20.0,0.0,0.0,0.0
yan-e001,Esteban Yan,Atlanta Braves,BRAVES,3,6,4,10,1995,1999,4,13.08,11.82,-1.26,850,727,-123,3247,1894,-1353,105.0,396.0,291.0,575000.0,700000.0,125000.0
yan-e001,Esteban Yan,Texas Rangers,RNGRS,1,1,1,2,2003,2003,0,-0.49,0.0,0.49,74,0,-74,1,0,-1,130.0,0.0,-130.0,1500000.0,0.0,-1500000.0
yan-e001,Esteban Yan,Anaheim Angels,ANGELS,1,2,1,3,2006,2006,0,0.23,0.0,-0.23,28,0,-28,0,0,0,45.0,0.0,-45.0,1250000.0,0.0,-1250000.0
yanch101,Hugh Yancy,Chicago White Sox,WSOX,1,1,1,2,1976,1978,2,0.0,-0.61,-0.61,0,29,29,0,67,67,0.0,0.0,0.0,0.0,0.0,0.0
yantg101,George Yantz,Cleveland Indians,INDINS,1,6,1,7,1913,1914,1,0.0,-0.98,-0.98,0,48,48,0,37,37,0.0,303.0,303.0,0.0,0.0,0.0
yarbr001,Ryan Yarbrough,Seattle Mariners,MARNRS,1,3,1,4,2017,2017,0,6.86,0.0,-6.86,335,0,-335,833,0,-833,1499.0,0.0,-1499.0,0.0,0.0,0.0
yarne001,Ed Yarnall,New York Mets,METS,1,3,1,4,1998,2005,7,6.18,24.6,18.42,588,972,384,2350,3941,1591,0.0,0.0,0.0,0.0,0.0,0.0
yarne001,Ed Yarnall,Florida Marlins,MARLNS,8,17,20,37,1999,2019,20,61.77,64.47,2.7,1848,3278,1430,4569,10868,6299,8696.0,5082.0,-3614.0,29867000.0,14191425.0,-15675575.0
yarne001,Ed Yarnall,New York Yankees,YANKS,1,4,2,6,2000,2000,0,-1.35,0.26,1.61,143,16,-127,19,0,-19,383.0,274.0,-109.0,0.0,4750000.0,4750000.0
yarrr101,Rube Yarrison,Brooklyn Dodgers,DOGRS,1,1,1,2,1924,1924,0,0.0,0.0,0.0,0,0,0,0,0,0,0.0,0.0,0.0,4500.0,0.0,-4500.0
yastm001,Mike Yastrzemski,Baltimore Orioles,ORLS,1,1,1,2,2019,2019,0,7.67,0.0,-7.67,300,0,-300,1168,0,-1168,0.0,0.0,0.0,0.0,0.0,0.0
yatea101,Al Yates,New York Mets,METS,1,2,1,3,1967,1968,1,0.0,-0.1,-0.1,0,16,16,0,8,8,0.0,79.0,79.0,0.0,20000.0,20000.0
yatea101,Al Yates,Boston Red Sox,RSOX,1,1,1,2,1970,1974,4,0.09,2.98,2.89,24,197,173,52,15,-37,0.0,485.0,485.0,0.0,33000.0,33000.0
yatet001,Tyler Yates,Oakland Athletics,ATLTCS,1,2,1,3,2001,2001,0,0.66,0.0,-0.66,175,0,-175,14,0,-14,284.0,0.0,-284.0,1800000.0,0.0,-1800000.0
yatet001,Tyler Yates,Atlanta Braves,BRAVES,2,2,2,4,2008,2013,5,-0.69,-0.57,0.12,174,107,-67,1,231,230,266.0,0.0,-266.0,0.0,0.0,0.0
yde-e101,Emil Yde,OklahomaCity,OklahomaCity,1,1,1,2,1923,1924,1,3.69,0.0,-3.69,275,0,-275,284,0,-284,1850.0,0.0,-1850.0,0.0,0.0,0.0
yde-e101,Emil Yde,Pittsburgh Pirates,PIRATS,1,2,1,3,1927,1927,0,0.0,0.0,0.0,0,0,0,0,0,0,0.0,0.0,0.0,11200.0,0.0,-11200.0
yeagj101,Joe Yeager,New York Yankees,YANKS,1,1,1,2,1907,1907,0,2.92,-1.04,-3.96,133,52,-81,497,153,-344,0.0,0.0,0.0,0.0,0.0,0.0
yeags001,Steve Yeager,Los Angeles Dodgers,DOGRS,1,1,1,2,1985,1986,1,-0.02,0.6,0.62,50,120,70,146,1,-145,0.0,214.0,214.0,500000.0,315000.0,-185000.0
yeara101,Al Yeargin,Boston Braves,BRAVES,15,35,27,62,1924,1952,28,61.82,121.75,59.93,3287,6434,3147,11058,21686,10628,3053.0,10767.0,7714.0,56700.0,31000.0,-25700.0
yelde001,Eric Yelding,Houston Astros,ASTROS,1,1,1,2,1992,1993,1,0.0,-0.18,-0.18,0,14,14,0,1,1,0.0,36.0,36.0,0.0,0.0,0.0
yelic001,Christian Yelich,Miami Marlins,MARLNS,2,2,5,7,2018,2021,3,15.72,-1.3,-17.02,456,144,-312,1955,432,-1523,20.0,270.0,250.0,0.0,0.0,0.0
yellc101,Chief Yellow Horse,Pittsburgh Pirates,PIRATS,1,5,1,6,1922,1922,0,0.0,0.0,0.0,0,0,0,0,0,0,0.0,0.0,0.0,2700.0,0.0,-2700.0
yerkc101,Carroll Yerkes,Philadelphia Athletics,ATLTCS,1,4,2,6,1929,1936,7,0.0,5.27,5.27,0,394,394,0,395,395,0.0,2946.0,2946.0,7500.0,0.0,-7500.0
yettr001,Rich Yett,Minnesota Twins,TWINS,4,9,7,16,1985,1995,10,10.17,8.8,-1.37,960,260,-700,2169,213,-1956,3138.0,2882.0,-256.0,1000000.0,650000.0,-350000.0
ynoah001,Huascar Ynoa,Minnesota Twins,TWINS,2,2,5,7,2017,2020,3,1.55,0.11,-1.44,58,49,-9,34,2,-32,459.0,223.0,-236.0,0.0,12800000.0,12800000.0
ynoam001,Michael Ynoa,Oakland Athletics,ATLTCS,1,2,4,6,2014,2020,6,0.52,22.61,22.09,80,1074,994,2,4228,4226,819.0,2.0,-817.0,5345000.0,500000.0,-4845000.0
yorkj101,Jim York,Kansas City Royals,ROYALS,1,2,2,4,1971,1978,7,-0.79,21.38,22.17,228,897,669,24,3753,3729,523.0,0.0,-523.0,25250.0,13000.0,-12250.0
yorkl101,Lefty York,Chicago Cubs,CUBS,2,4,2,6,1922,1935,13,1.8,38.34,36.54,269,1621,1352,1048,7164,6116,0.0,0.0,0.0,15500.0,11000.0,-4500.0
yorkm001,Mike York,Pittsburgh Pirates,PIRATS,2,2,2,4,1991,1991,0,-0.69,-1.09,-0.4,431,52,-379,736,129,-607,104.0,0.0,-104.0,0.0,750000.0,750000.0
yorkr101,Rudy York,Detroit Tigers,TIGRS,1,1,1,2,1946,1951,5,1.88,4.16,2.28,202,491,289,875,2016,1141,0.0,0.0,0.0,0.0,0.0,0.0
yorkr101,Rudy York,Boston Red Sox,RSOX,1,1,1,2,1947,1947,0,0.58,0.13,-0.45,102,109,7,438,451,13,0.0,0.0,0.0,0.0,0.0,0.0
yorkt102,Tony York,Boston Braves,BRAVES,6,10,11,21,1946,1966,20,4.65,47.8,43.15,447,2538,2091,1596,8887,7291,15.0,0.0,-15.0,0.0,0.0,0.0
yoshm001,Masato Yoshii,New York Mets,METS,2,4,4,8,2000,2003,3,1.23,0.94,-0.29,67,107,40,77,11,-66,531.0,263.0,-268.0,0.0,500000.0,500000.0
yoste001,Ned Yost,Milwaukee Brewers,BREWRS,4,6,7,13,1983,1991,8,21.39,21.5,0.11,1530,927,-603,1542,2353,811,4939.0,4297.0,-642.0,700000.0,325000.0,-375000.0
yoste101,Eddie Yost,Washington Senators,TWINS,5,10,8,18,1958,1963,5,7.52,-2.19,-9.71,769,798,29,2600,2634,34,5.0,80.0,75.0,9500.0,7000.0,-2500.0
yotee101,Elmer Yoter,Indianapolis,Indianapolis,1,1,2,3,1927,1928,1,0.14,0.0,-0.14,14,0,-14,31,0,-31,0.0,0.0,0.0,0.0,0.0,0.0
youkk001,Kevin Youkilis,Boston Red Sox,RSOX,3,4,4,8,2012,2013,1,1.33,-1.09,-2.42,123,19,-104,467,16,-451,0.0,51.0,51.0,981500.0,0.0,-981500.0
youmf001,Floyd Youmans,New York Mets,METS,1,4,1,5,1984,1989,5,17.64,11.38,-6.26,1847,600,-1247,5919,2448,-3471,1489.0,0.0,-1489.0,356000.0,0.0,-356000.0
youmf001,Floyd Youmans,Montreal Expos,NATEX,1,2,1,3,1988,1990,2,-0.06,1.75,1.81,294,125,-169,31,135,104,762.0,1094.0,332.0,250000.0,450000.0,200000.0
youna001,Anthony Young,New York Mets,METS,2,4,3,7,1994,1998,4,2.23,3.48,1.25,191,688,497,349,2703,2354,468.0,0.0,-468.0,4160000.0,5150000.0,990000.0
youna003,Andy Young,St. Louis Cardinals,CARDS,1,4,1,5,2018,2018,0,4.82,0.0,-4.82,382,0,-382,1034,0,-1034,549.0,0.0,-549.0,550800.0,11100000.0,10549200.0
younb101,Bobby Young,St. Louis Cardinals,CARDS,1,1,1,2,1949,1949,0,-1.88,0.0,1.88,633,0,-633,2603,0,-2603,0.0,0.0,0.0,0.0,0.0,0.0
younb101,Bobby Young,Baltimore Orioles,ORLS,1,1,1,2,1955,1955,0,0.18,-0.41,-0.59,19,16,-3,47,43,-4,0.0,0.0,0.0,0.0,0.0,0.0
younb102,Babe Young,New York Giants,GIANTS,1,1,1,2,1947,1948,1,1.92,-0.03,-1.95,144,66,-78,554,15,-539,0.0,199.0,199.0,0.0,0.0,0.0
younb102,Babe Young,Cincinnati Reds,REDS,1,1,1,2,1948,1948,0,-0.22,-0.47,-0.25,41,32,-9,127,11,-116,0.0,122.0,122.0,0.0,0.0,0.0
younc002,Cliff Young,Montreal Expos,NATEX,4,6,6,12,1985,2001,16,10.34,22.69,12.35,993,1451,458,2591,3729,1138,539.0,722.0,183.0,837500.0,135000.0,-702500.0
younc002,Cliff Young,Toronto Blue Jays,BJAYS,1,1,1,2,1989,1989,0,0.42,-0.3,-0.72,28,7,-21,0,0,0,130.0,51.0,-79.0,0.0,0.0,0.0
younc003,Chris Young,Pittsburgh Pirates,PIRATS,1,2,1,3,2002,2003,1,0.0,0.0,0.0,0,0,0,0,0,0,0.0,0.0,0.0,0.0,370000.0,370000.0
younc003,Chris Young,Montreal Expos,NATEX,1,2,2,4,2004,2004,0,3.6,-0.83,-4.43,40,55,15,5,159,154,603.0,0.0,-603.0,0.0,0.0,0.0
younc003,Chris Young,Texas Rangers,RNGRS,1,3,3,6,2006,2007,1,28.55,3.75,-24.8,1126,114,-1012,3924,0,-3924,1652.0,471.0,-1181.0,0.0,0.0,0.0
younc004,Chris Young,Chicago White Sox,WSOX,3,7,7,14,2005,2015,10,21.04,18.91,-2.13,1161,870,-291,3709,2249,-1460,1060.0,1883.0,823.0,16705000.0,11000000.0,-5705000.0
younc004,Chris Young,Arizona Diamondbacks,DBACKS,4,10,7,17,2012,2017,5,-2.7,5.27,7.97,277,431,154,890,914,24,52.0,197.0,145.0,19275000.0,490000.0,-18785000.0
younc102,Cy Young,Boston Red Sox,RSOX,3,7,7,14,1909,1913,4,5.53,13.46,7.93,126,735,609,191,757,566,1513.0,5050.0,3537.0,0.0,0.0,0.0
yound001,Dmitri Young,St. Louis Cardinals,CARDS,2,4,3,7,1997,1999,2,9.56,-0.59,-10.15,1040,227,-813,3190,4,-3186,549.0,372.0,-177.0,8625000.0,5185000.0,-3440000.0
yound001,Dmitri Young,Tampa Bay Devil Rays,RAYS,1,1,1,2,1997,1999,2,5.59,-0.19,-5.78,565,106,-459,2178,303,-1875,0.0,0.0,0.0,0.0,175000.0,175000.0
yound001,Dmitri Young,Cincinnati Reds,REDS,2,4,3,7,2001,2003,2,8.28,-1.1,-9.38,902,211,-691,3664,427,-3237,0.0,710.0,710.0,5900000.0,6875000.0,975000.0
yound003,Delmon Young,Tampa Bay Devil Rays,RAYS,6,10,18,28,2007,2018,11,7.31,39.77,32.46,1554,1744,190,4454,3404,-1050,1936.0,6404.0,4468.0,6476100.0,1362800.0,-5113300.0
yound003,Delmon Young,Minnesota Twins,TWINS,1,1,2,3,2011,2015,4,-0.57,0.02,0.59,191,18,-173,786,0,-786,0.0,64.0,64.0,5375000.0,0.0,-5375000.0
yound004,Delwyn Young,Los Angeles Dodgers,DOGRS,1,1,2,3,2009,2010,1,-0.88,0.0,0.88,234,0,-234,595,0,-595,0.0,0.0,0.0,0.0,0.0,0.0
yound101,Dick Young,Philadelphia Phillies,PHILS,8,13,12,25,1954,1984,30,31.81,64.58,32.77,1931,3925,1994,6995,10274,3279,0.0,2963.0,2963.0,0.0,123000.0,123000.0
yound103,Don Young,Chicago Cubs,CUBS,1,1,1,2,1970,1970,0,0.0,-0.82,-0.82,0,52,52,0,9,9,0.0,130.0,130.0,0.0,0.0,0.0
youne001,Eric Young,Colorado Rockies,ROCKS,2,3,2,5,1997,2004,7,5.33,7.43,2.1,281,303,22,1234,358,-876,86.0,2830.0,2744.0,10050000.0,3300000.0,-6750000.0
youne001,Eric Young,Los Angeles Dodgers,DOGRS,3,5,6,11,1999,2006,7,3.68,11.28,7.6,433,1170,737,1668,2480,812,416.0,1435.0,1019.0,12175000.0,11536000.0,-639000.0
youne001,Eric Young,Milwaukee Brewers,BREWRS,1,1,1,2,2003,2003,0,-0.78,0.0,0.78,26,0,-26,82,0,-82,0.0,0.0,0.0,2000000.0,0.0,-2000000.0
youne003,Eric Young,Colorado Rockies,ROCKS,1,1,1,2,2013,2013,0,2.06,-0.62,-2.68,209,8,-201,743,4,-739,0.0,57.0,57.0,492000.0,0.0,-492000.0
young001,Gerald Young,New York Mets,METS,1,3,1,4,1984,1986,2,6.19,2.33,-3.86,605,254,-351,2016,932,-1084,0.0,0.0,0.0,0.0,0.0,0.0
younh103,Harley Young,Pittsburgh Pirates,PIRATS,1,2,1,3,1908,1909,1,1.07,0.43,-0.64,57,32,-25,69,31,-38,500.0,269.0,-231.0,1500.0,0.0,-1500.0
youni101,Irv Young,Boston Braves,BRAVES,2,2,3,5,1908,1909,1,0.43,0.35,-0.08,32,65,33,31,78,47,269.0,565.0,296.0,0.0,1500.0,1500.0
younj001,Joel Youngblood,Cincinnati Reds,REDS,2,3,2,5,1977,1981,4,2.35,3.66,1.31,313,112,-201,98,126,28,1033.0,1005.0,-28.0,85000.0,0.0,-85000.0
younj001,Joel Youngblood,St. Louis Cardinals,CARDS,10,27,19,46,1977,1992,15,92.92,102.16,9.24,7343,4582,-2761,22954,15172,-7782,6532.0,3025.0,-3507.0,1533333.0,576667.0,-956666.0
younj001,Joel Youngblood,New York Mets,METS,1,1,1,2,1982,1986,4,-0.73,0.26,0.99,40,196,156,104,16,-88,0.0,507.0,507.0,366667.0,0.0,-366667.0
younj101,John Young,Detroit Tigers,TIGRS,1,1,1,2,1974,1974,0,0.0,0.0,0.0,0,0,0,0,0,0,0.0,0.0,0.0,0.0,0.0,0.0
younl101,Larry Yount,Houston Astros,ASTROS,1,2,1,3,1974,1974,0,0.0,-0.58,-0.58,0,64,64,0,116,116,0.0,0.0,0.0,0.0,0.0,0.0
younm001,Matt Young,Seattle Mariners,MARNRS,1,1,2,3,1986,1990,4,-0.02,0.16,0.18,94,73,-21,3,0,-3,163.0,303.0,140.0,205000.0,62000.0,-143000.0
younm001,Matt Young,Los Angeles Dodgers,DOGRS,1,3,3,6,1987,1992,5,9.39,9.73,0.34,242,1063,821,1,1797,1796,3926.0,1084.0,-2842.0,1187500.0,1137653.0,-49847.0
younm002,Mike Young,Baltimore Orioles,ORLS,2,4,5,9,1988,1989,1,0.13,-2.08,-2.21,83,157,74,184,486,302,0.0,0.0,0.0,0.0,0.0,0.0
younm002,Mike Young,Philadelphia Phillies,PHILS,1,1,1,2,1988,1988,0,-0.38,0.43,0.81,8,10,2,18,3,-15,0.0,49.0,49.0,395000.0,0.0,-395000.0
younm003,Michael Young,Toronto Blue Jays,BJAYS,1,2,1,3,2000,2002,2,25.41,3.65,-21.76,1836,80,-1756,8047,8,-8039,53.0,1300.0,1247.0,0.0,2650000.0,2650000.0
younm003,Michael Young,Texas Rangers,RNGRS,3,6,5,11,2012,2015,3,0.34,-2.78,-3.12,251,118,-133,826,281,-545,19.0,285.0,266.0,17001100.0,3000000.0,-14001100.0
younm003,Michael Young,Philadelphia Phillies,PHILS,2,4,2,6,2013,2014,1,0.28,-0.1,-0.38,67,4,-63,137,0,-137,37.0,7.0,-30.0,496000.0,0.0,-496000.0
younp101,Pep Young,Pittsburgh Pirates,PIRATS,1,1,1,2,1940,1940,0,0.0,0.0,0.0,0,0,0,0,0,0,0.0,0.0,0.0,0.0,0.0,0.0
younp101,Pep Young,Brooklyn Dodgers,DOGRS,1,1,1,2,1940,1946,6,-0.08,2.1,2.18,4,148,144,13,423,410,0.0,0.0,0.0,0.0,5000.0,5000.0
younr102,Russ Young,Milwaukee,Milwaukee,1,1,4,5,1930,1931,1,-0.31,0.0,0.31,16,0,-16,36,0,-36,0.0,0.0,0.0,0.0,10000.0,10000.0
younr103,Ralph Young,Sacramento,Sacramento,1,1,1,2,1914,1914,0,3.49,0.0,-3.49,890,0,-890,3786,0,-3786,0.0,0.0,0.0,0.0,0.0,0.0
yvars101,Sal Yvars,St. Louis Cardinals,CARDS,1,1,1,2,1954,1954,0,0.0,0.0,0.0,0,0,0,0,0,0,0.0,0.0,0.0,0.0,0.0,0.0
zabaa101,Adrian Zabala,New York Giants,GIANTS,1,4,1,5,1953,1957,4,0.0,2.61,2.61,0,252,252,0,49,49,0.0,709.0,709.0,0.0,0.0,0.0
zabez101,Zip Zabel,Brooklyn Dodgers,DOGRS,1,2,1,3,1913,1913,0,1.78,0.0,-1.78,159,0,-159,149,0,-149,886.0,0.0,-886.0,0.0,0.0,0.0
zachc101,Chris Zachary,Kansas City Royals,ROYALS,1,1,1,2,1970,1973,3,-1.11,3.97,5.08,47,288,241,33,37,4,269.0,585.0,316.0,0.0,0.0,0.0
zachc101,Chris Zachary,St. Louis Cardinals,CARDS,1,1,1,2,1971,1971,0,1.46,0.0,-1.46,50,0,-50,3,0,-3,115.0,0.0,-115.0,0.0,0.0,0.0
zachc101,Chris Zachary,Detroit Tigers,TIGRS,3,3,3,6,1973,1973,0,0.39,0.46,0.07,72,22,-50,148,0,-148,36.0,241.0,205.0,0.0,0.0,0.0
zachc101,Chris Zachary,Pittsburgh Pirates,PIRATS,1,1,1,2,1973,1973,0,0.0,0.0,0.0,0,0,0,0,0,0,0.0,0.0,0.0,17500.0,0.0,-17500.0
zachp001,Pat Zachry,Cincinnati Reds,REDS,3,6,5,11,1977,1990,13,13.19,18.54,5.35,1751,636,-1115,5361,1105,-4256,2918.0,3754.0,836.0,450000.0,287500.0,-162500.0
zachp001,Pat Zachry,New York Mets,METS,3,4,4,8,1982,1984,2,-0.9,-1.63,-0.73,659,108,-551,1758,288,-1470,432.0,0.0,-432.0,0.0,250000.0,250000.0
zachp001,Pat Zachry,Los Angeles Dodgers,DOGRS,2,2,2,4,1985,1985,0,-0.66,0.15,0.81,81,78,-3,196,161,-35,38.0,0.0,-38.0,750000.0,185000.0,-565000.0
zacht101,Tom Zachary,Washington Senators,TWINS,1,2,2,4,1926,1926,0,4.68,-1.0,-5.68,222,56,-166,205,69,-136,1704.0,214.0,-1490.0,0.0,0.0,0.0
zacht101,Tom Zachary,St.Louis Browns,ORLS,22,41,50,91,1927,1952,25,133.07,120.47,-12.6,6485,9318,2833,21218,29687,8469,12714.0,17495.0,4781.0,217500.0,195450.0,-22050.0
zagum001,Mike Zagurski,Philadelphia Phillies,PHILS,1,1,1,2,2011,2011,0,-0.41,0.0,0.41,88,0,-88,0,0,0,112.0,0.0,-112.0,0.0,0.0,0.0
zahng001,Geoff Zahn,Los Angeles Dodgers,DOGRS,1,2,1,3,1975,1984,9,-0.7,25.95,26.65,50,645,595,25,676,651,233.0,5584.0,5351.0,0.0,0.0,0.0
zahnp101,Paul Zahniser,Washington Senators,TWINS,1,2,1,3,1925,1927,2,1.68,5.81,4.13,272,192,-80,587,672,85,1044.0,0.0,-1044.0,3600.0,8000.0,4400.0
zahnp101,Paul Zahniser,StPaul,StPaul,2,2,4,6,1928,1930,2,-0.07,0.0,0.07,47,0,-47,121,0,-121,3.0,0.0,-3.0,0.0,25000.0,25000.0
zahnp101,Paul Zahniser,Boston Red Sox,RSOX,1,4,2,6,1926,1926,0,0.0,0.0,0.0,0,0,0,0,0,0,0.0,0.0,0.0,15750.0,0.0,-15750.0
zaluj101,Jack Zalusky,New York Yankees,YANKS,1,2,1,3,1904,1910,6,0.0,5.04,5.04,0,522,522,0,1684,1684,0.0,0.0,0.0,0.0,0.0,0.0
zambc001,Carlos Zambrano,Chicago Cubs,CUBS,1,2,1,3,2012,2012,0,0.72,-1.46,-2.18,67,42,-25,36,34,-2,397.0,334.0,-63.0,0.0,0.0,0.0
zambv001,Victor Zambrano,Tampa Bay Devil Rays,RAYS,9,12,17,29,2004,2020,16,1.53,40.6,39.07,1161,1574,413,1626,3513,1887,2118.0,4281.0,2163.0,9958000.0,505000.0,-9453000.0
zamod001,Daniel Zamora,Pittsburgh Pirates,PIRATS,1,2,1,3,2018,2018,0,0.3,-0.37,-0.67,65,13,-52,0,0,0,53.0,17.0,-36.0,0.0,0.0,0.0
zannd101,Dom Zanni,San Francisco Giants,GIANTS,1,4,2,6,1961,1964,3,7.93,4.13,-3.8,685,341,-344,242,140,-102,2569.0,1260.0,-1309.0,0.0,0.0,0.0
zannd101,Dom Zanni,Chicago White Sox,WSOX,1,1,1,2,1963,1964,1,0.85,1.23,0.38,88,90,2,5,13,8,191.0,219.0,28.0,0.0,0.0,0.0
zapuj101,Joe Zapustas,Philadelphia Athletics,ATLTCS,2,4,2,6,1933,1934,1,0.0,0.0,0.0,0,0,0,0,0,0,0.0,0.0,0.0,0.0,0.0,0.0
zaria101,Al Zarilla,St.Louis Browns,ORLS,1,1,2,3,1949,1949,0,2.81,0.33,-2.48,332,104,-228,1231,376,-855,0.0,0.0,0.0,14500.0,15000.0,500.0
zaria101,Al Zarilla,Boston Red Sox,RSOX,3,9,8,17,1950,1956,6,14.02,9.79,-4.23,1662,1085,-577,5506,3192,-2314,1880.0,1611.0,-269.0,111000.0,40000.0,-71000.0
zaria101,Al Zarilla,Chicago White Sox,WSOX,2,3,3,6,1952,1954,2,-0.05,0.64,0.69,740,156,-584,2104,332,-1772,0.0,0.0,0.0,20000.0,0.0,-20000.0
zaskj001,Jeff Zaske,Pittsburgh Pirates,PIRATS,2,2,2,4,1986,1990,4,0.14,-0.49,-0.63,20,106,86,2,42,40,61.0,441.0,380.0,150000.0,0.0,-150000.0
zaucn101,Norm Zauchin,Boston Red Sox,RSOX,2,3,2,5,1958,1962,4,0.48,20.28,19.8,432,732,300,1643,3004,1361,0.0,0.0,0.0,0.0,0.0,0.0
zaung001,Gregg Zaun,Baltimore Orioles,ORLS,1,1,1,2,1996,1998,2,0.01,0.38,0.37,174,95,-79,545,0,-545,0.0,307.0,307.0,140000.0,292500.0,152500.0
zaung001,Gregg Zaun,Texas Rangers,RNGRS,3,10,10,20,1999,2013,14,7.41,32.82,25.41,760,2098,1338,1243,6477,5234,821.0,1323.0,502.0,18360260.0,14087500.0,-4272760.0
zaung001,Gregg Zaun,Baltimore Orioles,ORLS,1,1,1,2,2009,2011,2,0.33,-0.13,-0.46,34,14,-20,99,51,-48,0.0,0.0,0.0,1500000.0,0.0,-1500000.0
zdebj101,Joe Zdeb,Kansas City Royals,ROYALS,1,1,1,2,1980,1980,0,0.0,0.0,0.0,0,0,0,0,0,0,0.0,0.0,0.0,0.0,0.0,0.0
zeidj001,Josh Zeid,Philadelphia Phillies,PHILS,2,5,5,10,2011,2018,7,10.84,2.57,-8.27,1005,441,-564,3635,1629,-2006,674.0,0.0,-674.0,10400000.0,8200000.0,-2200000.0
zeidr101,Rollie Zeider,Chicago White Sox,WSOX,1,2,1,3,1913,1914,1,-0.81,2.78,3.59,83,160,77,319,648,329,0.0,0.0,0.0,0.0,6000.0,6000.0
zeilt001,Todd Zeile,St. Louis Cardinals,CARDS,1,2,3,5,1995,1996,1,-1.32,0.22,1.54,79,70,-9,325,79,-246,0.0,629.0,629.0,3700000.0,0.0,-3700000.0
zeilt001,Todd Zeile,Philadelphia Phillies,PHILS,4,6,7,13,1996,2002,6,5.3,4.73,-0.57,557,658,101,602,1100,498,2055.0,1429.0,-626.0,10946667.0,14670000.0,3723333.0
zeilt001,Todd Zeile,Los Angeles Dodgers,DOGRS,9,17,19,36,1998,2017,19,17.97,55.2,37.23,1483,3217,1734,4788,11288,6500,1883.0,2450.0,567.0,29893334.0,36745000.0,6851666.0
zeilt001,Todd Zeile,Florida Marlins,MARLNS,1,1,2,3,1998,1998,0,3.05,0.0,-3.05,208,0,-208,869,0,-869,0.0,0.0,0.0,0.0,0.0,0.0
zeilt001,Todd Zeile,New York Mets,METS,11,24,26,50,2002,2021,19,23.06,23.68,0.62,980,1702,722,2021,4506,2485,5255.0,3554.0,-1701.0,30731467.0,4325000.0,-26406467.0
zellb101,Bart Zeller,Milwaukee Brewers,BREWRS,3,4,4,8,1971,1973,2,-0.12,-0.77,-0.65,3,126,123,9,406,397,0.0,22.0,22.0,18000.0,0.0,-18000.0
zeppb101,Bill Zepp,Minnesota Twins,TWINS,2,2,3,5,1971,1974,3,-0.75,0.24,0.99,59,58,-1,44,90,46,95.0,0.0,-95.0,0.0,0.0,0.0
zerng101,Gus Zernial,Chicago White Sox,WSOX,37,70,65,135,1951,1971,20,135.72,175.24,39.52,11342,10596,-746,33371,28350,-5021,13927.0,15729.0,1802.0,374250.0,340500.0,-33750.0
zerng101,Gus Zernial,Kansas City Athletics,ATLTCS,31,62,61,123,1957,1976,19,95.85,56.38,-39.47,9593,6643,-2950,23097,19018,-4079,12004.0,6179.0,-5825.0,476100.0,606500.0,130400.0
ziegb001,Brad Ziegler,Oakland Athletics,ATLTCS,1,1,2,3,2011,2013,2,7.21,0.64,-6.57,736,91,-645,7,165,158,1072.0,176.0,-896.0,1250000.0,0.0,-1250000.0
ziegb001,Brad Ziegler,Arizona Diamondbacks,DBACKS,1,1,2,3,2016,2016,0,0.93,0.0,-0.93,34,0,-34,0,0,0,89.0,0.0,-89.0,0.0,0.0,0.0
ziegb001,Brad Ziegler,Miami Marlins,MARLNS,1,1,1,2,2018,2018,0,0.01,0.0,-0.01,56,0,-56,0,0,0,65.0,0.0,-65.0,9000000.0,0.0,-9000000.0
zimmb002,Bruce Zimmermann,Atlanta Braves,BRAVES,1,5,2,7,2018,2020,2,0.09,0.72,0.63,63,86,23,4,50,46,357.0,484.0,127.0,0.0,5600000.0,5600000.0
zimmb101,Bill Zimmerman,Newark,Newark,1,1,1,2,1915,1915,0,-0.17,0.0,0.17,22,0,-22,62,0,-62,0.0,0.0,0.0,0.0,0.0,0.0
zimmb101,Bill Zimmerman,Brooklyn Dodgers,DOGRS,3,8,5,13,1916,1927,11,6.65,18.0,11.35,787,1605,818,3022,6599,3577,0.0,0.0,0.0,27500.0,4800.0,-22700.0
zimmc101,Chief Zimmer,Louisville Colonels,LS3,1,12,5,17,1899,1900,1,267.1,0.0,-267.1,7388,0,-7388,29004,0,-29004,7568.0,0.0,-7568.0,4350.0,0.0,-4350.0
zimmd101,Don Zimmer,Los Angeles Dodgers,DOGRS,2,4,6,10,1960,1968,8,9.89,15.02,5.13,1184,1098,-86,1862,588,-1274,1656.0,2535.0,879.0,122000.0,73000.0,-49000.0
zimmd101,Don Zimmer,New York Mets,METS,1,1,2,3,1962,1962,0,0.31,-0.97,-1.28,63,74,11,207,120,-87,0.0,61.0,61.0,0.0,0.0,0.0
zimmd101,Don Zimmer,Cincinnati Reds,REDS,1,1,1,2,1963,1963,0,0.25,0.0,-0.25,22,0,-22,26,0,-26,0.0,0.0,0.0,0.0,0.0,0.0
zimmh101,Heinie Zimmerman,Chicago Cubs,CUBS,3,6,5,11,1916,1923,7,11.54,10.57,-0.97,610,657,47,2316,2253,-63,0.0,807.0,807.0,6500.0,7400.0,900.0
zimmj101,Jerry Zimmerman,Cincinnati Reds,REDS,1,1,1,2,1962,1962,0,-1.16,0.0,1.16,407,0,-407,897,0,-897,0.0,0.0,0.0,0.0,0.0,0.0
zimmr101,Roy Zimmerman,New York Giants,GIANTS,1,2,2,4,1950,1957,7,0.0,-0.62,-0.62,0,132,132,0,152,152,0.0,0.0,0.0,0.0,0.0,0.0
zinng101,Guy Zinn,New York Yankees,YANKS,6,15,9,24,1912,1946,34,28.8,114.46,85.66,1052,3746,2694,1402,10175,8773,7730.0,15194.0,7464.0,42500.0,38450.0,-4050.0
zinta001,Alan Zinter,New York Mets,METS,3,3,4,7,1994,1997,3,-3.03,2.58,5.61,499,315,-184,2022,891,-1131,10.0,148.0,138.0,587500.0,468250.0,-119250.0
zipfb101,Bud Zipfel,Los Angeles Angels,ANGELS,6,9,8,17,1960,1968,8,-1.84,8.4,10.24,437,851,414,827,2608,1781,443.0,1270.0,827.0,44000.0,0.0,-44000.0
ziskr101,Richie Zisk,Pittsburgh Pirates,PIRATS,1,2,2,4,1976,1977,1,2.48,6.27,3.79,151,213,62,599,52,-547,63.0,661.0,598.0,0.0,0.0,0.0
ziskr101,Richie Zisk,Texas Rangers,RNGRS,4,10,10,20,1980,1987,7,9.35,8.94,-0.41,686,425,-261,1581,631,-950,2721.0,2684.0,-37.0,817500.0,331000.0,-486500.0
zobrb001,Ben Zobrist,Houston Astros,ASTROS,1,2,2,4,2006,2006,0,34.91,0.23,-34.68,1067,68,-999,4478,261,-4217,29.0,0.0,-29.0,0.0,6916667.0,6916667.0
zobrb001,Ben Zobrist,Tampa Bay Devil Rays,RAYS,3,7,8,15,2015,2020,5,1.14,10.45,9.31,141,997,856,395,3417,3022,283.0,217.0,-66.0,508800.0,3779600.0,3270800.0
zobrb001,Ben Zobrist,Oakland Athletics,ATLTCS,3,4,4,8,2015,2016,1,1.77,-2.5,-4.27,107,79,-28,392,193,-199,0.0,153.0,153.0,0.0,4800000.0,4800000.0
zoccp001,Peter Zoccolillo,Chicago Cubs,CUBS,1,2,2,4,2001,2001,0,-1.88,0.61,2.49,108,56,-52,117,0,-117,715.0,85.0,-630.0,0.0,1200000.0,1200000.0
zolds101,Sam Zoldak,Philadelphia Athletics,ATLTCS,4,5,4,9,1944,1953,9,7.79,8.9,1.11,528,937,409,1124,3595,2471,1511.0,0.0,-1511.0,24000.0,0.0,-24000.0
zolds101,Sam Zoldak,St.Louis Browns,ORLS,1,1,2,3,1948,1952,4,2.07,2.27,0.2,166,188,22,66,111,45,667.0,1031.0,364.0,10500.0,0.0,-10500.0
zolds101,Sam Zoldak,Cleveland Indians,INDINS,1,3,1,4,1951,1951,0,2.32,1.96,-0.36,252,108,-144,644,24,-620,610.0,338.0,-272.0,0.0,15200.0,15200.0
zoske001,Eddie Zosky,Toronto Blue Jays,BJAYS,1,1,1,2,1994,1998,4,-0.1,0.0,0.1,6,0,-6,5,0,-5,0.0,0.0,0.0,0.0,0.0,0.0
zubeb101,Bill Zuber,Washington Senators,TWINS,3,4,4,8,1943,1952,9,6.27,10.3,4.03,428,788,360,1420,1973,553,1073.0,1761.0,688.0,9000.0,14000.0,5000.0
zunim001,Mike Zunino,Seattle Mariners,MARNRS,1,3,2,5,2018,2020,2,3.75,-0.48,-4.23,316,148,-168,979,613,-366,0.0,0.0,0.0,2975000.0,0.0,-2975000.0
zuvep001,Paul Zuvella,Atlanta Braves,BRAVES,1,2,2,4,1986,1988,2,2.5,1.46,-1.04,350,271,-79,1144,976,-168,0.0,0.0,0.0,750000.0,1050000.0,300000.0
